userID,trajID,poiID,startTime,endTime,#photo,trajLen,poiDuration
10000151@N02,1,17,1445055661,1445056081,1,1,420
10004778@N07,2,7,1365918281,1365918401,1,1,120
10013542@N02,3,17,1429426348,1429426768,1,1,420
100344010@N06,4,24,1354336114,1354337614,1,1,1500
100373287@N02,5,6,1407466438,1407466558,1,1,120
100373287@N02,6,25,1407496883,1407498983,1,1,2100
100432722@N02,7,12,1434582533,1434582803,1,1,270
100448554@N06,8,22,1355980080,1355980147,2,2,67
100448554@N06,8,13,1355980147,1355980447,1,2,300
100448554@N06,9,19,1356079286,1356079826,3,2,540
100448554@N06,9,16,1356087077,1356087497,1,2,420
100448554@N06,10,12,1356132432,1356132702,2,3,270
100448554@N06,10,10,1356140843,1356140993,2,3,150
100448554@N06,10,24,1356169614,1356171114,1,3,1500
100459519@N02,11,24,1398077941,1398079441,1,1,1500
10050886@N06,12,12,1344569913,1344570183,3,2,270
10050886@N06,12,16,1344600391,1344600811,1,2,420
100548895@N03,13,7,1453792770,1453792890,1,1,120
100548895@N03,14,7,1453956474,1453956594,1,1,120
10055157@N02,15,17,1338365524,1338365944,2,2,420
10055157@N02,15,7,1338373675,1338373795,1,2,120
10055157@N02,16,12,1356693316,1356693586,1,1,270
10055157@N02,17,12,1357819194,1357819464,1,1,270
10055157@N02,18,13,1430292770,1430293070,2,2,300
10055157@N02,18,23,1430294018,1430295218,1,2,1200
10055157@N02,19,13,1462920696,1462920996,2,2,300
10055157@N02,19,7,1462935357,1462935477,1,2,120
10062483@N05,20,8,1336354340,1336354460,2,3,120
10062483@N05,20,2,1336354776,1336354777,2,3,1
10062483@N05,20,9,1336354777,1336354897,1,3,120
100632664@N02,21,12,1467130154,1467130424,1,1,270
10079095@N04,22,13,1339139126,1339139426,4,5,300
10079095@N04,22,22,1339139966,1339140096,2,5,130
10079095@N04,22,12,1339140096,1339140366,2,5,270
10079095@N04,22,4,1339160823,1339160913,2,5,90
10079095@N04,22,12,1339167648,1339167918,1,5,270
100800732@N07,23,16,1405811865,1405812285,1,1,420
100800732@N07,24,10,1405858518,1405858668,1,1,150
10104403@N00,25,6,1252645595,1252645715,44,1,120
10104403@N00,26,6,1252739690,1252739810,25,1,120
10104403@N00,27,16,1313669418,1313669838,1,1,420
10104403@N00,28,24,1375990651,1375992151,1,1,1500
10104914@N07,29,12,1191381339,1191381609,2,5,270
10104914@N07,29,24,1191385160,1191385638,3,5,478
10104914@N07,29,16,1191385638,1191386058,4,5,420
10104914@N07,29,5,1191387753,1191387873,2,5,120
10104914@N07,29,7,1191390468,1191390588,1,5,120
10106605@N07,30,12,1338524426,1338524507,4,8,81
10106605@N07,30,24,1338524507,1338524625,6,8,118
10106605@N07,30,20,1338524625,1338524646,2,8,21
10106605@N07,30,24,1338524646,1338524848,3,8,202
10106605@N07,30,25,1338524848,1338524927,2,8,79
10106605@N07,30,15,1338524927,1338525175,2,8,248
10106605@N07,30,6,1338525175,1338525295,2,8,120
10106605@N07,30,19,1338525335,1338525875,10,8,540
10106605@N07,31,14,1351666577,1351666937,1,1,360
10106605@N07,32,24,1353991520,1353993020,9,1,1500
101075959@N06,33,19,1376208176,1376208716,2,12,540
101075959@N06,33,7,1376209889,1376210009,2,12,120
101075959@N06,33,16,1376211626,1376211711,2,12,85
101075959@N06,33,23,1376211711,1376211996,2,12,285
101075959@N06,33,12,1376211996,1376212154,2,12,158
101075959@N06,33,24,1376212154,1376212251,2,12,97
101075959@N06,33,25,1376212251,1376214351,5,12,2100
101075959@N06,33,4,1376215090,1376215180,3,12,90
101075959@N06,33,14,1376215636,1376215745,3,12,109
101075959@N06,33,6,1376215745,1376215865,5,12,120
101075959@N06,33,12,1376218372,1376218642,3,12,270
101075959@N06,33,16,1376218669,1376219089,10,12,420
101200606@N03,34,24,1387927191,1387928691,1,1,1500
101200606@N03,35,16,1387964968,1387965388,2,1,420
101208631@N08,36,20,1381455452,1381456052,3,2,600
101208631@N08,36,16,1381473785,1381474205,1,2,420
10129939@N08,37,18,1335850672,1335851212,8,3,540
10129939@N08,37,7,1335855819,1335855939,2,3,120
10129939@N08,37,11,1335857550,1335857790,1,3,240
10129939@N08,38,3,1336104829,1336104919,2,2,90
10129939@N08,38,11,1336106905,1336107145,2,2,240
10129939@N08,39,4,1336361039,1336361129,1,1,90
101312296@N05,40,18,1374673764,1374674304,1,1,540
101316071@N05,41,22,1396933646,1396933717,2,5,71
101316071@N05,41,24,1396933717,1396935217,3,5,1500
101316071@N05,41,17,1396936216,1396936636,2,5,420
101316071@N05,41,19,1396939970,1396940510,4,5,540
101316071@N05,41,6,1396952747,1396952867,5,5,120
101334634@N07,42,12,1383986193,1383986463,1,1,270
101355699@N08,43,24,1407725136,1407725312,2,8,176
101355699@N08,43,25,1407725312,1407727412,4,8,2100
101355699@N08,43,6,1407737630,1407737750,2,8,120
101355699@N08,43,14,1407742314,1407742436,2,8,122
101355699@N08,43,19,1407742436,1407742976,4,8,540
101355699@N08,43,16,1407744393,1407744813,4,8,420
101355699@N08,43,18,1407744979,1407745519,3,8,540
101355699@N08,43,10,1407759559,1407759709,1,8,150
10136713@N00,44,17,1202863893,1202864313,3,2,420
10136713@N00,44,18,1202870473,1202871013,2,2,540
10152427@N08,45,24,1250508963,1250510463,3,2,1500
10152427@N08,45,10,1250514107,1250514257,1,2,150
10152427@N08,46,23,1250951004,1250952204,1,1,1200
101538895@N08,47,12,1423475632,1423475902,3,1,270
101593101@N02,48,13,1441008467,1441008767,2,2,300
101593101@N02,48,10,1441012344,1441012494,1,2,150
101593101@N02,49,24,1465335020,1465336520,3,12,1500
101593101@N02,49,14,1465344616,1465344976,2,12,360
101593101@N02,49,24,1465346511,1465348011,8,12,1500
101593101@N02,49,12,1465353254,1465353524,2,12,270
101593101@N02,49,16,1465355557,1465355977,2,12,420
101593101@N02,49,7,1465356401,1465356521,2,12,120
101593101@N02,49,22,1465371159,1465371669,3,12,510
101593101@N02,49,2,1465371669,1465371729,4,12,60
101593101@N02,49,20,1465375028,1465375141,2,12,113
101593101@N02,49,6,1465375141,1465375261,2,12,120
101593101@N02,49,8,1465375882,1465376002,2,12,120
101593101@N02,49,14,1465376499,1465376859,3,12,360
10182842@N08,50,12,1308370127,1308370236,3,12,109
10182842@N08,50,24,1308370236,1308370307,3,12,71
10182842@N08,50,25,1308370307,1308370984,5,12,677
10182842@N08,50,4,1308370984,1308371074,4,12,90
10182842@N08,50,20,1308371596,1308371772,2,12,176
10182842@N08,50,16,1308371772,1308372054,4,12,282
10182842@N08,50,10,1308372054,1308372204,2,12,150
10182842@N08,50,18,1308373278,1308373740,12,12,462
10182842@N08,50,16,1308373740,1308374111,2,12,371
10182842@N08,50,18,1308374111,1308374199,2,12,88
10182842@N08,50,3,1308374199,1308374289,4,12,90
10182842@N08,50,16,1308374313,1308374733,2,12,420
10182842@N08,51,25,1309743711,1309744093,8,13,382
10182842@N08,51,6,1309744093,1309744213,4,13,120
10182842@N08,51,16,1309744426,1309744846,8,13,420
10182842@N08,51,11,1309746121,1309746293,2,13,172
10182842@N08,51,7,1309746293,1309746413,9,13,120
10182842@N08,51,18,1309748095,1309748635,2,13,540
10182842@N08,51,3,1309749582,1309749672,11,13,90
10182842@N08,51,16,1309753397,1309753817,8,13,420
10182842@N08,51,17,1309755563,1309755983,3,13,420
10182842@N08,51,25,1309771443,1309773543,11,13,2100
10182842@N08,51,19,1309774443,1309774856,6,13,413
10182842@N08,51,16,1309774856,1309775147,2,13,291
10182842@N08,51,17,1309775147,1309775567,2,13,420
10182842@N08,52,12,1310096925,1310097195,2,6,270
10182842@N08,52,17,1310097388,1310097808,6,6,420
10182842@N08,52,16,1310120154,1310120300,5,6,146
10182842@N08,52,19,1310120300,1310120809,3,6,509
10182842@N08,52,17,1310120809,1310121229,5,6,420
10182842@N08,52,12,1310122129,1310122399,4,6,270
10182842@N08,53,8,1310795022,1310795142,3,4,120
10182842@N08,53,16,1310795768,1310796088,2,4,320
10182842@N08,53,7,1310796088,1310796208,6,4,120
10182842@N08,53,15,1310814973,1310815333,1,4,360
10182842@N08,54,19,1310898587,1310898870,2,4,283
10182842@N08,54,16,1310898870,1310899077,2,4,207
10182842@N08,54,19,1310899077,1310899617,2,4,540
10182842@N08,54,16,1310904403,1310904823,2,4,420
10182842@N08,55,12,1311818912,1311819182,2,1,270
10182842@N08,56,13,1312600141,1312600441,7,2,300
10182842@N08,56,12,1312603932,1312604202,1,2,270
10182842@N08,57,7,1313288762,1313288882,28,5,120
10182842@N08,57,16,1313291689,1313292109,3,5,420
10182842@N08,57,5,1313294196,1313294316,6,5,120
10182842@N08,57,16,1313294900,1313295125,2,5,225
10182842@N08,57,17,1313295125,1313295545,4,5,420
10182842@N08,58,16,1316163207,1316163627,6,11,420
10182842@N08,58,25,1316164239,1316164949,3,11,710
10182842@N08,58,16,1316164949,1316165369,2,11,420
10182842@N08,58,25,1316166515,1316168541,4,11,2026
10182842@N08,58,11,1316168541,1316168781,2,11,240
10182842@N08,58,7,1316168828,1316168948,2,11,120
10182842@N08,58,16,1316168949,1316169121,2,11,172
10182842@N08,58,11,1316169121,1316169361,3,11,240
10182842@N08,58,18,1316169656,1316169855,3,11,199
10182842@N08,58,5,1316169855,1316169975,2,11,120
10182842@N08,58,1,1316170037,1316170097,2,11,60
10182842@N08,59,12,1316498357,1316498627,2,5,270
10182842@N08,59,7,1316501958,1316502078,3,5,120
10182842@N08,59,10,1316503870,1316504020,5,5,150
10182842@N08,59,16,1316504298,1316504718,2,5,420
10182842@N08,59,17,1316504823,1316505243,1,5,420
10182842@N08,60,16,1321068028,1321068420,3,7,392
10182842@N08,60,7,1321068420,1321068495,2,7,75
10182842@N08,60,11,1321068495,1321068735,3,7,240
10182842@N08,60,7,1321068902,1321069022,4,7,120
10182842@N08,60,18,1321070446,1321070692,2,7,246
10182842@N08,60,1,1321070692,1321070752,4,7,60
10182842@N08,60,16,1321070813,1321071233,3,7,420
10182842@N08,61,19,1324094158,1324094698,2,3,540
10182842@N08,61,16,1324095939,1324096359,4,3,420
10182842@N08,61,17,1324096843,1324097263,1,3,420
10182842@N08,62,6,1327128084,1327128204,3,2,120
10182842@N08,62,16,1327129004,1327129424,14,2,420
10182842@N08,63,19,1330720373,1330720913,2,1,540
10182842@N08,64,12,1331470911,1331471141,2,15,230
10182842@N08,64,17,1331471141,1331471314,2,15,173
10182842@N08,64,4,1331471314,1331471404,2,15,90
10182842@N08,64,18,1331471579,1331472119,2,15,540
10182842@N08,64,11,1331472556,1331472796,2,15,240
10182842@N08,64,7,1331473039,1331473159,4,15,120
10182842@N08,64,18,1331475405,1331475945,4,15,540
10182842@N08,64,19,1331477119,1331477659,2,15,540
10182842@N08,64,6,1331477953,1331478022,2,15,69
10182842@N08,64,19,1331478022,1331478187,2,15,165
10182842@N08,64,4,1331478187,1331478277,2,15,90
10182842@N08,64,8,1331478302,1331478370,2,15,68
10182842@N08,64,4,1331478370,1331478460,3,15,90
10182842@N08,64,25,1331479608,1331479912,4,15,304
10182842@N08,64,13,1331479912,1331480212,2,15,300
10182842@N08,65,17,1332565863,1332565941,3,9,78
10182842@N08,65,23,1332565941,1332566094,2,9,153
10182842@N08,65,16,1332566094,1332566514,4,9,420
10182842@N08,65,10,1332566522,1332566672,8,9,150
10182842@N08,65,5,1332567041,1332567161,7,9,120
10182842@N08,65,18,1332567701,1332567838,2,9,137
10182842@N08,65,5,1332567838,1332567958,2,9,120
10182842@N08,65,7,1332568158,1332568278,8,9,120
10182842@N08,65,16,1332569631,1332570051,1,9,420
10182842@N08,66,7,1333269566,1333269633,3,3,67
10182842@N08,66,16,1333269633,1333269764,2,3,131
10182842@N08,66,7,1333269764,1333269884,1,3,120
10182842@N08,67,25,1334413239,1334415339,9,11,2100
10182842@N08,67,6,1334416457,1334416507,2,11,50
10182842@N08,67,20,1334416507,1334416677,5,11,170
10182842@N08,67,24,1334416677,1334416719,2,11,42
10182842@N08,67,20,1334416719,1334416978,3,11,259
10182842@N08,67,6,1334416978,1334417098,2,11,120
10182842@N08,67,16,1334417203,1334417488,2,11,285
10182842@N08,67,7,1334417488,1334417608,9,11,120
10182842@N08,67,10,1334418891,1334418943,2,11,52
10182842@N08,67,7,1334418943,1334419063,3,11,120
10182842@N08,67,3,1334419324,1334419414,2,11,90
10182842@N08,68,24,1336276158,1336276712,3,13,554
10182842@N08,68,6,1336276712,1336276832,2,13,120
10182842@N08,68,11,1336277258,1336277492,3,13,234
10182842@N08,68,16,1336277492,1336277507,2,13,15
10182842@N08,68,11,1336277507,1336277747,2,13,240
10182842@N08,68,19,1336277880,1336278420,3,13,540
10182842@N08,68,11,1336278643,1336278878,5,13,235
10182842@N08,68,18,1336278878,1336278983,2,13,105
10182842@N08,68,11,1336278983,1336279200,3,13,217
10182842@N08,68,7,1336279200,1336279320,12,13,120
10182842@N08,68,18,1336280086,1336280374,2,13,288
10182842@N08,68,6,1336280374,1336280494,2,13,120
10182842@N08,68,17,1336280602,1336281022,1,13,420
10182842@N08,69,24,1338164779,1338164946,2,8,167
10182842@N08,69,25,1338164946,1338165375,2,8,429
10182842@N08,69,24,1338165375,1338165660,5,8,285
10182842@N08,69,13,1338165660,1338165884,5,8,224
10182842@N08,69,25,1338165884,1338166649,5,8,765
10182842@N08,69,16,1338166649,1338166690,2,8,41
10182842@N08,69,8,1338166690,1338166810,3,8,120
10182842@N08,69,19,1338167318,1338167858,4,8,540
10182842@N08,70,19,1339084431,1339084856,3,3,425
10182842@N08,70,17,1339084856,1339085276,2,3,420
10182842@N08,70,12,1339092743,1339093013,3,3,270
10182842@N08,71,24,1339904064,1339904921,7,6,857
10182842@N08,71,14,1339904921,1339905281,17,6,360
10182842@N08,71,6,1339910304,1339910424,2,6,120
10182842@N08,71,12,1339910790,1339911060,2,6,270
10182842@N08,71,14,1339914145,1339914505,2,6,360
10182842@N08,71,12,1339915564,1339915834,3,6,270
10182842@N08,72,14,1340319968,1340320328,9,3,360
10182842@N08,72,24,1340323802,1340325302,4,3,1500
10182842@N08,72,12,1340326792,1340327062,1,3,270
10182842@N08,73,24,1341371311,1341372811,9,5,1500
10182842@N08,73,14,1341373660,1341374020,15,5,360
10182842@N08,73,9,1341375936,1341376028,2,5,92
10182842@N08,73,14,1341376028,1341376034,2,5,6
10182842@N08,73,24,1341376034,1341377534,4,5,1500
10182842@N08,74,24,1341574157,1341574549,2,3,392
10182842@N08,74,14,1341574549,1341574909,16,3,360
10182842@N08,74,19,1341578501,1341579041,1,3,540
10182842@N08,75,12,1343466338,1343466608,5,9,270
10182842@N08,75,13,1343467632,1343467903,6,9,271
10182842@N08,75,12,1343467903,1343468173,2,9,270
10182842@N08,75,8,1343468826,1343468946,6,9,120
10182842@N08,75,14,1343469826,1343470186,3,9,360
10182842@N08,75,19,1343470446,1343470986,3,9,540
10182842@N08,75,16,1343472756,1343472972,3,9,216
10182842@N08,75,19,1343472972,1343473274,3,9,302
10182842@N08,75,23,1343473274,1343474474,1,9,1200
10182842@N08,76,14,1345191734,1345192094,8,8,360
10182842@N08,76,16,1345194989,1345195409,2,8,420
10182842@N08,76,7,1345195526,1345195646,3,8,120
10182842@N08,76,18,1345195856,1345196396,7,8,540
10182842@N08,76,5,1345198029,1345198149,3,8,120
10182842@N08,76,16,1345198270,1345198690,3,8,420
10182842@N08,76,14,1345199662,1345200022,4,8,360
10182842@N08,76,13,1345200826,1345201126,1,8,300
10182842@N08,77,24,1348125250,1348126750,2,1,1500
10182842@N08,78,12,1352595875,1352596145,2,4,270
10182842@N08,78,14,1352596678,1352597038,3,4,360
10182842@N08,78,5,1352601047,1352601167,2,4,120
10182842@N08,78,1,1352601682,1352601742,1,4,60
10182842@N08,79,21,1355889095,1355889995,1,1,900
10182842@N08,80,14,1357348998,1357349358,2,1,360
10182842@N08,81,22,1362210887,1362211907,2,2,1020
10182842@N08,81,14,1362216589,1362216949,3,2,360
10182842@N08,82,7,1364417837,1364417957,1,1,120
10182842@N08,83,24,1365215576,1365216049,2,2,473
10182842@N08,83,12,1365216049,1365216319,1,2,270
10182842@N08,84,22,1371951748,1371952219,2,8,471
10182842@N08,84,25,1371952219,1371952891,3,8,672
10182842@N08,84,14,1371952891,1371953025,2,8,134
10182842@N08,84,19,1371953025,1371953348,3,8,323
10182842@N08,84,14,1371953348,1371953708,2,8,360
10182842@N08,84,19,1371955695,1371956235,3,8,540
10182842@N08,84,16,1371958099,1371958445,2,8,346
10182842@N08,84,17,1371958445,1371958865,1,8,420
10182842@N08,85,10,1391156430,1391156580,2,4,150
10182842@N08,85,16,1391156688,1391157108,5,4,420
10182842@N08,85,4,1391158262,1391158352,2,4,90
10182842@N08,85,13,1391159190,1391159490,7,4,300
10182842@N08,86,25,1399615929,1399617319,4,3,1390
10182842@N08,86,14,1399617319,1399617679,2,3,360
10182842@N08,86,19,1399617849,1399618389,2,3,540
10182842@N08,87,25,1401612720,1401614820,1,1,2100
10182842@N08,88,1,1408103221,1408103281,1,1,60
10182842@N08,89,17,1413004686,1413005106,1,1,420
10182842@N08,90,14,1417659199,1417659559,7,3,360
10182842@N08,90,19,1417662393,1417662485,2,3,92
10182842@N08,90,23,1417662485,1417663685,2,3,1200
10182842@N08,91,25,1425005869,1425007969,1,1,2100
10185356@N05,92,17,1377100214,1377100634,2,5,420
10185356@N05,92,25,1377103673,1377104972,3,5,1299
10185356@N05,92,15,1377104972,1377105332,2,5,360
10185356@N05,92,24,1377106142,1377107642,2,5,1500
10185356@N05,92,25,1377109884,1377111984,1,5,2100
10185356@N05,93,16,1377193402,1377193822,2,4,420
10185356@N05,93,5,1377194654,1377194774,2,4,120
10185356@N05,93,7,1377197013,1377197133,3,4,120
10185356@N05,93,19,1377202114,1377202654,3,4,540
10185356@N05,94,14,1377304118,1377304478,4,7,360
10185356@N05,94,18,1377306359,1377306407,3,7,48
10185356@N05,94,10,1377306407,1377306557,2,7,150
10185356@N05,94,18,1377306584,1377306683,2,7,99
10185356@N05,94,10,1377306683,1377306833,2,7,150
10185356@N05,94,18,1377308497,1377309037,3,7,540
10185356@N05,94,7,1377309193,1377309313,1,7,120
101957095@N05,95,10,1384311505,1384311655,2,2,150
101957095@N05,95,1,1384315440,1384315500,1,2,60
10196023@N00,96,24,1191043557,1191045057,1,1,1500
10196023@N00,97,10,1191582345,1191582495,2,3,150
10196023@N00,97,6,1191582915,1191583035,2,3,120
10196023@N00,97,20,1191583454,1191584054,1,3,600
10196023@N00,98,25,1199243948,1199246048,1,1,2100
10196023@N00,99,24,1202534430,1202535930,1,1,1500
10196023@N00,100,25,1203139156,1203141256,3,1,2100
10196023@N00,101,12,1203198543,1203198813,1,1,270
10196023@N00,102,12,1203726945,1203727215,3,2,270
10196023@N00,102,24,1203727314,1203728814,3,2,1500
10196023@N00,103,24,1205537600,1205539100,2,2,1500
10196023@N00,103,19,1205562571,1205563111,15,2,540
10196023@N00,104,7,1212814062,1212814182,2,2,120
10196023@N00,104,24,1212816258,1212817758,1,2,1500
10196023@N00,105,7,1214784572,1214784692,1,1,120
10196023@N00,106,24,1215754050,1215755550,1,1,1500
10196023@N00,107,16,1215860971,1215861391,1,1,420
10196023@N00,108,23,1223035022,1223036222,2,3,1200
10196023@N00,108,16,1223038292,1223038712,2,3,420
10196023@N00,108,12,1223040982,1223041252,1,3,270
10196023@N00,109,11,1225446129,1225446369,2,2,240
10196023@N00,109,25,1225449335,1225451435,1,2,2100
10196023@N00,110,6,1225941509,1225941629,1,1,120
10196023@N00,111,24,1232167239,1232168739,1,1,1500
10196023@N00,112,17,1247254848,1247255268,1,1,420
10196023@N00,113,10,1247302827,1247302977,2,2,150
10196023@N00,113,2,1247309431,1247309491,1,2,60
10196023@N00,114,6,1247384198,1247384318,1,1,120
10196023@N00,115,5,1266636978,1266637098,1,1,120
10196023@N00,116,13,1269651305,1269651605,1,1,300
10196023@N00,117,20,1278838174,1278838774,2,3,600
10196023@N00,117,16,1278844443,1278844863,2,3,420
10196023@N00,117,22,1278853059,1278854079,1,3,1020
10196023@N00,118,24,1287820724,1287821191,2,3,467
10196023@N00,118,22,1287821191,1287822211,2,3,1020
10196023@N00,118,13,1287823660,1287823960,3,3,300
10196023@N00,119,20,1289099355,1289099955,1,1,600
10196023@N00,120,24,1301701714,1301703214,2,2,1500
10196023@N00,120,25,1301709365,1301711465,3,2,2100
10196023@N00,121,16,1307758268,1307758688,1,1,420
10196023@N00,122,9,1340525383,1340525503,1,1,120
10196023@N00,123,8,1340611496,1340611616,1,1,120
10196023@N00,124,1,1341212713,1341212773,1,1,60
10196023@N00,125,8,1341785167,1341785287,1,1,120
10196023@N00,126,8,1347063095,1347063215,2,2,120
10196023@N00,126,2,1347063368,1347063428,1,2,60
10196023@N00,127,24,1365902707,1365904207,1,1,1500
10196023@N00,128,22,1436684790,1436685810,1,1,1020
102237062@N02,129,6,1451422532,1451422652,3,17,120
102237062@N02,129,15,1451425168,1451425528,10,17,360
102237062@N02,129,18,1451427825,1451428365,2,17,540
102237062@N02,129,16,1451430360,1451430600,6,17,240
102237062@N02,129,11,1451430600,1451430840,3,17,240
102237062@N02,129,14,1451430967,1451431327,12,17,360
102237062@N02,129,25,1451435057,1451437157,2,17,2100
102237062@N02,129,15,1451440407,1451440767,4,17,360
102237062@N02,129,16,1451443542,1451443962,5,17,420
102237062@N02,129,11,1451445276,1451445516,2,17,240
102237062@N02,129,24,1451446437,1451447937,8,17,1500
102237062@N02,129,6,1451464554,1451464674,4,17,120
102237062@N02,129,14,1451464932,1451465292,3,17,360
102237062@N02,129,16,1451465918,1451466338,73,17,420
102237062@N02,129,11,1451471062,1451471302,4,17,240
102237062@N02,129,16,1451473532,1451473952,20,17,420
102237062@N02,129,17,1451475238,1451475658,1,17,420
10242313@N05,130,13,1200642538,1200642838,3,1,300
10242313@N05,131,20,1236421853,1236421868,5,4,15
10242313@N05,131,12,1236421868,1236421879,4,4,11
10242313@N05,131,24,1236421879,1236422552,9,4,673
10242313@N05,131,12,1236422552,1236422822,12,4,270
10259875@N03,132,17,1342667694,1342668114,3,17,420
10259875@N03,132,7,1342671271,1342671391,2,17,120
10259875@N03,132,1,1342673494,1342673554,2,17,60
10259875@N03,132,24,1342675132,1342676253,3,17,1121
10259875@N03,132,20,1342676253,1342676350,3,17,97
10259875@N03,132,24,1342676350,1342677047,2,17,697
10259875@N03,132,20,1342677047,1342677647,2,17,600
10259875@N03,132,15,1342681895,1342682255,2,17,360
10259875@N03,132,6,1342692492,1342692612,2,17,120
10259875@N03,132,20,1342694574,1342694668,2,17,94
10259875@N03,132,13,1342694668,1342694968,2,17,300
10259875@N03,132,20,1342695868,1342696468,2,17,600
10259875@N03,132,16,1342697656,1342698076,2,17,420
10259875@N03,132,14,1342698308,1342698560,2,17,252
10259875@N03,132,6,1342698560,1342698680,2,17,120
10259875@N03,132,7,1342705929,1342706049,2,17,120
10259875@N03,132,19,1342706933,1342707473,1,17,540
10259875@N03,133,24,1455686284,1455687784,3,14,1500
10259875@N03,133,19,1455688550,1455689090,2,14,540
10259875@N03,133,24,1455694117,1455695617,3,14,1500
10259875@N03,133,18,1455702295,1455702835,2,14,540
10259875@N03,133,5,1455703241,1455703361,3,14,120
10259875@N03,133,16,1455708684,1455708896,2,14,212
10259875@N03,133,11,1455708896,1455709136,2,14,240
10259875@N03,133,16,1455709149,1455709172,2,14,23
10259875@N03,133,19,1455709172,1455709517,4,14,345
10259875@N03,133,14,1455709517,1455709815,4,14,298
10259875@N03,133,2,1455709815,1455709875,2,14,60
10259875@N03,133,25,1455709979,1455710072,2,14,93
10259875@N03,133,22,1455710072,1455710204,2,14,132
10259875@N03,133,24,1455710204,1455711704,1,14,1500
10259875@N03,134,19,1455771676,1455772216,1,1,540
102667810@N03,135,10,1366526811,1366526961,9,6,150
102667810@N03,135,16,1366529121,1366529541,5,6,420
102667810@N03,135,6,1366531395,1366531515,2,6,120
102667810@N03,135,16,1366531758,1366532178,2,6,420
102667810@N03,135,1,1366534382,1366534442,4,6,60
102667810@N03,135,16,1366545113,1366545533,2,6,420
10274899@N06,136,25,1248929159,1248930328,2,5,1169
10274899@N06,136,13,1248930328,1248930628,2,5,300
10274899@N06,136,19,1248935708,1248936248,2,5,540
10274899@N06,136,7,1248939338,1248939458,2,5,120
10274899@N06,136,12,1248945671,1248945941,1,5,270
10295241@N02,137,14,1366414486,1366414792,2,9,306
10295241@N02,137,15,1366414792,1366414937,2,9,145
10295241@N02,137,18,1366414937,1366415477,2,9,540
10295241@N02,137,11,1366419965,1366420205,2,9,240
10295241@N02,137,17,1366444425,1366444593,2,9,168
10295241@N02,137,23,1366444593,1366445392,2,9,799
10295241@N02,137,17,1366445392,1366445812,4,9,420
10295241@N02,137,18,1366448270,1366448810,4,9,540
10295241@N02,137,17,1366451634,1366452054,1,9,420
10295241@N02,138,3,1366512800,1366512890,10,1,90
10295241@N02,139,15,1425111420,1425111780,1,1,360
10295241@N02,140,15,1430991701,1430992061,1,1,360
10295241@N02,141,14,1434172794,1434173154,2,2,360
10295241@N02,141,8,1434177913,1434178033,1,2,120
10295241@N02,142,24,1441419635,1441421135,1,1,1500
10295241@N02,143,15,1441517650,1441518010,3,3,360
10295241@N02,143,19,1441530079,1441530481,2,3,402
10295241@N02,143,14,1441530481,1441530841,1,3,360
10295241@N02,144,12,1441586538,1441586808,2,2,270
10295241@N02,144,8,1441594832,1441594952,1,2,120
102953813@N07,145,12,1272093031,1272093052,4,6,21
102953813@N07,145,24,1272093052,1272094552,3,6,1500
102953813@N07,145,6,1272094846,1272094966,2,6,120
102953813@N07,145,23,1272095896,1272096396,2,6,500
102953813@N07,145,10,1272096396,1272096396,2,6,0
102953813@N07,145,18,1272096396,1272096936,1,6,540
102953813@N07,146,19,1272619828,1272620368,1,1,540
102953813@N07,147,12,1284278133,1284278165,3,2,32
102953813@N07,147,24,1284278165,1284279665,2,2,1500
102953813@N07,148,19,1358315371,1358315911,1,1,540
102953813@N07,149,19,1359441019,1359441559,1,1,540
102953813@N07,150,14,1362266493,1362266853,2,1,360
102953813@N07,151,19,1365762317,1365762857,2,2,540
102953813@N07,151,24,1365763726,1365765226,1,2,1500
102953813@N07,152,17,1365907334,1365907754,3,3,420
102953813@N07,152,19,1365910440,1365910980,2,3,540
102953813@N07,152,18,1365916064,1365916604,1,3,540
102953813@N07,153,14,1367545804,1367546164,5,10,360
102953813@N07,153,6,1367547149,1367547269,4,10,120
102953813@N07,153,19,1367547544,1367548084,2,10,540
102953813@N07,153,17,1367548854,1367549274,2,10,420
102953813@N07,153,16,1367549673,1367549886,2,10,213
102953813@N07,153,5,1367549886,1367549911,2,10,25
102953813@N07,153,10,1367549911,1367550061,2,10,150
102953813@N07,153,3,1367550077,1367550167,3,10,90
102953813@N07,153,10,1367550992,1367551142,2,10,150
102953813@N07,153,16,1367551305,1367551725,2,10,420
102953813@N07,154,4,1371950621,1371950711,2,14,90
102953813@N07,154,8,1371950770,1371950890,2,14,120
102953813@N07,154,14,1371951189,1371951549,3,14,360
102953813@N07,154,23,1371956447,1371956758,2,14,311
102953813@N07,154,16,1371956758,1371957178,2,14,420
102953813@N07,154,10,1371958124,1371958274,2,14,150
102953813@N07,154,19,1371958407,1371958888,3,14,481
102953813@N07,154,14,1371958888,1371959248,3,14,360
102953813@N07,154,11,1371962697,1371962937,2,14,240
102953813@N07,154,16,1371963245,1371963665,2,14,420
102953813@N07,154,7,1371964111,1371964231,3,14,120
102953813@N07,154,16,1371966675,1371967095,4,14,420
102953813@N07,154,12,1371980250,1371980520,2,14,270
102953813@N07,154,14,1371981173,1371981533,3,14,360
102953813@N07,155,12,1372746097,1372746367,2,18,270
102953813@N07,155,24,1372746516,1372747121,3,18,605
102953813@N07,155,12,1372747121,1372747391,2,18,270
102953813@N07,155,23,1372748323,1372748610,2,18,287
102953813@N07,155,16,1372748610,1372748828,2,18,218
102953813@N07,155,10,1372748828,1372748978,5,18,150
102953813@N07,155,18,1372753455,1372753685,3,18,230
102953813@N07,155,7,1372753685,1372753805,4,18,120
102953813@N07,155,11,1372754356,1372754596,2,18,240
102953813@N07,155,16,1372754637,1372754781,3,18,144
102953813@N07,155,19,1372754781,1372755120,4,18,339
102953813@N07,155,14,1372755120,1372755401,5,18,281
102953813@N07,155,8,1372755401,1372755521,2,18,120
102953813@N07,155,14,1372755553,1372755868,2,18,315
102953813@N07,155,2,1372755868,1372755868,2,18,0
102953813@N07,155,25,1372755868,1372756084,2,18,216
102953813@N07,155,13,1372756084,1372756384,3,18,300
102953813@N07,155,24,1372756834,1372758334,6,18,1500
102953813@N07,156,17,1372919678,1372920098,2,6,420
102953813@N07,156,16,1372922248,1372922668,5,6,420
102953813@N07,156,1,1372926530,1372926590,2,6,60
102953813@N07,156,6,1372930280,1372930400,2,6,120
102953813@N07,156,19,1372931350,1372931890,2,6,540
102953813@N07,156,16,1372937330,1372937750,1,6,420
102953813@N07,157,12,1374936915,1374937185,1,1,270
102953813@N07,158,11,1378031892,1378032132,3,3,240
102953813@N07,158,7,1378036463,1378036583,2,3,120
102953813@N07,158,14,1378037841,1378038201,3,3,360
102953813@N07,159,12,1379067449,1379067719,2,1,270
102953813@N07,160,7,1379214756,1379214876,1,1,120
102953813@N07,161,12,1379916360,1379916630,3,5,270
102953813@N07,161,23,1379917929,1379918304,2,5,375
102953813@N07,161,16,1379918304,1379918724,2,5,420
102953813@N07,161,14,1379919006,1379919366,3,5,360
102953813@N07,161,6,1379921645,1379921765,1,5,120
10299767@N08,162,16,1224405355,1224405775,2,1,420
10299767@N08,163,6,1400194233,1400194353,1,1,120
10302113@N02,164,12,1258075597,1258075867,4,1,270
10302113@N02,165,16,1258108541,1258108961,3,1,420
10304915@N00,166,16,1229660224,1229660644,1,1,420
10304915@N00,167,17,1426817064,1426817484,1,1,420
103109013@N07,168,11,1395034558,1395034798,2,2,240
103109013@N07,168,7,1395034893,1395035013,1,2,120
103297030@N03,169,2,1367078662,1367078722,2,18,60
103297030@N03,169,8,1367078833,1367078953,2,18,120
103297030@N03,169,20,1367079020,1367079030,2,18,10
103297030@N03,169,6,1367079030,1367079150,3,18,120
103297030@N03,169,14,1367079516,1367079556,2,18,40
103297030@N03,169,19,1367079556,1367079849,4,18,293
103297030@N03,169,16,1367079849,1367080038,2,18,189
103297030@N03,169,3,1367080038,1367080128,2,18,90
103297030@N03,169,7,1367081985,1367081995,2,18,10
103297030@N03,169,11,1367081995,1367082095,2,18,100
103297030@N03,169,16,1367082095,1367082515,2,18,420
103297030@N03,169,12,1367082857,1367083127,2,18,270
103297030@N03,169,23,1367083887,1367085087,5,18,1200
103297030@N03,169,8,1367085774,1367085894,2,18,120
103297030@N03,169,14,1367086252,1367086612,3,18,360
103297030@N03,169,25,1367091470,1367091731,2,18,261
103297030@N03,169,15,1367091731,1367091940,2,18,209
103297030@N03,169,21,1367091940,1367092840,1,18,900
103297030@N03,170,18,1388283591,1388284131,3,6,540
103297030@N03,170,11,1388284456,1388284696,2,6,240
103297030@N03,170,6,1388285612,1388285693,2,6,81
103297030@N03,170,14,1388285693,1388285989,4,6,296
103297030@N03,170,9,1388285989,1388286109,2,6,120
103297030@N03,170,12,1388287367,1388287637,1,6,270
103400918@N03,171,16,1375580678,1375581098,3,2,420
103400918@N03,171,5,1375602437,1375602557,1,2,120
103479379@N08,172,24,1360961168,1360962668,1,1,1500
10352809@N08,173,16,1329803130,1329803550,6,2,420
10352809@N08,173,6,1329819067,1329819187,6,2,120
103708587@N06,174,7,1388390850,1388390970,1,1,120
10414404@N08,175,24,1374123599,1374125099,1,1,1500
10414404@N08,176,10,1374230866,1374231016,1,1,150
10420619@N06,177,16,1355644640,1355645060,14,1,420
10420619@N06,178,16,1365913177,1365913597,1,1,420
10420619@N06,179,24,1390716367,1390717867,7,1,1500
10420619@N06,180,24,1394342964,1394344464,1,1,1500
10420619@N06,181,24,1396759040,1396760540,12,1,1500
10420619@N06,182,17,1430052934,1430053354,1,1,420
10450800@N03,183,1,1306054457,1306054517,1,1,60
10450800@N03,184,7,1321148666,1321148786,2,2,120
10450800@N03,184,10,1321151408,1321151558,1,2,150
10450800@N03,185,22,1323570576,1323571596,3,2,1020
10450800@N03,185,13,1323590206,1323590506,2,2,300
10450800@N03,186,11,1332651053,1332651293,3,2,240
10450800@N03,186,15,1332655279,1332655639,1,2,360
10450800@N03,187,19,1350180452,1350180992,3,4,540
10450800@N03,187,11,1350190739,1350190912,2,4,173
10450800@N03,187,19,1350190912,1350190914,2,4,2
10450800@N03,187,14,1350190914,1350191274,3,4,360
10450800@N03,188,7,1359878677,1359878797,2,4,120
10450800@N03,188,11,1359878861,1359879101,2,4,240
10450800@N03,188,14,1359882264,1359882624,3,4,360
10450800@N03,188,15,1359885797,1359886157,1,4,360
10450800@N03,189,12,1370142982,1370143252,2,7,270
10450800@N03,189,14,1370158512,1370158834,2,7,322
10450800@N03,189,6,1370158834,1370158954,3,7,120
10450800@N03,189,15,1370165861,1370166221,2,7,360
10450800@N03,189,24,1370166639,1370168139,2,7,1500
10450800@N03,189,16,1370169190,1370169610,7,7,420
10450800@N03,189,19,1370171984,1370172524,1,7,540
10450800@N03,190,14,1371970890,1371971250,2,3,360
10450800@N03,190,7,1371974963,1371975083,5,3,120
10450800@N03,190,23,1371990330,1371991530,2,3,1200
10450800@N03,191,7,1381038406,1381038526,2,1,120
10450800@N03,192,25,1389498943,1389501043,3,2,2100
10450800@N03,192,7,1389502488,1389502608,1,2,120
10450800@N03,193,24,1394949711,1394951211,2,3,1500
10450800@N03,193,22,1394957896,1394958916,2,3,1020
10450800@N03,193,14,1394964377,1394964737,1,3,360
10450800@N03,194,25,1395984701,1395986801,2,4,2100
10450800@N03,194,3,1395990143,1395990233,3,4,90
10450800@N03,194,7,1395993541,1395993578,2,4,37
10450800@N03,194,18,1395993578,1395994118,1,4,540
10450800@N03,195,19,1400399426,1400399966,2,1,540
10450800@N03,196,6,1408855512,1408855632,1,1,120
10450800@N03,197,22,1411964152,1411965172,2,4,1020
10450800@N03,197,18,1411968618,1411969158,2,4,540
10450800@N03,197,15,1411971698,1411972058,2,4,360
10450800@N03,197,6,1411972356,1411972476,1,4,120
10450800@N03,198,24,1447558443,1447558963,3,7,520
10450800@N03,198,8,1447558963,1447559083,2,7,120
10450800@N03,198,19,1447560404,1447560944,2,7,540
10450800@N03,198,10,1447565913,1447566063,2,7,150
10450800@N03,198,19,1447566357,1447566897,4,7,540
10450800@N03,198,15,1447570975,1447571335,2,7,360
10450800@N03,198,13,1447573684,1447573984,3,7,300
10450800@N03,199,13,1458449279,1458449579,2,4,300
10450800@N03,199,9,1458451283,1458451403,2,4,120
10450800@N03,199,15,1458455573,1458455933,2,4,360
10450800@N03,199,19,1458456739,1458457279,1,4,540
104708298@N06,200,1,1458881250,1458881310,2,1,60
104785013@N07,201,5,1452969750,1452969870,1,1,120
104785013@N07,202,13,1453017643,1453017943,14,3,300
104785013@N07,202,19,1453029456,1453029950,2,3,494
104785013@N07,202,14,1453029950,1453030310,1,3,360
104785013@N07,203,20,1453157161,1453157761,2,2,600
104785013@N07,203,18,1453159208,1453159748,1,2,540
10485586@N05,204,17,1435974946,1435975366,2,1,420
10495641@N00,205,17,1368781421,1368781841,1,1,420
10504927@N08,206,3,1372192721,1372192811,2,2,90
10504927@N08,206,7,1372202258,1372202378,1,2,120
10544660@N05,207,18,1299548029,1299548569,1,1,540
10572043@N03,208,23,1299243698,1299244898,1,1,1200
10572043@N03,209,17,1307762312,1307762732,1,1,420
105745254@N04,210,12,1350777503,1350777773,1,1,270
105745254@N04,211,25,1360389952,1360392052,1,1,2100
105745254@N04,212,12,1390023522,1390023792,1,1,270
105745254@N04,213,24,1407569193,1407570693,1,1,1500
105745254@N04,214,14,1457675710,1457676070,1,1,360
105745254@N04,215,12,1459517475,1459517745,2,1,270
10581108@N00,216,4,1296869333,1296869423,2,3,90
10581108@N00,216,10,1296873462,1296873612,2,3,150
10581108@N00,216,23,1296874967,1296876167,1,3,1200
10581770@N02,217,17,1303635442,1303635862,1,1,420
105959704@N07,218,12,1401892718,1401892988,2,1,270
105959704@N07,219,12,1461333255,1461333525,1,1,270
105959704@N07,220,12,1467491967,1467492237,1,1,270
106187463@N02,221,16,1340778922,1340779342,2,2,420
106187463@N02,221,8,1340788231,1340788351,1,2,120
106187463@N02,222,13,1381570175,1381570475,1,1,300
106228936@N07,223,16,1273367934,1273368354,3,3,420
106228936@N07,223,17,1273372397,1273372417,3,3,20
106228936@N07,223,12,1273372417,1273372687,8,3,270
106228936@N07,224,18,1304817803,1304817820,2,2,17
106228936@N07,224,7,1304817820,1304817940,1,2,120
106228936@N07,225,18,1306024424,1306024484,7,2,60
106228936@N07,225,7,1306024484,1306024604,2,2,120
106228936@N07,226,25,1306894791,1306896891,4,1,2100
106228936@N07,227,18,1308973611,1308974151,3,1,540
106228936@N07,228,7,1311815415,1311815535,2,2,120
106228936@N07,228,25,1311824796,1311826896,1,2,2100
106228936@N07,229,25,1314953798,1314955898,10,1,2100
106228936@N07,230,18,1315124695,1315125235,4,1,540
106228936@N07,231,12,1316214612,1316214882,1,1,270
10632018@N00,232,12,1275114361,1275114631,3,1,270
106331106@N07,233,14,1440020538,1440020898,1,1,360
10635134@N00,234,25,1187942857,1187944957,4,1,2100
10635276@N00,235,14,1443947191,1443947551,1,1,360
10651907@N02,236,12,1191484612,1191484882,2,1,270
106602685@N05,237,24,1451123052,1451124552,2,9,1500
106602685@N05,237,23,1451125234,1451125387,9,9,153
106602685@N05,237,16,1451125387,1451125709,6,9,322
106602685@N05,237,11,1451125709,1451125949,3,9,240
106602685@N05,237,25,1451130811,1451131196,2,9,385
106602685@N05,237,8,1451131196,1451131316,2,9,120
106602685@N05,237,6,1451131439,1451131559,3,9,120
106602685@N05,237,14,1451131773,1451132133,2,9,360
106602685@N05,237,24,1451133777,1451135277,3,9,1500
106809490@N03,238,16,1261103689,1261104109,2,4,420
106809490@N03,238,7,1261106728,1261106848,2,4,120
106809490@N03,238,19,1261107859,1261108399,2,4,540
106809490@N03,238,12,1261108593,1261108863,2,4,270
10681948@N00,239,7,1295907579,1295907699,1,1,120
10691751@N02,240,3,1217121857,1217121947,3,8,90
10691751@N02,240,19,1217124515,1217125055,2,8,540
10691751@N02,240,18,1217127741,1217127777,2,8,36
10691751@N02,240,5,1217127777,1217127897,2,8,120
10691751@N02,240,18,1217127924,1217128464,2,8,540
10691751@N02,240,1,1217131488,1217131548,4,8,60
10691751@N02,240,3,1217133384,1217133474,3,8,90
10691751@N02,240,18,1217133949,1217134489,2,8,540
106954173@N04,241,18,1431250711,1431251251,2,1,540
107234368@N03,242,15,1350965620,1350965980,1,1,360
107470608@N03,243,7,1227572244,1227572364,1,1,120
107470608@N03,244,13,1227760754,1227761054,2,1,300
107470608@N03,245,17,1273401412,1273401832,2,2,420
107470608@N03,245,12,1273406479,1273406749,1,2,270
107470608@N03,246,15,1290570524,1290570884,2,10,360
107470608@N03,246,11,1290576373,1290576613,2,10,240
107470608@N03,246,7,1290579417,1290579537,2,10,120
107470608@N03,246,18,1290581548,1290582088,2,10,540
107470608@N03,246,7,1290583744,1290583864,2,10,120
107470608@N03,246,11,1290587209,1290587449,3,10,240
107470608@N03,246,10,1290591490,1290591640,6,10,150
107470608@N03,246,16,1290594701,1290594741,6,10,40
107470608@N03,246,7,1290594741,1290594861,2,10,120
107470608@N03,246,12,1290600755,1290601025,1,10,270
107470608@N03,247,25,1319274341,1319276054,2,4,1713
107470608@N03,247,18,1319276054,1319276594,2,4,540
107470608@N03,247,25,1319277579,1319279292,2,4,1713
107470608@N03,247,15,1319279292,1319279652,1,4,360
107470608@N03,248,18,1319351447,1319351987,2,1,540
107701933@N04,249,17,1377298643,1377299063,3,1,420
107987296@N07,250,12,1400889479,1400889749,2,2,270
107987296@N07,250,16,1400916786,1400917206,1,2,420
108081344@N07,251,16,1458852123,1458852543,1,1,420
108118224@N04,252,16,1408791481,1408791901,3,3,420
108118224@N04,252,12,1408792773,1408793043,4,3,270
108118224@N04,252,22,1408794900,1408795920,1,3,1020
10843604@N02,253,10,1297159751,1297159901,1,1,150
10843892@N00,254,14,1286682174,1286682534,1,1,360
10858077@N00,255,20,1209962334,1209962934,3,5,600
10858077@N00,255,16,1209965316,1209965736,4,5,420
10858077@N00,255,10,1209966514,1209966664,2,5,150
10858077@N00,255,19,1209967947,1209968487,2,5,540
10858077@N00,255,4,1209969212,1209969302,1,5,90
10858077@N00,256,16,1246172179,1246172599,2,2,420
10858077@N00,256,6,1246172958,1246173078,1,2,120
10858077@N00,257,13,1328359412,1328359712,1,1,300
10858077@N00,258,25,1379743026,1379745126,1,1,2100
10858077@N00,259,24,1380359806,1380361306,1,1,1500
10858077@N00,260,3,1424478246,1424478336,2,1,90
108599313@N07,261,6,1393383197,1393383317,2,2,120
108599313@N07,261,7,1393388925,1393389045,1,2,120
108599313@N07,262,7,1394674635,1394674755,1,1,120
108599313@N07,263,13,1394754798,1394755098,4,1,300
10869410@N07,264,16,1368494752,1368495172,2,1,420
109004625@N06,265,23,1390470631,1390471831,1,1,1200
10910455@N04,266,11,1307520199,1307520439,1,1,240
10925918@N03,267,17,1243312789,1243313209,2,5,420
10925918@N03,267,12,1243328402,1243328672,2,5,270
10925918@N03,267,7,1243333456,1243333576,2,5,120
10925918@N03,267,23,1243336599,1243337799,2,5,1200
10925918@N03,267,16,1243353463,1243353883,1,5,420
10925918@N03,268,25,1243393932,1243396032,2,4,2100
10925918@N03,268,17,1243421897,1243422180,2,4,283
10925918@N03,268,13,1243422180,1243422480,2,4,300
10925918@N03,268,24,1243423362,1243424862,1,4,1500
10947824@N07,269,14,1379482210,1379482218,2,2,8
10947824@N07,269,15,1379482218,1379482578,1,2,360
109478840@N03,270,25,1437569636,1437571736,1,1,2100
109570752@N02,271,16,1386205328,1386205748,1,1,420
10967865@N04,272,4,1334473638,1334473728,4,3,90
10967865@N04,272,13,1334479730,1334480030,3,3,300
10967865@N04,272,12,1334487541,1334487811,1,3,270
10967865@N04,273,14,1344146536,1344146896,4,1,360
10967865@N04,274,12,1347585245,1347585515,1,1,270
10967865@N04,275,3,1436148212,1436148302,2,3,90
10967865@N04,275,25,1436159000,1436161100,2,3,2100
10967865@N04,275,3,1436177979,1436178069,1,3,90
10969685@N00,276,5,1296453915,1296454035,2,2,120
10969685@N00,276,10,1296467599,1296467749,1,2,150
10981483@N07,277,11,1294357917,1294358157,1,1,240
10982860@N00,278,15,1320184617,1320184977,1,1,360
10990739@N05,279,12,1258862869,1258863139,2,2,270
10990739@N05,279,18,1258872281,1258872821,2,2,540
11013574@N07,280,16,1349521348,1349521768,1,1,420
11013574@N07,281,7,1349572488,1349572608,1,1,120
11013574@N07,282,11,1364022776,1364023016,1,1,240
110286494@N07,283,8,1396806988,1396807108,3,3,120
110286494@N07,283,7,1396807757,1396807877,2,3,120
110286494@N07,283,16,1396809339,1396809759,5,3,420
11033661@N08,284,12,1349600772,1349601017,2,3,245
11033661@N08,284,19,1349601017,1349601302,2,3,285
11033661@N08,284,14,1349601302,1349601662,2,3,360
11033661@N08,285,12,1362884234,1362884504,1,1,270
11033661@N08,286,19,1401435547,1401436087,1,1,540
11033661@N08,287,18,1411859418,1411859958,1,1,540
11033661@N08,288,18,1412065384,1412065924,1,1,540
11033661@N08,289,17,1454830776,1454831196,1,1,420
11055104@N07,290,19,1244271477,1244272017,2,2,540
11055104@N07,290,12,1244276776,1244277046,1,2,270
110565084@N04,291,7,1386074992,1386075112,1,1,120
110565084@N04,292,18,1391483499,1391484039,4,2,540
110565084@N04,292,11,1391498223,1391498463,1,2,240
11071376@N07,293,24,1245722525,1245724025,9,4,1500
11071376@N07,293,19,1245730447,1245730987,3,4,540
11071376@N07,293,1,1245732463,1245732523,3,4,60
11071376@N07,293,12,1245752592,1245752862,10,4,270
110888119@N08,294,16,1387539606,1387540026,1,1,420
110888119@N08,295,14,1390726753,1390727113,1,1,360
111373490@N03,296,16,1400677969,1400678389,1,1,420
111552892@N02,297,17,1402592935,1402593355,1,1,420
111750816@N06,298,17,1447751144,1447751564,1,1,420
111750816@N06,299,6,1451447725,1451447845,1,1,120
111750816@N06,300,6,1460705427,1460705547,1,1,120
111750816@N06,301,19,1464068662,1464069202,1,1,540
111750816@N06,302,6,1465283642,1465283762,1,1,120
111750816@N06,303,25,1471588678,1471590778,1,1,2100
11203254@N03,304,23,1271223015,1271224215,1,1,1200
112036688@N06,305,14,1388424468,1388424828,1,1,360
112167218@N08,306,24,1419906315,1419907815,6,15,1500
112167218@N08,306,18,1419914671,1419914775,2,15,104
112167218@N08,306,14,1419914775,1419915135,6,15,360
112167218@N08,306,6,1419917091,1419917197,4,15,106
112167218@N08,306,19,1419917197,1419917737,2,15,540
112167218@N08,306,16,1419918632,1419919052,6,15,420
112167218@N08,306,18,1419921138,1419921678,6,15,540
112167218@N08,306,22,1419924635,1419924768,3,15,133
112167218@N08,306,25,1419924768,1419926868,2,15,2100
112167218@N08,306,24,1419927549,1419929049,3,15,1500
112167218@N08,306,12,1419934740,1419934900,2,15,160
112167218@N08,306,6,1419934900,1419935014,5,15,114
112167218@N08,306,19,1419935014,1419935088,3,15,74
112167218@N08,306,6,1419935088,1419935208,2,15,120
112167218@N08,306,16,1419936113,1419936533,3,15,420
11258841@N04,307,10,1210001747,1210001897,1,1,150
11260538@N06,308,6,1360489229,1360489349,1,1,120
11260538@N06,309,12,1361488768,1361489038,2,8,270
11260538@N06,309,13,1361494145,1361494445,2,8,300
11260538@N06,309,12,1361496921,1361497191,3,8,270
11260538@N06,309,24,1361502004,1361503504,2,8,1500
11260538@N06,309,6,1361505169,1361505289,3,8,120
11260538@N06,309,8,1361509241,1361509361,2,8,120
11260538@N06,309,15,1361517036,1361517396,2,8,360
11260538@N06,309,13,1361528587,1361528887,1,8,300
112659844@N02,310,6,1407816006,1407816126,2,3,120
112659844@N02,310,14,1407817130,1407817490,2,3,360
112659844@N02,310,15,1407819586,1407819946,1,3,360
112659844@N02,311,14,1407886484,1407886844,2,4,360
112659844@N02,311,16,1407887404,1407887824,2,4,420
112659844@N02,311,10,1407891021,1407891171,2,4,150
112659844@N02,311,6,1407894708,1407894828,1,4,120
112659844@N02,312,24,1408087216,1408088716,1,1,1500
11277578@N00,313,20,1224913053,1224913653,1,1,600
11277772@N00,314,25,1275314400,1275316500,12,1,2100
112828108@N08,315,16,1409309870,1409310290,2,3,420
112828108@N08,315,7,1409311912,1409312032,2,3,120
112828108@N08,315,19,1409314589,1409315129,1,3,540
112828108@N08,316,25,1452045299,1452047399,1,1,2100
112920986@N06,317,11,1384757524,1384757764,1,1,240
11312146@N04,318,7,1208619260,1208619380,1,1,120
113252547@N06,319,16,1393581492,1393581912,1,1,420
11331418@N00,320,12,1352999836,1352999836,2,7,0
11331418@N00,320,24,1352999836,1353001336,2,7,1500
11331418@N00,320,6,1353003754,1353003874,3,7,120
11331418@N00,320,14,1353004812,1353005172,3,7,360
11331418@N00,320,1,1353006151,1353006211,5,7,60
11331418@N00,320,20,1353008552,1353009152,3,7,600
11331418@N00,320,14,1353009906,1353010266,4,7,360
11331418@N00,321,14,1360393890,1360394250,3,3,360
11331418@N00,321,12,1360405643,1360405913,3,3,270
11331418@N00,321,15,1360425312,1360425672,2,3,360
11331418@N00,322,17,1362423168,1362423588,1,1,420
11331418@N00,323,7,1362500341,1362500461,1,1,120
11331418@N00,324,18,1367571475,1367572015,1,1,540
11355999@N08,325,19,1206601830,1206602370,69,1,540
11374644@N06,326,24,1226125146,1226126646,3,1,1500
11374644@N06,327,24,1226189288,1226189348,3,7,60
11374644@N06,327,17,1226189348,1226189768,6,7,420
11374644@N06,327,7,1226192373,1226192493,3,7,120
11374644@N06,327,17,1226192984,1226193125,2,7,141
11374644@N06,327,7,1226193125,1226193146,2,7,21
11374644@N06,327,17,1226193146,1226193566,2,7,420
11374644@N06,327,24,1226193742,1226195242,8,7,1500
11374644@N06,328,17,1226227712,1226228132,1,1,420
11374644@N06,329,24,1226982278,1226983778,2,1,1500
11374644@N06,330,24,1228258938,1228260438,1,1,1500
11374644@N06,331,12,1383645591,1383645861,9,3,270
11374644@N06,331,17,1383646040,1383646460,2,3,420
11374644@N06,331,12,1383649051,1383649321,1,3,270
11374644@N06,332,23,1383688522,1383689026,5,9,504
11374644@N06,332,17,1383689026,1383689440,3,9,414
11374644@N06,332,23,1383689440,1383690640,23,9,1200
11374644@N06,332,17,1383691435,1383691710,2,9,275
11374644@N06,332,23,1383691710,1383691727,4,9,17
11374644@N06,332,17,1383691727,1383691733,2,9,6
11374644@N06,332,23,1383691733,1383691753,4,9,20
11374644@N06,332,17,1383691753,1383691756,2,9,3
11374644@N06,332,23,1383691756,1383692956,9,9,1200
11374644@N06,333,12,1383791097,1383791367,1,1,270
11374644@N06,334,8,1383862025,1383862056,2,23,31
11374644@N06,334,14,1383862056,1383862416,6,23,360
11374644@N06,334,8,1383862472,1383862592,4,23,120
11374644@N06,334,14,1383863074,1383863434,6,23,360
11374644@N06,334,18,1383864348,1383864552,2,23,204
11374644@N06,334,19,1383864552,1383864637,2,23,85
11374644@N06,334,14,1383864637,1383864997,6,23,360
11374644@N06,334,11,1383866604,1383866844,2,23,240
11374644@N06,334,14,1383867076,1383867436,4,23,360
11374644@N06,334,6,1383867685,1383867805,9,23,120
11374644@N06,334,19,1383868655,1383868776,2,23,121
11374644@N06,334,16,1383868776,1383869070,3,23,294
11374644@N06,334,23,1383869070,1383869167,2,23,97
11374644@N06,334,16,1383869167,1383869269,3,23,102
11374644@N06,334,23,1383869269,1383869500,2,23,231
11374644@N06,334,16,1383869500,1383869852,2,23,352
11374644@N06,334,7,1383869852,1383869972,2,23,120
11374644@N06,334,11,1383869981,1383870221,3,23,240
11374644@N06,334,5,1383870594,1383870714,4,23,120
11374644@N06,334,10,1383871197,1383871347,6,23,150
11374644@N06,334,17,1383871739,1383872140,2,23,401
11374644@N06,334,20,1383872140,1383872208,2,23,68
11374644@N06,334,24,1383872208,1383873708,4,23,1500
11401724@N05,335,17,1434103493,1434103913,1,1,420
11405513@N06,336,8,1419285583,1419285703,2,7,120
11405513@N06,336,6,1419286194,1419286314,10,7,120
11405513@N06,336,7,1419289850,1419289970,3,7,120
11405513@N06,336,18,1419291062,1419291602,5,7,540
11405513@N06,336,5,1419293899,1419294019,3,7,120
11405513@N06,336,12,1419314708,1419314862,2,7,154
11405513@N06,336,20,1419314862,1419315462,15,7,600
11425379@N02,337,16,1333273308,1333273728,1,1,420
11429691@N03,338,23,1299925606,1299926806,1,1,1200
114343416@N06,339,7,1364025981,1364026101,1,1,120
11434691@N07,340,12,1366736201,1366736471,4,7,270
11434691@N07,340,11,1366739048,1366739288,2,7,240
11434691@N07,340,3,1366739595,1366739685,11,7,90
11434691@N07,340,10,1366740426,1366740576,23,7,150
11434691@N07,340,19,1366743359,1366743498,5,7,139
11434691@N07,340,6,1366743498,1366743618,10,7,120
11434691@N07,340,20,1366743797,1366744397,2,7,600
11438926@N00,341,12,1191648582,1191648852,1,1,270
11438926@N00,342,12,1321661774,1321662044,1,1,270
11438926@N00,343,12,1323760755,1323760987,2,2,232
11438926@N00,343,23,1323760987,1323762187,1,2,1200
11438926@N00,344,23,1370435107,1370436307,1,1,1200
11441631@N00,345,12,1349569117,1349569387,2,3,270
11441631@N00,345,14,1349570872,1349571232,3,3,360
11441631@N00,345,24,1349583140,1349584640,1,3,1500
11441631@N00,346,14,1351317653,1351318013,1,1,360
11441631@N00,347,12,1352525225,1352525495,2,2,270
11441631@N00,347,24,1352534600,1352536100,1,2,1500
11441631@N00,348,24,1389519486,1389520986,1,1,1500
11441631@N00,349,12,1430006687,1430006957,1,1,270
114730568@N08,350,7,1384840350,1384840470,1,1,120
114730568@N08,351,7,1385877254,1385877374,1,1,120
114730568@N08,352,24,1390477240,1390478740,1,1,1500
114730568@N08,353,19,1391391855,1391392395,2,1,540
11504096@N08,354,12,1310965376,1310965646,5,10,270
11504096@N08,354,25,1310965669,1310967769,4,10,2100
11504096@N08,354,13,1310971011,1310971311,6,10,300
11504096@N08,354,12,1310980024,1310980294,3,10,270
11504096@N08,354,23,1310980491,1310981048,3,10,557
11504096@N08,354,6,1310981048,1310981168,3,10,120
11504096@N08,354,23,1310982604,1310983450,4,10,846
11504096@N08,354,25,1310983450,1310985550,2,10,2100
11504096@N08,354,5,1310992056,1310992176,6,10,120
11504096@N08,354,1,1310995436,1310995496,25,10,60
11507238@N05,355,17,1224562594,1224563014,1,1,420
115078164@N07,356,6,1378600350,1378600470,1,1,120
115142813@N02,357,8,1405822602,1405822722,1,1,120
115142813@N02,358,18,1413689174,1413689714,1,1,540
11541209@N06,359,7,1221213238,1221213358,2,3,120
11541209@N06,359,25,1221214293,1221214996,4,3,703
11541209@N06,359,13,1221214996,1221215296,2,3,300
11541209@N06,360,6,1224211016,1224211136,1,1,120
11541209@N06,361,16,1242381477,1242381897,2,3,420
11541209@N06,361,10,1242383997,1242384147,3,3,150
11541209@N06,361,16,1242384984,1242385404,1,3,420
11541209@N06,362,14,1252722060,1252722420,3,1,360
11541209@N06,363,14,1252807167,1252807527,1,1,360
11541209@N06,364,16,1261384819,1261385239,2,1,420
11541209@N06,365,16,1263879195,1263879615,3,1,420
11541209@N06,366,5,1265091553,1265091641,2,5,88
11541209@N06,366,16,1265091641,1265092051,4,5,410
11541209@N06,366,18,1265092051,1265092074,2,5,23
11541209@N06,366,7,1265092074,1265092194,3,5,120
11541209@N06,366,16,1265092252,1265092672,3,5,420
11541209@N06,367,16,1267175142,1267175562,3,1,420
11541209@N06,368,16,1271408230,1271408650,6,1,420
11541209@N06,369,16,1276255855,1276256275,1,1,420
11541209@N06,370,6,1276307272,1276307392,11,1,120
11541209@N06,371,18,1276346712,1276347252,2,1,540
11541209@N06,372,18,1277382099,1277382639,3,5,540
11541209@N06,372,16,1277382651,1277382699,2,5,48
11541209@N06,372,18,1277382699,1277383201,4,5,502
11541209@N06,372,16,1277383201,1277383440,3,5,239
11541209@N06,372,18,1277383440,1277383980,14,5,540
11541209@N06,373,16,1277905500,1277905920,2,1,420
11541209@N06,374,16,1278764217,1278764637,10,1,420
11541209@N06,375,7,1279891145,1279891265,4,1,120
11541209@N06,376,16,1284637369,1284637789,1,1,420
11541209@N06,377,18,1285412614,1285413154,9,1,540
11541209@N06,378,16,1297833141,1297833413,3,4,272
11541209@N06,378,14,1297833413,1297833773,2,4,360
11541209@N06,378,16,1297834518,1297834691,3,4,173
11541209@N06,378,14,1297834691,1297835051,1,4,360
11541209@N06,379,14,1301098309,1301098669,1,1,360
11541209@N06,380,19,1304907216,1304907756,3,2,540
11541209@N06,380,16,1304935046,1304935466,2,2,420
11541209@N06,381,16,1306831067,1306831487,1,1,420
11541209@N06,382,16,1309517813,1309518233,15,1,420
11541209@N06,383,12,1312959339,1312959609,2,2,270
11541209@N06,383,14,1312961142,1312961502,1,2,360
11541209@N06,384,19,1329287826,1329288366,1,1,540
11541209@N06,385,19,1340154257,1340154797,2,5,540
11541209@N06,385,14,1340156490,1340156850,5,5,360
11541209@N06,385,19,1340162027,1340162077,2,5,50
11541209@N06,385,14,1340162077,1340162437,2,5,360
11541209@N06,385,19,1340163377,1340163917,1,5,540
11541209@N06,386,14,1340369460,1340369820,3,2,360
11541209@N06,386,19,1340370535,1340371075,4,2,540
11541209@N06,387,19,1353675589,1353676129,2,5,540
11541209@N06,387,25,1353676358,1353677046,2,5,688
11541209@N06,387,14,1353677046,1353677406,4,5,360
11541209@N06,387,19,1353677867,1353678318,2,5,451
11541209@N06,387,24,1353678318,1353679818,1,5,1500
11541209@N06,388,16,1374238899,1374239319,1,1,420
11541209@N06,389,19,1381910658,1381911198,1,1,540
11543886@N00,390,6,1450840049,1450840169,2,4,120
11543886@N00,390,19,1450840456,1450840996,2,4,540
11543886@N00,390,6,1450855588,1450855648,2,4,60
11543886@N00,390,19,1450855648,1450856188,1,4,540
11566207@N08,391,23,1443234479,1443235679,1,1,1200
11566207@N08,392,15,1449299950,1449300310,1,1,360
11566207@N08,393,18,1451105181,1451105721,1,1,540
11566207@N08,394,13,1461983197,1461983497,1,1,300
11594367@N03,395,11,1292418037,1292418277,1,1,240
116142246@N08,396,14,1388866423,1388866783,1,1,360
11631833@N00,397,7,1384054489,1384054609,1,1,120
11640161@N03,398,18,1364872082,1364872622,2,2,540
11640161@N03,398,16,1364897111,1364897531,8,2,420
11654707@N07,399,25,1369575235,1369577335,1,1,2100
11674433@N00,400,7,1294422878,1294422998,18,1,120
116915458@N03,401,18,1398619411,1398619951,1,1,540
116915458@N03,402,24,1400477319,1400478819,1,1,1500
116915458@N03,403,19,1400989214,1400989754,1,1,540
117588347@N06,404,20,1393742419,1393743019,2,1,600
117931874@N07,405,24,1357781753,1357783253,2,6,1500
117931874@N07,405,13,1357785326,1357785626,2,6,300
117931874@N07,405,24,1357787248,1357787521,2,6,273
117931874@N07,405,16,1357787521,1357787941,3,6,420
117931874@N07,405,12,1357798956,1357799226,5,6,270
117931874@N07,405,25,1357799389,1357801489,19,6,2100
118043454@N05,406,24,1393400993,1393402493,1,1,1500
118043454@N05,407,14,1406464792,1406465022,3,4,230
118043454@N05,407,24,1406465022,1406465188,2,4,166
118043454@N05,407,19,1406465188,1406465651,2,4,463
118043454@N05,407,24,1406465651,1406467151,1,4,1500
118043454@N05,408,24,1409657879,1409659379,1,1,1500
11825945@N00,409,19,1391919030,1391919570,2,3,540
11825945@N00,409,18,1391939028,1391939568,2,3,540
11825945@N00,409,14,1391951518,1391951878,1,3,360
11825945@N00,410,15,1392015151,1392015511,2,1,360
11825945@N00,411,7,1392170524,1392170644,3,2,120
11825945@N00,411,15,1392179399,1392179759,1,2,360
11840939@N06,412,25,1358645826,1358647926,2,2,2100
11840939@N06,412,1,1358662186,1358662246,1,2,60
11844862@N00,413,6,1359507442,1359507562,2,2,120
11844862@N00,413,12,1359515694,1359515964,1,2,270
11844862@N00,414,7,1359614431,1359614551,3,1,120
11849171@N00,415,18,1216020835,1216021375,1,1,540
11849171@N00,416,18,1216643535,1216643569,2,2,34
11849171@N00,416,25,1216643569,1216645669,1,2,2100
11855439@N00,417,18,1227342538,1227343078,2,1,540
11855439@N00,418,12,1239946345,1239946503,4,5,158
11855439@N00,418,24,1239946503,1239947824,2,5,1321
11855439@N00,418,18,1239947824,1239948364,4,5,540
11855439@N00,418,4,1239951984,1239952074,2,5,90
11855439@N00,418,18,1239953900,1239954440,1,5,540
11855439@N00,419,18,1306302837,1306303377,3,2,540
11855439@N00,419,16,1306318936,1306319356,2,2,420
11901577@N03,420,12,1360364446,1360364716,2,2,270
11901577@N03,420,5,1360366460,1360366580,1,2,120
11901577@N03,421,14,1366107402,1366107762,2,2,360
11901577@N03,421,15,1366111224,1366111584,1,2,360
11901577@N03,422,11,1370768923,1370769163,1,1,240
11901577@N03,423,24,1370816744,1370818244,1,1,1500
11901577@N03,424,25,1413536575,1413538675,2,2,2100
11901577@N03,424,13,1413545008,1413545308,1,2,300
11901577@N03,425,14,1417732494,1417732854,2,2,360
11901577@N03,425,18,1417759686,1417760226,1,2,540
11901577@N03,426,17,1422866029,1422866449,1,1,420
11901577@N03,427,7,1426148814,1426148934,1,1,120
11901577@N03,428,22,1427710320,1427711340,2,2,1020
11901577@N03,428,24,1427715325,1427716825,1,2,1500
11901577@N03,429,17,1430734822,1430735242,1,1,420
11901577@N03,430,13,1434974096,1434974396,1,1,300
11901577@N03,431,6,1435130151,1435130271,1,1,120
11901577@N03,432,17,1439857153,1439857573,1,1,420
11909488@N00,433,16,1349404848,1349405268,4,1,420
11909488@N00,434,16,1349473832,1349474252,3,1,420
11909488@N00,435,16,1349664168,1349664588,2,1,420
11949829@N04,436,19,1190446915,1190447455,2,4,540
11949829@N04,436,16,1190447726,1190448146,2,4,420
11949829@N04,436,11,1190449017,1190449257,2,4,240
11949829@N04,436,18,1190451132,1190451672,1,4,540
11949829@N04,437,18,1194138162,1194138702,1,1,540
11949829@N04,438,1,1197074890,1197074950,4,4,60
11949829@N04,438,22,1197076117,1197077137,6,4,1020
11949829@N04,438,25,1197077146,1197079246,2,4,2100
11949829@N04,438,22,1197080236,1197081256,2,4,1020
11949829@N04,439,19,1201909623,1201910163,3,3,540
11949829@N04,439,7,1201911523,1201911643,2,3,120
11949829@N04,439,22,1201917251,1201918271,1,3,1020
11949829@N04,440,7,1214097459,1214097579,2,2,120
11949829@N04,440,19,1214097765,1214098305,1,2,540
11949829@N04,441,7,1215173529,1215173649,1,1,120
11949829@N04,442,7,1216256591,1216256711,4,2,120
11949829@N04,442,16,1216261117,1216261537,3,2,420
11949829@N04,443,7,1216307860,1216307980,1,1,120
11949829@N04,444,7,1218878051,1218878171,2,1,120
11949829@N04,445,7,1219129670,1219129790,2,1,120
11949829@N04,446,7,1220404334,1220404454,2,1,120
11949829@N04,447,7,1221212301,1221212421,2,2,120
11949829@N04,447,3,1221212895,1221212985,1,2,90
11949829@N04,448,12,1224917195,1224917465,2,4,270
11949829@N04,448,6,1224917637,1224917757,2,4,120
11949829@N04,448,10,1224919905,1224920055,2,4,150
11949829@N04,448,18,1224922727,1224923267,2,4,540
11949829@N04,449,7,1227257338,1227257458,2,3,120
11949829@N04,449,18,1227257615,1227258155,2,3,540
11949829@N04,449,7,1227259168,1227259288,2,3,120
11949829@N04,450,7,1227946375,1227946495,1,1,120
11949829@N04,451,7,1229761305,1229761425,2,1,120
11949829@N04,452,7,1233368647,1233368767,2,1,120
11949829@N04,453,7,1237015598,1237015718,2,4,120
11949829@N04,453,3,1237017015,1237017105,3,4,90
11949829@N04,453,10,1237017861,1237018011,2,4,150
11949829@N04,453,19,1237018097,1237018637,1,4,540
11949829@N04,454,7,1249297979,1249298099,1,1,120
11949829@N04,455,25,1262246341,1262246784,2,3,443
11949829@N04,455,19,1262246784,1262247154,3,3,370
11949829@N04,455,7,1262247154,1262247274,2,3,120
119809222@N04,456,11,1396952090,1396952330,2,2,240
119809222@N04,456,18,1396952370,1396952910,1,2,540
11985480@N04,457,18,1323857124,1323857664,1,1,540
11985480@N04,458,12,1340930534,1340930804,2,1,270
11996697@N00,459,23,1275087048,1275088248,2,1,1200
120024993@N07,460,16,1388493990,1388494410,2,3,420
120024993@N07,460,1,1388494854,1388494866,3,3,12
120024993@N07,460,10,1388494866,1388495016,1,3,150
120040317@N03,461,25,1403311134,1403313234,4,2,2100
120040317@N03,461,14,1403317396,1403317756,7,2,360
12048536@N00,462,17,1442563085,1442563505,1,1,420
12048536@N00,463,17,1446516407,1446516827,1,1,420
120533378@N03,464,24,1413245016,1413246516,52,1,1500
120533378@N03,465,24,1413358085,1413359585,23,1,1500
120533378@N03,466,24,1414850428,1414851928,1,1,1500
120978164@N04,467,16,1395669701,1395670121,1,1,420
12119240@N07,468,13,1398945418,1398945718,1,1,300
121634217@N06,469,16,1419814012,1419814432,2,8,420
121634217@N06,469,11,1419814808,1419815048,7,8,240
121634217@N06,469,18,1419818885,1419819425,2,8,540
121634217@N06,469,24,1419825322,1419826822,4,8,1500
121634217@N06,469,8,1419837014,1419837134,2,8,120
121634217@N06,469,19,1419837530,1419837706,2,8,176
121634217@N06,469,14,1419837706,1419838066,2,8,360
121634217@N06,469,24,1419839021,1419840521,1,8,1500
12172123@N00,470,12,1332406294,1332406564,1,1,270
12175608@N00,471,14,1401269066,1401269426,1,1,360
12227796@N08,472,17,1278303060,1278303480,1,1,420
122315583@N05,473,17,1440493909,1440494329,1,1,420
122360115@N05,474,24,1396660022,1396661522,2,1,1500
122360115@N05,475,24,1396692819,1396694319,1,1,1500
122360115@N05,476,24,1396750739,1396752239,1,1,1500
122360115@N05,477,14,1396945065,1396945425,1,1,360
122360115@N05,478,19,1398125460,1398126000,1,1,540
122360115@N05,479,18,1398236599,1398237139,3,1,540
122360115@N05,480,18,1398577226,1398577766,1,1,540
122360115@N05,481,25,1399190905,1399193005,1,1,2100
122360115@N05,482,25,1399340130,1399342230,2,2,2100
122360115@N05,482,18,1399362761,1399363301,2,2,540
122360115@N05,483,18,1399428366,1399428906,2,1,540
122360115@N05,484,6,1400224953,1400225073,1,1,120
122360115@N05,485,6,1400375921,1400376041,1,1,120
122360115@N05,486,24,1400668944,1400670444,1,1,1500
122360115@N05,487,24,1400835510,1400837010,1,1,1500
122360115@N05,488,16,1400929373,1400929793,3,3,420
122360115@N05,488,19,1400931922,1400932462,2,3,540
122360115@N05,488,16,1400932691,1400933111,1,3,420
122360115@N05,489,19,1401017019,1401017559,1,1,540
122360115@N05,490,19,1401268542,1401269082,1,1,540
122360115@N05,491,24,1401524250,1401525750,1,1,1500
122360115@N05,492,24,1401592461,1401593961,1,1,1500
122360115@N05,493,12,1402015804,1402016074,1,1,270
122360115@N05,494,16,1402292167,1402292587,1,1,420
122360115@N05,495,18,1403227690,1403228230,1,1,540
122360115@N05,496,23,1405143672,1405144872,1,1,1200
122360115@N05,497,19,1405246988,1405247528,1,1,540
122360115@N05,498,18,1405578682,1405579222,1,1,540
122360115@N05,499,14,1407477935,1407478295,2,2,360
122360115@N05,499,7,1407491195,1407491315,1,2,120
122360115@N05,500,23,1408069633,1408070833,1,1,1200
122360115@N05,501,18,1409435817,1409436357,1,1,540
122360115@N05,502,18,1409650840,1409651380,1,1,540
122360115@N05,503,18,1409709947,1409710487,6,1,540
122360115@N05,504,18,1409821935,1409822475,1,1,540
122360115@N05,505,18,1410166763,1410167303,1,1,540
122360115@N05,506,17,1410226219,1410226639,2,2,420
122360115@N05,506,18,1410252690,1410253230,1,2,540
122360115@N05,507,18,1410338369,1410338909,1,1,540
122360115@N05,508,18,1410391410,1410391950,1,1,540
122360115@N05,509,18,1410748971,1410749511,2,1,540
122360115@N05,510,18,1410804370,1410804910,1,1,540
122360115@N05,511,18,1410861070,1410861610,1,1,540
122360115@N05,512,18,1410931243,1410931783,1,1,540
122360115@N05,513,18,1411183275,1411183815,1,1,540
122360115@N05,514,14,1411378901,1411379261,1,1,360
122360115@N05,515,18,1411540030,1411540570,1,1,540
122360115@N05,516,18,1411738455,1411738995,1,1,540
122360115@N05,517,11,1411835225,1411835465,1,1,240
122360115@N05,518,14,1412596766,1412597126,1,1,360
122381618@N08,519,16,1393397487,1393397907,12,1,420
12241674@N03,520,14,1417725098,1417725458,2,2,360
12241674@N03,520,1,1417729303,1417729363,1,2,60
12241674@N03,521,7,1417902583,1417902703,3,5,120
12241674@N03,521,14,1417905145,1417905505,6,5,360
12241674@N03,521,13,1417932648,1417932948,3,5,300
12241674@N03,521,10,1417941009,1417941159,4,5,150
12241674@N03,521,1,1417942030,1417942090,1,5,60
12273652@N04,522,7,1384129952,1384130072,1,1,120
123072326@N08,523,24,1382334210,1382335710,1,1,1500
123895834@N08,524,19,1435309165,1435309705,2,2,540
123895834@N08,524,6,1435309765,1435309885,1,2,120
123908048@N03,525,12,1435572251,1435572521,2,1,270
12406261@N00,526,18,1376651687,1376652227,1,1,540
124121858@N04,527,17,1368578540,1368578960,1,1,420
12423353@N02,528,10,1306908984,1306909134,1,1,150
12423353@N02,529,24,1306978195,1306978268,2,2,73
12423353@N02,529,20,1306978268,1306978868,2,2,600
12431447@N04,530,17,1446938518,1446938938,1,1,420
12438054@N08,531,14,1353126576,1353126936,1,1,360
12438054@N08,532,24,1386424904,1386426404,1,1,1500
12445726@N06,533,14,1351042386,1351042746,1,1,360
124481497@N05,534,6,1412481589,1412481709,1,1,120
124495835@N08,535,10,1396515256,1396515406,1,1,150
124495835@N08,536,15,1399607329,1399607689,1,1,360
124495835@N08,537,16,1420522126,1420522546,1,1,420
124495835@N08,538,20,1427273307,1427273907,3,2,600
124495835@N08,538,25,1427274394,1427276494,1,2,2100
124495835@N08,539,22,1440907259,1440908279,1,1,1020
124495835@N08,540,24,1456223176,1456224676,1,1,1500
124495835@N08,541,16,1456897630,1456898050,1,1,420
124495835@N08,542,19,1467895576,1467896116,1,1,540
124848726@N03,543,24,1434927398,1434928898,1,1,1500
124848726@N03,544,24,1463644149,1463645649,1,1,1500
124848726@N03,545,24,1464311333,1464312833,3,1,1500
124848726@N03,546,24,1464393036,1464394536,1,1,1500
12508217@N08,547,20,1346492907,1346493507,4,4,600
12508217@N08,547,6,1346493537,1346493657,14,4,120
12508217@N08,547,24,1346495607,1346495736,3,4,129
12508217@N08,547,12,1346495736,1346496006,9,4,270
12508217@N08,548,23,1346530392,1346531592,8,1,1200
12508217@N08,549,24,1369426368,1369427802,4,5,1434
12508217@N08,549,6,1369427802,1369427922,2,5,120
12508217@N08,549,12,1369428730,1369429000,2,5,270
12508217@N08,549,13,1369447880,1369448180,3,5,300
12508217@N08,549,6,1369448989,1369449109,2,5,120
125508504@N03,550,12,1292632678,1292632948,1,1,270
12560240@N07,551,11,1340010246,1340010486,1,1,240
12560240@N07,552,1,1340593399,1340593459,1,1,60
12572833@N04,553,19,1339928607,1339929147,1,1,540
12584309@N00,554,12,1237031759,1237032029,1,1,270
12611986@N08,555,17,1311172007,1311172427,1,1,420
12619133@N07,556,15,1228780890,1228781250,2,6,360
12619133@N07,556,24,1228805719,1228807219,2,6,1500
12619133@N07,556,10,1228807245,1228807395,27,6,150
12619133@N07,556,18,1228811852,1228812392,3,6,540
12619133@N07,556,7,1228814765,1228814885,2,6,120
12619133@N07,556,2,1228815332,1228815392,3,6,60
12619133@N07,557,16,1228868052,1228868472,4,8,420
12619133@N07,557,7,1228868473,1228868593,10,8,120
12619133@N07,557,5,1228871552,1228871672,21,8,120
12619133@N07,557,1,1228872036,1228872096,8,8,60
12619133@N07,557,5,1228873295,1228873313,4,8,18
12619133@N07,557,1,1228873313,1228873373,4,8,60
12619133@N07,557,13,1228877813,1228878113,5,8,300
12619133@N07,557,25,1228878843,1228880943,4,8,2100
12640453@N06,558,19,1319778915,1319779455,2,2,540
12640453@N06,558,18,1319780553,1319781093,1,2,540
126748312@N04,559,19,1458006261,1458006801,1,1,540
126797303@N08,560,9,1385591029,1385591149,2,7,120
126797303@N08,560,24,1385596670,1385598170,2,7,1500
126797303@N08,560,23,1385600294,1385601494,3,7,1200
126797303@N08,560,19,1385616965,1385617505,2,7,540
126797303@N08,560,16,1385621501,1385621921,2,7,420
126797303@N08,560,11,1385634264,1385634504,2,7,240
126797303@N08,560,7,1385635348,1385635468,2,7,120
12685141@N08,561,12,1359802002,1359802272,2,1,270
12685141@N08,562,6,1359875534,1359875654,2,5,120
12685141@N08,562,19,1359875748,1359876288,3,5,540
12685141@N08,562,12,1359882600,1359882756,2,5,156
12685141@N08,562,13,1359882756,1359883056,2,5,300
12685141@N08,562,16,1359895706,1359896126,1,5,420
12685141@N08,563,19,1366455444,1366455984,2,2,540
12685141@N08,563,16,1366460647,1366461067,1,2,420
12685141@N08,564,24,1371457955,1371459455,1,1,1500
12685141@N08,565,16,1371547341,1371547761,1,1,420
12685141@N08,566,16,1386489408,1386489828,1,1,420
12689533@N05,567,12,1319782548,1319782818,2,1,270
12696073@N07,568,14,1371096026,1371096386,1,1,360
12706502@N00,569,17,1421146829,1421147249,1,1,420
12706502@N00,570,17,1439455714,1439456134,1,1,420
12706502@N00,571,1,1457323152,1457323212,1,1,60
12706502@N00,572,17,1457428175,1457428595,1,1,420
127105840@N06,573,24,1440057426,1440058926,1,1,1500
127217744@N06,574,19,1325302044,1325302584,1,1,540
12734746@N00,575,24,1270177711,1270179211,223,1,1500
12734746@N00,576,24,1270376774,1270378274,4,5,1500
12734746@N00,576,15,1270379129,1270379489,11,5,360
12734746@N00,576,24,1270384777,1270385890,7,5,1113
12734746@N00,576,15,1270385890,1270385990,3,5,100
12734746@N00,576,24,1270385990,1270387490,1,5,1500
12734746@N00,577,24,1274956624,1274958124,27,1,1500
12734746@N00,578,19,1276155533,1276156073,49,1,540
12734746@N00,579,24,1277350056,1277351556,1,1,1500
12734746@N00,580,24,1282817882,1282819382,33,1,1500
12742129@N00,581,7,1371872381,1371872501,2,2,120
12742129@N00,581,24,1371897506,1371899006,2,2,1500
12742129@N00,582,15,1374893317,1374893677,1,1,360
12742564@N00,583,25,1446017115,1446019215,1,1,2100
127460346@N03,584,17,1439794530,1439794950,3,2,420
127460346@N03,584,3,1439799259,1439799349,3,2,90
127460346@N03,585,25,1439893287,1439895387,1,1,2100
12767421@N08,586,6,1283759076,1283759191,2,3,115
12767421@N08,586,19,1283759191,1283759731,11,3,540
12767421@N08,586,15,1283766968,1283767328,1,3,360
127845322@N07,587,18,1405141193,1405141733,1,1,540
12784818@N04,588,6,1398702848,1398702968,84,1,120
12784818@N04,589,6,1398830803,1398830923,1,1,120
127890209@N05,590,16,1448337051,1448337471,1,1,420
127890209@N05,591,19,1448372325,1448372865,4,2,540
127890209@N05,591,16,1448374347,1448374767,7,2,420
12793852@N00,592,12,1320054973,1320055243,1,1,270
12793852@N00,593,20,1340939168,1340939768,4,18,600
12793852@N00,593,24,1340939955,1340940833,20,18,878
12793852@N00,593,6,1340940833,1340940953,11,18,120
12793852@N00,593,19,1340941878,1340942299,2,18,421
12793852@N00,593,6,1340942299,1340942419,2,18,120
12793852@N00,593,14,1340942716,1340943076,15,18,360
12793852@N00,593,22,1340949710,1340949733,3,18,23
12793852@N00,593,25,1340949733,1340949779,4,18,46
12793852@N00,593,21,1340949779,1340949842,3,18,63
12793852@N00,593,25,1340949842,1340950424,3,18,582
12793852@N00,593,9,1340950424,1340950544,4,18,120
12793852@N00,593,4,1340951041,1340951131,9,18,90
12793852@N00,593,19,1340961797,1340962084,5,18,287
12793852@N00,593,6,1340962084,1340962204,3,18,120
12793852@N00,593,14,1340962976,1340963336,2,18,360
12793852@N00,593,8,1340965563,1340965683,4,18,120
12793852@N00,593,14,1340968804,1340969164,2,18,360
12793852@N00,593,12,1340970990,1340971260,2,18,270
12793852@N00,594,8,1341015006,1341015126,4,5,120
12793852@N00,594,7,1341042014,1341042134,8,5,120
12793852@N00,594,23,1341044166,1341044173,2,5,7
12793852@N00,594,19,1341044173,1341044713,2,5,540
12793852@N00,594,16,1341049595,1341050015,91,5,420
128287982@N02,595,25,1439792314,1439794414,1,1,2100
128287982@N02,596,16,1439821965,1439822385,1,1,420
128509080@N04,597,17,1424768262,1424768682,3,1,420
128509080@N04,598,20,1424839324,1424839924,3,5,600
128509080@N04,598,2,1424843523,1424843583,3,5,60
128509080@N04,598,1,1424848896,1424848956,2,5,60
128509080@N04,598,18,1424855297,1424855837,3,5,540
128509080@N04,598,13,1424857859,1424858159,1,5,300
12861032@N00,599,16,1350980570,1350980990,4,1,420
12861032@N00,600,14,1351044084,1351044444,2,4,360
12861032@N00,600,19,1351061362,1351061523,2,4,161
12861032@N00,600,6,1351061523,1351061643,2,4,120
12861032@N00,600,8,1351062032,1351062152,2,4,120
12861032@N00,601,16,1398662275,1398662695,2,2,420
12861032@N00,601,10,1398677610,1398677760,1,2,150
12861032@N00,602,19,1398752659,1398753199,1,1,540
12861032@N00,603,16,1448849875,1448850295,3,3,420
12861032@N00,603,8,1448863554,1448863674,3,3,120
12861032@N00,603,16,1448869935,1448870355,2,3,420
12861032@N00,604,25,1448947209,1448949309,4,1,2100
129032122@N06,605,7,1421898754,1421898874,1,1,120
129068573@N04,606,19,1426315307,1426315847,2,7,540
129068573@N04,606,16,1426317616,1426318036,8,7,420
129068573@N04,606,11,1426318981,1426319221,10,7,240
129068573@N04,606,7,1426320138,1426320258,14,7,120
129068573@N04,606,18,1426322657,1426323197,3,7,540
129068573@N04,606,6,1426325484,1426325604,9,7,120
129068573@N04,606,19,1426330855,1426331395,1,7,540
129181069@N07,607,20,1434500749,1434500936,2,16,187
129181069@N07,607,16,1434500936,1434501356,2,16,420
129181069@N07,607,23,1434503297,1434503991,2,16,694
129181069@N07,607,17,1434503991,1434504411,3,16,420
129181069@N07,607,23,1434507726,1434508926,2,16,1200
129181069@N07,607,16,1434509080,1434509500,4,16,420
129181069@N07,607,3,1434511073,1434511163,4,16,90
129181069@N07,607,24,1434518986,1434520486,2,16,1500
129181069@N07,607,6,1434521396,1434521516,2,16,120
129181069@N07,607,14,1434521599,1434521959,5,16,360
129181069@N07,607,5,1434524922,1434525042,4,16,120
129181069@N07,607,14,1434527904,1434528264,5,16,360
129181069@N07,607,19,1434530927,1434531237,3,16,310
129181069@N07,607,16,1434531237,1434531657,2,16,420
129181069@N07,607,11,1434532148,1434532388,2,16,240
129181069@N07,607,16,1434536201,1434536621,3,16,420
129397947@N05,608,24,1455511839,1455513339,2,1,1500
129438227@N06,609,6,1411986711,1411986831,2,2,120
129438227@N06,609,12,1411989675,1411989945,1,2,270
129438227@N06,610,25,1441975123,1441977223,1,1,2100
129456803@N08,611,14,1414123474,1414123834,1,1,360
129456803@N08,612,19,1420857949,1420858489,1,1,540
129456803@N08,613,16,1423817573,1423817993,1,1,420
12946812@N03,614,12,1214911185,1214911455,1,1,270
12959411@N00,615,19,1194149865,1194150405,1,1,540
12987527@N05,616,7,1243583943,1243584063,2,2,120
12987527@N05,616,17,1243588171,1243588591,1,2,420
12996122@N00,617,19,1349607022,1349607562,1,1,540
130254872@N05,618,19,1425091059,1425091599,1,1,540
13042723@N00,619,15,1238312288,1238312648,2,4,360
13042723@N00,619,7,1238313846,1238313966,2,4,120
13042723@N00,619,12,1238314684,1238314954,2,4,270
13042723@N00,619,15,1238316027,1238316387,1,4,360
130777482@N08,620,11,1422836066,1422836306,1,1,240
130912872@N04,621,6,1427493939,1427494059,2,2,120
130912872@N04,621,13,1427494267,1427494567,1,2,300
130912872@N04,622,7,1427533580,1427533700,2,2,120
130912872@N04,622,16,1427537119,1427537539,1,2,420
130912872@N04,623,13,1427590326,1427590492,3,8,166
130912872@N04,623,2,1427590492,1427590552,2,8,60
130912872@N04,623,8,1427590622,1427590742,4,8,120
130912872@N04,623,14,1427590774,1427591134,2,8,360
130912872@N04,623,7,1427596481,1427596601,2,8,120
130912872@N04,623,19,1427615458,1427615998,6,8,540
130912872@N04,623,5,1427620357,1427620477,2,8,120
130912872@N04,623,16,1427623911,1427624331,1,8,420
130912872@N04,624,15,1427666973,1427667333,2,4,360
130912872@N04,624,23,1427668281,1427668636,2,4,355
130912872@N04,624,16,1427668636,1427669056,3,4,420
130912872@N04,624,25,1427671203,1427673303,1,4,2100
13093780@N04,625,17,1247478230,1247478246,2,3,16
13093780@N04,625,16,1247478246,1247478383,2,3,137
13093780@N04,625,15,1247478383,1247478743,1,3,360
130979231@N04,626,7,1366941347,1366941467,2,2,120
130979231@N04,626,14,1366968544,1366968904,1,2,360
13101664@N03,627,20,1424210320,1424210920,2,18,600
13101664@N03,627,15,1424212248,1424212608,2,18,360
13101664@N03,627,11,1424213083,1424213323,3,18,240
13101664@N03,627,7,1424214074,1424214194,5,18,120
13101664@N03,627,5,1424215672,1424215792,4,18,120
13101664@N03,627,16,1424217949,1424218369,4,18,420
13101664@N03,627,19,1424219083,1424219518,2,18,435
13101664@N03,627,14,1424219518,1424219878,4,18,360
13101664@N03,627,19,1424224521,1424225061,3,18,540
13101664@N03,627,14,1424227770,1424228130,4,18,360
13101664@N03,627,8,1424228470,1424228590,2,18,120
13101664@N03,627,22,1424230729,1424231749,3,18,1020
13101664@N03,627,24,1424233810,1424235310,2,18,1500
13101664@N03,627,16,1424236398,1424236818,2,18,420
13101664@N03,627,10,1424236969,1424237119,3,18,150
13101664@N03,627,16,1424240031,1424240451,11,18,420
13101664@N03,627,7,1424243553,1424243673,2,18,120
13101664@N03,627,19,1424248814,1424249354,1,18,540
13101664@N03,628,18,1424381466,1424382006,2,2,540
13101664@N03,628,24,1424384810,1424386310,1,2,1500
13101664@N03,629,24,1424918357,1424919857,1,1,1500
13108546@N07,630,12,1340906986,1340907256,4,21,270
13108546@N07,630,25,1340910129,1340912229,13,21,2100
13108546@N07,630,22,1340913569,1340913936,3,21,367
13108546@N07,630,19,1340913936,1340914369,4,21,433
13108546@N07,630,16,1340914369,1340914492,2,21,123
13108546@N07,630,11,1340914492,1340914732,2,21,240
13108546@N07,630,19,1340915665,1340916205,3,21,540
13108546@N07,630,6,1340917794,1340917914,4,21,120
13108546@N07,630,19,1340918277,1340918649,5,21,372
13108546@N07,630,6,1340918649,1340918769,2,21,120
13108546@N07,630,19,1340918842,1340919366,17,21,524
13108546@N07,630,14,1340919366,1340919376,2,21,10
13108546@N07,630,6,1340919376,1340919496,3,21,120
13108546@N07,630,19,1340919498,1340919616,2,21,118
13108546@N07,630,6,1340919616,1340919736,14,21,120
13108546@N07,630,14,1340920675,1340920972,8,21,297
13108546@N07,630,19,1340920972,1340921210,6,21,238
13108546@N07,630,6,1340921210,1340921304,3,21,94
13108546@N07,630,19,1340921304,1340921625,3,21,321
13108546@N07,630,24,1340921625,1340921892,4,21,267
13108546@N07,630,12,1340921892,1340922162,3,21,270
13125640@N07,631,12,1197623917,1197624187,2,5,270
13125640@N07,631,7,1197624234,1197624354,8,5,120
13125640@N07,631,11,1197626632,1197626872,6,5,240
13125640@N07,631,16,1197627754,1197628174,3,5,420
13125640@N07,631,12,1197628187,1197628457,4,5,270
13125640@N07,632,12,1200108500,1200108770,4,5,270
13125640@N07,632,15,1200109324,1200109684,7,5,360
13125640@N07,632,12,1200112839,1200113109,4,5,270
13125640@N07,632,19,1200113565,1200114105,6,5,540
13125640@N07,632,11,1200114964,1200115204,5,5,240
13125640@N07,633,7,1204273866,1204273986,26,4,120
13125640@N07,633,11,1204279389,1204279629,3,4,240
13125640@N07,633,15,1204281286,1204281646,17,4,360
13125640@N07,633,12,1204284258,1204284528,2,4,270
131306365@N08,634,24,1451887615,1451889115,1,1,1500
131378402@N06,635,19,1420290005,1420290545,3,1,540
13158511@N00,636,18,1356863728,1356864268,4,2,540
13158511@N00,636,14,1356867431,1356867791,1,2,360
13158511@N00,637,11,1370597742,1370597982,1,1,240
13158511@N00,638,6,1384247268,1384247388,1,1,120
13158511@N00,639,19,1386488720,1386489260,1,1,540
13168981@N04,640,11,1341450046,1341450286,21,1,240
13168981@N04,641,11,1356134866,1356135106,3,1,240
132060684@N07,642,20,1435371094,1435371694,4,5,600
132060684@N07,642,12,1435375517,1435375787,3,5,270
132060684@N07,642,16,1435379155,1435379575,52,5,420
132060684@N07,642,11,1435385232,1435385472,4,5,240
132060684@N07,642,25,1435392885,1435394985,5,5,2100
13251558@N06,643,22,1324872759,1324872868,2,2,109
13251558@N06,643,16,1324872868,1324873288,1,2,420
13288022@N00,644,12,1214646047,1214646317,1,1,270
13312992@N06,645,17,1348125277,1348125697,2,9,420
13312992@N06,645,19,1348126301,1348126841,5,9,540
13312992@N06,645,17,1348127094,1348127501,2,9,407
13312992@N06,645,25,1348127501,1348127750,2,9,249
13312992@N06,645,23,1348127750,1348128165,3,9,415
13312992@N06,645,17,1348128165,1348128585,8,9,420
13312992@N06,645,23,1348131250,1348132450,2,9,1200
13312992@N06,645,11,1348132983,1348133223,2,9,240
13312992@N06,645,16,1348133340,1348133760,5,9,420
13312992@N06,646,24,1348288847,1348290347,4,4,1500
13312992@N06,646,17,1348310386,1348310806,2,4,420
13312992@N06,646,12,1348311460,1348311730,10,4,270
13312992@N06,646,25,1348316318,1348318418,2,4,2100
13312992@N06,647,17,1348359322,1348359742,3,9,420
13312992@N06,647,22,1348359984,1348360211,9,9,227
13312992@N06,647,25,1348360211,1348360539,6,9,328
13312992@N06,647,2,1348360539,1348360599,4,9,60
13312992@N06,647,20,1348361613,1348362213,3,9,600
13312992@N06,647,2,1348362638,1348362698,2,9,60
13312992@N06,647,19,1348362824,1348363364,13,9,540
13312992@N06,647,10,1348366940,1348367090,6,9,150
13312992@N06,647,17,1348367595,1348368015,1,9,420
13312992@N06,648,24,1356074043,1356075543,3,1,1500
13312992@N06,649,6,1356123439,1356123559,3,4,120
13312992@N06,649,24,1356126151,1356126875,7,4,724
13312992@N06,649,6,1356126875,1356126995,3,4,120
13312992@N06,649,19,1356127089,1356127629,15,4,540
13332833@N06,650,24,1327650994,1327652494,2,1,1500
13332833@N06,651,18,1333866070,1333866610,1,1,540
13332833@N06,652,24,1334482954,1334484454,2,1,1500
13349207@N00,653,7,1397340303,1397340423,2,2,120
13349207@N00,653,19,1397356851,1397357391,2,2,540
13349207@N00,654,12,1426412261,1426412531,2,1,270
13349207@N00,655,19,1426456975,1426457515,1,1,540
13349207@N00,656,18,1433112201,1433112215,2,3,14
13349207@N00,656,7,1433112215,1433112335,4,3,120
13349207@N00,656,18,1433113688,1433114228,3,3,540
13349207@N00,657,11,1441163147,1441163387,2,2,240
13349207@N00,657,7,1441163601,1441163721,2,2,120
13349207@N00,658,12,1460870604,1460870874,1,1,270
13349207@N00,659,17,1464519259,1464519679,1,1,420
13355109@N08,660,14,1350531184,1350531544,1,1,360
13355580@N00,661,10,1317204156,1317204306,1,1,150
13359849@N00,662,19,1330766220,1330766760,1,1,540
13359849@N00,663,19,1337492330,1337492870,1,1,540
13359849@N00,664,12,1358537734,1358538004,1,1,270
13359849@N00,665,24,1384328913,1384330413,1,1,1500
13359849@N00,666,16,1400850705,1400851125,1,1,420
13359849@N00,667,18,1415950186,1415950726,1,1,540
13359849@N00,668,17,1434881429,1434881849,2,2,420
13359849@N00,668,16,1434888103,1434888523,1,2,420
133911707@N06,669,16,1362043626,1362044046,5,7,420
133911707@N06,669,12,1362072663,1362072788,3,7,125
133911707@N06,669,19,1362072788,1362072799,2,7,11
133911707@N06,669,18,1362072799,1362073339,2,7,540
133911707@N06,669,20,1362077680,1362078280,4,7,600
133911707@N06,669,18,1362106403,1362106943,3,7,540
133911707@N06,669,16,1362110306,1362110726,9,7,420
135451172@N07,670,5,1453612814,1453612934,2,1,120
135451172@N07,671,14,1453677430,1453677790,1,1,360
13551979@N02,672,16,1360473797,1360473829,2,2,32
13551979@N02,672,12,1360473829,1360474099,1,2,270
13551979@N02,673,24,1369102511,1369104011,1,1,1500
13551979@N02,674,22,1371622019,1371623039,3,1,1020
13551979@N02,675,22,1371886208,1371887228,3,1,1020
13551979@N02,676,14,1377320285,1377320645,1,1,360
13551979@N02,677,14,1384309773,1384310133,2,1,360
13551979@N02,678,17,1426815729,1426816149,1,1,420
136309822@N08,679,20,1462413472,1462414072,1,1,600
136309822@N08,680,24,1462453597,1462455097,2,1,1500
136309822@N08,681,24,1463038689,1463040189,1,1,1500
13644648@N03,682,12,1244294152,1244294422,1,1,270
13644648@N03,683,17,1272443375,1272443377,3,18,2
13644648@N03,683,23,1272443377,1272443378,2,18,1
13644648@N03,683,19,1272443378,1272443378,2,18,0
13644648@N03,683,23,1272443378,1272443380,3,18,2
13644648@N03,683,20,1272443380,1272443381,2,18,1
13644648@N03,683,12,1272443381,1272443381,2,18,0
13644648@N03,683,16,1272443381,1272443382,2,18,1
13644648@N03,683,5,1272443382,1272443383,2,18,1
13644648@N03,683,1,1272443383,1272443384,2,18,1
13644648@N03,683,3,1272443384,1272443384,2,18,0
13644648@N03,683,7,1272443384,1272443386,3,18,2
13644648@N03,683,5,1272443386,1272443387,2,18,1
13644648@N03,683,10,1272443387,1272443388,2,18,1
13644648@N03,683,7,1272443388,1272443389,2,18,1
13644648@N03,683,4,1272443389,1272443390,2,18,1
13644648@N03,683,10,1272443390,1272443391,2,18,1
13644648@N03,683,6,1272443391,1272443392,2,18,1
13644648@N03,683,10,1272443392,1272443542,5,18,150
13644648@N03,684,7,1272611689,1272611809,1,1,120
13644648@N03,685,5,1280211807,1280211808,2,16,1
13644648@N03,685,4,1280211808,1280211809,2,16,1
13644648@N03,685,5,1280211809,1280211810,2,16,1
13644648@N03,685,17,1280211810,1280211811,2,16,1
13644648@N03,685,23,1280211811,1280211815,4,16,4
13644648@N03,685,7,1280211815,1280211816,2,16,1
13644648@N03,685,3,1280211816,1280211820,5,16,4
13644648@N03,685,23,1280211820,1280211821,2,16,1
13644648@N03,685,7,1280211821,1280211822,2,16,1
13644648@N03,685,12,1280211822,1280211824,2,16,2
13644648@N03,685,10,1280211824,1280211824,2,16,0
13644648@N03,685,18,1280211824,1280211826,2,16,2
13644648@N03,685,10,1280211826,1280211827,2,16,1
13644648@N03,685,16,1280211827,1280211828,2,16,1
13644648@N03,685,15,1280211828,1280212188,4,16,360
13644648@N03,685,4,1280217196,1280217286,1,16,90
13665830@N07,686,16,1454381995,1454382415,3,2,420
13665830@N07,686,24,1454383714,1454385214,4,2,1500
136678498@N06,687,17,1443853742,1443854087,2,3,345
136678498@N06,687,23,1443854087,1443854734,2,3,647
136678498@N06,687,19,1443854734,1443855274,1,3,540
136678498@N06,688,17,1464777942,1464778362,1,1,420
136678498@N06,689,14,1465470391,1465470751,2,2,360
136678498@N06,689,16,1465472048,1465472468,1,2,420
136678498@N06,690,25,1469001386,1469003486,2,2,2100
136678498@N06,690,14,1469018148,1469018508,2,2,360
13701504@N00,691,23,1282855019,1282856219,1,1,1200
13725122@N02,692,14,1348462517,1348462877,4,3,360
13725122@N02,692,11,1348471807,1348472047,2,3,240
13725122@N02,692,18,1348473753,1348474293,1,3,540
13750887@N06,693,19,1193978531,1193979071,49,1,540
13750887@N06,694,19,1195170155,1195170695,52,1,540
13818837@N05,695,7,1291685201,1291685321,2,2,120
13818837@N05,695,6,1291689901,1291690021,1,2,120
13818837@N05,696,7,1314709956,1314710076,1,1,120
13818837@N05,697,25,1317631201,1317632619,2,2,1418
13818837@N05,697,12,1317632619,1317632889,1,2,270
13818837@N05,698,16,1317703361,1317703781,2,4,420
13818837@N05,698,10,1317704355,1317704505,2,4,150
13818837@N05,698,1,1317706422,1317706482,2,4,60
13818837@N05,698,17,1317715644,1317716064,1,4,420
13818837@N05,699,17,1317807001,1317807421,2,2,420
13818837@N05,699,18,1317810212,1317810752,1,2,540
13818837@N05,700,24,1343048107,1343049607,2,1,1500
13818837@N05,701,18,1343103759,1343104299,1,1,540
13818837@N05,702,14,1389612717,1389613077,1,1,360
138235424@N04,703,14,1448864445,1448864805,1,1,360
138710409@N03,704,19,1462252715,1462253255,3,2,540
138710409@N03,704,16,1462269155,1462269575,1,2,420
138748094@N04,705,16,1460514131,1460514551,1,1,420
13875847@N00,706,12,1254689092,1254689362,2,3,270
13875847@N00,706,18,1254691012,1254691552,2,3,540
13875847@N00,706,19,1254697986,1254698526,1,3,540
13875847@N00,707,17,1254731036,1254731456,1,1,420
13875847@N00,708,15,1276414744,1276415104,3,1,360
13875847@N00,709,23,1286000356,1286001556,1,1,1200
13875847@N00,710,12,1286068145,1286068415,7,8,270
13875847@N00,710,20,1286071444,1286072044,2,8,600
13875847@N00,710,8,1286072984,1286073104,4,8,120
13875847@N00,710,15,1286078532,1286078892,5,8,360
13875847@N00,710,18,1286081810,1286082350,8,8,540
13875847@N00,710,17,1286089047,1286089467,8,8,420
13875847@N00,710,16,1286099500,1286099920,4,8,420
13875847@N00,710,24,1286103684,1286105184,1,8,1500
13875847@N00,711,14,1349476122,1349476482,5,8,360
13875847@N00,711,24,1349483198,1349484698,5,8,1500
13875847@N00,711,6,1349495110,1349495230,2,8,120
13875847@N00,711,24,1349497992,1349499492,2,8,1500
13875847@N00,711,12,1349509002,1349509250,2,8,248
13875847@N00,711,24,1349509250,1349510750,2,8,1500
13875847@N00,711,14,1349512980,1349513340,2,8,360
13875847@N00,711,19,1349515008,1349515548,1,8,540
13875847@N00,712,24,1349567412,1349568912,5,10,1500
13875847@N00,712,14,1349576436,1349576796,2,10,360
13875847@N00,712,8,1349578050,1349578170,3,10,120
13875847@N00,712,6,1349579736,1349579856,2,10,120
13875847@N00,712,23,1349580342,1349581316,2,10,974
13875847@N00,712,17,1349581316,1349581736,3,10,420
13875847@N00,712,16,1349586744,1349587058,2,10,314
13875847@N00,712,11,1349587058,1349587298,2,10,240
13875847@N00,712,23,1349590914,1349592114,2,10,1200
13875847@N00,712,17,1349596516,1349596936,7,10,420
13878873@N08,713,19,1208055930,1208056470,4,2,540
13878873@N08,713,16,1208057906,1208058326,2,2,420
13885531@N00,714,12,1237594814,1237595084,1,1,270
13885531@N00,715,24,1237800480,1237800871,2,2,391
13885531@N00,715,17,1237800871,1237801291,1,2,420
13885531@N00,716,18,1237957545,1237958085,2,3,540
13885531@N00,716,20,1237958574,1237958622,2,3,48
13885531@N00,716,24,1237958622,1237960122,1,3,1500
13906433@N05,717,7,1316839607,1316839727,32,1,120
13922841@N00,718,12,1413007770,1413008040,13,1,270
13922841@N00,719,12,1434811144,1434811414,12,1,270
13922841@N00,720,12,1435685981,1435686251,8,1,270
13922841@N00,721,1,1437113994,1437114054,3,9,60
13922841@N00,721,10,1437139038,1437139188,2,9,150
13922841@N00,721,14,1437140584,1437140944,5,9,360
13922841@N00,721,25,1437141118,1437143218,2,9,2100
13922841@N00,721,20,1437143535,1437144135,27,9,600
13922841@N00,721,19,1437145779,1437146319,7,9,540
13922841@N00,721,6,1437159955,1437160035,2,9,80
13922841@N00,721,19,1437160035,1437160049,2,9,14
13922841@N00,721,14,1437160049,1437160409,1,9,360
13922841@N00,722,12,1440837538,1440837808,3,4,270
13922841@N00,722,22,1440838528,1440839548,3,4,1020
13922841@N00,722,25,1440845690,1440847790,5,4,2100
13922841@N00,722,13,1440850810,1440851110,1,4,300
13922841@N00,723,17,1443834648,1443835068,9,5,420
13922841@N00,723,23,1443860603,1443861286,4,5,683
13922841@N00,723,16,1443861286,1443861545,2,5,259
13922841@N00,723,19,1443861545,1443861698,7,5,153
13922841@N00,723,14,1443861698,1443862058,2,5,360
13922841@N00,724,12,1448714210,1448714480,4,8,270
13922841@N00,724,6,1448730696,1448730816,6,8,120
13922841@N00,724,14,1448731091,1448731232,2,8,141
13922841@N00,724,19,1448731232,1448731724,2,8,492
13922841@N00,724,3,1448731724,1448731814,5,8,90
13922841@N00,724,18,1448732325,1448732627,2,8,302
13922841@N00,724,11,1448732627,1448732867,2,8,240
13922841@N00,724,19,1448734959,1448735499,4,8,540
13922841@N00,725,24,1448805594,1448807094,2,1,1500
13922841@N00,726,22,1451827350,1451828370,3,5,1020
13922841@N00,726,25,1451833441,1451835541,18,5,2100
13922841@N00,726,15,1451838813,1451839115,7,5,302
13922841@N00,726,25,1451839115,1451839712,3,5,597
13922841@N00,726,12,1451839712,1451839982,1,5,270
13922841@N00,727,14,1453546345,1453546705,10,5,360
13922841@N00,727,16,1453557747,1453558167,17,5,420
13922841@N00,727,10,1453558482,1453558632,8,5,150
13922841@N00,727,1,1453559732,1453559792,4,5,60
13922841@N00,727,24,1453561939,1453563439,1,5,1500
13922841@N00,728,1,1454892079,1454892139,2,11,60
13922841@N00,728,6,1454919829,1454919949,2,11,120
13922841@N00,728,19,1454920003,1454920543,9,11,540
13922841@N00,728,10,1454920726,1454920853,2,11,127
13922841@N00,728,3,1454920853,1454920874,2,11,21
13922841@N00,728,1,1454920874,1454920934,2,11,60
13922841@N00,728,3,1454920934,1454921024,6,11,90
13922841@N00,728,1,1454921357,1454921417,18,11,60
13922841@N00,728,10,1454922742,1454922834,2,11,92
13922841@N00,728,16,1454922834,1454923232,4,11,398
13922841@N00,728,24,1454923232,1454924732,2,11,1500
13922841@N00,729,20,1462090552,1462090908,3,6,356
13922841@N00,729,6,1462090908,1462091028,4,6,120
13922841@N00,729,20,1462091692,1462092066,3,6,374
13922841@N00,729,19,1462092066,1462092606,4,6,540
13922841@N00,729,16,1462093379,1462093799,4,6,420
13922841@N00,729,12,1462094276,1462094546,1,6,270
13922841@N00,730,12,1468000187,1468000457,3,4,270
13922841@N00,730,6,1468001175,1468001295,2,4,120
13922841@N00,730,14,1468001313,1468001673,2,4,360
13922841@N00,730,24,1468004067,1468005567,1,4,1500
13922841@N00,731,24,1468601297,1468601408,2,9,111
13922841@N00,731,20,1468601408,1468602008,4,9,600
13922841@N00,731,1,1468604107,1468604167,6,9,60
13922841@N00,731,23,1468605107,1468605391,2,9,284
13922841@N00,731,17,1468605391,1468605811,5,9,420
13922841@N00,731,24,1468606178,1468606692,2,9,514
13922841@N00,731,6,1468606692,1468606806,2,9,114
13922841@N00,731,14,1468606806,1468606887,2,9,81
13922841@N00,731,19,1468606887,1468607427,2,9,540
13923792@N06,732,24,1340403708,1340405208,1,1,1500
13923792@N06,733,23,1340432929,1340434129,1,1,1200
13923792@N06,734,23,1348308290,1348309490,1,1,1200
13923792@N06,735,7,1369355352,1369355472,1,1,120
13923792@N06,736,4,1369405545,1369405635,1,1,90
13923792@N06,737,24,1369687764,1369689264,1,1,1500
13923792@N06,738,24,1369777827,1369779327,1,1,1500
13923792@N06,739,23,1377922904,1377924104,1,1,1200
13923792@N06,740,13,1388304553,1388304853,1,1,300
13923792@N06,741,13,1388440771,1388441071,1,1,300
13923792@N06,742,23,1417511107,1417512307,1,1,1200
13923792@N06,743,3,1417578696,1417578786,2,2,90
13923792@N06,743,24,1417586024,1417587524,1,2,1500
13923792@N06,744,6,1433148966,1433149086,1,1,120
13923792@N06,745,7,1434603593,1434603666,2,2,73
13923792@N06,745,19,1434603666,1434604206,1,2,540
13927809@N02,746,19,1340015739,1340016279,1,1,540
13933131@N08,747,12,1295673968,1295674238,2,2,270
13933131@N08,747,18,1295676698,1295677238,2,2,540
13933131@N08,748,10,1324541439,1324541589,1,1,150
13933131@N08,749,6,1356074399,1356074519,2,2,120
13933131@N08,749,14,1356079867,1356080227,1,2,360
13968334@N06,750,11,1212342268,1212342508,2,4,240
13968334@N06,750,5,1212345136,1212345256,2,4,120
13968334@N06,750,12,1212350534,1212350804,2,4,270
13968334@N06,750,17,1212351324,1212351744,1,4,420
13975595@N00,751,14,1375937726,1375938086,1,1,360
13998921@N02,752,24,1346129150,1346129614,4,5,464
13998921@N02,752,20,1346129614,1346129736,2,5,122
13998921@N02,752,7,1346129736,1346129856,2,5,120
13998921@N02,752,6,1346136368,1346136488,2,5,120
13998921@N02,752,12,1346150500,1346150770,1,5,270
14013471@N04,753,7,1235395823,1235395943,1,1,120
14042144@N07,754,24,1393468913,1393470413,2,4,1500
14042144@N07,754,7,1393472086,1393472206,2,4,120
14042144@N07,754,14,1393472230,1393472369,2,4,139
14042144@N07,754,19,1393472369,1393472909,1,4,540
14102022@N02,755,16,1194948086,1194948506,7,1,420
141210124@N05,756,22,1465074322,1465075342,1,1,1020
14136614@N03,757,12,1328229782,1328230052,1,1,270
14161238@N08,758,7,1401088132,1401088252,1,1,120
14161238@N08,759,18,1416721921,1416722461,2,2,540
14161238@N08,759,16,1416740601,1416741021,1,2,420
14161238@N08,760,17,1436680289,1436680709,10,4,420
14161238@N08,760,12,1436682567,1436682837,5,4,270
14161238@N08,760,8,1436686781,1436686901,4,4,120
14161238@N08,760,20,1436687692,1436688292,1,4,600
14221499@N00,761,16,1301475198,1301475618,1,1,420
14221499@N00,762,11,1363394138,1363394378,1,1,240
14221499@N00,763,14,1377045061,1377045421,1,1,360
14221499@N00,764,18,1413194399,1413194939,1,1,540
142287241@N02,765,17,1468386410,1468386558,2,3,148
142287241@N02,765,23,1468386558,1468386884,2,3,326
142287241@N02,765,16,1468386884,1468387304,1,3,420
142287241@N02,766,25,1468491068,1468492306,3,4,1238
142287241@N02,766,16,1468492306,1468492726,2,4,420
142287241@N02,766,17,1468492792,1468493084,2,4,292
142287241@N02,766,12,1468493084,1468493354,1,4,270
142287241@N02,767,24,1468556428,1468556568,2,4,140
142287241@N02,767,12,1468556568,1468556716,2,4,148
142287241@N02,767,24,1468556716,1468556898,2,4,182
142287241@N02,767,12,1468556898,1468557168,1,4,270
142287241@N02,768,12,1468836974,1468837244,2,4,270
142287241@N02,768,3,1468837388,1468837478,2,4,90
142287241@N02,768,19,1468838616,1468838948,2,4,332
142287241@N02,768,12,1468838948,1468839218,1,4,270
142287241@N02,769,12,1470219824,1470220094,1,1,270
14232531@N07,770,5,1331361845,1331361965,1,1,120
14233893@N02,771,12,1299231579,1299231849,1,1,270
14233893@N02,772,11,1340510946,1340511186,1,1,240
14246866@N05,773,12,1232266493,1232266763,3,10,270
14246866@N05,773,24,1232266816,1232267114,3,10,298
14246866@N05,773,12,1232267114,1232267384,3,10,270
14246866@N05,773,23,1232267866,1232268540,4,10,674
14246866@N05,773,10,1232268540,1232268690,3,10,150
14246866@N05,773,1,1232268785,1232268845,2,10,60
14246866@N05,773,5,1232268959,1232269012,2,10,53
14246866@N05,773,7,1232269012,1232269132,6,10,120
14246866@N05,773,11,1232270053,1232270293,2,10,240
14246866@N05,773,6,1232270930,1232271050,1,10,120
142525331@N04,774,12,1459921731,1459922001,2,2,270
142525331@N04,774,14,1459924474,1459924834,3,2,360
142525331@N04,775,19,1461819022,1461819562,1,1,540
14256823@N08,776,12,1192428582,1192428852,2,1,270
14267139@N08,777,16,1305291072,1305291492,1,1,420
14272980@N03,778,16,1274503579,1274503942,2,2,363
14272980@N03,778,6,1274503942,1274504062,1,2,120
14280234@N04,779,7,1227933856,1227933976,1,1,120
14280234@N04,780,7,1244192492,1244192612,1,1,120
14280234@N04,781,20,1247482526,1247483126,1,1,600
14280234@N04,782,22,1255150881,1255151901,1,1,1020
14280234@N04,783,22,1258875846,1258876866,1,1,1020
14280234@N04,784,13,1264208771,1264209071,1,1,300
14280234@N04,785,7,1265007426,1265007546,1,1,120
14280234@N04,786,17,1266191305,1266191725,1,1,420
14280234@N04,787,22,1266638603,1266639623,1,1,1020
14280234@N04,788,25,1269303031,1269305131,1,1,2100
14280234@N04,789,25,1272509323,1272511423,1,1,2100
14280234@N04,790,19,1273897253,1273897793,1,1,540
14280234@N04,791,25,1277098247,1277100347,1,1,2100
14280234@N04,792,25,1278796701,1278798801,1,1,2100
14280234@N04,793,22,1288311314,1288312334,1,1,1020
14280234@N04,794,1,1306543728,1306543788,1,1,60
14280234@N04,795,23,1329528087,1329529287,1,1,1200
14280234@N04,796,19,1344991854,1344992394,1,1,540
14286574@N00,797,12,1364639707,1364639977,1,1,270
14286574@N00,798,25,1364677169,1364677629,2,5,460
14286574@N00,798,23,1364677629,1364677939,2,5,310
14286574@N00,798,17,1364677939,1364678359,2,5,420
14286574@N00,798,16,1364679265,1364679685,2,5,420
14286574@N00,798,12,1364682702,1364682972,1,5,270
14286574@N00,799,17,1364728847,1364729267,1,1,420
14291689@N07,800,10,1328430836,1328430986,1,1,150
14291689@N07,801,7,1360562835,1360562955,2,2,120
14291689@N07,801,10,1360565118,1360565268,7,2,150
14291689@N07,802,6,1422743460,1422743580,5,3,120
14291689@N07,802,25,1422747238,1422749338,5,3,2100
14291689@N07,802,18,1422764563,1422765103,1,3,540
14320654@N03,803,13,1459466908,1459467208,1,1,300
14329698@N03,804,5,1282420502,1282420622,1,1,120
14379699@N02,805,22,1383446296,1383447316,2,9,1020
14379699@N02,805,15,1383449909,1383450269,2,9,360
14379699@N02,805,4,1383451765,1383451855,2,9,90
14379699@N02,805,20,1383452097,1383452697,2,9,600
14379699@N02,805,18,1383456308,1383456848,2,9,540
14379699@N02,805,7,1383460493,1383460613,2,9,120
14379699@N02,805,19,1383461015,1383461521,2,9,506
14379699@N02,805,14,1383461521,1383461881,2,9,360
14379699@N02,805,25,1383466382,1383468482,1,9,2100
14379699@N02,806,24,1392256469,1392257969,2,12,1500
14379699@N02,806,15,1392258977,1392259078,2,12,101
14379699@N02,806,2,1392259078,1392259138,2,12,60
14379699@N02,806,19,1392260171,1392260711,2,12,540
14379699@N02,806,14,1392261185,1392261327,2,12,142
14379699@N02,806,19,1392261327,1392261867,2,12,540
14379699@N02,806,6,1392262892,1392263012,3,12,120
14379699@N02,806,19,1392264748,1392265288,2,12,540
14379699@N02,806,7,1392268452,1392268572,2,12,120
14379699@N02,806,16,1392269328,1392269748,3,12,420
14379699@N02,806,23,1392270940,1392271934,2,12,994
14379699@N02,806,12,1392271934,1392272204,1,12,270
14379699@N02,807,25,1412567112,1412569212,4,12,2100
14379699@N02,807,17,1412570112,1412570532,2,12,420
14379699@N02,807,23,1412571408,1412571555,2,12,147
14379699@N02,807,17,1412571555,1412571975,2,12,420
14379699@N02,807,14,1412574717,1412575077,2,12,360
14379699@N02,807,2,1412576681,1412576741,2,12,60
14379699@N02,807,9,1412577357,1412577416,2,12,59
14379699@N02,807,2,1412577416,1412577476,2,12,60
14379699@N02,807,6,1412579340,1412579424,2,12,84
14379699@N02,807,18,1412579424,1412579964,2,12,540
14379699@N02,807,7,1412581887,1412582007,2,12,120
14379699@N02,807,16,1412584681,1412585101,1,12,420
14379699@N02,808,17,1444515409,1444515829,1,1,420
14418030@N00,809,24,1212292661,1212294161,1,1,1500
14418851@N04,810,25,1192182347,1192184447,3,3,2100
14418851@N04,810,24,1192187241,1192188313,2,3,1072
14418851@N04,810,7,1192188313,1192188433,1,3,120
14447350@N05,811,7,1324192946,1324193066,2,3,120
14447350@N05,811,6,1324197539,1324197659,2,3,120
14447350@N05,811,20,1324197800,1324198400,1,3,600
14449931@N08,812,17,1420703916,1420704336,3,1,420
14449931@N08,813,17,1420761114,1420761534,2,5,420
14449931@N08,813,19,1420762358,1420762898,2,5,540
14449931@N08,813,16,1420768009,1420768429,2,5,420
14449931@N08,813,19,1420785119,1420785659,2,5,540
14449931@N08,813,17,1420797632,1420798052,2,5,420
14449931@N08,814,19,1420882022,1420882562,2,1,540
14474397@N00,815,19,1347675149,1347675689,1,1,540
14483469@N00,816,18,1380970827,1380971367,1,1,540
14486777@N07,817,18,1410668954,1410669494,2,1,540
14487451@N00,818,7,1357348866,1357348986,2,2,120
14487451@N00,818,14,1357356826,1357357186,1,2,360
14487451@N00,819,14,1358635264,1358635624,1,1,360
14506090@N06,820,6,1189744412,1189744532,2,3,120
14506090@N06,820,5,1189750001,1189750121,2,3,120
14506090@N06,820,11,1189754270,1189754510,2,3,240
14617204@N06,821,6,1454988765,1454988885,3,1,120
14648099@N05,822,17,1309320203,1309320623,1,1,420
14673856@N04,823,16,1204340440,1204340860,3,1,420
14709786@N05,824,11,1392901079,1392901319,1,1,240
14775381@N03,825,18,1397807975,1397808515,3,1,540
14775381@N03,826,18,1397866654,1397867194,2,1,540
14792256@N00,827,14,1339974887,1339975247,2,2,360
14792256@N00,827,18,1339982956,1339983496,1,2,540
14792256@N00,828,13,1340018575,1340018875,2,2,300
14792256@N00,828,14,1340029290,1340029650,1,2,360
14792256@N00,829,13,1358844322,1358844622,1,1,300
14831331@N07,830,24,1345542020,1345543520,1,1,1500
14834314@N00,831,21,1340232724,1340233552,2,10,828
14834314@N00,831,24,1340233552,1340235052,2,10,1500
14834314@N00,831,21,1340235382,1340236282,2,10,900
14834314@N00,831,13,1340236478,1340236778,2,10,300
14834314@N00,831,18,1340243368,1340243908,9,10,540
14834314@N00,831,24,1340253190,1340254690,2,10,1500
14834314@N00,831,19,1340260271,1340260510,2,10,239
14834314@N00,831,8,1340260510,1340260630,2,10,120
14834314@N00,831,19,1340260677,1340261217,2,10,540
14834314@N00,831,10,1340274941,1340275091,1,10,150
14848876@N00,832,7,1282962189,1282962309,2,1,120
14848876@N00,833,10,1282996878,1282997028,2,1,150
14877255@N04,834,17,1391418491,1391418911,2,1,420
14877255@N04,835,17,1394241796,1394242216,1,1,420
14877255@N04,836,17,1422076709,1422077129,2,1,420
14877255@N04,837,17,1437189607,1437190027,3,1,420
14877255@N04,838,17,1448510882,1448511302,1,1,420
14877255@N04,839,14,1450510530,1450510890,2,3,360
14877255@N04,839,17,1450514194,1450514508,2,3,314
14877255@N04,839,24,1450514508,1450516008,1,3,1500
14877255@N04,840,5,1452882200,1452882320,1,1,120
14877255@N04,841,23,1455332884,1455334084,1,1,1200
14877255@N04,842,8,1457757900,1457758020,1,1,120
14877255@N04,843,25,1468753978,1468756078,1,1,2100
14877255@N04,844,12,1469250234,1469250504,1,1,270
14877255@N04,845,12,1469867704,1469867974,1,1,270
14889576@N08,846,19,1272847707,1272848247,1,1,540
14894152@N04,847,18,1397128333,1397128873,1,1,540
14894152@N04,848,12,1462083543,1462083813,1,1,270
14897087@N04,849,19,1337411122,1337411662,1,1,540
14899943@N06,850,8,1450924099,1450924219,1,1,120
14902480@N02,851,6,1340270173,1340270293,1,1,120
14920533@N06,852,24,1395891731,1395893231,2,2,1500
14920533@N06,852,6,1395894501,1395894621,1,2,120
14942605@N03,853,19,1301275774,1301276314,2,1,540
15026501@N00,854,12,1340255594,1340255864,1,1,270
15037455@N08,855,24,1340669210,1340670710,67,1,1500
15037455@N08,856,24,1340747520,1340749020,35,1,1500
15037455@N08,857,24,1342326438,1342327938,4,1,1500
15037455@N08,858,24,1343386388,1343387888,1,1,1500
15037455@N08,859,24,1343438155,1343439655,2,1,1500
15079826@N00,860,16,1313663225,1313663645,2,5,420
15079826@N00,860,19,1313667379,1313667919,12,5,540
15079826@N00,860,25,1313668308,1313670408,2,5,2100
15079826@N00,860,13,1313670531,1313670831,6,5,300
15079826@N00,860,18,1313676375,1313676915,1,5,540
15082380@N07,861,16,1190430048,1190430468,1,1,420
15082380@N07,862,16,1224376006,1224376426,11,1,420
15099999@N07,863,18,1277035527,1277036067,7,1,540
15104804@N08,864,2,1358827960,1358827962,2,5,2
15104804@N08,864,4,1358827962,1358828052,5,5,90
15104804@N08,864,18,1358835142,1358835682,3,5,540
15104804@N08,864,19,1358836667,1358837207,3,5,540
15104804@N08,864,5,1358840697,1358840817,1,5,120
15125199@N07,865,7,1287905158,1287905278,1,1,120
15125199@N07,866,24,1288236421,1288237921,3,3,1500
15125199@N07,866,15,1288240969,1288241329,2,3,360
15125199@N07,866,6,1288242711,1288242831,2,3,120
15125199@N07,867,12,1289380354,1289380624,2,4,270
15125199@N07,867,15,1289380774,1289381134,2,4,360
15125199@N07,867,11,1289382580,1289382820,3,4,240
15125199@N07,867,15,1289383719,1289384079,1,4,360
15125199@N07,868,25,1294718373,1294718897,2,4,524
15125199@N07,868,15,1294718897,1294719257,2,4,360
15125199@N07,868,11,1294720710,1294720950,2,4,240
15125199@N07,868,18,1294722203,1294722743,4,4,540
15125199@N07,869,7,1295928281,1295928401,2,2,120
15125199@N07,869,15,1295930657,1295931017,1,2,360
15125199@N07,870,7,1299556538,1299556658,1,1,120
15125199@N07,871,4,1314496476,1314496566,4,1,90
15125199@N07,872,12,1314954404,1314954674,2,3,270
15125199@N07,872,16,1314955348,1314955768,6,3,420
15125199@N07,872,11,1314957601,1314957841,1,3,240
15125199@N07,873,14,1349439626,1349439986,6,1,360
15215996@N08,874,18,1437984838,1437985378,2,2,540
15215996@N08,874,23,1437994616,1437995816,1,2,1200
15217104@N02,875,17,1366590732,1366591152,2,20,420
15217104@N02,875,12,1366596383,1366596429,4,20,46
15217104@N02,875,24,1366596429,1366596621,4,20,192
15217104@N02,875,22,1366596621,1366597641,3,20,1020
15217104@N02,875,13,1366599097,1366599397,5,20,300
15217104@N02,875,19,1366601996,1366602083,3,20,87
15217104@N02,875,6,1366602083,1366602128,2,20,45
15217104@N02,875,19,1366602128,1366602668,2,20,540
15217104@N02,875,14,1366603842,1366604187,7,20,345
15217104@N02,875,20,1366604187,1366604245,2,20,58
15217104@N02,875,8,1366604245,1366604365,2,20,120
15217104@N02,875,9,1366604385,1366604505,7,20,120
15217104@N02,875,8,1366605032,1366605152,3,20,120
15217104@N02,875,14,1366607941,1366608301,3,20,360
15217104@N02,875,24,1366613331,1366614415,4,20,1084
15217104@N02,875,16,1366614415,1366614835,4,20,420
15217104@N02,875,20,1366621962,1366622119,3,20,157
15217104@N02,875,6,1366622119,1366622239,3,20,120
15217104@N02,875,19,1366622254,1366622794,14,20,540
15217104@N02,875,16,1366624463,1366624883,11,20,420
15218401@N04,876,10,1428900011,1428900161,2,4,150
15218401@N04,876,6,1428901049,1428901169,2,4,120
15218401@N04,876,14,1428905794,1428906154,2,4,360
15218401@N04,876,7,1428912715,1428912835,2,4,120
15218401@N04,877,14,1429145950,1429146310,4,1,360
15235007@N00,878,16,1228533008,1228533428,14,5,420
15235007@N00,878,7,1228533769,1228533889,8,5,120
15235007@N00,878,11,1228534022,1228534262,8,5,240
15235007@N00,878,13,1228535352,1228535652,7,5,300
15235007@N00,878,24,1228535711,1228537211,4,5,1500
15235007@N00,879,17,1241824156,1241824576,28,1,420
15235007@N00,880,16,1243312609,1243313029,8,3,420
15235007@N00,880,19,1243314344,1243314884,7,3,540
15235007@N00,880,12,1243317437,1243317707,5,3,270
15235007@N00,881,24,1279330350,1279330840,8,3,490
15235007@N00,881,25,1279330840,1279331040,4,3,200
15235007@N00,881,15,1279331040,1279331400,1,3,360
15235007@N00,882,12,1339306184,1339306454,41,4,270
15235007@N00,882,24,1339314240,1339315740,19,4,1500
15235007@N00,882,6,1339322618,1339322738,25,4,120
15235007@N00,882,14,1339330285,1339330645,5,4,360
15235007@N00,883,12,1354312594,1354312864,3,25,270
15235007@N00,883,24,1354316283,1354317490,6,25,1207
15235007@N00,883,25,1354317490,1354318230,9,25,740
15235007@N00,883,15,1354318230,1354318273,2,25,43
15235007@N00,883,25,1354318273,1354318549,2,25,276
15235007@N00,883,2,1354318549,1354318609,4,25,60
15235007@N00,883,8,1354318795,1354318915,2,25,120
15235007@N00,883,19,1354319196,1354319497,6,25,301
15235007@N00,883,6,1354319497,1354319511,2,25,14
15235007@N00,883,19,1354319511,1354319551,2,25,40
15235007@N00,883,6,1354319551,1354319598,4,25,47
15235007@N00,883,19,1354319598,1354319643,2,25,45
15235007@N00,883,6,1354319643,1354319653,2,25,10
15235007@N00,883,14,1354319653,1354319781,2,25,128
15235007@N00,883,6,1354319781,1354319901,2,25,120
15235007@N00,883,8,1354320032,1354320152,4,25,120
15235007@N00,883,6,1354320163,1354320221,2,25,58
15235007@N00,883,19,1354320221,1354320443,2,25,222
15235007@N00,883,6,1354320443,1354320462,2,25,19
15235007@N00,883,14,1354320462,1354320822,5,25,360
15235007@N00,883,19,1354320934,1354321474,11,25,540
15235007@N00,883,18,1354322596,1354323136,3,25,540
15235007@N00,883,11,1354323227,1354323467,8,25,240
15235007@N00,883,1,1354324646,1354324706,4,25,60
15235007@N00,883,23,1354325080,1354326280,1,25,1200
15389242@N00,884,19,1355125384,1355125924,1,1,540
15390973@N03,885,5,1207367734,1207367854,2,4,120
15390973@N03,885,7,1207369984,1207370104,3,4,120
15390973@N03,885,15,1207381273,1207381633,2,4,360
15390973@N03,885,7,1207383239,1207383359,1,4,120
15409581@N00,886,16,1334469044,1334469464,2,2,420
15409581@N00,886,2,1334475491,1334475551,1,2,60
15409581@N00,887,14,1341729185,1341729545,1,1,360
15409581@N00,888,19,1374898776,1374899316,2,3,540
15409581@N00,888,7,1374917021,1374917141,2,3,120
15409581@N00,888,6,1374919996,1374920116,1,3,120
15409581@N00,889,14,1375577391,1375577751,6,11,360
15409581@N00,889,7,1375585681,1375585801,2,11,120
15409581@N00,889,18,1375586460,1375587000,3,11,540
15409581@N00,889,7,1375587873,1375587993,4,11,120
15409581@N00,889,23,1375591312,1375592512,3,11,1200
15409581@N00,889,25,1375596920,1375599020,3,11,2100
15409581@N00,889,13,1375602926,1375603015,2,11,89
15409581@N00,889,25,1375603015,1375603080,2,11,65
15409581@N00,889,13,1375603080,1375603380,2,11,300
15409581@N00,889,22,1375603845,1375604865,4,11,1020
15409581@N00,889,24,1375617634,1375619134,1,11,1500
15409581@N00,890,14,1380931590,1380931950,4,2,360
15409581@N00,890,19,1380957672,1380958212,1,2,540
15463022@N02,891,12,1193203666,1193203936,1,1,270
15468918@N00,892,12,1361145396,1361145666,2,14,270
15468918@N00,892,19,1361145680,1361146220,2,14,540
15468918@N00,892,24,1361146369,1361146412,2,14,43
15468918@N00,892,12,1361146412,1361146682,2,14,270
15468918@N00,892,22,1361146767,1361146817,2,14,50
15468918@N00,892,13,1361146817,1361147117,2,14,300
15468918@N00,892,22,1361148722,1361149742,2,14,1020
15468918@N00,892,14,1361151000,1361151360,2,14,360
15468918@N00,892,18,1361154224,1361154257,2,14,33
15468918@N00,892,23,1361154257,1361154392,2,14,135
15468918@N00,892,18,1361154392,1361154553,5,14,161
15468918@N00,892,16,1361154553,1361154973,2,14,420
15468918@N00,892,18,1361157385,1361157925,5,14,540
15468918@N00,892,12,1361160943,1361161213,2,14,270
15468918@N00,893,12,1361350217,1361350487,2,4,270
15468918@N00,893,19,1361350521,1361350574,3,4,53
15468918@N00,893,14,1361350574,1361350934,6,4,360
15468918@N00,893,16,1361354642,1361355062,36,4,420
15468918@N00,894,16,1392512779,1392513199,2,2,420
15468918@N00,894,10,1392513721,1392513871,1,2,150
15474023@N03,895,24,1229724534,1229726034,10,1,1500
15474023@N03,896,6,1229912806,1229912926,4,1,120
15474023@N03,897,6,1259295550,1259295670,4,1,120
15474023@N03,898,8,1409343472,1409343592,2,2,120
15474023@N03,898,16,1409343715,1409344135,2,2,420
15474023@N03,899,7,1409381224,1409381344,2,8,120
15474023@N03,899,11,1409383402,1409383642,2,8,240
15474023@N03,899,7,1409386320,1409386440,2,8,120
15474023@N03,899,18,1409390386,1409390926,3,8,540
15474023@N03,899,16,1409391782,1409392202,2,8,420
15474023@N03,899,6,1409392214,1409392240,2,8,26
15474023@N03,899,19,1409392240,1409392278,2,8,38
15474023@N03,899,14,1409392278,1409392638,4,8,360
15474023@N03,900,10,1409431772,1409431922,1,1,150
15474023@N03,901,16,1409485257,1409485677,1,1,420
15532592@N00,902,19,1353187929,1353188469,1,1,540
15532592@N00,903,7,1393128286,1393128406,2,2,120
15532592@N00,903,17,1393144127,1393144547,1,2,420
15532592@N00,904,14,1393203114,1393203474,1,1,360
15532592@N00,905,17,1405863326,1405863746,1,1,420
15532592@N00,906,7,1415577764,1415577884,1,1,120
15533594@N00,907,12,1192881127,1192881397,2,1,270
15533594@N00,908,16,1371268175,1371268595,1,1,420
15533594@N00,909,17,1403771984,1403772404,1,1,420
15771726@N05,910,6,1357350762,1357350882,2,2,120
15771726@N05,910,15,1357359138,1357359498,1,2,360
15778445@N02,911,14,1391853178,1391853538,4,3,360
15778445@N02,911,7,1391853622,1391853742,2,3,120
15778445@N02,911,12,1391854772,1391855042,2,3,270
15834837@N08,912,19,1375925740,1375925898,2,4,158
15834837@N08,912,14,1375925898,1375926258,4,4,360
15834837@N08,912,8,1375927640,1375927652,2,4,12
15834837@N08,912,14,1375927652,1375928012,1,4,360
15935500@N02,913,6,1405894948,1405895068,1,1,120
15935500@N02,914,4,1408701965,1408702055,2,1,90
15935500@N02,915,16,1408754469,1408754889,2,3,420
15935500@N02,915,12,1408781663,1408781933,3,3,270
15935500@N02,915,24,1408782350,1408783850,1,3,1500
15935500@N02,916,4,1410521475,1410521565,2,1,90
15935500@N02,917,19,1425761184,1425761582,2,3,398
15935500@N02,917,7,1425761582,1425761702,8,3,120
15935500@N02,917,19,1425767098,1425767638,3,3,540
15935500@N02,918,12,1433045668,1433045938,1,1,270
15935500@N02,919,20,1446754694,1446755294,1,1,600
15935500@N02,920,16,1451802415,1451802835,2,2,420
15935500@N02,920,4,1451809412,1451809502,5,2,90
15935500@N02,921,19,1469923116,1469923656,3,6,540
15935500@N02,921,7,1469940340,1469940373,3,6,33
15935500@N02,921,11,1469940373,1469940549,2,6,176
15935500@N02,921,19,1469940549,1469941089,5,6,540
15935500@N02,921,11,1469951457,1469951697,5,6,240
15935500@N02,921,19,1469952238,1469952778,5,6,540
16035349@N05,922,5,1266200184,1266200304,2,2,120
16035349@N05,922,18,1266206612,1266207152,2,2,540
16071565@N00,923,14,1422314873,1422315233,2,2,360
16071565@N00,923,22,1422322227,1422323247,1,2,1020
16093042@N00,924,1,1345868236,1345868296,2,2,60
16093042@N00,924,15,1345877630,1345877990,1,2,360
16093042@N00,925,19,1379822787,1379823327,2,2,540
16093042@N00,925,4,1379832590,1379832680,1,2,90
16103221@N04,926,15,1328403933,1328404293,1,1,360
16131811@N00,927,19,1340170274,1340170814,2,1,540
16222234@N00,928,17,1445060842,1445061262,3,1,420
16222234@N00,929,17,1445116461,1445116881,1,1,420
16272116@N03,930,25,1259828613,1259830713,2,2,2100
16272116@N03,930,12,1259842354,1259842624,1,2,270
16272116@N03,931,7,1263715080,1263715200,1,1,120
16272116@N03,932,16,1282651673,1282652093,1,1,420
16272116@N03,933,2,1303279750,1303279766,2,3,16
16272116@N03,933,16,1303279766,1303279781,2,3,15
16272116@N03,933,12,1303279781,1303280051,1,3,270
16336194@N00,934,16,1410419442,1410419697,2,2,255
16336194@N00,934,14,1410419697,1410420057,1,2,360
16336194@N00,935,17,1415062877,1415063297,2,2,420
16336194@N00,935,14,1415070518,1415070878,11,2,360
16336194@N00,936,22,1446609138,1446609295,2,4,157
16336194@N00,936,15,1446609295,1446609655,3,4,360
16336194@N00,936,16,1446612208,1446612628,2,4,420
16336194@N00,936,18,1446614876,1446615416,1,4,540
16438861@N00,937,14,1353910371,1353910731,2,3,360
16438861@N00,937,12,1353928104,1353928167,2,3,63
16438861@N00,937,16,1353928167,1353928587,1,3,420
16438861@N00,938,3,1381650026,1381650116,1,1,90
16442000@N00,939,18,1426982857,1426983397,5,2,540
16442000@N00,939,5,1426994899,1426995019,1,2,120
16442000@N00,940,25,1431856421,1431858521,14,1,2100
16442000@N00,941,5,1438476404,1438476406,2,5,2
16442000@N00,941,6,1438476406,1438476526,3,5,120
16442000@N00,941,9,1438480445,1438480450,3,5,5
16442000@N00,941,2,1438480450,1438480464,2,5,14
16442000@N00,941,9,1438480464,1438480584,2,5,120
16562518@N00,942,12,1251770275,1251770545,1,1,270
16562518@N00,943,12,1251867077,1251867347,1,1,270
16572880@N08,944,24,1379478358,1379479858,1,1,1500
16591891@N00,945,8,1339908673,1339908793,75,1,120
16591891@N00,946,13,1362044817,1362045117,1,1,300
16591891@N00,947,19,1390707287,1390707827,1,1,540
16591891@N00,948,10,1394351603,1394351753,2,1,150
16591891@N00,949,19,1405520285,1405520825,1,1,540
16591891@N00,950,17,1430626751,1430627171,1,1,420
16591891@N00,951,23,1441599550,1441600750,1,1,1200
16613671@N00,952,6,1465090092,1465090212,1,1,120
16712945@N00,953,14,1355298184,1355298544,9,1,360
16811913@N00,954,12,1334106700,1334106970,1,1,270
16811913@N00,955,14,1346030747,1346031107,1,1,360
16811913@N00,956,15,1346116316,1346116676,1,1,360
16811913@N00,957,14,1346231219,1346231579,1,1,360
16811913@N00,958,14,1346323680,1346324040,1,1,360
16813616@N00,959,24,1328258484,1328259984,2,1,1500
16813616@N00,960,8,1330659590,1330659710,1,1,120
16813616@N00,961,24,1361708694,1361710194,1,1,1500
16813616@N00,962,12,1393286992,1393287262,1,1,270
16911222@N04,963,12,1365114483,1365114753,1,1,270
17076493@N00,964,24,1237848971,1237850471,13,1,1500
17076493@N00,965,24,1238108741,1238110241,8,1,1500
17076493@N00,966,24,1238302808,1238304308,1,1,1500
17221717@N02,967,10,1341025419,1341025569,1,1,150
17221717@N02,968,14,1360978316,1360978676,1,1,360
17221717@N02,969,3,1365842549,1365842639,1,1,90
17221717@N02,970,7,1367652889,1367653009,3,2,120
17221717@N02,970,23,1367658220,1367659420,1,2,1200
17221717@N02,971,11,1373687233,1373687288,2,2,55
17221717@N02,971,7,1373687288,1373687408,2,2,120
17529682@N05,972,12,1202023298,1202023568,1,1,270
17596088@N00,973,12,1348218156,1348218426,1,1,270
17644792@N00,974,17,1220875378,1220875798,1,1,420
17726320@N03,975,12,1405243875,1405244145,5,1,270
17726320@N03,976,3,1421626204,1421626229,2,7,25
17726320@N03,976,10,1421626229,1421626347,2,7,118
17726320@N03,976,16,1421626347,1421626424,3,7,77
17726320@N03,976,3,1421626424,1421626514,2,7,90
17726320@N03,976,16,1421626515,1421626595,2,7,80
17726320@N03,976,3,1421626595,1421626685,2,7,90
17726320@N03,976,16,1421626706,1421627126,2,7,420
17760597@N04,977,21,1341368308,1341369208,1,1,900
17955069@N04,978,12,1189973833,1189974103,1,1,270
17989686@N00,979,7,1254470015,1254470135,1,1,120
18026860@N03,980,9,1348547007,1348547127,5,13,120
18026860@N03,980,11,1348552293,1348552533,3,13,240
18026860@N03,980,19,1348553983,1348554523,2,13,540
18026860@N03,980,9,1348555006,1348555126,2,13,120
18026860@N03,980,6,1348555744,1348555864,2,13,120
18026860@N03,980,24,1348556365,1348556640,2,13,275
18026860@N03,980,12,1348556640,1348556717,2,13,77
18026860@N03,980,9,1348556717,1348556837,2,13,120
18026860@N03,980,12,1348556840,1348557042,2,13,202
18026860@N03,980,17,1348557042,1348557373,3,13,331
18026860@N03,980,9,1348557373,1348557493,3,13,120
18026860@N03,980,23,1348557673,1348558873,2,13,1200
18026860@N03,980,9,1348559651,1348559771,6,13,120
18027113@N07,981,24,1302430463,1302431963,3,1,1500
18111184@N00,982,5,1339209327,1339209447,1,1,120
18325240@N00,983,7,1346925665,1346925785,1,1,120
18366889@N00,984,12,1440369274,1440369544,2,21,270
18366889@N00,984,24,1440369946,1440371078,5,21,1132
18366889@N00,984,19,1440371078,1440371156,2,21,78
18366889@N00,984,6,1440371156,1440371276,9,21,120
18366889@N00,984,8,1440373203,1440373294,3,21,91
18366889@N00,984,14,1440373294,1440373654,7,21,360
18366889@N00,984,6,1440374058,1440374178,2,21,120
18366889@N00,984,14,1440374483,1440374843,9,21,360
18366889@N00,984,6,1440380449,1440380569,2,21,120
18366889@N00,984,25,1440387654,1440389754,2,21,2100
18366889@N00,984,16,1440391168,1440391588,3,21,420
18366889@N00,984,7,1440396878,1440396998,2,21,120
18366889@N00,984,16,1440397442,1440397862,3,21,420
18366889@N00,984,7,1440397978,1440398098,4,21,120
18366889@N00,984,10,1440404813,1440404963,3,21,150
18366889@N00,984,1,1440405670,1440405730,2,21,60
18366889@N00,984,18,1440407226,1440407766,4,21,540
18366889@N00,984,6,1440409344,1440409464,4,21,120
18366889@N00,984,19,1440409815,1440409929,2,21,114
18366889@N00,984,14,1440409929,1440410289,21,21,360
18366889@N00,984,6,1440411482,1440411602,1,21,120
18366889@N00,985,14,1440501604,1440501964,1,1,360
18366889@N00,986,20,1440547164,1440547764,3,16,600
18366889@N00,986,6,1440548441,1440548561,4,16,120
18366889@N00,986,14,1440550902,1440551262,2,16,360
18366889@N00,986,6,1440551421,1440551541,11,16,120
18366889@N00,986,24,1440552750,1440554250,2,16,1500
18366889@N00,986,14,1440556226,1440556586,2,16,360
18366889@N00,986,19,1440557432,1440557972,2,16,540
18366889@N00,986,24,1440564767,1440566267,21,16,1500
18366889@N00,986,6,1440589179,1440589299,5,16,120
18366889@N00,986,14,1440589649,1440589709,2,16,60
18366889@N00,986,6,1440589709,1440589829,3,16,120
18366889@N00,986,19,1440589865,1440589978,2,16,113
18366889@N00,986,14,1440589978,1440590286,7,16,308
18366889@N00,986,19,1440590286,1440590363,2,16,77
18366889@N00,986,6,1440590363,1440590483,2,16,120
18366889@N00,986,19,1440590822,1440591362,3,16,540
18366889@N00,987,19,1440752842,1440753382,6,6,540
18366889@N00,987,6,1440754245,1440754365,2,6,120
18366889@N00,987,19,1440757643,1440757700,3,6,57
18366889@N00,987,6,1440757700,1440757820,2,6,120
18366889@N00,987,19,1440757940,1440758042,2,6,102
18366889@N00,987,16,1440758042,1440758462,1,6,420
18384077@N00,988,12,1331373936,1331374206,2,2,270
18384077@N00,988,11,1331376907,1331377147,1,2,240
18384077@N00,989,14,1344840029,1344840389,2,1,360
18753948@N00,990,18,1289472878,1289473418,4,1,540
18753948@N00,991,16,1289522654,1289523074,1,1,420
18753948@N00,992,18,1289551494,1289552034,2,1,540
18753948@N00,993,13,1289611793,1289612093,2,1,300
18753948@N00,994,17,1414369696,1414370116,10,1,420
18753948@N00,995,17,1414533149,1414533569,2,1,420
18753948@N00,996,17,1414565106,1414565526,4,1,420
18753948@N00,997,17,1414645004,1414645424,9,1,420
18753948@N00,998,17,1414700066,1414700486,1,1,420
18763213@N00,999,12,1360972032,1360972302,1,1,270
18837886@N00,1000,10,1391769408,1391769558,1,1,150
18840194@N02,1001,12,1218676210,1218676480,1,1,270
18953624@N00,1002,11,1301009455,1301009695,1,1,240
18963732@N06,1003,24,1408003227,1408003451,2,8,224
18963732@N06,1003,19,1408003451,1408003991,3,8,540
18963732@N06,1003,15,1408006962,1408007322,3,8,360
18963732@N06,1003,10,1408013609,1408013759,3,8,150
18963732@N06,1003,24,1408024574,1408024748,3,8,174
18963732@N06,1003,17,1408024748,1408025078,2,8,330
18963732@N06,1003,7,1408025078,1408025198,2,8,120
18963732@N06,1003,14,1408025209,1408025569,1,8,360
18966792@N00,1004,16,1429007379,1429007799,7,1,420
19026178@N00,1005,15,1272521042,1272521402,3,1,360
19026178@N00,1006,20,1340769233,1340769833,42,1,600
19027415@N00,1007,12,1295847182,1295847452,1,1,270
19027415@N00,1008,16,1296257417,1296257837,1,1,420
19027415@N00,1009,17,1296809399,1296809819,1,1,420
19174219@N00,1010,24,1225504158,1225505658,1,1,1500
19216095@N00,1011,12,1340569945,1340570215,1,1,270
19302008@N00,1012,17,1435397312,1435397732,2,2,420
19302008@N00,1012,25,1435404116,1435406216,1,2,2100
19302008@N00,1013,20,1435465468,1435466068,1,1,600
19302008@N00,1014,14,1437191311,1437191671,1,1,360
19302008@N00,1015,14,1437277210,1437277570,1,1,360
19329919@N00,1016,15,1289524475,1289524835,2,3,360
19329919@N00,1016,11,1289542820,1289543060,2,3,240
19329919@N00,1016,25,1289552907,1289555007,1,3,2100
19452106@N00,1017,19,1344049339,1344049879,2,4,540
19452106@N00,1017,10,1344053267,1344053417,2,4,150
19452106@N00,1017,18,1344058883,1344059423,2,4,540
19452106@N00,1017,10,1344082658,1344082808,2,4,150
19466493@N00,1018,7,1469779919,1469780039,1,1,120
19467401@N00,1019,13,1349000205,1349000505,18,2,300
19467401@N00,1019,14,1349000957,1349001317,21,2,360
19482074@N00,1020,12,1277018892,1277019162,1,1,270
19527814@N06,1021,23,1290499362,1290500562,1,1,1200
19567516@N00,1022,12,1462230623,1462230893,2,18,270
19567516@N00,1022,19,1462231000,1462231032,8,18,32
19567516@N00,1022,6,1462231032,1462231038,2,18,6
19567516@N00,1022,19,1462231038,1462231578,6,18,540
19567516@N00,1022,14,1462231769,1462232129,16,18,360
19567516@N00,1022,19,1462234225,1462234585,2,18,360
19567516@N00,1022,23,1462234585,1462235785,3,18,1200
19567516@N00,1022,12,1462238524,1462238794,2,18,270
19567516@N00,1022,3,1462241412,1462241502,8,18,90
19567516@N00,1022,16,1462249598,1462249606,2,18,8
19567516@N00,1022,3,1462249606,1462249655,3,18,49
19567516@N00,1022,19,1462249655,1462249986,2,18,331
19567516@N00,1022,3,1462249986,1462249995,2,18,9
19567516@N00,1022,19,1462249995,1462250535,2,18,540
19567516@N00,1022,14,1462265257,1462265617,5,18,360
19567516@N00,1022,16,1462271246,1462271396,2,18,150
19567516@N00,1022,3,1462271396,1462271397,2,18,1
19567516@N00,1022,16,1462271397,1462271817,1,18,420
19575849@N00,1023,20,1384209650,1384210250,2,2,600
19575849@N00,1023,12,1384228283,1384228553,1,2,270
19581463@N06,1024,18,1327214322,1327214862,1,1,540
19709423@N04,1025,16,1215169948,1215170368,1,1,420
19709423@N04,1026,15,1384134260,1384134620,1,1,360
19709423@N04,1027,3,1442117165,1442117255,1,1,90
19712216@N08,1028,18,1236503355,1236503360,2,2,5
19712216@N08,1028,24,1236503360,1236504860,1,2,1500
19712216@N08,1029,22,1238037119,1238037775,2,3,656
19712216@N08,1029,25,1238037775,1238039244,3,3,1469
19712216@N08,1029,8,1238039244,1238039364,3,3,120
19712216@N08,1030,24,1243464246,1243465746,4,1,1500
19712216@N08,1031,15,1267760439,1267760799,4,1,360
19712216@N08,1032,22,1311648927,1311649947,4,2,1020
19712216@N08,1032,25,1311651183,1311653283,1,2,2100
19714819@N00,1033,1,1423357592,1423357652,1,1,60
19797342@N00,1034,24,1370321366,1370322866,1,1,1500
19797342@N00,1035,18,1406080674,1406081214,1,1,540
19797342@N00,1036,23,1432552098,1432553298,1,1,1200
19797342@N00,1037,17,1432644531,1432644951,1,1,420
19898864@N00,1038,12,1231136479,1231136749,1,1,270
19944325@N00,1039,3,1379746973,1379747063,1,1,90
19944325@N00,1040,17,1440668924,1440669344,1,1,420
19955759@N00,1041,20,1450510674,1450511274,1,1,600
20009658@N00,1042,5,1224817836,1224817956,1,1,120
20154444@N04,1043,16,1469942028,1469942448,1,1,420
20163306@N00,1044,24,1228618368,1228618441,2,5,73
20163306@N00,1044,20,1228618441,1228618470,2,5,29
20163306@N00,1044,6,1228618470,1228618590,2,5,120
20163306@N00,1044,16,1228618600,1228618817,2,5,217
20163306@N00,1044,11,1228618817,1228619057,3,5,240
20163306@N00,1045,7,1228650776,1228650896,8,1,120
20220624@N03,1046,12,1355635463,1355635733,1,1,270
20306506@N08,1047,23,1309154187,1309154189,2,33,2
20306506@N08,1047,16,1309154189,1309154429,5,33,240
20306506@N08,1047,3,1309154429,1309154519,4,33,90
20306506@N08,1047,18,1309154828,1309155368,11,33,540
20306506@N08,1047,11,1309159022,1309159262,3,33,240
20306506@N08,1047,7,1309159397,1309159517,8,33,120
20306506@N08,1047,18,1309159605,1309160145,26,33,540
20306506@N08,1047,4,1309165478,1309165562,12,33,84
20306506@N08,1047,15,1309165562,1309165568,2,33,6
20306506@N08,1047,8,1309165568,1309165588,3,33,20
20306506@N08,1047,20,1309165588,1309165678,2,33,90
20306506@N08,1047,19,1309165678,1309165788,5,33,110
20306506@N08,1047,11,1309165788,1309165794,2,33,6
20306506@N08,1047,7,1309165794,1309165889,3,33,95
20306506@N08,1047,18,1309165889,1309165897,2,33,8
20306506@N08,1047,7,1309165897,1309166017,2,33,120
20306506@N08,1047,18,1309166824,1309167364,2,33,540
20306506@N08,1047,1,1309168363,1309168373,3,33,10
20306506@N08,1047,5,1309168373,1309168406,3,33,33
20306506@N08,1047,1,1309168406,1309168466,8,33,60
20306506@N08,1047,10,1309168512,1309168662,2,33,150
20306506@N08,1047,1,1309168877,1309168884,2,33,7
20306506@N08,1047,17,1309168884,1309169287,13,33,403
20306506@N08,1047,3,1309169287,1309169377,2,33,90
20306506@N08,1047,23,1309170929,1309171493,4,33,564
20306506@N08,1047,17,1309171493,1309171913,2,33,420
20306506@N08,1047,13,1309173018,1309173026,5,33,8
20306506@N08,1047,12,1309173026,1309173033,2,33,7
20306506@N08,1047,25,1309173033,1309173034,2,33,1
20306506@N08,1047,12,1309173034,1309173035,2,33,1
20306506@N08,1047,25,1309173035,1309173355,3,33,320
20306506@N08,1047,13,1309173355,1309173655,13,33,300
20306506@N08,1047,15,1309173670,1309174030,2,33,360
20319059@N06,1048,12,1217292508,1217292720,4,8,212
20319059@N06,1048,17,1217292720,1217293140,6,8,420
20319059@N06,1048,23,1217293474,1217293635,6,8,161
20319059@N06,1048,16,1217293635,1217293975,5,8,340
20319059@N06,1048,11,1217293975,1217294215,4,8,240
20319059@N06,1048,7,1217294742,1217294862,7,8,120
20319059@N06,1048,10,1217296223,1217296373,12,8,150
20319059@N06,1048,24,1217298260,1217299760,2,8,1500
20319059@N06,1049,12,1217382367,1217382637,4,1,270
20319059@N06,1050,12,1218858818,1218859088,15,7,270
20319059@N06,1050,24,1218859403,1218860903,3,7,1500
20319059@N06,1050,13,1218861631,1218861931,4,7,300
20319059@N06,1050,22,1218862143,1218863163,7,7,1020
20319059@N06,1050,13,1218864748,1218865048,3,7,300
20319059@N06,1050,12,1218868370,1218868640,5,7,270
20319059@N06,1050,20,1218874183,1218874783,5,7,600
20319059@N06,1051,12,1221214861,1221214956,2,8,95
20319059@N06,1051,24,1221214956,1221215170,3,8,214
20319059@N06,1051,20,1221215170,1221215345,2,8,175
20319059@N06,1051,6,1221215345,1221215465,3,8,120
20319059@N06,1051,19,1221215753,1221216293,6,8,540
20319059@N06,1051,16,1221217003,1221217423,8,8,420
20319059@N06,1051,10,1221217716,1221217866,4,8,150
20319059@N06,1051,23,1221218584,1221219784,2,8,1200
20319059@N06,1052,24,1221267466,1221268966,4,14,1500
20319059@N06,1052,11,1221270089,1221270329,2,14,240
20319059@N06,1052,7,1221270534,1221270654,8,14,120
20319059@N06,1052,16,1221273183,1221273410,3,14,227
20319059@N06,1052,6,1221273410,1221273530,4,14,120
20319059@N06,1052,20,1221273654,1221274254,7,14,600
20319059@N06,1052,6,1221274564,1221274684,6,14,120
20319059@N06,1052,23,1221276255,1221277455,3,14,1200
20319059@N06,1052,19,1221280851,1221281391,3,14,540
20319059@N06,1052,23,1221283494,1221283834,5,14,340
20319059@N06,1052,17,1221283834,1221284254,5,14,420
20319059@N06,1052,16,1221299672,1221300092,2,14,420
20319059@N06,1052,17,1221301260,1221301574,2,14,314
20319059@N06,1052,23,1221301574,1221302774,6,14,1200
20319059@N06,1053,12,1225515282,1225515552,5,7,270
20319059@N06,1053,22,1225515893,1225516913,6,7,1020
20319059@N06,1053,6,1225520292,1225520412,3,7,120
20319059@N06,1053,8,1225520479,1225520599,3,7,120
20319059@N06,1053,4,1225521060,1225521150,5,7,90
20319059@N06,1053,16,1225523012,1225523432,3,7,420
20319059@N06,1053,12,1225527125,1225527395,2,7,270
20319059@N06,1054,12,1227313787,1227314057,2,1,270
20319059@N06,1055,17,1237004632,1237004993,7,2,361
20319059@N06,1055,16,1237004993,1237005413,4,2,420
20319059@N06,1056,12,1243653997,1243654267,3,12,270
20319059@N06,1056,20,1243654579,1243655179,2,12,600
20319059@N06,1056,19,1243655538,1243656078,8,12,540
20319059@N06,1056,16,1243656224,1243656466,2,12,242
20319059@N06,1056,17,1243656466,1243656886,2,12,420
20319059@N06,1056,22,1243658177,1243658992,4,12,815
20319059@N06,1056,13,1243658992,1243659292,2,12,300
20319059@N06,1056,22,1243659619,1243660151,3,12,532
20319059@N06,1056,13,1243660151,1243660451,8,12,300
20319059@N06,1056,19,1243663947,1243664096,2,12,149
20319059@N06,1056,16,1243664096,1243664472,2,12,376
20319059@N06,1056,23,1243664472,1243665672,3,12,1200
20319059@N06,1057,12,1243729731,1243730001,4,1,270
20319059@N06,1058,12,1274497585,1274497855,2,3,270
20319059@N06,1058,19,1274507907,1274508447,3,3,540
20319059@N06,1058,12,1274510529,1274510799,1,3,270
20319059@N06,1059,12,1311989939,1311990209,4,6,270
20319059@N06,1059,16,1311996535,1311996955,19,6,420
20319059@N06,1059,12,1311999853,1312000123,5,6,270
20319059@N06,1059,7,1312015207,1312015327,3,6,120
20319059@N06,1059,16,1312023114,1312023183,2,6,69
20319059@N06,1059,18,1312023183,1312023723,2,6,540
20319059@N06,1060,19,1312078295,1312078835,2,19,540
20319059@N06,1060,15,1312092712,1312093072,2,19,360
20319059@N06,1060,19,1312093619,1312094159,2,19,540
20319059@N06,1060,24,1312106376,1312107876,2,19,1500
20319059@N06,1060,22,1312108504,1312109005,2,19,501
20319059@N06,1060,19,1312109005,1312109545,3,19,540
20319059@N06,1060,12,1312110530,1312110652,2,19,122
20319059@N06,1060,19,1312110652,1312111192,2,19,540
20319059@N06,1060,13,1312114076,1312114135,2,19,59
20319059@N06,1060,25,1312114135,1312114278,3,19,143
20319059@N06,1060,13,1312114278,1312114378,2,19,100
20319059@N06,1060,25,1312114378,1312114433,3,19,55
20319059@N06,1060,13,1312114433,1312114481,3,19,48
20319059@N06,1060,22,1312114481,1312114577,2,19,96
20319059@N06,1060,24,1312114577,1312114837,5,19,260
20319059@N06,1060,13,1312114837,1312114896,2,19,59
20319059@N06,1060,22,1312114896,1312115001,4,19,105
20319059@N06,1060,24,1312115001,1312116100,9,19,1099
20319059@N06,1060,12,1312116100,1312116370,4,19,270
20322483@N05,1061,12,1200611295,1200611565,1,1,270
20322483@N05,1062,1,1200671030,1200671090,3,3,60
20322483@N05,1062,10,1200673176,1200673326,2,3,150
20322483@N05,1062,25,1200677558,1200679658,2,3,2100
20322483@N05,1063,16,1200740415,1200740835,2,1,420
20363327@N00,1064,18,1291611856,1291612396,1,1,540
20478898@N04,1065,18,1442633073,1442633613,1,1,540
20496242@N00,1066,7,1317271921,1317272041,1,1,120
20521043@N03,1067,17,1287809812,1287810232,1,1,420
20558299@N07,1068,24,1447376625,1447378125,2,1,1500
20635459@N00,1069,14,1354776835,1354777195,1,1,360
20635459@N00,1070,14,1366274744,1366275104,1,1,360
20642429@N00,1071,14,1332819813,1332820173,5,5,360
20642429@N00,1071,11,1332821338,1332821578,3,5,240
20642429@N00,1071,14,1332822715,1332823075,2,5,360
20642429@N00,1071,11,1332824399,1332824639,2,5,240
20642429@N00,1071,14,1332825117,1332825477,19,5,360
20826856@N04,1072,19,1377920258,1377920798,2,2,540
20826856@N04,1072,18,1377922531,1377923071,1,2,540
20864470@N00,1073,12,1338642268,1338642538,1,1,270
20909536@N02,1074,17,1433154255,1433154675,1,1,420
20910424@N07,1075,24,1375323546,1375325046,2,1,1500
20953529@N03,1076,25,1306478172,1306480272,1,1,2100
20953529@N03,1077,24,1306584065,1306585565,2,2,1500
20953529@N03,1077,7,1306588106,1306588226,1,2,120
20962557@N07,1078,16,1362473029,1362473449,2,2,420
20962557@N07,1078,10,1362476780,1362476930,1,2,150
20962557@N07,1079,16,1362800077,1362800497,1,1,420
21035134@N07,1080,12,1311470479,1311470749,43,1,270
21045988@N07,1081,14,1350599071,1350599431,1,1,360
21050065@N06,1082,12,1250835581,1250835851,4,1,270
21050065@N06,1083,12,1250911248,1250911518,2,1,270
21050065@N06,1084,7,1319272797,1319272917,1,1,120
21050065@N06,1085,7,1383860895,1383861015,1,1,120
21068473@N06,1086,19,1452750976,1452751516,1,1,540
21073818@N00,1087,14,1372834575,1372834935,1,1,360
21077668@N06,1088,19,1429403485,1429404025,3,1,540
21089047@N06,1089,5,1254182400,1254182520,90,1,120
21125890@N00,1090,19,1344296187,1344296727,1,1,540
21129002@N00,1091,24,1255752397,1255753897,1,1,1500
21228638@N00,1092,18,1220249036,1220249576,3,5,540
21228638@N00,1092,7,1220250203,1220250323,4,5,120
21228638@N00,1092,18,1220251113,1220251310,3,5,197
21228638@N00,1092,5,1220251310,1220251430,3,5,120
21228638@N00,1092,1,1220252067,1220252127,1,5,60
21228638@N00,1093,18,1226557529,1226558069,1,1,540
21228638@N00,1094,11,1226918157,1226918397,2,1,240
21228638@N00,1095,11,1227259802,1227260042,3,1,240
21228638@N00,1096,11,1291419470,1291419710,1,1,240
21313533@N02,1097,19,1349672988,1349673528,1,1,540
21313533@N02,1098,25,1379032958,1379035058,1,1,2100
21313533@N02,1099,13,1379070591,1379070891,1,1,300
21313533@N02,1100,3,1390468361,1390468451,1,1,90
21313533@N02,1101,16,1390521163,1390521583,2,1,420
21313533@N02,1102,12,1461906092,1461906362,1,1,270
21313845@N06,1103,16,1354654276,1354654696,8,1,420
21314760@N00,1104,16,1202541848,1202542268,2,2,420
21314760@N00,1104,2,1202549973,1202550033,1,2,60
21314760@N00,1105,17,1202981511,1202981931,1,1,420
21327522@N04,1106,24,1247153860,1247155360,2,1,1500
21358387@N02,1107,13,1323476693,1323476993,1,1,300
21392573@N02,1108,12,1196816585,1196816855,4,6,270
21392573@N02,1108,17,1196819792,1196820212,5,6,420
21392573@N02,1108,19,1196820363,1196820903,2,6,540
21392573@N02,1108,23,1196821674,1196822874,3,6,1200
21392573@N02,1108,24,1196823832,1196825332,5,6,1500
21392573@N02,1108,12,1196847415,1196847685,1,6,270
21407390@N00,1109,16,1287480763,1287481183,1,1,420
21435190@N00,1110,7,1296517989,1296518109,28,1,120
21435190@N00,1111,7,1296554711,1296554831,1,1,120
21447068@N04,1112,14,1332390211,1332390571,1,1,360
21488463@N07,1113,25,1193878676,1193879990,2,2,1314
21488463@N07,1113,19,1193879990,1193880530,1,2,540
21497668@N08,1114,3,1406694186,1406694276,2,1,90
21522703@N00,1115,6,1347940385,1347940505,1,1,120
21532305@N05,1116,17,1432800370,1432800790,2,1,420
21532305@N05,1117,17,1432874599,1432875019,5,1,420
21535817@N00,1118,12,1377914193,1377914463,1,1,270
21541710@N00,1119,18,1213519394,1213519934,4,1,540
21541710@N00,1120,12,1229759097,1229759367,1,1,270
21591624@N00,1121,19,1373595695,1373596235,14,7,540
21591624@N00,1121,18,1373598652,1373599192,2,7,540
21591624@N00,1121,15,1373613386,1373613746,2,7,360
21591624@N00,1121,25,1373615008,1373617108,8,7,2100
21591624@N00,1121,13,1373619083,1373619383,4,7,300
21591624@N00,1121,19,1373620098,1373620638,41,7,540
21591624@N00,1121,18,1373636774,1373637314,11,7,540
21597019@N06,1122,24,1233967617,1233969117,3,1,1500
21597019@N06,1123,24,1243142634,1243144134,3,2,1500
21597019@N06,1123,12,1243170986,1243171256,1,2,270
21681738@N03,1124,23,1332060984,1332062184,1,1,1200
21681738@N03,1125,10,1332129792,1332129942,1,1,150
21739162@N04,1126,22,1240985775,1240985831,2,2,56
21739162@N04,1126,24,1240985831,1240987331,1,2,1500
21739162@N04,1127,18,1323567255,1323567795,1,1,540
21739162@N04,1128,14,1346623807,1346624167,4,1,360
21748548@N00,1129,17,1280191386,1280191806,2,8,420
21748548@N00,1129,20,1280198405,1280199005,2,8,600
21748548@N00,1129,25,1280208811,1280210911,4,8,2100
21748548@N00,1129,13,1280213102,1280213402,3,8,300
21748548@N00,1129,18,1280220766,1280220825,2,8,59
21748548@N00,1129,7,1280220825,1280220945,2,8,120
21748548@N00,1129,16,1280225816,1280226236,8,8,420
21748548@N00,1129,7,1280229648,1280229768,1,8,120
21748548@N00,1130,7,1280363426,1280363546,2,2,120
21748548@N00,1130,18,1280364488,1280365028,4,2,540
21748548@N00,1131,24,1280400095,1280401595,2,1,1500
21748548@N00,1132,11,1301975463,1301975470,2,3,7
21748548@N00,1132,7,1301975470,1301975590,2,3,120
21748548@N00,1132,25,1301978362,1301980462,6,3,2100
21748548@N00,1133,16,1313814479,1313814578,2,8,99
21748548@N00,1133,10,1313814578,1313814677,2,8,99
21748548@N00,1133,16,1313814677,1313814783,2,8,106
21748548@N00,1133,23,1313814783,1313814796,2,8,13
21748548@N00,1133,16,1313814796,1313814947,4,8,151
21748548@N00,1133,23,1313814947,1313815007,2,8,60
21748548@N00,1133,16,1313815007,1313815427,5,8,420
21748548@N00,1133,24,1313816687,1313818187,2,8,1500
21748548@N00,1134,24,1376522970,1376524470,3,1,1500
21857090@N08,1135,23,1189260856,1189262056,2,4,1200
21857090@N08,1135,3,1189262322,1189262412,3,4,90
21857090@N08,1135,16,1189264667,1189265087,2,4,420
21857090@N08,1135,20,1189265845,1189266445,1,4,600
21897757@N00,1136,12,1226130838,1226131108,1,1,270
21897757@N00,1137,15,1323051333,1323051693,2,9,360
21897757@N00,1137,8,1323052363,1323052483,2,9,120
21897757@N00,1137,16,1323053102,1323053522,2,9,420
21897757@N00,1137,5,1323053607,1323053727,2,9,120
21897757@N00,1137,18,1323055419,1323055959,2,9,540
21897757@N00,1137,11,1323056276,1323056516,3,9,240
21897757@N00,1137,7,1323061633,1323061753,2,9,120
21897757@N00,1137,16,1323063489,1323063784,2,9,295
21897757@N00,1137,23,1323063784,1323064984,1,9,1200
21897757@N00,1138,6,1344981995,1344982115,18,1,120
21897757@N00,1139,24,1359960051,1359961551,3,4,1500
21897757@N00,1139,2,1359963268,1359963328,2,4,60
21897757@N00,1139,21,1359963762,1359964340,3,4,578
21897757@N00,1139,25,1359964340,1359966440,1,4,2100
21899239@N04,1140,19,1443516861,1443517401,6,1,540
21922804@N02,1141,6,1201243985,1201244105,115,1,120
21922804@N02,1142,6,1201314756,1201314876,75,1,120
21945198@N05,1143,7,1201740926,1201741046,1,1,120
21963906@N06,1144,12,1339802891,1339803161,1,1,270
22037357@N04,1145,18,1368520881,1368521421,2,1,540
22117934@N05,1146,18,1410349948,1410350488,1,1,540
22175532@N06,1147,12,1217816191,1217816461,2,1,270
22191840@N00,1148,12,1243568137,1243568407,6,13,270
22191840@N00,1148,17,1243569483,1243569903,2,13,420
22191840@N00,1148,23,1243570090,1243570126,2,13,36
22191840@N00,1148,1,1243570126,1243570186,2,13,60
22191840@N00,1148,16,1243570231,1243570651,2,13,420
22191840@N00,1148,1,1243571073,1243571133,2,13,60
22191840@N00,1148,5,1243572299,1243572419,4,13,120
22191840@N00,1148,18,1243572872,1243573412,6,13,540
22191840@N00,1148,1,1243578541,1243578601,5,13,60
22191840@N00,1148,6,1243579585,1243579705,4,13,120
22191840@N00,1148,20,1243580635,1243580939,2,13,304
22191840@N00,1148,6,1243580939,1243581059,2,13,120
22191840@N00,1148,13,1243581782,1243582082,20,13,300
22191840@N00,1149,22,1321928268,1321929288,3,1,1020
22191840@N00,1150,12,1332748561,1332748831,1,1,270
22191840@N00,1151,16,1332814872,1332815292,53,5,420
22191840@N00,1151,1,1332815315,1332815375,3,5,60
22191840@N00,1151,17,1332815602,1332815641,2,5,39
22191840@N00,1151,1,1332815641,1332815701,2,5,60
22191840@N00,1151,7,1332825854,1332825974,5,5,120
22198509@N03,1152,10,1298097011,1298097161,2,1,150
22198509@N03,1153,12,1298169874,1298170144,1,1,270
22201281@N08,1154,18,1314273186,1314273726,8,1,540
22213891@N03,1155,13,1299408419,1299408719,2,1,300
22218920@N08,1156,16,1254561031,1254561451,20,1,420
22232518@N05,1157,11,1196427600,1196427600,2,3,0
22232518@N05,1157,15,1196427600,1196427600,2,3,0
22232518@N05,1157,17,1196427600,1196428020,1,3,420
22232518@N05,1158,22,1270981383,1270982098,2,2,715
22232518@N05,1158,12,1270982098,1270982368,1,2,270
22232518@N05,1159,23,1271118487,1271118708,3,18,221
22232518@N05,1159,16,1271118708,1271119128,3,18,420
22232518@N05,1159,19,1271123383,1271123861,2,18,478
22232518@N05,1159,18,1271123861,1271124006,2,18,145
22232518@N05,1159,5,1271124006,1271124126,2,18,120
22232518@N05,1159,18,1271124328,1271124868,6,18,540
22232518@N05,1159,5,1271125634,1271125754,2,18,120
22232518@N05,1159,11,1271129663,1271129903,2,18,240
22232518@N05,1159,19,1271130248,1271130788,3,18,540
22232518@N05,1159,18,1271132039,1271132503,2,18,464
22232518@N05,1159,19,1271132503,1271132666,2,18,163
22232518@N05,1159,16,1271132666,1271133086,2,18,420
22232518@N05,1159,11,1271133110,1271133269,3,18,159
22232518@N05,1159,7,1271133269,1271133389,3,18,120
22232518@N05,1159,6,1271136298,1271136418,3,18,120
22232518@N05,1159,19,1271136879,1271136953,2,18,74
22232518@N05,1159,20,1271136953,1271137135,2,18,182
22232518@N05,1159,12,1271137135,1271137405,1,18,270
22232518@N05,1160,15,1347668779,1347669139,3,2,360
22232518@N05,1160,13,1347671440,1347671740,2,2,300
22232518@N05,1161,15,1355268756,1355269116,1,1,360
22276416@N03,1162,15,1205829271,1205829631,1,1,360
22276416@N03,1163,19,1206163806,1206164346,1,1,540
22285503@N00,1164,12,1356042956,1356043226,2,2,270
22285503@N00,1164,14,1356046485,1356046845,2,2,360
22299423@N05,1165,15,1287191979,1287192339,3,2,360
22299423@N05,1165,24,1287199518,1287201018,1,2,1500
22306383@N07,1166,25,1193432701,1193434801,1,1,2100
22308745@N04,1167,7,1453435161,1453435281,1,1,120
22309110@N03,1168,25,1292746622,1292748722,10,1,2100
22309110@N03,1169,25,1292896174,1292898274,133,3,2100
22309110@N03,1169,13,1292919665,1292919965,5,3,300
22309110@N03,1169,16,1292923879,1292924299,17,3,420
22309110@N03,1170,24,1292974505,1292976005,63,2,1500
22309110@N03,1170,16,1292977013,1292977433,4,2,420
22309110@N03,1171,12,1297474758,1297475028,6,3,270
22309110@N03,1171,25,1297475580,1297477680,36,3,2100
22309110@N03,1171,13,1297486437,1297486737,30,3,300
22309110@N03,1172,16,1303000835,1303001255,74,6,420
22309110@N03,1172,8,1303004277,1303004372,3,6,95
22309110@N03,1172,2,1303004372,1303004432,3,6,60
22309110@N03,1172,25,1303004613,1303006713,40,6,2100
22309110@N03,1172,24,1303007675,1303009175,80,6,1500
22309110@N03,1172,25,1303009373,1303011473,167,6,2100
22309110@N03,1173,16,1303088591,1303089011,62,9,420
22309110@N03,1173,25,1303092290,1303094112,24,9,1822
22309110@N03,1173,24,1303094112,1303095612,44,9,1500
22309110@N03,1173,25,1303104411,1303105983,27,9,1572
22309110@N03,1173,13,1303105983,1303106283,33,9,300
22309110@N03,1173,25,1303107383,1303109012,27,9,1629
22309110@N03,1173,13,1303109012,1303109312,36,9,300
22309110@N03,1173,25,1303115502,1303117602,118,9,2100
22309110@N03,1173,24,1303119812,1303121312,15,9,1500
22309110@N03,1174,25,1303190873,1303192973,90,1,2100
22309110@N03,1175,16,1303260128,1303260548,110,8,420
22309110@N03,1175,25,1303268593,1303270693,25,8,2100
22309110@N03,1175,13,1303278811,1303279111,34,8,300
22309110@N03,1175,25,1303280162,1303281811,22,8,1649
22309110@N03,1175,13,1303281811,1303282111,51,8,300
22309110@N03,1175,25,1303288212,1303290312,72,8,2100
22309110@N03,1175,24,1303291180,1303292680,24,8,1500
22309110@N03,1175,13,1303293715,1303294015,24,8,300
22309110@N03,1176,13,1310037611,1310037911,8,1,300
22309110@N03,1177,16,1310083517,1310083937,151,2,420
22309110@N03,1177,25,1310093203,1310095303,75,2,2100
22309110@N03,1178,24,1313662505,1313664005,19,1,1500
22309110@N03,1179,25,1313974960,1313977060,114,2,2100
22309110@N03,1179,24,1314005183,1314006683,19,2,1500
22309110@N03,1180,16,1314066759,1314067179,48,3,420
22309110@N03,1180,23,1314068646,1314069846,9,3,1200
22309110@N03,1180,24,1314091362,1314092862,52,3,1500
22309110@N03,1181,16,1314147866,1314148286,188,1,420
22309110@N03,1182,13,1317528302,1317528602,75,1,300
22309110@N03,1183,25,1318044571,1318046648,16,2,2077
22309110@N03,1183,13,1318046648,1318046948,76,2,300
22309110@N03,1184,25,1319249028,1319251128,28,2,2100
22309110@N03,1184,13,1319256231,1319256531,31,2,300
22309110@N03,1185,16,1325378439,1325378859,221,1,420
22309110@N03,1186,16,1325742809,1325743229,40,1,420
22309110@N03,1187,25,1325894436,1325896174,39,3,1738
22309110@N03,1187,16,1325896174,1325896594,44,3,420
22309110@N03,1187,25,1325898001,1325900101,9,3,2100
22309110@N03,1188,25,1326000453,1326002045,7,2,1592
22309110@N03,1188,16,1326002045,1326002465,27,2,420
22309110@N03,1189,13,1326445272,1326445572,1,1,300
22309110@N03,1190,10,1326590913,1326591063,20,1,150
22309110@N03,1191,10,1327031760,1327031910,49,1,150
22309110@N03,1192,25,1328234388,1328236488,29,2,2100
22309110@N03,1192,10,1328248501,1328248651,13,2,150
22309110@N03,1193,25,1329017136,1329019099,11,2,1963
22309110@N03,1193,10,1329019099,1329019249,49,2,150
22309110@N03,1194,12,1329437050,1329437320,128,3,270
22309110@N03,1194,25,1329449300,1329450917,10,3,1617
22309110@N03,1194,10,1329450917,1329451067,22,3,150
22309110@N03,1195,13,1329642232,1329642532,3,1,300
22309110@N03,1196,16,1330142065,1330142485,28,1,420
22309110@N03,1197,12,1331255197,1331255467,54,1,270
22309110@N03,1198,12,1331785958,1331786228,36,3,270
22309110@N03,1198,24,1331788659,1331790159,26,3,1500
22309110@N03,1198,16,1331791001,1331791421,23,3,420
22309110@N03,1199,11,1332741076,1332741268,3,2,192
22309110@N03,1199,16,1332741268,1332741688,44,2,420
22309110@N03,1200,22,1333239726,1333240746,5,4,1020
22309110@N03,1200,25,1333242005,1333243835,14,4,1830
22309110@N03,1200,16,1333243835,1333244255,34,4,420
22309110@N03,1200,12,1333245835,1333246105,43,4,270
22309110@N03,1201,25,1333846936,1333848740,18,2,1804
22309110@N03,1201,16,1333848740,1333849160,34,2,420
22309110@N03,1202,25,1334365335,1334366931,11,9,1596
22309110@N03,1202,16,1334366931,1334367351,28,9,420
22309110@N03,1202,25,1334368818,1334370730,7,9,1912
22309110@N03,1202,16,1334370730,1334371150,14,9,420
22309110@N03,1202,25,1334372403,1334374336,15,9,1933
22309110@N03,1202,13,1334374336,1334374636,31,9,300
22309110@N03,1202,25,1334377565,1334379665,12,9,2100
22309110@N03,1202,24,1334391354,1334392854,81,9,1500
22309110@N03,1202,13,1334397247,1334397547,29,9,300
22309110@N03,1203,25,1335661327,1335663044,15,5,1717
22309110@N03,1203,16,1335663044,1335663464,20,5,420
22309110@N03,1203,25,1335664918,1335666705,13,5,1787
22309110@N03,1203,16,1335666705,1335667125,14,5,420
22309110@N03,1203,25,1335668490,1335670590,78,5,2100
22309110@N03,1204,16,1336197391,1336197811,10,1,420
22309110@N03,1205,12,1337303803,1337304073,82,1,270
22309110@N03,1206,12,1337997814,1337998084,38,3,270
22309110@N03,1206,16,1337999806,1338000226,5,3,420
22309110@N03,1206,13,1338024508,1338024808,53,3,300
22309110@N03,1207,12,1338512958,1338513228,37,8,270
22309110@N03,1207,16,1338514329,1338514749,8,8,420
22309110@N03,1207,12,1338516256,1338516526,19,8,270
22309110@N03,1207,25,1338534370,1338535464,46,8,1094
22309110@N03,1207,6,1338535464,1338535584,2,8,120
22309110@N03,1207,3,1338535844,1338535934,51,8,90
22309110@N03,1207,22,1338541033,1338541482,10,8,449
22309110@N03,1207,13,1338541482,1338541782,63,8,300
22309110@N03,1208,16,1339048561,1339048981,23,2,420
22309110@N03,1208,12,1339051807,1339052077,40,2,270
22309110@N03,1209,24,1340262653,1340264153,39,2,1500
22309110@N03,1209,13,1340269675,1340269975,113,2,300
22309110@N03,1210,24,1340321881,1340323381,57,4,1500
22309110@N03,1210,16,1340325026,1340325446,18,4,420
22309110@N03,1210,12,1340327137,1340327407,31,4,270
22309110@N03,1210,24,1340330500,1340332000,31,4,1500
22309110@N03,1211,3,1340954764,1340954854,36,2,90
22309110@N03,1211,13,1340960661,1340960961,161,2,300
22309110@N03,1212,24,1341040281,1341041781,21,2,1500
22309110@N03,1212,13,1341046978,1341047278,86,2,300
22309110@N03,1213,13,1341138208,1341138508,69,1,300
22309110@N03,1214,24,1341360082,1341361582,32,7,1500
22309110@N03,1214,22,1341363003,1341363694,3,7,691
22309110@N03,1214,24,1341363694,1341365194,64,7,1500
22309110@N03,1214,13,1341372724,1341373024,10,7,300
22309110@N03,1214,22,1341375977,1341376997,16,7,1020
22309110@N03,1214,16,1341381637,1341382057,11,7,420
22309110@N03,1214,13,1341392680,1341392980,70,7,300
22309110@N03,1215,24,1341533331,1341534831,74,5,1500
22309110@N03,1215,16,1341541754,1341542174,6,5,420
22309110@N03,1215,13,1341544241,1341544541,16,5,300
22309110@N03,1215,24,1341551099,1341552599,19,5,1500
22309110@N03,1215,25,1341558363,1341560463,24,5,2100
22309110@N03,1216,24,1342231321,1342232821,19,8,1500
22309110@N03,1216,16,1342233160,1342233580,11,8,420
22309110@N03,1216,24,1342235017,1342236517,13,8,1500
22309110@N03,1216,13,1342238800,1342239100,4,8,300
22309110@N03,1216,22,1342239825,1342240845,27,8,1020
22309110@N03,1216,24,1342242116,1342243616,20,8,1500
22309110@N03,1216,16,1342245408,1342245828,11,8,420
22309110@N03,1216,3,1342250630,1342250720,29,8,90
22309110@N03,1217,24,1342321761,1342322444,5,5,683
22309110@N03,1217,13,1342322444,1342322744,25,5,300
22309110@N03,1217,16,1342331849,1342332269,16,5,420
22309110@N03,1217,13,1342334148,1342334448,16,5,300
22309110@N03,1217,25,1342335818,1342337918,21,5,2100
22309110@N03,1218,13,1342501496,1342501796,9,3,300
22309110@N03,1218,16,1342504583,1342505003,16,3,420
22309110@N03,1218,13,1342506757,1342507057,4,3,300
22309110@N03,1219,13,1342588038,1342588338,6,1,300
22309110@N03,1220,24,1343088213,1343089713,28,1,1500
22309110@N03,1221,24,1343354525,1343356025,14,2,1500
22309110@N03,1221,22,1343372738,1343373758,21,2,1020
22309110@N03,1222,13,1343812285,1343812585,117,1,300
22309110@N03,1223,16,1343961174,1343961594,15,7,420
22309110@N03,1223,24,1343962208,1343963708,38,7,1500
22309110@N03,1223,22,1343967755,1343968775,17,7,1020
22309110@N03,1223,24,1343970114,1343971614,32,7,1500
22309110@N03,1223,25,1343977455,1343979555,21,7,2100
22309110@N03,1223,22,1343984321,1343985030,16,7,709
22309110@N03,1223,13,1343985030,1343985330,81,7,300
22309110@N03,1224,22,1344140408,1344141428,10,3,1020
22309110@N03,1224,24,1344146623,1344148123,15,3,1500
22309110@N03,1224,13,1344157829,1344158129,89,3,300
22309110@N03,1225,13,1344254859,1344255159,21,1,300
22309110@N03,1226,13,1345698290,1345698590,10,4,300
22309110@N03,1226,22,1345705543,1345706563,13,4,1020
22309110@N03,1226,3,1345706623,1345706713,22,4,90
22309110@N03,1226,13,1345713790,1345714090,84,4,300
22309110@N03,1227,24,1345775284,1345776784,98,3,1500
22309110@N03,1227,22,1345791996,1345793016,20,3,1020
22309110@N03,1227,13,1345800227,1345800527,13,3,300
22309110@N03,1228,22,1345955201,1345956221,11,3,1020
22309110@N03,1228,24,1345957820,1345959320,14,3,1500
22309110@N03,1228,13,1345973345,1345973645,78,3,300
22309110@N03,1229,22,1346041511,1346042531,10,3,1020
22309110@N03,1229,24,1346043896,1346045396,37,3,1500
22309110@N03,1229,13,1346058354,1346058654,84,3,300
22309110@N03,1230,22,1346118927,1346119947,4,2,1020
22309110@N03,1230,24,1346123062,1346124562,26,2,1500
22309110@N03,1231,24,1348191500,1348193000,30,6,1500
22309110@N03,1231,16,1348194379,1348194799,39,6,420
22309110@N03,1231,14,1348206080,1348206440,12,6,360
22309110@N03,1231,24,1348209170,1348210670,34,6,1500
22309110@N03,1231,22,1348211188,1348212208,27,6,1020
22309110@N03,1231,13,1348214848,1348215148,57,6,300
22309110@N03,1232,24,1348896902,1348898402,23,4,1500
22309110@N03,1232,16,1348899205,1348899625,26,4,420
22309110@N03,1232,22,1348902454,1348903474,27,4,1020
22309110@N03,1232,13,1348910906,1348911206,6,4,300
22309110@N03,1233,22,1349417442,1349418462,33,2,1020
22309110@N03,1233,24,1349418783,1349420283,42,2,1500
22309110@N03,1234,12,1350159758,1350160028,4,10,270
22309110@N03,1234,24,1350160119,1350160546,4,10,427
22309110@N03,1234,6,1350160546,1350160666,6,10,120
22309110@N03,1234,14,1350161196,1350161556,4,10,360
22309110@N03,1234,16,1350161750,1350162170,8,10,420
22309110@N03,1234,23,1350163265,1350164465,2,10,1200
22309110@N03,1234,24,1350175208,1350176708,16,10,1500
22309110@N03,1234,16,1350191573,1350191993,28,10,420
22309110@N03,1234,12,1350193126,1350193396,40,10,270
22309110@N03,1234,22,1350194918,1350195938,24,10,1020
22309110@N03,1235,22,1350623367,1350624387,40,3,1020
22309110@N03,1235,24,1350624745,1350626245,30,3,1500
22309110@N03,1235,14,1350628973,1350629333,10,3,360
22309110@N03,1236,24,1351913135,1351914630,33,5,1495
22309110@N03,1236,12,1351914630,1351914900,38,5,270
22309110@N03,1236,24,1351916459,1351917959,75,5,1500
22309110@N03,1236,22,1351923720,1351924740,11,5,1020
22309110@N03,1236,13,1351926861,1351927161,94,5,300
22309110@N03,1237,24,1352503868,1352505368,61,2,1500
22309110@N03,1237,22,1352528420,1352529440,11,2,1020
22309110@N03,1238,24,1353028395,1353029895,20,3,1500
22309110@N03,1238,3,1353036980,1353037070,26,3,90
22309110@N03,1238,24,1353038015,1353039515,11,3,1500
22309110@N03,1239,16,1353561977,1353562397,20,1,420
22309110@N03,1240,16,1353642017,1353642437,36,1,420
22309110@N03,1241,24,1353726305,1353727805,41,3,1500
22309110@N03,1241,22,1353738094,1353739114,15,3,1020
22309110@N03,1241,13,1353745249,1353745549,6,3,300
22309110@N03,1242,22,1354342820,1354343840,18,1,1020
22309110@N03,1243,16,1354843626,1354844046,29,4,420
22309110@N03,1243,14,1354854930,1354855290,3,4,360
22309110@N03,1243,22,1354861385,1354862405,22,4,1020
22309110@N03,1243,13,1354868824,1354869124,52,4,300
22309110@N03,1244,24,1354936873,1354938345,2,4,1472
22309110@N03,1244,16,1354938345,1354938765,16,4,420
22309110@N03,1244,22,1354947725,1354948745,15,4,1020
22309110@N03,1244,13,1354954843,1354955143,40,4,300
22309110@N03,1245,16,1355013178,1355013598,12,5,420
22309110@N03,1245,12,1355015007,1355015277,22,5,270
22309110@N03,1245,16,1355016322,1355016742,16,5,420
22309110@N03,1245,24,1355017718,1355019218,27,5,1500
22309110@N03,1245,16,1355034848,1355035268,3,5,420
22309110@N03,1246,16,1355116476,1355116896,20,1,420
22309110@N03,1247,16,1356147600,1356148020,54,2,420
22309110@N03,1247,24,1356164453,1356165953,3,2,1500
22309110@N03,1248,24,1356318252,1356319752,33,2,1500
22309110@N03,1248,13,1356326752,1356327052,21,2,300
22309110@N03,1249,16,1356651888,1356652308,9,2,420
22309110@N03,1249,23,1356663842,1356665042,5,2,1200
22309110@N03,1250,24,1357089721,1357091221,3,3,1500
22309110@N03,1250,16,1357098234,1357098654,46,3,420
22309110@N03,1250,24,1357104470,1357105970,15,3,1500
22309110@N03,1251,16,1357281603,1357282023,12,1,420
22309110@N03,1252,16,1357346108,1357346528,16,3,420
22309110@N03,1252,13,1357351944,1357352244,2,3,300
22309110@N03,1252,16,1357357041,1357357461,31,3,420
22309110@N03,1253,23,1357438047,1357439247,10,2,1200
22309110@N03,1253,16,1357443661,1357444081,46,2,420
22309110@N03,1254,14,1357879282,1357879642,6,2,360
22309110@N03,1254,22,1357885374,1357886394,8,2,1020
22309110@N03,1255,14,1358659924,1358660284,3,2,360
22309110@N03,1255,16,1358663728,1358664148,4,2,420
22309110@N03,1256,24,1359087440,1359088940,39,1,1500
22309110@N03,1257,16,1359761582,1359762002,8,6,420
22309110@N03,1257,10,1359775106,1359775256,11,6,150
22309110@N03,1257,16,1359776762,1359777182,14,6,420
22309110@N03,1257,24,1359778018,1359779518,14,6,1500
22309110@N03,1257,16,1359787197,1359787617,11,6,420
22309110@N03,1257,13,1359789026,1359789326,51,6,300
22309110@N03,1258,10,1360467887,1360468037,16,2,150
22309110@N03,1258,16,1360470472,1360470892,15,2,420
22309110@N03,1259,16,1360813477,1360813897,14,1,420
22309110@N03,1260,24,1361065812,1361066696,14,4,884
22309110@N03,1260,12,1361066696,1361066966,18,4,270
22309110@N03,1260,24,1361075552,1361077052,29,4,1500
22309110@N03,1260,16,1361083034,1361083454,14,4,420
22309110@N03,1261,14,1361680546,1361680906,4,4,360
22309110@N03,1261,16,1361682835,1361683255,14,4,420
22309110@N03,1261,14,1361684185,1361684545,14,4,360
22309110@N03,1261,16,1361687921,1361688341,16,4,420
22309110@N03,1262,22,1362464546,1362465566,23,2,1020
22309110@N03,1262,10,1362465583,1362465733,31,2,150
22309110@N03,1263,12,1362887233,1362887503,45,2,270
22309110@N03,1263,16,1362892345,1362892765,37,2,420
22309110@N03,1264,22,1363501404,1363502424,26,2,1020
22309110@N03,1264,16,1363502699,1363503119,11,2,420
22309110@N03,1265,24,1363909002,1363910502,22,5,1500
22309110@N03,1265,16,1363924049,1363924469,5,5,420
22309110@N03,1265,24,1363929679,1363931179,16,5,1500
22309110@N03,1265,16,1363934255,1363934675,24,5,420
22309110@N03,1265,13,1363944541,1363944841,9,5,300
22309110@N03,1266,24,1364009091,1364010334,3,6,1243
22309110@N03,1266,16,1364010334,1364010754,8,6,420
22309110@N03,1266,12,1364017067,1364017337,16,6,270
22309110@N03,1266,20,1364019939,1364020539,32,6,600
22309110@N03,1266,12,1364024073,1364024343,9,6,270
22309110@N03,1266,13,1364026353,1364026653,37,6,300
22309110@N03,1267,24,1364268257,1364269757,30,2,1500
22309110@N03,1267,20,1364279246,1364279846,26,2,600
22309110@N03,1268,24,1364617956,1364619456,15,7,1500
22309110@N03,1268,16,1364620352,1364620772,4,7,420
22309110@N03,1268,24,1364622723,1364624223,5,7,1500
22309110@N03,1268,20,1364625138,1364625738,21,7,600
22309110@N03,1268,13,1364627525,1364627825,17,7,300
22309110@N03,1268,12,1364630189,1364630459,9,7,270
22309110@N03,1268,13,1364630906,1364631206,11,7,300
22309110@N03,1269,12,1365295152,1365295422,3,3,270
22309110@N03,1269,20,1365319814,1365320414,27,3,600
22309110@N03,1269,14,1365320984,1365321344,12,3,360
22309110@N03,1270,16,1365666113,1365666533,16,1,420
22309110@N03,1271,22,1365907847,1365908867,6,5,1020
22309110@N03,1271,16,1365919900,1365920320,17,5,420
22309110@N03,1271,24,1365921191,1365922691,15,5,1500
22309110@N03,1271,16,1365924993,1365925413,26,5,420
22309110@N03,1271,14,1365926058,1365926418,4,5,360
22309110@N03,1272,12,1367736334,1367736604,3,2,270
22309110@N03,1272,20,1367739334,1367739934,25,2,600
22309110@N03,1273,22,1369466688,1369467650,8,2,962
22309110@N03,1273,16,1369467650,1369468070,34,2,420
22309110@N03,1274,22,1371443360,1371444339,11,7,979
22309110@N03,1274,13,1371444339,1371444639,13,7,300
22309110@N03,1274,22,1371445608,1371446050,3,7,442
22309110@N03,1274,16,1371446050,1371446470,5,7,420
22309110@N03,1274,24,1371447060,1371448560,5,7,1500
22309110@N03,1274,16,1371449307,1371449727,7,7,420
22309110@N03,1274,13,1371461254,1371461554,7,7,300
22309110@N03,1275,13,1371784471,1371784771,10,3,300
22309110@N03,1275,16,1371787845,1371788265,35,3,420
22309110@N03,1275,22,1371798440,1371799460,17,3,1020
22309110@N03,1276,22,1372566780,1372567800,26,4,1020
22309110@N03,1276,24,1372568004,1372569504,16,4,1500
22309110@N03,1276,16,1372572089,1372572509,22,4,420
22309110@N03,1276,14,1372577834,1372578194,8,4,360
22309110@N03,1277,16,1372911180,1372911600,33,8,420
22309110@N03,1277,22,1372912601,1372913621,17,8,1020
22309110@N03,1277,16,1372914317,1372914737,15,8,420
22309110@N03,1277,14,1372916152,1372916512,9,8,360
22309110@N03,1277,13,1372919503,1372919803,20,8,300
22309110@N03,1277,22,1372921640,1372922660,20,8,1020
22309110@N03,1277,16,1372923100,1372923520,10,8,420
22309110@N03,1277,14,1372928729,1372929089,13,8,360
22309110@N03,1278,13,1373957385,1373957685,12,2,300
22309110@N03,1278,22,1373958582,1373959602,20,2,1020
22309110@N03,1279,13,1374044215,1374044515,5,2,300
22309110@N03,1279,16,1374045843,1374046263,20,2,420
22309110@N03,1280,16,1374564425,1374564845,21,1,420
22309110@N03,1281,16,1374898088,1374898508,27,3,420
22309110@N03,1281,7,1374899755,1374899875,7,3,120
22309110@N03,1281,22,1374908981,1374910001,13,3,1020
22309110@N03,1282,16,1375503002,1375503422,9,6,420
22309110@N03,1282,25,1375504409,1375506509,8,6,2100
22309110@N03,1282,12,1375508608,1375508878,21,6,270
22309110@N03,1282,13,1375512015,1375512315,4,6,300
22309110@N03,1282,20,1375514462,1375515062,11,6,600
22309110@N03,1282,10,1375515188,1375515338,15,6,150
22309110@N03,1283,16,1375756600,1375757020,13,1,420
22309110@N03,1284,16,1376366921,1376367341,33,2,420
22309110@N03,1284,10,1376378694,1376378844,22,2,150
22309110@N03,1285,24,1376809852,1376811352,16,1,1500
22309110@N03,1286,16,1376971917,1376972337,20,2,420
22309110@N03,1286,22,1376973127,1376974147,23,2,1020
22309110@N03,1287,13,1377403403,1377403703,106,2,300
22309110@N03,1287,10,1377415905,1377416055,28,2,150
22309110@N03,1288,13,1377579600,1377579900,2,3,300
22309110@N03,1288,12,1377581400,1377581670,2,3,270
22309110@N03,1288,10,1377588599,1377588749,8,3,150
22309110@N03,1289,16,1377756351,1377756771,13,3,420
22309110@N03,1289,13,1377757589,1377757889,18,3,300
22309110@N03,1289,10,1377760686,1377760836,22,3,150
22309110@N03,1290,24,1380349292,1380350792,26,4,1500
22309110@N03,1290,20,1380352536,1380353136,20,4,600
22309110@N03,1290,10,1380353503,1380353653,17,4,150
22309110@N03,1290,13,1380360523,1380360823,29,4,300
22309110@N03,1291,12,1381610894,1381611164,5,13,270
22309110@N03,1291,22,1381611199,1381611346,3,13,147
22309110@N03,1291,25,1381611346,1381611419,2,13,73
22309110@N03,1291,4,1381611419,1381611509,3,13,90
22309110@N03,1291,14,1381611668,1381612028,5,13,360
22309110@N03,1291,16,1381612335,1381612563,2,13,228
22309110@N03,1291,7,1381612563,1381612683,2,13,120
22309110@N03,1291,16,1381612897,1381613317,2,13,420
22309110@N03,1291,12,1381621680,1381621950,27,13,270
22309110@N03,1291,24,1381624512,1381626012,16,13,1500
22309110@N03,1291,16,1381627895,1381628315,3,13,420
22309110@N03,1291,10,1381645577,1381645727,18,13,150
22309110@N03,1291,12,1381647295,1381647565,2,13,270
22309110@N03,1292,12,1382226523,1382226793,71,2,270
22309110@N03,1292,20,1382249577,1382250177,28,2,600
22309110@N03,1293,14,1382676634,1382676994,15,3,360
22309110@N03,1293,10,1382682261,1382682411,33,3,150
22309110@N03,1293,14,1382684023,1382684383,3,3,360
22309110@N03,1294,16,1382846526,1382846946,34,1,420
22309110@N03,1295,24,1383454245,1383455745,15,2,1500
22309110@N03,1295,10,1383459824,1383459974,7,2,150
22309110@N03,1296,14,1384058183,1384058543,11,3,360
22309110@N03,1296,25,1384061761,1384062810,32,3,1049
22309110@N03,1296,6,1384062810,1384062930,7,3,120
22309110@N03,1297,24,1384331619,1384333119,19,1,1500
22309110@N03,1298,16,1384648991,1384649411,12,4,420
22309110@N03,1298,1,1384651626,1384651686,21,4,60
22309110@N03,1298,16,1384653391,1384653811,21,4,420
22309110@N03,1298,10,1384667656,1384667806,20,4,150
22309110@N03,1299,16,1386732384,1386732804,13,5,420
22309110@N03,1299,1,1386734003,1386734063,16,5,60
22309110@N03,1299,23,1386735448,1386736648,12,5,1200
22309110@N03,1299,24,1386737601,1386739101,9,5,1500
22309110@N03,1299,6,1386740926,1386741046,20,5,120
22309110@N03,1300,19,1387777836,1387778376,18,1,540
22309110@N03,1301,3,1387946329,1387946419,6,5,90
22309110@N03,1301,1,1387947256,1387947316,5,5,60
22309110@N03,1301,25,1387949809,1387951372,17,5,1563
22309110@N03,1301,16,1387951372,1387951792,6,5,420
22309110@N03,1301,3,1387953139,1387953229,3,5,90
22309110@N03,1302,16,1388029286,1388029706,21,1,420
22309110@N03,1303,13,1390037552,1390037852,3,1,300
22309110@N03,1304,3,1391234840,1391234930,6,3,90
22309110@N03,1304,10,1391237133,1391237283,19,3,150
22309110@N03,1304,13,1391243363,1391243663,8,3,300
22309110@N03,1305,10,1391928206,1391928356,21,1,150
22309110@N03,1306,10,1392533013,1392533163,19,1,150
22309110@N03,1307,16,1394343688,1394344108,25,1,420
22309110@N03,1308,25,1400397775,1400399220,7,3,1445
22309110@N03,1308,16,1400399220,1400399640,14,3,420
22309110@N03,1308,14,1400404142,1400404502,9,3,360
22309110@N03,1309,22,1403928587,1403929607,3,4,1020
22309110@N03,1309,16,1403933554,1403933974,6,4,420
22309110@N03,1309,24,1403937397,1403938897,3,4,1500
22309110@N03,1309,25,1403940056,1403942156,17,4,2100
22309110@N03,1310,25,1404026447,1404027632,20,2,1185
22309110@N03,1310,16,1404027632,1404028052,16,2,420
22309110@N03,1311,25,1404890459,1404892559,4,1,2100
22309110@N03,1312,1,1405323930,1405323990,13,1,60
22309110@N03,1313,10,1405582990,1405583140,28,1,150
22309110@N03,1314,10,1405669412,1405669562,41,1,150
22309110@N03,1315,25,1406186601,1406188701,14,2,2100
22309110@N03,1315,14,1406192870,1406193230,7,2,360
22309110@N03,1316,10,1406274221,1406274371,18,1,150
22309110@N03,1317,10,1406619814,1406619964,27,1,150
22309110@N03,1318,10,1406965394,1406965544,34,1,150
22309110@N03,1319,10,1407742942,1407743092,39,1,150
22309110@N03,1320,10,1407829351,1407829501,10,1,150
22309110@N03,1321,12,1408182317,1408182587,4,1,270
22309110@N03,1322,10,1408347910,1408348060,20,1,150
22309110@N03,1323,16,1408858442,1408858862,5,2,420
22309110@N03,1323,10,1408866233,1408866383,17,2,150
22309110@N03,1324,13,1409274633,1409274933,3,3,300
22309110@N03,1324,24,1409275368,1409276868,9,3,1500
22309110@N03,1324,10,1409298397,1409298547,34,3,150
22309110@N03,1325,10,1411803841,1411803991,19,2,150
22309110@N03,1325,13,1411817659,1411817959,12,2,300
22309110@N03,1326,13,1412418777,1412419077,22,1,300
22309110@N03,1327,12,1413062546,1413062816,4,9,270
22309110@N03,1327,22,1413062940,1413063050,2,9,110
22309110@N03,1327,25,1413063050,1413063248,3,9,198
22309110@N03,1327,4,1413063248,1413063338,2,9,90
22309110@N03,1327,19,1413063524,1413063687,3,9,163
22309110@N03,1327,14,1413063687,1413064047,5,9,360
22309110@N03,1327,16,1413064148,1413064568,3,9,420
22309110@N03,1327,24,1413084510,1413086010,5,9,1500
22309110@N03,1327,16,1413096062,1413096482,29,9,420
22309110@N03,1328,16,1413520517,1413520937,13,2,420
22309110@N03,1328,10,1413528198,1413528348,28,2,150
22309110@N03,1329,16,1414643690,1414644110,22,3,420
22309110@N03,1329,10,1414651560,1414651710,46,3,150
22309110@N03,1329,14,1414653138,1414653498,6,3,360
22309110@N03,1330,16,1414888227,1414888647,19,3,420
22309110@N03,1330,20,1414909542,1414910142,3,3,600
22309110@N03,1330,16,1414910678,1414911098,12,3,420
22309110@N03,1331,12,1415508855,1415509125,25,3,270
22309110@N03,1331,25,1415514108,1415515211,11,3,1103
22309110@N03,1331,10,1415515211,1415515361,7,3,150
22309110@N03,1332,10,1416552275,1416552425,18,2,150
22309110@N03,1332,13,1416555231,1416555531,29,2,300
22309110@N03,1333,1,1419906771,1419906831,7,4,60
22309110@N03,1333,24,1419907996,1419909496,2,4,1500
22309110@N03,1333,16,1419911113,1419911533,34,4,420
22309110@N03,1333,24,1419926786,1419928286,20,4,1500
22309110@N03,1334,24,1420360937,1420362437,3,1,1500
22309110@N03,1335,24,1420882831,1420884331,9,1,1500
22309110@N03,1336,10,1423377742,1423377892,12,1,150
22309110@N03,1337,10,1424414478,1424414628,25,1,150
22309110@N03,1338,3,1424577419,1424577509,2,1,90
22309110@N03,1339,10,1426747488,1426747638,29,2,150
22309110@N03,1339,14,1426748802,1426749162,3,2,360
22309110@N03,1340,10,1427784058,1427784208,23,1,150
22311697@N06,1341,17,1445298076,1445298496,2,5,420
22311697@N06,1341,16,1445298604,1445299024,2,5,420
22311697@N06,1341,19,1445306844,1445307384,2,5,540
22311697@N06,1341,15,1445314575,1445314935,2,5,360
22311697@N06,1341,18,1445324495,1445325035,1,5,540
22316898@N07,1342,12,1446374766,1446375036,3,3,270
22316898@N07,1342,24,1446379758,1446379814,3,3,56
22316898@N07,1342,12,1446379814,1446380084,2,3,270
22316898@N07,1343,16,1446468590,1446468733,2,2,143
22316898@N07,1343,19,1446468733,1446469273,5,2,540
22316898@N07,1344,24,1446550856,1446552356,3,2,1500
22316898@N07,1344,12,1446555175,1446555445,1,2,270
22316898@N07,1345,19,1447373930,1447373931,8,9,1
22316898@N07,1345,8,1447373931,1447373931,2,9,0
22316898@N07,1345,13,1447373931,1447373932,7,9,1
22316898@N07,1345,22,1447373932,1447373933,2,9,1
22316898@N07,1345,16,1447373933,1447373933,3,9,0
22316898@N07,1345,22,1447373933,1447373934,3,9,1
22316898@N07,1345,16,1447373934,1447373934,4,9,0
22316898@N07,1345,23,1447373934,1447373948,2,9,14
22316898@N07,1345,19,1447373948,1447374488,5,9,540
22325101@N00,1346,24,1218722701,1218723301,8,3,600
22325101@N00,1346,18,1218723301,1218723541,5,3,240
22325101@N00,1346,7,1218723541,1218723661,1,3,120
22333963@N00,1347,14,1371038189,1371038549,1,1,360
22342760@N05,1348,3,1394136443,1394136533,1,1,90
22407012@N00,1349,15,1376953883,1376954243,1,1,360
22456113@N00,1350,25,1231634537,1231635132,2,9,595
22456113@N00,1350,15,1231635132,1231635492,5,9,360
22456113@N00,1350,24,1231637115,1231638615,2,9,1500
22456113@N00,1350,25,1231638776,1231640638,3,9,1862
22456113@N00,1350,22,1231640638,1231641658,3,9,1020
22456113@N00,1350,1,1231643996,1231644056,2,9,60
22456113@N00,1350,5,1231644288,1231644408,6,9,120
22456113@N00,1350,11,1231646756,1231646996,3,9,240
22456113@N00,1350,7,1231648360,1231648480,1,9,120
22456113@N00,1351,14,1361000661,1361001021,1,1,360
22456113@N00,1352,6,1361602701,1361602821,1,1,120
22456113@N00,1353,15,1363854189,1363854549,2,2,360
22456113@N00,1353,16,1363872689,1363873109,1,2,420
22456113@N00,1354,14,1364704483,1364704843,1,1,360
22456113@N00,1355,14,1387672026,1387672386,1,1,360
22456113@N00,1356,11,1394261118,1394261358,1,1,240
22462989@N05,1357,18,1279726508,1279727048,2,1,540
22472042@N02,1358,12,1365590235,1365590505,1,1,270
22473198@N00,1359,14,1402629955,1402630315,1,1,360
22511860@N06,1360,17,1213435226,1213435646,3,1,420
22519766@N03,1361,20,1339050214,1339050814,3,1,600
22576224@N08,1362,19,1356781367,1356781907,21,5,540
22576224@N08,1362,6,1356788698,1356788703,2,5,5
22576224@N08,1362,19,1356788703,1356788909,6,5,206
22576224@N08,1362,6,1356788909,1356789029,3,5,120
22576224@N08,1362,24,1356792742,1356794242,4,5,1500
22576224@N08,1363,7,1356871329,1356871449,4,2,120
22576224@N08,1363,16,1356879231,1356879651,2,2,420
22648301@N07,1364,17,1201838152,1201838572,3,1,420
22648301@N07,1365,19,1201871316,1201871856,1,1,540
22672393@N08,1366,16,1366276097,1366276517,1,1,420
22695386@N07,1367,16,1414309089,1414309509,1,1,420
22729779@N04,1368,6,1357518083,1357518203,2,15,120
22729779@N04,1368,24,1357534319,1357534470,2,15,151
22729779@N04,1368,6,1357534470,1357534590,5,15,120
22729779@N04,1368,3,1357535638,1357535728,2,15,90
22729779@N04,1368,6,1357535920,1357536040,9,15,120
22729779@N04,1368,8,1357537911,1357538031,7,15,120
22729779@N04,1368,6,1357541288,1357541403,2,15,115
22729779@N04,1368,19,1357541403,1357541943,6,15,540
22729779@N04,1368,14,1357544327,1357544687,2,15,360
22729779@N04,1368,19,1357553764,1357554182,2,15,418
22729779@N04,1368,10,1357554182,1357554332,4,15,150
22729779@N04,1368,18,1357555786,1357556326,4,15,540
22729779@N04,1368,5,1357556711,1357556831,3,15,120
22729779@N04,1368,18,1357558478,1357559018,2,15,540
22729779@N04,1368,16,1357560824,1357561244,1,15,420
22751315@N05,1369,18,1400463185,1400463292,2,3,107
22751315@N05,1369,14,1400463292,1400463652,2,3,360
22751315@N05,1369,18,1400466344,1400466884,1,3,540
22770078@N06,1370,19,1361062378,1361062918,1,1,540
22774022@N07,1371,19,1227156546,1227156979,2,3,433
22774022@N07,1371,23,1227156979,1227157408,2,3,429
22774022@N07,1371,17,1227157408,1227157828,1,3,420
22774022@N07,1372,16,1227272154,1227272574,1,1,420
22774022@N07,1373,16,1227362783,1227363203,1,1,420
22789621@N02,1374,16,1247626146,1247626337,2,6,191
22789621@N02,1374,10,1247626337,1247626343,2,6,6
22789621@N02,1374,18,1247626343,1247626774,3,6,431
22789621@N02,1374,7,1247626774,1247626894,6,6,120
22789621@N02,1374,6,1247659285,1247659405,3,6,120
22789621@N02,1374,24,1247660958,1247662458,1,6,1500
22826842@N04,1375,12,1387472814,1387473084,1,1,270
22826842@N04,1376,8,1389280654,1389280774,2,4,120
22826842@N04,1376,14,1389282226,1389282304,2,4,78
22826842@N04,1376,19,1389282304,1389282844,4,4,540
22826842@N04,1376,7,1389289514,1389289634,2,4,120
22880371@N04,1377,19,1350276334,1350276874,1,1,540
22887781@N03,1378,18,1418942610,1418943150,1,1,540
22887781@N03,1379,18,1418979935,1418980475,2,1,540
22890516@N03,1380,16,1366261063,1366261096,2,2,33
22890516@N03,1380,12,1366261096,1366261366,1,2,270
22890516@N03,1381,11,1366449075,1366449246,3,2,171
22890516@N03,1381,18,1366449246,1366449786,1,2,540
22890555@N06,1382,14,1382597780,1382598140,2,1,360
22890555@N06,1383,16,1392695151,1392695571,1,1,420
22909555@N04,1384,13,1330228213,1330228513,1,1,300
22918179@N08,1385,24,1208219929,1208220130,4,15,201
22918179@N08,1385,25,1208220130,1208220811,3,15,681
22918179@N08,1385,13,1208220811,1208221111,7,15,300
22918179@N08,1385,15,1208224641,1208225001,2,15,360
22918179@N08,1385,22,1208226297,1208227242,2,15,945
22918179@N08,1385,24,1208227242,1208227823,2,15,581
22918179@N08,1385,23,1208227823,1208228975,3,15,1152
22918179@N08,1385,16,1208228975,1208229196,3,15,221
22918179@N08,1385,10,1208229196,1208229346,2,15,150
22918179@N08,1385,18,1208230180,1208230720,4,15,540
22918179@N08,1385,6,1208235991,1208236111,6,15,120
22918179@N08,1385,9,1208237798,1208237918,2,15,120
22918179@N08,1385,4,1208238433,1208238523,4,15,90
22918179@N08,1385,20,1208238654,1208238757,2,15,103
22918179@N08,1385,6,1208238757,1208238877,1,15,120
22918179@N08,1386,15,1208486770,1208487130,4,9,360
22918179@N08,1386,22,1208489580,1208490600,2,9,1020
22918179@N08,1386,18,1208491471,1208492011,4,9,540
22918179@N08,1386,12,1208498055,1208498325,3,9,270
22918179@N08,1386,4,1208499425,1208499515,6,9,90
22918179@N08,1386,6,1208500652,1208500772,2,9,120
22918179@N08,1386,11,1208501354,1208501594,5,9,240
22918179@N08,1386,19,1208503592,1208504132,28,9,540
22918179@N08,1386,24,1208504575,1208506075,1,9,1500
22935007@N08,1387,7,1240124486,1240124606,1,1,120
22935007@N08,1388,6,1246469007,1246469127,1,1,120
22937808@N04,1389,16,1404436120,1404436540,1,1,420
22937808@N04,1390,24,1405753299,1405754799,1,1,1500
22937808@N04,1391,12,1406935081,1406935351,1,1,270
22937808@N04,1392,11,1407667276,1407667516,1,1,240
22937808@N04,1393,7,1409394084,1409394204,1,1,120
22937808@N04,1394,14,1410606851,1410607211,1,1,360
22937808@N04,1395,14,1411819643,1411820003,2,1,360
22937808@N04,1396,13,1420069289,1420069589,1,1,300
22937808@N04,1397,14,1426246630,1426246990,1,1,360
22937808@N04,1398,19,1439033555,1439034095,2,2,540
22937808@N04,1398,14,1439035120,1439035480,1,2,360
22937808@N04,1399,7,1440235692,1440235812,2,2,120
22937808@N04,1399,19,1440240221,1440240761,2,2,540
22937808@N04,1400,11,1457843999,1457844239,1,1,240
22937808@N04,1401,19,1459121573,1459122113,1,1,540
22938314@N08,1402,5,1242392547,1242392667,1,1,120
22938314@N08,1403,12,1244969034,1244969304,2,1,270
22938314@N08,1404,16,1247483670,1247484090,4,1,420
23004611@N00,1405,18,1414159515,1414160055,1,1,540
23032267@N00,1406,13,1297230292,1297230592,1,1,300
23032267@N00,1407,16,1298696953,1298697197,2,3,244
23032267@N00,1407,19,1298697197,1298697485,2,3,288
23032267@N00,1407,12,1298697485,1298697755,1,3,270
23036476@N00,1408,8,1229562618,1229562738,2,3,120
23036476@N00,1408,19,1229566313,1229566853,2,3,540
23036476@N00,1408,5,1229567941,1229568061,1,3,120
23036476@N00,1409,25,1229743619,1229743629,2,2,10
23036476@N00,1409,12,1229743629,1229743899,1,2,270
23065916@N04,1410,13,1345767051,1345767351,3,1,300
23065916@N04,1411,13,1345858529,1345858829,3,1,300
23065916@N04,1412,19,1354829762,1354830302,1,1,540
23089307@N02,1413,6,1356920434,1356920554,6,10,120
23089307@N02,1413,12,1356924120,1356924390,2,10,270
23089307@N02,1413,17,1356924404,1356924824,3,10,420
23089307@N02,1413,5,1356928639,1356928759,3,10,120
23089307@N02,1413,19,1356931115,1356931655,2,10,540
23089307@N02,1413,14,1356932232,1356932395,2,10,163
23089307@N02,1413,6,1356932395,1356932515,4,10,120
23089307@N02,1413,8,1356934265,1356934385,3,10,120
23089307@N02,1413,19,1356934730,1356935270,2,10,540
23089307@N02,1413,24,1356935352,1356936852,3,10,1500
23108813@N00,1414,7,1350778548,1350778668,1,1,120
23108813@N00,1415,14,1350978175,1350978535,1,1,360
23108813@N00,1416,23,1351073439,1351074639,1,1,1200
23113465@N08,1417,24,1388987429,1388988012,2,3,583
23113465@N08,1417,19,1388988012,1388988552,3,3,540
23113465@N08,1417,11,1388991279,1388991519,1,3,240
23113465@N08,1418,19,1403867490,1403868030,1,1,540
23113465@N08,1419,19,1422861774,1422862314,1,1,540
23113465@N08,1420,18,1424679055,1424679595,1,1,540
23113465@N08,1421,17,1443350445,1443350865,1,1,420
23113465@N08,1422,17,1443426487,1443426907,3,1,420
23113465@N08,1423,17,1443606615,1443607035,1,1,420
23113465@N08,1424,6,1443691159,1443691279,2,2,120
23113465@N08,1424,17,1443698590,1443699010,1,2,420
23113465@N08,1425,17,1444295517,1444295937,1,1,420
23113465@N08,1426,14,1454237853,1454238213,1,1,360
23119895@N00,1427,7,1288829467,1288829587,2,3,120
23119895@N00,1427,13,1288849343,1288849643,2,3,300
23119895@N00,1427,16,1288863881,1288864301,1,3,420
23119895@N00,1428,2,1289022283,1289022343,1,1,60
23119895@N00,1429,3,1324347635,1324347725,3,8,90
23119895@N00,1429,18,1324351930,1324352470,2,8,540
23119895@N00,1429,7,1324352545,1324352665,2,8,120
23119895@N00,1429,19,1324355609,1324356149,2,8,540
23119895@N00,1429,6,1324356736,1324356856,2,8,120
23119895@N00,1429,4,1324366275,1324366365,2,8,90
23119895@N00,1429,13,1324373568,1324373868,2,8,300
23119895@N00,1429,15,1324377069,1324377429,2,8,360
23119895@N00,1430,19,1406852284,1406852824,2,2,540
23119895@N00,1430,15,1406860476,1406860836,1,2,360
23119895@N00,1431,19,1406892264,1406892804,1,1,540
23124863@N02,1432,14,1338417007,1338417367,1,1,360
23129782@N00,1433,24,1435108009,1435109509,3,12,1500
23129782@N00,1433,16,1435120578,1435120998,4,12,420
23129782@N00,1433,3,1435122593,1435122683,2,12,90
23129782@N00,1433,18,1435124068,1435124608,2,12,540
23129782@N00,1433,11,1435128087,1435128327,3,12,240
23129782@N00,1433,6,1435129640,1435129760,2,12,120
23129782@N00,1433,18,1435134502,1435134526,2,12,24
23129782@N00,1433,17,1435134526,1435134946,2,12,420
23129782@N00,1433,18,1435136211,1435136751,2,12,540
23129782@N00,1433,14,1435138559,1435138919,3,12,360
23129782@N00,1433,18,1435139140,1435139680,2,12,540
23129782@N00,1433,14,1435139909,1435140269,1,12,360
23143137@N06,1434,10,1334840581,1334840731,1,1,150
23149244@N02,1435,18,1277859171,1277859711,1,1,540
23149244@N02,1436,15,1278628421,1278628781,1,1,360
23165320@N07,1437,7,1356772042,1356772162,1,1,120
23176711@N07,1438,8,1307153697,1307153817,4,9,120
23176711@N07,1438,18,1307154209,1307154495,2,9,286
23176711@N07,1438,17,1307154495,1307154648,2,9,153
23176711@N07,1438,20,1307154648,1307155248,2,9,600
23176711@N07,1438,16,1307163902,1307164322,2,9,420
23176711@N07,1438,18,1307164658,1307165198,2,9,540
23176711@N07,1438,8,1307166028,1307166116,2,9,88
23176711@N07,1438,12,1307166116,1307166386,2,9,270
23176711@N07,1438,18,1307190661,1307191201,3,9,540
23197443@N07,1439,18,1323502573,1323503113,1,1,540
23205379@N02,1440,19,1332977325,1332977865,1,1,540
23205379@N02,1441,7,1333161969,1333162089,1,1,120
23205379@N02,1442,15,1336007029,1336007389,1,1,360
23205379@N02,1443,12,1341042672,1341042689,2,3,17
23205379@N02,1443,14,1341042689,1341042898,4,3,209
23205379@N02,1443,6,1341042898,1341043018,1,3,120
23205379@N02,1444,12,1342047565,1342047610,2,4,45
23205379@N02,1444,14,1342047610,1342047646,2,4,36
23205379@N02,1444,6,1342047646,1342047751,2,4,105
23205379@N02,1444,12,1342047751,1342048021,1,4,270
23205379@N02,1445,12,1342162258,1342162407,3,3,149
23205379@N02,1445,14,1342162407,1342162432,2,3,25
23205379@N02,1445,12,1342162432,1342162702,2,3,270
23205379@N02,1446,25,1343187963,1343190063,1,1,2100
23205379@N02,1447,19,1343357267,1343357280,2,7,13
23205379@N02,1447,11,1343357280,1343357309,2,7,29
23205379@N02,1447,12,1343357309,1343357322,2,7,13
23205379@N02,1447,25,1343357322,1343357337,2,7,15
23205379@N02,1447,12,1343357337,1343357537,4,7,200
23205379@N02,1447,13,1343357537,1343357626,2,7,89
23205379@N02,1447,24,1343357626,1343359126,1,7,1500
23205379@N02,1448,14,1356812572,1356812932,3,2,360
23205379@N02,1448,12,1356820610,1356820880,1,2,270
23205379@N02,1449,19,1362900686,1362901226,1,1,540
23205379@N02,1450,10,1365058772,1365058922,1,1,150
23205379@N02,1451,17,1369472284,1369472704,2,1,420
23205379@N02,1452,3,1372488206,1372488296,1,1,90
23205379@N02,1453,14,1375530103,1375530463,1,1,360
23205379@N02,1454,3,1378019567,1378019657,1,1,90
23205379@N02,1455,24,1385622335,1385623835,1,1,1500
23205379@N02,1456,3,1388361610,1388361700,1,1,90
23205379@N02,1457,19,1388402524,1388403064,1,1,540
23205379@N02,1458,13,1388491536,1388491836,1,1,300
23205379@N02,1459,17,1391241482,1391241902,1,1,420
23205379@N02,1460,17,1393659460,1393659880,2,1,420
23205379@N02,1461,24,1397882772,1397884272,1,1,1500
23205379@N02,1462,4,1399106774,1399106864,1,1,90
23205379@N02,1463,24,1399168001,1399169501,1,1,1500
23205379@N02,1464,23,1400372098,1400373298,1,1,1200
23205379@N02,1465,24,1401526283,1401527783,1,1,1500
23205379@N02,1466,12,1402122475,1402122745,2,1,270
23205379@N02,1467,16,1402195017,1402195437,1,1,420
23205379@N02,1468,18,1403930177,1403930717,3,1,540
23205379@N02,1469,18,1404001828,1404002368,1,1,540
23205379@N02,1470,18,1405757173,1405757713,2,2,540
23205379@N02,1470,19,1405758439,1405758979,1,2,540
23205379@N02,1471,24,1406972545,1406974045,2,2,1500
23205379@N02,1471,18,1406976199,1406976739,1,2,540
23205379@N02,1472,18,1407027166,1407027706,1,1,540
23205379@N02,1473,18,1409464907,1409465447,1,1,540
23205379@N02,1474,18,1413634349,1413634889,1,1,540
23205379@N02,1475,24,1417163454,1417164954,1,1,1500
23205379@N02,1476,18,1417243314,1417243854,1,1,540
23205379@N02,1477,18,1417668587,1417669127,1,1,540
23205379@N02,1478,24,1418032734,1418034234,1,1,1500
23205379@N02,1479,18,1418199498,1418200038,1,1,540
23205379@N02,1480,17,1418472801,1418473221,1,1,420
23205379@N02,1481,18,1419413639,1419414179,2,2,540
23205379@N02,1481,16,1419418289,1419418709,1,2,420
23205379@N02,1482,18,1419912503,1419913043,2,1,540
23205379@N02,1483,18,1420028965,1420029505,1,1,540
23205379@N02,1484,24,1420163257,1420164757,2,2,1500
23205379@N02,1484,18,1420181760,1420182300,1,2,540
23205379@N02,1485,17,1421318581,1421319001,1,1,420
23205379@N02,1486,17,1425102280,1425102700,1,1,420
23205379@N02,1487,17,1426048062,1426048482,1,1,420
23205379@N02,1488,17,1428553751,1428554171,1,1,420
23205379@N02,1489,24,1428744100,1428745600,1,1,1500
23205379@N02,1490,17,1428974133,1428974553,1,1,420
23205379@N02,1491,24,1429850982,1429852482,2,2,1500
23205379@N02,1491,17,1429860198,1429860618,1,2,420
23205379@N02,1492,12,1432274975,1432275245,1,1,270
23205379@N02,1493,24,1432619860,1432621360,1,1,1500
23205379@N02,1494,17,1433563852,1433564272,1,1,420
23205379@N02,1495,23,1434321636,1434322836,1,1,1200
23205379@N02,1496,17,1435824034,1435824454,1,1,420
23205379@N02,1497,17,1438846564,1438846984,1,1,420
23205379@N02,1498,17,1439212813,1439213233,1,1,420
23205379@N02,1499,17,1441244682,1441245102,1,1,420
23210338@N08,1500,16,1325147609,1325148029,1,1,420
23212779@N04,1501,16,1276867740,1276868160,1,1,420
23212779@N04,1502,24,1282736369,1282737869,1,1,1500
23212779@N04,1503,16,1306378670,1306379090,1,1,420
23212779@N04,1504,13,1338035208,1338035508,2,2,300
23212779@N04,1504,24,1338039838,1338041338,1,2,1500
23212779@N04,1505,13,1340122538,1340122838,1,1,300
23212779@N04,1506,14,1340805779,1340806139,2,2,360
23212779@N04,1506,24,1340808493,1340809993,1,2,1500
23212779@N04,1507,14,1343816952,1343817312,1,1,360
23218963@N00,1508,3,1428657089,1428657179,1,1,90
23218963@N00,1509,6,1428739926,1428740046,1,1,120
23218963@N00,1510,25,1428787973,1428789361,2,4,1388
23218963@N00,1510,19,1428789361,1428789901,2,4,540
23218963@N00,1510,4,1428790676,1428790766,2,4,90
23218963@N00,1510,24,1428791548,1428793048,3,4,1500
23218963@N00,1511,5,1428874900,1428875020,2,13,120
23218963@N00,1511,10,1428876240,1428876390,3,13,150
23218963@N00,1511,11,1428876933,1428877016,2,13,83
23218963@N00,1511,7,1428877016,1428877136,2,13,120
23218963@N00,1511,14,1428878887,1428879247,2,13,360
23218963@N00,1511,23,1428882577,1428883215,2,13,638
23218963@N00,1511,17,1428883215,1428883493,3,13,278
23218963@N00,1511,18,1428883493,1428883732,3,13,239
23218963@N00,1511,17,1428883732,1428884152,2,13,420
23218963@N00,1511,18,1428885391,1428885931,2,13,540
23218963@N00,1511,5,1428886064,1428886184,2,13,120
23218963@N00,1511,18,1428895280,1428895820,3,13,540
23218963@N00,1511,15,1428900987,1428901347,1,13,360
23218963@N00,1512,14,1471127504,1471127864,2,10,360
23218963@N00,1512,11,1471132918,1471132964,2,10,46
23218963@N00,1512,18,1471132964,1471133504,2,10,540
23218963@N00,1512,7,1471134605,1471134725,2,10,120
23218963@N00,1512,25,1471135949,1471136792,2,10,843
23218963@N00,1512,19,1471136792,1471137332,3,10,540
23218963@N00,1512,17,1471146395,1471146815,5,10,420
23218963@N00,1512,5,1471162942,1471163062,3,10,120
23218963@N00,1512,10,1471170488,1471170638,2,10,150
23218963@N00,1512,16,1471174003,1471174423,1,10,420
23218963@N00,1513,16,1471218293,1471218713,1,1,420
23218963@N00,1514,3,1471391522,1471391612,1,1,90
23322134@N02,1515,7,1218853574,1218853694,2,9,120
23322134@N02,1515,18,1218855088,1218855628,4,9,540
23322134@N02,1515,16,1218856995,1218857415,2,9,420
23322134@N02,1515,15,1218864743,1218865103,2,9,360
23322134@N02,1515,13,1218887848,1218888148,5,9,300
23322134@N02,1515,25,1218888172,1218888665,2,9,493
23322134@N02,1515,15,1218888665,1218889025,3,9,360
23322134@N02,1515,24,1218889729,1218891229,2,9,1500
23322134@N02,1515,20,1218891896,1218892496,3,9,600
23322134@N02,1516,13,1250325257,1250325557,1,1,300
23322134@N02,1517,7,1250397915,1250398035,2,4,120
23322134@N02,1517,10,1250400711,1250400861,2,4,150
23322134@N02,1517,12,1250407356,1250407626,2,4,270
23322134@N02,1517,13,1250410173,1250410473,1,4,300
23322134@N02,1518,24,1256644051,1256645551,1,1,1500
23373396@N03,1519,11,1351904052,1351904292,2,1,240
23375196@N06,1520,12,1298671189,1298671459,2,7,270
23375196@N06,1520,22,1298685401,1298686421,3,7,1020
23375196@N06,1520,13,1298686737,1298687037,5,7,300
23375196@N06,1520,6,1298687296,1298687343,3,7,47
23375196@N06,1520,16,1298687343,1298687763,4,7,420
23375196@N06,1520,7,1298687861,1298687981,2,7,120
23375196@N06,1520,12,1298691580,1298691850,4,7,270
23375196@N06,1521,12,1328926405,1328926675,5,5,270
23375196@N06,1521,5,1328933129,1328933249,2,5,120
23375196@N06,1521,3,1328934091,1328934181,4,5,90
23375196@N06,1521,1,1328934673,1328934733,3,5,60
23375196@N06,1521,5,1328947454,1328947574,4,5,120
23375196@N06,1522,16,1329089545,1329089965,3,2,420
23375196@N06,1522,12,1329102936,1329103206,1,2,270
23399885@N00,1523,11,1304929952,1304930192,4,3,240
23399885@N00,1523,25,1304937619,1304939719,19,3,2100
23399885@N00,1523,12,1304941110,1304941380,3,3,270
23399885@N00,1524,18,1305097912,1305098452,10,4,540
23399885@N00,1524,16,1305105726,1305106146,27,4,420
23399885@N00,1524,7,1305108043,1305108163,2,4,120
23399885@N00,1524,16,1305134485,1305134905,1,4,420
23400884@N07,1525,15,1332290625,1332290985,1,1,360
23404661@N06,1526,7,1362567952,1362568072,1,1,120
23411300@N00,1527,17,1429053834,1429054254,3,1,420
23424011@N06,1528,24,1205551430,1205552930,1,1,1500
23442653@N00,1529,16,1279459203,1279459623,2,1,420
23450846@N07,1530,19,1291605943,1291606013,2,2,70
23450846@N07,1530,16,1291606013,1291606433,1,2,420
23450846@N07,1531,16,1293499276,1293499696,2,2,420
23450846@N07,1531,6,1293501633,1293501753,1,2,120
23450846@N07,1532,16,1327127292,1327127712,1,1,420
23450846@N07,1533,14,1371978644,1371979004,1,1,360
23450846@N07,1534,7,1373158914,1373159034,1,1,120
23450846@N07,1535,14,1373533284,1373533644,1,1,360
23450846@N07,1536,18,1392219044,1392219584,1,1,540
23450846@N07,1537,14,1393674158,1393674518,1,1,360
23450846@N07,1538,14,1394967932,1394968292,1,1,360
23450846@N07,1539,11,1398567540,1398567780,1,1,240
23450846@N07,1540,7,1404753871,1404753991,1,1,120
23450846@N07,1541,14,1408509453,1408509813,1,1,360
23450846@N07,1542,1,1408742335,1408742395,1,1,60
23484004@N03,1543,10,1353668335,1353668485,1,1,150
23568093@N00,1544,17,1301041078,1301041498,1,1,420
23571697@N00,1545,19,1221294239,1221294779,1,1,540
23571697@N00,1546,12,1362722160,1362722430,2,2,270
23571697@N00,1546,16,1362731100,1362731520,1,2,420
23621009@N07,1547,25,1202211037,1202213137,2,1,2100
23642145@N00,1548,7,1252895720,1252895840,1,1,120
23654380@N00,1549,12,1257758878,1257759148,8,1,270
23654380@N00,1550,12,1257812033,1257812303,2,10,270
23654380@N00,1550,24,1257815824,1257816115,4,10,291
23654380@N00,1550,17,1257816115,1257816535,35,10,420
23654380@N00,1550,23,1257820281,1257821481,179,10,1200
23654380@N00,1550,10,1257824359,1257824509,15,10,150
23654380@N00,1550,16,1257827643,1257828063,21,10,420
23654380@N00,1550,4,1257833330,1257833420,37,10,90
23654380@N00,1550,24,1257835640,1257837140,2,10,1500
23654380@N00,1550,20,1257837560,1257838160,29,10,600
23654380@N00,1550,24,1257838645,1257840145,3,10,1500
23673310@N02,1551,17,1241931688,1241932108,2,4,420
23673310@N02,1551,7,1241933023,1241933143,3,4,120
23673310@N02,1551,12,1241941003,1241941273,2,4,270
23673310@N02,1551,24,1241946043,1241947543,1,4,1500
23673310@N02,1552,19,1313746758,1313747298,2,2,540
23673310@N02,1552,16,1313747943,1313748363,24,2,420
23673310@N02,1553,17,1313918051,1313918209,2,3,158
23673310@N02,1553,14,1313918209,1313918569,2,3,360
23673310@N02,1553,13,1313921356,1313921656,11,3,300
23673310@N02,1554,16,1313996016,1313996436,2,1,420
23673310@N02,1555,15,1314059944,1314060121,2,3,177
23673310@N02,1555,25,1314060121,1314060456,3,3,335
23673310@N02,1555,13,1314060456,1314060756,1,3,300
23673310@N02,1556,12,1369876654,1369876924,2,11,270
23673310@N02,1556,16,1369877720,1369878140,6,11,420
23673310@N02,1556,18,1369879149,1369879689,9,11,540
23673310@N02,1556,11,1369881915,1369882155,2,11,240
23673310@N02,1556,14,1369882396,1369882756,6,11,360
23673310@N02,1556,6,1369883017,1369883137,7,11,120
23673310@N02,1556,20,1369890445,1369890713,2,11,268
23673310@N02,1556,24,1369890713,1369892213,2,11,1500
23673310@N02,1556,16,1369910254,1369910674,6,11,420
23673310@N02,1556,14,1369913714,1369914074,8,11,360
23673310@N02,1556,6,1369914333,1369914453,1,11,120
23673310@N02,1557,14,1369953577,1369953937,4,6,360
23673310@N02,1557,22,1369954663,1369955683,2,6,1020
23673310@N02,1557,6,1369956833,1369956953,2,6,120
23673310@N02,1557,7,1369957819,1369957939,3,6,120
23673310@N02,1557,9,1369977771,1369977891,3,6,120
23673310@N02,1557,14,1369979518,1369979878,1,6,360
23679036@N04,1558,18,1396684102,1396684642,1,1,540
23679036@N04,1559,13,1443865342,1443865642,1,1,300
23684486@N07,1560,1,1188732226,1188732226,2,12,0
23684486@N07,1560,5,1188732226,1188732226,3,12,0
23684486@N07,1560,7,1188732226,1188732226,4,12,0
23684486@N07,1560,12,1188732226,1188732226,4,12,0
23684486@N07,1560,13,1188732226,1188732226,2,12,0
23684486@N07,1560,15,1188732226,1188732226,2,12,0
23684486@N07,1560,16,1188732226,1188732226,3,12,0
23684486@N07,1560,17,1188732226,1188732226,2,12,0
23684486@N07,1560,18,1188732226,1188732226,2,12,0
23684486@N07,1560,20,1188732226,1188732226,2,12,0
23684486@N07,1560,24,1188732226,1188732226,2,12,0
23684486@N07,1560,25,1188732226,1188734326,1,12,2100
23684642@N08,1561,12,1244855541,1244855811,4,14,270
23684642@N08,1561,17,1244856623,1244856758,2,14,135
23684642@N08,1561,23,1244856758,1244857958,5,14,1200
23684642@N08,1561,3,1244859792,1244859882,2,14,90
23684642@N08,1561,23,1244860938,1244862138,2,14,1200
23684642@N08,1561,16,1244864462,1244864627,3,14,165
23684642@N08,1561,11,1244864627,1244864867,2,14,240
23684642@N08,1561,7,1244865206,1244865326,3,14,120
23684642@N08,1561,18,1244866864,1244867059,2,14,195
23684642@N08,1561,5,1244867059,1244867179,2,14,120
23684642@N08,1561,1,1244867989,1244868049,3,14,60
23684642@N08,1561,19,1244872032,1244872366,2,14,334
23684642@N08,1561,16,1244872366,1244872502,3,14,136
23684642@N08,1561,19,1244872502,1244873042,1,14,540
23684642@N08,1562,6,1245036716,1245036836,2,16,120
23684642@N08,1562,9,1245037300,1245037420,2,16,120
23684642@N08,1562,8,1245038515,1245038635,3,16,120
23684642@N08,1562,25,1245041217,1245043317,2,16,2100
23684642@N08,1562,6,1245043539,1245043659,3,16,120
23684642@N08,1562,24,1245043917,1245044076,2,16,159
23684642@N08,1562,22,1245044076,1245044139,2,16,63
23684642@N08,1562,25,1245044139,1245045200,4,16,1061
23684642@N08,1562,22,1245045200,1245045354,3,16,154
23684642@N08,1562,25,1245045354,1245045645,3,16,291
23684642@N08,1562,13,1245045645,1245045945,2,16,300
23684642@N08,1562,16,1245049976,1245049992,2,16,16
23684642@N08,1562,19,1245049992,1245050532,2,16,540
23684642@N08,1562,25,1245052025,1245054125,4,16,2100
23684642@N08,1562,7,1245063095,1245063215,2,16,120
23684642@N08,1562,16,1245064142,1245064562,13,16,420
23684642@N08,1563,23,1245196581,1245197781,1,1,1200
23684642@N08,1564,25,1251619675,1251621775,1,1,2100
23684642@N08,1565,19,1251703896,1251704436,5,1,540
23684642@N08,1566,22,1251780361,1251780693,2,2,332
23684642@N08,1566,25,1251780693,1251782793,3,2,2100
23684642@N08,1567,4,1251864143,1251864233,2,2,90
23684642@N08,1567,19,1251867193,1251867733,2,2,540
23684642@N08,1568,18,1251942624,1251943164,2,5,540
23684642@N08,1568,7,1251943450,1251943570,2,5,120
23684642@N08,1568,11,1251945447,1251945687,2,5,240
23684642@N08,1568,12,1251951101,1251951371,2,5,270
23684642@N08,1568,25,1251954680,1251956780,3,5,2100
23684642@N08,1569,14,1345469539,1345469899,2,2,360
23684642@N08,1569,12,1345470473,1345470743,1,2,270
23693552@N03,1570,23,1340876949,1340878149,3,2,1200
23693552@N03,1570,17,1340879224,1340879644,5,2,420
23693552@N03,1571,17,1340920602,1340921022,3,10,420
23693552@N03,1571,19,1340947002,1340947542,2,10,540
23693552@N03,1571,7,1340947836,1340947956,2,10,120
23693552@N03,1571,19,1340948519,1340949059,2,10,540
23693552@N03,1571,14,1340949633,1340949993,3,10,360
23693552@N03,1571,6,1340951062,1340951182,3,10,120
23693552@N03,1571,19,1340952168,1340952708,3,10,540
23693552@N03,1571,4,1340958163,1340958253,2,10,90
23693552@N03,1571,24,1340958764,1340960264,2,10,1500
23693552@N03,1571,16,1340966811,1340967231,7,10,420
23693552@N03,1572,12,1341023329,1341023599,2,3,270
23693552@N03,1572,14,1341027223,1341027583,2,3,360
23693552@N03,1572,24,1341027588,1341029088,2,3,1500
23693552@N03,1573,14,1342422358,1342422718,1,1,360
23693552@N03,1574,16,1342701815,1342702235,1,1,420
23694509@N06,1575,14,1428314498,1428314858,1,1,360
23716112@N06,1576,24,1372022240,1372022331,3,20,91
23716112@N06,1576,4,1372022331,1372022406,2,20,75
23716112@N06,1576,14,1372022406,1372022715,4,20,309
23716112@N06,1576,19,1372022715,1372022739,2,20,24
23716112@N06,1576,14,1372022739,1372023099,21,20,360
23716112@N06,1576,20,1372029444,1372029765,2,20,321
23716112@N06,1576,15,1372029765,1372030125,6,20,360
23716112@N06,1576,22,1372032190,1372032814,4,20,624
23716112@N06,1576,25,1372032814,1372033631,3,20,817
23716112@N06,1576,17,1372033631,1372034051,3,20,420
23716112@N06,1576,7,1372034320,1372034440,7,20,120
23716112@N06,1576,19,1372060482,1372060758,2,20,276
23716112@N06,1576,16,1372060758,1372061178,2,20,420
23716112@N06,1576,19,1372063313,1372063853,2,20,540
23716112@N06,1576,7,1372064760,1372064880,4,20,120
23716112@N06,1576,10,1372068872,1372069022,2,20,150
23716112@N06,1576,16,1372069654,1372070074,4,20,420
23716112@N06,1576,14,1372073011,1372073133,2,20,122
23716112@N06,1576,6,1372073133,1372073164,3,20,31
23716112@N06,1576,14,1372073164,1372073524,8,20,360
23716112@N06,1577,3,1372108793,1372108883,4,13,90
23716112@N06,1577,12,1372126152,1372126422,2,13,270
23716112@N06,1577,13,1372129458,1372129758,2,13,300
23716112@N06,1577,22,1372130399,1372130867,2,13,468
23716112@N06,1577,25,1372130867,1372131848,4,13,981
23716112@N06,1577,14,1372131848,1372131995,3,13,147
23716112@N06,1577,19,1372131995,1372132035,2,13,40
23716112@N06,1577,14,1372132035,1372132395,8,13,360
23716112@N06,1577,18,1372134531,1372134584,4,13,53
23716112@N06,1577,11,1372134584,1372134824,2,13,240
23716112@N06,1577,24,1372135797,1372136408,2,13,611
23716112@N06,1577,12,1372136408,1372136678,3,13,270
23716112@N06,1577,3,1372138096,1372138186,4,13,90
23720661@N08,1578,12,1226025851,1226026121,3,4,270
23720661@N08,1578,17,1226030452,1226030872,2,4,420
23720661@N08,1578,23,1226031606,1226032806,2,4,1200
23720661@N08,1578,13,1226035673,1226035973,1,4,300
23720661@N08,1579,23,1227492945,1227494145,1,1,1200
23720661@N08,1580,13,1229433502,1229433802,1,1,300
23720661@N08,1581,15,1230696079,1230696439,1,1,360
23720661@N08,1582,8,1240142548,1240142668,1,1,120
23720661@N08,1583,17,1247467453,1247467873,1,1,420
23751350@N02,1584,12,1394949116,1394949386,1,1,270
23751350@N02,1585,11,1395199487,1395199727,1,1,240
23807199@N00,1586,12,1278835612,1278835882,3,7,270
23807199@N00,1586,9,1278838632,1278838752,2,7,120
23807199@N00,1586,4,1278839858,1278839948,2,7,90
23807199@N00,1586,19,1278842952,1278843492,3,7,540
23807199@N00,1586,11,1278843668,1278843789,2,7,121
23807199@N00,1586,7,1278843789,1278843909,2,7,120
23807199@N00,1586,18,1278845001,1278845541,11,7,540
23807199@N00,1587,16,1279006036,1279006456,21,2,420
23807199@N00,1587,12,1279028801,1279029071,1,2,270
23807199@N00,1588,10,1279078855,1279079005,2,4,150
23807199@N00,1588,18,1279080115,1279080655,3,4,540
23807199@N00,1588,2,1279086657,1279086717,2,4,60
23807199@N00,1588,22,1279089522,1279090542,1,4,1020
23807199@N00,1589,19,1310022980,1310023520,3,1,540
23807199@N00,1590,12,1310080010,1310080280,1,1,270
23807199@N00,1591,13,1371506539,1371506839,3,3,300
23807199@N00,1591,14,1371509028,1371509388,8,3,360
23807199@N00,1591,16,1371511071,1371511491,2,3,420
23807199@N00,1592,7,1371597989,1371598109,3,7,120
23807199@N00,1592,16,1371598657,1371599077,3,7,420
23807199@N00,1592,14,1371606838,1371607198,4,7,360
23807199@N00,1592,19,1371608219,1371608759,4,7,540
23807199@N00,1592,14,1371633608,1371633968,8,7,360
23807199@N00,1592,4,1371635236,1371635326,3,7,90
23807199@N00,1592,14,1371635532,1371635892,1,7,360
23807199@N00,1593,13,1419631146,1419631446,4,2,300
23807199@N00,1593,14,1419641269,1419641629,1,2,360
23827356@N04,1594,7,1361005804,1361005924,2,2,120
23827356@N04,1594,14,1361013286,1361013646,1,2,360
23836979@N00,1595,16,1300270533,1300270953,1,1,420
23836979@N00,1596,14,1363649163,1363649523,6,9,360
23836979@N00,1596,8,1363651698,1363651818,2,9,120
23836979@N00,1596,14,1363654144,1363654504,2,9,360
23836979@N00,1596,16,1363654660,1363655080,2,9,420
23836979@N00,1596,5,1363655249,1363655369,2,9,120
23836979@N00,1596,16,1363656180,1363656600,3,9,420
23836979@N00,1596,14,1363659927,1363660287,3,9,360
23836979@N00,1596,11,1363685403,1363685643,3,9,240
23836979@N00,1596,21,1363690758,1363691658,1,9,900
23837366@N00,1597,19,1349589980,1349590520,2,2,540
23837366@N00,1597,14,1349595604,1349595964,2,2,360
23837366@N00,1598,16,1352009246,1352009666,1,1,420
23837366@N00,1599,7,1353216844,1353216964,2,3,120
23837366@N00,1599,6,1353218349,1353218469,4,3,120
23837366@N00,1599,14,1353218969,1353219329,2,3,360
23837366@N00,1600,24,1355032333,1355032861,2,2,528
23837366@N00,1600,10,1355032861,1355033011,2,2,150
23837366@N00,1601,25,1387074059,1387076159,4,1,2100
23837366@N00,1602,24,1418618165,1418619665,1,1,1500
23837366@N00,1603,14,1431057673,1431058033,1,1,360
23837366@N00,1604,6,1435052867,1435052987,2,2,120
23837366@N00,1604,14,1435056548,1435056908,1,2,360
23837366@N00,1605,23,1449795906,1449797106,1,1,1200
23837366@N00,1606,10,1453622631,1453622781,1,1,150
23837366@N00,1607,14,1465448440,1465448800,1,1,360
23841725@N05,1608,23,1369994532,1369995732,2,1,1200
23841725@N05,1609,13,1370781692,1370781992,1,1,300
23841725@N05,1610,14,1373727795,1373728155,1,1,360
23841725@N05,1611,8,1374866609,1374866729,1,1,120
23841725@N05,1612,23,1428812010,1428813210,1,1,1200
23866387@N03,1613,6,1347770393,1347770445,2,6,52
23866387@N03,1613,19,1347770445,1347770499,2,6,54
23866387@N03,1613,6,1347770499,1347770619,2,6,120
23866387@N03,1613,14,1347770646,1347771006,2,6,360
23866387@N03,1613,19,1347771067,1347771412,2,6,345
23866387@N03,1613,14,1347771412,1347771772,2,6,360
23866387@N03,1614,6,1352075368,1352075488,3,7,120
23866387@N03,1614,14,1352076781,1352077141,2,7,360
23866387@N03,1614,1,1352082517,1352082540,3,7,23
23866387@N03,1614,10,1352082540,1352082690,2,7,150
23866387@N03,1614,11,1352103315,1352103555,2,7,240
23866387@N03,1614,14,1352103600,1352103960,2,7,360
23866387@N03,1614,8,1352104283,1352104403,3,7,120
23866387@N03,1615,12,1353462919,1353463140,2,19,221
23866387@N03,1615,24,1353463140,1353463622,2,19,482
23866387@N03,1615,19,1353463622,1353464162,6,19,540
23866387@N03,1615,16,1353466231,1353466651,2,19,420
23866387@N03,1615,10,1353466965,1353467115,8,19,150
23866387@N03,1615,1,1353467306,1353467366,3,19,60
23866387@N03,1615,10,1353468110,1353468260,2,19,150
23866387@N03,1615,7,1353469689,1353469809,4,19,120
23866387@N03,1615,4,1353477073,1353477163,6,19,90
23866387@N03,1615,25,1353483282,1353485382,6,19,2100
23866387@N03,1615,13,1353487006,1353487306,3,19,300
23866387@N03,1615,15,1353488668,1353489028,3,19,360
23866387@N03,1615,16,1353491354,1353491774,2,19,420
23866387@N03,1615,7,1353491879,1353491999,8,19,120
23866387@N03,1615,18,1353493334,1353493336,3,19,2
23866387@N03,1615,7,1353493336,1353493456,4,19,120
23866387@N03,1615,18,1353493679,1353493684,2,19,5
23866387@N03,1615,7,1353493684,1353493804,3,19,120
23866387@N03,1615,23,1353496215,1353497415,2,19,1200
23866387@N03,1616,7,1354439394,1354439401,3,4,7
23866387@N03,1616,18,1354439401,1354439941,2,4,540
23866387@N03,1616,7,1354440046,1354440166,2,4,120
23866387@N03,1616,12,1354443422,1354443692,2,4,270
23866387@N03,1617,6,1355122868,1355122988,2,3,120
23866387@N03,1617,14,1355123777,1355124137,6,3,360
23866387@N03,1617,12,1355129265,1355129535,21,3,270
23866387@N03,1618,11,1362882980,1362883220,4,7,240
23866387@N03,1618,6,1362885367,1362885487,8,7,120
23866387@N03,1618,25,1362904248,1362905717,4,7,1469
23866387@N03,1618,13,1362905717,1362906017,2,7,300
23866387@N03,1618,24,1362906133,1362906143,2,7,10
23866387@N03,1618,22,1362906143,1362906981,3,7,838
23866387@N03,1618,24,1362906981,1362908481,1,7,1500
23866387@N03,1619,19,1365319171,1365319711,2,4,540
23866387@N03,1619,14,1365321001,1365321361,3,4,360
23866387@N03,1619,21,1365331918,1365331958,2,4,40
23866387@N03,1619,4,1365331958,1365332048,1,4,90
23866387@N03,1620,7,1367116538,1367116544,2,8,6
23866387@N03,1620,11,1367116544,1367116784,2,8,240
23866387@N03,1620,18,1367118884,1367118910,3,8,26
23866387@N03,1620,7,1367118910,1367119030,2,8,120
23866387@N03,1620,11,1367119842,1367120082,2,8,240
23866387@N03,1620,10,1367122658,1367122808,2,8,150
23866387@N03,1620,25,1367134309,1367136409,3,8,2100
23866387@N03,1620,4,1367138192,1367138282,1,8,90
23866387@N03,1621,14,1369641995,1369642355,3,7,360
23866387@N03,1621,1,1369645088,1369645148,2,7,60
23866387@N03,1621,5,1369645286,1369645406,3,7,120
23866387@N03,1621,16,1369645456,1369645876,2,7,420
23866387@N03,1621,10,1369648864,1369649014,3,7,150
23866387@N03,1621,14,1369650608,1369650968,3,7,360
23866387@N03,1621,8,1369652627,1369652747,1,7,120
23866387@N03,1622,15,1373110287,1373110647,2,2,360
23866387@N03,1622,10,1373111710,1373111860,1,2,150
23866387@N03,1623,25,1376201593,1376201756,4,9,163
23866387@N03,1623,15,1376201756,1376202116,2,9,360
23866387@N03,1623,2,1376202249,1376202309,2,9,60
23866387@N03,1623,19,1376205870,1376205949,2,9,79
23866387@N03,1623,16,1376205949,1376206369,2,9,420
23866387@N03,1623,7,1376206703,1376206823,3,9,120
23866387@N03,1623,5,1376207932,1376208052,2,9,120
23866387@N03,1623,3,1376209297,1376209387,2,9,90
23866387@N03,1623,17,1376209880,1376210300,1,9,420
23866387@N03,1624,15,1380349698,1380350058,2,4,360
23866387@N03,1624,19,1380354161,1380354701,2,4,540
23866387@N03,1624,16,1380357821,1380358241,2,4,420
23866387@N03,1624,18,1380359377,1380359917,1,4,540
23866387@N03,1625,17,1380949097,1380949486,2,4,389
23866387@N03,1625,14,1380949486,1380949846,2,4,360
23866387@N03,1625,11,1380953037,1380953277,2,4,240
23866387@N03,1625,12,1380955738,1380956008,2,4,270
23866387@N03,1626,7,1382936411,1382936531,2,5,120
23866387@N03,1626,11,1382939793,1382940033,3,5,240
23866387@N03,1626,25,1382944071,1382944154,2,5,83
23866387@N03,1626,13,1382944154,1382944454,6,5,300
23866387@N03,1626,25,1382945301,1382947401,4,5,2100
23866387@N03,1627,5,1384669497,1384669579,2,4,82
23866387@N03,1627,18,1384669579,1384670119,9,4,540
23866387@N03,1627,15,1384672318,1384672678,2,4,360
23866387@N03,1627,25,1384675100,1384677200,2,4,2100
23866387@N03,1628,14,1390707428,1390707788,6,1,360
23866387@N03,1629,24,1400397547,1400399047,1,1,1500
23881252@N00,1630,20,1413499984,1413500584,1,1,600
23951075@N06,1631,20,1262586189,1262586789,2,1,600
23951075@N06,1632,10,1272083957,1272084107,1,1,150
23951075@N06,1633,16,1272147739,1272148159,3,5,420
23951075@N06,1633,18,1272148524,1272149064,5,5,540
23951075@N06,1633,3,1272150797,1272150887,2,5,90
23951075@N06,1633,22,1272152316,1272153336,5,5,1020
23951075@N06,1633,13,1272153453,1272153753,1,5,300
23951075@N06,1634,6,1277426252,1277426372,4,3,120
23951075@N06,1634,18,1277427793,1277428333,2,3,540
23951075@N06,1634,12,1277448952,1277449222,1,3,270
23951075@N06,1635,7,1277541839,1277541959,2,4,120
23951075@N06,1635,16,1277545649,1277546069,2,4,420
23951075@N06,1635,13,1277550040,1277550340,2,4,300
23951075@N06,1635,24,1277550967,1277552467,1,4,1500
23951075@N06,1636,13,1288317423,1288317723,3,2,300
23951075@N06,1636,8,1288318014,1288318134,3,2,120
23951075@N06,1637,16,1325561391,1325561811,1,1,420
23965310@N07,1638,1,1384662549,1384662609,1,1,60
23965310@N07,1639,24,1415590652,1415592152,2,4,1500
23965310@N07,1639,12,1415592406,1415592676,4,4,270
23965310@N07,1639,23,1415594113,1415595313,2,4,1200
23965310@N07,1639,16,1415600058,1415600478,5,4,420
23965310@N07,1640,16,1427951567,1427951987,2,6,420
23965310@N07,1640,18,1427952191,1427952731,2,6,540
23965310@N07,1640,7,1427953664,1427953784,3,6,120
23965310@N07,1640,12,1427958845,1427959115,2,6,270
23965310@N07,1640,15,1427960436,1427960512,2,6,76
23965310@N07,1640,25,1427960512,1427962612,1,6,2100
23965310@N07,1641,7,1463812932,1463813052,2,2,120
23965310@N07,1641,19,1463815851,1463816391,1,2,540
23988377@N02,1642,16,1276270088,1276270508,1,1,420
23997578@N00,1643,17,1440116161,1440116581,1,1,420
23997578@N00,1644,17,1440147638,1440148058,1,1,420
24046138@N00,1645,15,1359250026,1359250386,2,2,360
24046138@N00,1645,14,1359256258,1359256618,1,2,360
24055538@N03,1646,8,1305258791,1305258911,1,1,120
24063938@N02,1647,16,1323594997,1323595417,1,1,420
24074281@N06,1648,12,1240392969,1240393239,1,1,270
24090212@N04,1649,12,1237841429,1237841699,3,1,270
24090212@N04,1650,12,1237933939,1237934209,2,6,270
24090212@N04,1650,23,1237937217,1237938417,5,6,1200
24090212@N04,1650,17,1237939442,1237939862,3,6,420
24090212@N04,1650,1,1237946443,1237946503,5,6,60
24090212@N04,1650,10,1237947244,1237947394,9,6,150
24090212@N04,1650,13,1237955773,1237956073,1,6,300
24091355@N00,1651,17,1294479803,1294480223,1,1,420
24122903@N00,1652,15,1298282018,1298282378,2,2,360
24122903@N00,1652,16,1298282819,1298283239,1,2,420
24122903@N00,1653,7,1374319825,1374319945,1,1,120
24122903@N00,1654,7,1377929741,1377929861,1,1,120
24122903@N00,1655,14,1398484368,1398484728,1,1,360
24122903@N00,1656,14,1422693502,1422693862,1,1,360
24230954@N06,1657,24,1218060152,1218060173,2,10,21
24230954@N06,1657,12,1218060173,1218060183,2,10,10
24230954@N06,1657,17,1218060183,1218060316,2,10,133
24230954@N06,1657,25,1218060316,1218060397,4,10,81
24230954@N06,1657,15,1218060397,1218060757,2,10,360
24230954@N06,1657,17,1218062311,1218062417,3,10,106
24230954@N06,1657,20,1218062417,1218062672,2,10,255
24230954@N06,1657,16,1218062672,1218062985,2,10,313
24230954@N06,1657,18,1218062985,1218063525,9,10,540
24230954@N06,1657,6,1218095243,1218095363,1,10,120
24243188@N04,1658,23,1210645318,1210646518,61,1,1200
24243188@N04,1659,20,1453165887,1453166487,1,1,600
24293654@N00,1660,15,1382435725,1382436085,1,1,360
24295504@N05,1661,25,1304259436,1304261536,1,1,2100
24295504@N05,1662,12,1305813845,1305814115,1,1,270
24295504@N05,1663,13,1306227742,1306228042,1,1,300
24295504@N05,1664,20,1325843926,1325844526,1,1,600
24295504@N05,1665,19,1326622512,1326623052,1,1,540
24327996@N03,1666,12,1419346733,1419347003,1,1,270
24328796@N05,1667,13,1297587012,1297587312,1,1,300
24328796@N05,1668,14,1348802970,1348803330,1,1,360
24359697@N04,1669,24,1371121557,1371123057,1,1,1500
24369655@N00,1670,15,1296799539,1296799899,1,1,360
24435646@N00,1671,17,1443783380,1443783800,9,1,420
24435646@N00,1672,17,1454656443,1454656863,1,1,420
24435646@N00,1673,1,1458363232,1458363292,1,1,60
24435646@N00,1674,24,1459843065,1459844565,2,1,1500
24503701@N02,1675,12,1282264061,1282264331,2,8,270
24503701@N02,1675,16,1282264849,1282265269,2,8,420
24503701@N02,1675,4,1282271263,1282271353,2,8,90
24503701@N02,1675,16,1282271891,1282272311,2,8,420
24503701@N02,1675,17,1282285664,1282286084,2,8,420
24503701@N02,1675,7,1282295787,1282295907,2,8,120
24503701@N02,1675,24,1282302496,1282303996,2,8,1500
24503701@N02,1675,16,1282305457,1282305877,3,8,420
24508772@N03,1676,12,1289018747,1289019017,2,3,270
24508772@N03,1676,10,1289020594,1289020744,2,3,150
24508772@N03,1676,24,1289021463,1289022963,1,3,1500
24509213@N00,1677,12,1435024362,1435024632,2,7,270
24509213@N00,1677,17,1435027308,1435027728,2,7,420
24509213@N00,1677,6,1435027886,1435028006,2,7,120
24509213@N00,1677,14,1435033593,1435033953,2,7,360
24509213@N00,1677,19,1435049915,1435050455,2,7,540
24509213@N00,1677,14,1435056987,1435057347,2,7,360
24509213@N00,1677,16,1435059861,1435060281,4,7,420
24509213@N00,1678,23,1435198898,1435200098,3,5,1200
24509213@N00,1678,24,1435217056,1435218556,14,5,1500
24509213@N00,1678,14,1435224474,1435224586,2,5,112
24509213@N00,1678,19,1435224586,1435225126,2,5,540
24509213@N00,1678,12,1435232741,1435233011,1,5,270
24528629@N06,1679,12,1368570919,1368571189,4,32,270
24528629@N06,1679,16,1368574418,1368574838,4,32,420
24528629@N06,1679,7,1368574882,1368575002,2,32,120
24528629@N06,1679,19,1368576271,1368576811,5,32,540
24528629@N06,1679,11,1368577055,1368577295,3,32,240
24528629@N06,1679,19,1368577557,1368577945,5,32,388
24528629@N06,1679,7,1368577945,1368578010,5,32,65
24528629@N06,1679,18,1368578010,1368578550,5,32,540
24528629@N06,1679,5,1368578740,1368578860,2,32,120
24528629@N06,1679,18,1368579136,1368579676,7,32,540
24528629@N06,1679,1,1368580776,1368580836,5,32,60
24528629@N06,1679,16,1368581443,1368581863,3,32,420
24528629@N06,1679,9,1368582232,1368582248,3,32,16
24528629@N06,1679,17,1368582248,1368582467,3,32,219
24528629@N06,1679,18,1368582467,1368582478,3,32,11
24528629@N06,1679,17,1368582478,1368582898,2,32,420
24528629@N06,1679,23,1368585015,1368585677,8,32,662
24528629@N06,1679,18,1368585677,1368586217,2,32,540
24528629@N06,1679,20,1368588525,1368588537,3,32,12
24528629@N06,1679,12,1368588537,1368588807,3,32,270
24528629@N06,1679,24,1368591843,1368593343,8,32,1500
24528629@N06,1679,4,1368593579,1368593669,3,32,90
24528629@N06,1679,14,1368596242,1368596602,5,32,360
24528629@N06,1679,19,1368596798,1368597338,7,32,540
24528629@N06,1679,16,1368597898,1368598124,3,32,226
24528629@N06,1679,1,1368598124,1368598184,2,32,60
24528629@N06,1679,3,1368598987,1368599077,2,32,90
24528629@N06,1679,10,1368602152,1368602155,3,32,3
24528629@N06,1679,1,1368602155,1368602215,3,32,60
24528629@N06,1679,18,1368602958,1368603091,11,32,133
24528629@N06,1679,7,1368603091,1368603211,15,32,120
24528629@N06,1679,16,1368606934,1368607354,4,32,420
24528629@N06,1680,17,1368752143,1368752563,7,2,420
24528629@N06,1680,19,1368754810,1368755350,5,2,540
24537422@N02,1681,14,1395180245,1395180605,3,1,360
24537422@N02,1682,1,1395216193,1395216253,1,1,60
24555603@N04,1683,14,1355271064,1355271424,1,1,360
24577327@N06,1684,6,1343602172,1343602292,7,7,120
24577327@N06,1684,8,1343603258,1343603350,2,7,92
24577327@N06,1684,19,1343603350,1343603398,2,7,48
24577327@N06,1684,14,1343603398,1343603758,2,7,360
24577327@N06,1684,7,1343604525,1343604645,7,7,120
24577327@N06,1684,18,1343606756,1343607296,4,7,540
24577327@N06,1684,11,1343628996,1343629236,1,7,240
24577327@N06,1685,19,1343821949,1343822489,1,1,540
24577327@N06,1686,6,1429224754,1429224874,4,3,120
24577327@N06,1686,7,1429225484,1429225604,3,3,120
24577327@N06,1686,17,1429234037,1429234457,3,3,420
24577327@N06,1687,6,1429393278,1429393398,2,2,120
24577327@N06,1687,11,1429396480,1429396720,1,2,240
24603283@N00,1688,17,1260063498,1260063652,10,2,154
24603283@N00,1688,23,1260063652,1260064852,3,2,1200
24675871@N02,1689,19,1364818101,1364818641,1,1,540
24675871@N02,1690,24,1374199143,1374200643,1,1,1500
24675871@N02,1691,13,1374229423,1374229723,1,1,300
24684763@N02,1692,4,1353707812,1353707902,1,1,90
24685814@N04,1693,25,1268864672,1268866772,1,1,2100
24688575@N06,1694,24,1296358916,1296360416,2,2,1500
24688575@N06,1694,19,1296360885,1296361425,1,2,540
24732960@N03,1695,14,1375948130,1375948490,1,1,360
24736628@N05,1696,10,1415066646,1415066796,1,1,150
24739740@N00,1697,12,1296364771,1296365041,1,1,270
24739740@N00,1698,20,1297926251,1297926851,2,1,600
24745847@N00,1699,5,1338457883,1338458003,1,1,120
24769125@N02,1700,8,1344669749,1344669758,2,3,9
24769125@N02,1700,4,1344669758,1344669767,2,3,9
24769125@N02,1700,6,1344669767,1344669887,1,3,120
24792498@N07,1701,20,1353305417,1353306017,1,1,600
24850040@N07,1702,7,1213611926,1213612046,1,1,120
24850040@N07,1703,7,1215671675,1215671795,3,2,120
24850040@N07,1703,6,1215675018,1215675138,4,2,120
24850040@N07,1704,17,1215769147,1215769567,1,1,420
24850040@N07,1705,6,1215943723,1215943843,2,4,120
24850040@N07,1705,4,1215944077,1215944167,2,4,90
24850040@N07,1705,12,1215945004,1215945061,2,4,57
24850040@N07,1705,24,1215945061,1215946561,1,4,1500
24850040@N07,1706,12,1216117342,1216117612,9,2,270
24850040@N07,1706,24,1216121588,1216123088,1,2,1500
24850040@N07,1707,12,1218194239,1218194509,1,1,270
24850040@N07,1708,23,1233911793,1233912993,5,3,1200
24850040@N07,1708,17,1233913646,1233914066,3,3,420
24850040@N07,1708,12,1233914830,1233915100,2,3,270
24850040@N07,1709,6,1233999062,1233999182,2,2,120
24850040@N07,1709,7,1234001061,1234001181,1,2,120
24850040@N07,1710,6,1235299624,1235299744,4,1,120
24850040@N07,1711,15,1236163461,1236163553,3,2,92
24850040@N07,1711,24,1236163553,1236165053,2,2,1500
24850040@N07,1712,6,1247715750,1247715870,24,3,120
24850040@N07,1712,25,1247730024,1247730157,2,3,133
24850040@N07,1712,22,1247730157,1247731177,3,3,1020
24850040@N07,1713,12,1247891976,1247892246,1,1,270
24850040@N07,1714,22,1248078681,1248079701,5,3,1020
24850040@N07,1714,24,1248082217,1248083717,3,3,1500
24850040@N07,1714,13,1248092801,1248093101,1,3,300
24850040@N07,1715,25,1263637675,1263639775,17,1,2100
24850040@N07,1716,13,1266839069,1266839369,1,1,300
24850040@N07,1717,6,1279280429,1279280549,1,1,120
24850040@N07,1718,25,1279527574,1279529674,13,8,2100
24850040@N07,1718,24,1279530780,1279531561,2,8,781
24850040@N07,1718,22,1279531561,1279532356,2,8,795
24850040@N07,1718,25,1279532356,1279534456,2,8,2100
24850040@N07,1718,24,1279535040,1279535184,2,8,144
24850040@N07,1718,12,1279535184,1279535454,3,8,270
24850040@N07,1718,22,1279537949,1279538969,2,8,1020
24850040@N07,1718,24,1279541515,1279543015,1,8,1500
24850040@N07,1719,13,1287232985,1287233285,9,3,300
24850040@N07,1719,22,1287235342,1287235537,2,3,195
24850040@N07,1719,24,1287235537,1287237037,1,3,1500
24850040@N07,1720,24,1287468533,1287470033,4,1,1500
24850040@N07,1721,13,1309442400,1309442700,2,1,300
24850040@N07,1722,16,1312120800,1312121220,1,1,420
24850040@N07,1723,14,1349421693,1349422053,4,2,360
24850040@N07,1723,19,1349432006,1349432546,2,2,540
24850040@N07,1724,22,1349508105,1349509125,13,6,1020
24850040@N07,1724,19,1349526350,1349526890,2,6,540
24850040@N07,1724,14,1349526938,1349527298,3,6,360
24850040@N07,1724,19,1349527999,1349528245,2,6,246
24850040@N07,1724,14,1349528245,1349528605,2,6,360
24850040@N07,1724,19,1349534217,1349534757,4,6,540
24850040@N07,1725,22,1349684460,1349685200,2,3,740
24850040@N07,1725,2,1349685200,1349685260,2,3,60
24850040@N07,1725,11,1349689948,1349690188,1,3,240
24850040@N07,1726,24,1407751636,1407753136,1,1,1500
24850040@N07,1727,14,1407911800,1407912160,4,1,360
24861798@N05,1728,7,1394702302,1394702422,1,1,120
24959465@N08,1729,16,1330769949,1330770369,1,1,420
24959465@N08,1730,18,1367456740,1367457280,2,2,540
24959465@N08,1730,14,1367465473,1367465833,1,2,360
24959465@N08,1731,12,1378177930,1378178200,1,1,270
24959465@N08,1732,1,1418531206,1418531266,1,1,60
24959465@N08,1733,14,1429147028,1429147388,1,1,360
24959465@N08,1734,19,1440492350,1440492890,1,1,540
25005098@N03,1735,21,1351934064,1351934964,1,1,900
25027171@N08,1736,13,1346723879,1346723976,3,2,97
25027171@N08,1736,24,1346723976,1346725476,2,2,1500
25027171@N08,1737,12,1346810423,1346810477,4,48,54
25027171@N08,1737,23,1346810477,1346810515,2,48,38
25027171@N08,1737,17,1346810515,1346810525,2,48,10
25027171@N08,1737,23,1346810525,1346810543,3,48,18
25027171@N08,1737,17,1346810543,1346810550,2,48,7
25027171@N08,1737,23,1346810550,1346810586,2,48,36
25027171@N08,1737,17,1346810586,1346810588,2,48,2
25027171@N08,1737,23,1346810588,1346810654,2,48,66
25027171@N08,1737,17,1346810654,1346810660,2,48,6
25027171@N08,1737,16,1346810660,1346810669,2,48,9
25027171@N08,1737,17,1346810669,1346810709,3,48,40
25027171@N08,1737,16,1346810709,1346810709,2,48,0
25027171@N08,1737,17,1346810709,1346810739,2,48,30
25027171@N08,1737,16,1346810739,1346810766,4,48,27
25027171@N08,1737,12,1346810766,1346810801,3,48,35
25027171@N08,1737,16,1346810801,1346810804,2,48,3
25027171@N08,1737,12,1346810804,1346810822,2,48,18
25027171@N08,1737,10,1346810822,1346810825,2,48,3
25027171@N08,1737,12,1346810825,1346810897,2,48,72
25027171@N08,1737,16,1346810897,1346810949,4,48,52
25027171@N08,1737,23,1346810949,1346812149,4,48,1200
25027171@N08,1737,17,1346812236,1346812385,2,48,149
25027171@N08,1737,16,1346812385,1346812433,3,48,48
25027171@N08,1737,23,1346812433,1346812515,6,48,82
25027171@N08,1737,16,1346812515,1346812534,2,48,19
25027171@N08,1737,10,1346812534,1346812684,5,48,150
25027171@N08,1737,7,1346812914,1346813034,7,48,120
25027171@N08,1737,11,1346813227,1346813467,4,48,240
25027171@N08,1737,19,1346813628,1346813807,11,48,179
25027171@N08,1737,6,1346813807,1346813813,2,48,6
25027171@N08,1737,19,1346813813,1346813821,2,48,8
25027171@N08,1737,6,1346813821,1346813941,5,48,120
25027171@N08,1737,19,1346814713,1346814723,2,48,10
25027171@N08,1737,6,1346814723,1346814843,16,48,120
25027171@N08,1737,8,1346815069,1346815133,5,48,64
25027171@N08,1737,14,1346815133,1346815287,7,48,154
25027171@N08,1737,8,1346815287,1346815370,2,48,83
25027171@N08,1737,14,1346815370,1346815495,5,48,125
25027171@N08,1737,19,1346815495,1346815675,2,48,180
25027171@N08,1737,6,1346815675,1346815681,2,48,6
25027171@N08,1737,8,1346815681,1346815801,2,48,120
25027171@N08,1737,9,1346815839,1346815886,2,48,47
25027171@N08,1737,8,1346815886,1346815949,2,48,63
25027171@N08,1737,4,1346815949,1346816039,4,48,90
25027171@N08,1737,6,1346816085,1346816155,3,48,70
25027171@N08,1737,20,1346816155,1346816755,3,48,600
25027171@N08,1737,24,1346817536,1346817685,11,48,149
25027171@N08,1737,22,1346817685,1346818705,4,48,1020
25027171@N08,1738,18,1386552272,1386552287,2,12,15
25027171@N08,1738,14,1386552287,1386552647,17,12,360
25027171@N08,1738,8,1386558358,1386558373,3,12,15
25027171@N08,1738,6,1386558373,1386558493,6,12,120
25027171@N08,1738,20,1386558626,1386558705,3,12,79
25027171@N08,1738,12,1386558705,1386558720,4,12,15
25027171@N08,1738,20,1386558720,1386559320,2,12,600
25027171@N08,1738,12,1386561734,1386562004,2,12,270
25027171@N08,1738,19,1386564039,1386564579,5,12,540
25027171@N08,1738,14,1386572996,1386573110,2,12,114
25027171@N08,1738,23,1386573110,1386573151,2,12,41
25027171@N08,1738,16,1386573151,1386573571,9,12,420
25027171@N08,1739,23,1386633626,1386634826,2,2,1200
25027171@N08,1739,12,1386636387,1386636657,1,2,270
25027171@N08,1740,16,1387511940,1387512360,1,1,420
25103656@N06,1741,7,1359775462,1359775582,1,1,120
25119612@N02,1742,13,1190517678,1190517978,5,1,300
25119612@N02,1743,24,1192948482,1192949982,1,1,1500
25119612@N02,1744,20,1287270637,1287271237,31,1,600
25126997@N08,1745,17,1443930260,1443930680,1,1,420
25199567@N05,1746,24,1220699399,1220700899,1,1,1500
25228353@N03,1747,14,1457924260,1457924620,2,2,360
25228353@N03,1747,16,1457932181,1457932601,1,2,420
25262413@N03,1748,11,1453501828,1453501875,2,3,47
25262413@N03,1748,19,1453501875,1453501921,2,3,46
25262413@N03,1748,11,1453501921,1453502161,1,3,240
25266505@N08,1749,16,1206921785,1206921844,3,2,59
25266505@N08,1749,18,1206921844,1206922384,1,2,540
25269451@N07,1750,16,1214043481,1214043638,2,2,157
25269451@N07,1750,7,1214043638,1214043758,4,2,120
25322748@N04,1751,17,1221832800,1221833220,1,1,420
25343363@N05,1752,10,1296462673,1296462823,1,1,150
25360342@N02,1753,24,1393152108,1393153608,2,2,1500
25360342@N02,1753,16,1393154090,1393154510,1,2,420
25360342@N02,1754,20,1393192024,1393192624,4,10,600
25360342@N02,1754,19,1393193210,1393193678,2,10,468
25360342@N02,1754,14,1393193678,1393194038,6,10,360
25360342@N02,1754,6,1393195867,1393195987,3,10,120
25360342@N02,1754,7,1393198429,1393198549,2,10,120
25360342@N02,1754,11,1393199120,1393199360,3,10,240
25360342@N02,1754,25,1393208551,1393209341,2,10,790
25360342@N02,1754,15,1393209341,1393209701,3,10,360
25360342@N02,1754,19,1393225570,1393226110,2,10,540
25360342@N02,1754,16,1393233479,1393233899,5,10,420
25360342@N02,1755,12,1393278710,1393278980,1,1,270
25360342@N02,1756,14,1393368150,1393368510,1,1,360
25360342@N02,1757,3,1393406840,1393406930,2,1,90
25403350@N00,1758,7,1242879110,1242879230,2,1,120
25403350@N00,1759,7,1255828462,1255828582,3,2,120
25403350@N00,1759,24,1255840918,1255842418,2,2,1500
25429242@N00,1760,19,1203122270,1203122810,5,1,540
25445710@N00,1761,10,1189853655,1189853805,1,1,150
25462637@N08,1762,24,1375852021,1375853521,2,2,1500
25462637@N08,1762,19,1375859655,1375860195,1,2,540
25468573@N08,1763,12,1238380517,1238380787,3,2,270
25468573@N08,1763,7,1238396992,1238397112,4,2,120
25468671@N00,1764,6,1458418186,1458418306,2,2,120
25468671@N00,1764,14,1458418722,1458419082,1,2,360
25495689@N03,1765,16,1464998929,1464999349,1,1,420
25554959@N06,1766,16,1213708813,1213709233,2,3,420
25554959@N06,1766,7,1213712600,1213712720,2,3,120
25554959@N06,1766,12,1213716479,1213716749,1,3,270
25569106@N00,1767,14,1390004371,1390004731,1,1,360
25601992@N00,1768,12,1432520578,1432520848,2,17,270
25601992@N00,1768,17,1432520946,1432521366,6,17,420
25601992@N00,1768,16,1432521472,1432521816,5,17,344
25601992@N00,1768,18,1432521816,1432522083,3,17,267
25601992@N00,1768,7,1432522083,1432522203,2,17,120
25601992@N00,1768,11,1432522227,1432522467,2,17,240
25601992@N00,1768,16,1432522639,1432522801,3,17,162
25601992@N00,1768,19,1432522801,1432522915,6,17,114
25601992@N00,1768,14,1432522915,1432522947,2,17,32
25601992@N00,1768,19,1432522947,1432522965,2,17,18
25601992@N00,1768,14,1432522965,1432523325,6,17,360
25601992@N00,1768,6,1432523463,1432523519,2,17,56
25601992@N00,1768,24,1432523519,1432523522,2,17,3
25601992@N00,1768,20,1432523522,1432523700,2,17,178
25601992@N00,1768,25,1432523700,1432523961,6,17,261
25601992@N00,1768,22,1432523961,1432524902,2,17,941
25601992@N00,1768,12,1432524902,1432525172,1,17,270
25612048@N00,1769,17,1454150095,1454150515,1,1,420
25628053@N00,1770,19,1236399562,1236400102,2,1,540
25633301@N00,1771,7,1414981241,1414981361,4,1,120
25652918@N06,1772,16,1207290435,1207290855,1,1,420
25652918@N06,1773,12,1207386515,1207386785,1,1,270
25652918@N06,1774,1,1207444154,1207444214,2,2,60
25652918@N06,1774,11,1207444521,1207444761,1,2,240
25728552@N00,1775,12,1331287881,1331288151,1,1,270
25728552@N00,1776,19,1461628402,1461628673,2,6,271
25728552@N00,1776,14,1461628673,1461629033,2,6,360
25728552@N00,1776,16,1461631190,1461631610,3,6,420
25728552@N00,1776,14,1461644371,1461644690,3,6,319
25728552@N00,1776,19,1461644690,1461645140,2,6,450
25728552@N00,1776,24,1461645140,1461646640,1,6,1500
25728552@N00,1777,14,1461885802,1461886162,2,3,360
25728552@N00,1777,25,1461887017,1461888267,4,3,1250
25728552@N00,1777,22,1461888267,1461889287,1,3,1020
25771935@N08,1778,17,1340532927,1340533347,1,1,420
25771935@N08,1779,7,1340594434,1340594554,1,1,120
25771935@N08,1780,13,1340624777,1340625077,1,1,300
25771935@N08,1781,12,1348097469,1348097739,2,2,270
25771935@N08,1781,7,1348109852,1348109972,1,2,120
25771935@N08,1782,19,1348210116,1348210656,1,1,540
25771952@N00,1783,18,1235292019,1235292559,1,1,540
25793750@N07,1784,6,1207836000,1207836016,15,4,16
25793750@N07,1784,20,1207836016,1207836019,2,4,3
25793750@N07,1784,6,1207836019,1207836022,3,4,3
25793750@N07,1784,15,1207836022,1207836382,1,4,360
25824985@N04,1785,18,1356187492,1356188032,1,1,540
25827417@N00,1786,19,1447896610,1447897150,1,1,540
25829583@N00,1787,17,1440816236,1440816656,1,1,420
25854008@N00,1788,9,1327908788,1327908908,1,1,120
25854008@N00,1789,14,1358672740,1358673100,1,1,360
25854008@N00,1790,7,1358761678,1358761798,1,1,120
25854008@N00,1791,11,1370238011,1370238251,1,1,240
25855529@N04,1792,16,1336222367,1336222787,1,1,420
25872173@N00,1793,9,1343679454,1343679574,3,2,120
25872173@N00,1793,8,1343682821,1343682941,1,2,120
25872173@N00,1794,9,1343726105,1343726225,1,1,120
25950855@N08,1795,23,1340578091,1340579291,6,2,1200
25950855@N08,1795,3,1340580826,1340580916,4,2,90
25950855@N08,1796,20,1340675632,1340676232,2,1,600
25972243@N07,1797,10,1363080991,1363081141,1,1,150
25991947@N00,1798,25,1428621815,1428623915,1,1,2100
26000176@N07,1799,15,1211254093,1211254453,1,1,360
26000176@N07,1800,15,1223199336,1223199696,1,1,360
26000176@N07,1801,7,1233386315,1233386435,1,1,120
26000176@N07,1802,7,1269386907,1269387027,1,1,120
26000176@N07,1803,5,1345365896,1345366016,2,1,120
26000176@N07,1804,8,1448250526,1448250646,1,1,120
26000176@N07,1805,22,1448337464,1448338484,1,1,1020
26051472@N05,1806,24,1358652784,1358654284,2,5,1500
26051472@N05,1806,19,1358656273,1358656813,2,5,540
26051472@N05,1806,18,1358658568,1358659108,4,5,540
26051472@N05,1806,7,1358661619,1358661739,3,5,120
26051472@N05,1806,18,1358662240,1358662780,1,5,540
26066055@N00,1807,19,1296304401,1296304941,1,1,540
26071009@N04,1808,12,1336853432,1336853702,2,3,270
26071009@N04,1808,16,1336854164,1336854584,2,3,420
26071009@N04,1808,18,1336858668,1336859208,1,3,540
26153219@N00,1809,12,1284601571,1284601817,3,28,246
26153219@N00,1809,20,1284601817,1284601992,2,28,175
26153219@N00,1809,16,1284601992,1284602412,3,28,420
26153219@N00,1809,18,1284602818,1284603358,5,28,540
26153219@N00,1809,16,1284604074,1284604177,2,28,103
26153219@N00,1809,10,1284604177,1284604207,2,28,30
26153219@N00,1809,18,1284604207,1284604294,2,28,87
26153219@N00,1809,10,1284604294,1284604316,2,28,22
26153219@N00,1809,16,1284604316,1284604443,3,28,127
26153219@N00,1809,5,1284604443,1284604563,3,28,120
26153219@N00,1809,18,1284604633,1284604672,2,28,39
26153219@N00,1809,16,1284604672,1284604842,3,28,170
26153219@N00,1809,10,1284604842,1284604992,3,28,150
26153219@N00,1809,18,1284606412,1284606952,2,28,540
26153219@N00,1809,16,1284608087,1284608507,3,28,420
26153219@N00,1809,17,1284609053,1284609222,2,28,169
26153219@N00,1809,23,1284609222,1284610422,2,28,1200
26153219@N00,1809,6,1284611396,1284611516,2,28,120
26153219@N00,1809,4,1284612028,1284612118,2,28,90
26153219@N00,1809,25,1284613087,1284613356,3,28,269
26153219@N00,1809,21,1284613356,1284614256,2,28,900
26153219@N00,1809,16,1284615758,1284616178,2,28,420
26153219@N00,1809,7,1284616204,1284616324,2,28,120
26153219@N00,1809,16,1284616333,1284616753,3,28,420
26153219@N00,1809,18,1284617607,1284617618,2,28,11
26153219@N00,1809,7,1284617618,1284617738,3,28,120
26153219@N00,1809,17,1284619034,1284619454,3,28,420
26153219@N00,1809,12,1284631908,1284632178,2,28,270
26153219@N00,1810,3,1284680150,1284680240,6,1,90
26170480@N05,1811,2,1380408419,1380408479,4,7,60
26170480@N05,1811,6,1380409734,1380409854,3,7,120
26170480@N05,1811,19,1380410725,1380411265,2,7,540
26170480@N05,1811,24,1380411519,1380413019,2,7,1500
26170480@N05,1811,22,1380413826,1380414846,2,7,1020
26170480@N05,1811,18,1380416893,1380417086,3,7,193
26170480@N05,1811,16,1380417086,1380417506,1,7,420
26173770@N06,1812,18,1370775540,1370776080,1,1,540
26175247@N00,1813,15,1312600324,1312600684,3,3,360
26175247@N00,1813,5,1312621278,1312621398,2,3,120
26175247@N00,1813,16,1312627223,1312627643,1,3,420
26232027@N02,1814,6,1218955792,1218955912,1,1,120
26251489@N04,1815,24,1288566551,1288567054,2,4,503
26251489@N04,1815,13,1288567054,1288567354,2,4,300
26251489@N04,1815,6,1288567854,1288567922,2,4,68
26251489@N04,1815,20,1288567922,1288568522,1,4,600
26251489@N04,1816,18,1292162931,1292163471,1,1,540
26284290@N05,1817,13,1299330001,1299330002,2,2,1
26284290@N05,1817,25,1299330002,1299332102,1,2,2100
26312461@N00,1818,10,1234790859,1234791009,1,1,150
26340416@N07,1819,7,1308558799,1308558919,1,1,120
26340416@N07,1820,12,1312277278,1312277548,4,2,270
26340416@N07,1820,16,1312290572,1312290992,1,2,420
26340416@N07,1821,15,1313913169,1313913529,2,3,360
26340416@N07,1821,19,1313920546,1313921086,2,3,540
26340416@N07,1821,24,1313926065,1313927565,1,3,1500
26340416@N07,1822,15,1316594941,1316595301,1,1,360
26340416@N07,1823,3,1321418495,1321418585,2,1,90
26340416@N07,1824,19,1330502779,1330503319,2,2,540
26340416@N07,1824,15,1330510185,1330510545,1,2,360
26340416@N07,1825,15,1332322543,1332322903,1,1,360
26340416@N07,1826,12,1339491966,1339492236,2,1,270
26340416@N07,1827,14,1340669589,1340669949,1,1,360
26340416@N07,1828,14,1340698509,1340698869,2,2,360
26340416@N07,1828,19,1340700026,1340700566,1,2,540
26340416@N07,1829,14,1345349253,1345349613,2,1,360
26340416@N07,1830,6,1348553408,1348553528,1,1,120
26340416@N07,1831,19,1348995626,1348996166,1,1,540
26340416@N07,1832,12,1349066106,1349066376,1,1,270
26340416@N07,1833,12,1349678919,1349679189,1,1,270
26340416@N07,1834,12,1351486594,1351486864,1,1,270
26340416@N07,1835,12,1353041449,1353041719,2,2,270
26340416@N07,1835,7,1353046477,1353046597,1,2,120
26340416@N07,1836,12,1353820244,1353820514,2,2,270
26340416@N07,1836,7,1353833158,1353833278,1,2,120
26340416@N07,1837,18,1355971514,1355972054,1,1,540
26340416@N07,1838,7,1358753663,1358753783,3,2,120
26340416@N07,1838,12,1358760536,1358760806,1,2,270
26340416@N07,1839,12,1366530361,1366530631,1,1,270
26373638@N03,1840,18,1312448631,1312449171,1,1,540
26415623@N00,1841,11,1276671119,1276671359,2,2,240
26415623@N00,1841,7,1276673196,1276673316,1,2,120
26433797@N00,1842,12,1240099269,1240099539,2,1,270
26433797@N00,1843,7,1240144675,1240144795,1,1,120
26460999@N02,1844,10,1297939226,1297939376,8,3,150
26460999@N02,1844,15,1297945733,1297946093,3,3,360
26460999@N02,1844,23,1297952157,1297953357,9,3,1200
26460999@N02,1845,25,1298028655,1298030755,5,2,2100
26460999@N02,1845,6,1298032996,1298033116,5,2,120
26475706@N08,1846,16,1316385764,1316386184,1,1,420
26476440@N03,1847,12,1461800829,1461801099,1,1,270
26486914@N00,1848,11,1332751679,1332751919,1,1,240
26522673@N07,1849,17,1203481295,1203481715,2,4,420
26522673@N07,1849,22,1203489116,1203489928,2,4,812
26522673@N07,1849,15,1203489928,1203490288,3,4,360
26522673@N07,1849,24,1203498552,1203500052,1,4,1500
26522673@N07,1850,17,1212564324,1212564744,2,1,420
26522673@N07,1851,15,1226324482,1226324842,1,1,360
26544234@N03,1852,18,1304567448,1304567801,2,9,353
26544234@N03,1852,7,1304567801,1304567921,2,9,120
26544234@N03,1852,19,1304568165,1304568284,4,9,119
26544234@N03,1852,8,1304568284,1304568404,2,9,120
26544234@N03,1852,15,1304569276,1304569405,2,9,129
26544234@N03,1852,13,1304569405,1304569518,2,9,113
26544234@N03,1852,22,1304569518,1304569591,2,9,73
26544234@N03,1852,13,1304569591,1304569891,4,9,300
26544234@N03,1852,7,1304572296,1304572416,16,9,120
26544234@N03,1853,7,1399957567,1399957687,2,2,120
26544234@N03,1853,19,1399957982,1399958522,3,2,540
26568149@N00,1854,15,1245040073,1245040248,3,10,175
26568149@N00,1854,13,1245040248,1245040548,2,10,300
26568149@N00,1854,12,1245040849,1245041119,3,10,270
26568149@N00,1854,1,1245042564,1245042624,8,10,60
26568149@N00,1854,5,1245043714,1245043834,3,10,120
26568149@N00,1854,1,1245047610,1245047670,3,10,60
26568149@N00,1854,5,1245047800,1245047920,21,10,120
26568149@N00,1854,1,1245052285,1245052345,4,10,60
26568149@N00,1854,10,1245053791,1245053941,23,10,150
26568149@N00,1854,17,1245054448,1245054868,1,10,420
26573031@N05,1855,24,1392960429,1392961929,1,1,1500
26590617@N03,1856,19,1250801380,1250801920,6,2,540
26590617@N03,1856,7,1250810384,1250810504,14,2,120
26616207@N00,1857,17,1336537104,1336537524,1,1,420
26624922@N03,1858,12,1469583812,1469584082,1,1,270
26625410@N04,1859,18,1345302446,1345302986,1,1,540
26625410@N04,1860,18,1345475227,1345475227,2,2,0
26625410@N04,1860,19,1345475227,1345475767,1,2,540
26625410@N04,1861,24,1401856097,1401857597,1,1,1500
26625410@N04,1862,16,1405469631,1405470051,1,1,420
26640890@N04,1863,12,1352691731,1352692001,1,1,270
26646647@N04,1864,7,1354689209,1354689329,1,1,120
26670686@N06,1865,19,1456553129,1456553146,2,2,17
26670686@N06,1865,6,1456553146,1456553266,1,2,120
26670686@N06,1866,24,1460254903,1460256403,1,1,1500
26670686@N06,1867,2,1462093864,1462093924,2,2,60
26670686@N06,1867,12,1462095247,1462095517,1,2,270
26670686@N06,1868,2,1463535242,1463535302,1,1,60
26670686@N06,1869,17,1467523082,1467523502,2,2,420
26670686@N06,1869,5,1467528624,1467528744,1,2,120
26670686@N06,1870,6,1468136637,1468136757,2,3,120
26670686@N06,1870,8,1468139825,1468139945,2,3,120
26670686@N06,1870,24,1468143491,1468144991,1,3,1500
26670686@N06,1871,20,1468744899,1468745499,1,1,600
26670686@N06,1872,14,1469947820,1469948180,1,1,360
26670686@N06,1873,12,1470191550,1470191820,1,1,270
26764455@N05,1874,20,1202611558,1202612158,1,1,600
26764455@N05,1875,20,1202659318,1202659918,2,1,600
26764455@N05,1876,20,1202777639,1202778239,10,1,600
26764455@N05,1877,20,1202868480,1202869080,8,1,600
26764455@N05,1878,20,1202943771,1202944371,2,1,600
26764455@N05,1879,20,1203029634,1203030234,2,1,600
26766729@N06,1880,16,1287312870,1287313290,2,1,420
26766729@N06,1881,13,1287915031,1287915331,1,1,300
26794632@N00,1882,18,1383098671,1383099211,2,3,540
26794632@N00,1882,15,1383107841,1383108201,2,3,360
26794632@N00,1882,11,1383112144,1383112384,1,3,240
26806480@N07,1883,19,1458811856,1458812396,2,1,540
26874770@N06,1884,7,1220012654,1220012774,1,1,120
26874770@N06,1885,13,1220329096,1220329396,1,1,300
26874770@N06,1886,15,1220491921,1220492281,1,1,360
26874770@N06,1887,5,1225188887,1225189007,2,4,120
26874770@N06,1887,24,1225195919,1225196449,2,4,530
26874770@N06,1887,15,1225196449,1225196809,2,4,360
26874770@N06,1887,25,1225200031,1225202131,1,4,2100
26874770@N06,1888,6,1225242763,1225242883,14,2,120
26874770@N06,1888,12,1225256469,1225256739,1,2,270
26874770@N06,1889,6,1225453865,1225453985,2,1,120
26874770@N06,1890,6,1248154462,1248154582,9,2,120
26874770@N06,1890,12,1248179038,1248179308,1,2,270
26874770@N06,1891,18,1252843453,1252843993,1,1,540
26874770@N06,1892,17,1277781699,1277782119,2,10,420
26874770@N06,1892,18,1277785668,1277785865,2,10,197
26874770@N06,1892,7,1277785865,1277785985,2,10,120
26874770@N06,1892,24,1277796746,1277798246,3,10,1500
26874770@N06,1892,25,1277805316,1277807416,2,10,2100
26874770@N06,1892,10,1277819926,1277820076,2,10,150
26874770@N06,1892,18,1277821419,1277821959,2,10,540
26874770@N06,1892,25,1277822778,1277823103,5,10,325
26874770@N06,1892,22,1277823103,1277823226,2,10,123
26874770@N06,1892,24,1277823226,1277824726,1,10,1500
26874770@N06,1893,6,1285305781,1285305901,4,3,120
26874770@N06,1893,16,1285308215,1285308635,2,3,420
26874770@N06,1893,12,1285309476,1285309746,1,3,270
26874770@N06,1894,5,1285564363,1285564390,3,8,27
26874770@N06,1894,3,1285564390,1285564431,4,8,41
26874770@N06,1894,1,1285564431,1285564475,2,8,44
26874770@N06,1894,5,1285564475,1285564595,5,8,120
26874770@N06,1894,7,1285564756,1285564876,3,8,120
26874770@N06,1894,10,1285566129,1285566279,2,8,150
26874770@N06,1894,25,1285566509,1285568609,3,8,2100
26874770@N06,1894,24,1285569960,1285571460,1,8,1500
26879117@N08,1895,20,1405029885,1405030485,1,1,600
26928146@N03,1896,14,1306672956,1306673316,1,1,360
26970624@N02,1897,25,1438584098,1438586198,6,4,2100
26970624@N02,1897,21,1438587652,1438587847,2,4,195
26970624@N02,1897,8,1438587847,1438587967,2,4,120
26970624@N02,1897,14,1438590909,1438591269,1,4,360
26996545@N08,1898,18,1217660540,1217661080,4,4,540
26996545@N08,1898,7,1217661570,1217661690,5,4,120
26996545@N08,1898,11,1217668388,1217668628,2,4,240
26996545@N08,1898,12,1217675943,1217676213,1,4,270
27045606@N06,1899,12,1358321436,1358321706,1,1,270
27136682@N00,1900,18,1209083397,1209083655,2,6,258
27136682@N00,1900,5,1209083655,1209083775,2,6,120
27136682@N00,1900,10,1209084656,1209084806,2,6,150
27136682@N00,1900,22,1209085431,1209085505,2,6,74
27136682@N00,1900,25,1209085505,1209087605,3,6,2100
27136682@N00,1900,12,1209113663,1209113933,1,6,270
27136682@N00,1901,16,1209204346,1209204766,5,1,420
27191491@N06,1902,24,1368931512,1368933012,2,3,1500
27191491@N06,1902,17,1368934755,1368935175,2,3,420
27191491@N06,1902,7,1368950367,1368950487,1,3,120
27204329@N02,1903,25,1215911795,1215913895,364,1,2100
27205052@N05,1904,13,1299472496,1299472796,1,1,300
27242285@N02,1905,16,1323941222,1323941642,1,1,420
27249348@N03,1906,18,1399688314,1399688854,2,2,540
27249348@N03,1906,6,1399702703,1399702823,1,2,120
27261720@N00,1907,1,1223316129,1223316189,2,1,60
27276174@N07,1908,12,1355358258,1355358528,1,1,270
27343295@N07,1909,23,1230511185,1230512385,2,3,1200
27343295@N07,1909,13,1230514265,1230514557,2,3,292
27343295@N07,1909,22,1230514557,1230515577,1,3,1020
27365671@N00,1910,6,1281242889,1281243009,1,1,120
27365671@N00,1911,22,1343532099,1343533119,2,4,1020
27365671@N00,1911,10,1343540506,1343540656,2,4,150
27365671@N00,1911,4,1343542405,1343542495,2,4,90
27365671@N00,1911,24,1343547863,1343549363,2,4,1500
27365671@N00,1912,8,1350080208,1350080328,2,3,120
27365671@N00,1912,20,1350085851,1350086451,2,3,600
27365671@N00,1912,14,1350100848,1350101208,1,3,360
27365671@N00,1913,14,1353618838,1353619198,1,1,360
27365671@N00,1914,11,1383351976,1383352216,2,3,240
27365671@N00,1914,18,1383355486,1383356026,2,3,540
27365671@N00,1914,19,1383371289,1383371829,2,3,540
27365671@N00,1915,6,1383431887,1383432007,1,1,120
27365671@N00,1916,3,1414134854,1414134944,1,1,90
27365671@N00,1917,12,1419368575,1419368845,1,1,270
27365671@N00,1918,3,1435977008,1435977098,2,2,90
27365671@N00,1918,17,1435980273,1435980693,1,2,420
27374044@N00,1919,17,1280792706,1280793126,3,3,420
27374044@N00,1919,23,1280793519,1280794563,2,3,1044
27374044@N00,1919,17,1280794563,1280794983,1,3,420
27374044@N00,1920,12,1280825718,1280825988,2,5,270
27374044@N00,1920,16,1280827903,1280828315,3,5,412
27374044@N00,1920,11,1280828315,1280828555,2,5,240
27374044@N00,1920,18,1280830867,1280831142,2,5,275
27374044@N00,1920,10,1280831142,1280831292,17,5,150
27374044@N00,1921,24,1280885928,1280886532,3,7,604
27374044@N00,1921,12,1280886532,1280886802,3,7,270
27374044@N00,1921,19,1280887289,1280887829,5,7,540
27374044@N00,1921,6,1280889388,1280889508,4,7,120
27374044@N00,1921,8,1280889598,1280889718,4,7,120
27374044@N00,1921,24,1280890661,1280892161,3,7,1500
27374044@N00,1921,25,1280892299,1280894399,7,7,2100
27379479@N00,1922,14,1300348183,1300348543,1,1,360
27379479@N00,1923,24,1308460018,1308461518,2,2,1500
27379479@N00,1923,13,1308476987,1308477287,1,2,300
27388187@N07,1924,18,1310695243,1310695783,4,2,540
27388187@N07,1924,20,1310703173,1310703773,1,2,600
27422735@N04,1925,24,1378205890,1378207390,2,2,1500
27422735@N04,1925,16,1378213944,1378214364,1,2,420
27428435@N00,1926,19,1248692255,1248692795,1,1,540
27428435@N00,1927,6,1276411707,1276411827,1,1,120
27452410@N00,1928,17,1357491813,1357491923,2,2,110
27452410@N00,1928,19,1357491923,1357492463,1,2,540
27464730@N06,1929,7,1332736332,1332736452,4,2,120
27464730@N06,1929,10,1332755417,1332755567,1,2,150
27467292@N03,1930,5,1276030255,1276030375,1,1,120
27467292@N03,1931,14,1355037728,1355038088,1,1,360
27492162@N03,1932,24,1382487833,1382489333,2,1,1500
27502547@N02,1933,16,1355037882,1355038302,1,1,420
27502547@N02,1934,2,1355296178,1355296238,1,1,60
27534487@N08,1935,19,1369712302,1369712842,1,1,540
27583299@N03,1936,18,1306143351,1306143891,1,1,540
27609173@N03,1937,16,1307011380,1307011800,8,1,420
27637794@N05,1938,16,1359885690,1359886110,1,1,420
27666630@N00,1939,7,1406801410,1406801530,1,1,120
27668079@N00,1940,24,1351997626,1351999126,1,1,1500
27699849@N08,1941,17,1326419015,1326419435,2,2,420
27699849@N08,1941,25,1326420168,1326422268,5,2,2100
27751748@N08,1942,21,1262078141,1262079041,4,1,900
27801060@N00,1943,24,1430709773,1430711273,1,1,1500
27813472@N00,1944,11,1361003324,1361003564,2,1,240
27813472@N00,1945,16,1361048426,1361048846,2,1,420
27813472@N00,1946,20,1361089070,1361089432,2,4,362
27813472@N00,1946,14,1361089432,1361089498,2,4,66
27813472@N00,1946,19,1361089498,1361089699,3,4,201
27813472@N00,1946,14,1361089699,1361090059,10,4,360
27813472@N00,1947,19,1361161049,1361161532,2,11,483
27813472@N00,1947,16,1361161532,1361161952,6,11,420
27813472@N00,1947,19,1361163406,1361163946,6,11,540
27813472@N00,1947,6,1361164728,1361164739,2,11,11
27813472@N00,1947,14,1361164739,1361164749,2,11,10
27813472@N00,1947,19,1361164749,1361164919,3,11,170
27813472@N00,1947,6,1361164919,1361165039,2,11,120
27813472@N00,1947,19,1361165599,1361165969,3,11,370
27813472@N00,1947,11,1361165969,1361166209,2,11,240
27813472@N00,1947,16,1361167871,1361168291,9,11,420
27813472@N00,1947,23,1361168484,1361169684,1,11,1200
27813472@N00,1948,17,1361216459,1361216879,3,10,420
27813472@N00,1948,10,1361223253,1361223403,2,10,150
27813472@N00,1948,24,1361226190,1361227690,4,10,1500
27813472@N00,1948,7,1361229631,1361229751,7,10,120
27813472@N00,1948,14,1361232602,1361232962,11,10,360
27813472@N00,1948,20,1361235225,1361235241,2,10,16
27813472@N00,1948,14,1361235241,1361235601,3,10,360
27813472@N00,1948,19,1361235949,1361236489,3,10,540
27813472@N00,1948,6,1361236720,1361236840,2,10,120
27813472@N00,1948,12,1361236994,1361237264,4,10,270
27813472@N00,1949,3,1361342489,1361342579,3,6,90
27813472@N00,1949,12,1361345912,1361346182,2,6,270
27813472@N00,1949,19,1361346591,1361347131,4,6,540
27813472@N00,1949,10,1361347833,1361347983,2,6,150
27813472@N00,1949,1,1361348585,1361348645,3,6,60
27813472@N00,1949,18,1361350072,1361350612,4,6,540
27813472@N00,1950,11,1361405185,1361405425,2,8,240
27813472@N00,1950,18,1361406276,1361406608,2,8,332
27813472@N00,1950,11,1361406608,1361406848,2,8,240
27813472@N00,1950,19,1361407007,1361407492,3,8,485
27813472@N00,1950,8,1361407492,1361407612,3,8,120
27813472@N00,1950,20,1361407677,1361408057,2,8,380
27813472@N00,1950,24,1361408057,1361408210,2,8,153
27813472@N00,1950,12,1361408210,1361408480,1,8,270
27813472@N00,1951,19,1361500708,1361501248,1,1,540
27813472@N00,1952,19,1361863474,1361864014,2,1,540
27813472@N00,1953,18,1403311386,1403311926,1,1,540
27813472@N00,1954,5,1425017225,1425017345,2,2,120
27813472@N00,1954,16,1425017530,1425017950,1,2,420
27813472@N00,1955,24,1425072862,1425072910,2,6,48
27813472@N00,1955,12,1425072910,1425073180,2,6,270
27813472@N00,1955,14,1425074794,1425075154,2,6,360
27813472@N00,1955,25,1425078197,1425080297,3,6,2100
27813472@N00,1955,24,1425092285,1425093785,3,6,1500
27813472@N00,1955,12,1425094916,1425095186,1,6,270
27813472@N00,1956,12,1437211760,1437212030,2,3,270
27813472@N00,1956,17,1437212041,1437212461,2,3,420
27813472@N00,1956,10,1437221629,1437221779,2,3,150
27813472@N00,1957,12,1437801077,1437801347,2,9,270
27813472@N00,1957,5,1437801354,1437801474,2,9,120
27813472@N00,1957,16,1437817937,1437818357,2,9,420
27813472@N00,1957,6,1437820269,1437820361,2,9,92
27813472@N00,1957,14,1437820361,1437820663,2,9,302
27813472@N00,1957,19,1437820663,1437821203,2,9,540
27813472@N00,1957,13,1437823305,1437823605,2,9,300
27813472@N00,1957,24,1437824063,1437824093,2,9,30
27813472@N00,1957,25,1437824093,1437826193,3,9,2100
27813472@N00,1958,7,1439590342,1439590462,2,9,120
27813472@N00,1958,18,1439591004,1439591544,2,9,540
27813472@N00,1958,11,1439592919,1439592955,2,9,36
27813472@N00,1958,7,1439592955,1439593075,2,9,120
27813472@N00,1958,11,1439593181,1439593302,2,9,121
27813472@N00,1958,16,1439593302,1439593576,2,9,274
27813472@N00,1958,3,1439593576,1439593666,2,9,90
27813472@N00,1958,19,1439609991,1439610531,2,9,540
27813472@N00,1958,12,1439612336,1439612606,1,9,270
27813472@N00,1959,17,1445396638,1445397058,2,2,420
27813472@N00,1959,18,1445399365,1445399905,1,2,540
27813472@N00,1960,19,1445461989,1445462529,2,9,540
27813472@N00,1960,7,1445462825,1445462945,5,9,120
27813472@N00,1960,19,1445465030,1445465570,2,9,540
27813472@N00,1960,14,1445466451,1445466811,2,9,360
27813472@N00,1960,18,1445467030,1445467570,2,9,540
27813472@N00,1960,9,1445468116,1445468236,5,9,120
27813472@N00,1960,8,1445469517,1445469637,5,9,120
27813472@N00,1960,17,1445472376,1445472796,4,9,420
27813472@N00,1960,12,1445475010,1445475280,3,9,270
27813472@N00,1961,7,1449702627,1449702747,10,6,120
27813472@N00,1961,18,1449703386,1449703926,8,6,540
27813472@N00,1961,16,1449706699,1449707119,2,6,420
27813472@N00,1961,11,1449716620,1449716860,4,6,240
27813472@N00,1961,18,1449717766,1449718306,12,6,540
27813472@N00,1961,16,1449720788,1449721208,2,6,420
27813472@N00,1962,20,1454116955,1454117555,2,1,600
27813472@N00,1963,6,1455595913,1455596033,2,1,120
27813472@N00,1964,12,1461534492,1461534762,1,1,270
27813472@N00,1965,12,1461661778,1461662048,1,1,270
27813472@N00,1966,7,1461809662,1461809782,3,5,120
27813472@N00,1966,16,1461813593,1461813782,2,5,189
27813472@N00,1966,23,1461813782,1461814982,2,5,1200
27813472@N00,1966,17,1461815417,1461815837,2,5,420
27813472@N00,1966,7,1461824031,1461824151,1,5,120
27835170@N07,1967,10,1453335050,1453335200,1,1,150
27835170@N07,1968,10,1453435197,1453435347,2,1,150
27844735@N06,1969,3,1217827662,1217827752,15,1,90
27844735@N06,1970,3,1218160688,1218160778,11,1,90
27846420@N03,1971,18,1268155687,1268156227,1,1,540
27851952@N00,1972,19,1351817576,1351818116,1,1,540
27874578@N06,1973,16,1440983323,1440983743,8,1,420
27934342@N00,1974,7,1420843410,1420843530,2,3,120
27934342@N00,1974,8,1420870865,1420870985,2,3,120
27934342@N00,1974,25,1420872154,1420874254,3,3,2100
27947273@N03,1975,6,1243073700,1243073820,1,1,120
27948083@N02,1976,18,1329457804,1329458344,1,1,540
27948083@N02,1977,17,1333508670,1333509090,2,2,420
27948083@N02,1977,11,1333534224,1333534464,1,2,240
27975072@N04,1978,18,1406781008,1406781548,1,1,540
27983123@N00,1979,6,1270985258,1270985378,1,1,120
27983123@N00,1980,19,1302397200,1302397740,1,1,540
28006064@N02,1981,24,1460130079,1460131579,2,2,1500
28006064@N02,1981,5,1460133743,1460133863,1,2,120
28040168@N06,1982,24,1341318829,1341320329,1,1,1500
28040168@N06,1983,24,1343458703,1343460203,1,1,1500
28040168@N06,1984,14,1344469799,1344470159,1,1,360
28040168@N06,1985,25,1369117812,1369117848,3,4,36
28040168@N06,1985,14,1369117848,1369118208,2,4,360
28040168@N06,1985,7,1369119555,1369119565,2,4,10
28040168@N06,1985,25,1369119565,1369121665,1,4,2100
28057734@N03,1986,16,1336424586,1336425006,1,1,420
28069890@N06,1987,10,1214529284,1214529434,1,1,150
28132447@N00,1988,7,1220677068,1220677188,3,3,120
28132447@N00,1988,11,1220677233,1220677473,3,3,240
28132447@N00,1988,16,1220680366,1220680786,2,3,420
28132447@N00,1989,17,1264901785,1264902205,1,1,420
28139097@N00,1990,12,1197704008,1197704278,1,1,270
28163198@N05,1991,12,1395290118,1395290388,1,1,270
28172462@N00,1992,11,1328673426,1328673666,3,2,240
28172462@N00,1992,7,1328686640,1328686760,1,2,120
28172462@N00,1993,13,1330929586,1330929886,1,1,300
28173640@N00,1994,23,1340758678,1340759878,2,1,1200
28173640@N00,1995,10,1340795656,1340795806,1,1,150
28173907@N00,1996,16,1283633799,1283634219,1,1,420
28173907@N00,1997,14,1363496225,1363496388,8,2,163
28173907@N00,1997,6,1363496388,1363496508,2,2,120
28215341@N07,1998,5,1429056918,1429057038,1,1,120
28223347@N00,1999,13,1270086286,1270086485,3,3,199
28223347@N00,1999,22,1270086485,1270087505,4,3,1020
28223347@N00,1999,16,1270088290,1270088710,1,3,420
28287117@N00,2000,12,1282096419,1282096689,2,1,270
28293356@N00,2001,1,1381802979,1381803039,2,2,60
28293356@N00,2001,16,1381804592,1381805012,2,2,420
28312009@N03,2002,11,1310176298,1310176538,1,1,240
28402154@N03,2003,19,1388402738,1388403278,2,2,540
28402154@N03,2003,16,1388403637,1388404057,1,2,420
28402154@N03,2004,15,1391241934,1391242294,1,1,360
28402154@N03,2005,24,1391302399,1391302406,2,2,7
28402154@N03,2005,19,1391302406,1391302946,1,2,540
28402154@N03,2006,24,1396279749,1396281249,1,1,1500
28402154@N03,2007,7,1411030342,1411030462,1,1,120
28427006@N07,2008,17,1448787833,1448788253,1,1,420
28427006@N07,2009,17,1448863174,1448863594,1,1,420
28443026@N04,2010,10,1385540548,1385540698,1,1,150
28446678@N00,2011,17,1224332813,1224333233,1,1,420
28450912@N02,2012,24,1446773854,1446774962,2,4,1108
28450912@N02,2012,12,1446774962,1446775232,2,4,270
28450912@N02,2012,14,1446775680,1446776040,5,4,360
28450912@N02,2012,16,1446780918,1446781338,1,4,420
28450912@N02,2013,24,1446816240,1446816800,2,5,560
28450912@N02,2013,16,1446816800,1446817220,3,5,420
28450912@N02,2013,19,1446817296,1446817422,2,5,126
28450912@N02,2013,6,1446817422,1446817542,5,5,120
28450912@N02,2013,14,1446817786,1446818146,4,5,360
28495222@N04,2014,12,1238416631,1238416901,1,1,270
28498286@N05,2015,14,1371355516,1371355876,1,1,360
28519626@N07,2016,7,1299138098,1299138218,3,2,120
28519626@N07,2016,16,1299140930,1299141350,1,2,420
28519626@N07,2017,22,1299226273,1299226644,2,4,371
28519626@N07,2017,13,1299226644,1299226901,2,4,257
28519626@N07,2017,25,1299226901,1299227570,2,4,669
28519626@N07,2017,13,1299227570,1299227870,2,4,300
28519626@N07,2018,14,1353424236,1353424596,1,1,360
28519626@N07,2019,12,1353453097,1353453367,1,1,270
28519626@N07,2020,6,1353538169,1353538289,2,2,120
28519626@N07,2020,14,1353561210,1353561570,1,2,360
28530203@N03,2021,15,1388183478,1388183838,2,5,360
28530203@N03,2021,17,1388190116,1388190536,4,5,420
28530203@N03,2021,23,1388191624,1388192824,2,5,1200
28530203@N03,2021,15,1388200285,1388200645,2,5,360
28530203@N03,2021,12,1388204171,1388204441,1,5,270
28555425@N00,2022,17,1347871091,1347871511,1,1,420
28555425@N00,2023,14,1347930665,1347930727,2,13,62
28555425@N00,2023,25,1347930727,1347930883,2,13,156
28555425@N00,2023,17,1347930883,1347931126,6,13,243
28555425@N00,2023,19,1347931126,1347931161,3,13,35
28555425@N00,2023,17,1347931161,1347931581,2,13,420
28555425@N00,2023,6,1347932140,1347932260,2,13,120
28555425@N00,2023,25,1347933255,1347935192,2,13,1937
28555425@N00,2023,1,1347935192,1347935252,2,13,60
28555425@N00,2023,14,1347958386,1347958746,2,13,360
28555425@N00,2023,18,1347959865,1347960405,4,13,540
28555425@N00,2023,19,1347962729,1347963269,5,13,540
28555425@N00,2023,24,1347963403,1347963486,2,13,83
28555425@N00,2023,20,1347963486,1347964086,1,13,600
28555425@N00,2024,19,1348223305,1348223845,1,1,540
28567108@N00,2025,25,1304650107,1304652207,33,4,2100
28567108@N00,2025,15,1304656811,1304657171,2,4,360
28567108@N00,2025,23,1304657782,1304658982,2,4,1200
28567108@N00,2025,16,1304678618,1304679038,115,4,420
28578572@N05,2026,13,1301641424,1301641724,1,1,300
28585603@N04,2027,3,1363585400,1363585490,1,1,90
28585603@N04,2028,16,1363829306,1363829726,4,5,420
28585603@N04,2028,11,1363830942,1363831182,2,5,240
28585603@N04,2028,17,1363831814,1363832234,2,5,420
28585603@N04,2028,18,1363834903,1363835443,4,5,540
28585603@N04,2028,19,1363837238,1363837778,3,5,540
28654593@N07,2029,25,1237782463,1237784563,1,1,2100
28689840@N02,2030,24,1371521399,1371522899,1,1,1500
28715461@N05,2031,16,1341065275,1341065695,1,1,420
28786002@N00,2032,18,1244252087,1244252627,10,1,540
28789195@N03,2033,12,1467441083,1467441353,1,1,270
28789416@N05,2034,12,1343203117,1343203387,1,1,270
28797200@N05,2035,16,1281401098,1281401518,1,1,420
28799689@N00,2036,25,1203139817,1203141917,4,2,2100
28799689@N00,2036,16,1203146849,1203147269,1,2,420
28801640@N08,2037,6,1345100676,1345100796,3,1,120
28886223@N00,2038,19,1390941265,1390941805,2,3,540
28886223@N00,2038,24,1390948077,1390949577,4,3,1500
28886223@N00,2038,19,1390953086,1390953626,1,3,540
28927824@N05,2039,24,1231573568,1231575068,18,1,1500
28927824@N05,2040,24,1237275992,1237277492,4,1,1500
28935188@N00,2041,16,1285655841,1285656261,1,1,420
28935188@N00,2042,16,1349907399,1349907819,4,3,420
28935188@N00,2042,8,1349913579,1349913699,3,3,120
28935188@N00,2042,7,1349930041,1349930161,2,3,120
28935188@N00,2043,16,1383519630,1383520050,2,3,420
28935188@N00,2043,17,1383523118,1383523538,2,3,420
28935188@N00,2043,13,1383529556,1383529856,1,3,300
28935188@N00,2044,19,1383630444,1383630984,2,1,540
28935188@N00,2045,22,1383699889,1383700909,1,1,1020
28935188@N00,2046,23,1450386500,1450386614,2,7,114
28935188@N00,2046,16,1450386614,1450386739,2,7,125
28935188@N00,2046,6,1450386739,1450386769,2,7,30
28935188@N00,2046,14,1450386769,1450387129,4,7,360
28935188@N00,2046,18,1450393963,1450394503,2,7,540
28935188@N00,2046,16,1450396651,1450397071,2,7,420
28935188@N00,2046,17,1450397181,1450397601,1,7,420
28947491@N03,2047,12,1237024313,1237024583,2,1,270
28977679@N02,2048,16,1453177672,1453178092,4,1,420
28977679@N02,2049,14,1453484224,1453484465,4,3,241
28977679@N02,2049,19,1453484465,1453485005,3,3,540
28977679@N02,2049,16,1453487761,1453488181,12,3,420
28986472@N02,2050,16,1233534398,1233534818,1,1,420
29013352@N06,2051,15,1303797163,1303797523,5,1,360
29066111@N06,2052,19,1464145987,1464146527,4,5,540
29066111@N06,2052,8,1464147136,1464147256,3,5,120
29066111@N06,2052,14,1464147394,1464147754,2,5,360
29066111@N06,2052,5,1464151055,1464151175,2,5,120
29066111@N06,2052,18,1464151201,1464151741,5,5,540
29080772@N05,2053,17,1221191844,1221192264,3,2,420
29080772@N05,2053,3,1221219167,1221219257,2,2,90
29080772@N05,2054,25,1221270770,1221272870,1,1,2100
29080772@N05,2055,25,1221344584,1221346684,1,1,2100
29080772@N05,2056,13,1221377869,1221378169,1,1,300
29131150@N07,2057,14,1340194248,1340194608,1,1,360
29141650@N00,2058,17,1450259805,1450260225,1,1,420
29202288@N04,2059,14,1381318939,1381319299,1,1,360
29224349@N04,2060,13,1349475298,1349475598,1,1,300
29224349@N04,2061,13,1351890179,1351890479,47,7,300
29224349@N04,2061,22,1351897480,1351898250,14,7,770
29224349@N04,2061,25,1351898250,1351898258,2,7,8
29224349@N04,2061,22,1351898258,1351898291,2,7,33
29224349@N04,2061,25,1351898291,1351898309,2,7,18
29224349@N04,2061,22,1351898309,1351898489,2,7,180
29224349@N04,2061,13,1351898489,1351898789,2,7,300
29224349@N04,2062,13,1352499741,1352500041,14,4,300
29224349@N04,2062,22,1352509976,1352510315,2,4,339
29224349@N04,2062,13,1352510315,1352510615,2,4,300
29224349@N04,2062,24,1352510646,1352512146,1,4,1500
29224349@N04,2063,13,1353719930,1353720230,6,1,300
29224349@N04,2064,13,1364598715,1364599015,1,1,300
29225947@N00,2065,17,1318461266,1318461686,22,11,420
29225947@N00,2065,13,1318463327,1318463425,4,11,98
29225947@N00,2065,25,1318463425,1318464256,7,11,831
29225947@N00,2065,12,1318464256,1318464526,9,11,270
29225947@N00,2065,23,1318465927,1318466205,8,11,278
29225947@N00,2065,16,1318466205,1318466625,17,11,420
29225947@N00,2065,3,1318470180,1318470270,3,11,90
29225947@N00,2065,18,1318496031,1318496571,21,11,540
29225947@N00,2065,16,1318497534,1318497954,17,11,420
29225947@N00,2065,10,1318498670,1318498820,3,11,150
29225947@N00,2065,16,1318500518,1318500938,9,11,420
29225947@N00,2066,18,1318561226,1318561272,2,6,46
29225947@N00,2066,7,1318561272,1318561341,2,6,69
29225947@N00,2066,18,1318561341,1318561881,3,6,540
29225947@N00,2066,3,1318563107,1318563197,3,6,90
29225947@N00,2066,7,1318566973,1318567093,2,6,120
29225947@N00,2066,16,1318567183,1318567603,1,6,420
29225947@N00,2067,10,1318640556,1318640706,3,1,150
29226532@N00,2068,23,1407120914,1407122114,4,3,1200
29226532@N00,2068,16,1407123312,1407123732,2,3,420
29226532@N00,2068,19,1407131333,1407131873,1,3,540
29238928@N03,2069,18,1349478810,1349479350,2,4,540
29238928@N03,2069,7,1349481524,1349481644,8,4,120
29238928@N03,2069,11,1349487062,1349487302,3,4,240
29238928@N03,2069,16,1349496415,1349496835,2,4,420
29238928@N03,2070,10,1349568582,1349568690,2,7,108
29238928@N03,2070,14,1349568690,1349569050,2,7,360
29238928@N03,2070,8,1349569158,1349569278,2,7,120
29238928@N03,2070,18,1349573859,1349574399,2,7,540
29238928@N03,2070,16,1349575490,1349575910,2,7,420
29238928@N03,2070,10,1349595918,1349596068,3,7,150
29238928@N03,2070,16,1349604443,1349604863,2,7,420
29259314@N04,2071,25,1254714468,1254716568,1,1,2100
29259314@N04,2072,12,1254868721,1254868734,2,30,13
29259314@N04,2072,24,1254868734,1254868814,2,30,80
29259314@N04,2072,12,1254868814,1254868982,2,30,168
29259314@N04,2072,17,1254868982,1254869402,2,30,420
29259314@N04,2072,7,1254870940,1254870966,2,30,26
29259314@N04,2072,17,1254870966,1254871386,2,30,420
29259314@N04,2072,18,1254873341,1254873726,6,30,385
29259314@N04,2072,16,1254873726,1254873855,2,30,129
29259314@N04,2072,15,1254873855,1254873884,2,30,29
29259314@N04,2072,16,1254873884,1254874080,2,30,196
29259314@N04,2072,17,1254874080,1254874468,2,30,388
29259314@N04,2072,12,1254874468,1254874738,7,30,270
29259314@N04,2072,24,1254876608,1254876803,6,30,195
29259314@N04,2072,13,1254876803,1254876843,2,30,40
29259314@N04,2072,25,1254876843,1254877012,3,30,169
29259314@N04,2072,15,1254877012,1254877372,2,30,360
29259314@N04,2072,13,1254878442,1254878742,4,30,300
29259314@N04,2072,20,1254880276,1254880312,2,30,36
29259314@N04,2072,6,1254880312,1254880432,4,30,120
29259314@N04,2072,19,1254880465,1254881005,5,30,540
29259314@N04,2072,23,1254884806,1254885641,5,30,835
29259314@N04,2072,7,1254885641,1254885761,8,30,120
29259314@N04,2072,16,1254886962,1254886980,2,30,18
29259314@N04,2072,15,1254886980,1254887037,3,30,57
29259314@N04,2072,16,1254887037,1254887122,2,30,85
29259314@N04,2072,7,1254887122,1254887149,2,30,27
29259314@N04,2072,16,1254887149,1254887381,3,30,232
29259314@N04,2072,7,1254887381,1254887402,2,30,21
29259314@N04,2072,16,1254887402,1254887430,2,30,28
29259314@N04,2072,7,1254887430,1254887550,4,30,120
29259314@N04,2073,5,1314997582,1314997702,2,14,120
29259314@N04,2073,15,1314998791,1314998833,2,14,42
29259314@N04,2073,7,1314998833,1314998891,2,14,58
29259314@N04,2073,19,1314998891,1314998953,3,14,62
29259314@N04,2073,15,1314998953,1314999054,2,14,101
29259314@N04,2073,19,1314999054,1314999162,2,14,108
29259314@N04,2073,11,1314999162,1314999184,2,14,22
29259314@N04,2073,18,1314999184,1314999284,4,14,100
29259314@N04,2073,6,1314999284,1314999309,2,14,25
29259314@N04,2073,7,1314999309,1314999319,2,14,10
29259314@N04,2073,3,1314999319,1314999339,2,14,20
29259314@N04,2073,5,1314999339,1314999418,2,14,79
29259314@N04,2073,3,1314999418,1314999508,2,14,90
29259314@N04,2073,12,1315001000,1315001270,3,14,270
29259314@N04,2074,22,1315081550,1315081600,2,6,50
29259314@N04,2074,24,1315081600,1315081653,2,6,53
29259314@N04,2074,6,1315081653,1315081773,2,6,120
29259314@N04,2074,14,1315088217,1315088577,2,6,360
29259314@N04,2074,7,1315102978,1315103098,2,6,120
29259314@N04,2074,21,1315106042,1315106942,1,6,900
29259314@N04,2075,13,1315216508,1315216808,8,1,300
29259314@N04,2076,14,1315279172,1315279532,2,4,360
29259314@N04,2076,18,1315301205,1315301745,4,4,540
29259314@N04,2076,10,1315302622,1315302628,2,4,6
29259314@N04,2076,18,1315302628,1315303168,1,4,540
29259314@N04,2077,2,1352613185,1352613245,1,1,60
29259314@N04,2078,19,1377897690,1377898230,2,7,540
29259314@N04,2078,24,1377898460,1377899960,2,7,1500
29259314@N04,2078,23,1377902936,1377904136,2,7,1200
29259314@N04,2078,19,1377909531,1377910071,3,7,540
29259314@N04,2078,8,1377911116,1377911236,2,7,120
29259314@N04,2078,14,1377911658,1377912018,2,7,360
29259314@N04,2078,7,1377912655,1377912775,3,7,120
29259314@N04,2079,10,1377979895,1377980045,2,2,150
29259314@N04,2079,16,1377980343,1377980763,1,2,420
29259314@N04,2080,5,1378090729,1378090849,2,5,120
29259314@N04,2080,17,1378107192,1378107612,2,5,420
29259314@N04,2080,18,1378108760,1378109300,9,5,540
29259314@N04,2080,12,1378115762,1378116032,2,5,270
29259314@N04,2080,18,1378118224,1378118764,1,5,540
29259314@N04,2081,24,1378166413,1378167557,2,16,1144
29259314@N04,2081,8,1378167557,1378167677,2,16,120
29259314@N04,2081,14,1378168129,1378168489,3,16,360
29259314@N04,2081,6,1378170047,1378170167,4,16,120
29259314@N04,2081,10,1378174925,1378174966,2,16,41
29259314@N04,2081,14,1378174966,1378175326,2,16,360
29259314@N04,2081,6,1378176951,1378177071,2,16,120
29259314@N04,2081,24,1378184396,1378185896,2,16,1500
29259314@N04,2081,13,1378194222,1378194522,2,16,300
29259314@N04,2081,7,1378200445,1378200565,6,16,120
29259314@N04,2081,19,1378202387,1378202536,2,16,149
29259314@N04,2081,16,1378202536,1378202956,5,16,420
29259314@N04,2081,6,1378206052,1378206172,3,16,120
29259314@N04,2081,14,1378206213,1378206554,5,16,341
29259314@N04,2081,6,1378206554,1378206674,2,16,120
29259314@N04,2081,24,1378206767,1378208267,3,16,1500
29259314@N04,2082,14,1378282328,1378282688,1,1,360
29311223@N00,2083,9,1225587845,1225587965,3,3,120
29311223@N00,2083,11,1225604957,1225605197,3,3,240
29311223@N00,2083,16,1225608115,1225608535,3,3,420
29311223@N00,2084,25,1226369911,1226372011,2,2,2100
29311223@N00,2084,24,1226373566,1226375066,1,2,1500
29311223@N00,2085,22,1228614141,1228614941,2,3,800
29311223@N00,2085,24,1228614941,1228616441,3,3,1500
29311223@N00,2085,17,1228619658,1228620078,2,3,420
29311223@N00,2086,11,1240907649,1240907889,1,1,240
29311223@N00,2087,16,1245924536,1245924956,1,1,420
29315916@N07,2088,15,1373523931,1373524291,2,3,360
29315916@N07,2088,16,1373525099,1373525519,2,3,420
29315916@N07,2088,17,1373528662,1373529082,1,3,420
29329200@N04,2089,25,1419995703,1419997803,3,3,2100
29329200@N04,2089,14,1420000164,1420000524,2,3,360
29329200@N04,2089,18,1420013336,1420013876,1,3,540
29329200@N04,2090,25,1420079559,1420081659,1,1,2100
29329200@N04,2091,11,1420117509,1420117749,1,1,240
29329200@N04,2092,13,1420161692,1420161992,1,1,300
29329200@N04,2093,14,1420361396,1420361756,1,1,360
29335885@N00,2094,7,1388376009,1388376129,1,1,120
29358051@N07,2095,24,1216442590,1216442750,2,2,160
29358051@N07,2095,13,1216442750,1216443050,1,2,300
29358051@N07,2096,12,1221906641,1221906911,1,1,270
29389873@N00,2097,18,1239152825,1239153365,2,1,540
29426527@N03,2098,7,1361427956,1361428076,1,1,120
29426527@N03,2099,12,1361491795,1361492065,2,1,270
29426527@N03,2100,14,1361946370,1361946730,1,1,360
29426527@N03,2101,12,1363074907,1363075177,1,1,270
29426527@N03,2102,12,1363691706,1363691976,1,1,270
29426527@N03,2103,7,1364285104,1364285224,1,1,120
29426527@N03,2104,12,1365462057,1365462327,1,1,270
29426527@N03,2105,12,1367124106,1367124376,2,1,270
29426527@N03,2106,12,1367742926,1367743196,2,2,270
29426527@N03,2106,13,1367747155,1367747455,1,2,300
29426527@N03,2107,7,1368004953,1368005073,1,1,120
29426527@N03,2108,7,1368436305,1368436425,1,1,120
29426527@N03,2109,7,1369620786,1369620906,1,1,120
29426527@N03,2110,18,1371462382,1371462922,1,1,540
29426527@N03,2111,18,1375757287,1375757827,1,1,540
29426527@N03,2112,24,1377595953,1377597324,2,2,1371
29426527@N03,2112,19,1377597324,1377597864,1,2,540
29426527@N03,2113,24,1378169520,1378171020,2,1,1500
29428169@N02,2114,15,1352080447,1352080807,1,1,360
29482910@N07,2115,16,1362211255,1362211675,3,1,420
29507492@N07,2116,12,1276507367,1276507637,3,10,270
29507492@N07,2116,24,1276523926,1276524389,3,10,463
29507492@N07,2116,22,1276524389,1276524564,5,10,175
29507492@N07,2116,24,1276524564,1276525682,2,10,1118
29507492@N07,2116,22,1276525682,1276526702,2,10,1020
29507492@N07,2116,23,1276532586,1276532945,2,10,359
29507492@N07,2116,16,1276532945,1276533141,4,10,196
29507492@N07,2116,11,1276533141,1276533381,3,10,240
29507492@N07,2116,18,1276533400,1276533940,2,10,540
29507492@N07,2116,11,1276535284,1276535524,1,10,240
29507492@N07,2117,16,1276586903,1276587323,4,8,420
29507492@N07,2117,5,1276587868,1276587877,2,8,9
29507492@N07,2117,18,1276587877,1276588417,8,8,540
29507492@N07,2117,6,1276598838,1276598839,2,8,1
29507492@N07,2117,20,1276598839,1276598840,2,8,1
29507492@N07,2117,6,1276598840,1276598960,2,8,120
29507492@N07,2117,12,1276600943,1276601213,2,8,270
29507492@N07,2117,16,1276622110,1276622530,26,8,420
29507492@N07,2118,12,1277045140,1277045410,2,2,270
29507492@N07,2118,25,1277050006,1277052106,15,2,2100
29507492@N07,2119,19,1277303465,1277304005,45,4,540
29507492@N07,2119,16,1277308289,1277308366,2,4,77
29507492@N07,2119,11,1277308366,1277308606,2,4,240
29507492@N07,2119,15,1277309488,1277309848,1,4,360
29555476@N06,2120,18,1336383335,1336383875,1,1,540
29619840@N00,2121,12,1189263723,1189263727,7,2,4
29619840@N00,2121,16,1189263727,1189264147,1,2,420
29639346@N08,2122,1,1221130532,1221130592,3,1,60
29639346@N08,2123,1,1221167595,1221167655,2,1,60
29639346@N08,2124,1,1221281595,1221281655,1,1,60
29650271@N08,2125,11,1298692145,1298692385,2,2,240
29650271@N08,2125,7,1298694501,1298694621,1,2,120
29684629@N08,2126,17,1421396778,1421397198,2,3,420
29684629@N08,2126,14,1421408926,1421409286,2,3,360
29684629@N08,2126,19,1421409735,1421410275,1,3,540
29684629@N08,2127,18,1421481339,1421481787,2,2,448
29684629@N08,2127,17,1421481787,1421482207,1,2,420
29684629@N08,2128,23,1421537506,1421538706,2,3,1200
29684629@N08,2128,17,1421548213,1421548633,2,3,420
29684629@N08,2128,23,1421552445,1421553645,5,3,1200
29722669@N05,2129,6,1343467300,1343467420,1,1,120
29722669@N05,2130,12,1343895288,1343895558,1,1,270
29722669@N05,2131,12,1345683757,1345684027,1,1,270
29758791@N00,2132,14,1358642664,1358643024,1,1,360
29762068@N03,2133,12,1252097724,1252097777,2,6,53
29762068@N03,2133,20,1252097777,1252097827,2,6,50
29762068@N03,2133,9,1252097827,1252097875,2,6,48
29762068@N03,2133,24,1252097875,1252097926,2,6,51
29762068@N03,2133,25,1252097926,1252098030,2,6,104
29762068@N03,2133,13,1252098030,1252098330,1,6,300
29762068@N03,2134,11,1252181057,1252181297,2,16,240
29762068@N03,2134,14,1252181303,1252181401,2,16,98
29762068@N03,2134,19,1252181401,1252181450,2,16,49
29762068@N03,2134,6,1252181450,1252181500,2,16,50
29762068@N03,2134,12,1252181500,1252181770,2,16,270
29762068@N03,2134,2,1252184746,1252184794,2,16,48
29762068@N03,2134,6,1252184794,1252184845,2,16,51
29762068@N03,2134,10,1252184845,1252184894,2,16,49
29762068@N03,2134,5,1252184894,1252185014,2,16,120
29762068@N03,2134,3,1252185258,1252185311,2,16,53
29762068@N03,2134,1,1252185311,1252185362,2,16,51
29762068@N03,2134,19,1252185362,1252185412,2,16,50
29762068@N03,2134,6,1252185412,1252185461,2,16,49
29762068@N03,2134,9,1252185461,1252185510,2,16,49
29762068@N03,2134,15,1252185510,1252185870,2,16,360
29762068@N03,2134,14,1252190451,1252190811,1,16,360
29764570@N00,2135,11,1286983787,1286984027,2,6,240
29764570@N00,2135,18,1286984194,1286984734,6,6,540
29764570@N00,2135,7,1286985877,1286985997,3,6,120
29764570@N00,2135,16,1286997973,1286998393,2,6,420
29764570@N00,2135,15,1286998531,1286998891,3,6,360
29764570@N00,2135,10,1287003059,1287003209,1,6,150
29764570@N00,2136,12,1287870748,1287871018,3,10,270
29764570@N00,2136,20,1287873388,1287873631,3,10,243
29764570@N00,2136,16,1287873631,1287874051,4,10,420
29764570@N00,2136,10,1287874143,1287874293,3,10,150
29764570@N00,2136,18,1287874472,1287875012,6,10,540
29764570@N00,2136,11,1287876410,1287876650,3,10,240
29764570@N00,2136,4,1287881598,1287881688,4,10,90
29764570@N00,2136,15,1287881814,1287882174,2,10,360
29764570@N00,2136,24,1287883480,1287884050,2,10,570
29764570@N00,2136,13,1287884050,1287884350,4,10,300
29764570@N00,2137,16,1287914467,1287914887,12,1,420
29774230@N00,2138,14,1397004715,1397005075,2,2,360
29774230@N00,2138,19,1397007931,1397008471,1,2,540
29785315@N07,2139,20,1251011056,1251011656,19,1,600
29785315@N07,2140,20,1251168853,1251169453,36,1,600
29785315@N07,2141,20,1399158134,1399158734,38,1,600
29785315@N07,2142,20,1399243358,1399243958,15,1,600
29788456@N00,2143,5,1223604006,1223604126,2,1,120
29807137@N03,2144,13,1248849464,1248849764,2,3,300
29807137@N03,2144,19,1248857157,1248857697,2,3,540
29807137@N03,2144,17,1248857748,1248858168,1,3,420
29848483@N05,2145,5,1354674274,1354674394,1,1,120
29856669@N02,2146,12,1357110077,1357110347,2,1,270
29873212@N05,2147,18,1416986566,1416987106,7,1,540
29873212@N05,2148,17,1440613784,1440614204,1,1,420
29885425@N02,2149,24,1303963300,1303963341,2,3,41
29885425@N02,2149,20,1303963341,1303963387,3,3,46
29885425@N02,2149,6,1303963387,1303963507,1,3,120
29948744@N03,2150,12,1193960855,1193961125,2,2,270
29948744@N03,2150,18,1193968100,1193968640,1,2,540
29948744@N03,2151,20,1209351286,1209351886,1,1,600
29966284@N00,2152,6,1352162872,1352162992,2,6,120
29966284@N00,2152,14,1352168221,1352168581,2,6,360
29966284@N00,2152,16,1352175533,1352175953,2,6,420
29966284@N00,2152,14,1352183528,1352183888,3,6,360
29966284@N00,2152,3,1352188871,1352188961,2,6,90
29966284@N00,2152,19,1352190302,1352190842,1,6,540
29966284@N00,2153,12,1461156782,1461157052,1,1,270
30082031@N04,2154,15,1307264820,1307265180,1,1,360
30082031@N04,2155,14,1354226882,1354227242,1,1,360
30141170@N07,2156,23,1335503991,1335505191,1,1,1200
30141170@N07,2157,20,1335576931,1335577531,1,1,600
30141170@N07,2158,16,1335615327,1335615747,2,1,420
30141170@N07,2159,14,1348304328,1348304688,1,1,360
30147619@N04,2160,14,1455338705,1455339065,2,2,360
30147619@N04,2160,17,1455344765,1455345185,1,2,420
30184872@N06,2161,25,1301614758,1301616858,1,1,2100
30184872@N06,2162,23,1320725117,1320726317,1,1,1200
30184872@N06,2163,18,1344594212,1344594752,1,1,540
30184872@N06,2164,3,1352684466,1352684556,1,1,90
30184872@N06,2165,16,1357020947,1357021367,2,2,420
30184872@N06,2165,6,1357021760,1357021880,2,2,120
30184872@N06,2166,16,1358123311,1358123731,2,5,420
30184872@N06,2166,3,1358128137,1358128227,2,5,90
30184872@N06,2166,1,1358128722,1358128782,2,5,60
30184872@N06,2166,16,1358128982,1358129172,2,5,190
30184872@N06,2166,10,1358129172,1358129322,1,5,150
30288502@N07,2167,18,1301376749,1301377289,1,1,540
30296805@N00,2168,14,1452296718,1452297078,2,4,360
30296805@N00,2168,19,1452325085,1452325625,3,4,540
30296805@N00,2168,16,1452325791,1452326211,2,4,420
30296805@N00,2168,14,1452326648,1452327008,3,4,360
30298163@N06,2169,14,1367634566,1367634926,5,2,360
30298163@N06,2169,19,1367643708,1367644248,1,2,540
30314547@N00,2170,15,1323427737,1323428097,2,2,360
30314547@N00,2170,16,1323435823,1323436243,3,2,420
30346812@N07,2171,20,1454390398,1454390998,1,1,600
30350281@N06,2172,10,1342416542,1342416692,1,1,150
30350281@N06,2173,17,1344210317,1344210603,2,4,286
30350281@N06,2173,23,1344210603,1344210624,2,4,21
30350281@N06,2173,19,1344210624,1344211164,2,4,540
30350281@N06,2173,14,1344216779,1344217139,1,4,360
30350281@N06,2174,6,1344246576,1344246696,2,2,120
30350281@N06,2174,16,1344255156,1344255576,1,2,420
30350281@N06,2175,24,1344308372,1344309872,3,2,1500
30350281@N06,2175,17,1344324490,1344324910,1,2,420
30350281@N06,2176,13,1345444106,1345444132,2,4,26
30350281@N06,2176,14,1345444132,1345444492,5,4,360
30350281@N06,2176,3,1345452765,1345452855,2,4,90
30350281@N06,2176,14,1345454929,1345455289,1,4,360
30401284@N05,2177,18,1311540007,1311540547,1,1,540
30401284@N05,2178,7,1342662330,1342662450,4,2,120
30401284@N05,2178,5,1342663518,1342663638,4,2,120
30438157@N03,2179,24,1371435051,1371436551,2,4,1500
30438157@N03,2179,25,1371451624,1371453724,3,4,2100
30438157@N03,2179,16,1371466610,1371467030,2,4,420
30438157@N03,2179,14,1371472914,1371473274,7,4,360
30446909@N07,2180,17,1293142596,1293143016,1,1,420
30446909@N07,2181,24,1293348000,1293349500,1,1,1500
30450479@N04,2182,18,1373514713,1373515253,2,3,540
30450479@N04,2182,12,1373525051,1373525321,2,3,270
30450479@N04,2182,5,1373537972,1373538092,1,3,120
30517235@N02,2183,15,1267595850,1267596210,2,5,360
30517235@N02,2183,7,1267597576,1267597696,2,5,120
30517235@N02,2183,16,1267598012,1267598072,2,5,60
30517235@N02,2183,23,1267598072,1267599272,2,5,1200
30517235@N02,2183,6,1267606495,1267606615,1,5,120
30531653@N00,2184,17,1409700358,1409700778,137,1,420
30545687@N00,2185,24,1213337791,1213339291,29,1,1500
30573133@N00,2186,12,1375421729,1375421790,2,5,61
30573133@N00,2186,24,1375421790,1375422187,3,5,397
30573133@N00,2186,14,1375422187,1375422547,7,5,360
30573133@N00,2186,10,1375431274,1375431424,4,5,150
30573133@N00,2186,19,1375433518,1375434058,2,5,540
30573133@N00,2187,14,1375510757,1375511117,3,2,360
30573133@N00,2187,19,1375513126,1375513666,2,2,540
30573133@N00,2188,18,1375612454,1375612994,1,1,540
30573133@N00,2189,23,1375671051,1375672251,3,2,1200
30573133@N00,2189,14,1375674959,1375675319,1,2,360
30573133@N00,2190,14,1375963159,1375963519,2,1,360
30573204@N04,2191,7,1381730309,1381730429,1,1,120
30573204@N04,2192,13,1444084499,1444084799,6,11,300
30573204@N04,2192,24,1444084871,1444086371,2,11,1500
30573204@N04,2192,13,1444089044,1444089344,4,11,300
30573204@N04,2192,2,1444091775,1444091835,3,11,60
30573204@N04,2192,15,1444099737,1444100097,2,11,360
30573204@N04,2192,16,1444102613,1444103033,2,11,420
30573204@N04,2192,14,1444106919,1444107279,3,11,360
30573204@N04,2192,18,1444110171,1444110711,5,11,540
30573204@N04,2192,7,1444113902,1444114022,2,11,120
30573204@N04,2192,19,1444115603,1444116143,3,11,540
30573204@N04,2192,6,1444117404,1444117524,1,11,120
30613719@N00,2193,12,1321254346,1321254616,8,1,270
30613719@N00,2194,12,1321343725,1321343995,13,1,270
30621442@N00,2195,18,1413018752,1413019292,1,1,540
30650680@N02,2196,19,1333264105,1333264645,1,1,540
30650680@N02,2197,19,1333363868,1333364408,1,1,540
30650680@N02,2198,18,1333432827,1333433367,3,3,540
30650680@N02,2198,7,1333442399,1333442519,2,3,120
30650680@N02,2198,16,1333443036,1333443456,1,3,420
30650680@N02,2199,25,1359334987,1359337087,2,6,2100
30650680@N02,2199,11,1359338167,1359338407,2,6,240
30650680@N02,2199,7,1359339517,1359339550,2,6,33
30650680@N02,2199,16,1359339550,1359339970,3,6,420
30650680@N02,2199,20,1359340195,1359340536,2,6,341
30650680@N02,2199,24,1359340536,1359342036,1,6,1500
30650680@N02,2200,16,1359525007,1359525427,3,2,420
30650680@N02,2200,6,1359538556,1359538676,1,2,120
30650680@N02,2201,22,1359589359,1359589430,2,4,71
30650680@N02,2201,9,1359589430,1359589550,2,4,120
30650680@N02,2201,13,1359589609,1359589909,2,4,300
30650680@N02,2201,2,1359593328,1359593388,1,4,60
30650680@N02,2202,19,1361673384,1361673924,3,3,540
30650680@N02,2202,14,1361699751,1361700111,2,3,360
30650680@N02,2202,7,1361705887,1361706007,1,3,120
30650680@N02,2203,19,1367894915,1367895087,2,4,172
30650680@N02,2203,7,1367895087,1367895207,2,4,120
30650680@N02,2203,19,1367895604,1367896144,2,4,540
30650680@N02,2203,5,1367896192,1367896312,1,4,120
30650680@N02,2204,5,1457748065,1457748185,1,1,120
30674850@N00,2205,8,1228468282,1228468402,2,1,120
30674850@N00,2206,24,1228548958,1228550458,2,1,1500
30674850@N00,2207,16,1313489847,1313490267,1,1,420
30683883@N08,2208,5,1266383013,1266383133,1,1,120
30726295@N05,2209,18,1307609748,1307609871,3,4,123
30726295@N05,2209,10,1307609871,1307610021,2,4,150
30726295@N05,2209,7,1307614818,1307614938,2,4,120
30726295@N05,2209,12,1307615243,1307615513,2,4,270
30726295@N05,2210,14,1372290699,1372291059,4,6,360
30726295@N05,2210,19,1372291283,1372291823,2,6,540
30726295@N05,2210,14,1372292280,1372292640,2,6,360
30726295@N05,2210,5,1372301722,1372301842,2,6,120
30726295@N05,2210,18,1372302951,1372303491,3,6,540
30726295@N05,2210,4,1372309532,1372309622,4,6,90
30738244@N07,2211,7,1236386524,1236386644,4,3,120
30738244@N07,2211,18,1236390556,1236390681,2,3,125
30738244@N07,2211,7,1236390681,1236390801,1,3,120
30746584@N00,2212,23,1380954705,1380955905,2,2,1200
30746584@N00,2212,20,1380957602,1380958202,1,2,600
30755785@N02,2213,13,1325117312,1325117612,6,5,300
30755785@N02,2213,22,1325122664,1325123684,2,5,1020
30755785@N02,2213,6,1325124534,1325124654,3,5,120
30755785@N02,2213,12,1325134060,1325134330,2,5,270
30755785@N02,2213,16,1325139170,1325139590,1,5,420
30755785@N02,2214,7,1325207702,1325207822,2,6,120
30755785@N02,2214,11,1325208117,1325208357,3,6,240
30755785@N02,2214,19,1325209385,1325209925,4,6,540
30755785@N02,2214,2,1325215629,1325215689,3,6,60
30755785@N02,2214,20,1325216999,1325217127,2,6,128
30755785@N02,2214,12,1325217127,1325217397,1,6,270
30758629@N00,2215,12,1235792676,1235792946,2,1,270
30758629@N00,2216,23,1306138638,1306139838,1,1,1200
30783759@N06,2217,24,1414483771,1414485271,1,1,1500
30784763@N03,2218,6,1224211915,1224212035,37,7,120
30784763@N03,2218,24,1224233472,1224234302,2,7,830
30784763@N03,2218,25,1224234302,1224234382,2,7,80
30784763@N03,2218,24,1224234382,1224235882,2,7,1500
30784763@N03,2218,23,1224236481,1224237681,2,7,1200
30784763@N03,2218,13,1224243459,1224243759,8,7,300
30784763@N03,2218,24,1224244478,1224245978,23,7,1500
30844146@N02,2219,16,1370566564,1370566984,1,1,420
30845357@N02,2220,16,1238049349,1238049769,2,3,420
30845357@N02,2220,22,1238051998,1238052619,4,3,621
30845357@N02,2220,24,1238052619,1238054119,1,3,1500
30848780@N03,2221,10,1239591317,1239591467,8,1,150
30848780@N03,2222,10,1239864977,1239865127,6,1,150
30863942@N00,2223,2,1354508973,1354509033,1,1,60
30894945@N04,2224,24,1354946182,1354947137,5,16,955
30894945@N04,2224,6,1354947137,1354947257,5,16,120
30894945@N04,2224,16,1354949231,1354949294,6,16,63
30894945@N04,2224,19,1354949294,1354949303,2,16,9
30894945@N04,2224,16,1354949303,1354949705,6,16,402
30894945@N04,2224,10,1354949705,1354949713,2,16,8
30894945@N04,2224,7,1354949713,1354949781,2,16,68
30894945@N04,2224,10,1354949781,1354949876,2,16,95
30894945@N04,2224,16,1354949876,1354949883,2,16,7
30894945@N04,2224,10,1354949883,1354950033,8,16,150
30894945@N04,2224,1,1354950675,1354950735,6,16,60
30894945@N04,2224,10,1354951120,1354951270,8,16,150
30894945@N04,2224,16,1354951809,1354951861,2,16,52
30894945@N04,2224,23,1354951861,1354951879,2,16,18
30894945@N04,2224,16,1354951879,1354952299,3,16,420
30894945@N04,2224,24,1354952871,1354954371,3,16,1500
30902022@N00,2225,25,1203683150,1203683229,3,4,79
30902022@N00,2225,22,1203683229,1203683252,2,4,23
30902022@N00,2225,19,1203683252,1203683512,2,4,260
30902022@N00,2225,8,1203683512,1203683632,1,4,120
30926699@N06,2226,7,1267798785,1267798905,1,1,120
30926699@N06,2227,24,1267831720,1267833220,1,1,1500
31019923@N00,2228,12,1343627398,1343627466,2,6,68
31019923@N00,2228,24,1343627466,1343627871,2,6,405
31019923@N00,2228,25,1343627871,1343627885,2,6,14
31019923@N00,2228,15,1343627885,1343628245,2,6,360
31019923@N00,2228,5,1343637489,1343637511,3,6,22
31019923@N00,2228,16,1343637511,1343637931,1,6,420
31019923@N00,2229,14,1343686729,1343687089,22,10,360
31019923@N00,2229,19,1343689509,1343690049,2,10,540
31019923@N00,2229,14,1343690084,1343690444,10,10,360
31019923@N00,2229,18,1343693494,1343694034,8,10,540
31019923@N00,2229,25,1343697642,1343697659,2,10,17
31019923@N00,2229,15,1343697659,1343698019,6,10,360
31019923@N00,2229,16,1343701363,1343701390,2,10,27
31019923@N00,2229,19,1343701390,1343701930,4,10,540
31019923@N00,2229,17,1343702553,1343702953,3,10,400
31019923@N00,2229,24,1343702953,1343704453,4,10,1500
31019923@N00,2230,16,1352680865,1352681133,3,7,268
31019923@N00,2230,23,1352681133,1352682333,9,7,1200
31019923@N00,2230,7,1352683401,1352683521,2,7,120
31019923@N00,2230,22,1352687861,1352688866,4,7,1005
31019923@N00,2230,24,1352688866,1352689930,5,7,1064
31019923@N00,2230,6,1352689930,1352690016,3,7,86
31019923@N00,2230,24,1352690016,1352691516,3,7,1500
31070925@N07,2231,18,1415919135,1415919675,5,9,540
31070925@N07,2231,14,1415919888,1415920248,4,9,360
31070925@N07,2231,6,1415922453,1415922573,2,9,120
31070925@N07,2231,18,1415924001,1415924541,2,9,540
31070925@N07,2231,7,1415928146,1415928266,2,9,120
31070925@N07,2231,15,1415941946,1415942306,4,9,360
31070925@N07,2231,24,1415947224,1415947728,6,9,504
31070925@N07,2231,12,1415947728,1415947740,4,9,12
31070925@N07,2231,24,1415947740,1415949240,2,9,1500
31105023@N06,2232,7,1309861865,1309861985,1,1,120
31106358@N05,2233,25,1204353320,1204355420,1,1,2100
31130361@N06,2234,11,1326516252,1326516492,1,1,240
31130361@N06,2235,11,1330649101,1330649341,1,1,240
31160848@N06,2236,14,1346922442,1346922802,1,1,360
31160848@N06,2237,17,1350820902,1350821322,1,1,420
31172882@N02,2238,10,1222956003,1222956007,5,8,4
31172882@N02,2238,20,1222956007,1222956011,5,8,4
31172882@N02,2238,25,1222956011,1222956022,8,8,11
31172882@N02,2238,16,1222956022,1222956024,3,8,2
31172882@N02,2238,7,1222956024,1222956028,5,8,4
31172882@N02,2238,10,1222956028,1222956178,4,8,150
31172882@N02,2238,25,1222971997,1222973572,8,8,1575
31172882@N02,2238,12,1222973572,1222973842,2,8,270
31254726@N03,2239,19,1292917083,1292917115,2,9,32
31254726@N03,2239,12,1292917115,1292917385,2,9,270
31254726@N03,2239,19,1292917943,1292917983,2,9,40
31254726@N03,2239,15,1292917983,1292918144,3,9,161
31254726@N03,2239,19,1292918144,1292918539,4,9,395
31254726@N03,2239,7,1292918539,1292918581,2,9,42
31254726@N03,2239,18,1292918581,1292918646,2,9,65
31254726@N03,2239,19,1292918646,1292918680,2,9,34
31254726@N03,2239,7,1292918680,1292918800,1,9,120
31266253@N06,2240,3,1259898103,1259898193,1,1,90
31266253@N06,2241,12,1259974876,1259975146,3,1,270
31346822@N08,2242,6,1434698098,1434698218,1,1,120
31355566@N06,2243,6,1279667768,1279667877,3,7,109
31355566@N06,2243,19,1279667877,1279668213,5,7,336
31355566@N06,2243,11,1279668213,1279668453,4,7,240
31355566@N06,2243,16,1279671971,1279672391,4,7,420
31355566@N06,2243,18,1279675224,1279675764,3,7,540
31355566@N06,2243,10,1279676606,1279676756,4,7,150
31355566@N06,2243,6,1279683991,1279684111,2,7,120
31375322@N00,2244,17,1413662786,1413663206,1,1,420
31385681@N02,2245,12,1257821709,1257821979,1,1,270
31428730@N07,2246,6,1377979757,1377979877,114,1,120
31428878@N02,2247,18,1253854915,1253855455,1,1,540
31428878@N02,2248,15,1297659085,1297659445,1,1,360
31437555@N00,2249,17,1340277259,1340277679,1,1,420
31473961@N06,2250,6,1354170193,1354170313,1,1,120
31479144@N00,2251,11,1398552793,1398553033,2,2,240
31479144@N00,2251,15,1398557700,1398558060,1,2,360
31544947@N00,2252,16,1437822826,1437823246,4,1,420
31579500@N08,2253,13,1345547797,1345548097,2,1,300
31596300@N07,2254,19,1347092493,1347093033,1,1,540
31641212@N05,2255,3,1388105659,1388105749,1,1,90
31641212@N05,2256,14,1388264071,1388264431,1,1,360
31641212@N05,2257,22,1397606615,1397607635,1,1,1020
31660814@N02,2258,17,1450512966,1450513386,1,1,420
31660989@N05,2259,23,1279698540,1279699740,2,6,1200
31660989@N05,2259,16,1279700776,1279700986,2,6,210
31660989@N05,2259,23,1279700986,1279700991,2,6,5
31660989@N05,2259,16,1279700991,1279701411,2,6,420
31660989@N05,2259,7,1279702795,1279702915,2,6,120
31660989@N05,2259,16,1279719799,1279720219,2,6,420
31664770@N02,2260,14,1346719495,1346719855,1,1,360
31664770@N02,2261,24,1346750793,1346751140,2,2,347
31664770@N02,2261,14,1346751140,1346751500,1,2,360
31751836@N04,2262,24,1362379396,1362380896,3,2,1500
31751836@N04,2262,19,1362394721,1362395261,1,2,540
31779495@N05,2263,25,1415981203,1415981238,2,2,35
31779495@N05,2263,13,1415981238,1415981538,1,2,300
31779495@N05,2264,15,1416096618,1416096978,1,1,360
31794493@N00,2265,24,1306035528,1306035708,2,6,180
31794493@N00,2265,16,1306035708,1306036128,2,6,420
31794493@N00,2265,21,1306045420,1306046320,12,6,900
31794493@N00,2265,13,1306047803,1306048103,2,6,300
31794493@N00,2265,25,1306048589,1306050689,2,6,2100
31794493@N00,2265,10,1306061810,1306061960,1,6,150
31916258@N00,2266,15,1205899615,1205899975,2,10,360
31916258@N00,2266,22,1205901403,1205902423,3,10,1020
31916258@N00,2266,13,1205902519,1205902819,2,10,300
31916258@N00,2266,19,1205906967,1205907507,2,10,540
31916258@N00,2266,18,1205907679,1205908219,3,10,540
31916258@N00,2266,7,1205911493,1205911613,3,10,120
31916258@N00,2266,18,1205911725,1205912265,4,10,540
31916258@N00,2266,19,1205913769,1205914300,2,10,531
31916258@N00,2266,24,1205914300,1205915475,2,10,1175
31916258@N00,2266,13,1205915475,1205915775,1,10,300
31916258@N00,2267,7,1222575608,1222575728,1,1,120
31916258@N00,2268,7,1226735541,1226735661,1,1,120
31916258@N00,2269,15,1247361638,1247361998,2,4,360
31916258@N00,2269,13,1247362419,1247362719,5,4,300
31916258@N00,2269,16,1247378736,1247378969,2,4,233
31916258@N00,2269,19,1247378969,1247379509,1,4,540
31936017@N00,2270,18,1306733382,1306733922,1,1,540
31940369@N04,2271,19,1347962637,1347963177,1,1,540
31940369@N04,2272,7,1348048800,1348048920,1,1,120
31954625@N00,2273,24,1384225458,1384225669,2,6,211
31954625@N00,2273,6,1384225669,1384225789,3,6,120
31954625@N00,2273,11,1384225831,1384226071,2,6,240
31954625@N00,2273,5,1384226499,1384226619,2,6,120
31954625@N00,2273,1,1384227497,1384227532,3,6,35
31954625@N00,2273,3,1384227532,1384227622,4,6,90
31954625@N00,2274,3,1384312253,1384312343,2,6,90
31954625@N00,2274,6,1384314028,1384314063,2,6,35
31954625@N00,2274,19,1384314063,1384314221,2,6,158
31954625@N00,2274,14,1384314221,1384314472,2,6,251
31954625@N00,2274,6,1384314472,1384314592,2,6,120
31954625@N00,2274,25,1384314742,1384316842,2,6,2100
31954625@N00,2275,24,1384829634,1384831134,4,2,1500
31954625@N00,2275,16,1384832784,1384833204,5,2,420
31954625@N00,2276,5,1386129694,1386129814,10,2,120
31954625@N00,2276,12,1386130479,1386130749,1,2,270
31954625@N00,2277,3,1388970981,1388971071,4,2,90
31954625@N00,2277,1,1388971374,1388971434,2,2,60
31954625@N00,2278,5,1392001909,1392002029,3,1,120
31954625@N00,2279,19,1395801619,1395802159,1,1,540
31954625@N00,2280,24,1398063422,1398063767,8,8,345
31954625@N00,2280,16,1398063767,1398064187,2,8,420
31954625@N00,2280,24,1398064197,1398065697,9,8,1500
31954625@N00,2280,12,1398067018,1398067056,4,8,38
31954625@N00,2280,24,1398067056,1398067125,2,8,69
31954625@N00,2280,16,1398067125,1398067153,2,8,28
31954625@N00,2280,7,1398067153,1398067273,2,8,120
31954625@N00,2280,24,1398082051,1398083551,1,8,1500
31954625@N00,2281,22,1401342425,1401343445,7,3,1020
31954625@N00,2281,16,1401345028,1401345108,4,3,80
31954625@N00,2281,19,1401345108,1401345648,3,3,540
31954625@N00,2282,3,1408493992,1408494082,1,1,90
31954625@N00,2283,22,1409803581,1409804601,5,1,1020
31954625@N00,2284,3,1413517743,1413517833,2,2,90
31954625@N00,2284,1,1413519102,1413519162,1,2,60
31954625@N00,2285,3,1415769364,1415769454,3,4,90
31954625@N00,2285,12,1415771753,1415771799,2,4,46
31954625@N00,2285,17,1415771799,1415771811,2,4,12
31954625@N00,2285,24,1415771811,1415773311,1,4,1500
31954625@N00,2286,1,1416456002,1416456062,1,1,60
31954625@N00,2287,12,1417576715,1417576985,1,1,270
31954625@N00,2288,14,1418170675,1418170745,2,4,70
31954625@N00,2288,8,1418170745,1418170865,5,4,120
31954625@N00,2288,6,1418170899,1418171019,6,4,120
31954625@N00,2288,19,1418174671,1418175211,1,4,540
31957707@N08,2289,14,1346454856,1346455216,2,1,360
31971780@N03,2290,16,1268012573,1268012993,3,2,420
31971780@N03,2290,18,1268014111,1268014651,4,2,540
32021900@N00,2291,12,1331471432,1331471702,1,1,270
32037358@N06,2292,18,1372595569,1372596109,2,1,540
32046871@N00,2293,19,1393030835,1393031375,2,1,540
32087030@N07,2294,17,1283187625,1283188045,4,1,420
32136822@N08,2295,5,1209263647,1209263767,1,1,120
32169245@N00,2296,5,1325311461,1325311581,2,2,120
32169245@N00,2296,18,1325316454,1325316994,5,2,540
32218114@N00,2297,16,1361615996,1361616416,2,1,420
32218114@N00,2298,7,1361761627,1361761747,2,2,120
32218114@N00,2298,1,1361763187,1361763247,2,2,60
32218114@N00,2299,22,1378541506,1378542526,1,1,1020
32248086@N03,2300,16,1461837778,1461838198,1,1,420
32248086@N03,2301,16,1461931106,1461931526,2,1,420
32281247@N08,2302,3,1301570468,1301570558,1,1,90
32281247@N08,2303,1,1301613073,1301613133,1,1,60
32281247@N08,2304,16,1301650186,1301650606,1,1,420
32288855@N08,2305,12,1435548888,1435549158,2,4,270
32288855@N08,2305,14,1435553548,1435553908,3,4,360
32288855@N08,2305,8,1435555272,1435555392,2,4,120
32288855@N08,2305,16,1435556633,1435557053,1,4,420
32289743@N03,2306,19,1328316749,1328317289,2,2,540
32289743@N03,2306,18,1328319600,1328320140,2,2,540
32289743@N03,2307,13,1330053458,1330053758,1,1,300
32289743@N03,2308,23,1331531015,1331532215,1,1,1200
32289743@N03,2309,20,1333791718,1333792318,2,3,600
32289743@N03,2309,23,1333794189,1333794788,2,3,599
32289743@N03,2309,17,1333794788,1333795208,1,3,420
32289743@N03,2310,9,1334194930,1334195050,1,1,120
32289743@N03,2311,13,1336725499,1336725799,1,1,300
32289743@N03,2312,17,1337307915,1337308335,2,2,420
32289743@N03,2312,23,1337311721,1337312921,1,2,1200
32289743@N03,2313,17,1337918981,1337919401,2,2,420
32289743@N03,2313,24,1337920828,1337922328,1,2,1500
32289743@N03,2314,12,1338261700,1338261970,2,3,270
32289743@N03,2314,23,1338263660,1338264860,2,3,1200
32289743@N03,2314,25,1338270630,1338272730,2,3,2100
32289743@N03,2315,19,1339557339,1339557879,1,1,540
32289743@N03,2316,9,1339983722,1339983842,2,5,120
32289743@N03,2316,14,1339984838,1339985071,2,5,233
32289743@N03,2316,9,1339985071,1339985191,3,5,120
32289743@N03,2316,8,1339985396,1339985454,2,5,58
32289743@N03,2316,14,1339985454,1339985814,1,5,360
32289743@N03,2317,12,1340186797,1340187067,1,1,270
32289743@N03,2318,1,1341116007,1341116067,7,2,60
32289743@N03,2318,14,1341117435,1341117795,2,2,360
32289743@N03,2319,6,1341487348,1341487468,1,1,120
32289743@N03,2320,17,1342249330,1342249750,3,5,420
32289743@N03,2320,23,1342250466,1342251666,2,5,1200
32289743@N03,2320,14,1342253448,1342253487,2,5,39
32289743@N03,2320,19,1342253487,1342254027,2,5,540
32289743@N03,2320,14,1342254185,1342254545,1,5,360
32289743@N03,2321,15,1343283810,1343284170,3,6,360
32289743@N03,2321,9,1343285264,1343285384,2,6,120
32289743@N03,2321,8,1343285407,1343285527,2,6,120
32289743@N03,2321,19,1343285621,1343286161,2,6,540
32289743@N03,2321,18,1343288154,1343288694,2,6,540
32289743@N03,2321,12,1343291745,1343292015,1,6,270
32289743@N03,2322,13,1345780959,1345781259,1,1,300
32289743@N03,2323,9,1345857392,1345857512,2,4,120
32289743@N03,2323,14,1345858199,1345858279,2,4,80
32289743@N03,2323,9,1345858279,1345858399,2,4,120
32289743@N03,2323,6,1345860387,1345860507,1,4,120
32289743@N03,2324,14,1346302606,1346302966,4,4,360
32289743@N03,2324,9,1346303442,1346303562,2,4,120
32289743@N03,2324,8,1346303616,1346303671,2,4,55
32289743@N03,2324,6,1346303671,1346303791,8,4,120
32289743@N03,2325,19,1346909409,1346909493,2,3,84
32289743@N03,2325,14,1346909493,1346909853,2,3,360
32289743@N03,2325,25,1346910785,1346912885,1,3,2100
32289743@N03,2326,6,1346983831,1346983951,2,4,120
32289743@N03,2326,17,1346984112,1346984532,2,4,420
32289743@N03,2326,12,1346985994,1346986264,2,4,270
32289743@N03,2326,25,1346987001,1346989101,1,4,2100
32289743@N03,2327,9,1347591548,1347591638,2,5,90
32289743@N03,2327,8,1347591638,1347591748,2,5,110
32289743@N03,2327,14,1347591748,1347591936,3,5,188
32289743@N03,2327,8,1347591936,1347592056,3,5,120
32289743@N03,2327,14,1347593067,1347593427,2,5,360
32289743@N03,2328,12,1347953223,1347953493,3,2,270
32289743@N03,2328,24,1347955603,1347957103,1,2,1500
32289743@N03,2329,25,1349325485,1349325946,3,6,461
32289743@N03,2329,13,1349325946,1349326022,2,6,76
32289743@N03,2329,25,1349326022,1349326818,2,6,796
32289743@N03,2329,13,1349326818,1349327118,2,6,300
32289743@N03,2329,14,1349329096,1349329456,2,6,360
32289743@N03,2329,19,1349332747,1349333287,1,6,540
32289743@N03,2330,14,1352942389,1352942749,2,2,360
32289743@N03,2330,24,1352943509,1352945009,2,2,1500
32289743@N03,2331,24,1453264335,1453265835,1,1,1500
32303563@N00,2332,15,1288327339,1288327699,2,3,360
32303563@N00,2332,20,1288335050,1288335650,2,3,600
32303563@N00,2332,10,1288338224,1288338374,1,3,150
32354567@N00,2333,18,1365845202,1365845640,3,3,438
32354567@N00,2333,10,1365845640,1365845790,2,3,150
32354567@N00,2333,18,1365848089,1365848629,1,3,540
32354567@N00,2334,11,1365890134,1365890374,3,7,240
32354567@N00,2334,10,1365896591,1365896741,3,7,150
32354567@N00,2334,11,1365897224,1365897464,3,7,240
32354567@N00,2334,2,1365899601,1365899661,2,7,60
32354567@N00,2334,10,1365927470,1365927490,2,7,20
32354567@N00,2334,18,1365927490,1365928030,3,7,540
32354567@N00,2334,16,1365935241,1365935661,1,7,420
32354567@N00,2335,24,1365994555,1365996055,2,5,1500
32354567@N00,2335,3,1365997553,1365997643,2,5,90
32354567@N00,2335,16,1366000519,1366000939,2,5,420
32354567@N00,2335,17,1366002004,1366002424,2,5,420
32354567@N00,2335,14,1366026567,1366026927,1,5,360
32354567@N00,2336,7,1366078227,1366078347,1,1,120
32373689668@N01,2337,24,1257484267,1257485767,1,1,1500
32394902@N06,2338,19,1218368010,1218368550,1,1,540
32462910@N02,2339,1,1362725265,1362725325,1,1,60
32470664@N08,2340,22,1422882000,1422883020,1,1,1020
32471539@N03,2341,12,1295354706,1295354976,1,1,270
32493439@N00,2342,10,1356475885,1356476035,1,1,150
32493439@N00,2343,15,1356560748,1356561108,1,1,360
32516034@N02,2344,12,1391914169,1391914439,2,2,270
32516034@N02,2344,14,1391924391,1391924751,1,2,360
32604470@N08,2345,16,1398163394,1398163814,1,1,420
32604470@N08,2346,17,1435709976,1435710396,2,4,420
32604470@N08,2346,19,1435715206,1435715746,2,4,540
32604470@N08,2346,14,1435741363,1435741723,2,4,360
32604470@N08,2346,18,1435745873,1435746413,3,4,540
32609765@N00,2347,24,1460852112,1460853612,2,1,1500
32643997@N00,2348,14,1339758929,1339759289,1,1,360
32715761@N00,2349,17,1201233135,1201233555,1,1,420
32715761@N00,2350,4,1201315992,1201316082,20,6,90
32715761@N00,2350,23,1201320027,1201321227,3,6,1200
32715761@N00,2350,16,1201330035,1201330297,2,6,262
32715761@N00,2350,10,1201330297,1201330447,3,6,150
32715761@N00,2350,18,1201332655,1201333093,2,6,438
32715761@N00,2350,1,1201333093,1201333153,2,6,60
32715761@N00,2351,12,1201408574,1201408844,7,2,270
32715761@N00,2351,7,1201411806,1201411926,2,2,120
32715761@N00,2352,17,1223592302,1223592722,2,10,420
32715761@N00,2352,24,1223605756,1223605812,2,10,56
32715761@N00,2352,25,1223605812,1223606111,5,10,299
32715761@N00,2352,13,1223606111,1223606411,6,10,300
32715761@N00,2352,18,1223611551,1223612091,10,10,540
32715761@N00,2352,1,1223613839,1223613899,3,10,60
32715761@N00,2352,10,1223614152,1223614302,2,10,150
32715761@N00,2352,23,1223614569,1223615744,2,10,1175
32715761@N00,2352,17,1223615744,1223616164,6,10,420
32715761@N00,2352,12,1223618476,1223618746,7,10,270
32715761@N00,2353,24,1223691747,1223693247,4,2,1500
32715761@N00,2353,12,1223705779,1223706049,2,2,270
32715761@N00,2354,22,1223773597,1223774268,4,6,671
32715761@N00,2354,20,1223774268,1223774868,2,6,600
32715761@N00,2354,11,1223775183,1223775332,2,6,149
32715761@N00,2354,7,1223775332,1223775452,4,6,120
32715761@N00,2354,16,1223779182,1223779394,2,6,212
32715761@N00,2354,17,1223779394,1223779814,1,6,420
32752574@N07,2355,12,1337100450,1337100720,1,1,270
32752574@N07,2356,16,1337131324,1337131744,2,1,420
32752574@N07,2357,5,1337289196,1337289316,1,1,120
32752574@N07,2358,24,1355689211,1355690711,1,1,1500
32787846@N00,2359,13,1226382154,1226382454,1,1,300
32823446@N00,2360,15,1300669444,1300669804,3,7,360
32823446@N00,2360,19,1300680636,1300681176,3,7,540
32823446@N00,2360,15,1300681565,1300681925,2,7,360
32823446@N00,2360,18,1300683977,1300684517,2,7,540
32823446@N00,2360,7,1300685522,1300685642,2,7,120
32823446@N00,2360,17,1300690905,1300691325,2,7,420
32823446@N00,2360,16,1300701427,1300701847,7,7,420
32823446@N00,2361,14,1364781204,1364781564,2,4,360
32823446@N00,2361,15,1364798308,1364798668,2,4,360
32823446@N00,2361,19,1364805488,1364805568,2,4,80
32823446@N00,2361,6,1364805568,1364805688,1,4,120
32823446@N00,2362,16,1450571134,1450571554,3,3,420
32823446@N00,2362,6,1450591222,1450591342,2,3,120
32823446@N00,2362,10,1450606290,1450606440,1,3,150
32835156@N00,2363,18,1408265099,1408265639,7,1,540
32835156@N00,2364,6,1408354747,1408354867,2,1,120
32835156@N00,2365,18,1408403881,1408404421,1,1,540
32835156@N00,2366,24,1408590004,1408590013,2,3,9
32835156@N00,2366,12,1408590013,1408590283,3,3,270
32835156@N00,2366,6,1408614067,1408614187,1,3,120
32841500@N05,2367,14,1402731173,1402731533,2,5,360
32841500@N05,2367,18,1402741623,1402742163,3,5,540
32841500@N05,2367,14,1402751868,1402752228,2,5,360
32841500@N05,2367,19,1402752277,1402752701,2,5,424
32841500@N05,2367,18,1402752701,1402753241,1,5,540
32841500@N05,2368,18,1402901784,1402902324,7,2,540
32841500@N05,2368,14,1402920645,1402921005,1,2,360
32841500@N05,2369,18,1402979211,1402979349,2,2,138
32841500@N05,2369,16,1402979349,1402979769,1,2,420
32917595@N00,2370,25,1303030790,1303032890,2,2,2100
32917595@N00,2370,10,1303036258,1303036408,1,2,150
32917595@N00,2371,6,1303170839,1303170959,2,9,120
32917595@N00,2371,21,1303173289,1303174189,3,9,900
32917595@N00,2371,12,1303175712,1303175982,2,9,270
32917595@N00,2371,16,1303178966,1303179386,2,9,420
32917595@N00,2371,7,1303182936,1303182989,2,9,53
32917595@N00,2371,18,1303182989,1303183529,2,9,540
32917595@N00,2371,16,1303186061,1303186481,2,9,420
32917595@N00,2371,10,1303186927,1303187077,2,9,150
32917595@N00,2371,12,1303190600,1303190870,1,9,270
32932933@N00,2372,4,1387154921,1387155011,2,2,90
32932933@N00,2372,11,1387167053,1387167293,2,2,240
32955865@N04,2373,16,1322457424,1322457844,1,1,420
32955865@N04,2374,19,1323580271,1323580811,2,3,540
32955865@N04,2374,11,1323580950,1323581190,2,3,240
32955865@N04,2374,7,1323581633,1323581753,1,3,120
33005083@N00,2375,21,1316840640,1316841317,2,2,677
33005083@N00,2375,4,1316841317,1316841407,2,2,90
33005083@N00,2376,7,1328765560,1328765680,1,1,120
33063488@N02,2377,17,1281834191,1281834611,3,3,420
33063488@N02,2377,4,1281851778,1281851868,2,3,90
33063488@N02,2377,25,1281852118,1281854218,1,3,2100
33063488@N02,2378,7,1281883615,1281883735,2,9,120
33063488@N02,2378,11,1281884378,1281884443,2,9,65
33063488@N02,2378,7,1281884443,1281884443,2,9,0
33063488@N02,2378,11,1281884443,1281884683,4,9,240
33063488@N02,2378,18,1281884864,1281885016,2,9,152
33063488@N02,2378,11,1281885016,1281885256,3,9,240
33063488@N02,2378,10,1281885718,1281885841,2,9,123
33063488@N02,2378,17,1281885841,1281886261,4,9,420
33063488@N02,2378,24,1281886595,1281888095,1,9,1500
33063488@N02,2379,14,1346411143,1346411503,2,1,360
33063488@N02,2380,14,1357889595,1357889955,1,1,360
33063488@N02,2381,10,1359444979,1359445129,1,1,150
33067733@N05,2382,13,1349522021,1349522321,1,1,300
33067733@N05,2383,18,1378619419,1378619959,1,1,540
33067733@N05,2384,24,1380364013,1380365513,4,1,1500
33077451@N02,2385,24,1238386469,1238387144,2,2,675
33077451@N02,2385,6,1238387144,1238387264,2,2,120
33127956@N07,2386,2,1312195736,1312195796,1,1,60
33149991@N00,2387,25,1231533987,1231536087,1,1,2100
33207205@N00,2388,4,1265160132,1265160222,1,1,90
33207205@N00,2389,25,1271729253,1271731353,1,1,2100
33207205@N00,2390,7,1271812230,1271812350,2,2,120
33207205@N00,2390,18,1271812953,1271813493,1,2,540
33207205@N00,2391,16,1276861451,1276861871,2,1,420
33207205@N00,2392,24,1280490860,1280492360,1,1,1500
33207205@N00,2393,15,1284119278,1284119638,1,1,360
33207205@N00,2394,15,1290919294,1290919654,1,1,360
33207205@N00,2395,15,1292485017,1292485377,1,1,360
33207205@N00,2396,15,1292666064,1292666424,1,1,360
33207205@N00,2397,15,1294394031,1294394391,1,1,360
33207205@N00,2398,15,1296207051,1296207411,1,1,360
33207205@N00,2399,6,1339319606,1339319726,1,1,120
33212119@N00,2400,10,1298010213,1298010363,1,1,150
33213804@N04,2401,6,1340707856,1340707976,3,1,120
33213804@N04,2402,6,1340752441,1340752561,3,1,120
33213804@N04,2403,6,1340836714,1340836834,11,1,120
33213804@N04,2404,6,1341045588,1341045708,1,1,120
33213804@N04,2405,14,1354917130,1354917490,4,1,360
33213804@N04,2406,13,1462604578,1462604878,3,7,300
33213804@N04,2406,22,1462604928,1462605948,2,7,1020
33213804@N04,2406,7,1462607553,1462607673,5,7,120
33213804@N04,2406,10,1462608579,1462608729,2,7,150
33213804@N04,2406,19,1462612237,1462612777,2,7,540
33213804@N04,2406,8,1462615236,1462615356,7,7,120
33213804@N04,2406,6,1462616643,1462616763,3,7,120
33227061@N08,2407,14,1406878231,1406878591,1,1,360
33227061@N08,2408,12,1406936928,1406937198,1,1,270
33227061@N08,2409,2,1407025516,1407025576,1,1,60
33234549@N02,2410,15,1325719543,1325719903,2,1,360
33234549@N02,2411,25,1325843559,1325845659,1,1,2100
33234549@N02,2412,20,1325903497,1325904097,2,1,600
33283655@N02,2413,17,1426552097,1426552517,2,2,420
33283655@N02,2413,19,1426568967,1426569507,1,2,540
33283655@N02,2414,19,1426662697,1426663237,1,1,540
33308929@N04,2415,17,1280141074,1280141494,5,1,420
33308929@N04,2416,17,1295155850,1295156270,1,1,420
33308929@N04,2417,17,1299401895,1299402315,5,1,420
33308929@N04,2418,17,1324963348,1324963768,2,1,420
33308929@N04,2419,17,1324993812,1324994232,6,1,420
33308929@N04,2420,1,1331965417,1331965477,2,4,60
33308929@N04,2420,7,1331966903,1331967023,2,4,120
33308929@N04,2420,5,1331970025,1331970145,3,4,120
33308929@N04,2420,1,1331970281,1331970341,1,4,60
33308929@N04,2421,24,1339833679,1339835179,9,1,1500
33308929@N04,2422,6,1341542471,1341542591,2,2,120
33308929@N04,2422,14,1341542943,1341543303,2,2,360
33308929@N04,2423,19,1348299970,1348300510,2,3,540
33308929@N04,2423,24,1348306320,1348307820,2,3,1500
33308929@N04,2423,19,1348325185,1348325725,10,3,540
33308929@N04,2424,19,1350113976,1350114338,2,4,362
33308929@N04,2424,14,1350114338,1350114698,3,4,360
33308929@N04,2424,19,1350122079,1350122272,2,4,193
33308929@N04,2424,6,1350122272,1350122392,1,4,120
33308929@N04,2425,19,1359874574,1359875114,3,1,540
33308929@N04,2426,19,1360018289,1360018829,1,1,540
33308929@N04,2427,18,1456524820,1456525360,3,4,540
33308929@N04,2427,1,1456525583,1456525605,2,4,22
33308929@N04,2427,5,1456525605,1456525725,2,4,120
33308929@N04,2427,6,1456551989,1456552109,1,4,120
33313572@N02,2428,18,1240475821,1240476361,3,2,540
33313572@N02,2428,19,1240478164,1240478704,1,2,540
33441409@N00,2429,8,1258180074,1258180194,3,1,120
33444594@N02,2430,3,1314346857,1314346947,1,1,90
33445276@N03,2431,16,1229228947,1229229367,1,1,420
33509969@N08,2432,18,1364943035,1364943575,5,2,540
33509969@N08,2432,25,1364949268,1364951368,2,2,2100
33509969@N08,2433,3,1365024596,1365024686,4,1,90
33593400@N04,2434,5,1331788069,1331788189,1,1,120
33633422@N05,2435,14,1342488263,1342488309,2,2,46
33633422@N05,2435,8,1342488309,1342488429,1,2,120
33710465@N07,2436,19,1324000119,1324000659,14,1,540
33745480@N05,2437,19,1421378449,1421378989,1,1,540
33747232@N00,2438,7,1346073496,1346073616,1,1,120
33747232@N00,2439,17,1346400407,1346400827,1,1,420
33753067@N04,2440,18,1411118117,1411118657,2,1,540
33771723@N00,2441,5,1237509871,1237509991,1,1,120
33803664@N06,2442,6,1254010739,1254010856,2,31,117
33803664@N06,2442,21,1254010856,1254010969,2,31,113
33803664@N06,2442,4,1254010969,1254011036,4,31,67
33803664@N06,2442,9,1254011036,1254011156,4,31,120
33803664@N06,2442,21,1254011733,1254012420,2,31,687
33803664@N06,2442,8,1254012420,1254012540,5,31,120
33803664@N06,2442,9,1254013982,1254014102,3,31,120
33803664@N06,2442,19,1254014105,1254014645,4,31,540
33803664@N06,2442,23,1254015742,1254016942,4,31,1200
33803664@N06,2442,17,1254017435,1254017855,6,31,420
33803664@N06,2442,16,1254018940,1254019360,3,31,420
33803664@N06,2442,23,1254020256,1254020403,2,31,147
33803664@N06,2442,21,1254020403,1254020648,3,31,245
33803664@N06,2442,23,1254020648,1254020979,2,31,331
33803664@N06,2442,21,1254020979,1254021052,2,31,73
33803664@N06,2442,19,1254021052,1254021592,2,31,540
33803664@N06,2442,6,1254022709,1254022733,2,31,24
33803664@N06,2442,20,1254022733,1254023333,3,31,600
33803664@N06,2442,23,1254023589,1254024279,2,31,690
33803664@N06,2442,16,1254024279,1254024699,39,31,420
33803664@N06,2442,23,1254035153,1254036003,3,31,850
33803664@N06,2442,19,1254036003,1254036543,21,31,540
33803664@N06,2442,9,1254037277,1254037397,2,31,120
33803664@N06,2442,4,1254037503,1254037574,2,31,71
33803664@N06,2442,9,1254037574,1254037639,2,31,65
33803664@N06,2442,21,1254037639,1254038345,4,31,706
33803664@N06,2442,9,1254038345,1254038465,4,31,120
33803664@N06,2442,19,1254039463,1254039496,2,31,33
33803664@N06,2442,20,1254039496,1254039529,2,31,33
33803664@N06,2442,6,1254039529,1254039649,5,31,120
33803664@N06,2442,16,1254042934,1254043354,4,31,420
33813043@N00,2443,16,1342402510,1342402930,53,1,420
33823100@N00,2444,12,1353290383,1353290653,2,9,270
33823100@N00,2444,15,1353294733,1353295093,2,9,360
33823100@N00,2444,2,1353295811,1353295871,2,9,60
33823100@N00,2444,6,1353312336,1353312405,3,9,69
33823100@N00,2444,13,1353312405,1353312482,2,9,77
33823100@N00,2444,14,1353312482,1353312547,2,9,65
33823100@N00,2444,12,1353312547,1353312817,2,9,270
33823100@N00,2444,14,1353313799,1353314159,2,9,360
33823100@N00,2444,16,1353320527,1353320947,1,9,420
33823100@N00,2445,24,1370746993,1370747679,2,5,686
33823100@N00,2445,14,1370747679,1370748039,3,5,360
33823100@N00,2445,15,1370765291,1370765651,2,5,360
33823100@N00,2445,13,1370765831,1370766131,2,5,300
33823100@N00,2445,14,1370776610,1370776970,1,5,360
33823100@N00,2446,18,1383111016,1383111166,2,5,150
33823100@N00,2446,14,1383111166,1383111526,2,5,360
33823100@N00,2446,24,1383113142,1383114642,2,5,1500
33823100@N00,2446,4,1383127538,1383127628,2,5,90
33823100@N00,2446,14,1383127657,1383128017,2,5,360
33823100@N00,2447,14,1383271195,1383271555,2,4,360
33823100@N00,2447,18,1383284093,1383284633,2,4,540
33823100@N00,2447,7,1383304807,1383304927,2,4,120
33823100@N00,2447,24,1383305024,1383306524,1,4,1500
33823100@N00,2448,7,1383365903,1383366023,1,1,120
33823100@N00,2449,12,1387951512,1387951782,2,2,270
33823100@N00,2449,15,1387972295,1387972655,1,2,360
33823100@N00,2450,16,1388058062,1388058482,1,1,420
33853652177@N01,2451,16,1408496761,1408497181,1,1,420
33873368@N00,2452,17,1361578184,1361578604,1,1,420
33884801@N02,2453,11,1358939864,1358940104,1,1,240
33934101@N06,2454,17,1274197666,1274198086,1,1,420
33959358@N05,2455,17,1294557276,1294557696,1,1,420
33959358@N05,2456,12,1338641307,1338641577,1,1,270
33959358@N05,2457,12,1345717612,1345717882,1,1,270
33959358@N05,2458,19,1358933512,1358934052,1,1,540
33999459@N06,2459,15,1345359439,1345359598,2,3,159
33999459@N06,2459,8,1345359598,1345359718,3,3,120
33999459@N06,2459,6,1345366117,1345366237,1,3,120
33999459@N06,2460,18,1367207962,1367208502,2,2,540
33999459@N06,2460,10,1367223281,1367223431,1,2,150
34052289@N06,2461,11,1312021840,1312022080,1,1,240
34118276@N04,2462,23,1228444865,1228446065,2,3,1200
34118276@N04,2462,24,1228470563,1228472063,2,3,1500
34118276@N04,2462,12,1228472458,1228472728,1,3,270
34128007@N04,2463,7,1238200115,1238200235,1,1,120
34128007@N04,2464,7,1244940186,1244940306,4,1,120
34128007@N04,2465,7,1301091849,1301091969,2,12,120
34128007@N04,2465,19,1301091987,1301092159,2,12,172
34128007@N04,2465,11,1301092159,1301092399,2,12,240
34128007@N04,2465,7,1301092410,1301092530,3,12,120
34128007@N04,2465,19,1301094481,1301094728,2,12,247
34128007@N04,2465,23,1301094728,1301095124,2,12,396
34128007@N04,2465,11,1301095124,1301095166,2,12,42
34128007@N04,2465,16,1301095166,1301095586,2,12,420
34128007@N04,2465,11,1301096983,1301097164,2,12,181
34128007@N04,2465,17,1301097164,1301097371,2,12,207
34128007@N04,2465,11,1301097371,1301097611,3,12,240
34128007@N04,2465,7,1301098487,1301098607,5,12,120
34128007@N04,2466,10,1360897623,1360897773,1,1,150
34128007@N04,2467,23,1362788741,1362789054,2,3,313
34128007@N04,2467,10,1362789054,1362789204,2,3,150
34128007@N04,2467,16,1362791036,1362791456,1,3,420
34131297@N02,2468,12,1291122000,1291122000,2,2,0
34131297@N02,2468,18,1291122000,1291122540,7,2,540
34154171@N00,2469,3,1310438564,1310438654,1,1,90
34154171@N00,2470,2,1310717727,1310717787,2,2,60
34154171@N00,2470,13,1310723309,1310723609,2,2,300
34154171@N00,2471,12,1311319363,1311319633,1,1,270
34154171@N00,2472,15,1315719893,1315720253,1,1,360
34154171@N00,2473,12,1330546421,1330546691,1,1,270
34154171@N00,2474,17,1337674375,1337674795,2,3,420
34154171@N00,2474,11,1337678846,1337679086,2,3,240
34154171@N00,2474,7,1337679387,1337679507,1,3,120
34154171@N00,2475,12,1340863473,1340863743,1,1,270
34168709@N00,2476,12,1232318693,1232318952,2,3,259
34168709@N00,2476,24,1232318952,1232320452,4,3,1500
34168709@N00,2476,3,1232322128,1232322218,2,3,90
34168709@N00,2477,3,1244303848,1244303858,2,16,10
34168709@N00,2477,7,1244303858,1244303873,2,16,15
34168709@N00,2477,16,1244303873,1244303886,2,16,13
34168709@N00,2477,17,1244303886,1244303902,2,16,16
34168709@N00,2477,25,1244303902,1244303917,2,16,15
34168709@N00,2477,12,1244303917,1244303946,3,16,29
34168709@N00,2477,15,1244303946,1244303959,2,16,13
34168709@N00,2477,16,1244303959,1244303973,2,16,14
34168709@N00,2477,11,1244303973,1244303982,2,16,9
34168709@N00,2477,16,1244303982,1244304000,2,16,18
34168709@N00,2477,17,1244304000,1244304027,2,16,27
34168709@N00,2477,23,1244304027,1244304042,2,16,15
34168709@N00,2477,16,1244304042,1244304058,2,16,16
34168709@N00,2477,12,1244304058,1244304073,2,16,15
34168709@N00,2477,17,1244304073,1244304084,2,16,11
34168709@N00,2477,12,1244304084,1244304354,1,16,270
34168709@N00,2478,25,1244961052,1244961227,2,12,175
34168709@N00,2478,13,1244961227,1244961527,3,12,300
34168709@N00,2478,16,1244964884,1244965304,13,12,420
34168709@N00,2478,11,1244965558,1244965798,2,12,240
34168709@N00,2478,7,1244967191,1244967311,3,12,120
34168709@N00,2478,18,1244967794,1244967877,3,12,83
34168709@N00,2478,5,1244967877,1244967997,5,12,120
34168709@N00,2478,3,1244968080,1244968152,2,12,72
34168709@N00,2478,10,1244968152,1244968302,2,12,150
34168709@N00,2478,15,1244972363,1244972723,6,12,360
34168709@N00,2478,22,1244974320,1244974528,2,12,208
34168709@N00,2478,12,1244974528,1244974798,1,12,270
34168709@N00,2479,7,1262675134,1262675254,2,1,120
34168709@N00,2480,17,1279066570,1279066990,6,6,420
34168709@N00,2480,16,1279068124,1279068544,2,6,420
34168709@N00,2480,17,1279070634,1279071054,2,6,420
34168709@N00,2480,13,1279075881,1279076181,2,6,300
34168709@N00,2480,12,1279099191,1279099461,2,6,270
34168709@N00,2480,16,1279103448,1279103868,24,6,420
34183523@N00,2481,15,1355312401,1355312761,2,3,360
34183523@N00,2481,18,1355313450,1355313462,2,3,12
34183523@N00,2481,13,1355313462,1355313762,1,3,300
34199992@N06,2482,16,1275736015,1275736435,1,1,420
34204052@N00,2483,17,1420795591,1420796011,3,1,420
34204052@N00,2484,17,1420850228,1420850648,1,1,420
34207923@N02,2485,5,1275208566,1275208686,1,1,120
34207923@N02,2486,24,1323491025,1323491242,7,4,217
34207923@N02,2486,6,1323491242,1323491362,5,4,120
34207923@N02,2486,19,1323491406,1323491946,3,4,540
34207923@N02,2486,14,1323493103,1323493463,29,4,360
34207923@N02,2487,12,1336786866,1336787136,6,6,270
34207923@N02,2487,19,1336787359,1336787899,12,6,540
34207923@N02,2487,11,1336787982,1336788222,2,6,240
34207923@N02,2487,18,1336790110,1336790650,17,6,540
34207923@N02,2487,25,1336791403,1336791536,3,6,133
34207923@N02,2487,13,1336791536,1336791836,23,6,300
34207923@N02,2488,6,1359172369,1359172489,123,2,120
34207923@N02,2488,8,1359180499,1359180619,1,2,120
34207923@N02,2489,24,1388453513,1388454071,5,15,558
34207923@N02,2489,12,1388454071,1388454341,40,15,270
34207923@N02,2489,5,1388457153,1388457273,3,15,120
34207923@N02,2489,19,1388457829,1388458369,3,15,540
34207923@N02,2489,25,1388460525,1388462625,151,15,2100
34207923@N02,2489,16,1388465120,1388465540,3,15,420
34207923@N02,2489,7,1388466144,1388466264,25,15,120
34207923@N02,2489,11,1388470848,1388470924,3,15,76
34207923@N02,2489,16,1388470924,1388471064,2,15,140
34207923@N02,2489,19,1388471064,1388471279,3,15,215
34207923@N02,2489,6,1388471279,1388471399,97,15,120
34207923@N02,2489,11,1388476249,1388476489,4,15,240
34207923@N02,2489,18,1388476589,1388477129,19,15,540
34207923@N02,2489,10,1388482752,1388482902,5,15,150
34207923@N02,2489,19,1388485202,1388485742,9,15,540
34240084@N05,2490,16,1268293024,1268293444,1,1,420
34240084@N05,2491,18,1269505959,1269506499,4,3,540
34240084@N05,2491,5,1269506826,1269506946,2,3,120
34240084@N05,2491,20,1269514041,1269514641,2,3,600
34240084@N05,2492,16,1270722737,1270723157,1,1,420
34240084@N05,2493,18,1277206129,1277206669,1,1,540
34240084@N05,2494,16,1294050326,1294050746,1,1,420
34240084@N05,2495,24,1334758580,1334760080,1,1,1500
34240084@N05,2496,14,1339856409,1339856769,1,1,360
34240084@N05,2497,16,1341018173,1341018593,1,1,420
34240084@N05,2498,14,1346151645,1346152005,1,1,360
34240084@N05,2499,10,1356958831,1356958981,5,1,150
34240084@N05,2500,16,1360383552,1360383972,1,1,420
34240084@N05,2501,5,1366890174,1366890294,1,1,120
34240084@N05,2502,16,1368597872,1368598292,1,1,420
34337036@N08,2503,24,1421378732,1421380232,1,1,1500
34342819@N07,2504,16,1230016719,1230017139,1,1,420
34379501@N00,2505,7,1383445881,1383446001,2,2,120
34379501@N00,2505,14,1383464134,1383464494,1,2,360
34390084@N07,2506,16,1207780718,1207781138,7,1,420
34390084@N07,2507,12,1208109700,1208109970,2,7,270
34390084@N07,2507,10,1208112336,1208112486,2,7,150
34390084@N07,2507,11,1208112591,1208112831,2,7,240
34390084@N07,2507,24,1208121080,1208121453,2,7,373
34390084@N07,2507,25,1208121453,1208122005,3,7,552
34390084@N07,2507,24,1208122005,1208123505,2,7,1500
34390084@N07,2507,12,1208134078,1208134348,1,7,270
34390084@N07,2508,16,1233149501,1233149921,1,1,420
34390084@N07,2509,15,1242045687,1242046047,1,1,360
34390084@N07,2510,12,1242094059,1242094196,2,10,137
34390084@N07,2510,17,1242094196,1242094260,2,10,64
34390084@N07,2510,19,1242094260,1242094510,2,10,250
34390084@N07,2510,16,1242094510,1242094930,2,10,420
34390084@N07,2510,18,1242095475,1242096015,3,10,540
34390084@N07,2510,10,1242098552,1242098688,2,10,136
34390084@N07,2510,18,1242098688,1242099040,2,10,352
34390084@N07,2510,17,1242099040,1242099460,3,10,420
34390084@N07,2510,15,1242099956,1242100316,2,10,360
34390084@N07,2510,12,1242100596,1242100866,1,10,270
34390084@N07,2511,23,1253003058,1253003523,2,6,465
34390084@N07,2511,5,1253003523,1253003643,2,6,120
34390084@N07,2511,18,1253004335,1253004875,3,6,540
34390084@N07,2511,16,1253011611,1253011902,3,6,291
34390084@N07,2511,19,1253011902,1253012153,2,6,251
34390084@N07,2511,12,1253012153,1253012423,1,6,270
34390084@N07,2512,18,1253272140,1253272680,5,3,540
34390084@N07,2512,10,1253272920,1253273070,2,3,150
34390084@N07,2512,16,1253273389,1253273809,2,3,420
34390084@N07,2513,7,1253446184,1253446304,2,3,120
34390084@N07,2513,10,1253448569,1253448719,5,3,150
34390084@N07,2513,19,1253450267,1253450807,1,3,540
34390084@N07,2514,13,1260096974,1260097274,13,1,300
34426369@N06,2515,24,1394522581,1394524081,1,1,1500
34426369@N06,2516,17,1442199359,1442199779,4,1,420
34444521@N03,2517,12,1339315942,1339316212,1,1,270
34453007@N00,2518,24,1268459582,1268461082,1,1,1500
34456039@N00,2519,7,1214657544,1214657664,1,1,120
34462981@N04,2520,16,1232175108,1232175528,39,1,420
34469598@N00,2521,5,1278593406,1278593526,1,1,120
34510069@N03,2522,19,1232751539,1232752079,1,1,540
34510069@N03,2523,19,1233395094,1233395634,2,1,540
34563292@N08,2524,23,1346900952,1346902152,1,1,1200
34574088@N04,2525,6,1376698735,1376698855,2,3,120
34574088@N04,2525,9,1376706011,1376706131,2,3,120
34574088@N04,2525,16,1376712157,1376712577,1,3,420
34578487@N02,2526,13,1325308585,1325308885,1,1,300
34649366@N06,2527,18,1215546670,1215547210,1,1,540
34649366@N06,2528,18,1233050311,1233050851,1,1,540
34649366@N06,2529,22,1291363280,1291364300,5,2,1020
34649366@N06,2529,12,1291364446,1291364716,1,2,270
34671478@N05,2530,1,1317807254,1317807314,1,1,60
34690629@N02,2531,6,1281052972,1281053092,2,1,120
34690629@N02,2532,6,1281084284,1281084404,4,3,120
34690629@N02,2532,19,1281084571,1281084585,2,3,14
34690629@N02,2532,6,1281084585,1281084705,1,3,120
34729147@N00,2533,12,1358679368,1358679638,1,1,270
34729147@N00,2534,17,1442782097,1442782517,1,1,420
34729147@N00,2535,17,1442876147,1442876567,1,1,420
34754162@N00,2536,15,1191496189,1191496549,2,3,360
34754162@N00,2536,22,1191499743,1191500763,2,3,1020
34754162@N00,2536,15,1191501702,1191502062,1,3,360
34845623@N00,2537,14,1341049799,1341050159,1,1,360
34849589@N03,2538,11,1262564453,1262564568,2,3,115
34849589@N03,2538,5,1262564568,1262564688,2,3,120
34849589@N03,2538,11,1262567731,1262567971,1,3,240
34875170@N06,2539,8,1235698967,1235699087,2,2,120
34875170@N06,2539,3,1235721408,1235721498,1,2,90
34899062@N05,2540,14,1349002483,1349002843,2,1,360
34899062@N05,2541,14,1349048206,1349048566,1,1,360
34899062@N05,2542,14,1349086290,1349086650,1,1,360
34899062@N05,2543,24,1390817443,1390818943,1,1,1500
34899062@N05,2544,16,1390875786,1390876206,1,1,420
34899062@N05,2545,7,1422659514,1422659634,1,1,120
35034347782@N01,2546,18,1367746407,1367746947,2,2,540
35034347782@N01,2546,13,1367747457,1367747757,1,2,300
35034347782@N01,2547,6,1367837254,1367837374,2,3,120
35034347782@N01,2547,14,1367837449,1367837631,3,3,182
35034347782@N01,2547,19,1367837631,1367838171,2,3,540
35034363039@N01,2548,7,1349767831,1349767926,2,5,95
35034363039@N01,2548,16,1349767926,1349768200,2,5,274
35034363039@N01,2548,19,1349768200,1349768319,2,5,119
35034363039@N01,2548,14,1349768319,1349768679,2,5,360
35034363039@N01,2548,10,1349769500,1349769650,1,5,150
35068332@N00,2549,24,1213316186,1213317686,3,2,1500
35068332@N00,2549,5,1213320039,1213320159,1,2,120
35068332@N00,2550,17,1213350032,1213350452,1,1,420
35068332@N00,2551,17,1213415227,1213415647,1,1,420
35068332@N00,2552,7,1213499386,1213499506,1,1,120
35068332@N00,2553,19,1380869053,1380869219,2,4,166
35068332@N00,2553,8,1380869219,1380869339,2,4,120
35068332@N00,2553,14,1380870301,1380870661,2,4,360
35068332@N00,2553,24,1380875054,1380876554,1,4,1500
35071666@N00,2554,18,1319866772,1319867312,2,2,540
35071666@N00,2554,25,1319869967,1319872067,1,2,2100
35137530@N00,2555,11,1313892102,1313892342,1,1,240
35168155@N03,2556,24,1425451311,1425452811,1,1,1500
35172613@N00,2557,6,1339137164,1339137284,1,1,120
35172613@N00,2558,19,1342585621,1342586161,4,3,540
35172613@N00,2558,6,1342602365,1342602485,2,3,120
35172613@N00,2558,24,1342608942,1342610442,1,3,1500
35181047@N04,2559,12,1283909464,1283909734,10,23,270
35181047@N04,2559,24,1283914496,1283914593,2,23,97
35181047@N04,2559,22,1283914593,1283914721,2,23,128
35181047@N04,2559,25,1283914721,1283916821,2,23,2100
35181047@N04,2559,24,1283918219,1283918312,2,23,93
35181047@N04,2559,6,1283918312,1283918336,2,23,24
35181047@N04,2559,20,1283918336,1283918738,2,23,402
35181047@N04,2559,6,1283918738,1283918858,2,23,120
35181047@N04,2559,4,1283919172,1283919262,5,23,90
35181047@N04,2559,2,1283919587,1283919647,5,23,60
35181047@N04,2559,9,1283920176,1283920296,7,23,120
35181047@N04,2559,15,1283921520,1283921880,4,23,360
35181047@N04,2559,19,1283922082,1283922203,3,23,121
35181047@N04,2559,16,1283922203,1283922623,5,23,420
35181047@N04,2559,18,1283922708,1283923248,6,23,540
35181047@N04,2559,5,1283923740,1283923860,6,23,120
35181047@N04,2559,10,1283924576,1283924726,3,23,150
35181047@N04,2559,16,1283924960,1283925380,2,23,420
35181047@N04,2559,17,1283926042,1283926462,6,23,420
35181047@N04,2559,23,1283927242,1283928442,11,23,1200
35181047@N04,2559,17,1283928476,1283928896,2,23,420
35181047@N04,2559,24,1283930109,1283931103,22,23,994
35181047@N04,2559,12,1283931103,1283931373,2,23,270
35237099571@N01,2560,22,1328337405,1328338425,2,6,1020
35237099571@N01,2560,15,1328339262,1328339622,4,6,360
35237099571@N01,2560,16,1328341116,1328341536,2,6,420
35237099571@N01,2560,7,1328341817,1328341937,2,6,120
35237099571@N01,2560,11,1328343517,1328343757,2,6,240
35237099571@N01,2560,18,1328345373,1328345913,3,6,540
35237099571@N01,2561,12,1344494744,1344495014,2,3,270
35237099571@N01,2561,15,1344495193,1344495553,4,3,360
35237099571@N01,2561,11,1344499629,1344499869,1,3,240
35237099571@N01,2562,14,1356086137,1356086497,1,1,360
35258228@N00,2563,18,1353481221,1353481761,3,1,540
35258228@N00,2564,7,1356850164,1356850284,1,1,120
35258228@N00,2565,7,1358497826,1358497946,1,1,120
35258228@N00,2566,13,1358577605,1358577905,2,3,300
35258228@N00,2566,22,1358577965,1358578985,4,3,1020
35258228@N00,2566,15,1358599678,1358600038,1,3,360
35258228@N00,2567,7,1396309204,1396309324,2,1,120
35258228@N00,2568,18,1411816506,1411817046,1,1,540
35261188@N00,2569,15,1304391154,1304391514,2,2,360
35261188@N00,2569,1,1304397393,1304397453,1,2,60
35270320@N03,2570,17,1222505311,1222505731,1,1,420
35270320@N03,2571,1,1222661782,1222661842,1,1,60
35281067@N03,2572,23,1297406197,1297407397,1,1,1200
35303955@N04,2573,22,1260937232,1260938252,7,4,1020
35303955@N04,2573,25,1260938998,1260939442,5,4,444
35303955@N04,2573,22,1260939442,1260940462,3,4,1020
35303955@N04,2573,24,1260945054,1260946554,3,4,1500
35304832@N05,2574,12,1346555483,1346555753,1,1,270
35306697@N07,2575,15,1377414365,1377414725,2,2,360
35306697@N07,2575,14,1377416478,1377416838,1,2,360
35351453@N02,2576,17,1262293078,1262293498,3,2,420
35351453@N02,2576,15,1262298821,1262299181,1,2,360
35371784@N00,2577,6,1278922567,1278922687,4,1,120
35371784@N00,2578,10,1279022221,1279022371,14,1,150
35371784@N00,2579,12,1279067417,1279067687,1,1,270
35390259@N05,2580,14,1360452814,1360453174,13,1,360
35390259@N05,2581,14,1360527823,1360528183,2,1,360
35392052@N07,2582,16,1209114369,1209114789,1,1,420
35399820@N07,2583,10,1358572676,1358572826,1,1,150
35421783@N04,2584,2,1301223938,1301223998,1,1,60
35439195@N08,2585,15,1293074765,1293075125,2,2,360
35439195@N08,2585,11,1293082041,1293082281,1,2,240
35468135814@N01,2586,12,1277703772,1277704042,1,1,270
35468135814@N01,2587,12,1278516574,1278516844,3,5,270
35468135814@N01,2587,11,1278527060,1278527300,7,5,240
35468135814@N01,2587,6,1278529853,1278529922,2,5,69
35468135814@N01,2587,20,1278529922,1278530522,2,5,600
35468135814@N01,2587,9,1278531261,1278531381,1,5,120
35468135814@N01,2588,17,1279418880,1279419300,2,6,420
35468135814@N01,2588,6,1279420106,1279420226,2,6,120
35468135814@N01,2588,4,1279423233,1279423323,2,6,90
35468135814@N01,2588,6,1279423418,1279423538,3,6,120
35468135814@N01,2588,16,1279424831,1279425251,2,6,420
35468135814@N01,2588,5,1279430405,1279430525,1,6,120
35468136420@N01,2589,2,1276309127,1276309187,1,1,60
35472851@N00,2590,12,1356914734,1356915004,2,2,270
35472851@N00,2590,24,1356915500,1356917000,1,2,1500
35498711@N04,2591,19,1304917994,1304918534,2,4,540
35498711@N04,2591,13,1304920530,1304920830,2,4,300
35498711@N04,2591,19,1304928208,1304928748,2,4,540
35498711@N04,2591,16,1304937802,1304938222,1,4,420
35498711@N04,2592,16,1305002799,1305003219,1,1,420
35498711@N04,2593,9,1376964382,1376964502,3,6,120
35498711@N04,2593,3,1376977213,1376977303,2,6,90
35498711@N04,2593,22,1376978003,1376979023,2,6,1020
35498711@N04,2593,19,1376984926,1376985466,2,6,540
35498711@N04,2593,22,1376988738,1376989758,3,6,1020
35498711@N04,2593,6,1376991793,1376991913,2,6,120
35595560@N00,2594,16,1323420778,1323421198,1,1,420
35595560@N00,2595,19,1355880690,1355881230,1,1,540
35599995@N04,2596,25,1231751042,1231751161,2,4,119
35599995@N04,2596,15,1231751161,1231751521,2,4,360
35599995@N04,2596,13,1231752802,1231753102,2,4,300
35599995@N04,2596,17,1231754898,1231755318,7,4,420
35602564@N00,2597,19,1428292590,1428293130,1,1,540
35727288@N00,2598,20,1292257949,1292258366,2,3,417
35727288@N00,2598,17,1292258366,1292258595,2,3,229
35727288@N00,2598,23,1292258595,1292259795,1,3,1200
35727989@N00,2599,12,1450164595,1450164865,2,2,270
35727989@N00,2599,17,1450169169,1450169589,3,2,420
35727989@N00,2600,16,1450215942,1450216362,2,3,420
35727989@N00,2600,6,1450219617,1450219737,3,3,120
35727989@N00,2600,19,1450252595,1450253135,1,3,540
35737816@N04,2601,24,1375747406,1375748906,2,2,1500
35737816@N04,2601,7,1375774746,1375774866,1,2,120
35737816@N04,2602,14,1375849928,1375850288,1,1,360
35737816@N04,2603,7,1387356994,1387357114,1,1,120
35737816@N04,2604,14,1387432800,1387433160,1,1,360
35775623@N00,2605,18,1416568318,1416568858,1,1,540
35795945@N02,2606,24,1242550838,1242550883,2,14,45
35795945@N02,2606,22,1242550883,1242551050,3,14,167
35795945@N02,2606,15,1242551050,1242551410,4,14,360
35795945@N02,2606,22,1242551493,1242551947,2,14,454
35795945@N02,2606,12,1242551947,1242552088,2,14,141
35795945@N02,2606,17,1242552088,1242552195,2,14,107
35795945@N02,2606,6,1242552195,1242552221,2,14,26
35795945@N02,2606,20,1242552221,1242552381,3,14,160
35795945@N02,2606,4,1242552381,1242552471,2,14,90
35795945@N02,2606,20,1242552478,1242552557,3,14,79
35795945@N02,2606,6,1242552557,1242552677,2,14,120
35795945@N02,2606,18,1242552787,1242553327,2,14,540
35795945@N02,2606,23,1242553418,1242553652,3,14,234
35795945@N02,2606,12,1242553652,1242553922,1,14,270
35795945@N02,2607,17,1244843412,1244843422,4,10,10
35795945@N02,2607,12,1244843422,1244843426,2,10,4
35795945@N02,2607,17,1244843426,1244843441,5,10,15
35795945@N02,2607,23,1244843441,1244843446,3,10,5
35795945@N02,2607,5,1244843446,1244843449,2,10,3
35795945@N02,2607,7,1244843449,1244843452,3,10,3
35795945@N02,2607,16,1244843452,1244843457,3,10,5
35795945@N02,2607,17,1244843457,1244843462,2,10,5
35795945@N02,2607,6,1244843462,1244843582,4,10,120
35795945@N02,2607,10,1244844517,1244844667,1,10,150
35795945@N02,2608,20,1250411730,1250411934,6,3,204
35795945@N02,2608,17,1250411934,1250412354,3,3,420
35795945@N02,2608,16,1250412914,1250413334,1,3,420
35795945@N02,2609,17,1273367250,1273367670,5,2,420
35795945@N02,2609,6,1273368363,1273368483,6,2,120
35795945@N02,2610,12,1274952573,1274952843,1,1,270
35795945@N02,2611,24,1286698495,1286698586,3,5,91
35795945@N02,2611,25,1286698586,1286698656,2,5,70
35795945@N02,2611,13,1286698656,1286698956,12,5,300
35795945@N02,2611,25,1286699291,1286699500,2,5,209
35795945@N02,2611,20,1286699500,1286700100,2,5,600
35922097@N00,2612,19,1377947489,1377948029,1,1,540
35922097@N00,2613,24,1381480006,1381481506,1,1,1500
35942475@N05,2614,19,1350116274,1350116814,1,1,540
35942475@N05,2615,16,1353111119,1353111539,2,1,420
35942475@N05,2616,19,1353483131,1353483671,1,1,540
35942475@N05,2617,11,1353972073,1353972313,1,1,240
35942475@N05,2618,19,1354052138,1354052678,2,2,540
35942475@N05,2618,11,1354053641,1354053881,1,2,240
35942475@N05,2619,11,1354577782,1354578022,1,1,240
35942475@N05,2620,6,1359409969,1359410089,1,1,120
35942475@N05,2621,23,1361912194,1361913394,1,1,1200
35942475@N05,2622,11,1363290916,1363291156,1,1,240
35942475@N05,2623,17,1366332860,1366333280,1,1,420
35942475@N05,2624,6,1379718209,1379718329,1,1,120
35945797@N05,2625,6,1341101958,1341102078,8,1,120
35945797@N05,2626,16,1352591666,1352592086,3,3,420
35945797@N05,2626,19,1352592978,1352593518,5,3,540
35945797@N05,2626,8,1352596670,1352596790,2,3,120
35945797@N05,2627,19,1353365530,1353366059,4,4,529
35945797@N05,2627,23,1353366059,1353366137,4,4,78
35945797@N05,2627,17,1353366137,1353366557,4,4,420
35945797@N05,2627,24,1353366984,1353368484,2,4,1500
35989941@N04,2628,16,1328943282,1328943702,1,1,420
35991126@N08,2629,18,1243227425,1243227965,1,1,540
36033182@N00,2630,15,1210392017,1210392377,3,3,360
36033182@N00,2630,16,1210394508,1210394928,2,3,420
36033182@N00,2630,18,1210401211,1210401751,2,3,540
36076461@N00,2631,24,1286771363,1286772863,1,1,1500
36121294@N06,2632,24,1267007605,1267009105,1,1,1500
36179078@N03,2633,24,1386945856,1386947356,1,1,1500
36179078@N03,2634,24,1393138157,1393139657,1,1,1500
36179078@N03,2635,24,1394193592,1394195092,1,1,1500
36179078@N03,2636,17,1448810497,1448810917,1,1,420
36179078@N03,2637,17,1452235278,1452235698,1,1,420
36209531@N07,2638,12,1341983218,1341983488,1,1,270
36209531@N07,2639,24,1394088808,1394089899,2,4,1091
36209531@N07,2639,14,1394089899,1394090259,2,4,360
36209531@N07,2639,11,1394091121,1394091361,2,4,240
36209531@N07,2639,24,1394097117,1394098617,1,4,1500
36231632@N00,2640,16,1414653539,1414653959,1,1,420
36244940@N07,2641,17,1256884562,1256884982,1,1,420
36244940@N07,2642,16,1301356990,1301357274,3,13,284
36244940@N07,2642,5,1301357274,1301357394,3,13,120
36244940@N07,2642,10,1301357901,1301358049,2,13,148
36244940@N07,2642,24,1301358049,1301358357,2,13,308
36244940@N07,2642,11,1301358357,1301358561,3,13,204
36244940@N07,2642,7,1301358561,1301358681,2,13,120
36244940@N07,2642,11,1301358959,1301359199,3,13,240
36244940@N07,2642,15,1301362079,1301362439,2,13,360
36244940@N07,2642,12,1301364410,1301364476,2,13,66
36244940@N07,2642,19,1301364476,1301365016,2,13,540
36244940@N07,2642,10,1301386487,1301386637,2,13,150
36244940@N07,2642,19,1301388646,1301389186,2,13,540
36244940@N07,2642,16,1301389313,1301389733,1,13,420
36244940@N07,2643,7,1301451764,1301451884,3,3,120
36244940@N07,2643,11,1301453057,1301453101,2,3,44
36244940@N07,2643,7,1301453101,1301453221,3,3,120
36244940@N07,2644,16,1301526000,1301526420,2,5,420
36244940@N07,2644,18,1301532838,1301533378,3,5,540
36244940@N07,2644,5,1301533645,1301533765,2,5,120
36244940@N07,2644,1,1301534189,1301534249,2,5,60
36244940@N07,2644,18,1301534389,1301534929,1,5,540
36244940@N07,2645,11,1301623309,1301623549,1,1,240
36258343@N03,2646,6,1359890161,1359890281,2,3,120
36258343@N03,2646,14,1359892981,1359893341,3,3,360
36258343@N03,2646,19,1359894094,1359894634,2,3,540
36258343@N03,2647,6,1366812330,1366812450,1,1,120
36258343@N03,2648,23,1366940148,1366941348,1,1,1200
36277109@N03,2649,14,1398228785,1398229145,1,1,360
36312349@N00,2650,13,1290759581,1290759881,2,1,300
36312349@N00,2651,25,1407194718,1407196818,1,1,2100
36330825967@N01,2652,12,1213717518,1213717788,2,1,270
36330825967@N01,2653,10,1227601054,1227601204,2,2,150
36330825967@N01,2653,13,1227604049,1227604349,2,2,300
36330825967@N01,2654,24,1273887602,1273889102,1,1,1500
36330825967@N01,2655,15,1289464049,1289464409,2,1,360
36330825967@N01,2656,15,1289544105,1289544465,1,1,360
36330825967@N01,2657,18,1289633625,1289634165,1,1,540
36330825967@N01,2658,18,1311466524,1311467064,1,1,540
36330825967@N01,2659,19,1357852959,1357853499,2,2,540
36330825967@N01,2659,23,1357858688,1357859888,1,2,1200
36330825967@N01,2660,17,1357890742,1357891162,1,1,420
36330825967@N01,2661,7,1358042037,1358042157,2,2,120
36330825967@N01,2661,19,1358052120,1358052660,1,2,540
36330825967@N01,2662,19,1358116025,1358116565,1,1,540
36330825967@N01,2663,22,1372035542,1372036562,3,3,1020
36330825967@N01,2663,15,1372039152,1372039512,2,3,360
36330825967@N01,2663,22,1372043035,1372044055,2,3,1020
36330825967@N01,2664,23,1389426403,1389427603,1,1,1200
36330825967@N01,2665,14,1464730115,1464730475,2,2,360
36330825967@N01,2665,11,1464733190,1464733430,4,2,240
36330825967@N01,2666,8,1464853482,1464853602,2,2,120
36330825967@N01,2666,18,1464860579,1464861119,2,2,540
36330825967@N01,2667,19,1464902274,1464902756,2,4,482
36330825967@N01,2667,14,1464902756,1464902777,2,4,21
36330825967@N01,2667,8,1464902777,1464902897,2,4,120
36330825967@N01,2667,11,1464907177,1464907417,1,4,240
36330825967@N01,2668,16,1464950026,1464950446,1,1,420
36342378@N02,2669,19,1370424679,1370425219,1,1,540
36342378@N02,2670,19,1377173401,1377173941,1,1,540
36342378@N02,2671,19,1388284291,1388284831,1,1,540
36342378@N02,2672,17,1419922263,1419922683,1,1,420
36342378@N02,2673,17,1445589668,1445590088,1,1,420
36423739@N02,2674,12,1353369812,1353370082,4,2,270
36423739@N02,2674,15,1353373746,1353374106,1,2,360
36470826@N06,2675,7,1324121042,1324121162,2,2,120
36470826@N06,2675,22,1324124127,1324125147,1,2,1020
36470826@N06,2676,24,1450527133,1450528633,11,1,1500
36470826@N06,2677,24,1451045275,1451046775,1,1,1500
36521981324@N01,2678,7,1252569812,1252569932,1,1,120
36559368@N07,2679,7,1357652611,1357652731,1,1,120
36669200@N05,2680,12,1440224411,1440224681,2,2,270
36669200@N05,2680,19,1440240018,1440240558,1,2,540
36671802@N04,2681,16,1468761228,1468761648,20,1,420
36736609@N08,2682,10,1435538113,1435538263,1,1,150
36738674@N00,2683,24,1389608241,1389609741,1,1,1500
36754584@N04,2684,11,1227308602,1227308842,1,1,240
36786209@N00,2685,24,1421971935,1421973435,9,1,1500
36786209@N00,2686,24,1422264901,1422266401,1,1,1500
36909370@N06,2687,15,1306076499,1306076535,2,2,36
36909370@N06,2687,2,1306076535,1306076595,1,2,60
36909370@N06,2688,5,1319358731,1319358851,1,1,120
36909370@N06,2689,19,1442425310,1442425850,1,1,540
36911028@N00,2690,16,1338386951,1338387371,2,1,420
36911028@N00,2691,14,1341796578,1341796938,2,2,360
36911028@N00,2691,22,1341813531,1341814551,1,2,1020
36911028@N00,2692,24,1341892242,1341893742,1,1,1500
36911028@N00,2693,7,1345683251,1345683371,2,2,120
36911028@N00,2693,16,1345711989,1345712409,1,2,420
36911028@N00,2694,18,1416363474,1416364014,2,2,540
36911028@N00,2694,25,1416368361,1416370461,1,2,2100
36911028@N00,2695,17,1441948640,1441949060,2,2,420
36911028@N00,2695,5,1441953428,1441953548,1,2,120
36911028@N00,2696,12,1442197121,1442197391,1,1,270
36942952@N00,2697,12,1194144709,1194144979,18,32,270
36942952@N00,2697,24,1194147760,1194148265,6,32,505
36942952@N00,2697,22,1194148265,1194148798,8,32,533
36942952@N00,2697,24,1194148798,1194149059,4,32,261
36942952@N00,2697,22,1194149059,1194149178,4,32,119
36942952@N00,2697,24,1194149178,1194149542,5,32,364
36942952@N00,2697,22,1194149542,1194149640,4,32,98
36942952@N00,2697,25,1194149640,1194149686,3,32,46
36942952@N00,2697,22,1194149686,1194149904,3,32,218
36942952@N00,2697,13,1194149904,1194150078,2,32,174
36942952@N00,2697,25,1194150078,1194150505,6,32,427
36942952@N00,2697,22,1194150505,1194151124,3,32,619
36942952@N00,2697,12,1194151124,1194151394,2,32,270
36942952@N00,2697,16,1194151526,1194151946,4,32,420
36942952@N00,2697,3,1194151949,1194152039,6,32,90
36942952@N00,2697,5,1194152334,1194152454,9,32,120
36942952@N00,2697,18,1194152909,1194153369,6,32,460
36942952@N00,2697,7,1194153369,1194153489,4,32,120
36942952@N00,2697,11,1194153815,1194154020,4,32,205
36942952@N00,2697,7,1194154020,1194154140,5,32,120
36942952@N00,2697,19,1194154443,1194154983,8,32,540
36942952@N00,2697,6,1194155027,1194155147,3,32,120
36942952@N00,2697,18,1194156429,1194156969,4,32,540
36942952@N00,2697,7,1194180854,1194180891,2,32,37
36942952@N00,2697,19,1194180891,1194180937,3,32,46
36942952@N00,2697,18,1194180937,1194181041,7,32,104
36942952@N00,2697,12,1194181041,1194181114,5,32,73
36942952@N00,2697,22,1194181114,1194181241,3,32,127
36942952@N00,2697,24,1194181241,1194181303,2,32,62
36942952@N00,2697,13,1194181303,1194181337,4,32,34
36942952@N00,2697,22,1194181337,1194181424,2,32,87
36942952@N00,2697,25,1194181424,1194183524,3,32,2100
36942952@N00,2698,5,1211445241,1211445361,2,2,120
36942952@N00,2698,17,1211445808,1211446228,1,2,420
36942952@N00,2699,7,1216807987,1216808107,2,1,120
36942952@N00,2700,16,1229080579,1229080769,2,5,190
36942952@N00,2700,11,1229080769,1229080949,2,5,180
36942952@N00,2700,16,1229080949,1229081112,2,5,163
36942952@N00,2700,19,1229081112,1229081289,2,5,177
36942952@N00,2700,16,1229081289,1229081709,1,5,420
36942952@N00,2701,16,1236570399,1236570819,1,1,420
36942952@N00,2702,16,1236941867,1236942287,1,1,420
36942952@N00,2703,24,1244812841,1244814341,5,1,1500
36942952@N00,2704,7,1246268703,1246268823,1,1,120
36942952@N00,2705,17,1257057401,1257057424,3,2,23
36942952@N00,2705,24,1257057424,1257058924,1,2,1500
36942952@N00,2706,17,1259482907,1259483326,2,7,419
36942952@N00,2706,23,1259483326,1259483447,2,7,121
36942952@N00,2706,16,1259483447,1259483867,2,7,420
36942952@N00,2706,11,1259484262,1259484432,3,7,170
36942952@N00,2706,7,1259484432,1259484552,2,7,120
36942952@N00,2706,11,1259484827,1259485067,2,7,240
36942952@N00,2706,5,1259485270,1259485390,1,7,120
36942952@N00,2707,24,1289618070,1289618463,3,6,393
36942952@N00,2707,19,1289618463,1289618705,2,6,242
36942952@N00,2707,16,1289618705,1289619125,8,6,420
36942952@N00,2707,10,1289619198,1289619285,2,6,87
36942952@N00,2707,3,1289619285,1289619375,2,6,90
36942952@N00,2707,5,1289619448,1289619568,1,6,120
36942952@N00,2708,3,1301375676,1301375766,1,1,90
36942952@N00,2709,12,1328374134,1328374315,2,7,181
36942952@N00,2709,24,1328374315,1328374404,4,7,89
36942952@N00,2709,12,1328374404,1328374415,2,7,11
36942952@N00,2709,24,1328374415,1328374646,3,7,231
36942952@N00,2709,19,1328374646,1328375186,3,7,540
36942952@N00,2709,16,1328375410,1328375830,5,7,420
36942952@N00,2709,23,1328376106,1328377306,1,7,1200
36942952@N00,2710,12,1341036302,1341036572,1,1,270
36942952@N00,2711,12,1373022264,1373022534,12,1,270
36942952@N00,2712,3,1380279229,1380279319,2,1,90
36942952@N00,2713,14,1400321410,1400321770,2,1,360
36942952@N00,2714,12,1409296351,1409296621,9,7,270
36942952@N00,2714,24,1409296796,1409297017,7,7,221
36942952@N00,2714,20,1409297017,1409297617,4,7,600
36942952@N00,2714,14,1409297934,1409298294,4,7,360
36942952@N00,2714,12,1409309896,1409310148,2,7,252
36942952@N00,2714,20,1409310148,1409310748,8,7,600
36942952@N00,2714,12,1409312313,1409312583,1,7,270
36942952@N00,2715,12,1412071526,1412071796,5,2,270
36942952@N00,2715,10,1412072630,1412072780,3,2,150
36942952@N00,2716,12,1419232586,1419232856,1,1,270
36942952@N00,2717,12,1420272322,1420272592,1,1,270
36987405@N02,2718,18,1340920829,1340921369,2,3,540
36987405@N02,2718,14,1340923521,1340923881,2,3,360
36987405@N02,2718,15,1340928670,1340929030,1,3,360
36987405@N02,2719,11,1340958003,1340958243,1,1,240
37032567@N05,2720,15,1329114389,1329114749,1,1,360
37168969@N00,2721,13,1356948176,1356948476,1,1,300
37168969@N00,2722,25,1357022069,1357022144,2,3,75
37168969@N00,2722,22,1357022144,1357022434,4,3,290
37168969@N00,2722,25,1357022434,1357024534,1,3,2100
37218967@N00,2723,12,1436010491,1436010761,1,1,270
37241421@N07,2724,6,1448070199,1448070319,36,1,120
37258140@N04,2725,12,1354745803,1354746073,2,3,270
37258140@N04,2725,18,1354761247,1354761787,2,3,540
37258140@N04,2725,16,1354784981,1354785401,2,3,420
37258140@N04,2726,14,1354918744,1354919104,1,1,360
37258140@N04,2727,14,1355007265,1355007625,1,1,360
37279543@N00,2728,19,1285835834,1285836374,2,1,540
37363832@N03,2729,13,1336908989,1336909289,2,1,300
37363832@N03,2730,12,1337515789,1337515812,2,3,23
37363832@N03,2730,16,1337515812,1337516232,2,3,420
37363832@N03,2730,13,1337516746,1337517046,1,3,300
37363832@N03,2731,14,1345947549,1345947909,1,1,360
37363832@N03,2732,13,1345978045,1345978345,2,1,300
37363832@N03,2733,12,1346198420,1346198690,1,1,270
37363832@N03,2734,14,1346807583,1346807943,2,2,360
37363832@N03,2734,18,1346811269,1346811809,1,2,540
37363832@N03,2735,22,1349593837,1349594857,1,1,1020
37363832@N03,2736,24,1353820254,1353821754,1,1,1500
37363832@N03,2737,14,1354065650,1354066010,2,2,360
37363832@N03,2737,12,1354069114,1354069384,1,2,270
37363832@N03,2738,13,1354434528,1354434828,2,1,300
37363832@N03,2739,12,1370166509,1370166779,1,1,270
37363832@N03,2740,24,1370256745,1370258245,1,1,1500
37363832@N03,2741,11,1370319539,1370319779,1,1,240
37363832@N03,2742,25,1370398310,1370400410,1,1,2100
37363832@N03,2743,24,1370434723,1370436223,1,1,1500
37363832@N03,2744,24,1380454780,1380456280,1,1,1500
37364998@N05,2745,14,1376868133,1376868493,1,1,360
37364998@N05,2746,15,1377069289,1377069649,1,1,360
37364998@N05,2747,7,1377204127,1377204247,1,1,120
37369621@N00,2748,22,1332987035,1332987242,2,5,207
37369621@N00,2748,25,1332987242,1332987801,2,5,559
37369621@N00,2748,15,1332987801,1332988161,2,5,360
37369621@N00,2748,20,1332991657,1332992107,2,5,450
37369621@N00,2748,16,1332992107,1332992527,2,5,420
37376032@N00,2749,18,1418078736,1418079276,1,1,540
37376032@N00,2750,18,1418112476,1418113016,4,1,540
37376032@N00,2751,18,1418167809,1418168349,3,3,540
37376032@N00,2751,14,1418176383,1418176743,2,3,360
37376032@N00,2751,18,1418202202,1418202742,1,3,540
37382345@N08,2752,12,1347859808,1347860078,1,1,270
37382345@N08,2753,13,1352455958,1352456258,1,1,300
37382345@N08,2754,12,1358145468,1358145738,1,1,270
37382345@N08,2755,13,1361610776,1361611076,68,1,300
37382345@N08,2756,17,1365321220,1365321407,2,8,187
37382345@N08,2756,23,1365321407,1365322607,2,8,1200
37382345@N08,2756,15,1365324047,1365324373,2,8,326
37382345@N08,2756,14,1365324373,1365324713,3,8,340
37382345@N08,2756,19,1365324713,1365325253,3,8,540
37382345@N08,2756,20,1365326059,1365326659,2,8,600
37382345@N08,2756,13,1365326811,1365327111,5,8,300
37382345@N08,2756,24,1365328162,1365329662,1,8,1500
37382345@N08,2757,13,1366452309,1366452609,12,1,300
37382345@N08,2758,22,1368851018,1368852038,3,2,1020
37382345@N08,2758,5,1368854425,1368854545,1,2,120
37382345@N08,2759,14,1371282151,1371282511,7,3,360
37382345@N08,2759,15,1371287127,1371287321,2,3,194
37382345@N08,2759,9,1371287321,1371287441,1,3,120
37382345@N08,2760,24,1372670771,1372670949,2,2,178
37382345@N08,2760,13,1372670949,1372671249,19,2,300
37382345@N08,2761,13,1372756771,1372757071,1,1,300
37382345@N08,2762,24,1373697898,1373699304,5,2,1406
37382345@N08,2762,13,1373699304,1373699604,28,2,300
37382345@N08,2763,13,1374398660,1374398960,58,1,300
37382345@N08,2764,13,1375962189,1375962489,2,1,300
37382345@N08,2765,13,1382865013,1382865313,2,1,300
37382345@N08,2766,13,1387875166,1387875466,11,1,300
37382345@N08,2767,13,1388910089,1388910389,5,1,300
37382345@N08,2768,13,1391840020,1391840320,23,3,300
37382345@N08,2768,23,1391850119,1391851319,2,3,1200
37382345@N08,2768,16,1391855046,1391855466,7,3,420
37382345@N08,2769,13,1393058464,1393058764,10,2,300
37382345@N08,2769,14,1393061201,1393061561,3,2,360
37382345@N08,2770,17,1393140273,1393140693,2,2,420
37382345@N08,2770,10,1393141097,1393141247,1,2,150
37382345@N08,2771,14,1399346180,1399346540,3,3,360
37382345@N08,2771,19,1399347505,1399348045,3,3,540
37382345@N08,2771,11,1399348475,1399348715,1,3,240
37382345@N08,2772,13,1401094741,1401095041,4,1,300
37382345@N08,2773,13,1404813413,1404813713,28,1,300
37382345@N08,2774,7,1405157078,1405157198,2,2,120
37382345@N08,2774,13,1405158222,1405158522,11,2,300
37413911@N07,2775,7,1304831129,1304831249,1,1,120
37423919@N00,2776,8,1408344492,1408344612,1,1,120
37495946@N04,2777,12,1466061615,1466061885,1,1,270
37500995@N03,2778,17,1329966257,1329966677,1,1,420
37513581@N03,2779,11,1236146123,1236146363,1,1,240
37513581@N03,2780,5,1236752504,1236752624,1,1,120
37513581@N03,2781,24,1240407597,1240409097,2,2,1500
37513581@N03,2781,15,1240411744,1240412104,3,2,360
37513581@N03,2782,16,1242148182,1242148302,3,2,120
37513581@N03,2782,11,1242148302,1242148542,2,2,240
37513581@N03,2783,5,1245042182,1245042302,2,2,120
37513581@N03,2783,18,1245043667,1245044207,2,2,540
37541876@N06,2784,14,1382351086,1382351446,2,2,360
37541876@N06,2784,24,1382352392,1382353892,1,2,1500
37572076@N08,2785,19,1412415530,1412416070,1,1,540
37575596@N07,2786,24,1369992703,1369994203,13,1,1500
37588991@N00,2787,19,1257879929,1257880469,2,1,540
37642540@N04,2788,16,1369132176,1369132596,5,1,420
37642540@N04,2789,19,1369209228,1369209768,7,5,540
37642540@N04,2789,7,1369212124,1369212244,4,5,120
37642540@N04,2789,6,1369215647,1369215748,4,5,101
37642540@N04,2789,19,1369215748,1369215910,2,5,162
37642540@N04,2789,24,1369215910,1369217410,5,5,1500
37645295@N00,2790,13,1288264925,1288265225,1,1,300
37648075@N08,2791,14,1350270674,1350271034,3,4,360
37648075@N08,2791,12,1350278179,1350278449,2,4,270
37648075@N08,2791,14,1350290039,1350290399,3,4,360
37648075@N08,2791,16,1350291686,1350292106,4,4,420
37689138@N07,2792,12,1336887628,1336887898,1,1,270
37709784@N00,2793,12,1254472647,1254472917,2,3,270
37709784@N00,2793,6,1254479358,1254479478,5,3,120
37709784@N00,2793,20,1254481271,1254481871,1,3,600
37718676626@N01,2794,23,1356645677,1356646877,8,2,1200
37718676626@N01,2794,10,1356651936,1356652086,2,2,150
37763182@N03,2795,10,1212231049,1212231199,1,1,150
37763182@N03,2796,7,1214303143,1214303263,1,1,120
37763182@N03,2797,24,1217748404,1217749904,2,3,1500
37763182@N03,2797,7,1217751786,1217751906,2,3,120
37763182@N03,2797,15,1217755816,1217756176,1,3,360
37763182@N03,2798,7,1251161947,1251162067,1,1,120
37763182@N03,2799,15,1268461953,1268462313,1,1,360
37763182@N03,2800,18,1271408100,1271408640,2,2,540
37763182@N03,2800,7,1271409871,1271409991,2,2,120
37763182@N03,2801,22,1278669687,1278670707,2,1,1020
37763182@N03,2802,25,1280371858,1280373958,2,1,2100
37763182@N03,2803,22,1280747945,1280748965,8,1,1020
37763182@N03,2804,22,1281067011,1281068031,6,2,1020
37763182@N03,2804,15,1281080619,1281080979,2,2,360
37763182@N03,2805,6,1281445014,1281445134,1,1,120
37763182@N03,2806,15,1281682169,1281682529,5,2,360
37763182@N03,2806,25,1281684432,1281686532,25,2,2100
37763182@N03,2807,16,1283755567,1283755987,3,2,420
37763182@N03,2807,25,1283764601,1283766701,40,2,2100
37763182@N03,2808,1,1284082147,1284082207,3,3,60
37763182@N03,2808,18,1284111864,1284112404,2,3,540
37763182@N03,2808,10,1284114466,1284114616,10,3,150
37763182@N03,2809,15,1286407035,1286407395,3,3,360
37763182@N03,2809,20,1286408610,1286409210,4,3,600
37763182@N03,2809,25,1286416359,1286418459,36,3,2100
37763182@N03,2810,25,1287800216,1287802316,5,3,2100
37763182@N03,2810,22,1287824586,1287825606,2,3,1020
37763182@N03,2810,10,1287826004,1287826154,2,3,150
37763182@N03,2811,13,1289022982,1289023282,4,3,300
37763182@N03,2811,15,1289025433,1289025793,2,3,360
37763182@N03,2811,25,1289027236,1289029336,56,3,2100
37763182@N03,2812,15,1289447613,1289447973,3,3,360
37763182@N03,2812,6,1289448687,1289448807,4,3,120
37763182@N03,2812,4,1289472396,1289472486,1,3,90
37763182@N03,2813,25,1293673801,1293675901,15,4,2100
37763182@N03,2813,15,1293683295,1293683655,2,4,360
37763182@N03,2813,1,1293686488,1293686548,3,4,60
37763182@N03,2813,18,1293686858,1293687398,6,4,540
37763182@N03,2814,18,1295495565,1295496105,1,1,540
37763182@N03,2815,25,1296805245,1296807345,10,1,2100
37763182@N03,2816,25,1299395924,1299398024,10,1,2100
37763182@N03,2817,12,1305539217,1305539487,1,1,270
37763182@N03,2818,16,1306368265,1306368685,5,1,420
37763182@N03,2819,16,1307428471,1307428891,2,1,420
37763182@N03,2820,22,1308707340,1308708360,1,1,1020
37763949@N00,2821,12,1359259842,1359260112,1,1,270
37869753@N06,2822,18,1301560711,1301561251,2,1,540
37869753@N06,2823,12,1327199680,1327199950,2,4,270
37869753@N06,2823,23,1327200066,1327200608,2,4,542
37869753@N06,2823,16,1327200608,1327201028,3,4,420
37869753@N06,2823,18,1327202102,1327202642,2,4,540
37869753@N06,2824,19,1332653804,1332654344,3,4,540
37869753@N06,2824,13,1332659022,1332659076,2,4,54
37869753@N06,2824,15,1332659076,1332659095,2,4,19
37869753@N06,2824,13,1332659095,1332659395,1,4,300
37869753@N06,2825,23,1332713596,1332714641,2,2,1045
37869753@N06,2825,16,1332714641,1332715061,1,2,420
37869753@N06,2826,23,1334875064,1334876264,2,6,1200
37869753@N06,2826,7,1334877176,1334877296,2,6,120
37869753@N06,2826,3,1334878546,1334878636,2,6,90
37869753@N06,2826,6,1334879514,1334879634,3,6,120
37869753@N06,2826,12,1334880437,1334880707,3,6,270
37869753@N06,2826,16,1334903456,1334903876,1,6,420
37869753@N06,2827,24,1339576280,1339577780,1,1,1500
37869753@N06,2828,25,1339713114,1339715214,2,27,2100
37869753@N06,2828,19,1339715335,1339715408,2,27,73
37869753@N06,2828,8,1339715408,1339715528,2,27,120
37869753@N06,2828,14,1339717402,1339717430,2,27,28
37869753@N06,2828,8,1339717430,1339717447,2,27,17
37869753@N06,2828,19,1339717447,1339717987,2,27,540
37869753@N06,2828,20,1339721882,1339722182,2,27,300
37869753@N06,2828,14,1339722182,1339722542,4,27,360
37869753@N06,2828,8,1339726358,1339726478,2,27,120
37869753@N06,2828,22,1339730802,1339731822,3,27,1020
37869753@N06,2828,24,1339731847,1339732249,3,27,402
37869753@N06,2828,12,1339732249,1339732519,2,27,270
37869753@N06,2828,24,1339733108,1339734608,5,27,1500
37869753@N06,2828,25,1339736473,1339737736,2,27,1263
37869753@N06,2828,8,1339737736,1339737856,2,27,120
37869753@N06,2828,6,1339741139,1339741259,6,27,120
37869753@N06,2828,14,1339743208,1339743504,4,27,296
37869753@N06,2828,9,1339743504,1339743606,2,27,102
37869753@N06,2828,14,1339743606,1339743666,2,27,60
37869753@N06,2828,8,1339743666,1339743786,3,27,120
37869753@N06,2828,19,1339743985,1339744525,2,27,540
37869753@N06,2828,8,1339748461,1339748581,2,27,120
37869753@N06,2828,14,1339749950,1339750310,2,27,360
37869753@N06,2828,18,1339754170,1339754613,2,27,443
37869753@N06,2828,16,1339754613,1339755033,4,27,420
37869753@N06,2828,14,1339757152,1339757305,2,27,153
37869753@N06,2828,24,1339757305,1339758805,1,27,1500
37869753@N06,2829,5,1343637832,1343637952,2,5,120
37869753@N06,2829,16,1343638192,1343638612,4,5,420
37869753@N06,2829,14,1343644964,1343645093,3,5,129
37869753@N06,2829,8,1343645093,1343645213,3,5,120
37869753@N06,2829,12,1343647635,1343647905,1,5,270
37869753@N06,2830,11,1344895559,1344895799,2,6,240
37869753@N06,2830,12,1344897877,1344898147,3,6,270
37869753@N06,2830,24,1344917140,1344918630,11,6,1490
37869753@N06,2830,22,1344918630,1344919650,2,6,1020
37869753@N06,2830,25,1344924912,1344927012,4,6,2100
37869753@N06,2830,8,1344927352,1344927472,3,6,120
37869753@N06,2831,22,1350002755,1350003775,7,4,1020
37869753@N06,2831,24,1350007556,1350009056,4,4,1500
37869753@N06,2831,14,1350031651,1350032011,2,4,360
37869753@N06,2831,13,1350032599,1350032899,4,4,300
37869753@N06,2832,8,1350790590,1350790710,2,3,120
37869753@N06,2832,13,1350792667,1350792967,2,3,300
37869753@N06,2832,25,1350795748,1350797848,1,3,2100
37869753@N06,2833,19,1352678270,1352678345,3,11,75
37869753@N06,2833,14,1352678345,1352678705,2,11,360
37869753@N06,2833,8,1352678931,1352679051,2,11,120
37869753@N06,2833,11,1352683299,1352683539,3,11,240
37869753@N06,2833,16,1352683677,1352684097,3,11,420
37869753@N06,2833,20,1352684245,1352684358,2,11,113
37869753@N06,2833,24,1352684358,1352685858,2,11,1500
37869753@N06,2833,13,1352705294,1352705594,2,11,300
37869753@N06,2833,14,1352711403,1352711763,2,11,360
37869753@N06,2833,8,1352713078,1352713198,2,11,120
37869753@N06,2833,14,1352714769,1352715129,1,11,360
37869753@N06,2834,20,1355613122,1355613199,2,3,77
37869753@N06,2834,24,1355613199,1355614699,4,3,1500
37869753@N06,2834,12,1355632553,1355632823,1,3,270
37869753@N06,2835,24,1358586632,1358586843,3,2,211
37869753@N06,2835,13,1358586843,1358587143,6,2,300
37869753@N06,2836,24,1361662788,1361664288,2,1,1500
37869753@N06,2837,24,1370992936,1370994436,4,2,1500
37869753@N06,2837,16,1370996984,1370997404,3,2,420
37869753@N06,2838,3,1374894567,1374894657,5,1,90
37869753@N06,2839,12,1379818168,1379818438,1,1,270
37869753@N06,2840,24,1386735750,1386737250,5,1,1500
37869753@N06,2841,16,1393551721,1393552141,5,1,420
37869753@N06,2842,7,1402535500,1402535620,1,1,120
37869753@N06,2843,16,1409655307,1409655727,1,1,420
37869753@N06,2844,14,1411707061,1411707421,3,1,360
37869753@N06,2845,16,1417600143,1417600563,2,3,420
37869753@N06,2845,14,1417604720,1417605080,2,3,360
37869753@N06,2845,12,1417605590,1417605860,1,3,270
37869753@N06,2846,14,1439966693,1439967053,4,2,360
37869753@N06,2846,13,1439969723,1439970023,1,2,300
37869753@N06,2847,14,1453524461,1453524821,2,1,360
37869753@N06,2848,14,1457045372,1457045732,1,1,360
37893053@N02,2849,16,1429433624,1429434044,1,1,420
37912374286@N01,2850,18,1244084578,1244085118,2,1,540
37913092@N00,2851,7,1382427773,1382427893,1,1,120
37920932@N07,2852,14,1313866277,1313866637,2,1,360
37947859@N05,2853,24,1368366157,1368367657,1,1,1500
37955866@N03,2854,19,1211883482,1211884022,1,1,540
37955866@N03,2855,19,1211942516,1211943056,1,1,540
37955866@N03,2856,19,1212026037,1212026577,2,1,540
37955866@N03,2857,19,1213775115,1213775655,1,1,540
37955866@N03,2858,19,1214910915,1214911455,1,1,540
37955866@N03,2859,19,1219121026,1219121566,2,1,540
37955866@N03,2860,19,1219190168,1219190708,2,1,540
37955866@N03,2861,19,1220235892,1220236432,1,1,540
37955866@N03,2862,19,1220946981,1220947521,1,1,540
37955866@N03,2863,19,1222252084,1222252624,1,1,540
37955866@N03,2864,19,1222915685,1222916225,4,1,540
37955866@N03,2865,19,1224116402,1224116942,6,1,540
37955866@N03,2866,19,1224718747,1224719287,4,1,540
37955866@N03,2867,19,1225148764,1225149304,6,1,540
37955866@N03,2868,19,1225754696,1225755236,1,1,540
37955866@N03,2869,19,1226883370,1226883910,3,1,540
37955866@N03,2870,19,1227931339,1227931879,6,1,540
37955866@N03,2871,19,1228193138,1228193678,2,1,540
37955866@N03,2872,19,1228865222,1228865762,4,1,540
37996575176@N01,2873,7,1322627674,1322627794,1,1,120
37996583849@N01,2874,14,1344261023,1344261383,1,1,360
37996583849@N01,2875,25,1357299056,1357301156,1,1,2100
37996583849@N01,2876,5,1370330818,1370330938,2,3,120
37996583849@N01,2876,14,1370338517,1370338877,2,3,360
37996583849@N01,2876,17,1370343371,1370343791,1,3,420
37996583849@N01,2877,14,1379030931,1379031291,1,1,360
37996583849@N01,2878,16,1384479848,1384480268,1,1,420
37996583849@N01,2879,5,1386227344,1386227464,1,1,120
37996583849@N01,2880,7,1388910050,1388910170,1,1,120
37996583849@N01,2881,17,1417791958,1417792378,1,1,420
37996583849@N01,2882,17,1435222270,1435222690,1,1,420
38023997@N05,2883,11,1281531309,1281531549,1,1,240
38067879@N08,2884,17,1336961744,1336962164,2,5,420
38067879@N08,2884,11,1336970632,1336970872,3,5,240
38067879@N08,2884,13,1336973338,1336973638,2,5,300
38067879@N08,2884,25,1336976558,1336978658,2,5,2100
38067879@N08,2884,16,1336992162,1336992582,1,5,420
38067879@N08,2885,16,1337321299,1337321719,1,1,420
38067879@N08,2886,13,1337672292,1337672592,1,1,300
38067879@N08,2887,23,1354260270,1354261470,1,1,1200
38067879@N08,2888,12,1354307501,1354307771,2,1,270
38067879@N08,2889,12,1354340560,1354340830,1,1,270
38067879@N08,2890,16,1354397227,1354397486,2,3,259
38067879@N08,2890,23,1354397486,1354398528,2,3,1042
38067879@N08,2890,16,1354398528,1354398948,1,3,420
38067879@N08,2891,14,1354567865,1354568225,2,2,360
38067879@N08,2891,24,1354582106,1354583606,1,2,1500
38067879@N08,2892,14,1382940889,1382941249,2,1,360
38067879@N08,2893,17,1397645752,1397646172,1,1,420
38067879@N08,2894,24,1397718085,1397719585,1,1,1500
38067879@N08,2895,14,1397772663,1397773023,2,1,360
38067879@N08,2896,12,1462102275,1462102545,1,1,270
38075565@N00,2897,17,1244893193,1244893613,7,1,420
38084526@N06,2898,16,1318642969,1318643389,2,1,420
38102706@N05,2899,12,1267805405,1267805675,1,1,270
38102706@N05,2900,12,1267909105,1267909375,3,1,270
38102706@N05,2901,12,1267967242,1267967512,1,1,270
38102706@N05,2902,12,1268009036,1268009306,4,27,270
38102706@N05,2902,20,1268009390,1268009481,3,27,91
38102706@N05,2902,17,1268009481,1268009901,5,27,420
38102706@N05,2902,20,1268012405,1268012568,2,27,163
38102706@N05,2902,6,1268012568,1268012688,2,27,120
38102706@N05,2902,16,1268012705,1268013110,3,27,405
38102706@N05,2902,7,1268013110,1268013230,19,27,120
38102706@N05,2902,16,1268016194,1268016388,2,27,194
38102706@N05,2902,7,1268016388,1268016508,5,27,120
38102706@N05,2902,10,1268017018,1268017044,2,27,26
38102706@N05,2902,18,1268017044,1268017448,7,27,404
38102706@N05,2902,7,1268017448,1268017568,9,27,120
38102706@N05,2902,19,1268018947,1268019050,2,27,103
38102706@N05,2902,6,1268019050,1268019095,2,27,45
38102706@N05,2902,19,1268019095,1268019141,4,27,46
38102706@N05,2902,21,1268019141,1268019278,7,27,137
38102706@N05,2902,4,1268019278,1268019310,2,27,32
38102706@N05,2902,15,1268019310,1268019340,4,27,30
38102706@N05,2902,25,1268019340,1268019368,3,27,28
38102706@N05,2902,15,1268019368,1268019728,4,27,360
38102706@N05,2902,25,1268020659,1268022312,22,27,1653
38102706@N05,2902,24,1268022312,1268023812,4,27,1500
38102706@N05,2902,25,1268024199,1268024327,3,27,128
38102706@N05,2902,22,1268024327,1268024488,2,27,161
38102706@N05,2902,24,1268024488,1268024772,3,27,284
38102706@N05,2902,20,1268024772,1268024864,2,27,92
38102706@N05,2902,12,1268024864,1268025134,2,27,270
38102706@N05,2903,18,1306212251,1306212791,1,1,540
38102706@N05,2904,18,1306305807,1306306347,2,1,540
38102706@N05,2905,16,1306369762,1306369998,6,2,236
38102706@N05,2905,17,1306369998,1306370418,5,2,420
38102706@N05,2906,7,1400732421,1400732541,2,4,120
38102706@N05,2906,24,1400735379,1400736879,2,4,1500
38102706@N05,2906,19,1400752894,1400753434,2,4,540
38102706@N05,2906,16,1400757360,1400757780,1,4,420
38116435@N00,2907,3,1283756400,1283756400,2,3,0
38116435@N00,2907,5,1283756400,1283756400,2,3,0
38116435@N00,2907,16,1283756400,1283756820,1,3,420
38116435@N00,2908,5,1284102000,1284102000,2,3,0
38116435@N00,2908,7,1284102000,1284102000,3,3,0
38116435@N00,2908,18,1284102000,1284102540,1,3,540
38116435@N00,2909,6,1287896517,1287896637,2,2,120
38116435@N00,2909,9,1287897328,1287897448,1,2,120
38116435@N00,2910,13,1299407587,1299407887,2,2,300
38116435@N00,2910,12,1299408160,1299408430,1,2,270
38116435@N00,2911,7,1305015443,1305015563,2,1,120
38116435@N00,2912,12,1310786020,1310786290,1,1,270
38116435@N00,2913,16,1317302990,1317303410,1,1,420
38116435@N00,2914,14,1339373074,1339373434,1,1,360
38117207@N03,2915,12,1340031310,1340031580,2,1,270
38117207@N03,2916,12,1340079371,1340079641,41,1,270
38231195@N04,2917,6,1360305839,1360305959,3,6,120
38231195@N04,2917,25,1360312060,1360312465,9,6,405
38231195@N04,2917,13,1360312465,1360312648,2,6,183
38231195@N04,2917,25,1360312648,1360312818,2,6,170
38231195@N04,2917,13,1360312818,1360312832,2,6,14
38231195@N04,2917,25,1360312832,1360314932,1,6,2100
38235069@N00,2918,23,1324771869,1324773069,5,5,1200
38235069@N00,2918,16,1324774860,1324775104,2,5,244
38235069@N00,2918,11,1324775104,1324775344,2,5,240
38235069@N00,2918,18,1324777156,1324777696,3,5,540
38235069@N00,2918,10,1324803183,1324803333,1,5,150
38235069@N00,2919,12,1329089979,1329090249,8,12,270
38235069@N00,2919,17,1329091961,1329092381,3,12,420
38235069@N00,2919,23,1329093037,1329094237,7,12,1200
38235069@N00,2919,18,1329095769,1329096309,3,12,540
38235069@N00,2919,10,1329097479,1329097629,3,12,150
38235069@N00,2919,18,1329097909,1329098449,2,12,540
38235069@N00,2919,7,1329098459,1329098579,3,12,120
38235069@N00,2919,18,1329099124,1329099324,3,12,200
38235069@N00,2919,7,1329099324,1329099383,2,12,59
38235069@N00,2919,18,1329099383,1329099923,13,12,540
38235069@N00,2919,25,1329102574,1329104674,4,12,2100
38235069@N00,2919,19,1329112194,1329112734,2,12,540
38235069@N00,2920,17,1329179089,1329179509,6,3,420
38235069@N00,2920,23,1329179759,1329180959,4,3,1200
38235069@N00,2920,4,1329195505,1329195595,2,3,90
38235069@N00,2921,18,1329268706,1329269246,2,1,540
38235069@N00,2922,24,1346114271,1346115061,2,11,790
38235069@N00,2922,6,1346115061,1346115181,6,11,120
38235069@N00,2922,14,1346117146,1346117506,8,11,360
38235069@N00,2922,19,1346120382,1346120922,2,11,540
38235069@N00,2922,14,1346124235,1346124595,3,11,360
38235069@N00,2922,25,1346131474,1346132340,3,11,866
38235069@N00,2922,19,1346132340,1346132722,2,11,382
38235069@N00,2922,8,1346132722,1346132842,2,11,120
38235069@N00,2922,14,1346132854,1346133214,2,11,360
38235069@N00,2922,24,1346139427,1346140927,3,11,1500
38235069@N00,2922,17,1346145971,1346146391,3,11,420
38235069@N00,2923,5,1349397604,1349397724,1,1,120
38235069@N00,2924,16,1359773091,1359773511,24,1,420
38235069@N00,2925,16,1371628410,1371628613,3,6,203
38235069@N00,2925,19,1371628613,1371629094,9,6,481
38235069@N00,2925,14,1371629094,1371629418,4,6,324
38235069@N00,2925,8,1371629418,1371629538,3,6,120
38235069@N00,2925,25,1371630107,1371630478,7,6,371
38235069@N00,2925,22,1371630478,1371631498,18,6,1020
38235069@N00,2926,6,1377408556,1377408676,3,8,120
38235069@N00,2926,17,1377422823,1377423243,7,8,420
38235069@N00,2926,16,1377423649,1377424069,2,8,420
38235069@N00,2926,3,1377428775,1377428865,19,8,90
38235069@N00,2926,1,1377429940,1377429974,6,8,34
38235069@N00,2926,3,1377429974,1377430064,4,8,90
38235069@N00,2926,16,1377430090,1377430123,2,8,33
38235069@N00,2926,3,1377430123,1377430213,2,8,90
38235069@N00,2927,7,1377478235,1377478355,4,3,120
38235069@N00,2927,1,1377498986,1377499046,2,3,60
38235069@N00,2927,3,1377510708,1377510798,1,3,90
38235069@N00,2928,19,1379233591,1379234131,1,1,540
38235069@N00,2929,17,1381019523,1381019943,18,3,420
38235069@N00,2929,22,1381027107,1381027283,2,3,176
38235069@N00,2929,24,1381027283,1381028783,1,3,1500
38235069@N00,2930,19,1387585427,1387585967,7,5,540
38235069@N00,2930,14,1387586395,1387586755,3,5,360
38235069@N00,2930,8,1387587839,1387587959,4,5,120
38235069@N00,2930,25,1387588202,1387590302,2,5,2100
38235069@N00,2930,17,1387599220,1387599640,4,5,420
38235069@N00,2931,10,1437024709,1437024831,2,4,122
38235069@N00,2931,3,1437024831,1437024921,6,4,90
38235069@N00,2931,19,1437027344,1437027884,11,4,540
38235069@N00,2931,6,1437028471,1437028591,4,4,120
38235069@N00,2932,23,1437167784,1437168984,5,1,1200
38235069@N00,2933,14,1438649281,1438649641,3,8,360
38235069@N00,2933,12,1438651019,1438651289,2,8,270
38235069@N00,2933,16,1438652959,1438653379,6,8,420
38235069@N00,2933,10,1438653426,1438653576,2,8,150
38235069@N00,2933,11,1438654123,1438654363,10,8,240
38235069@N00,2933,7,1438654449,1438654569,6,8,120
38235069@N00,2933,19,1438655067,1438655607,6,8,540
38235069@N00,2933,8,1438656427,1438656547,5,8,120
38235069@N00,2934,5,1443776036,1443776084,3,4,48
38235069@N00,2934,16,1443776084,1443776097,3,4,13
38235069@N00,2934,5,1443776097,1443776217,11,4,120
38235069@N00,2934,19,1443777431,1443777971,1,4,540
38235069@N00,2935,3,1443828145,1443828235,2,1,90
38235069@N00,2936,5,1443918053,1443918173,3,5,120
38235069@N00,2936,24,1443922145,1443923645,44,5,1500
38235069@N00,2936,20,1443925226,1443925231,4,5,5
38235069@N00,2936,24,1443925231,1443926731,7,5,1500
38235069@N00,2936,19,1443928360,1443928900,5,5,540
38235069@N00,2937,7,1448140858,1448140978,4,17,120
38235069@N00,2937,14,1448141604,1448141728,10,17,124
38235069@N00,2937,19,1448141728,1448142268,43,17,540
38235069@N00,2937,6,1448142742,1448142862,5,17,120
38235069@N00,2937,3,1448148981,1448149071,3,17,90
38235069@N00,2937,23,1448154868,1448156068,15,17,1200
38235069@N00,2937,3,1448157385,1448157475,8,17,90
38235069@N00,2937,6,1448177618,1448177738,5,17,120
38235069@N00,2937,14,1448178026,1448178386,13,17,360
38235069@N00,2937,19,1448178618,1448178770,7,17,152
38235069@N00,2937,16,1448178770,1448178770,2,17,0
38235069@N00,2937,19,1448178770,1448178771,2,17,1
38235069@N00,2937,16,1448178771,1448178772,2,17,1
38235069@N00,2937,19,1448178772,1448178778,2,17,6
38235069@N00,2937,16,1448178778,1448178780,2,17,2
38235069@N00,2937,19,1448178780,1448179031,2,17,251
38235069@N00,2937,11,1448179031,1448179271,2,17,240
38235069@N00,2938,5,1448229353,1448229473,3,8,120
38235069@N00,2938,14,1448229499,1448229587,3,8,88
38235069@N00,2938,17,1448229587,1448230007,2,8,420
38235069@N00,2938,23,1448230991,1448231501,5,8,510
38235069@N00,2938,14,1448231501,1448231530,7,8,29
38235069@N00,2938,18,1448231530,1448231549,7,8,19
38235069@N00,2938,23,1448231549,1448232749,10,8,1200
38235069@N00,2938,19,1448233950,1448234490,11,8,540
38235069@N00,2939,12,1452150240,1452150510,1,1,270
38235069@N00,2940,25,1458352255,1458354355,3,16,2100
38235069@N00,2940,14,1458359159,1458359519,11,16,360
38235069@N00,2940,19,1458360797,1458361337,3,16,540
38235069@N00,2940,7,1458364122,1458364242,6,16,120
38235069@N00,2940,23,1458365066,1458365249,4,16,183
38235069@N00,2940,16,1458365249,1458365669,2,16,420
38235069@N00,2940,23,1458366798,1458367998,3,16,1200
38235069@N00,2940,17,1458368009,1458368429,3,16,420
38235069@N00,2940,12,1458368712,1458368982,5,16,270
38235069@N00,2940,25,1458369916,1458369923,2,16,7
38235069@N00,2940,13,1458369923,1458370025,4,16,102
38235069@N00,2940,25,1458370025,1458370524,3,16,499
38235069@N00,2940,6,1458370524,1458370644,6,16,120
38235069@N00,2940,19,1458370746,1458371286,5,16,540
38235069@N00,2940,7,1458371488,1458371608,3,16,120
38235069@N00,2940,6,1458375573,1458375693,4,16,120
38235069@N00,2941,16,1460786724,1460787144,7,2,420
38235069@N00,2941,25,1460788657,1460790757,7,2,2100
38235069@N00,2942,12,1464398340,1464398610,2,4,270
38235069@N00,2942,15,1464415785,1464415887,5,4,102
38235069@N00,2942,25,1464415887,1464417987,4,4,2100
38235069@N00,2942,14,1464426513,1464426873,9,4,360
38235069@N00,2943,12,1466240576,1466240846,2,1,270
38235069@N00,2944,12,1467858658,1467858928,10,6,270
38235069@N00,2944,24,1467860905,1467862315,3,6,1410
38235069@N00,2944,12,1467862315,1467862585,3,6,270
38235069@N00,2944,3,1467874749,1467874839,2,6,90
38235069@N00,2944,8,1467884663,1467884783,5,6,120
38235069@N00,2944,6,1467888839,1467888959,2,6,120
38235069@N00,2945,14,1467927352,1467927712,5,7,360
38235069@N00,2945,8,1467928783,1467928903,6,7,120
38235069@N00,2945,7,1467930113,1467930125,3,7,12
38235069@N00,2945,18,1467930125,1467930146,2,7,21
38235069@N00,2945,7,1467930146,1467930266,3,7,120
38235069@N00,2945,18,1467931350,1467931414,4,7,64
38235069@N00,2945,7,1467931414,1467931534,4,7,120
38235069@N00,2946,24,1470545098,1470546598,4,7,1500
38235069@N00,2946,20,1470547672,1470547738,2,7,66
38235069@N00,2946,6,1470547738,1470547858,4,7,120
38235069@N00,2946,19,1470549203,1470549743,3,7,540
38235069@N00,2946,16,1470550858,1470550958,3,7,100
38235069@N00,2946,23,1470550958,1470551414,5,7,456
38235069@N00,2946,12,1470551414,1470551684,4,7,270
38376245@N04,2947,11,1260803577,1260803817,1,1,240
38376245@N04,2948,11,1314432432,1314432672,2,2,240
38376245@N04,2948,22,1314445219,1314446239,1,2,1020
38376245@N04,2949,11,1322026801,1322027041,1,1,240
38376245@N04,2950,6,1327470972,1327471092,1,1,120
38376245@N04,2951,7,1340702739,1340702859,1,1,120
38387241@N02,2952,17,1276232242,1276232662,5,15,420
38387241@N02,2952,23,1276233696,1276234806,7,15,1110
38387241@N02,2952,16,1276234806,1276235002,2,15,196
38387241@N02,2952,5,1276235002,1276235116,2,15,114
38387241@N02,2952,18,1276235116,1276235460,3,15,344
38387241@N02,2952,7,1276235460,1276235580,2,15,120
38387241@N02,2952,17,1276235884,1276236304,3,15,420
38387241@N02,2952,20,1276236496,1276237096,2,15,600
38387241@N02,2952,6,1276237486,1276237606,4,15,120
38387241@N02,2952,20,1276239266,1276239452,2,15,186
38387241@N02,2952,22,1276239452,1276239512,2,15,60
38387241@N02,2952,13,1276239512,1276239644,4,15,132
38387241@N02,2952,25,1276239644,1276239990,2,15,346
38387241@N02,2952,21,1276239990,1276240286,2,15,296
38387241@N02,2952,24,1276240286,1276241786,2,15,1500
38393814@N07,2953,17,1310521745,1310522165,1,1,420
38488038@N03,2954,13,1354327802,1354328102,1,1,300
38501353@N00,2955,19,1261878549,1261879089,6,1,540
38501353@N00,2956,19,1296888456,1296888996,6,1,540
38501353@N00,2957,19,1305451910,1305452450,15,1,540
38501353@N00,2958,19,1313664371,1313664911,4,1,540
38501353@N00,2959,19,1316857046,1316857586,1,1,540
38501353@N00,2960,19,1341656564,1341657104,2,1,540
38501353@N00,2961,19,1342736894,1342737434,22,1,540
38501353@N00,2962,19,1343215429,1343215969,14,1,540
38501353@N00,2963,19,1344561536,1344562076,16,1,540
38501353@N00,2964,19,1353136115,1353136655,13,1,540
38501353@N00,2965,19,1353189111,1353189651,3,1,540
38501353@N00,2966,19,1369899690,1369900230,4,1,540
38501353@N00,2967,19,1387006436,1387006976,1,1,540
38501353@N00,2968,19,1433555066,1433555606,2,1,540
38564198@N03,2969,23,1225508775,1225509975,1,1,1200
38662033@N08,2970,7,1318577391,1318577511,1,1,120
38662033@N08,2971,1,1327737520,1327737580,2,4,60
38662033@N08,2971,16,1327738030,1327738450,6,4,420
38662033@N08,2971,6,1327744178,1327744298,2,4,120
38662033@N08,2971,1,1327748320,1327748380,1,4,60
38664989@N06,2972,18,1246869952,1246870492,1,1,540
38730049@N08,2973,12,1188002799,1188003069,2,1,270
38730049@N08,2974,12,1188085126,1188085396,4,1,270
38730049@N08,2975,12,1188174260,1188174530,1,1,270
38730049@N08,2976,12,1188258810,1188259080,6,1,270
38730049@N08,2977,12,1197942686,1197942956,11,1,270
38730049@N08,2978,12,1198026487,1198026757,4,1,270
38730049@N08,2979,12,1198111849,1198112119,2,1,270
38730049@N08,2980,12,1219053283,1219053553,4,1,270
38730049@N08,2981,12,1219104493,1219104763,3,1,270
38730049@N08,2982,12,1219191974,1219192244,1,1,270
38730049@N08,2983,12,1219226617,1219226887,2,1,270
38730049@N08,2984,12,1219277539,1219277809,4,1,270
38730049@N08,2985,12,1230945943,1230946213,7,1,270
38730049@N08,2986,12,1231030301,1231030571,1,1,270
38730049@N08,2987,12,1231064198,1231064468,2,1,270
38730049@N08,2988,12,1231118711,1231118981,2,1,270
38730049@N08,2989,12,1253755777,1253756047,10,1,270
38730049@N08,2990,12,1253838339,1253838609,7,1,270
38730049@N08,2991,12,1254022766,1254023036,1,1,270
38730049@N08,2992,12,1254097036,1254097306,2,1,270
38730049@N08,2993,12,1260929171,1260929441,2,1,270
38730049@N08,2994,12,1261010795,1261011065,8,1,270
38730049@N08,2995,12,1281266434,1281266704,3,1,270
38730049@N08,2996,12,1281311067,1281311337,1,1,270
38730049@N08,2997,12,1281357712,1281357982,1,1,270
38730049@N08,2998,12,1281396086,1281396356,4,1,270
38730049@N08,2999,12,1281487958,1281488228,4,1,270
38730049@N08,3000,12,1281574101,1281574371,5,1,270
38730049@N08,3001,12,1286762346,1286762616,3,1,270
38730049@N08,3002,12,1286838189,1286838459,5,1,270
38730049@N08,3003,12,1286924597,1286924867,7,1,270
38730049@N08,3004,12,1287011969,1287012239,2,1,270
38730049@N08,3005,12,1287099234,1287099504,2,1,270
38730049@N08,3006,12,1292201270,1292201540,5,1,270
38730049@N08,3007,12,1292288083,1292288353,5,1,270
38730049@N08,3008,12,1292374087,1292374357,4,1,270
38730049@N08,3009,12,1292456923,1292457193,1,1,270
38730049@N08,3010,12,1302520679,1302520949,2,1,270
38730049@N08,3011,12,1302565409,1302565679,5,1,270
38730049@N08,3012,12,1302661842,1302662112,3,1,270
38730049@N08,3013,12,1302750357,1302750627,1,1,270
38730049@N08,3014,12,1307319104,1307319374,7,1,270
38730049@N08,3015,12,1307446977,1307447247,1,1,270
38730049@N08,3016,12,1319326971,1319327241,1,1,270
38730049@N08,3017,12,1323747344,1323747614,4,1,270
38730049@N08,3018,12,1323827511,1323827781,2,1,270
38730049@N08,3019,12,1323912301,1323912571,2,1,270
38730049@N08,3020,12,1338339079,1338339349,2,1,270
38730049@N08,3021,12,1338422254,1338422524,4,1,270
38730049@N08,3022,12,1345433765,1345434035,10,1,270
38730049@N08,3023,12,1345493911,1345494181,1,1,270
38730049@N08,3024,12,1345534628,1345534898,9,1,270
38730049@N08,3025,12,1345589027,1345589297,10,1,270
38730049@N08,3026,12,1345697131,1345697401,9,1,270
38730049@N08,3027,12,1349678189,1349678459,7,1,270
38730049@N08,3028,12,1349726897,1349727167,11,1,270
38730049@N08,3029,12,1349826926,1349827196,3,1,270
38730049@N08,3030,12,1349862880,1349863150,1,1,270
38730049@N08,3031,12,1355877371,1355877641,17,3,270
38730049@N08,3031,23,1355906273,1355907473,2,3,1200
38730049@N08,3031,12,1355908952,1355909222,1,3,270
38730049@N08,3032,12,1356044660,1356044930,3,1,270
38730049@N08,3033,12,1365389523,1365389793,3,1,270
38730049@N08,3034,12,1365459626,1365459896,10,1,270
38730049@N08,3035,12,1365551312,1365551582,4,1,270
38730049@N08,3036,12,1369700808,1369701078,2,1,270
38730049@N08,3037,12,1369787252,1369787522,8,1,270
38730049@N08,3038,12,1369871280,1369871550,8,1,270
38730049@N08,3039,12,1376903038,1376903308,6,1,270
38730049@N08,3040,12,1376949674,1376949944,19,1,270
38730049@N08,3041,12,1377045671,1377045941,4,1,270
38730049@N08,3042,12,1377128477,1377128747,3,1,270
38730049@N08,3043,12,1379469810,1379470080,7,1,270
38730049@N08,3044,12,1379553310,1379553580,10,1,270
38730049@N08,3045,12,1379638547,1379638817,5,1,270
38730049@N08,3046,12,1385349073,1385349343,5,1,270
38730049@N08,3047,12,1385421502,1385421772,5,1,270
38730049@N08,3048,12,1385513414,1385513684,4,1,270
38730049@N08,3049,12,1385544537,1385544807,3,1,270
38730049@N08,3050,12,1396243214,1396243484,10,1,270
38730049@N08,3051,12,1396303504,1396303774,2,1,270
38730049@N08,3052,12,1396395469,1396395739,12,1,270
38730049@N08,3053,12,1396502986,1396503256,22,1,270
38730049@N08,3054,12,1401676263,1401676533,4,1,270
38730049@N08,3055,12,1401744031,1401744301,6,1,270
38730049@N08,3056,12,1401839464,1401839734,4,1,270
38730049@N08,3057,12,1401923378,1401923648,1,1,270
38730049@N08,3058,12,1408515378,1408515648,6,1,270
38730049@N08,3059,12,1408576391,1408576661,9,1,270
38730049@N08,3060,12,1408668558,1408668828,6,1,270
38730049@N08,3061,12,1414543321,1414543591,8,1,270
38730049@N08,3062,12,1414627740,1414628010,7,1,270
38730049@N08,3063,12,1414713495,1414713765,8,1,270
38730049@N08,3064,12,1418696806,1418697076,9,1,270
38730049@N08,3065,12,1418780347,1418780617,3,1,270
38730049@N08,3066,12,1418853793,1418854063,6,1,270
38730049@N08,3067,17,1418953826,1418954246,2,1,420
38730049@N08,3068,12,1427167337,1427167607,5,1,270
38730049@N08,3069,12,1427233123,1427233393,15,1,270
38730049@N08,3070,12,1427312266,1427312536,10,1,270
38730049@N08,3071,12,1427359679,1427359949,1,1,270
38730049@N08,3072,12,1432618013,1432618283,6,1,270
38730049@N08,3073,12,1432688980,1432689250,4,1,270
38730049@N08,3074,12,1432757938,1432758208,16,1,270
38730049@N08,3075,12,1433140938,1433141208,27,1,270
38730049@N08,3076,12,1433190583,1433190853,8,1,270
38730049@N08,3077,12,1439882912,1439883182,22,1,270
38730049@N08,3078,12,1439950036,1439950306,20,1,270
38730049@N08,3079,12,1440019870,1440020140,47,1,270
38730049@N08,3080,12,1442994732,1442995002,3,1,270
38730049@N08,3081,12,1443046476,1443046746,13,1,270
38730049@N08,3082,12,1443142141,1443142411,34,1,270
38730049@N08,3083,12,1448181926,1448182196,1,1,270
38730049@N08,3084,12,1448257128,1448257398,13,1,270
38730049@N08,3085,12,1448313147,1448313417,48,1,270
38730049@N08,3086,12,1448439740,1448440010,17,1,270
38730049@N08,3087,12,1459807828,1459808098,19,1,270
38730049@N08,3088,12,1459902780,1459903050,2,1,270
38730049@N08,3089,12,1459977097,1459977367,9,1,270
38731688@N06,3090,12,1364718493,1364718763,1,1,270
38739245@N06,3091,19,1368564860,1368565400,4,1,540
38739245@N06,3092,19,1368609441,1368609981,2,1,540
38739245@N06,3093,19,1368646848,1368647388,10,1,540
38765937@N03,3094,14,1380776864,1380777224,1,1,360
38794272@N04,3095,10,1314045487,1314045637,23,1,150
39024895@N00,3096,12,1219458107,1219458377,2,6,270
39024895@N00,3096,11,1219459119,1219459146,2,6,27
39024895@N00,3096,5,1219459146,1219459160,2,6,14
39024895@N00,3096,18,1219459160,1219459266,2,6,106
39024895@N00,3096,7,1219459266,1219459386,10,6,120
39024895@N00,3096,6,1219475462,1219475582,72,6,120
39024895@N00,3097,9,1219535772,1219535892,2,5,120
39024895@N00,3097,3,1219537372,1219537462,12,5,90
39024895@N00,3097,12,1219537942,1219538014,6,5,72
39024895@N00,3097,17,1219538014,1219538434,29,5,420
39024895@N00,3097,12,1219538894,1219539164,6,5,270
39024895@N00,3098,19,1241848655,1241849195,8,1,540
39024895@N00,3099,19,1241918291,1241918831,11,1,540
39024895@N00,3100,7,1278660137,1278660257,48,8,120
39024895@N00,3100,6,1278673708,1278673828,5,8,120
39024895@N00,3100,3,1278676425,1278676510,5,8,85
39024895@N00,3100,16,1278676510,1278676636,2,8,126
39024895@N00,3100,3,1278676636,1278676726,10,8,90
39024895@N00,3100,16,1278678064,1278678484,3,8,420
39024895@N00,3100,3,1278679336,1278679426,17,8,90
39024895@N00,3100,10,1278679457,1278679607,3,8,150
39024895@N00,3101,10,1278729690,1278729840,30,1,150
39038543@N08,3102,11,1359806542,1359806782,2,1,240
39066378@N08,3103,24,1406521959,1406523459,7,1,1500
39066378@N08,3104,25,1428396163,1428398263,2,1,2100
39073297@N04,3105,8,1463260524,1463260644,1,1,120
39101963@N00,3106,12,1228819904,1228820174,1,1,270
39114360@N08,3107,19,1340832559,1340833099,1,1,540
39146060@N00,3108,17,1205562914,1205563206,4,5,292
39146060@N00,3108,23,1205563206,1205563634,2,5,428
39146060@N00,3108,19,1205563634,1205564174,13,5,540
39146060@N00,3108,6,1205564620,1205564734,2,5,114
39146060@N00,3108,24,1205564734,1205566234,1,5,1500
39146060@N00,3109,16,1209705740,1209706160,2,16,420
39146060@N00,3109,11,1209706516,1209706636,3,16,120
39146060@N00,3109,18,1209706636,1209706640,2,16,4
39146060@N00,3109,7,1209706640,1209706650,2,16,10
39146060@N00,3109,18,1209706650,1209706672,2,16,22
39146060@N00,3109,7,1209706672,1209706758,2,16,86
39146060@N00,3109,11,1209706758,1209706932,2,16,174
39146060@N00,3109,7,1209706932,1209707052,2,16,120
39146060@N00,3109,18,1209708810,1209709350,5,16,540
39146060@N00,3109,20,1209710598,1209711096,2,16,498
39146060@N00,3109,22,1209711096,1209711402,4,16,306
39146060@N00,3109,25,1209711402,1209713098,2,16,1696
39146060@N00,3109,19,1209713098,1209713638,30,16,540
39146060@N00,3109,15,1209718521,1209718881,19,16,360
39146060@N00,3109,7,1209722691,1209722811,7,16,120
39146060@N00,3109,11,1209724655,1209724895,1,16,240
39146060@N00,3110,19,1209772346,1209772886,3,1,540
39146060@N00,3111,19,1209824644,1209825184,1,1,540
39146060@N00,3112,11,1209864284,1209864314,2,7,30
39146060@N00,3112,7,1209864314,1209864314,2,7,0
39146060@N00,3112,11,1209864314,1209864554,2,7,240
39146060@N00,3112,25,1209865020,1209867120,2,7,2100
39146060@N00,3112,22,1209868508,1209869528,2,7,1020
39146060@N00,3112,19,1209870524,1209871064,13,7,540
39146060@N00,3112,1,1209899396,1209899456,21,7,60
39146060@N00,3113,6,1213277130,1213277137,2,2,7
39146060@N00,3113,7,1213277137,1213277257,14,2,120
39146060@N00,3114,12,1224191654,1224191924,1,1,270
39146060@N00,3115,6,1237505326,1237505446,3,9,120
39146060@N00,3115,16,1237506522,1237506751,2,9,229
39146060@N00,3115,5,1237506751,1237506871,2,9,120
39146060@N00,3115,18,1237506932,1237507096,3,9,164
39146060@N00,3115,11,1237507096,1237507131,2,9,35
39146060@N00,3115,5,1237507131,1237507251,2,9,120
39146060@N00,3115,16,1237507398,1237507505,4,9,107
39146060@N00,3115,11,1237507505,1237507567,2,9,62
39146060@N00,3115,16,1237507567,1237507987,4,9,420
39146060@N00,3116,16,1239586334,1239586624,2,3,290
39146060@N00,3116,18,1239586624,1239586879,9,3,255
39146060@N00,3116,10,1239586879,1239587029,1,3,150
39146060@N00,3117,19,1241170045,1241170585,25,1,540
39146060@N00,3118,16,1243576117,1243576180,2,2,63
39146060@N00,3118,11,1243576180,1243576420,3,2,240
39146060@N00,3119,6,1248234954,1248235074,9,9,120
39146060@N00,3119,18,1248239209,1248239749,4,9,540
39146060@N00,3119,16,1248241200,1248241270,2,9,70
39146060@N00,3119,19,1248241270,1248241810,3,9,540
39146060@N00,3119,17,1248244616,1248245036,5,9,420
39146060@N00,3119,19,1248260282,1248260822,9,9,540
39146060@N00,3119,12,1248262280,1248262550,5,9,270
39146060@N00,3119,24,1248263012,1248263398,3,9,386
39146060@N00,3119,12,1248263398,1248263668,4,9,270
39146060@N00,3120,25,1248590175,1248592275,3,6,2100
39146060@N00,3120,15,1248592742,1248593102,2,6,360
39146060@N00,3120,4,1248599494,1248599584,2,6,90
39146060@N00,3120,8,1248600320,1248600440,5,6,120
39146060@N00,3120,17,1248602325,1248602745,2,6,420
39146060@N00,3120,19,1248605681,1248606221,1,6,540
39146060@N00,3121,17,1251269010,1251269430,3,6,420
39146060@N00,3121,16,1251270009,1251270165,3,6,156
39146060@N00,3121,10,1251270165,1251270315,5,6,150
39146060@N00,3121,18,1251270710,1251270902,2,6,192
39146060@N00,3121,11,1251270902,1251271142,5,6,240
39146060@N00,3121,18,1251272586,1251273126,4,6,540
39146060@N00,3122,19,1253348418,1253348555,2,2,137
39146060@N00,3122,7,1253348555,1253348675,1,2,120
39146060@N00,3123,16,1253845080,1253845455,2,4,375
39146060@N00,3123,7,1253845455,1253845575,2,4,120
39146060@N00,3123,10,1253846119,1253846218,4,4,99
39146060@N00,3123,16,1253846218,1253846638,2,4,420
39146060@N00,3124,16,1255670090,1255670324,3,5,234
39146060@N00,3124,7,1255670324,1255670444,3,5,120
39146060@N00,3124,18,1255670495,1255670771,3,5,276
39146060@N00,3124,5,1255670771,1255670852,2,5,81
39146060@N00,3124,10,1255670852,1255671002,2,5,150
39146060@N00,3125,16,1255897877,1255897884,2,2,7
39146060@N00,3125,7,1255897884,1255898004,1,2,120
39146060@N00,3126,7,1256292472,1256292484,5,5,12
39146060@N00,3126,11,1256292484,1256292490,4,5,6
39146060@N00,3126,16,1256292490,1256292492,2,5,2
39146060@N00,3126,18,1256292492,1256292493,2,5,1
39146060@N00,3126,10,1256292493,1256292643,1,5,150
39146060@N00,3127,17,1258185556,1258185560,3,8,4
39146060@N00,3127,16,1258185560,1258185563,2,8,3
39146060@N00,3127,7,1258185563,1258185566,2,8,3
39146060@N00,3127,18,1258185566,1258185597,12,8,31
39146060@N00,3127,6,1258185597,1258185606,4,8,9
39146060@N00,3127,8,1258185606,1258185609,2,8,3
39146060@N00,3127,6,1258185609,1258185617,4,8,8
39146060@N00,3127,24,1258185617,1258187117,1,8,1500
39146060@N00,3128,18,1260710347,1260710887,13,1,540
39146060@N00,3129,24,1266546482,1266546488,3,7,6
39146060@N00,3129,17,1266546488,1266546494,3,7,6
39146060@N00,3129,5,1266546494,1266546501,3,7,7
39146060@N00,3129,18,1266546501,1266546503,2,7,2
39146060@N00,3129,25,1266546503,1266546507,2,7,4
39146060@N00,3129,24,1266546507,1266547894,2,7,1387
39146060@N00,3129,4,1266547894,1266547984,1,7,90
39146060@N00,3130,6,1277557361,1277557481,10,1,120
39185249@N08,3131,12,1340605097,1340605367,2,1,270
39288814@N00,3132,23,1221970360,1221971560,1,1,1200
39321572@N00,3133,17,1453565528,1453565948,1,1,420
39334252@N04,3134,17,1330760780,1330761200,2,1,420
39358979@N03,3135,11,1339561307,1339561547,1,1,240
39358979@N03,3136,1,1339828123,1339828183,1,1,60
39358979@N03,3137,16,1341372448,1341372868,1,1,420
39358979@N03,3138,7,1345720805,1345720925,1,1,120
39358979@N03,3139,16,1349514596,1349515016,1,1,420
39360988@N05,3140,17,1318543203,1318543623,2,3,420
39360988@N05,3140,18,1318555675,1318556215,2,3,540
39360988@N05,3140,3,1318558075,1318558165,1,3,90
39372984@N02,3141,19,1354314088,1354314628,1,1,540
39403274@N00,3142,12,1245193427,1245193697,1,1,270
39411347@N04,3143,25,1199317650,1199319750,1,1,2100
39438001@N00,3144,19,1223180595,1223181135,2,6,540
39438001@N00,3144,17,1223181306,1223181726,3,6,420
39438001@N00,3144,24,1223184939,1223186014,4,6,1075
39438001@N00,3144,7,1223186014,1223186134,2,6,120
39438001@N00,3144,13,1223187836,1223188136,3,6,300
39438001@N00,3144,16,1223193232,1223193652,1,6,420
39471939@N00,3145,12,1238413216,1238413453,3,9,237
39471939@N00,3145,20,1238413453,1238413653,5,9,200
39471939@N00,3145,6,1238413653,1238413773,2,9,120
39471939@N00,3145,2,1238415023,1238415083,6,9,60
39471939@N00,3145,4,1238415670,1238415760,4,9,90
39471939@N00,3145,8,1238416421,1238416541,2,9,120
39471939@N00,3145,24,1238419752,1238421252,23,9,1500
39471939@N00,3145,22,1238421945,1238422330,2,9,385
39471939@N00,3145,25,1238422330,1238424430,3,9,2100
39527581@N07,3146,14,1305086400,1305086760,1,1,360
39527581@N07,3147,14,1305117045,1305117405,1,1,360
39527581@N07,3148,14,1305164727,1305165087,2,1,360
39527581@N07,3149,14,1323176400,1323176760,6,1,360
39527581@N07,3150,14,1323326145,1323326505,1,1,360
39527581@N07,3151,14,1323390411,1323390771,1,1,360
39527581@N07,3152,14,1325336400,1325336760,1,1,360
39561617@N03,3153,15,1446110202,1446110562,4,1,360
39658619@N04,3154,19,1263513352,1263513892,2,1,540
39713096@N04,3155,19,1219057583,1219058123,1,1,540
39713096@N04,3156,18,1219139860,1219140400,2,1,540
39713096@N04,3157,19,1377295824,1377296364,7,1,540
39713096@N04,3158,19,1377596277,1377596817,12,1,540
39713096@N04,3159,19,1377684551,1377685091,4,1,540
39713096@N04,3160,19,1377739198,1377739738,3,1,540
39723283@N05,3161,7,1400384434,1400384554,2,2,120
39723283@N05,3161,16,1400412976,1400413396,1,2,420
39726265@N00,3162,19,1239953844,1239954384,1,1,540
39726265@N00,3163,12,1240109206,1240109256,3,9,50
39726265@N00,3163,24,1240109256,1240109406,3,9,150
39726265@N00,3163,12,1240109406,1240109676,2,9,270
39726265@N00,3163,24,1240109719,1240111162,6,9,1443
39726265@N00,3163,22,1240111162,1240111569,2,9,407
39726265@N00,3163,25,1240111569,1240113669,20,9,2100
39726265@N00,3163,22,1240116635,1240117655,3,9,1020
39726265@N00,3163,17,1240122080,1240122155,5,9,75
39726265@N00,3163,16,1240122155,1240122575,8,9,420
39748674@N00,3164,14,1388832321,1388832681,1,1,360
39763571@N07,3165,11,1355727021,1355727261,1,1,240
39763571@N07,3166,12,1356240031,1356240301,1,1,270
39827687@N05,3167,3,1328331213,1328331303,3,2,90
39827687@N05,3167,17,1328337282,1328337702,1,2,420
39827687@N05,3168,17,1328400810,1328401230,17,1,420
39827687@N05,3169,17,1350159151,1350159571,1,1,420
39927206@N08,3170,7,1314682157,1314682277,1,1,120
39953677@N06,3171,19,1343486672,1343487212,1,1,540
39953677@N06,3172,16,1369575759,1369576179,1,1,420
39953677@N06,3173,11,1375583712,1375583952,2,3,240
39953677@N06,3173,15,1375586773,1375587133,2,3,360
39953677@N06,3173,24,1375601515,1375603015,1,3,1500
39953677@N06,3174,24,1378462379,1378463879,1,1,1500
39953677@N06,3175,24,1382251403,1382252903,4,2,1500
39953677@N06,3175,15,1382267866,1382268226,1,2,360
39953677@N06,3176,15,1383395577,1383395937,1,1,360
39953677@N06,3177,15,1385269053,1385269413,2,2,360
39953677@N06,3177,24,1385275740,1385277240,2,2,1500
39953677@N06,3178,24,1387004090,1387005590,2,1,1500
39953677@N06,3179,24,1394334546,1394336046,2,2,1500
39953677@N06,3179,3,1394341671,1394341761,1,2,90
39962075@N07,3180,19,1319884937,1319885477,1,1,540
39980698@N02,3181,11,1292075869,1292076109,1,1,240
39980698@N02,3182,14,1354822097,1354822457,1,1,360
39980698@N02,3183,19,1386225692,1386226232,1,1,540
39980698@N02,3184,7,1386302495,1386302615,2,3,120
39980698@N02,3184,10,1386309974,1386309991,3,3,17
39980698@N02,3184,16,1386309991,1386310411,1,3,420
39980698@N02,3185,16,1392353587,1392354007,1,1,420
40086524@N03,3186,12,1470711060,1470711143,2,15,83
40086524@N03,3186,24,1470711143,1470712643,3,15,1500
40086524@N03,3186,25,1470713151,1470715251,17,15,2100
40086524@N03,3186,8,1470718454,1470718542,2,15,88
40086524@N03,3186,14,1470718542,1470718689,5,15,147
40086524@N03,3186,6,1470718689,1470718809,3,15,120
40086524@N03,3186,1,1470721095,1470721155,3,15,60
40086524@N03,3186,10,1470722724,1470722874,2,15,150
40086524@N03,3186,16,1470722950,1470723370,15,15,420
40086524@N03,3186,23,1470725788,1470726052,2,15,264
40086524@N03,3186,17,1470726052,1470726202,2,15,150
40086524@N03,3186,23,1470726202,1470727402,2,15,1200
40086524@N03,3186,8,1470727795,1470727915,7,15,120
40086524@N03,3186,24,1470728968,1470730468,28,15,1500
40086524@N03,3186,12,1470748049,1470748319,1,15,270
40089931@N00,3187,14,1408922140,1408922500,6,6,360
40089931@N00,3187,19,1408923740,1408923845,2,6,105
40089931@N00,3187,14,1408923845,1408923951,4,6,106
40089931@N00,3187,19,1408923951,1408924340,5,6,389
40089931@N00,3187,14,1408924340,1408924700,2,6,360
40089931@N00,3187,6,1408925625,1408925745,3,6,120
40089931@N00,3188,14,1408959675,1408960035,3,2,360
40089931@N00,3188,16,1408964051,1408964471,1,2,420
40144079@N00,3189,24,1267325750,1267327250,7,1,1500
40144079@N00,3190,16,1271913247,1271913667,3,1,420
40144079@N00,3191,6,1283909761,1283909881,3,1,120
40144079@N00,3192,17,1284861667,1284862087,13,1,420
40144079@N00,3193,13,1290933654,1290933954,10,5,300
40144079@N00,3193,19,1290934102,1290934168,2,5,66
40144079@N00,3193,10,1290934168,1290934193,2,5,25
40144079@N00,3193,25,1290934193,1290935144,3,5,951
40144079@N00,3193,24,1290935144,1290936644,4,5,1500
40144079@N00,3194,25,1329799722,1329801822,3,3,2100
40144079@N00,3194,24,1329803450,1329803621,4,3,171
40144079@N00,3194,22,1329803621,1329804641,7,3,1020
40160086@N05,3195,15,1356485914,1356486274,2,3,360
40160086@N05,3195,7,1356491156,1356491276,2,3,120
40160086@N05,3195,24,1356496492,1356497992,4,3,1500
40185495@N00,3196,12,1356138298,1356138568,2,3,270
40185495@N00,3196,11,1356146003,1356146243,3,3,240
40185495@N00,3196,24,1356165807,1356167307,1,3,1500
40247218@N00,3197,1,1235200876,1235200936,2,2,60
40247218@N00,3197,12,1235205375,1235205645,1,2,270
40262057@N06,3198,18,1243249159,1243249699,3,1,540
40262057@N06,3199,18,1243383694,1243384234,7,3,540
40262057@N06,3199,15,1243392298,1243392658,2,3,360
40262057@N06,3199,2,1243393007,1243393067,1,3,60
40262057@N06,3200,12,1259886853,1259887123,4,14,270
40262057@N06,3200,17,1259887242,1259887285,5,14,43
40262057@N06,3200,20,1259887285,1259887885,2,14,600
40262057@N06,3200,18,1259888105,1259888267,7,14,162
40262057@N06,3200,7,1259888267,1259888387,4,14,120
40262057@N06,3200,18,1259889770,1259890098,7,14,328
40262057@N06,3200,5,1259890098,1259890218,4,14,120
40262057@N06,3200,18,1259890803,1259890811,2,14,8
40262057@N06,3200,17,1259890811,1259890840,2,14,29
40262057@N06,3200,18,1259890840,1259890966,2,14,126
40262057@N06,3200,15,1259890966,1259891326,2,14,360
40262057@N06,3200,24,1259894548,1259895097,4,14,549
40262057@N06,3200,25,1259895097,1259895257,2,14,160
40262057@N06,3200,15,1259895257,1259895617,11,14,360
40262057@N06,3201,18,1259972556,1259973096,5,2,540
40262057@N06,3201,19,1259975242,1259975782,1,2,540
40262057@N06,3202,16,1309998035,1309998455,13,2,420
40262057@N06,3202,18,1309999450,1309999990,5,2,540
40262057@N06,3203,18,1310034632,1310035172,12,4,540
40262057@N06,3203,10,1310035892,1310036042,3,4,150
40262057@N06,3203,18,1310036092,1310036107,2,4,15
40262057@N06,3203,10,1310036107,1310036257,37,4,150
40262057@N06,3204,23,1321139501,1321139779,3,5,278
40262057@N06,3204,16,1321139779,1321140199,12,5,420
40262057@N06,3204,18,1321140909,1321141449,3,5,540
40262057@N06,3204,20,1321143524,1321144124,4,5,600
40262057@N06,3204,15,1321145347,1321145707,7,5,360
40262057@N06,3205,18,1321260531,1321261071,6,2,540
40262057@N06,3205,10,1321262485,1321262635,6,2,150
40303166@N06,3206,17,1335607413,1335607833,1,1,420
40371941@N00,3207,22,1353491284,1353492304,1,1,1020
40414712@N00,3208,17,1289000691,1289001111,2,5,420
40414712@N00,3208,24,1289018247,1289019747,2,5,1500
40414712@N00,3208,11,1289020564,1289020804,2,5,240
40414712@N00,3208,16,1289020929,1289021349,2,5,420
40414712@N00,3208,6,1289025144,1289025264,1,5,120
40414712@N00,3209,19,1315119895,1315120435,1,1,540
40414712@N00,3210,18,1315991989,1315992529,1,1,540
40432809@N05,3211,11,1213747189,1213747429,1,1,240
40432809@N05,3212,7,1256860998,1256861118,1,1,120
40563308@N02,3213,5,1197774351,1197774471,1,1,120
40563308@N02,3214,13,1245549967,1245550267,2,2,300
40563308@N02,3214,25,1245550574,1245552674,2,2,2100
40563308@N02,3215,23,1253421011,1253421787,2,4,776
40563308@N02,3215,12,1253421787,1253422057,2,4,270
40563308@N02,3215,24,1253423745,1253425245,2,4,1500
40563308@N02,3215,15,1253431639,1253431999,1,4,360
40563308@N02,3216,24,1254106795,1254108295,1,1,1500
40563308@N02,3217,17,1263692554,1263692974,2,5,420
40563308@N02,3217,23,1263693801,1263695001,3,5,1200
40563308@N02,3217,25,1263697915,1263700015,2,5,2100
40563308@N02,3217,13,1263702110,1263702110,2,5,0
40563308@N02,3217,25,1263702110,1263704210,1,5,2100
40563308@N02,3218,19,1270462881,1270463421,3,3,540
40563308@N02,3218,17,1270465882,1270466254,2,3,372
40563308@N02,3218,24,1270466254,1270467754,1,3,1500
40563308@N02,3219,5,1276834561,1276834681,1,1,120
40563308@N02,3220,16,1280022596,1280023016,2,3,420
40563308@N02,3220,24,1280029892,1280031392,2,3,1500
40563308@N02,3220,12,1280037812,1280038082,2,3,270
40563308@N02,3221,24,1288994581,1288996081,2,4,1500
40563308@N02,3221,7,1288998610,1288998730,3,4,120
40563308@N02,3221,15,1289000989,1289001349,2,4,360
40563308@N02,3221,24,1289024075,1289025575,1,4,1500
40563308@N02,3222,17,1292122125,1292122545,2,2,420
40563308@N02,3222,25,1292126800,1292128900,1,2,2100
40563308@N02,3223,23,1301789986,1301790635,2,3,649
40563308@N02,3223,16,1301790635,1301791055,2,3,420
40563308@N02,3223,19,1301791099,1301791639,2,3,540
40563308@N02,3224,7,1303197860,1303197980,11,3,120
40563308@N02,3224,10,1303202752,1303202902,2,3,150
40563308@N02,3224,17,1303203985,1303204405,1,3,420
40563308@N02,3225,7,1303348156,1303348276,3,1,120
40563308@N02,3226,25,1303377275,1303379375,1,1,2100
40563308@N02,3227,7,1308269727,1308269847,2,2,120
40563308@N02,3227,11,1308270402,1308270642,1,2,240
40563308@N02,3228,12,1374209702,1374209972,2,2,270
40563308@N02,3228,20,1374210559,1374211159,1,2,600
40563308@N02,3229,14,1379136799,1379137159,1,1,360
40579602@N00,3230,13,1195707633,1195707933,9,3,300
40579602@N00,3230,24,1195709673,1195710537,2,3,864
40579602@N00,3230,22,1195710537,1195711557,1,3,1020
40579602@N00,3231,18,1258786387,1258786927,2,1,540
40629276@N07,3232,19,1401072816,1401073356,1,1,540
40647915@N03,3233,17,1301732087,1301732507,1,1,420
40708728@N04,3234,16,1317537812,1317538004,2,5,192
40708728@N04,3234,19,1317538004,1317538544,2,5,540
40708728@N04,3234,16,1317539957,1317540377,2,5,420
40708728@N04,3234,23,1317541546,1317542746,2,5,1200
40708728@N04,3234,12,1317543821,1317544091,1,5,270
40708728@N04,3235,9,1339766782,1339766902,2,4,120
40708728@N04,3235,8,1339768374,1339768494,3,4,120
40708728@N04,3235,14,1339769643,1339770003,2,4,360
40708728@N04,3235,24,1339770341,1339771841,1,4,1500
40708728@N04,3236,25,1350806608,1350808708,1,1,2100
40708728@N04,3237,14,1353847580,1353847940,1,1,360
40708728@N04,3238,8,1359286739,1359286859,2,3,120
40708728@N04,3238,14,1359286921,1359287281,2,3,360
40708728@N04,3238,24,1359287595,1359289095,1,3,1500
40708728@N04,3239,11,1359367758,1359367998,3,2,240
40708728@N04,3239,24,1359369852,1359371352,2,2,1500
40716102@N08,3240,6,1292480385,1292480505,1,1,120
40716541@N04,3241,14,1261268074,1261268434,3,1,360
40732565660@N01,3242,12,1241170573,1241170843,2,4,270
40732565660@N01,3242,23,1241171665,1241172865,3,4,1200
40732565660@N01,3242,18,1241173284,1241173824,2,4,540
40732565660@N01,3242,23,1241174090,1241175290,9,4,1200
40732565660@N01,3243,12,1241263280,1241263550,2,4,270
40732565660@N01,3243,16,1241264652,1241265072,2,4,420
40732565660@N01,3243,7,1241266961,1241267081,3,4,120
40732565660@N01,3243,16,1241267503,1241267923,2,4,420
40732565660@N01,3244,16,1241319226,1241319646,10,14,420
40732565660@N01,3244,10,1241327179,1241327329,2,14,150
40732565660@N01,3244,16,1241327517,1241327937,12,14,420
40732565660@N01,3244,10,1241328395,1241328530,4,14,135
40732565660@N01,3244,18,1241328530,1241328566,2,14,36
40732565660@N01,3244,16,1241328566,1241328723,2,14,157
40732565660@N01,3244,18,1241328723,1241328807,7,14,84
40732565660@N01,3244,16,1241328807,1241329227,4,14,420
40732565660@N01,3244,18,1241332272,1241332812,4,14,540
40732565660@N01,3244,16,1241333852,1241334272,6,14,420
40732565660@N01,3244,7,1241335929,1241336049,4,14,120
40732565660@N01,3244,16,1241336101,1241336521,2,14,420
40732565660@N01,3244,25,1241337621,1241339721,6,14,2100
40732565660@N01,3244,22,1241342240,1241343260,2,14,1020
40805205@N08,3245,12,1250216180,1250216450,1,1,270
40813946@N06,3246,6,1342088547,1342088667,3,3,120
40813946@N06,3246,8,1342088775,1342088895,2,3,120
40813946@N06,3246,6,1342089143,1342089263,1,3,120
40814789@N04,3247,17,1274172684,1274173104,2,1,420
40814789@N04,3248,18,1304651206,1304651746,1,1,540
40868192@N07,3249,19,1248168317,1248168857,10,1,540
40868192@N07,3250,18,1248257525,1248258065,2,3,540
40868192@N07,3250,10,1248261209,1248261359,2,3,150
40868192@N07,3250,11,1248263500,1248263740,1,3,240
40868192@N07,3251,25,1248331344,1248333444,2,1,2100
40868192@N07,3252,15,1248404854,1248405214,4,2,360
40868192@N07,3252,7,1248409623,1248409743,2,2,120
40879331@N06,3253,24,1385095243,1385096743,1,1,1500
40896284@N03,3254,12,1336069982,1336070252,1,1,270
40910200@N06,3255,12,1329366186,1329366456,8,1,270
40910200@N06,3256,12,1329444813,1329445083,10,6,270
40910200@N06,3256,19,1329447443,1329447983,3,6,540
40910200@N06,3256,24,1329451999,1329453499,4,6,1500
40910200@N06,3256,12,1329457239,1329457509,4,6,270
40910200@N06,3256,5,1329460547,1329460667,3,6,120
40910200@N06,3256,12,1329461576,1329461846,20,6,270
40910200@N06,3257,12,1331522671,1331522941,2,2,270
40910200@N06,3257,6,1331525192,1331525312,2,2,120
40910200@N06,3258,7,1340252644,1340252764,2,3,120
40910200@N06,3258,24,1340253915,1340255415,2,3,1500
40910200@N06,3258,5,1340256397,1340256517,1,3,120
40910200@N06,3259,24,1340439704,1340441204,2,2,1500
40910200@N06,3259,22,1340442590,1340443610,1,2,1020
40910200@N06,3260,24,1349922065,1349923565,2,2,1500
40910200@N06,3260,9,1349927610,1349927730,1,2,120
40937461@N02,3261,15,1388092792,1388093152,2,24,360
40937461@N02,3261,9,1388094382,1388094424,2,24,42
40937461@N02,3261,8,1388094424,1388094544,4,24,120
40937461@N02,3261,19,1388094753,1388095293,5,24,540
40937461@N02,3261,14,1388095957,1388096317,5,24,360
40937461@N02,3261,24,1388102404,1388102829,7,24,425
40937461@N02,3261,20,1388102829,1388102857,2,24,28
40937461@N02,3261,24,1388102857,1388103956,5,24,1099
40937461@N02,3261,12,1388103956,1388104226,2,24,270
40937461@N02,3261,24,1388104718,1388104747,3,24,29
40937461@N02,3261,22,1388104747,1388105066,2,24,319
40937461@N02,3261,24,1388105066,1388106566,2,24,1500
40937461@N02,3261,14,1388111626,1388111986,6,24,360
40937461@N02,3261,19,1388113773,1388114313,4,24,540
40937461@N02,3261,18,1388117950,1388118490,5,24,540
40937461@N02,3261,3,1388122687,1388122777,2,24,90
40937461@N02,3261,25,1388125483,1388127583,3,24,2100
40937461@N02,3261,12,1388127911,1388128181,3,24,270
40937461@N02,3261,20,1388131982,1388132270,2,24,288
40937461@N02,3261,19,1388132270,1388132343,4,24,73
40937461@N02,3261,8,1388132343,1388132373,3,24,30
40937461@N02,3261,6,1388132373,1388132414,3,24,41
40937461@N02,3261,8,1388132414,1388132534,3,24,120
40937461@N02,3261,16,1388137345,1388137765,6,24,420
40937461@N02,3262,20,1388300922,1388301522,5,7,600
40937461@N02,3262,22,1388314356,1388314922,3,7,566
40937461@N02,3262,25,1388314922,1388315432,2,7,510
40937461@N02,3262,13,1388315432,1388315732,2,7,300
40937461@N02,3262,12,1388318224,1388318251,2,7,27
40937461@N02,3262,24,1388318251,1388319751,2,7,1500
40937461@N02,3262,12,1388319998,1388320268,1,7,270
40938484@N02,3263,14,1440808362,1440808722,1,1,360
40938484@N02,3264,23,1440838613,1440839813,1,1,1200
40979501@N04,3265,17,1268002214,1268002634,97,1,420
41013423@N03,3266,23,1274615450,1274616650,1,1,1200
41047258@N00,3267,16,1289096475,1289096895,2,1,420
41058535@N08,3268,7,1441415079,1441415199,15,1,120
41126359@N00,3269,18,1300352077,1300352617,1,1,540
41126359@N00,3270,17,1440234409,1440234829,1,1,420
41131248@N00,3271,16,1449596021,1449596045,2,3,24
41131248@N00,3271,18,1449596045,1449596051,2,3,6
41131248@N00,3271,16,1449596051,1449596471,2,3,420
41197583@N00,3272,5,1208615596,1208615716,2,3,120
41197583@N00,3272,7,1208618354,1208618474,2,3,120
41197583@N00,3272,17,1208626054,1208626474,1,3,420
41254815@N02,3273,19,1408230409,1408230949,4,1,540
41266898@N04,3274,11,1293158004,1293158244,2,3,240
41266898@N04,3274,25,1293168847,1293170947,4,3,2100
41266898@N04,3274,16,1293188302,1293188722,2,3,420
41279612@N03,3275,23,1345855416,1345856616,1,1,1200
41296706@N00,3276,11,1291383833,1291384073,1,1,240
41407408@N00,3277,24,1439548867,1439550367,1,1,1500
41453183@N05,3278,16,1351593569,1351593989,8,5,420
41453183@N05,3278,14,1351596584,1351596944,10,5,360
41453183@N05,3278,18,1351601193,1351601251,4,5,58
41453183@N05,3278,7,1351601251,1351601273,2,5,22
41453183@N05,3278,18,1351601273,1351601813,3,5,540
41453183@N05,3279,15,1351678004,1351678364,1,1,360
41453183@N05,3280,14,1351769517,1351769877,2,1,360
41453183@N05,3281,13,1351834894,1351835194,1,1,300
41453183@N05,3282,18,1351948421,1351948445,3,7,24
41453183@N05,3282,11,1351948445,1351948685,3,7,240
41453183@N05,3282,18,1351948768,1351949308,11,7,540
41453183@N05,3282,7,1351951801,1351951921,3,7,120
41453183@N05,3282,16,1351952049,1351952469,2,7,420
41453183@N05,3282,20,1351952674,1351952727,3,7,53
41453183@N05,3282,24,1351952727,1351954227,5,7,1500
41453183@N05,3283,12,1352030010,1352030280,3,4,270
41453183@N05,3283,17,1352032274,1352032694,2,4,420
41453183@N05,3283,18,1352033477,1352034017,6,4,540
41453183@N05,3283,14,1352038359,1352038719,6,4,360
41453183@N05,3284,14,1352598123,1352598483,1,1,360
41453183@N05,3285,16,1352689134,1352689554,2,5,420
41453183@N05,3285,19,1352689621,1352689636,2,5,15
41453183@N05,3285,14,1352689636,1352689996,11,5,360
41453183@N05,3285,20,1352710284,1352710884,2,5,600
41453183@N05,3285,14,1352723387,1352723747,7,5,360
41476650@N00,3286,18,1408433693,1408434233,1,1,540
41476650@N00,3287,18,1408611900,1408612440,1,1,540
41476650@N00,3288,7,1420706551,1420706671,2,2,120
41476650@N00,3288,17,1420709492,1420709912,1,2,420
41476650@N00,3289,22,1420753451,1420754471,2,1,1020
41494703@N06,3290,14,1409481022,1409481382,3,2,360
41494703@N06,3290,19,1409481554,1409482094,2,2,540
41494703@N06,3291,24,1409785400,1409786900,1,1,1500
41540189@N05,3292,25,1334475740,1334477840,2,1,2100
41548074@N04,3293,18,1392866114,1392866654,1,1,540
41548074@N04,3294,8,1393138263,1393138383,1,1,120
41556385@N06,3295,18,1257385795,1257386335,1,1,540
41556385@N06,3296,4,1306129800,1306129890,2,3,90
41556385@N06,3296,25,1306136731,1306136789,3,3,58
41556385@N06,3296,22,1306136789,1306137809,1,3,1020
41564535@N00,3297,7,1276414244,1276414364,2,1,120
41623624@N05,3298,15,1305955082,1305955442,1,1,360
41689633@N00,3299,7,1214467530,1214467650,1,1,120
41848523@N00,3300,16,1307232359,1307232779,2,2,420
41848523@N00,3300,15,1307240241,1307240601,2,2,360
41848523@N00,3301,16,1307430986,1307431406,1,1,420
41894174086@N01,3302,17,1227399673,1227400093,3,6,420
41894174086@N01,3302,12,1227401869,1227402139,2,6,270
41894174086@N01,3302,11,1227406997,1227407237,2,6,240
41894174086@N01,3302,17,1227414110,1227414530,3,6,420
41894174086@N01,3302,12,1227415122,1227415392,2,6,270
41894174086@N01,3302,15,1227419733,1227420093,3,6,360
41894174086@N01,3303,12,1227571950,1227572220,2,8,270
41894174086@N01,3303,7,1227573749,1227573869,2,8,120
41894174086@N01,3303,11,1227577310,1227577550,2,8,240
41894174086@N01,3303,13,1227580996,1227581296,2,8,300
41894174086@N01,3303,24,1227582216,1227582689,4,8,473
41894174086@N01,3303,6,1227582689,1227582746,2,8,57
41894174086@N01,3303,19,1227582746,1227583286,2,8,540
41894174086@N01,3303,11,1227583594,1227583834,2,8,240
41967511@N00,3304,4,1233248977,1233249067,2,2,90
41967511@N00,3304,3,1233249439,1233249529,2,2,90
41996875@N05,3305,22,1407375166,1407376043,8,19,877
41996875@N05,3305,2,1407376043,1407376103,9,19,60
41996875@N05,3305,9,1407377577,1407377697,4,19,120
41996875@N05,3305,8,1407378311,1407378431,3,19,120
41996875@N05,3305,25,1407380140,1407380161,2,19,21
41996875@N05,3305,13,1407380161,1407380461,2,19,300
41996875@N05,3305,2,1407380794,1407380854,2,19,60
41996875@N05,3305,15,1407381836,1407382033,3,19,197
41996875@N05,3305,25,1407382033,1407382535,3,19,502
41996875@N05,3305,19,1407382535,1407383063,5,19,528
41996875@N05,3305,16,1407383063,1407383220,2,19,157
41996875@N05,3305,23,1407383220,1407384420,3,19,1200
41996875@N05,3305,14,1407387901,1407388261,6,19,360
41996875@N05,3305,6,1407393875,1407393995,2,19,120
41996875@N05,3305,11,1407396821,1407397061,4,19,240
41996875@N05,3305,17,1407399486,1407399906,3,19,420
41996875@N05,3305,13,1407402456,1407402756,9,19,300
41996875@N05,3305,6,1407403714,1407403834,6,19,120
41996875@N05,3305,25,1407404516,1407406616,3,19,2100
42118699@N08,3306,7,1219548404,1219548524,2,2,120
42118699@N08,3306,16,1219572134,1219572554,1,2,420
42118699@N08,3307,22,1219623628,1219624648,2,1,1020
42118699@N08,3308,7,1226898787,1226898907,1,1,120
42118699@N08,3309,23,1241673277,1241674477,1,1,1200
42118699@N08,3310,23,1257668314,1257669514,2,2,1200
42118699@N08,3310,16,1257671360,1257671780,1,2,420
42118699@N08,3311,12,1271153611,1271153881,2,1,270
42118699@N08,3312,24,1282486040,1282487540,1,1,1500
42118699@N08,3313,16,1311759259,1311759679,2,2,420
42118699@N08,3313,13,1311763788,1311764088,9,2,300
42118699@N08,3314,7,1311834160,1311834280,2,2,120
42118699@N08,3314,18,1311835165,1311835705,5,2,540
42118699@N08,3315,14,1339228615,1339228975,20,3,360
42118699@N08,3315,9,1339249174,1339249294,2,3,120
42118699@N08,3315,24,1339249618,1339251118,1,3,1500
42118699@N08,3316,13,1340535539,1340535839,2,2,300
42118699@N08,3316,14,1340537954,1340538314,1,2,360
42118699@N08,3317,16,1340590223,1340590643,2,5,420
42118699@N08,3317,12,1340590982,1340591252,2,5,270
42118699@N08,3317,14,1340613103,1340613463,3,5,360
42118699@N08,3317,6,1340619510,1340619630,2,5,120
42118699@N08,3317,14,1340627043,1340627403,3,5,360
42118699@N08,3318,14,1358043831,1358044191,2,4,360
42118699@N08,3318,17,1358045597,1358045927,2,4,330
42118699@N08,3318,23,1358045927,1358047127,2,4,1200
42118699@N08,3318,17,1358049280,1358049700,1,4,420
42118699@N08,3319,23,1358217565,1358218765,3,2,1200
42118699@N08,3319,14,1358240693,1358241053,1,2,360
42118699@N08,3320,14,1362311053,1362311413,4,1,360
42118699@N08,3321,20,1372223531,1372224131,1,1,600
42118699@N08,3322,22,1375492616,1375493636,2,3,1020
42118699@N08,3322,2,1375495415,1375495475,2,3,60
42118699@N08,3322,14,1375521915,1375522275,2,3,360
42118699@N08,3323,20,1379292961,1379293561,2,2,600
42118699@N08,3323,24,1379315372,1379316872,1,2,1500
42118699@N08,3324,20,1379467018,1379467618,1,1,600
42118699@N08,3325,14,1379500009,1379500369,2,2,360
42118699@N08,3325,6,1379500617,1379500737,1,2,120
42118699@N08,3326,24,1379585876,1379587376,2,2,1500
42118699@N08,3326,16,1379588933,1379589353,1,2,420
42118699@N08,3327,16,1460097130,1460097550,2,2,420
42118699@N08,3327,6,1460110569,1460110689,2,2,120
42141778@N07,3328,18,1410315540,1410316080,1,1,540
42161381@N00,3329,12,1276219455,1276219725,13,1,270
42185804@N02,3330,18,1257324493,1257325033,1,1,540
42205475@N00,3331,22,1188182601,1188183621,2,2,1020
42205475@N00,3331,24,1188184051,1188185551,11,2,1500
42299049@N06,3332,20,1261034408,1261035008,1,1,600
42299049@N06,3333,20,1276505599,1276506199,1,1,600
42299049@N06,3334,20,1293189491,1293190091,1,1,600
42299049@N06,3335,13,1339367858,1339368158,6,1,300
42300125@N03,3336,15,1363303687,1363303952,2,2,265
42300125@N03,3336,25,1363303952,1363306052,1,2,2100
42388593@N04,3337,6,1202534956,1202535076,4,1,120
42429171@N07,3338,18,1227757443,1227757660,2,2,217
42429171@N07,3338,5,1227757660,1227757780,1,2,120
42429171@N07,3339,5,1238295561,1238295681,3,2,120
42429171@N07,3339,6,1238313514,1238313634,1,2,120
42429171@N07,3340,11,1255249306,1255249546,2,1,240
42468795@N05,3341,24,1239447851,1239449351,1,1,1500
42504117@N06,3342,13,1269284279,1269284579,1,1,300
42504117@N06,3343,13,1270460692,1270460992,1,1,300
42504117@N06,3344,18,1278915076,1278915616,4,1,540
42504117@N06,3345,18,1282871303,1282871843,1,1,540
42504117@N06,3346,13,1284047302,1284047602,1,1,300
42504117@N06,3347,18,1284206697,1284207237,4,1,540
42504117@N06,3348,13,1326606986,1326607286,1,1,300
42504117@N06,3349,2,1405841040,1405841041,2,5,1
42504117@N06,3349,24,1405841041,1405841043,3,5,2
42504117@N06,3349,2,1405841043,1405841057,2,5,14
42504117@N06,3349,24,1405841057,1405841061,2,5,4
42504117@N06,3349,2,1405841061,1405841121,1,5,60
42504117@N06,3350,2,1408511821,1408511821,2,2,0
42504117@N06,3350,12,1408511821,1408512091,1,2,270
42504117@N06,3351,23,1443487378,1443488578,1,1,1200
42504117@N06,3352,25,1461021172,1461023272,2,4,2100
42504117@N06,3352,17,1461025295,1461025715,2,4,420
42504117@N06,3352,25,1461052472,1461054572,2,4,2100
42504117@N06,3352,10,1461060950,1461061100,62,4,150
42504117@N06,3353,25,1461113357,1461115457,27,2,2100
42504117@N06,3353,15,1461145079,1461145439,1,2,360
42533701@N00,3354,12,1361428421,1361428691,1,1,270
42652739@N06,3355,16,1293104367,1293104787,1,1,420
42723681@N08,3356,18,1388197119,1388197659,1,1,540
42837274@N07,3357,14,1394671977,1394672337,2,6,360
42837274@N07,3357,6,1394675891,1394676011,3,6,120
42837274@N07,3357,4,1394678361,1394678451,2,6,90
42837274@N07,3357,19,1394680358,1394680898,2,6,540
42837274@N07,3357,5,1394684353,1394684473,2,6,120
42837274@N07,3357,11,1394685948,1394686188,2,6,240
42912996@N00,3358,18,1317356420,1317356960,1,1,540
42912996@N00,3359,10,1328845611,1328845761,2,2,150
42912996@N00,3359,18,1328848751,1328849291,1,2,540
42912996@N00,3360,19,1332033002,1332033542,1,1,540
42912996@N00,3361,15,1336263634,1336263994,2,3,360
42912996@N00,3361,11,1336265436,1336265676,2,3,240
42912996@N00,3361,16,1336267324,1336267744,1,3,420
42912996@N00,3362,14,1339882628,1339882988,3,2,360
42912996@N00,3362,24,1339890309,1339891809,2,2,1500
42912996@N00,3363,12,1349048733,1349049003,2,8,270
42912996@N00,3363,14,1349051342,1349051702,3,8,360
42912996@N00,3363,15,1349062235,1349062595,2,8,360
42912996@N00,3363,12,1349063167,1349063437,3,8,270
42912996@N00,3363,22,1349071903,1349072923,2,8,1020
42912996@N00,3363,12,1349073762,1349074032,2,8,270
42912996@N00,3363,24,1349074923,1349076423,2,8,1500
42912996@N00,3363,16,1349090197,1349090617,1,8,420
42912996@N00,3364,12,1349137847,1349138117,2,2,270
42912996@N00,3364,6,1349151042,1349151162,1,2,120
42912996@N00,3365,12,1355032443,1355032713,2,2,270
42912996@N00,3365,14,1355035202,1355035562,1,2,360
42912996@N00,3366,14,1359073644,1359074004,2,5,360
42912996@N00,3366,16,1359075086,1359075274,2,5,188
42912996@N00,3366,6,1359075274,1359075394,2,5,120
42912996@N00,3366,10,1359076555,1359076705,2,5,150
42912996@N00,3366,12,1359083842,1359084112,2,5,270
42912996@N00,3367,12,1359233942,1359234212,3,2,270
42912996@N00,3367,14,1359246011,1359246371,1,2,360
42912996@N00,3368,16,1368591082,1368591502,2,2,420
42912996@N00,3368,12,1368597941,1368598211,1,2,270
42912996@N00,3369,24,1370155343,1370156644,2,2,1301
42912996@N00,3369,16,1370156644,1370157064,1,2,420
42912996@N00,3370,24,1371967311,1371968811,1,1,1500
42912996@N00,3371,14,1378035355,1378035715,1,1,360
42912996@N00,3372,16,1381395020,1381395440,1,1,420
42912996@N00,3373,19,1385255417,1385255957,1,1,540
42928631@N00,3374,24,1258076333,1258077833,1,1,1500
42985936@N08,3375,17,1422260350,1422260770,4,1,420
43017856@N00,3376,24,1350776649,1350778149,2,4,1500
43017856@N00,3376,23,1350783145,1350784345,2,4,1200
43017856@N00,3376,10,1350791025,1350791175,3,4,150
43017856@N00,3376,14,1350793441,1350793801,1,4,360
43031491@N00,3377,24,1296779254,1296780754,8,1,1500
43082306@N00,3378,12,1279247611,1279247881,2,3,270
43082306@N00,3378,18,1279249800,1279250340,2,3,540
43082306@N00,3378,13,1279253899,1279254199,1,3,300
43082306@N00,3379,25,1311147971,1311150071,1,1,2100
43082306@N00,3380,16,1311316108,1311316528,1,1,420
43082306@N00,3381,16,1346048770,1346049190,2,1,420
43082306@N00,3382,23,1346392792,1346393992,2,3,1200
43082306@N00,3382,14,1346410964,1346411324,2,3,360
43082306@N00,3382,19,1346434114,1346434654,1,3,540
43082306@N00,3383,19,1379775978,1379776518,1,1,540
43108539@N03,3384,18,1305008315,1305008855,1,1,540
43157990@N00,3385,11,1337387753,1337387993,1,1,240
43171170@N06,3386,17,1293591894,1293592314,2,2,420
43171170@N06,3386,1,1293609843,1293609903,1,2,60
43195725@N00,3387,12,1296292489,1296292759,1,1,270
43195725@N00,3388,7,1300406859,1300406979,2,8,120
43195725@N00,3388,18,1300407631,1300408171,2,8,540
43195725@N00,3388,23,1300408183,1300409383,2,8,1200
43195725@N00,3388,11,1300423567,1300423807,2,8,240
43195725@N00,3388,25,1300427070,1300429170,2,8,2100
43195725@N00,3388,19,1300434012,1300434552,2,8,540
43195725@N00,3388,24,1300441558,1300442366,2,8,808
43195725@N00,3388,13,1300442366,1300442666,1,8,300
43195725@N00,3389,16,1312591030,1312591450,3,2,420
43195725@N00,3389,10,1312591929,1312592079,1,2,150
43195725@N00,3390,22,1312629149,1312630169,2,2,1020
43195725@N00,3390,24,1312631281,1312632781,1,2,1500
43195725@N00,3391,17,1323312341,1323312761,3,3,420
43195725@N00,3391,16,1323317900,1323318320,3,3,420
43195725@N00,3391,15,1323319009,1323319369,2,3,360
43195725@N00,3392,15,1351206224,1351206584,1,1,360
43195725@N00,3393,15,1351241178,1351241538,2,2,360
43195725@N00,3393,10,1351251825,1351251975,2,2,150
43195725@N00,3394,20,1351285035,1351285635,2,2,600
43195725@N00,3394,14,1351289115,1351289475,1,2,360
43195725@N00,3395,19,1351334468,1351335008,1,1,540
43195725@N00,3396,20,1351390166,1351390766,3,2,600
43195725@N00,3396,19,1351394580,1351395120,2,2,540
43195725@N00,3397,8,1367053516,1367053636,1,1,120
43195725@N00,3398,19,1367140066,1367140606,2,3,540
43195725@N00,3398,14,1367142434,1367142794,2,3,360
43195725@N00,3398,8,1367143171,1367143291,1,3,120
43195725@N00,3399,14,1367230102,1367230462,1,1,360
43195725@N00,3400,7,1367319893,1367320013,2,2,120
43195725@N00,3400,10,1367323208,1367323358,1,2,150
43195725@N00,3401,15,1373690363,1373690723,2,4,360
43195725@N00,3401,12,1373698414,1373698684,2,4,270
43195725@N00,3401,8,1373710086,1373710206,2,4,120
43195725@N00,3401,19,1373711600,1373712140,2,4,540
43195725@N00,3402,20,1373759797,1373760397,2,2,600
43195725@N00,3402,19,1373764222,1373764762,1,2,540
43195725@N00,3403,4,1373845863,1373845953,1,1,90
43195725@N00,3404,19,1380413536,1380414076,1,1,540
43195725@N00,3405,15,1380518016,1380518376,3,4,360
43195725@N00,3405,12,1380530692,1380530962,2,4,270
43195725@N00,3405,14,1380531468,1380531828,2,4,360
43195725@N00,3405,8,1380532427,1380532547,1,4,120
43195725@N00,3406,22,1380582562,1380583582,1,1,1020
43195725@N00,3407,19,1414150320,1414150860,3,1,540
43195725@N00,3408,24,1414183352,1414184852,2,3,1500
43195725@N00,3408,12,1414185665,1414185935,2,3,270
43195725@N00,3408,14,1414199441,1414199801,1,3,360
43195725@N00,3409,19,1417727232,1417727772,1,1,540
43195725@N00,3410,14,1417863697,1417864057,1,1,360
43195725@N00,3411,16,1429999911,1430000331,1,1,420
43195725@N00,3412,14,1430041334,1430041694,1,1,360
43195725@N00,3413,23,1440450987,1440450992,2,2,5
43195725@N00,3413,8,1440450992,1440451112,1,2,120
43195725@N00,3414,19,1440666328,1440666868,1,1,540
43195725@N00,3415,14,1441266180,1441266540,1,1,360
43207034@N06,3416,16,1441012878,1441013298,1,1,420
43209364@N00,3417,13,1296347445,1296347745,1,1,300
43232455@N07,3418,11,1424398182,1424398422,2,4,240
43232455@N07,3418,16,1424398769,1424399189,2,4,420
43232455@N07,3418,13,1424421078,1424421378,3,4,300
43232455@N07,3418,16,1424424606,1424425026,2,4,420
43232455@N07,3419,10,1425511073,1425511223,3,4,150
43232455@N07,3419,15,1425513180,1425513540,2,4,360
43232455@N07,3419,18,1425518662,1425519202,2,4,540
43232455@N07,3419,14,1425522978,1425523338,2,4,360
43232455@N07,3420,7,1426720267,1426720387,2,3,120
43232455@N07,3420,15,1426729304,1426729664,5,3,360
43232455@N07,3420,2,1426731068,1426731128,1,3,60
43246079@N05,3421,19,1338105417,1338105957,2,2,540
43246079@N05,3421,25,1338112933,1338115033,1,2,2100
43246079@N05,3422,19,1342243784,1342244324,4,4,540
43246079@N05,3422,12,1342244544,1342244814,7,4,270
43246079@N05,3422,24,1342264382,1342265882,2,4,1500
43246079@N05,3422,13,1342267828,1342268128,1,4,300
43246079@N05,3423,24,1350706960,1350708460,3,9,1500
43246079@N05,3423,7,1350715281,1350715401,2,9,120
43246079@N05,3423,19,1350716075,1350716615,2,9,540
43246079@N05,3423,13,1350720842,1350721142,7,9,300
43246079@N05,3423,25,1350725311,1350725313,2,9,2
43246079@N05,3423,13,1350725313,1350725613,31,9,300
43246079@N05,3423,22,1350730813,1350731132,2,9,319
43246079@N05,3423,13,1350731132,1350731432,7,9,300
43246079@N05,3423,22,1350731518,1350732538,4,9,1020
43246079@N05,3424,24,1360392235,1360393735,5,7,1500
43246079@N05,3424,25,1360395763,1360395767,2,7,4
43246079@N05,3424,13,1360395767,1360396067,7,7,300
43246079@N05,3424,25,1360399078,1360399080,2,7,2
43246079@N05,3424,13,1360399080,1360399380,9,7,300
43246079@N05,3424,25,1360402102,1360402140,2,7,38
43246079@N05,3424,13,1360402140,1360402440,4,7,300
43246079@N05,3425,20,1371273046,1371273646,4,17,600
43246079@N05,3425,24,1371274406,1371274432,2,17,26
43246079@N05,3425,20,1371274432,1371275032,2,17,600
43246079@N05,3425,14,1371278605,1371278965,2,17,360
43246079@N05,3425,7,1371282176,1371282296,4,17,120
43246079@N05,3425,18,1371282541,1371283081,4,17,540
43246079@N05,3425,24,1371289317,1371290817,3,17,1500
43246079@N05,3425,13,1371292425,1371292725,2,17,300
43246079@N05,3425,25,1371292808,1371294908,3,17,2100
43246079@N05,3425,13,1371294969,1371295269,3,17,300
43246079@N05,3425,25,1371295624,1371295645,2,17,21
43246079@N05,3425,13,1371295645,1371295945,3,17,300
43246079@N05,3425,25,1371297256,1371297675,3,17,419
43246079@N05,3425,13,1371297675,1371297975,4,17,300
43246079@N05,3425,16,1371300426,1371300846,5,17,420
43246079@N05,3425,17,1371301145,1371301565,6,17,420
43246079@N05,3425,12,1371302906,1371303176,6,17,270
43246079@N05,3426,12,1377176346,1377176616,1,1,270
43246079@N05,3427,24,1386996624,1386998124,2,7,1500
43246079@N05,3427,25,1387014752,1387014944,2,7,192
43246079@N05,3427,13,1387014944,1387015244,4,7,300
43246079@N05,3427,25,1387016854,1387016917,2,7,63
43246079@N05,3427,13,1387016917,1387017217,12,7,300
43246079@N05,3427,24,1387022954,1387023307,2,7,353
43246079@N05,3427,12,1387023307,1387023577,1,7,270
43246079@N05,3428,24,1401775373,1401776873,1,1,1500
43246079@N05,3429,22,1412838483,1412839503,1,1,1020
43246079@N05,3430,11,1413358050,1413358290,7,1,240
43246079@N05,3431,11,1417155654,1417155829,4,2,175
43246079@N05,3431,16,1417155829,1417156249,3,2,420
43246079@N05,3432,17,1423629645,1423630065,2,2,420
43246079@N05,3432,12,1423632634,1423632904,1,2,270
43316227@N00,3433,18,1367042642,1367043182,2,2,540
43316227@N00,3433,14,1367049932,1367050292,1,2,360
43317782@N00,3434,16,1238109841,1238110261,2,9,420
43317782@N00,3434,7,1238111144,1238111264,2,9,120
43317782@N00,3434,1,1238114860,1238114920,2,9,60
43317782@N00,3434,24,1238117096,1238117644,2,9,548
43317782@N00,3434,15,1238117644,1238118004,8,9,360
43317782@N00,3434,25,1238118841,1238120941,2,9,2100
43317782@N00,3434,12,1238136593,1238136863,2,9,270
43317782@N00,3434,24,1238143392,1238144892,2,9,1500
43317782@N00,3434,12,1238147262,1238147532,1,9,270
43317782@N00,3435,12,1264814180,1264814450,2,23,270
43317782@N00,3435,17,1264817586,1264818006,3,23,420
43317782@N00,3435,11,1264819184,1264819193,2,23,9
43317782@N00,3435,18,1264819193,1264819238,4,23,45
43317782@N00,3435,7,1264819238,1264819249,3,23,11
43317782@N00,3435,18,1264819249,1264819789,2,23,540
43317782@N00,3435,7,1264819833,1264819953,2,23,120
43317782@N00,3435,5,1264820605,1264820725,7,23,120
43317782@N00,3435,23,1264821132,1264822332,2,23,1200
43317782@N00,3435,25,1264823683,1264824665,2,23,982
43317782@N00,3435,3,1264824665,1264824755,4,23,90
43317782@N00,3435,11,1264825197,1264825437,2,23,240
43317782@N00,3435,24,1264825636,1264826662,2,23,1026
43317782@N00,3435,15,1264826662,1264827022,2,23,360
43317782@N00,3435,25,1264832113,1264833014,4,23,901
43317782@N00,3435,24,1264833014,1264833060,2,23,46
43317782@N00,3435,20,1264833060,1264833510,2,23,450
43317782@N00,3435,16,1264833510,1264833778,4,23,268
43317782@N00,3435,18,1264833778,1264834318,5,23,540
43317782@N00,3435,11,1264835116,1264835302,2,23,186
43317782@N00,3435,16,1264835302,1264835721,2,23,419
43317782@N00,3435,24,1264835721,1264837221,2,23,1500
43317782@N00,3435,12,1264843352,1264843622,1,23,270
43317782@N00,3436,16,1291429449,1291429869,2,7,420
43317782@N00,3436,11,1291429984,1291430224,5,7,240
43317782@N00,3436,18,1291431792,1291432332,2,7,540
43317782@N00,3436,10,1291434591,1291434741,2,7,150
43317782@N00,3436,11,1291436065,1291436169,2,7,104
43317782@N00,3436,16,1291436169,1291436589,2,7,420
43317782@N00,3436,24,1291438223,1291439723,1,7,1500
43317782@N00,3437,14,1348878572,1348878932,1,1,360
43323231@N00,3438,11,1317441361,1317441601,1,1,240
43337914@N00,3439,25,1438381847,1438383947,2,1,2100
43425779@N04,3440,10,1323758175,1323758325,1,1,150
43433634@N05,3441,5,1355353006,1355353126,2,6,120
43433634@N05,3441,18,1355357700,1355357751,2,6,51
43433634@N05,3441,7,1355357751,1355357809,2,6,58
43433634@N05,3441,14,1355357809,1355357817,2,6,8
43433634@N05,3441,11,1355357817,1355358057,2,6,240
43433634@N05,3441,14,1355358875,1355359235,1,6,360
43477272@N00,3442,5,1319592478,1319592598,4,7,120
43477272@N00,3442,19,1319596713,1319597021,2,7,308
43477272@N00,3442,4,1319597021,1319597111,2,7,90
43477272@N00,3442,25,1319608034,1319610134,2,7,2100
43477272@N00,3442,4,1319610424,1319610439,2,7,15
43477272@N00,3442,15,1319610439,1319610799,2,7,360
43477272@N00,3442,16,1319610890,1319611310,1,7,420
43494963@N03,3443,12,1351553271,1351553413,3,3,142
43494963@N03,3443,20,1351553413,1351553459,2,3,46
43494963@N03,3443,22,1351553459,1351554479,2,3,1020
43494963@N03,3444,24,1451390950,1451391097,3,3,147
43494963@N03,3444,22,1451391097,1451391143,3,3,46
43494963@N03,3444,25,1451391143,1451393243,3,3,2100
43535605@N00,3445,12,1310796432,1310796702,3,2,270
43535605@N00,3445,15,1310798142,1310798502,1,2,360
43535605@N00,3446,25,1315717843,1315719943,3,1,2100
43535605@N00,3447,19,1335772853,1335773393,1,1,540
43554368@N08,3448,25,1254503002,1254505102,2,6,2100
43554368@N08,3448,22,1254510142,1254511162,2,6,1020
43554368@N08,3448,11,1254512507,1254512747,2,6,240
43554368@N08,3448,18,1254513707,1254514247,2,6,540
43554368@N08,3448,12,1254517855,1254518125,2,6,270
43554368@N08,3448,24,1254521598,1254523098,2,6,1500
43579472@N00,3449,12,1195877768,1195877783,3,3,15
43579472@N00,3449,20,1195877783,1195877801,3,3,18
43579472@N00,3449,16,1195877801,1195878221,1,3,420
43590398@N04,3450,24,1393140083,1393141583,1,1,1500
43597978@N00,3451,12,1214882656,1214882926,2,2,270
43597978@N00,3451,22,1214898760,1214899780,1,2,1020
43671132108@N01,3452,24,1370186739,1370188239,2,1,1500
43671228@N00,3453,3,1282670657,1282670747,1,1,90
43671228@N00,3454,12,1282742438,1282742708,2,1,270
43675529@N00,3455,18,1284113755,1284114295,2,2,540
43675529@N00,3455,16,1284129192,1284129612,4,2,420
43675529@N00,3456,14,1378254669,1378255029,3,5,360
43675529@N00,3456,7,1378280333,1378280453,2,5,120
43675529@N00,3456,16,1378287254,1378287674,2,5,420
43675529@N00,3456,18,1378294482,1378295022,2,5,540
43675529@N00,3456,16,1378301779,1378302199,2,5,420
43679955@N05,3457,12,1266290636,1266290678,2,13,42
43679955@N05,3457,24,1266290678,1266290680,2,13,2
43679955@N05,3457,12,1266290680,1266290950,7,13,270
43679955@N05,3457,17,1266292453,1266292724,2,13,271
43679955@N05,3457,12,1266292724,1266292994,2,13,270
43679955@N05,3457,18,1266293073,1266293164,3,13,91
43679955@N05,3457,7,1266293164,1266293284,2,13,120
43679955@N05,3457,11,1266293346,1266293586,2,13,240
43679955@N05,3457,20,1266293928,1266294035,2,13,107
43679955@N05,3457,22,1266294035,1266295055,5,13,1020
43679955@N05,3457,13,1266296264,1266296564,4,13,300
43679955@N05,3457,22,1266296658,1266296767,2,13,109
43679955@N05,3457,24,1266296767,1266298267,2,13,1500
43725348@N00,3458,17,1329537398,1329537818,4,5,420
43725348@N00,3458,23,1329538140,1329539340,6,5,1200
43725348@N00,3458,16,1329539391,1329539811,6,5,420
43725348@N00,3458,7,1329540783,1329540903,5,5,120
43725348@N00,3458,17,1329543406,1329543826,5,5,420
43725348@N00,3459,24,1339215759,1339215799,3,3,40
43725348@N00,3459,12,1339215799,1339216069,2,3,270
43725348@N00,3459,18,1339220033,1339220573,2,3,540
43725348@N00,3460,6,1340519428,1340519548,2,6,120
43725348@N00,3460,19,1340519866,1340520406,17,6,540
43725348@N00,3460,18,1340527199,1340527739,4,6,540
43725348@N00,3460,16,1340528307,1340528727,6,6,420
43725348@N00,3460,19,1340529873,1340530413,6,6,540
43725348@N00,3460,6,1340533611,1340533731,1,6,120
43725348@N00,3461,19,1341108088,1341108628,4,10,540
43725348@N00,3461,6,1341109014,1341109134,2,10,120
43725348@N00,3461,19,1341109404,1341109944,3,10,540
43725348@N00,3461,16,1341110171,1341110591,5,10,420
43725348@N00,3461,1,1341115471,1341115531,2,10,60
43725348@N00,3461,10,1341115597,1341115747,5,10,150
43725348@N00,3461,16,1341116474,1341116576,4,10,102
43725348@N00,3461,10,1341116576,1341116726,7,10,150
43725348@N00,3461,6,1341120007,1341120127,4,10,120
43725348@N00,3461,24,1341120355,1341121855,3,10,1500
43725348@N00,3462,19,1343423021,1343423561,8,5,540
43725348@N00,3462,20,1343434398,1343434998,2,5,600
43725348@N00,3462,12,1343435763,1343436033,3,5,270
43725348@N00,3462,25,1343436595,1343436660,2,5,65
43725348@N00,3462,24,1343436660,1343438160,1,5,1500
43725348@N00,3463,24,1345185399,1345186899,4,2,1500
43725348@N00,3463,19,1345195083,1345195623,2,2,540
43725348@N00,3464,18,1346746089,1346746629,24,3,540
43725348@N00,3464,16,1346750669,1346751089,7,3,420
43725348@N00,3464,10,1346752600,1346752750,5,3,150
43725348@N00,3465,6,1357865970,1357866090,1,1,120
43725348@N00,3466,16,1362989689,1362990109,2,3,420
43725348@N00,3466,19,1362990431,1362990971,2,3,540
43725348@N00,3466,8,1362992971,1362993091,3,3,120
43824287@N02,3467,7,1358476537,1358476657,1,1,120
43824287@N02,3468,5,1360836203,1360836323,1,1,120
43824287@N02,3469,19,1365835474,1365836014,1,1,540
43824287@N02,3470,24,1387180510,1387182010,1,1,1500
43825182@N00,3471,11,1304478470,1304478710,3,1,240
43825182@N00,3472,7,1306299769,1306299889,2,1,120
43825182@N00,3473,7,1307430759,1307430879,3,1,120
43825182@N00,3474,11,1328788294,1328788534,3,3,240
43825182@N00,3474,7,1328791454,1328791574,2,3,120
43825182@N00,3474,25,1328796877,1328798977,1,3,2100
43826697@N08,3475,18,1411289135,1411289675,2,1,540
43836891@N07,3476,16,1341830581,1341831001,1,1,420
43841868@N05,3477,12,1284691606,1284691876,2,1,270
43846796@N00,3478,7,1299499985,1299500105,1,1,120
43942132@N00,3479,17,1443947656,1443948076,1,1,420
43942132@N00,3480,23,1453721052,1453722252,1,1,1200
44030185@N02,3481,10,1263799670,1263799820,14,1,150
44042276@N00,3482,16,1375697067,1375697487,1,1,420
44060152@N07,3483,12,1343967133,1343967403,2,6,270
44060152@N07,3483,6,1343975456,1343975462,2,6,6
44060152@N07,3483,19,1343975462,1343976002,2,6,540
44060152@N07,3483,20,1343978181,1343978781,3,6,600
44060152@N07,3483,6,1343985852,1343985972,2,6,120
44060152@N07,3483,20,1343991403,1343992003,1,6,600
44082489@N00,3484,5,1419763119,1419763239,4,1,120
44082489@N00,3485,9,1419798026,1419798146,1,1,120
44118591@N00,3486,23,1225604117,1225605317,3,1,1200
44124316579@N01,3487,6,1401748687,1401748807,2,3,120
44124316579@N01,3487,8,1401754565,1401754685,2,3,120
44124316579@N01,3487,25,1401763062,1401765162,2,3,2100
44124364198@N01,3488,24,1358738819,1358740319,2,3,1500
44124364198@N01,3488,25,1358742261,1358742466,2,3,205
44124364198@N01,3488,2,1358742466,1358742526,1,3,60
44124364198@N01,3489,25,1361343822,1361345922,1,1,2100
44124364198@N01,3490,6,1439982111,1439982231,1,1,120
44124364198@N01,3491,25,1452240938,1452243038,1,1,2100
44124364198@N01,3492,25,1466315934,1466318034,1,1,2100
44124364198@N01,3493,25,1467265599,1467267699,1,1,2100
44124377471@N01,3494,8,1299200735,1299200784,2,5,49
44124377471@N01,3494,2,1299200784,1299200844,2,5,60
44124377471@N01,3494,4,1299201347,1299201437,2,5,90
44124377471@N01,3494,2,1299202168,1299202228,2,5,60
44124377471@N01,3494,9,1299202273,1299202393,1,5,120
44124377471@N01,3495,10,1320224394,1320224544,2,1,150
44124377471@N01,3496,3,1328408213,1328408303,3,2,90
44124377471@N01,3496,5,1328409476,1328409596,1,2,120
44124377471@N01,3497,1,1334030408,1334030468,2,2,60
44124377471@N01,3497,12,1334044310,1334044580,1,2,270
44124377471@N01,3498,2,1346312701,1346312761,2,7,60
44124377471@N01,3498,8,1346312841,1346312961,4,7,120
44124377471@N01,3498,10,1346315128,1346315278,3,7,150
44124377471@N01,3498,24,1346326077,1346326167,2,7,90
44124377471@N01,3498,12,1346326167,1346326437,2,7,270
44124377471@N01,3498,10,1346336738,1346336888,2,7,150
44124377471@N01,3498,12,1346337538,1346337808,1,7,270
44124377471@N01,3499,3,1351990288,1351990378,2,3,90
44124377471@N01,3499,1,1351992652,1351992712,2,3,60
44124377471@N01,3499,8,1351993755,1351993875,1,3,120
44124415797@N01,3500,19,1360046607,1360047147,1,1,540
44124426205@N01,3501,17,1447379103,1447379523,3,2,420
44124426205@N01,3501,14,1447391718,1447392078,1,2,360
44124426205@N01,3502,19,1447529110,1447529650,1,1,540
44124470535@N01,3503,2,1364427281,1364427341,1,1,60
44124473586@N01,3504,15,1340374982,1340375342,2,2,360
44124473586@N01,3504,14,1340379800,1340380160,2,2,360
44124473586@N01,3505,12,1341152801,1341153071,2,5,270
44124473586@N01,3505,10,1341154092,1341154242,2,5,150
44124473586@N01,3505,12,1341155300,1341155570,2,5,270
44124473586@N01,3505,14,1341159744,1341160104,2,5,360
44124473586@N01,3505,6,1341160568,1341160688,1,5,120
44164246@N00,3506,23,1273122813,1273124013,2,5,1200
44164246@N00,3506,17,1273124204,1273124213,2,5,9
44164246@N00,3506,12,1273124213,1273124263,6,5,50
44164246@N00,3506,17,1273124263,1273124683,5,5,420
44164246@N00,3506,12,1273139195,1273139465,1,5,270
44164246@N00,3507,25,1273198959,1273199878,15,7,919
44164246@N00,3507,22,1273199878,1273199999,4,7,121
44164246@N00,3507,25,1273199999,1273202099,3,7,2100
44164246@N00,3507,18,1273203504,1273203661,2,7,157
44164246@N00,3507,16,1273203661,1273204081,13,7,420
44164246@N00,3507,23,1273216982,1273218182,7,7,1200
44164246@N00,3507,12,1273224067,1273224337,7,7,270
44169189@N06,3508,3,1357519006,1357519096,2,33,90
44169189@N06,3508,19,1357521158,1357521698,3,33,540
44169189@N06,3508,15,1357523365,1357523479,4,33,114
44169189@N06,3508,14,1357523479,1357523571,2,33,92
44169189@N06,3508,6,1357523571,1357523691,4,33,120
44169189@N06,3508,19,1357523758,1357523994,3,33,236
44169189@N06,3508,18,1357523994,1357524117,4,33,123
44169189@N06,3508,11,1357524117,1357524357,2,33,240
44169189@N06,3508,18,1357524760,1357525300,2,33,540
44169189@N06,3508,7,1357526309,1357526429,2,33,120
44169189@N06,3508,16,1357526459,1357526879,3,33,420
44169189@N06,3508,13,1357527723,1357528023,4,33,300
44169189@N06,3508,24,1357528419,1357529919,3,33,1500
44169189@N06,3508,15,1357530824,1357531184,2,33,360
44169189@N06,3508,12,1357531563,1357531833,4,33,270
44169189@N06,3508,25,1357534552,1357535480,2,33,928
44169189@N06,3508,15,1357535480,1357535840,2,33,360
44169189@N06,3508,4,1357536248,1357536338,3,33,90
44169189@N06,3508,8,1357536843,1357536961,2,33,118
44169189@N06,3508,20,1357536961,1357537561,2,33,600
44169189@N06,3508,6,1357538566,1357538686,2,33,120
44169189@N06,3508,8,1357545236,1357545356,2,33,120
44169189@N06,3508,19,1357546511,1357547051,3,33,540
44169189@N06,3508,15,1357548813,1357549173,3,33,360
44169189@N06,3508,25,1357550261,1357550984,8,33,723
44169189@N06,3508,15,1357550984,1357551344,3,33,360
44169189@N06,3508,18,1357551606,1357551758,2,33,152
44169189@N06,3508,11,1357551758,1357551998,2,33,240
44169189@N06,3508,19,1357555327,1357555477,2,33,150
44169189@N06,3508,8,1357555477,1357555597,4,33,120
44169189@N06,3508,9,1357555758,1357555807,2,33,49
44169189@N06,3508,15,1357555807,1357556167,4,33,360
44169189@N06,3508,18,1357559673,1357560213,7,33,540
44312671@N03,3509,19,1326685249,1326685789,1,1,540
44315537@N03,3510,14,1376523078,1376523438,1,1,360
44332289@N05,3511,18,1356141658,1356142198,3,4,540
44332289@N05,3511,20,1356148844,1356149444,4,4,600
44332289@N05,3511,11,1356158611,1356158851,3,4,240
44332289@N05,3511,10,1356172147,1356172297,1,4,150
44332289@N05,3512,22,1379568310,1379569330,1,1,1020
44404893@N00,3513,7,1303276133,1303276253,1,1,120
44412893@N02,3514,3,1439480371,1439480461,2,2,90
44412893@N02,3514,14,1439483615,1439483975,2,2,360
44476715@N00,3515,12,1355652837,1355653107,1,1,270
44476715@N00,3516,14,1359247307,1359247667,3,2,360
44476715@N00,3516,5,1359257397,1359257517,1,2,120
44476715@N00,3517,14,1359762276,1359762636,5,4,360
44476715@N00,3517,22,1359789143,1359790163,2,4,1020
44476715@N00,3517,16,1359792016,1359792436,4,4,420
44476715@N00,3517,12,1359799769,1359800039,1,4,270
44606632@N02,3518,5,1284364115,1284364235,2,1,120
44606632@N02,3519,18,1290583526,1290584066,3,1,540
44616109@N08,3520,15,1377929171,1377929531,1,1,360
44783403@N05,3521,10,1376477097,1376477247,1,1,150
44795208@N00,3522,7,1304038283,1304038403,2,3,120
44795208@N00,3522,18,1304040341,1304040881,2,3,540
44795208@N00,3522,19,1304048862,1304049402,1,3,540
44795208@N00,3523,24,1304080387,1304081887,1,1,1500
44848889@N04,3524,14,1322810750,1322811110,1,1,360
44868632@N05,3525,19,1340640216,1340640756,1,1,540
44868632@N05,3526,14,1340673659,1340674019,1,1,360
44888637@N00,3527,12,1221529834,1221530104,4,3,270
44888637@N00,3527,5,1221534491,1221534611,4,3,120
44888637@N00,3527,25,1221546147,1221548247,1,3,2100
44934431@N00,3528,15,1306115961,1306116321,2,2,360
44934431@N00,3528,18,1306124942,1306125482,2,2,540
44957651@N00,3529,10,1323120362,1323120512,2,1,150
44957651@N00,3530,10,1337095787,1337095937,1,1,150
44957651@N00,3531,12,1342379166,1342379436,3,3,270
44957651@N00,3531,2,1342387268,1342387328,2,3,60
44957651@N00,3531,14,1342388464,1342388824,2,3,360
44957651@N00,3532,14,1342570499,1342570859,1,1,360
44957651@N00,3533,23,1378101908,1378102092,2,3,184
44957651@N00,3533,17,1378102092,1378102512,3,3,420
44957651@N00,3533,10,1378115059,1378115209,2,3,150
44957651@N00,3534,16,1379590693,1379591113,1,1,420
44957651@N00,3535,6,1385967027,1385967147,1,1,120
44957651@N00,3536,24,1411207515,1411209015,1,1,1500
44957651@N00,3537,18,1418424077,1418424617,1,1,540
44972365@N00,3538,3,1282741019,1282741109,1,1,90
44995817@N05,3539,18,1278335849,1278336389,1,1,540
44995817@N05,3540,18,1278420128,1278420668,3,1,540
45032460@N06,3541,12,1452853241,1452853511,1,1,270
45032460@N06,3542,14,1452984156,1452984516,5,10,360
45032460@N06,3542,7,1452989260,1452989380,2,10,120
45032460@N06,3542,18,1452992666,1452993206,2,10,540
45032460@N06,3542,14,1452995127,1452995408,2,10,281
45032460@N06,3542,19,1452995408,1452995948,2,10,540
45032460@N06,3542,25,1453001243,1453003343,3,10,2100
45032460@N06,3542,24,1453003446,1453004946,10,10,1500
45032460@N06,3542,19,1453005105,1453005645,3,10,540
45032460@N06,3542,14,1453011155,1453011363,8,10,208
45032460@N06,3542,6,1453011363,1453011483,9,10,120
45032460@N06,3543,14,1453090107,1453090467,1,1,360
45067258@N00,3544,12,1287120722,1287120992,5,1,270
45067258@N00,3545,16,1303387226,1303387646,1,1,420
45067258@N00,3546,23,1313834738,1313835024,4,5,286
45067258@N00,3546,10,1313835024,1313835174,4,5,150
45067258@N00,3546,5,1313836612,1313836732,2,5,120
45067258@N00,3546,10,1313837909,1313837929,2,5,20
45067258@N00,3546,3,1313837929,1313838019,1,5,90
45067258@N00,3547,7,1318062178,1318062298,2,1,120
45067258@N00,3548,12,1339226907,1339227177,1,1,270
45067258@N00,3549,15,1340295909,1340296269,1,1,360
45067258@N00,3550,24,1342840270,1342841770,1,1,1500
45067258@N00,3551,24,1344546776,1344547243,2,17,467
45067258@N00,3551,12,1344547243,1344547513,2,17,270
45067258@N00,3551,18,1344549089,1344549454,2,17,365
45067258@N00,3551,14,1344549454,1344549814,3,17,360
45067258@N00,3551,19,1344553009,1344553549,2,17,540
45067258@N00,3551,6,1344553724,1344553844,3,17,120
45067258@N00,3551,24,1344565088,1344565885,6,17,797
45067258@N00,3551,20,1344565885,1344566038,2,17,153
45067258@N00,3551,24,1344566038,1344567538,9,17,1500
45067258@N00,3551,19,1344590587,1344590916,2,17,329
45067258@N00,3551,14,1344590916,1344591172,2,17,256
45067258@N00,3551,6,1344591172,1344591292,2,17,120
45067258@N00,3551,5,1344593161,1344593281,4,17,120
45067258@N00,3551,10,1344597710,1344597737,2,17,27
45067258@N00,3551,16,1344597737,1344598157,3,17,420
45067258@N00,3551,24,1344600579,1344602079,4,17,1500
45067258@N00,3551,23,1344605647,1344606847,1,17,1200
45067258@N00,3552,12,1353108997,1353109267,1,1,270
45067258@N00,3553,12,1353137847,1353138117,1,1,270
45067258@N00,3554,14,1359270215,1359270575,2,1,360
45067258@N00,3555,14,1366325719,1366326079,2,2,360
45067258@N00,3555,12,1366334924,1366335194,1,2,270
45067258@N00,3556,24,1366454703,1366456203,14,1,1500
45067258@N00,3557,3,1366512740,1366512830,7,4,90
45067258@N00,3557,17,1366520338,1366520758,3,4,420
45067258@N00,3557,12,1366525337,1366525607,2,4,270
45067258@N00,3557,23,1366535001,1366536201,2,4,1200
45067258@N00,3558,23,1366589541,1366590741,1,1,1200
45067258@N00,3559,7,1439517143,1439517263,2,2,120
45067258@N00,3559,24,1439519582,1439521082,1,2,1500
45067258@N00,3560,7,1439592690,1439592810,1,1,120
45067258@N00,3561,3,1439722619,1439722709,13,1,90
45067258@N00,3562,20,1439775500,1439775515,2,6,15
45067258@N00,3562,24,1439775515,1439775948,6,6,433
45067258@N00,3562,20,1439775948,1439776548,2,6,600
45067258@N00,3562,17,1439776898,1439776918,2,6,20
45067258@N00,3562,12,1439776918,1439777188,4,6,270
45067258@N00,3562,19,1439780265,1439780805,5,6,540
45104424@N00,3563,12,1200972647,1200972917,1,1,270
45104424@N00,3564,17,1201027350,1201027770,2,2,420
45104424@N00,3564,10,1201030247,1201030397,2,2,150
45121853@N06,3565,18,1371130024,1371130564,1,1,540
45130440@N03,3566,19,1369279040,1369279580,1,1,540
45130440@N03,3567,24,1380855525,1380857025,1,1,1500
45130440@N03,3568,3,1383600099,1383600189,1,1,90
45303279@N00,3569,23,1192738587,1192739658,2,3,1071
45303279@N00,3569,18,1192739658,1192740198,2,3,540
45303279@N00,3569,7,1192741263,1192741383,1,3,120
45303279@N00,3570,13,1233029016,1233029316,5,1,300
45303279@N00,3571,23,1235004814,1235005369,2,2,555
45303279@N00,3571,18,1235005369,1235005909,1,2,540
45303279@N00,3572,20,1235347259,1235347859,1,1,600
45303279@N00,3573,10,1236044325,1236044475,1,1,150
45303279@N00,3574,17,1237859099,1237859519,2,8,420
45303279@N00,3574,15,1237860923,1237860995,2,8,72
45303279@N00,3574,4,1237860995,1237861085,2,8,90
45303279@N00,3574,23,1237861169,1237861188,2,8,19
45303279@N00,3574,20,1237861188,1237861256,2,8,68
45303279@N00,3574,4,1237861256,1237861346,2,8,90
45303279@N00,3574,17,1237863997,1237864078,2,8,81
45303279@N00,3574,12,1237864078,1237864348,7,8,270
45303279@N00,3575,20,1249384223,1249384823,8,1,600
45303279@N00,3576,12,1252471623,1252471893,2,1,270
45303279@N00,3577,19,1256298836,1256299376,7,1,540
45303279@N00,3578,13,1262320147,1262320447,4,1,300
45303279@N00,3579,12,1263177951,1263178221,3,20,270
45303279@N00,3579,16,1263178223,1263178643,6,20,420
45303279@N00,3579,10,1263178771,1263178906,2,20,135
45303279@N00,3579,3,1263178906,1263178996,4,20,90
45303279@N00,3579,18,1263179082,1263179152,2,20,70
45303279@N00,3579,16,1263179152,1263179397,2,20,245
45303279@N00,3579,11,1263179397,1263179624,3,20,227
45303279@N00,3579,19,1263179624,1263179883,5,20,259
45303279@N00,3579,4,1263179883,1263179973,6,20,90
45303279@N00,3579,15,1263180639,1263180999,4,20,360
45303279@N00,3579,22,1263181577,1263181756,3,20,179
45303279@N00,3579,25,1263181756,1263181880,2,20,124
45303279@N00,3579,22,1263181880,1263181911,2,20,31
45303279@N00,3579,25,1263181911,1263181925,2,20,14
45303279@N00,3579,22,1263181925,1263182038,4,20,113
45303279@N00,3579,15,1263182038,1263182064,2,20,26
45303279@N00,3579,22,1263182064,1263183084,10,20,1020
45303279@N00,3579,24,1263184047,1263184137,2,20,90
45303279@N00,3579,22,1263184137,1263184225,2,20,88
45303279@N00,3579,12,1263184225,1263184495,1,20,270
45303279@N00,3580,18,1265077329,1265077869,6,9,540
45303279@N00,3580,3,1265080520,1265080610,2,9,90
45303279@N00,3580,16,1265081425,1265081529,2,9,104
45303279@N00,3580,18,1265081529,1265081734,2,9,205
45303279@N00,3580,16,1265081734,1265082154,3,9,420
45303279@N00,3580,4,1265082451,1265082541,4,9,90
45303279@N00,3580,25,1265082855,1265083114,4,9,259
45303279@N00,3580,24,1265083114,1265084614,7,9,1500
45303279@N00,3580,12,1265086271,1265086541,1,9,270
45303279@N00,3581,24,1265507844,1265509344,2,4,1500
45303279@N00,3581,18,1265511163,1265511703,3,4,540
45303279@N00,3581,7,1265512591,1265512711,2,4,120
45303279@N00,3581,23,1265513184,1265514384,23,4,1200
45323160@N00,3582,12,1210805175,1210805445,2,3,270
45323160@N00,3582,25,1210805467,1210807567,4,3,2100
45323160@N00,3582,18,1210810767,1210811307,1,3,540
45349448@N00,3583,25,1444614602,1444616702,2,1,2100
45349448@N00,3584,25,1447219005,1447221105,1,1,2100
45352977@N05,3585,12,1350791747,1350792017,4,4,270
45352977@N05,3585,6,1350792877,1350792897,2,4,20
45352977@N05,3585,14,1350792897,1350793257,4,4,360
45352977@N05,3585,12,1350802166,1350802436,2,4,270
45352977@N05,3586,11,1365989949,1365990189,3,2,240
45352977@N05,3586,12,1365992105,1365992375,4,2,270
45352977@N05,3587,24,1369268618,1369270118,3,7,1500
45352977@N05,3587,4,1369289564,1369289654,2,7,90
45352977@N05,3587,9,1369290898,1369291018,2,7,120
45352977@N05,3587,4,1369291923,1369292013,2,7,90
45352977@N05,3587,2,1369292953,1369293013,2,7,60
45352977@N05,3587,4,1369293565,1369293655,2,7,90
45352977@N05,3587,16,1369296172,1369296592,1,7,420
45352977@N05,3588,12,1373596369,1373596639,1,1,270
45352977@N05,3589,6,1381369398,1381369518,2,4,120
45352977@N05,3589,11,1381371874,1381372114,2,4,240
45352977@N05,3589,17,1381373747,1381374167,2,4,420
45352977@N05,3589,12,1381378641,1381378911,1,4,270
45352977@N05,3590,24,1384819803,1384821303,2,5,1500
45352977@N05,3590,16,1384826751,1384827171,2,5,420
45352977@N05,3590,14,1384827277,1384827637,2,5,360
45352977@N05,3590,6,1384828667,1384828787,2,5,120
45352977@N05,3590,9,1384832472,1384832592,2,5,120
45352977@N05,3591,7,1385086734,1385086854,2,2,120
45352977@N05,3591,14,1385092169,1385092529,1,2,360
45352977@N05,3592,6,1397012141,1397012261,2,3,120
45352977@N05,3592,11,1397013943,1397014183,2,3,240
45352977@N05,3592,12,1397017772,1397018042,2,3,270
45352977@N05,3593,18,1409622557,1409623097,2,7,540
45352977@N05,3593,12,1409623873,1409624143,2,7,270
45352977@N05,3593,6,1409625047,1409625167,4,7,120
45352977@N05,3593,25,1409628859,1409630959,3,7,2100
45352977@N05,3593,4,1409630967,1409631057,2,7,90
45352977@N05,3593,14,1409631134,1409631494,3,7,360
45352977@N05,3593,11,1409649352,1409649592,1,7,240
45352977@N05,3594,12,1414041878,1414042148,2,2,270
45352977@N05,3594,11,1414048628,1414048868,1,2,240
45352977@N05,3595,6,1415239469,1415239589,2,9,120
45352977@N05,3595,14,1415239727,1415240060,2,9,333
45352977@N05,3595,11,1415240060,1415240300,3,9,240
45352977@N05,3595,7,1415241393,1415241513,2,9,120
45352977@N05,3595,23,1415244058,1415245258,2,9,1200
45352977@N05,3595,12,1415248382,1415248652,2,9,270
45352977@N05,3595,22,1415250526,1415251264,2,9,738
45352977@N05,3595,25,1415251264,1415253364,2,9,2100
45352977@N05,3595,14,1415254293,1415254653,2,9,360
45352977@N05,3596,12,1431400829,1431401099,1,1,270
45352977@N05,3597,12,1434856229,1434856499,2,2,270
45352977@N05,3597,19,1434863517,1434864057,1,2,540
45352977@N05,3598,13,1441780216,1441780516,1,1,300
45423318@N00,3599,16,1227916853,1227917273,2,1,420
45453038@N07,3600,23,1261562413,1261563613,2,1,1200
45462443@N08,3601,24,1278068626,1278070126,2,2,1500
45462443@N08,3601,16,1278072998,1278073418,1,2,420
45502281@N00,3602,24,1226729241,1226730741,3,1,1500
45502281@N00,3603,24,1227266562,1227268062,3,1,1500
45502281@N00,3604,24,1228018575,1228020075,2,1,1500
45553905@N00,3605,12,1238554762,1238554976,3,2,214
45553905@N00,3605,22,1238554976,1238555996,3,2,1020
45553905@N00,3606,15,1243756900,1243757260,3,2,360
45553905@N00,3606,12,1243760251,1243760521,1,2,270
45553905@N00,3607,12,1243919819,1243920089,2,5,270
45553905@N00,3607,22,1243921644,1243922570,2,5,926
45553905@N00,3607,24,1243922570,1243923071,3,5,501
45553905@N00,3607,12,1243923071,1243923341,2,5,270
45553905@N00,3607,13,1243928396,1243928696,6,5,300
45553905@N00,3608,22,1275452956,1275453933,2,5,977
45553905@N00,3608,3,1275453933,1275454023,2,5,90
45553905@N00,3608,23,1275454440,1275455640,2,5,1200
45553905@N00,3608,7,1275456739,1275456859,2,5,120
45553905@N00,3608,17,1275457753,1275458173,18,5,420
45561435@N00,3609,18,1201396172,1201396300,3,4,128
45561435@N00,3609,7,1201396300,1201396351,2,4,51
45561435@N00,3609,18,1201396351,1201396407,2,4,56
45561435@N00,3609,24,1201396407,1201397907,3,4,1500
45561435@N00,3610,25,1206147656,1206149756,1,1,2100
45571875@N06,3611,20,1368288178,1368288556,2,2,378
45571875@N06,3611,24,1368288556,1368290056,1,2,1500
45571875@N06,3612,7,1368615468,1368615588,2,5,120
45571875@N06,3612,11,1368625875,1368626115,2,5,240
45571875@N06,3612,19,1368626663,1368627203,2,5,540
45571875@N06,3612,14,1368628163,1368628523,5,5,360
45571875@N06,3612,23,1368629320,1368630520,1,5,1200
45571875@N06,3613,14,1368679414,1368679545,4,2,131
45571875@N06,3613,19,1368679545,1368680085,1,2,540
45584419@N07,3614,5,1338006634,1338006754,1,1,120
45584419@N07,3615,5,1338096137,1338096257,1,1,120
45584419@N07,3616,12,1347842700,1347842970,1,1,270
45628472@N04,3617,9,1350261361,1350261481,1,1,120
45643219@N05,3618,16,1384066749,1384067169,3,1,420
45744832@N07,3619,23,1316704805,1316706005,1,1,1200
45749280@N00,3620,10,1285785467,1285785617,2,2,150
45749280@N00,3620,20,1285785882,1285786482,1,2,600
45749280@N00,3621,15,1315996330,1315996690,1,1,360
45749280@N00,3622,19,1316155540,1316156080,1,1,540
45767882@N08,3623,25,1415575640,1415577740,1,1,2100
45851626@N06,3624,7,1381908273,1381908393,1,1,120
45871224@N03,3625,19,1386486253,1386486793,1,1,540
45871224@N03,3626,19,1393218910,1393219450,3,1,540
45875573@N08,3627,16,1310125902,1310126322,2,2,420
45875573@N08,3627,17,1310126329,1310126749,1,2,420
45906008@N00,3628,24,1254461420,1254462920,4,1,1500
45923298@N00,3629,12,1338431982,1338432252,1,1,270
45936466@N05,3630,24,1387431073,1387432573,2,1,1500
46016703@N00,3631,10,1308874483,1308874633,1,1,150
46026530@N04,3632,14,1384217138,1384217498,1,1,360
46027550@N00,3633,20,1245033429,1245034029,1,1,600
46027550@N00,3634,10,1299902809,1299902959,1,1,150
46050386@N03,3635,17,1268569049,1268569469,2,1,420
46050386@N03,3636,12,1268627647,1268627660,2,33,13
46050386@N03,3636,24,1268627660,1268627664,2,33,4
46050386@N03,3636,12,1268627664,1268627706,2,33,42
46050386@N03,3636,24,1268627706,1268627812,2,33,106
46050386@N03,3636,22,1268627812,1268627853,2,33,41
46050386@N03,3636,25,1268627853,1268628457,3,33,604
46050386@N03,3636,15,1268628457,1268628817,4,33,360
46050386@N03,3636,25,1268629537,1268629825,2,33,288
46050386@N03,3636,13,1268629825,1268630125,9,33,300
46050386@N03,3636,12,1268631720,1268631990,5,33,270
46050386@N03,3636,17,1268636670,1268636703,2,33,33
46050386@N03,3636,23,1268636703,1268636746,3,33,43
46050386@N03,3636,17,1268636746,1268636860,2,33,114
46050386@N03,3636,16,1268636860,1268636962,3,33,102
46050386@N03,3636,18,1268636962,1268636973,2,33,11
46050386@N03,3636,16,1268636973,1268636993,3,33,20
46050386@N03,3636,7,1268636993,1268637091,2,33,98
46050386@N03,3636,11,1268637091,1268637331,2,33,240
46050386@N03,3636,1,1268638215,1268638222,2,33,7
46050386@N03,3636,16,1268638222,1268638247,2,33,25
46050386@N03,3636,18,1268638247,1268638453,2,33,206
46050386@N03,3636,16,1268638453,1268638485,2,33,32
46050386@N03,3636,19,1268638485,1268638660,2,33,175
46050386@N03,3636,21,1268638660,1268638723,2,33,63
46050386@N03,3636,18,1268638723,1268639263,3,33,540
46050386@N03,3636,24,1268641747,1268641928,4,33,181
46050386@N03,3636,12,1268641928,1268641934,2,33,6
46050386@N03,3636,24,1268641934,1268641970,3,33,36
46050386@N03,3636,12,1268641970,1268641977,2,33,7
46050386@N03,3636,24,1268641977,1268642050,5,33,73
46050386@N03,3636,12,1268642050,1268642320,3,33,270
46050386@N03,3636,24,1268642661,1268642930,2,33,269
46050386@N03,3636,22,1268642930,1268643950,14,33,1020
46050386@N03,3637,12,1268692958,1268693228,2,1,270
46050386@N03,3638,24,1268722479,1268722642,4,11,163
46050386@N03,3638,6,1268722642,1268722762,11,11,120
46050386@N03,3638,20,1268723454,1268723640,2,11,186
46050386@N03,3638,6,1268723640,1268723691,4,11,51
46050386@N03,3638,20,1268723691,1268723735,5,11,44
46050386@N03,3638,8,1268723735,1268723788,3,11,53
46050386@N03,3638,4,1268723788,1268723813,3,11,25
46050386@N03,3638,8,1268723813,1268723826,2,11,13
46050386@N03,3638,2,1268723826,1268723841,2,11,15
46050386@N03,3638,8,1268723841,1268723961,2,11,120
46050386@N03,3638,13,1268724035,1268724335,3,11,300
46050386@N03,3639,16,1306325508,1306325651,3,7,143
46050386@N03,3639,18,1306325651,1306325862,2,7,211
46050386@N03,3639,7,1306325862,1306325982,2,7,120
46050386@N03,3639,5,1306326336,1306326456,2,7,120
46050386@N03,3639,18,1306326888,1306327428,2,7,540
46050386@N03,3639,16,1306327805,1306328225,2,7,420
46050386@N03,3639,18,1306329883,1306330423,7,7,540
46077647@N00,3640,24,1214973534,1214973705,2,8,171
46077647@N00,3640,25,1214973705,1214974179,3,8,474
46077647@N00,3640,16,1214974179,1214974369,4,8,190
46077647@N00,3640,11,1214974369,1214974494,2,8,125
46077647@N00,3640,7,1214974494,1214974614,2,8,120
46077647@N00,3640,10,1214975010,1214975160,2,8,150
46077647@N00,3640,17,1214975484,1214975564,2,8,80
46077647@N00,3640,12,1214975564,1214975834,1,8,270
46097854@N00,3641,14,1379664412,1379664772,2,3,360
46097854@N00,3641,5,1379673831,1379673951,2,3,120
46097854@N00,3641,16,1379688078,1379688498,1,3,420
46097854@N00,3642,25,1422424550,1422426650,3,2,2100
46097854@N00,3642,17,1422428130,1422428550,3,2,420
46097854@N00,3643,17,1422954186,1422954606,1,1,420
46097854@N00,3644,14,1456888178,1456888538,2,2,360
46097854@N00,3644,25,1456893135,1456895235,1,2,2100
46097854@N00,3645,16,1456973482,1456973902,3,1,420
46121254@N00,3646,18,1334209406,1334209946,3,3,540
46121254@N00,3646,4,1334215144,1334215234,4,3,90
46121254@N00,3646,7,1334217336,1334217456,1,3,120
46196249@N00,3647,19,1430030114,1430030654,2,2,540
46196249@N00,3647,6,1430032171,1430032291,1,2,120
46196249@N00,3648,21,1431507916,1431508816,1,1,900
46283533@N08,3649,17,1276227974,1276228394,1,1,420
46283533@N08,3650,10,1280485792,1280485942,1,1,150
46283533@N08,3651,12,1289561756,1289562026,2,3,270
46283533@N08,3651,13,1289563134,1289563186,2,3,52
46283533@N08,3651,22,1289563186,1289564206,1,3,1020
46283533@N08,3652,16,1313743414,1313743834,1,1,420
46283533@N08,3653,10,1314957954,1314958104,1,1,150
46283533@N08,3654,16,1316775769,1316776189,1,1,420
46283533@N08,3655,13,1338625718,1338626018,1,1,300
46283533@N08,3656,13,1339144154,1339144454,1,1,300
46283533@N08,3657,14,1340360499,1340360859,2,2,360
46283533@N08,3657,19,1340361750,1340362290,1,2,540
46283533@N08,3658,23,1412841698,1412842898,1,1,1200
46283533@N08,3659,12,1415595457,1415595727,1,1,270
46283533@N08,3660,19,1418365068,1418365608,1,1,540
46283533@N08,3661,23,1427875441,1427876641,1,1,1200
46300970@N06,3662,18,1235866210,1235866750,1,1,540
46300970@N06,3663,23,1430615965,1430617165,1,1,1200
46300970@N06,3664,10,1430655331,1430655481,1,1,150
46344160@N07,3665,18,1415596855,1415597395,1,1,540
46353666@N03,3666,18,1393067747,1393068286,4,4,539
46353666@N03,3666,14,1393068286,1393068419,2,4,133
46353666@N03,3666,8,1393068419,1393068539,2,4,120
46353666@N03,3666,24,1393068600,1393070100,3,4,1500
46397011@N07,3667,17,1441014846,1441015266,1,1,420
46419657@N06,3668,18,1370508095,1370508635,1,1,540
46453719@N00,3669,14,1388804363,1388804723,2,2,360
46453719@N00,3669,6,1388823726,1388823846,1,2,120
46539181@N03,3670,19,1296697703,1296698243,3,2,540
46539181@N03,3670,16,1296729081,1296729501,1,2,420
46539181@N03,3671,6,1296791709,1296791829,1,1,120
46539181@N03,3672,6,1296984544,1296984664,1,1,120
46539181@N03,3673,19,1297024566,1297025106,1,1,540
46542299@N06,3674,7,1385595996,1385596116,1,1,120
46559377@N00,3675,18,1415409406,1415409946,1,1,540
46602694@N00,3676,12,1377931081,1377931351,2,2,270
46602694@N00,3676,16,1377954370,1377954790,1,2,420
46631270@N00,3677,11,1282785255,1282785495,2,2,240
46631270@N00,3677,16,1282786327,1282786747,1,2,420
46631270@N00,3678,10,1300277066,1300277177,2,2,111
46631270@N00,3678,18,1300277177,1300277717,1,2,540
46709051@N03,3679,13,1355110349,1355110649,2,2,300
46709051@N03,3679,17,1355126103,1355126523,1,2,420
46709051@N03,3680,18,1355296335,1355296875,1,1,540
46806548@N00,3681,24,1389398291,1389399791,2,2,1500
46806548@N00,3681,15,1389410250,1389410610,1,2,360
46816976@N08,3682,14,1360053607,1360053967,1,1,360
46816976@N08,3683,6,1363764066,1363764186,2,3,120
46816976@N08,3683,14,1363764322,1363764650,3,3,328
46816976@N08,3683,6,1363764650,1363764770,1,3,120
46823063@N06,3684,6,1278728766,1278728886,1,1,120
46879921@N05,3685,20,1357189057,1357189657,2,2,600
46879921@N05,3685,16,1357202927,1357203347,1,2,420
46934698@N08,3686,16,1277413781,1277414201,88,1,420
46999149@N02,3687,12,1236588923,1236589193,1,1,270
46999149@N02,3688,12,1355294914,1355295184,3,1,270
47058171@N03,3689,17,1470738450,1470738870,1,1,420
47081385@N00,3690,16,1202197805,1202197884,3,5,79
47081385@N00,3690,10,1202197884,1202198034,2,5,150
47081385@N00,3690,5,1202198045,1202198165,2,5,120
47081385@N00,3690,11,1202201944,1202202184,5,5,240
47081385@N00,3690,13,1202227748,1202228048,6,5,300
47081385@N00,3691,5,1202920221,1202920341,1,1,120
47126723@N00,3692,14,1277836266,1277836626,10,1,360
47145959@N05,3693,14,1342950150,1342950510,1,1,360
47145959@N05,3694,18,1419330175,1419330715,1,1,540
47170787@N05,3695,12,1439540233,1439540503,1,1,270
47246716@N06,3696,6,1346141706,1346141826,1,1,120
47248421@N08,3697,24,1440734942,1440736442,1,1,1500
47280789@N05,3698,19,1395014344,1395014884,1,1,540
47327591@N07,3699,19,1337846358,1337846898,2,2,540
47327591@N07,3699,10,1337852372,1337852522,1,2,150
47423151@N06,3700,15,1331189001,1331189361,2,5,360
47423151@N06,3700,7,1331193834,1331193954,2,5,120
47423151@N06,3700,12,1331195656,1331195926,2,5,270
47423151@N06,3700,18,1331200118,1331200658,3,5,540
47423151@N06,3700,16,1331205719,1331206139,2,5,420
47423151@N06,3701,18,1409494260,1409494800,1,1,540
47444270@N03,3702,12,1352972504,1352972774,5,5,270
47444270@N03,3702,14,1352980236,1352980596,2,5,360
47444270@N03,3702,19,1352981179,1352981719,2,5,540
47444270@N03,3702,14,1352981945,1352982305,2,5,360
47444270@N03,3702,16,1352987661,1352988081,1,5,420
47462072@N00,3703,12,1386317960,1386318230,2,5,270
47462072@N00,3703,7,1386319662,1386319782,3,5,120
47462072@N00,3703,23,1386321560,1386322760,5,5,1200
47462072@N00,3703,10,1386325338,1386325488,4,5,150
47462072@N00,3703,16,1386325524,1386325944,1,5,420
47487972@N06,3704,19,1401175469,1401176009,3,4,540
47487972@N06,3704,25,1401177105,1401179205,2,4,2100
47487972@N06,3704,14,1401180161,1401180521,2,4,360
47487972@N06,3704,18,1401182422,1401182962,2,4,540
47576966@N05,3705,12,1193553147,1193553417,1,1,270
47647633@N03,3706,20,1305239716,1305240316,1,1,600
47684716@N07,3707,5,1273974480,1273974600,1,1,120
47684716@N07,3708,1,1274360292,1274360352,1,1,60
47694179@N06,3709,12,1471650391,1471650471,4,7,80
47694179@N06,3709,17,1471650471,1471650891,3,7,420
47694179@N06,3709,24,1471651321,1471651481,3,7,160
47694179@N06,3709,22,1471651481,1471652501,2,7,1020
47694179@N06,3709,6,1471654193,1471654313,2,7,120
47694179@N06,3709,19,1471654333,1471654357,3,7,24
47694179@N06,3709,14,1471654357,1471654717,2,7,360
47694179@N06,3710,8,1471737073,1471737193,6,1,120
47713580@N07,3711,24,1374898351,1374899794,17,3,1443
47713580@N07,3711,20,1374899794,1374900394,3,3,600
47713580@N07,3711,23,1374900720,1374901920,2,3,1200
47728175@N00,3712,16,1213409456,1213409876,2,3,420
47728175@N00,3712,11,1213409996,1213410236,2,3,240
47728175@N00,3712,19,1213414450,1213414990,1,3,540
47731649@N00,3713,6,1348401477,1348401597,1,1,120
47731649@N00,3714,12,1348431323,1348431593,1,1,270
47736026@N04,3715,14,1340558916,1340559276,2,4,360
47736026@N04,3715,19,1340559811,1340560351,2,4,540
47736026@N04,3715,24,1340569166,1340569226,2,4,60
47736026@N04,3715,20,1340569226,1340569826,1,4,600
47799833@N08,3716,7,1340629661,1340629781,1,1,120
47799833@N08,3717,6,1407177377,1407177497,1,1,120
47841296@N07,3718,7,1392790100,1392790220,2,1,120
47852199@N00,3719,24,1374594281,1374595781,1,1,1500
48081748@N00,3720,24,1379765305,1379766805,1,1,1500
48101006@N02,3721,17,1427760510,1427760930,2,3,420
48101006@N02,3721,19,1427768594,1427769134,2,3,540
48101006@N02,3721,18,1427769372,1427769912,1,3,540
48101006@N02,3722,12,1462346734,1462347004,1,1,270
48108659@N00,3723,18,1264637715,1264638255,3,12,540
48108659@N00,3723,3,1264639546,1264639636,2,12,90
48108659@N00,3723,24,1264649899,1264650027,2,12,128
48108659@N00,3723,12,1264650027,1264650297,2,12,270
48108659@N00,3723,13,1264650666,1264650966,2,12,300
48108659@N00,3723,9,1264654703,1264654823,4,12,120
48108659@N00,3723,4,1264655708,1264655798,2,12,90
48108659@N00,3723,6,1264657643,1264657735,2,12,92
48108659@N00,3723,20,1264657735,1264658335,2,12,600
48108659@N00,3723,18,1264660393,1264660933,3,12,540
48108659@N00,3723,3,1264663191,1264663281,4,12,90
48108659@N00,3723,1,1264663934,1264663994,1,12,60
48108659@N00,3724,3,1267699433,1267699523,2,1,90
48108659@N00,3725,3,1267742711,1267742801,10,1,90
48108659@N00,3726,9,1267779379,1267779499,3,3,120
48108659@N00,3726,4,1267779930,1267780020,2,3,90
48108659@N00,3726,7,1267780480,1267780600,2,3,120
48108659@N00,3727,3,1267833487,1267833577,10,1,90
48108659@N00,3728,16,1289865069,1289865489,2,7,420
48108659@N00,3728,18,1289865736,1289866276,4,7,540
48108659@N00,3728,1,1289866923,1289866932,2,7,9
48108659@N00,3728,5,1289866932,1289867052,3,7,120
48108659@N00,3728,1,1289867299,1289867359,5,7,60
48108659@N00,3728,20,1289868842,1289869442,3,7,600
48108659@N00,3728,12,1289874811,1289875081,1,7,270
48108659@N00,3729,9,1290988359,1290988479,3,3,120
48108659@N00,3729,4,1290988644,1290988734,3,3,90
48108659@N00,3729,25,1290994723,1290996823,8,3,2100
48108659@N00,3730,23,1294371674,1294372874,3,1,1200
48108659@N00,3731,12,1296086712,1296086982,6,1,270
48108659@N00,3732,16,1296116942,1296117362,3,1,420
48108659@N00,3733,12,1296173114,1296173384,1,1,270
48135145@N03,3734,7,1312537659,1312537779,1,1,120
48163256@N02,3735,11,1302758977,1302759217,2,1,240
48166800@N00,3736,16,1239510212,1239510632,2,3,420
48166800@N00,3736,18,1239514151,1239514691,2,3,540
48166800@N00,3736,22,1239527515,1239528535,2,3,1020
48210499@N04,3737,12,1328004794,1328005064,7,1,270
48228348@N00,3738,12,1341844013,1341844283,1,1,270
48238299@N02,3739,17,1364887392,1364887812,2,2,420
48238299@N02,3739,25,1364895672,1364897772,2,2,2100
48238299@N02,3740,25,1364980134,1364982234,4,2,2100
48238299@N02,3740,17,1364983372,1364983792,1,2,420
48238299@N02,3741,25,1365034814,1365036914,2,1,2100
48241744@N00,3742,10,1350818426,1350818576,1,1,150
48271781@N00,3743,19,1354423816,1354423855,2,3,39
48271781@N00,3743,15,1354423855,1354424215,2,3,360
48271781@N00,3743,23,1354450578,1354451778,1,3,1200
48275668@N02,3744,23,1351634311,1351635511,1,1,1200
48275668@N02,3745,12,1351688577,1351688847,2,5,270
48275668@N02,3745,25,1351691563,1351693663,2,5,2100
48275668@N02,3745,14,1351700036,1351700396,3,5,360
48275668@N02,3745,19,1351719419,1351719959,2,5,540
48275668@N02,3745,24,1351732724,1351734224,1,5,1500
48275668@N02,3746,14,1351802774,1351803134,1,1,360
48289250@N04,3747,19,1341646188,1341646728,2,1,540
48293564@N02,3748,12,1294727575,1294727845,1,1,270
48326723@N08,3749,14,1359351889,1359352249,6,1,360
48326723@N08,3750,14,1359441096,1359441456,11,1,360
48335730@N00,3751,12,1285910567,1285910837,1,1,270
48418487@N02,3752,12,1278724137,1278724407,2,5,270
48418487@N02,3752,20,1278724477,1278725077,3,5,600
48418487@N02,3752,16,1278725737,1278726157,4,5,420
48418487@N02,3752,23,1278727140,1278728340,4,5,1200
48418487@N02,3752,12,1278750519,1278750789,2,5,270
48418487@N02,3753,19,1279029078,1279029244,2,4,166
48418487@N02,3753,16,1279029244,1279029324,2,4,80
48418487@N02,3753,18,1279029324,1279029549,2,4,225
48418487@N02,3753,23,1279029549,1279030749,1,4,1200
48507415@N08,3754,7,1358050241,1358050361,1,1,120
48532661@N00,3755,12,1419833170,1419833440,2,1,270
48586087@N00,3756,5,1296209856,1296209976,1,1,120
48600072071@N01,3757,17,1291463802,1291464074,2,2,272
48600072071@N01,3757,24,1291464074,1291465574,1,2,1500
48600084288@N01,3758,16,1364950821,1364951241,3,4,420
48600084288@N01,3758,10,1364958159,1364958309,4,4,150
48600084288@N01,3758,7,1364960544,1364960664,2,4,120
48600084288@N01,3758,17,1364961477,1364961897,1,4,420
48600084288@N01,3759,7,1365027076,1365027196,2,7,120
48600084288@N01,3759,6,1365027833,1365027953,2,7,120
48600084288@N01,3759,8,1365030174,1365030294,4,7,120
48600084288@N01,3759,6,1365044192,1365044228,3,7,36
48600084288@N01,3759,19,1365044228,1365044768,2,7,540
48600084288@N01,3759,14,1365045961,1365046119,2,7,158
48600084288@N01,3759,6,1365046119,1365046239,1,7,120
48600093488@N01,3760,22,1310058284,1310059304,4,1,1020
48600113426@N01,3761,13,1237696204,1237696504,2,9,300
48600113426@N01,3761,22,1237697273,1237698293,6,9,1020
48600113426@N01,3761,16,1237699105,1237699525,3,9,420
48600113426@N01,3761,3,1237700886,1237700976,2,9,90
48600113426@N01,3761,17,1237707168,1237707588,2,9,420
48600113426@N01,3761,12,1237708911,1237709181,6,9,270
48600113426@N01,3761,24,1237711174,1237712674,7,9,1500
48600113426@N01,3761,7,1237716612,1237716732,5,9,120
48600113426@N01,3761,12,1237719500,1237719770,1,9,270
48600113426@N01,3762,22,1238134824,1238134931,2,8,107
48600113426@N01,3762,13,1238134931,1238134938,2,8,7
48600113426@N01,3762,12,1238134938,1238134980,3,8,42
48600113426@N01,3762,22,1238134980,1238134986,2,8,6
48600113426@N01,3762,13,1238134986,1238134992,2,8,6
48600113426@N01,3762,15,1238134992,1238135011,2,8,19
48600113426@N01,3762,13,1238135011,1238135017,2,8,6
48600113426@N01,3762,22,1238135017,1238136037,2,8,1020
48613002@N02,3763,19,1344211773,1344212313,1,1,540
48613002@N02,3764,19,1344250371,1344250911,2,1,540
48613002@N02,3765,19,1344328104,1344328644,10,1,540
48613002@N02,3766,19,1365988413,1365988953,23,1,540
48613002@N02,3767,19,1428820741,1428821281,1,1,540
48613002@N02,3768,19,1429056986,1429057526,1,1,540
48670824@N08,3769,14,1339625493,1339625853,1,1,360
48715359@N00,3770,17,1353299684,1353299690,2,12,6
48715359@N00,3770,25,1353299690,1353300746,2,12,1056
48715359@N00,3770,11,1353300746,1353300858,2,12,112
48715359@N00,3770,7,1353300858,1353300978,2,12,120
48715359@N00,3770,18,1353304886,1353305178,2,12,292
48715359@N00,3770,10,1353305178,1353305328,4,12,150
48715359@N00,3770,13,1353307211,1353307511,2,12,300
48715359@N00,3770,17,1353310688,1353311108,2,12,420
48715359@N00,3770,14,1353312633,1353312993,2,12,360
48715359@N00,3770,15,1353313063,1353313423,2,12,360
48715359@N00,3770,12,1353313695,1353313965,2,12,270
48715359@N00,3770,17,1353318316,1353318736,1,12,420
48715359@N00,3771,8,1353362594,1353362714,2,15,120
48715359@N00,3771,15,1353366135,1353366495,2,15,360
48715359@N00,3771,16,1353381562,1353381687,2,15,125
48715359@N00,3771,19,1353381687,1353382227,6,15,540
48715359@N00,3771,11,1353383144,1353383278,4,15,134
48715359@N00,3771,19,1353383278,1353383356,2,15,78
48715359@N00,3771,11,1353383356,1353383522,7,15,166
48715359@N00,3771,16,1353383522,1353383637,3,15,115
48715359@N00,3771,19,1353383637,1353384177,8,15,540
48715359@N00,3771,11,1353385063,1353385303,3,15,240
48715359@N00,3771,10,1353387860,1353388010,3,15,150
48715359@N00,3771,24,1353393306,1353394219,2,15,913
48715359@N00,3771,11,1353394219,1353394459,3,15,240
48715359@N00,3771,24,1353407071,1353407589,2,15,518
48715359@N00,3771,15,1353407589,1353407949,1,15,360
48715359@N00,3772,14,1353446173,1353446533,2,4,360
48715359@N00,3772,19,1353451408,1353451948,2,4,540
48715359@N00,3772,16,1353455099,1353455519,2,4,420
48715359@N00,3772,17,1353457910,1353458330,1,4,420
48721961@N08,3773,5,1452981201,1452981321,1,1,120
48721961@N08,3774,6,1453088391,1453088511,1,1,120
48731805@N02,3775,13,1315653033,1315653071,3,5,38
48731805@N02,3775,25,1315653071,1315653153,4,5,82
48731805@N02,3775,19,1315653153,1315653170,2,5,17
48731805@N02,3775,16,1315653170,1315653258,2,5,88
48731805@N02,3775,19,1315653258,1315653798,1,5,540
48741368@N00,3776,11,1365381650,1365381890,1,1,240
48741368@N00,3777,12,1365419397,1365419667,1,1,270
48797330@N00,3778,23,1398601904,1398603104,1,1,1200
48812619@N00,3779,17,1266870328,1266870748,1,1,420
48826873@N08,3780,19,1452138418,1452138958,1,1,540
48826873@N08,3781,12,1452223353,1452223623,1,1,270
48839284@N00,3782,6,1291466484,1291466604,16,1,120
48871176@N08,3783,17,1278461508,1278461928,1,1,420
48874768@N04,3784,10,1291951807,1291951957,2,1,150
48889068621@N01,3785,12,1229748397,1229748667,1,1,270
48889068621@N01,3786,24,1238288739,1238290239,2,3,1500
48889068621@N01,3786,25,1238294002,1238296102,2,3,2100
48889068621@N01,3786,23,1238297194,1238298394,7,3,1200
48889068621@N01,3787,6,1240103114,1240103234,5,5,120
48889068621@N01,3787,25,1240103283,1240103288,2,5,5
48889068621@N01,3787,6,1240103288,1240103408,3,5,120
48889068621@N01,3787,8,1240103477,1240103519,2,5,42
48889068621@N01,3787,6,1240103519,1240103639,2,5,120
48889068621@N01,3788,7,1241318113,1241318233,3,5,120
48889068621@N01,3788,21,1241318626,1241318638,3,5,12
48889068621@N01,3788,1,1241318638,1241318698,2,5,60
48889068621@N01,3788,18,1241318933,1241319473,2,5,540
48889068621@N01,3788,4,1241321225,1241321315,24,5,90
48889068621@N01,3789,24,1245550581,1245550722,3,3,141
48889068621@N01,3789,22,1245550722,1245551742,2,3,1020
48889068621@N01,3789,20,1245557860,1245558460,3,3,600
48889068621@N01,3790,16,1247999588,1248000008,2,5,420
48889068621@N01,3790,12,1248000165,1248000174,2,5,9
48889068621@N01,3790,7,1248000174,1248000193,2,5,19
48889068621@N01,3790,12,1248000193,1248000196,2,5,3
48889068621@N01,3790,7,1248000196,1248000316,1,5,120
48889068621@N01,3791,22,1258856286,1258857306,3,9,1020
48889068621@N01,3791,17,1258859936,1258859944,3,9,8
48889068621@N01,3791,3,1258859944,1258859964,2,9,20
48889068621@N01,3791,23,1258859964,1258861164,3,9,1200
48889068621@N01,3791,10,1258861733,1258861755,2,9,22
48889068621@N01,3791,3,1258861755,1258861845,2,9,90
48889068621@N01,3791,5,1258861912,1258862032,5,9,120
48889068621@N01,3791,24,1258862254,1258863336,3,9,1082
48889068621@N01,3791,3,1258863336,1258863426,2,9,90
48889068621@N01,3792,22,1262475792,1262476812,2,2,1020
48889068621@N01,3792,11,1262478305,1262478545,2,2,240
48889068621@N01,3793,7,1267345868,1267345988,2,1,120
48889068621@N01,3794,24,1267934106,1267935606,2,9,1500
48889068621@N01,3794,17,1267937003,1267937023,3,9,20
48889068621@N01,3794,23,1267937023,1267937082,2,9,59
48889068621@N01,3794,17,1267937082,1267937092,3,9,10
48889068621@N01,3794,23,1267937092,1267937371,3,9,279
48889068621@N01,3794,17,1267937371,1267937791,4,9,420
48889068621@N01,3794,25,1267943825,1267945925,7,9,2100
48889068621@N01,3794,16,1267951940,1267952360,2,9,420
48889068621@N01,3794,7,1267952556,1267952676,4,9,120
48889068621@N01,3795,6,1271573285,1271573405,21,1,120
48889068621@N01,3796,24,1278064463,1278065125,9,8,662
48889068621@N01,3796,4,1278065125,1278065154,2,8,29
48889068621@N01,3796,8,1278065154,1278065274,2,8,120
48889068621@N01,3796,11,1278066787,1278067027,3,8,240
48889068621@N01,3796,7,1278071320,1278071440,4,8,120
48889068621@N01,3796,18,1278071759,1278071771,2,8,12
48889068621@N01,3796,7,1278071771,1278071891,4,8,120
48889068621@N01,3796,22,1278073278,1278074298,6,8,1020
48889068621@N01,3797,13,1287808842,1287809142,2,3,300
48889068621@N01,3797,22,1287814907,1287815927,2,3,1020
48889068621@N01,3797,13,1287816736,1287817036,1,3,300
48889068621@N01,3798,12,1289085860,1289086130,3,4,270
48889068621@N01,3798,20,1289089736,1289090336,3,4,600
48889068621@N01,3798,8,1289090878,1289090998,2,4,120
48889068621@N01,3798,9,1289091379,1289091499,2,4,120
48889113645@N01,3799,14,1407843827,1407844187,1,1,360
48889118999@N01,3800,18,1299211804,1299212344,1,1,540
48889119704@N01,3801,12,1244189531,1244189801,2,12,270
48889119704@N01,3801,17,1244190043,1244190463,3,12,420
48889119704@N01,3801,11,1244191924,1244192164,3,12,240
48889119704@N01,3801,5,1244192700,1244192820,6,12,120
48889119704@N01,3801,10,1244193152,1244193302,3,12,150
48889119704@N01,3801,24,1244197656,1244197772,4,12,116
48889119704@N01,3801,13,1244197772,1244198072,2,12,300
48889119704@N01,3801,25,1244200133,1244202233,2,12,2100
48889119704@N01,3801,11,1244202706,1244202946,2,12,240
48889119704@N01,3801,18,1244203800,1244204340,3,12,540
48889119704@N01,3801,7,1244206506,1244206626,11,12,120
48889119704@N01,3801,20,1244211693,1244212293,1,12,600
48889119704@N01,3802,22,1244275589,1244276609,2,5,1020
48889119704@N01,3802,24,1244285368,1244286868,2,5,1500
48889119704@N01,3802,11,1244289109,1244289349,2,5,240
48889119704@N01,3802,1,1244290640,1244290700,3,5,60
48889119704@N01,3802,12,1244292604,1244292874,1,5,270
48914036@N06,3803,19,1448518594,1448519134,1,1,540
48925695@N06,3804,22,1427707636,1427708656,2,2,1020
48925695@N06,3804,6,1427721534,1427721654,4,2,120
48949906@N00,3805,6,1385586932,1385587052,3,31,120
48949906@N00,3805,8,1385591791,1385591911,3,31,120
48949906@N00,3805,14,1385592020,1385592380,7,31,360
48949906@N00,3805,19,1385596694,1385597234,2,31,540
48949906@N00,3805,6,1385597357,1385597477,2,31,120
48949906@N00,3805,23,1385600108,1385601308,4,31,1200
48949906@N00,3805,12,1385605758,1385606028,5,31,270
48949906@N00,3805,25,1385606909,1385606965,2,31,56
48949906@N00,3805,22,1385606965,1385607064,4,31,99
48949906@N00,3805,24,1385607064,1385608564,5,31,1500
48949906@N00,3805,22,1385608646,1385608667,3,31,21
48949906@N00,3805,25,1385608667,1385608695,5,31,28
48949906@N00,3805,13,1385608695,1385608995,2,31,300
48949906@N00,3805,25,1385609530,1385611630,6,31,2100
48949906@N00,3805,2,1385611804,1385611864,3,31,60
48949906@N00,3805,9,1385611942,1385612062,2,31,120
48949906@N00,3805,15,1385612190,1385612550,4,31,360
48949906@N00,3805,25,1385612759,1385612774,2,31,15
48949906@N00,3805,2,1385612774,1385612834,2,31,60
48949906@N00,3805,12,1385613702,1385613972,10,31,270
48949906@N00,3805,6,1385615977,1385616097,19,31,120
48949906@N00,3805,14,1385618792,1385618822,5,31,30
48949906@N00,3805,8,1385618822,1385618942,3,31,120
48949906@N00,3805,14,1385619370,1385619415,5,31,45
48949906@N00,3805,6,1385619415,1385619535,29,31,120
48949906@N00,3805,18,1385621517,1385622057,11,31,540
48949906@N00,3805,7,1385622146,1385622266,2,31,120
48949906@N00,3805,11,1385624072,1385624312,2,31,240
48949906@N00,3805,19,1385625809,1385626349,3,31,540
48949906@N00,3805,1,1385627022,1385627082,2,31,60
48949906@N00,3805,10,1385627251,1385627401,10,31,150
48949906@N00,3806,19,1385798393,1385798933,2,1,540
48963475@N06,3807,17,1264468442,1264468862,1,1,420
49039595@N00,3808,15,1287047859,1287048219,1,1,360
49050039@N06,3809,6,1471854649,1471854727,2,2,78
49050039@N06,3809,14,1471854727,1471855087,2,2,360
49059899@N00,3810,12,1220051194,1220051464,1,1,270
49072197@N02,3811,16,1294483202,1294483622,1,1,420
49111993@N00,3812,16,1344168559,1344168979,3,1,420
49165041@N00,3813,7,1258879396,1258879516,1,1,120
49165041@N00,3814,23,1289442875,1289444075,3,3,1200
49165041@N00,3814,18,1289444898,1289445438,2,3,540
49165041@N00,3814,19,1289445782,1289446322,1,3,540
49165041@N00,3815,9,1293765109,1293765229,3,3,120
49165041@N00,3815,1,1293769535,1293769595,6,3,60
49165041@N00,3815,10,1293770483,1293770633,5,3,150
49165041@N00,3816,23,1305448175,1305448643,2,4,468
49165041@N00,3816,5,1305448643,1305448763,3,4,120
49165041@N00,3816,19,1305450221,1305450761,4,4,540
49165041@N00,3816,13,1305450889,1305451189,12,4,300
49165041@N00,3817,16,1306807358,1306807778,12,2,420
49165041@N00,3817,23,1306816411,1306817611,2,2,1200
49165041@N00,3818,15,1306976589,1306976949,4,5,360
49165041@N00,3818,19,1306978344,1306978884,2,5,540
49165041@N00,3818,12,1306998180,1306998450,3,5,270
49165041@N00,3818,7,1307004369,1307004489,2,5,120
49165041@N00,3818,16,1307006844,1307007264,8,5,420
49165041@N00,3819,24,1344547152,1344548652,2,5,1500
49165041@N00,3819,18,1344560008,1344560548,3,5,540
49165041@N00,3819,22,1344565868,1344566888,5,5,1020
49165041@N00,3819,23,1344583336,1344584536,2,5,1200
49165041@N00,3819,18,1344590472,1344591012,1,5,540
49169223@N00,3820,24,1342865072,1342866572,1,1,1500
49169223@N00,3821,14,1342912855,1342913215,5,9,360
49169223@N00,3821,23,1342917111,1342918311,2,9,1200
49169223@N00,3821,7,1342920329,1342920449,2,9,120
49169223@N00,3821,14,1342924557,1342924917,3,9,360
49169223@N00,3821,17,1342927292,1342927712,3,9,420
49169223@N00,3821,25,1342931263,1342933363,2,9,2100
49169223@N00,3821,24,1342954477,1342955977,21,9,1500
49169223@N00,3821,7,1342962039,1342962159,21,9,120
49169223@N00,3821,14,1342965500,1342965860,5,9,360
49169223@N00,3822,24,1343123634,1343125134,6,1,1500
49193077@N03,3823,12,1313288437,1313288707,1,1,270
49199600@N00,3824,5,1223621619,1223621739,1,1,120
49239262@N00,3825,7,1378644414,1378644534,1,1,120
49239262@N00,3826,24,1386538419,1386539919,1,1,1500
49268359@N05,3827,23,1337769740,1337769786,2,2,46
49268359@N05,3827,16,1337769786,1337770206,2,2,420
49268359@N05,3828,3,1337839365,1337839455,2,2,90
49268359@N05,3828,11,1337840673,1337840913,2,2,240
49268359@N05,3829,23,1337909399,1337910599,1,1,1200
49275237@N00,3830,24,1239515215,1239516715,13,7,1500
49275237@N00,3830,22,1239518553,1239518714,2,7,161
49275237@N00,3830,25,1239518714,1239520814,6,7,2100
49275237@N00,3830,24,1239520980,1239521414,20,7,434
49275237@N00,3830,20,1239521414,1239521746,2,7,332
49275237@N00,3830,24,1239521746,1239523246,2,7,1500
49275237@N00,3830,5,1239524447,1239524567,1,7,120
49304581@N02,3831,11,1292407147,1292407387,1,1,240
49304581@N02,3832,4,1317980447,1317980537,1,1,90
49304581@N02,3833,23,1326526642,1326527842,1,1,1200
49304581@N02,3834,12,1327471342,1327471612,2,2,270
49304581@N02,3834,15,1327477983,1327478343,1,2,360
49304581@N02,3835,14,1347443171,1347443531,1,1,360
49304581@N02,3836,25,1348210902,1348213002,1,1,2100
49304581@N02,3837,17,1350708393,1350708813,1,1,420
49305593@N05,3838,17,1431059143,1431059563,6,1,420
49305593@N05,3839,17,1431164131,1431164551,1,1,420
49305593@N05,3840,17,1431252140,1431252560,3,1,420
49305593@N05,3841,17,1431414020,1431414440,3,1,420
49305593@N05,3842,17,1431666761,1431667181,1,1,420
49305593@N05,3843,17,1431697960,1431698380,2,1,420
49355871@N00,3844,24,1374669740,1374671240,1,1,1500
49362482@N00,3845,7,1349642591,1349642711,1,1,120
49427795@N00,3846,19,1354444573,1354445113,1,1,540
49427795@N00,3847,16,1354587381,1354587801,3,2,420
49427795@N00,3847,6,1354606041,1354606161,1,2,120
49439220@N07,3848,25,1399105098,1399107198,1,1,2100
49451382@N00,3849,12,1243740034,1243740304,2,1,270
49471872@N00,3850,12,1291678849,1291679119,1,1,270
49486281@N02,3851,12,1311564314,1311564584,1,1,270
49502967866@N01,3852,14,1367814629,1367814989,1,1,360
49502978053@N01,3853,17,1215649707,1215650127,6,5,420
49502978053@N01,3853,16,1215651126,1215651546,2,5,420
49502978053@N01,3853,7,1215651973,1215652093,2,5,120
49502978053@N01,3853,5,1215653087,1215653207,2,5,120
49502978053@N01,3853,12,1215662996,1215663266,2,5,270
49503142513@N01,3854,6,1345024187,1345024307,5,1,120
49503142513@N01,3855,6,1396779198,1396779318,2,1,120
49503142513@N01,3856,6,1396826178,1396826298,3,1,120
49503204666@N01,3857,3,1255827637,1255827727,3,2,90
49503204666@N01,3857,10,1255838221,1255838371,1,2,150
49545908@N00,3858,18,1283850417,1283850544,3,2,127
49545908@N00,3858,16,1283850544,1283850964,1,2,420
49556535@N04,3859,12,1467796484,1467796754,2,1,270
49578007@N05,3860,14,1356103894,1356103902,2,2,8
49578007@N05,3860,24,1356103902,1356105402,1,2,1500
49578007@N05,3861,12,1360639744,1360640014,2,6,270
49578007@N05,3861,10,1360641179,1360641329,2,6,150
49578007@N05,3861,18,1360648676,1360649216,2,6,540
49578007@N05,3861,25,1360650373,1360652473,2,6,2100
49578007@N05,3861,24,1360660309,1360661809,5,6,1500
49578007@N05,3861,16,1360674104,1360674524,1,6,420
49578007@N05,3862,18,1363512621,1363513161,2,4,540
49578007@N05,3862,10,1363514129,1363514279,2,4,150
49578007@N05,3862,19,1363517457,1363517997,2,4,540
49578007@N05,3862,14,1363521242,1363521602,1,4,360
49578007@N05,3863,13,1367138149,1367138449,2,2,300
49578007@N05,3863,7,1367141834,1367141954,1,2,120
49578007@N05,3864,24,1369492774,1369494274,1,1,1500
49578007@N05,3865,15,1376706469,1376706829,2,2,360
49578007@N05,3865,17,1376710428,1376710848,1,2,420
49578007@N05,3866,24,1377435957,1377437457,2,1,1500
49578007@N05,3867,3,1378618472,1378618562,1,1,90
49578007@N05,3868,24,1379745419,1379746919,3,2,1500
49578007@N05,3868,16,1379775211,1379775631,1,2,420
49578007@N05,3869,11,1380372817,1380373057,1,1,240
49578007@N05,3870,12,1380901617,1380901887,1,1,270
49578007@N05,3871,17,1380980760,1380981180,1,1,420
49578007@N05,3872,19,1381033875,1381034415,2,3,540
49578007@N05,3872,6,1381036976,1381037096,2,3,120
49578007@N05,3872,14,1381038026,1381038386,1,3,360
49578007@N05,3873,22,1382164765,1382165785,2,3,1020
49578007@N05,3873,24,1382172948,1382174448,2,3,1500
49578007@N05,3873,22,1382176052,1382177072,1,3,1020
49578007@N05,3874,24,1382251637,1382253137,2,1,1500
49578007@N05,3875,15,1385615098,1385615458,2,3,360
49578007@N05,3875,1,1385621456,1385621516,2,3,60
49578007@N05,3875,24,1385636683,1385638183,1,3,1500
49578007@N05,3876,6,1390049091,1390049211,1,1,120
49578007@N05,3877,3,1391834612,1391834702,2,3,90
49578007@N05,3877,22,1391846496,1391847516,2,3,1020
49578007@N05,3877,12,1391851033,1391851303,1,3,270
49578007@N05,3878,15,1393637197,1393637557,1,1,360
49578007@N05,3879,22,1400834518,1400835538,1,1,1020
49578007@N05,3880,22,1400936206,1400937226,1,1,1020
49578007@N05,3881,7,1404455032,1404455152,1,1,120
49578007@N05,3882,7,1405765658,1405765778,1,1,120
49578007@N05,3883,24,1408883458,1408884035,2,2,577
49578007@N05,3883,19,1408884035,1408884575,1,2,540
49578007@N05,3884,24,1412433518,1412435018,1,1,1500
49578007@N05,3885,17,1412479961,1412480381,2,2,420
49578007@N05,3885,22,1412488308,1412489328,1,2,1020
49578007@N05,3886,24,1416031847,1416033347,1,1,1500
49578007@N05,3887,18,1416663025,1416663565,1,1,540
49578007@N05,3888,18,1416737286,1416737826,1,1,540
49578007@N05,3889,19,1417090383,1417090923,1,1,540
49578007@N05,3890,18,1417271788,1417272328,1,1,540
49578007@N05,3891,13,1417341207,1417341507,1,1,300
49578007@N05,3892,24,1420097396,1420098896,1,1,1500
49578007@N05,3893,13,1424065111,1424065411,1,1,300
49578007@N05,3894,23,1432389170,1432390370,1,1,1200
49578007@N05,3895,10,1435895208,1435895358,1,1,150
49578007@N05,3896,22,1436003699,1436004719,1,1,1020
49578007@N05,3897,18,1443936239,1443936779,2,3,540
49578007@N05,3897,11,1443941263,1443941503,2,3,240
49578007@N05,3897,14,1443948370,1443948730,1,3,360
49578007@N05,3898,19,1452952131,1452952671,1,1,540
49578007@N05,3899,18,1453531822,1453532362,1,1,540
49603119@N00,3900,7,1392169193,1392169313,1,1,120
49657535@N06,3901,11,1287226940,1287227180,1,1,240
49672116@N07,3902,11,1319258841,1319259081,1,1,240
49693311@N02,3903,17,1242889984,1242890404,1,1,420
49693311@N02,3904,6,1248952348,1248952468,1,1,120
49693311@N02,3905,7,1271584457,1271584577,2,1,120
49768774@N02,3906,5,1416280199,1416280319,1,1,120
49780897@N07,3907,19,1317979141,1317979681,1,1,540
49780897@N07,3908,19,1323508768,1323509308,1,1,540
49780897@N07,3909,19,1323575267,1323575807,1,1,540
49780897@N07,3910,16,1331441918,1331442338,1,1,420
49782462@N00,3911,14,1419245135,1419245495,1,1,360
49787688@N02,3912,11,1332076716,1332076956,1,1,240
49858236@N04,3913,12,1323299433,1323299703,2,12,270
49858236@N04,3913,17,1323318809,1323319229,6,12,420
49858236@N04,3913,19,1323319557,1323320087,6,12,530
49858236@N04,3913,11,1323320087,1323320327,15,12,240
49858236@N04,3913,7,1323323017,1323323137,6,12,120
49858236@N04,3913,11,1323323137,1323323377,7,12,240
49858236@N04,3913,18,1323324353,1323324893,8,12,540
49858236@N04,3913,1,1323326508,1323326538,2,12,30
49858236@N04,3913,18,1323326538,1323327078,24,12,540
49858236@N04,3913,20,1323330582,1323330682,4,12,100
49858236@N04,3913,4,1323330682,1323330772,2,12,90
49858236@N04,3913,21,1323330892,1323331792,7,12,900
49858236@N04,3914,23,1324433494,1324434694,2,9,1200
49858236@N04,3914,7,1324434774,1324434894,43,9,120
49858236@N04,3914,17,1324439275,1324439695,20,9,420
49858236@N04,3914,12,1324440318,1324440588,8,9,270
49858236@N04,3914,22,1324464034,1324464208,3,9,174
49858236@N04,3914,13,1324464208,1324464508,7,9,300
49858236@N04,3914,25,1324465439,1324465779,4,9,340
49858236@N04,3914,24,1324465779,1324466760,2,9,981
49858236@N04,3914,12,1324466760,1324467030,1,9,270
49858236@N04,3915,7,1331356510,1331356630,2,2,120
49858236@N04,3915,16,1331357159,1331357579,2,2,420
49876360@N07,3916,18,1392513642,1392514182,4,4,540
49876360@N07,3916,11,1392514272,1392514512,2,4,240
49876360@N07,3916,23,1392514746,1392515946,3,4,1200
49876360@N07,3916,19,1392527013,1392527553,1,4,540
49876360@N07,3917,10,1393063806,1393063956,1,1,150
49876360@N07,3918,16,1394347280,1394347700,3,1,420
49876360@N07,3919,18,1399083263,1399083803,2,2,540
49876360@N07,3919,14,1399086832,1399087192,1,2,360
49876360@N07,3920,14,1403321058,1403321418,1,1,360
49876360@N07,3921,6,1459572561,1459572681,1,1,120
49887039@N04,3922,23,1313831974,1313833174,2,3,1200
49887039@N04,3922,22,1313838911,1313839931,2,3,1020
49887039@N04,3922,16,1313844018,1313844438,7,3,420
49887039@N04,3923,17,1313895051,1313895471,2,6,420
49887039@N04,3923,12,1313895484,1313895754,2,6,270
49887039@N04,3923,25,1313896772,1313896829,2,6,57
49887039@N04,3923,13,1313896829,1313897129,2,6,300
49887039@N04,3923,4,1313897272,1313897307,2,6,35
49887039@N04,3923,20,1313897307,1313897907,1,6,600
49887039@N04,3924,16,1313968888,1313969308,2,1,420
49887039@N04,3925,16,1340899238,1340899658,1,1,420
49887039@N04,3926,17,1340971688,1340972108,1,1,420
49887039@N04,3927,17,1341056987,1341057407,1,1,420
49887039@N04,3928,4,1341309264,1341309354,1,1,90
49887039@N04,3929,16,1341844755,1341845175,1,1,420
49897362@N02,3930,12,1288059224,1288059247,2,2,23
49897362@N02,3930,24,1288059247,1288060747,2,2,1500
49897362@N02,3931,15,1288088477,1288088837,4,1,360
50038815@N08,3932,16,1319893476,1319893896,14,1,420
50038815@N08,3933,14,1376171057,1376171417,4,2,360
50038815@N08,3933,10,1376173327,1376173477,6,2,150
50038815@N08,3934,24,1395778562,1395778903,2,2,341
50038815@N08,3934,12,1395778903,1395779173,2,2,270
50038815@N08,3935,6,1400771731,1400771851,2,5,120
50038815@N08,3935,2,1400772039,1400772099,3,5,60
50038815@N08,3935,19,1400784351,1400784891,3,5,540
50038815@N08,3935,23,1400786224,1400786939,4,5,715
50038815@N08,3935,17,1400786939,1400787359,1,5,420
50038815@N08,3936,6,1464994063,1464994183,2,5,120
50038815@N08,3936,12,1464997338,1464997608,2,5,270
50038815@N08,3936,25,1465018414,1465020514,2,5,2100
50038815@N08,3936,13,1465028163,1465028463,2,5,300
50038815@N08,3936,19,1465030057,1465030597,1,5,540
50053632@N04,3937,5,1302948266,1302948386,1,1,120
50069634@N06,3938,12,1340151903,1340152173,2,2,270
50069634@N06,3938,14,1340157750,1340158110,1,2,360
50198110@N00,3939,17,1297947603,1297948023,2,1,420
50267281@N07,3940,24,1346329366,1346330866,1,1,1500
50267281@N07,3941,24,1357245944,1357247444,1,1,1500
50267281@N07,3942,24,1372893802,1372895302,15,1,1500
50267281@N07,3943,24,1373106608,1373108108,1,1,1500
50267281@N07,3944,17,1431698610,1431699030,1,1,420
50267281@N07,3945,17,1448535152,1448535572,1,1,420
50267281@N07,3946,16,1452973836,1452974256,2,5,420
50267281@N07,3946,6,1452974513,1452974541,2,5,28
50267281@N07,3946,19,1452974541,1452974740,2,5,199
50267281@N07,3946,25,1452974740,1452974886,2,5,146
50267281@N07,3946,15,1452974886,1452975246,1,5,360
50267281@N07,3947,24,1453007979,1453008860,9,3,881
50267281@N07,3947,16,1453008860,1453009049,2,3,189
50267281@N07,3947,24,1453009049,1453010549,6,3,1500
50267281@N07,3948,24,1453062491,1453063991,11,4,1500
50267281@N07,3948,13,1453065183,1453065201,2,4,18
50267281@N07,3948,24,1453065201,1453066444,7,4,1243
50267281@N07,3948,12,1453066444,1453066714,1,4,270
50267281@N07,3949,6,1459461841,1459461961,45,1,120
50461532@N03,3950,12,1330766257,1330766527,1,1,270
50461532@N03,3951,23,1353715783,1353716983,1,1,1200
50461532@N03,3952,19,1362797359,1362797899,2,1,540
50461532@N03,3953,18,1367739811,1367740351,1,1,540
50500517@N03,3954,15,1275995750,1275995895,2,2,145
50500517@N03,3954,17,1275995895,1275996315,3,2,420
50500517@N03,3955,17,1276140317,1276140737,3,2,420
50500517@N03,3955,12,1276140793,1276141063,1,2,270
50507957@N04,3956,24,1376295868,1376297368,1,1,1500
50514859@N00,3957,5,1230025340,1230025460,1,1,120
50514859@N00,3958,18,1259366472,1259367012,1,1,540
50514859@N00,3959,5,1357024399,1357024519,1,1,120
50519631@N03,3960,24,1297416686,1297418186,4,2,1500
50519631@N03,3960,16,1297420549,1297420969,1,2,420
50519631@N03,3961,7,1314923528,1314923648,2,1,120
50576036@N00,3962,12,1350785384,1350785654,2,1,270
50576036@N00,3963,14,1365811870,1365812230,2,1,360
50576036@N00,3964,20,1380961780,1380962380,1,1,600
50576036@N00,3965,14,1381015729,1381016089,1,1,360
50616872@N07,3966,4,1441283912,1441284002,2,7,90
50616872@N07,3966,19,1441284336,1441284503,2,7,167
50616872@N07,3966,23,1441284503,1441284680,2,7,177
50616872@N07,3966,14,1441284680,1441284818,2,7,138
50616872@N07,3966,17,1441284818,1441284941,2,7,123
50616872@N07,3966,13,1441284941,1441285096,2,7,155
50616872@N07,3966,17,1441285096,1441285516,1,7,420
50637361@N07,3967,18,1336092230,1336092770,1,1,540
50661799@N02,3968,14,1394595039,1394595399,2,3,360
50661799@N02,3968,16,1394596524,1394596944,2,3,420
50661799@N02,3968,10,1394597286,1394597436,1,3,150
50661799@N02,3969,14,1395128675,1395129035,1,1,360
50674744@N07,3970,12,1277289632,1277289902,2,2,270
50674744@N07,3970,10,1277294116,1277294266,1,2,150
50751757@N00,3971,15,1279675742,1279676102,3,3,360
50751757@N00,3971,13,1279702905,1279702925,5,3,20
50751757@N00,3971,12,1279702925,1279703195,1,3,270
50751757@N00,3972,22,1279853627,1279854647,11,4,1020
50751757@N00,3972,19,1279874080,1279874620,2,4,540
50751757@N00,3972,15,1279876389,1279876749,2,4,360
50751757@N00,3972,16,1279880139,1279880559,62,4,420
50751757@N00,3973,24,1279934659,1279934839,2,17,180
50751757@N00,3973,23,1279934839,1279936039,16,17,1200
50751757@N00,3973,7,1279936849,1279936969,9,17,120
50751757@N00,3973,3,1279937559,1279937649,5,17,90
50751757@N00,3973,10,1279939764,1279939767,2,17,3
50751757@N00,3973,1,1279939767,1279939777,2,17,10
50751757@N00,3973,18,1279939777,1279939788,3,17,11
50751757@N00,3973,1,1279939788,1279939848,5,17,60
50751757@N00,3973,18,1279939873,1279939876,2,17,3
50751757@N00,3973,1,1279939876,1279939936,3,17,60
50751757@N00,3973,4,1279943319,1279943409,2,17,90
50751757@N00,3973,17,1279944593,1279945013,3,17,420
50751757@N00,3973,16,1279947814,1279947891,3,17,77
50751757@N00,3973,12,1279947891,1279948161,3,17,270
50751757@N00,3973,24,1279952509,1279954009,2,17,1500
50751757@N00,3973,25,1279956751,1279958851,2,17,2100
50751757@N00,3973,24,1279960990,1279962490,32,17,1500
50795446@N00,3974,17,1197356653,1197357073,10,1,420
50833122@N00,3975,19,1200287855,1200288395,1,1,540
50892381@N00,3976,16,1290589863,1290590283,2,1,420
50903038@N00,3977,3,1276740021,1276740111,3,12,90
50903038@N00,3977,10,1276740402,1276740552,2,12,150
50903038@N00,3977,20,1276740939,1276740982,2,12,43
50903038@N00,3977,12,1276740982,1276741252,2,12,270
50903038@N00,3977,17,1276741768,1276742188,4,12,420
50903038@N00,3977,20,1276743861,1276744461,4,12,600
50903038@N00,3977,24,1276745714,1276745961,3,12,247
50903038@N00,3977,13,1276745961,1276746261,2,12,300
50903038@N00,3977,7,1276752739,1276752859,3,12,120
50903038@N00,3977,18,1276753537,1276754077,3,12,540
50903038@N00,3977,7,1276757120,1276757240,2,12,120
50903038@N00,3977,15,1276759116,1276759476,1,12,360
50941887@N02,3978,11,1301481376,1301481616,1,1,240
50941887@N02,3979,7,1301517785,1301517905,1,1,120
50972822@N08,3980,6,1388351999,1388352119,8,20,120
50972822@N08,3980,24,1388353021,1388353025,2,20,4
50972822@N08,3980,14,1388353025,1388353385,7,20,360
50972822@N08,3980,8,1388353538,1388353658,3,20,120
50972822@N08,3980,6,1388353829,1388353949,2,20,120
50972822@N08,3980,17,1388355612,1388355620,2,20,8
50972822@N08,3980,7,1388355620,1388355740,16,20,120
50972822@N08,3980,18,1388356706,1388357246,5,20,540
50972822@N08,3980,16,1388357891,1388357897,2,20,6
50972822@N08,3980,18,1388357897,1388358437,11,20,540
50972822@N08,3980,14,1388361386,1388361746,4,20,360
50972822@N08,3980,11,1388363080,1388363320,5,20,240
50972822@N08,3980,17,1388366116,1388366391,13,20,275
50972822@N08,3980,23,1388366391,1388367591,3,20,1200
50972822@N08,3980,17,1388374161,1388374581,5,20,420
50972822@N08,3980,3,1388377338,1388377428,2,20,90
50972822@N08,3980,10,1388378695,1388378845,8,20,150
50972822@N08,3980,20,1388380209,1388380647,3,20,438
50972822@N08,3980,24,1388380647,1388381293,3,20,646
50972822@N08,3980,17,1388381293,1388381713,2,20,420
51007277@N08,3981,24,1406711058,1406712558,1,1,1500
51035569202@N01,3982,24,1257901661,1257903161,1,1,1500
51035623812@N01,3983,10,1347582381,1347582531,1,1,150
51035626656@N01,3984,22,1252487312,1252488065,4,2,753
51035626656@N01,3984,13,1252488065,1252488365,34,2,300
51035626656@N01,3985,13,1252814675,1252814975,1,1,300
51035626656@N01,3986,13,1253323555,1253323855,1,1,300
51035708949@N01,3987,19,1211939934,1211940474,11,8,540
51035708949@N01,3987,24,1211941975,1211943475,10,8,1500
51035708949@N01,3987,13,1211946124,1211946424,3,8,300
51035708949@N01,3987,24,1211947743,1211949243,9,8,1500
51035708949@N01,3987,8,1211950288,1211950408,2,8,120
51035708949@N01,3987,16,1211950876,1211951296,3,8,420
51035708949@N01,3987,3,1211952775,1211952865,3,8,90
51035708949@N01,3987,6,1211953642,1211953762,1,8,120
51035708949@N01,3988,3,1395199573,1395199663,4,2,90
51035708949@N01,3988,23,1395224756,1395225956,2,2,1200
51035708949@N01,3989,4,1395303423,1395303513,8,4,90
51035708949@N01,3989,9,1395304654,1395304774,2,4,120
51035708949@N01,3989,8,1395305375,1395305495,3,4,120
51035708949@N01,3989,6,1395309287,1395309407,1,4,120
51035708949@N01,3990,19,1395348043,1395348089,3,10,46
51035708949@N01,3990,14,1395348089,1395348449,16,10,360
51035708949@N01,3990,16,1395358120,1395358540,4,10,420
51035708949@N01,3990,9,1395359634,1395359754,4,10,120
51035708949@N01,3990,8,1395360424,1395360544,8,10,120
51035708949@N01,3990,19,1395364818,1395365358,3,10,540
51035708949@N01,3990,23,1395366339,1395367539,4,10,1200
51035708949@N01,3990,10,1395367707,1395367857,5,10,150
51035708949@N01,3990,6,1395370005,1395370125,5,10,120
51035708949@N01,3990,14,1395371840,1395372200,3,10,360
51035737861@N01,3991,25,1191720099,1191722199,2,7,2100
51035737861@N01,3991,11,1191723277,1191723517,2,7,240
51035737861@N01,3991,6,1191724027,1191724147,3,7,120
51035737861@N01,3991,15,1191731971,1191732331,8,7,360
51035737861@N01,3991,7,1191735175,1191735295,2,7,120
51035737861@N01,3991,18,1191736027,1191736567,6,7,540
51035737861@N01,3991,12,1191744756,1191745026,2,7,270
51037533@N00,3992,15,1342604687,1342605047,1,1,360
51037533@N00,3993,14,1416644659,1416645019,1,1,360
51064846@N07,3994,20,1405475163,1405475763,2,4,600
51064846@N07,3994,6,1405481739,1405481859,2,4,120
51064846@N07,3994,16,1405482034,1405482454,2,4,420
51064846@N07,3994,22,1405491559,1405492579,1,4,1020
51064846@N07,3995,14,1441066217,1441066577,2,7,360
51064846@N07,3995,6,1441069148,1441069268,2,7,120
51064846@N07,3995,16,1441069487,1441069907,2,7,420
51064846@N07,3995,7,1441070827,1441070947,2,7,120
51064846@N07,3995,6,1441077008,1441077128,2,7,120
51064846@N07,3995,22,1441077794,1441078814,2,7,1020
51064846@N07,3995,12,1441097546,1441097816,2,7,270
51074282@N08,3996,24,1298163344,1298164844,7,1,1500
51074282@N08,3997,24,1298205978,1298207478,1,1,1500
51074282@N08,3998,24,1298373817,1298375317,1,1,1500
51075626@N00,3999,12,1417918165,1417918435,1,1,270
51075626@N00,4000,17,1435130768,1435131188,1,1,420
51098012@N02,4001,6,1357695337,1357695457,1,1,120
51151458@N02,4002,13,1382789225,1382789525,1,1,300
51172115@N00,4003,14,1367023573,1367023933,4,1,360
51178640@N00,4004,24,1453771183,1453771224,3,5,41
51178640@N00,4004,13,1453771224,1453771524,11,5,300
51178640@N00,4004,8,1453771868,1453771988,2,5,120
51178640@N00,4004,14,1453772005,1453772365,3,5,360
51178640@N00,4004,12,1453778771,1453779041,1,5,270
51205683@N00,4005,7,1297298623,1297298743,3,2,120
51205683@N00,4005,16,1297302410,1297302830,1,2,420
51205683@N00,4006,24,1361312878,1361314378,2,3,1500
51205683@N00,4006,6,1361315030,1361315150,2,3,120
51205683@N00,4006,7,1361340845,1361340965,1,3,120
51311897@N00,4007,19,1340956901,1340957441,2,3,540
51311897@N00,4007,8,1340973673,1340973793,2,3,120
51311897@N00,4007,16,1340977376,1340977796,3,3,420
51311897@N00,4008,24,1362268313,1362269813,2,1,1500
51311897@N00,4009,6,1362886547,1362886667,9,3,120
51311897@N00,4009,8,1362886797,1362886917,5,3,120
51311897@N00,4009,6,1362886929,1362887049,32,3,120
51311897@N00,4010,10,1363925188,1363925338,6,4,150
51311897@N00,4010,5,1363926156,1363926246,7,4,90
51311897@N00,4010,7,1363926246,1363926366,8,4,120
51311897@N00,4010,25,1363929883,1363931983,14,4,2100
51311897@N00,4011,21,1365297072,1365297372,6,5,300
51311897@N00,4011,4,1365297372,1365297462,14,5,90
51311897@N00,4011,21,1365298988,1365299274,12,5,286
51311897@N00,4011,4,1365299274,1365299364,14,5,90
51311897@N00,4011,24,1365318004,1365319504,6,5,1500
51311897@N00,4012,16,1369635744,1369636164,6,1,420
51311897@N00,4013,25,1372137198,1372138675,8,4,1477
51311897@N00,4013,6,1372138675,1372138795,18,4,120
51311897@N00,4013,16,1372144875,1372145295,3,4,420
51311897@N00,4013,7,1372153261,1372153381,11,4,120
51311897@N00,4014,4,1377408426,1377408516,13,1,90
51311897@N00,4015,12,1390545612,1390545882,14,4,270
51311897@N00,4015,7,1390548513,1390548633,2,4,120
51311897@N00,4015,18,1390549324,1390549864,3,4,540
51311897@N00,4015,7,1390551132,1390551252,4,4,120
51311897@N00,4016,10,1409278744,1409278894,6,2,150
51311897@N00,4016,24,1409279647,1409281147,5,2,1500
51311897@N00,4017,24,1409313446,1409314946,9,1,1500
51311897@N00,4018,1,1414223290,1414223350,4,2,60
51311897@N00,4018,16,1414224070,1414224490,2,2,420
51311897@N00,4019,2,1418796369,1418796429,5,2,60
51311897@N00,4019,25,1418802277,1418804377,1,2,2100
51311897@N00,4020,4,1424062572,1424062662,17,2,90
51311897@N00,4020,10,1424073326,1424073476,20,2,150
51311897@N00,4021,4,1425787168,1425787258,7,2,90
51311897@N00,4021,21,1425787563,1425788463,3,2,900
51311897@N00,4022,22,1441327099,1441328119,2,9,1020
51311897@N00,4022,25,1441329200,1441330450,20,9,1250
51311897@N00,4022,24,1441330450,1441331950,9,9,1500
51311897@N00,4022,7,1441333065,1441333185,4,9,120
51311897@N00,4022,18,1441333608,1441333754,9,9,146
51311897@N00,4022,7,1441333754,1441333874,20,9,120
51311897@N00,4022,18,1441334074,1441334349,14,9,275
51311897@N00,4022,7,1441334349,1441334469,18,9,120
51311897@N00,4022,10,1441353854,1441354004,13,9,150
51337479@N00,4023,24,1390558776,1390560276,1,1,1500
51337479@N00,4024,24,1396868626,1396870126,1,1,1500
51390829@N07,4025,16,1317776747,1317777167,3,1,420
51427230@N02,4026,24,1284084503,1284085199,3,18,696
51427230@N02,4026,25,1284085199,1284085446,2,18,247
51427230@N02,4026,13,1284085446,1284085554,2,18,108
51427230@N02,4026,23,1284085554,1284086232,2,18,678
51427230@N02,4026,22,1284086232,1284086341,2,18,109
51427230@N02,4026,25,1284086341,1284086876,5,18,535
51427230@N02,4026,24,1284086876,1284087453,2,18,577
51427230@N02,4026,10,1284087453,1284087603,2,18,150
51427230@N02,4026,18,1284087793,1284088262,2,18,469
51427230@N02,4026,5,1284088262,1284088382,2,18,120
51427230@N02,4026,10,1284088455,1284088531,2,18,76
51427230@N02,4026,5,1284088531,1284088651,2,18,120
51427230@N02,4026,8,1284091860,1284091980,2,18,120
51427230@N02,4026,2,1284092963,1284093023,2,18,60
51427230@N02,4026,15,1284093054,1284093301,2,18,247
51427230@N02,4026,4,1284093301,1284093391,5,18,90
51427230@N02,4026,19,1284093865,1284094340,2,18,475
51427230@N02,4026,11,1284094340,1284094580,1,18,240
51427230@N02,4027,10,1284207382,1284207532,2,3,150
51427230@N02,4027,17,1284208998,1284209125,2,3,127
51427230@N02,4027,12,1284209125,1284209395,2,3,270
51427230@N02,4028,12,1284273276,1284273546,2,5,270
51427230@N02,4028,24,1284277258,1284278758,2,5,1500
51427230@N02,4028,23,1284279891,1284280125,6,5,234
51427230@N02,4028,17,1284280125,1284280308,2,5,183
51427230@N02,4028,23,1284280308,1284281508,1,5,1200
51494301@N02,4029,11,1285742864,1285743104,1,1,240
51579041@N00,4030,12,1246528540,1246528810,1,1,270
51588699@N00,4031,16,1322179256,1322179676,1,1,420
51588699@N00,4032,17,1323572930,1323573350,2,2,420
51588699@N00,4032,13,1323587464,1323587764,1,2,300
51588699@N00,4033,14,1350093776,1350094136,1,1,360
51594114@N04,4034,4,1336899362,1336899452,1,1,90
51652132@N04,4035,14,1391292266,1391292626,10,14,360
51652132@N04,4035,8,1391295348,1391295468,15,14,120
51652132@N04,4035,14,1391297404,1391297764,3,14,360
51652132@N04,4035,19,1391298423,1391298490,2,14,67
51652132@N04,4035,14,1391298490,1391298628,3,14,138
51652132@N04,4035,16,1391298628,1391299048,11,14,420
51652132@N04,4035,23,1391299818,1391299956,2,14,138
51652132@N04,4035,17,1391299956,1391300376,2,14,420
51652132@N04,4035,24,1391301571,1391303071,8,14,1500
51652132@N04,4035,6,1391306300,1391306420,2,14,120
51652132@N04,4035,15,1391307286,1391307646,19,14,360
51652132@N04,4035,17,1391311332,1391311752,2,14,420
51652132@N04,4035,14,1391312010,1391312370,6,14,360
51652132@N04,4035,12,1391316848,1391317118,1,14,270
51652132@N04,4036,17,1423772427,1423772847,2,3,420
51652132@N04,4036,14,1423773579,1423773601,2,3,22
51652132@N04,4036,19,1423773601,1423774141,1,3,540
51652132@N04,4037,16,1423822582,1423823002,8,1,420
51652132@N04,4038,23,1423867342,1423868542,2,5,1200
51652132@N04,4038,17,1423874406,1423874759,2,5,353
51652132@N04,4038,19,1423874759,1423875299,3,5,540
51652132@N04,4038,25,1423898499,1423900599,4,5,2100
51652132@N04,4038,15,1423901764,1423902124,2,5,360
51652132@N04,4039,17,1446008475,1446008895,3,1,420
51652132@N04,4040,16,1446455514,1446455934,13,2,420
51652132@N04,4040,17,1446457765,1446458185,2,2,420
51652132@N04,4041,13,1446518969,1446519269,4,3,300
51652132@N04,4041,24,1446522465,1446523965,2,3,1500
51652132@N04,4041,17,1446547699,1446548119,2,3,420
51652132@N04,4042,24,1446597103,1446598603,4,2,1500
51652132@N04,4042,12,1446603361,1446603631,1,2,270
51731902@N03,4043,11,1223036758,1223036998,1,1,240
51744687@N00,4044,5,1392343694,1392343814,1,1,120
51903736@N00,4045,17,1272889916,1272890336,17,2,420
51903736@N00,4045,12,1272895182,1272895452,4,2,270
51903736@N00,4046,24,1273069836,1273071336,14,6,1500
51903736@N00,4046,13,1273073363,1273073663,11,6,300
51903736@N00,4046,22,1273074944,1273075964,14,6,1020
51903736@N00,4046,7,1273082258,1273082378,13,6,120
51903736@N00,4046,18,1273086721,1273087261,9,6,540
51903736@N00,4046,3,1273089262,1273089352,1,6,90
51968610@N05,4047,24,1231047761,1231049261,2,1,1500
51968610@N05,4048,24,1235970206,1235971706,1,1,1500
51968610@N05,4049,24,1242529267,1242530767,4,5,1500
51968610@N05,4049,25,1242546276,1242546302,2,5,26
51968610@N05,4049,24,1242546302,1242546543,3,5,241
51968610@N05,4049,25,1242546543,1242546811,2,5,268
51968610@N05,4049,24,1242546811,1242548311,9,5,1500
51968610@N05,4050,20,1265591883,1265592482,2,4,599
51968610@N05,4050,19,1265592482,1265593022,2,4,540
51968610@N05,4050,6,1265597193,1265597313,2,4,120
51968610@N05,4050,8,1265606749,1265606869,1,4,120
51968610@N05,4051,19,1278927202,1278927742,1,1,540
52015062@N00,4052,25,1325590077,1325590859,8,3,782
52015062@N00,4052,19,1325590859,1325591399,15,3,540
52015062@N00,4052,25,1325591618,1325593718,1,3,2100
52015062@N00,4053,5,1357080512,1357080632,2,6,120
52015062@N00,4053,14,1357083834,1357084194,2,6,360
52015062@N00,4053,13,1357085123,1357085129,2,6,6
52015062@N00,4053,25,1357085129,1357087229,2,6,2100
52015062@N00,4053,24,1357087345,1357087639,2,6,294
52015062@N00,4053,25,1357087639,1357089739,4,6,2100
52015062@N00,4054,12,1357157572,1357157842,2,6,270
52015062@N00,4054,14,1357162952,1357163312,3,6,360
52015062@N00,4054,24,1357179593,1357181093,2,6,1500
52015062@N00,4054,25,1357181405,1357181551,4,6,146
52015062@N00,4054,22,1357181551,1357182571,2,6,1020
52015062@N00,4054,25,1357184329,1357186429,1,6,2100
52015062@N00,4055,14,1357244412,1357244772,1,1,360
52015062@N00,4056,6,1360580556,1360580676,1,1,120
52111728@N00,4057,3,1402749636,1402749726,1,1,90
52111728@N00,4058,19,1412412371,1412412911,1,1,540
52111728@N00,4059,16,1461891190,1461891610,1,1,420
52179512@N00,4060,23,1219460868,1219462068,2,3,1200
52179512@N00,4060,5,1219462863,1219462983,4,3,120
52179512@N00,4060,15,1219470992,1219471352,1,3,360
52192784@N08,4061,17,1284796711,1284797131,14,1,420
52192784@N08,4062,16,1443244695,1443245115,2,3,420
52192784@N08,4062,8,1443246178,1443246298,2,3,120
52192784@N08,4062,14,1443248998,1443249358,3,3,360
52230032@N08,4063,16,1310918600,1310919020,1,1,420
52255826@N04,4064,2,1300331219,1300331279,2,4,60
52255826@N04,4064,20,1300331387,1300331553,2,4,166
52255826@N04,4064,8,1300331553,1300331673,2,4,120
52255826@N04,4064,19,1300351386,1300351926,2,4,540
52255826@N04,4065,19,1300420059,1300420599,1,1,540
52378595@N06,4066,22,1295704133,1295705153,1,1,1020
52443338@N05,4067,6,1451430332,1451430452,2,4,120
52443338@N05,4067,19,1451435806,1451436346,2,4,540
52443338@N05,4067,6,1451438770,1451438890,2,4,120
52443338@N05,4067,19,1451443945,1451444485,2,4,540
52447507@N06,4068,18,1415145136,1415145676,2,8,540
52447507@N06,4068,7,1415146914,1415147034,4,8,120
52447507@N06,4068,5,1415148186,1415148306,2,8,120
52447507@N06,4068,7,1415148921,1415149041,2,8,120
52447507@N06,4068,16,1415149070,1415149490,2,8,420
52447507@N06,4068,10,1415149670,1415149820,2,8,150
52447507@N06,4068,3,1415152481,1415152571,2,8,90
52447507@N06,4068,14,1415157409,1415157769,3,8,360
52447507@N06,4069,11,1415261855,1415262095,1,1,240
52447507@N06,4070,14,1415320147,1415320507,5,5,360
52447507@N06,4070,6,1415322754,1415322874,2,5,120
52447507@N06,4070,14,1415343465,1415343531,2,5,66
52447507@N06,4070,19,1415343531,1415344071,2,5,540
52447507@N06,4070,14,1415344820,1415345180,1,5,360
52454187@N07,4071,10,1292395177,1292395327,2,3,150
52454187@N07,4071,16,1292397552,1292397972,2,3,420
52454187@N07,4071,23,1292398128,1292399328,2,3,1200
52496627@N03,4072,7,1364003945,1364004065,2,1,120
52496627@N03,4073,16,1364036712,1364037132,1,1,420
52571731@N05,4074,4,1356224534,1356224624,2,5,90
52571731@N05,4074,22,1356242686,1356243706,3,5,1020
52571731@N05,4074,13,1356249983,1356250283,2,5,300
52571731@N05,4074,16,1356251815,1356252235,2,5,420
52571731@N05,4074,11,1356252517,1356252757,1,5,240
52571731@N05,4075,19,1388276604,1388277144,2,5,540
52571731@N05,4075,14,1388280043,1388280403,2,5,360
52571731@N05,4075,6,1388280520,1388280640,2,5,120
52571731@N05,4075,15,1388285745,1388286105,3,5,360
52571731@N05,4075,14,1388301948,1388302308,1,5,360
52592482@N03,4076,18,1408249343,1408249883,1,1,540
52592482@N03,4077,11,1408279111,1408279351,1,1,240
52615621@N07,4078,8,1467768198,1467768318,2,11,120
52615621@N07,4078,4,1467772938,1467773028,4,11,90
52615621@N07,4078,13,1467774612,1467774850,4,11,238
52615621@N07,4078,22,1467774850,1467774888,2,11,38
52615621@N07,4078,13,1467774888,1467775188,21,11,300
52615621@N07,4078,16,1467780176,1467780596,27,11,420
52615621@N07,4078,6,1467787584,1467787704,2,11,120
52615621@N07,4078,14,1467789975,1467790335,2,11,360
52615621@N07,4078,6,1467791171,1467791223,3,11,52
52615621@N07,4078,20,1467791223,1467791329,3,11,106
52615621@N07,4078,24,1467791329,1467792829,7,11,1500
52615621@N07,4079,18,1467848476,1467848483,3,5,7
52615621@N07,4079,7,1467848483,1467848603,5,5,120
52615621@N07,4079,18,1467851546,1467852086,6,5,540
52615621@N07,4079,5,1467853254,1467853374,2,5,120
52615621@N07,4079,16,1467854365,1467854785,1,5,420
52650694@N06,4080,10,1326880793,1326880943,1,1,150
52650694@N06,4081,15,1326972032,1326972392,1,1,360
52654544@N00,4082,15,1197763781,1197764141,3,2,360
52654544@N00,4082,19,1197769677,1197770217,1,2,540
52654544@N00,4083,25,1197853092,1197855192,1,1,2100
52654544@N00,4084,19,1211085479,1211086019,8,9,540
52654544@N00,4084,7,1211086574,1211086574,2,9,0
52654544@N00,4084,19,1211086574,1211086596,2,9,22
52654544@N00,4084,7,1211086596,1211086596,2,9,0
52654544@N00,4084,19,1211086596,1211086880,2,9,284
52654544@N00,4084,1,1211086880,1211086940,2,9,60
52654544@N00,4084,19,1211087254,1211087287,2,9,33
52654544@N00,4084,17,1211087287,1211087326,2,9,39
52654544@N00,4084,19,1211087326,1211087866,6,9,540
52654544@N00,4085,19,1227398920,1227399460,2,1,540
52658090@N06,4086,9,1357361315,1357361435,5,2,120
52658090@N06,4086,8,1357375367,1357375487,1,2,120
52683902@N07,4087,14,1428668291,1428668651,2,2,360
52683902@N07,4087,8,1428668695,1428668815,1,2,120
52798516@N00,4088,12,1455424031,1455424301,1,1,270
52812594@N00,4089,15,1320984375,1320984735,1,1,360
52812594@N00,4090,19,1335592115,1335592655,1,1,540
52812594@N00,4091,17,1358551256,1358551265,2,3,9
52812594@N00,4091,15,1358551265,1358551280,2,3,15
52812594@N00,4091,1,1358551280,1358551340,3,3,60
52822882@N07,4092,12,1356845624,1356845894,1,1,270
52854532@N06,4093,17,1432450580,1432451000,1,1,420
52862228@N06,4094,18,1316366018,1316366558,1,1,540
52892088@N02,4095,14,1354186954,1354187314,4,3,360
52892088@N02,4095,11,1354188877,1354189117,3,3,240
52892088@N02,4095,12,1354190793,1354191063,1,3,270
52914491@N03,4096,24,1376022478,1376023978,1,1,1500
52914491@N03,4097,24,1376132117,1376133617,1,1,1500
52946269@N00,4098,19,1432711649,1432712189,1,1,540
53054066@N02,4099,19,1404740422,1404740962,2,2,540
53054066@N02,4099,14,1404745386,1404745746,1,2,360
53076272@N06,4100,20,1395860804,1395861404,1,1,600
53139290@N08,4101,11,1330101450,1330101690,5,3,240
53139290@N08,4101,12,1330104753,1330105023,2,3,270
53139290@N08,4101,6,1330105521,1330105641,1,3,120
53139290@N08,4102,13,1330198902,1330199202,12,1,300
53139290@N08,4103,7,1377817931,1377818051,3,1,120
53139290@N08,4104,7,1377909416,1377909536,1,1,120
53203629@N00,4105,3,1376118424,1376118514,1,1,90
53348255@N06,4106,12,1338025999,1338026269,1,1,270
53348255@N06,4107,19,1343965330,1343965870,1,1,540
53351535@N02,4108,7,1290638736,1290638856,1,1,120
53365974@N00,4109,19,1351301326,1351301866,7,31,540
53365974@N00,4109,6,1351304425,1351304545,3,31,120
53365974@N00,4109,20,1351304600,1351304683,2,31,83
53365974@N00,4109,12,1351304683,1351304953,2,31,270
53365974@N00,4109,24,1351306038,1351307538,4,31,1500
53365974@N00,4109,19,1351320781,1351320985,5,31,204
53365974@N00,4109,14,1351320985,1351321172,3,31,187
53365974@N00,4109,19,1351321172,1351321712,2,31,540
53365974@N00,4109,6,1351321841,1351321961,5,31,120
53365974@N00,4109,19,1351322690,1351322866,2,31,176
53365974@N00,4109,16,1351322866,1351323007,6,31,141
53365974@N00,4109,11,1351323007,1351323215,2,31,208
53365974@N00,4109,7,1351323215,1351323335,2,31,120
53365974@N00,4109,11,1351325137,1351325377,2,31,240
53365974@N00,4109,20,1351325423,1351326023,2,31,600
53365974@N00,4109,24,1351327294,1351327347,2,31,53
53365974@N00,4109,20,1351327347,1351327947,4,31,600
53365974@N00,4109,24,1351328400,1351329900,5,31,1500
53365974@N00,4109,20,1351331569,1351332169,2,31,600
53365974@N00,4109,24,1351335625,1351335817,5,31,192
53365974@N00,4109,20,1351335817,1351335836,2,31,19
53365974@N00,4109,24,1351335836,1351336616,4,31,780
53365974@N00,4109,16,1351336616,1351337036,4,31,420
53365974@N00,4109,18,1351337169,1351337475,3,31,306
53365974@N00,4109,7,1351337475,1351337595,3,31,120
53365974@N00,4109,19,1351338448,1351338988,3,31,540
53365974@N00,4109,14,1351339240,1351339600,3,31,360
53365974@N00,4109,19,1351341917,1351342029,2,31,112
53365974@N00,4109,14,1351342029,1351342088,3,31,59
53365974@N00,4109,19,1351342088,1351342303,3,31,215
53365974@N00,4109,24,1351342303,1351343803,1,31,1500
53365974@N00,4110,22,1391225026,1391225091,2,13,65
53365974@N00,4110,25,1391225091,1391227191,3,13,2100
53365974@N00,4110,15,1391231573,1391231723,2,13,150
53365974@N00,4110,2,1391231723,1391231783,3,13,60
53365974@N00,4110,8,1391231986,1391232046,2,13,60
53365974@N00,4110,14,1391232046,1391232211,3,13,165
53365974@N00,4110,19,1391232211,1391232751,2,13,540
53365974@N00,4110,6,1391233355,1391233475,5,13,120
53365974@N00,4110,24,1391235413,1391236913,4,13,1500
53365974@N00,4110,23,1391246815,1391246979,2,13,164
53365974@N00,4110,17,1391246979,1391247399,19,13,420
53365974@N00,4110,12,1391256138,1391256188,2,13,50
53365974@N00,4110,17,1391256188,1391256608,2,13,420
53365974@N00,4111,19,1426311863,1426312403,5,18,540
53365974@N00,4111,14,1426313193,1426313553,3,18,360
53365974@N00,4111,18,1426314309,1426314823,2,18,514
53365974@N00,4111,19,1426314823,1426315078,2,18,255
53365974@N00,4111,16,1426315078,1426315498,2,18,420
53365974@N00,4111,7,1426315959,1426316079,2,18,120
53365974@N00,4111,11,1426316156,1426316396,3,18,240
53365974@N00,4111,13,1426319986,1426320122,3,18,136
53365974@N00,4111,22,1426320122,1426320641,2,18,519
53365974@N00,4111,17,1426320641,1426321061,3,18,420
53365974@N00,4111,3,1426321108,1426321198,2,18,90
53365974@N00,4111,17,1426325877,1426326297,6,18,420
53365974@N00,4111,18,1426327293,1426327727,2,18,434
53365974@N00,4111,17,1426327727,1426328147,4,18,420
53365974@N00,4111,18,1426328220,1426328760,2,18,540
53365974@N00,4111,17,1426329367,1426329565,3,18,198
53365974@N00,4111,18,1426329565,1426330105,2,18,540
53365974@N00,4111,17,1426331016,1426331436,7,18,420
53500976@N04,4112,12,1349597730,1349598000,3,1,270
53513706@N07,4113,6,1296024752,1296024872,9,1,120
53529949@N02,4114,12,1291789495,1291789765,1,1,270
53536543@N06,4115,16,1284965052,1284965472,1,1,420
53536543@N06,4116,17,1286530109,1286530529,1,1,420
53536543@N06,4117,12,1286575507,1286575777,7,25,270
53536543@N06,4117,18,1286580481,1286581021,7,25,540
53536543@N06,4117,7,1286584049,1286584169,3,25,120
53536543@N06,4117,5,1286585577,1286585697,2,25,120
53536543@N06,4117,18,1286586144,1286586164,2,25,20
53536543@N06,4117,1,1286586164,1286586224,2,25,60
53536543@N06,4117,5,1286586255,1286586375,2,25,120
53536543@N06,4117,7,1286587027,1286587147,6,25,120
53536543@N06,4117,3,1286588174,1286588264,3,25,90
53536543@N06,4117,7,1286588792,1286588912,5,25,120
53536543@N06,4117,4,1286591498,1286591588,2,25,90
53536543@N06,4117,24,1286593460,1286593731,2,25,271
53536543@N06,4117,12,1286593731,1286594001,4,25,270
53536543@N06,4117,18,1286605966,1286606506,7,25,540
53536543@N06,4117,7,1286609192,1286609312,3,25,120
53536543@N06,4117,5,1286610770,1286610890,2,25,120
53536543@N06,4117,7,1286612479,1286612599,7,25,120
53536543@N06,4117,16,1286613336,1286613602,2,25,266
53536543@N06,4117,3,1286613602,1286613692,4,25,90
53536543@N06,4117,7,1286614743,1286614749,2,25,6
53536543@N06,4117,16,1286614749,1286615169,2,25,420
53536543@N06,4117,4,1286616763,1286616764,2,25,1
53536543@N06,4117,16,1286616764,1286617184,3,25,420
53536543@N06,4117,12,1286618824,1286619094,2,25,270
53536543@N06,4117,16,1286620052,1286620472,3,25,420
53609706@N00,4118,19,1379648491,1379649031,1,1,540
53610434@N07,4119,12,1255226640,1255226910,1,1,270
53610434@N07,4120,6,1356135413,1356135533,2,11,120
53610434@N07,4120,15,1356136438,1356136798,3,11,360
53610434@N07,4120,14,1356138530,1356138890,12,11,360
53610434@N07,4120,11,1356151687,1356151805,2,11,118
53610434@N07,4120,5,1356151805,1356151823,2,11,18
53610434@N07,4120,10,1356151823,1356151973,2,11,150
53610434@N07,4120,3,1356154963,1356155053,2,11,90
53610434@N07,4120,18,1356155072,1356155612,2,11,540
53610434@N07,4120,14,1356155997,1356156357,4,11,360
53610434@N07,4120,18,1356158706,1356159246,3,11,540
53610434@N07,4120,20,1356164265,1356164865,1,11,600
53610434@N07,4121,3,1358157078,1358157168,1,1,90
53687491@N00,4122,12,1199262921,1199263191,2,4,270
53687491@N00,4122,16,1199263383,1199263803,2,4,420
53687491@N00,4122,5,1199266180,1199266300,2,4,120
53687491@N00,4122,23,1199266592,1199267792,1,4,1200
53687491@N00,4123,13,1199342702,1199343002,3,2,300
53687491@N00,4123,20,1199344448,1199345048,1,2,600
53687491@N00,4124,9,1205634350,1205634470,1,1,120
53687766@N00,4125,14,1352440580,1352440940,4,1,360
53720296@N08,4126,9,1288813412,1288813532,2,2,120
53720296@N08,4126,18,1288817661,1288818201,1,2,540
53734320@N00,4127,10,1214363225,1214363375,1,1,150
53802134@N04,4128,12,1440209827,1440210097,1,1,270
53825050@N06,4129,5,1300438462,1300438480,2,2,18
53825050@N06,4129,18,1300438480,1300439020,1,2,540
53830503@N07,4130,17,1307253831,1307253896,2,3,65
53830503@N07,4130,16,1307253896,1307253937,2,3,41
53830503@N07,4130,24,1307253937,1307255437,1,3,1500
53856603@N00,4131,14,1360058085,1360058445,1,1,360
53879214@N03,4132,11,1386030570,1386030810,2,2,240
53879214@N03,4132,19,1386046551,1386047091,1,2,540
53936799@N05,4133,19,1367455521,1367456061,1,1,540
54023470@N03,4134,16,1343531552,1343531972,1,1,420
54023470@N03,4135,16,1345956666,1345957086,1,1,420
54023470@N03,4136,16,1367123633,1367124053,1,1,420
54028053@N08,4137,11,1241384360,1241384600,3,2,240
54028053@N08,4137,7,1241390735,1241390855,1,2,120
54028053@N08,4138,7,1244868327,1244868447,1,1,120
54164827@N00,4139,24,1382849604,1382851104,1,1,1500
54190611@N05,4140,7,1221226929,1221227049,2,1,120
54279502@N00,4141,5,1349080320,1349080440,1,1,120
54287961@N02,4142,12,1309754934,1309755204,1,1,270
54333941@N00,4143,23,1329189219,1329190419,2,5,1200
54333941@N00,4143,25,1329194603,1329194658,2,5,55
54333941@N00,4143,13,1329194658,1329194958,6,5,300
54333941@N00,4143,22,1329196650,1329197233,2,5,583
54333941@N00,4143,25,1329197233,1329199333,1,5,2100
54333941@N00,4144,13,1329463358,1329463658,1,1,300
54359359@N04,4145,14,1312837820,1312838180,1,1,360
54391405@N00,4146,24,1250839892,1250841107,16,5,1215
54391405@N00,4146,4,1250841107,1250841197,55,5,90
54391405@N00,4146,6,1250844091,1250844211,8,5,120
54391405@N00,4146,19,1250844731,1250845271,9,5,540
54391405@N00,4146,12,1250845906,1250846176,10,5,270
54395277@N00,4147,19,1330579557,1330580097,1,1,540
54495287@N04,4148,16,1322294897,1322295317,1,1,420
54495287@N04,4149,24,1339210434,1339211934,2,1,1500
54530258@N02,4150,14,1310612237,1310612597,5,1,360
54533756@N00,4151,7,1364699168,1364699288,1,1,120
54554745@N00,4152,3,1244757724,1244757814,1,1,90
54554745@N00,4153,17,1244792879,1244793299,2,1,420
54567575@N00,4154,17,1361201915,1361202335,2,8,420
54567575@N00,4154,7,1361203346,1361203466,2,8,120
54567575@N00,4154,19,1361207041,1361207581,2,8,540
54567575@N00,4154,2,1361208547,1361208607,4,8,60
54567575@N00,4154,12,1361237104,1361237374,3,8,270
54567575@N00,4154,18,1361243495,1361244035,2,8,540
54567575@N00,4154,2,1361247696,1361247756,3,8,60
54567575@N00,4154,4,1361248120,1361248210,1,8,90
54567575@N00,4155,23,1361309702,1361310902,1,1,1200
54594385@N04,4156,15,1308202398,1308202758,2,2,360
54594385@N04,4156,16,1308202952,1308203372,2,2,420
54594385@N04,4157,18,1350095151,1350095691,1,1,540
54608057@N02,4158,12,1358207399,1358207669,2,2,270
54608057@N02,4158,6,1358213696,1358213816,1,2,120
54608057@N02,4159,18,1365469336,1365469876,1,1,540
54608057@N02,4160,6,1379223640,1379223760,1,1,120
54668947@N00,4161,5,1315474356,1315474476,1,1,120
54674987@N00,4162,17,1422118181,1422118601,1,1,420
54674987@N00,4163,17,1426095532,1426095952,1,1,420
54674987@N00,4164,1,1426668336,1426668396,1,1,60
54674987@N00,4165,7,1426875438,1426875558,1,1,120
54674987@N00,4166,7,1427036569,1427036689,1,1,120
54674987@N00,4167,19,1427201215,1427201755,1,1,540
54674987@N00,4168,15,1427296574,1427296934,1,1,360
54674987@N00,4169,19,1427474751,1427475291,1,1,540
54674987@N00,4170,1,1433945781,1433945841,1,1,60
54717162@N00,4171,24,1200363406,1200364906,10,1,1500
54807333@N03,4172,12,1388486303,1388486573,1,1,270
54902025@N00,4173,10,1305814597,1305814747,1,1,150
54902025@N00,4174,20,1305862792,1305863392,2,2,600
54902025@N00,4174,15,1305867942,1305868302,3,2,360
54956677@N08,4175,4,1281674527,1281674617,1,1,90
54956677@N08,4176,13,1281758287,1281758587,2,5,300
54956677@N08,4176,3,1281765632,1281765722,2,5,90
54956677@N08,4176,16,1281770015,1281770435,2,5,420
54956677@N08,4176,18,1281770909,1281771449,3,5,540
54956677@N08,4176,11,1281776779,1281777019,2,5,240
54956677@N08,4177,7,1281843244,1281843364,3,3,120
54956677@N08,4177,21,1281850470,1281851370,2,3,900
54956677@N08,4177,15,1281857920,1281858280,2,3,360
54956677@N08,4178,23,1281957258,1281958458,2,2,1200
54956677@N08,4178,13,1281959298,1281959598,1,2,300
54982502@N03,4179,12,1296858972,1296859242,60,1,270
55043824@N00,4180,15,1255380568,1255380928,1,1,360
55070214@N06,4181,24,1455331280,1455332780,6,19,1500
55070214@N06,4181,12,1455332956,1455333226,3,19,270
55070214@N06,4181,24,1455333700,1455333968,3,19,268
55070214@N06,4181,22,1455333968,1455334020,3,19,52
55070214@N06,4181,13,1455334020,1455334320,2,19,300
55070214@N06,4181,21,1455337890,1455337969,2,19,79
55070214@N06,4181,2,1455337969,1455338029,3,19,60
55070214@N06,4181,4,1455338749,1455338839,2,19,90
55070214@N06,4181,21,1455338904,1455339804,2,19,900
55070214@N06,4181,8,1455340713,1455340833,4,19,120
55070214@N06,4181,6,1455341144,1455341264,2,19,120
55070214@N06,4181,23,1455350359,1455350611,2,19,252
55070214@N06,4181,10,1455350611,1455350704,2,19,93
55070214@N06,4181,15,1455350704,1455351064,3,19,360
55070214@N06,4181,14,1455352935,1455353295,3,19,360
55070214@N06,4181,15,1455354410,1455354434,2,19,24
55070214@N06,4181,4,1455354434,1455354524,2,19,90
55070214@N06,4181,7,1455358406,1455358526,4,19,120
55070214@N06,4181,18,1455359363,1455359903,2,19,540
55087643@N00,4182,5,1340398018,1340398138,1,1,120
55087679@N08,4183,14,1266391025,1266391385,1,1,360
55206175@N00,4184,17,1291507771,1291508191,1,1,420
55217458@N00,4185,11,1327746326,1327746566,2,1,240
55217458@N00,4186,10,1327887172,1327887322,1,1,150
55217458@N00,4187,12,1341716938,1341717208,1,1,270
55217458@N00,4188,19,1341828741,1341828816,2,3,75
55217458@N00,4188,14,1341828816,1341829176,3,3,360
55217458@N00,4188,11,1341840392,1341840632,1,3,240
55217458@N00,4189,15,1358714000,1358714360,2,6,360
55217458@N00,4189,12,1358723111,1358723381,3,6,270
55217458@N00,4189,18,1358738874,1358739414,2,6,540
55217458@N00,4189,11,1358742198,1358742325,2,6,127
55217458@N00,4189,12,1358742325,1358742449,2,6,124
55217458@N00,4189,7,1358742449,1358742569,1,6,120
55217458@N00,4190,14,1358823252,1358823612,9,1,360
55217458@N00,4191,14,1377859480,1377859840,1,1,360
55217458@N00,4192,24,1377922465,1377923965,1,1,1500
55217458@N00,4193,6,1378109325,1378109445,2,2,120
55217458@N00,4193,5,1378122135,1378122255,1,2,120
55217458@N00,4194,18,1378170959,1378171499,2,3,540
55217458@N00,4194,11,1378171612,1378171852,2,3,240
55217458@N00,4194,18,1378176638,1378177178,1,3,540
55217458@N00,4195,11,1389863305,1389863545,2,2,240
55217458@N00,4195,5,1389863625,1389863745,1,2,120
55217458@N00,4196,7,1389902745,1389902865,2,3,120
55217458@N00,4196,16,1389902946,1389903108,2,3,162
55217458@N00,4196,7,1389903108,1389903228,1,3,120
55217458@N00,4197,15,1390002080,1390002440,2,1,360
55217458@N00,4198,18,1416123130,1416123670,2,3,540
55217458@N00,4198,7,1416128586,1416128706,2,3,120
55217458@N00,4198,25,1416134304,1416136404,1,3,2100
55217458@N00,4199,14,1416214811,1416215171,1,1,360
55234777@N05,4200,12,1338481016,1338481286,1,1,270
55262458@N03,4201,1,1328512923,1328512983,1,1,60
55262458@N03,4202,24,1337999329,1338000829,2,2,1500
55262458@N03,4202,16,1338004611,1338005031,1,2,420
55262458@N03,4203,14,1339768993,1339769353,2,1,360
55262458@N03,4204,14,1341793070,1341793430,1,1,360
55262458@N03,4205,24,1342342054,1342343554,1,1,1500
55262458@N03,4206,14,1342416480,1342416840,1,1,360
55262458@N03,4207,14,1342771158,1342771518,2,1,360
55262458@N03,4208,24,1345797374,1345798874,2,1,1500
55262458@N03,4209,16,1348194315,1348194735,1,1,420
55262458@N03,4210,14,1348650163,1348650523,2,2,360
55262458@N03,4210,20,1348652059,1348652659,1,2,600
55262458@N03,4211,12,1349409573,1349409843,1,1,270
55262458@N03,4212,12,1350335441,1350335711,1,1,270
55262458@N03,4213,14,1352637182,1352637542,2,2,360
55262458@N03,4213,24,1352638418,1352639918,1,2,1500
55262458@N03,4214,24,1356871510,1356873010,1,1,1500
55262458@N03,4215,14,1358243482,1358243842,3,2,360
55262458@N03,4215,2,1358244922,1358244982,1,2,60
55262458@N03,4216,10,1360280510,1360280660,2,2,150
55262458@N03,4216,14,1360281851,1360282211,1,2,360
55262458@N03,4217,12,1361660947,1361661217,1,1,270
55262458@N03,4218,15,1363985091,1363985451,1,1,360
55262458@N03,4219,17,1365216405,1365216825,1,1,420
55262458@N03,4220,14,1366369040,1366369400,1,1,360
55268821@N06,4221,7,1411710426,1411710546,1,1,120
55268821@N06,4222,7,1414406576,1414406696,1,1,120
55284268@N05,4223,12,1360042111,1360042381,3,1,270
55292108@N00,4224,22,1362200065,1362201085,1,1,1020
55355125@N00,4225,18,1357522831,1357523371,1,1,540
55355125@N00,4226,19,1357721985,1357722525,2,3,540
55355125@N00,4226,14,1357725459,1357725724,2,3,265
55355125@N00,4226,19,1357725724,1357726264,1,3,540
55355125@N00,4227,6,1396772829,1396772949,1,1,120
55355125@N00,4228,24,1407482727,1407484227,1,1,1500
55355125@N00,4229,18,1407566183,1407566723,2,3,540
55355125@N00,4229,7,1407571959,1407572079,2,3,120
55355125@N00,4229,18,1407572673,1407573213,1,3,540
55355125@N00,4230,23,1419211758,1419212958,1,1,1200
55355125@N00,4231,7,1426991885,1426992005,2,2,120
55355125@N00,4231,17,1427011447,1427011867,1,2,420
55355125@N00,4232,23,1446675638,1446676838,1,1,1200
55355125@N00,4233,23,1446768687,1446769887,1,1,1200
55444807@N00,4234,13,1286701809,1286702109,2,2,300
55444807@N00,4234,24,1286702426,1286703926,1,2,1500
55503365@N04,4235,17,1311727796,1311728216,2,4,420
55503365@N04,4235,19,1311736084,1311736624,2,4,540
55503365@N04,4235,13,1311763407,1311763707,2,4,300
55503365@N04,4235,8,1311771120,1311771240,1,4,120
55503365@N04,4236,16,1362298455,1362298875,2,1,420
55503365@N04,4237,14,1362390788,1362391148,2,4,360
55503365@N04,4237,6,1362391718,1362391838,2,4,120
55503365@N04,4237,20,1362392880,1362392880,2,4,0
55503365@N04,4237,24,1362392880,1362394380,2,4,1500
55532309@N00,4238,15,1392807067,1392807427,1,1,360
55532309@N00,4239,11,1392859133,1392859373,1,1,240
55532309@N00,4240,19,1393068118,1393068658,1,1,540
55559255@N00,4241,23,1411609781,1411610981,1,1,1200
55629006@N02,4242,14,1290853796,1290854156,2,1,360
55713582@N08,4243,15,1310212970,1310213330,2,1,360
55779593@N00,4244,6,1278411368,1278411488,1,1,120
55779593@N00,4245,18,1281335544,1281336084,3,1,540
55779593@N00,4246,3,1324290936,1324291026,2,1,90
55843231@N00,4247,14,1378512861,1378513221,2,3,360
55843231@N00,4247,11,1378516040,1378516280,2,3,240
55843231@N00,4247,18,1378520090,1378520630,1,3,540
55851763@N00,4248,16,1348276783,1348277203,2,1,420
55980572@N05,4249,17,1309032745,1309033165,1,1,420
56003994@N00,4250,14,1374817041,1374817401,1,1,360
56007613@N07,4251,12,1365237420,1365237690,1,1,270
56072795@N00,4252,9,1358583916,1358584036,1,1,120
56119329@N00,4253,6,1305422554,1305422674,1,1,120
56169684@N02,4254,7,1390988815,1390988935,1,1,120
56197276@N02,4255,17,1306366885,1306367305,1,1,420
56212553@N07,4256,7,1358494611,1358494731,1,1,120
56223610@N07,4257,11,1391390381,1391390506,2,3,125
56223610@N07,4257,16,1391390506,1391390617,2,3,111
56223610@N07,4257,17,1391390617,1391391037,1,3,420
56223610@N07,4258,11,1391819620,1391819860,1,1,240
56228621@N03,4259,22,1300888127,1300889147,3,5,1020
56228621@N03,4259,25,1300893025,1300895125,2,5,2100
56228621@N03,4259,22,1300896733,1300897753,2,5,1020
56228621@N03,4259,25,1300902967,1300905067,2,5,2100
56228621@N03,4259,10,1300912012,1300912162,1,5,150
56228621@N03,4260,18,1301218973,1301219513,1,1,540
56279017@N03,4261,24,1341016567,1341018067,3,3,1500
56279017@N03,4261,12,1341022481,1341022751,2,3,270
56279017@N03,4261,16,1341025272,1341025692,1,3,420
56279017@N03,4262,24,1342013966,1342015466,1,1,1500
56279017@N03,4263,24,1342097520,1342099020,2,2,1500
56279017@N03,4263,13,1342101247,1342101547,1,2,300
56279017@N03,4264,13,1342609779,1342610079,1,1,300
56279017@N03,4265,18,1380944587,1380945127,1,1,540
56326087@N08,4266,16,1308373652,1308374072,2,3,420
56326087@N08,4266,23,1308383898,1308385098,2,3,1200
56326087@N08,4266,16,1308397034,1308397454,1,3,420
56326087@N08,4267,10,1311156874,1311157024,1,1,150
56381376@N07,4268,25,1428186601,1428188701,1,1,2100
56415989@N00,4269,24,1445075240,1445076740,2,3,1500
56415989@N00,4269,16,1445079749,1445080169,2,3,420
56415989@N00,4269,20,1445081100,1445081700,1,3,600
56515162@N02,4270,17,1252661424,1252661844,2,2,420
56515162@N02,4270,18,1252667505,1252668045,1,2,540
56963051@N02,4271,5,1320278477,1320278597,1,1,120
56999509@N00,4272,19,1349411559,1349412099,9,5,540
56999509@N00,4272,8,1349412943,1349413063,2,5,120
56999509@N00,4272,25,1349414568,1349416668,2,5,2100
56999509@N00,4272,19,1349423140,1349423680,5,5,540
56999509@N00,4272,16,1349426915,1349427335,2,5,420
57011939@N06,4273,6,1346725926,1346726046,5,1,120
57073634@N00,4274,14,1380539187,1380539547,1,1,360
57073634@N00,4275,24,1380608093,1380609593,1,1,1500
57073634@N00,4276,24,1380704559,1380706059,2,2,1500
57073634@N00,4276,18,1380709803,1380710343,2,2,540
57073634@N00,4277,24,1385608907,1385610407,2,3,1500
57073634@N00,4277,18,1385617752,1385618292,2,3,540
57073634@N00,4277,24,1385621575,1385623075,1,3,1500
57073634@N00,4278,18,1405577694,1405578234,1,1,540
57073634@N00,4279,7,1413601648,1413601768,1,1,120
57073634@N00,4280,12,1418530020,1418530290,1,1,270
57073634@N00,4281,18,1424564897,1424565437,3,2,540
57073634@N00,4281,19,1424571609,1424572149,1,2,540
57073634@N00,4282,24,1424600852,1424602352,1,1,1500
57079369@N00,4283,16,1452526175,1452526595,1,1,420
57085766@N00,4284,19,1220775919,1220776459,2,2,540
57085766@N00,4284,18,1220780100,1220780640,1,2,540
57192250@N07,4285,12,1356503004,1356503274,1,1,270
57221649@N05,4286,23,1316954949,1316956149,1,1,1200
57246695@N00,4287,3,1377853243,1377853333,1,1,90
57284198@N08,4288,13,1298331090,1298331390,2,2,300
57284198@N08,4288,11,1298334547,1298334787,1,2,240
57284198@N08,4289,10,1298363969,1298364119,1,1,150
57284198@N08,4290,13,1317457704,1317458004,3,1,300
57392952@N00,4291,12,1333721832,1333722102,1,1,270
57397592@N06,4292,17,1416907134,1416907554,1,1,420
57507256@N00,4293,22,1322289616,1322290636,2,6,1020
57507256@N00,4293,20,1322292956,1322293556,2,6,600
57507256@N00,4293,13,1322294911,1322295211,4,6,300
57507256@N00,4293,6,1322297328,1322297364,2,6,36
57507256@N00,4293,16,1322297364,1322297749,3,6,385
57507256@N00,4293,17,1322297749,1322298169,1,6,420
57573839@N06,4294,14,1388671973,1388672293,2,2,320
57573839@N06,4294,7,1388672293,1388672413,1,2,120
57573839@N06,4295,22,1388798859,1388798930,2,2,71
57573839@N06,4295,16,1388798930,1388799350,1,2,420
57623098@N07,4296,12,1280626733,1280627003,1,1,270
57623780@N04,4297,14,1353625167,1353625527,2,3,360
57623780@N04,4297,6,1353626174,1353626294,6,3,120
57623780@N04,4297,4,1353629460,1353629550,3,3,90
57623780@N04,4298,19,1353726825,1353727365,7,3,540
57623780@N04,4298,7,1353734165,1353734285,2,3,120
57623780@N04,4298,18,1353734615,1353735155,2,3,540
57623780@N04,4299,18,1388743238,1388743778,1,1,540
57665635@N00,4300,11,1297836650,1297836890,1,1,240
57667450@N03,4301,16,1401531351,1401531771,6,1,420
57667450@N03,4302,4,1415850074,1415850164,3,2,90
57667450@N03,4302,5,1415851364,1415851484,9,2,120
57667450@N03,4303,4,1417392355,1417392445,5,2,90
57667450@N03,4303,9,1417394096,1417394216,2,2,120
57705097@N05,4304,24,1377393099,1377394599,1,1,1500
57712585@N02,4305,7,1244087643,1244087763,1,1,120
57731366@N00,4306,18,1403076107,1403076647,2,2,540
57731366@N00,4306,13,1403077952,1403078252,1,2,300
57782593@N00,4307,14,1391851417,1391851777,1,1,360
57782593@N00,4308,14,1391940644,1391941004,1,1,360
57799803@N02,4309,14,1385013112,1385013472,1,1,360
57799803@N02,4310,6,1421576627,1421576747,1,1,120
57799803@N02,4311,17,1421848208,1421848628,1,1,420
57812277@N05,4312,19,1310687248,1310687788,1,1,540
57812277@N05,4313,7,1310724703,1310724823,1,1,120
57812277@N05,4314,19,1324855896,1324856436,2,1,540
57812277@N05,4315,7,1325062871,1325062991,1,1,120
57812277@N05,4316,13,1365489705,1365490005,2,2,300
57812277@N05,4316,7,1365506445,1365506565,2,2,120
57852884@N00,4317,6,1422331908,1422332028,1,1,120
57853113@N00,4318,24,1207873153,1207874653,37,1,1500
57869748@N00,4319,18,1412582316,1412582856,1,1,540
57885204@N00,4320,15,1367125282,1367125642,1,1,360
57885204@N00,4321,14,1380841442,1380841802,1,1,360
57885204@N00,4322,24,1398135660,1398137160,1,1,1500
57938267@N00,4323,12,1205319218,1205319488,1,1,270
57962793@N04,4324,16,1293247046,1293247466,1,1,420
57967471@N06,4325,13,1310128412,1310128712,1,1,300
57967471@N06,4326,16,1310176546,1310176966,3,5,420
57967471@N06,4326,15,1310185677,1310186037,2,5,360
57967471@N06,4326,8,1310197251,1310197371,2,5,120
57967471@N06,4326,16,1310209400,1310209820,2,5,420
57967471@N06,4326,7,1310212746,1310212866,1,5,120
57967471@N06,4327,22,1310264804,1310265824,2,2,1020
57967471@N06,4327,5,1310275261,1310275381,1,2,120
57991930@N07,4328,12,1350172451,1350172721,3,1,270
57991930@N07,4329,14,1350249161,1350249521,3,6,360
57991930@N07,4329,25,1350270474,1350272574,2,6,2100
57991930@N07,4329,20,1350285063,1350285332,2,6,269
57991930@N07,4329,4,1350285332,1350285422,2,6,90
57991930@N07,4329,6,1350290012,1350290123,2,6,111
57991930@N07,4329,14,1350290123,1350290483,1,6,360
57991930@N07,4330,1,1350347635,1350347695,2,4,60
57991930@N07,4330,23,1350349331,1350350281,2,4,950
57991930@N07,4330,17,1350350281,1350350701,2,4,420
57991930@N07,4330,8,1350356223,1350356343,1,4,120
57991930@N07,4331,18,1350427494,1350428034,3,4,540
57991930@N07,4331,7,1350429841,1350429961,2,4,120
57991930@N07,4331,11,1350430748,1350430988,2,4,240
57991930@N07,4331,12,1350432516,1350432786,1,4,270
58044290@N00,4332,17,1215923907,1215924327,2,2,420
58044290@N00,4332,18,1215945550,1215946090,1,2,540
58088668@N00,4333,23,1222251754,1222252954,30,1,1200
58105801@N04,4334,13,1401176494,1401176794,1,1,300
58112562@N00,4335,18,1364792617,1364793157,1,1,540
58112562@N00,4336,16,1364941792,1364942212,2,2,420
58112562@N00,4336,14,1364951375,1364951735,1,2,360
58276829@N06,4337,24,1302170456,1302171956,2,2,1500
58276829@N06,4337,7,1302175943,1302176063,3,2,120
58327394@N00,4338,17,1239697754,1239698174,2,1,420
58345372@N02,4339,25,1283738884,1283740984,3,1,2100
58345372@N02,4340,25,1294455281,1294457381,6,1,2100
58345372@N02,4341,25,1294648348,1294650448,7,1,2100
58345372@N02,4342,25,1294988557,1294990657,5,1,2100
58345372@N02,4343,25,1295232857,1295234957,32,1,2100
58345372@N02,4344,25,1295664798,1295666898,6,1,2100
58345372@N02,4345,25,1296204763,1296206863,5,1,2100
58345372@N02,4346,25,1296270486,1296272586,4,1,2100
58345372@N02,4347,25,1296794715,1296796815,16,1,2100
58345372@N02,4348,16,1296867929,1296868294,4,3,365
58345372@N02,4348,19,1296868294,1296868834,2,3,540
58345372@N02,4348,25,1296874381,1296876481,23,3,2100
58345372@N02,4349,25,1296961486,1296963586,8,1,2100
58345372@N02,4350,25,1297565613,1297567713,25,1,2100
58345372@N02,4351,25,1298257028,1298259128,29,1,2100
58345372@N02,4352,25,1298688778,1298690878,17,3,2100
58345372@N02,4352,24,1298698307,1298699807,3,3,1500
58345372@N02,4352,25,1298703555,1298705655,17,3,2100
58345372@N02,4353,25,1298771565,1298773665,15,1,2100
58345372@N02,4354,25,1299396634,1299398734,25,1,2100
58345372@N02,4355,12,1299884926,1299885196,6,2,270
58345372@N02,4355,25,1299891908,1299894008,12,2,2100
58345372@N02,4356,25,1299997830,1299999930,28,1,2100
58345372@N02,4357,25,1300582186,1300584286,5,1,2100
58345372@N02,4358,25,1301186927,1301189027,98,1,2100
58345372@N02,4359,16,1301788408,1301788828,10,2,420
58345372@N02,4359,25,1301793632,1301795732,30,2,2100
58345372@N02,4360,25,1302404225,1302406325,3,1,2100
58345372@N02,4361,25,1303003788,1303005888,3,1,2100
58345372@N02,4362,25,1304215596,1304217696,1,1,2100
58345372@N02,4363,25,1304661845,1304663945,3,2,2100
58345372@N02,4363,13,1304672067,1304672367,1,2,300
58345372@N02,4364,25,1305425961,1305428061,2,2,2100
58345372@N02,4364,16,1305431036,1305431456,2,2,420
58345372@N02,4365,10,1306399335,1306399485,1,1,150
58345372@N02,4366,25,1306468968,1306471068,1,1,2100
58345372@N02,4367,25,1307244414,1307246514,3,1,2100
58345372@N02,4368,25,1307848821,1307850921,3,1,2100
58345372@N02,4369,25,1308451945,1308454045,4,1,2100
58345372@N02,4370,18,1309518535,1309519075,5,1,540
58345372@N02,4371,25,1309755105,1309757205,2,1,2100
58345372@N02,4372,16,1310259803,1310260223,2,2,420
58345372@N02,4372,25,1310267314,1310269414,1,2,2100
58345372@N02,4373,25,1310705568,1310707668,1,1,2100
58345372@N02,4374,25,1311152568,1311154668,2,1,2100
58345372@N02,4375,16,1311469882,1311470302,2,2,420
58345372@N02,4375,25,1311476969,1311479069,3,2,2100
58345372@N02,4376,25,1311563760,1311565860,2,1,2100
58345372@N02,4377,16,1311816115,1311816535,2,2,420
58345372@N02,4377,25,1311823509,1311825609,2,2,2100
58345372@N02,4378,25,1312168984,1312171084,1,1,2100
58345372@N02,4379,16,1312333677,1312334097,2,2,420
58345372@N02,4379,25,1312342724,1312344824,1,2,2100
58345372@N02,4380,25,1312519241,1312521341,2,1,2100
58345372@N02,4381,25,1312693862,1312695962,2,1,2100
58345372@N02,4382,25,1312916169,1312918269,1,1,2100
58345372@N02,4383,25,1313175139,1313177239,5,1,2100
58345372@N02,4384,25,1313896667,1313898767,2,1,2100
58345372@N02,4385,25,1314500409,1314502509,4,1,2100
58345372@N02,4386,25,1314680283,1314682383,1,1,2100
58345372@N02,4387,25,1314866891,1314868991,3,1,2100
58345372@N02,4388,25,1315024221,1315026321,6,1,2100
58345372@N02,4389,25,1315110700,1315112800,4,1,2100
58345372@N02,4390,25,1315206602,1315208702,1,1,2100
58345372@N02,4391,25,1316926217,1316928317,4,1,2100
58345372@N02,4392,16,1322352950,1322353370,1,1,420
58345372@N02,4393,25,1323575729,1323577829,1,1,2100
58345372@N02,4394,16,1324167125,1324167545,1,1,420
58345372@N02,4395,16,1325383690,1325384110,2,2,420
58345372@N02,4395,25,1325389672,1325391772,1,2,2100
58381659@N00,4396,12,1357854781,1357855051,1,1,270
58383324@N00,4397,3,1387243843,1387243933,1,1,90
58413748@N00,4398,12,1252221917,1252222187,2,1,270
58436993@N00,4399,12,1459892004,1459892274,3,26,270
58436993@N00,4399,20,1459893791,1459893864,2,26,73
58436993@N00,4399,6,1459893864,1459893889,2,26,25
58436993@N00,4399,19,1459893889,1459893926,2,26,37
58436993@N00,4399,6,1459893926,1459894012,2,26,86
58436993@N00,4399,14,1459894012,1459894372,8,26,360
58436993@N00,4399,6,1459896897,1459897017,2,26,120
58436993@N00,4399,17,1459899485,1459899675,2,26,190
58436993@N00,4399,23,1459899675,1459900046,4,26,371
58436993@N00,4399,16,1459900046,1459900111,2,26,65
58436993@N00,4399,23,1459900111,1459901311,6,26,1200
58436993@N00,4399,16,1459901666,1459902086,2,26,420
58436993@N00,4399,7,1459904369,1459904489,2,26,120
58436993@N00,4399,18,1459906782,1459907322,4,26,540
58436993@N00,4399,3,1459908839,1459908929,2,26,90
58436993@N00,4399,17,1459911408,1459911713,2,26,305
58436993@N00,4399,24,1459911713,1459911759,2,26,46
58436993@N00,4399,22,1459911759,1459912779,2,26,1020
58436993@N00,4399,13,1459912972,1459913272,2,26,300
58436993@N00,4399,25,1459913494,1459914361,2,26,867
58436993@N00,4399,2,1459914361,1459914421,4,26,60
58436993@N00,4399,8,1459915037,1459915143,2,26,106
58436993@N00,4399,14,1459915143,1459915503,7,26,360
58436993@N00,4399,8,1459916608,1459916728,3,26,120
58436993@N00,4399,20,1459917223,1459917823,3,26,600
58436993@N00,4399,12,1459919196,1459919466,1,26,270
58493771@N00,4400,7,1304038471,1304038591,4,1,120
58512585@N00,4401,25,1299971872,1299973972,1,1,2100
58512585@N00,4402,13,1300009369,1300009669,2,1,300
58513125@N05,4403,12,1404520488,1404520758,3,1,270
58513931@N07,4404,23,1296936446,1296937646,1,1,1200
58553521@N02,4405,24,1437913131,1437914631,1,1,1500
58694515@N08,4406,15,1352610221,1352610581,1,1,360
58694515@N08,4407,12,1353653201,1353653471,1,1,270
58694515@N08,4408,11,1355633874,1355634114,1,1,240
58720664@N08,4409,16,1353231859,1353232279,1,1,420
58720664@N08,4410,10,1354277453,1354277603,1,1,150
58720664@N08,4411,13,1354439252,1354439552,1,1,300
58720664@N08,4412,7,1367488400,1367488520,1,1,120
58720664@N08,4413,19,1379836461,1379837001,2,2,540
58720664@N08,4413,7,1379843071,1379843191,1,2,120
58720664@N08,4414,11,1384512713,1384512953,1,1,240
58744093@N03,4415,3,1305213346,1305213436,1,1,90
58787704@N03,4416,6,1296112570,1296112690,1,1,120
58797347@N08,4417,24,1372486970,1372487922,2,2,952
58797347@N08,4417,14,1372487922,1372488282,1,2,360
58866333@N08,4418,14,1296217228,1296217588,1,1,360
58886894@N00,4419,17,1288997476,1288997896,1,1,420
58938024@N03,4420,5,1249243641,1249243761,2,2,120
58938024@N03,4420,17,1249244680,1249245100,1,2,420
58938024@N03,4421,18,1274611923,1274612463,1,1,540
58938245@N00,4422,23,1237626879,1237628079,4,1,1200
58938245@N00,4423,12,1393376174,1393376444,1,1,270
58938245@N00,4424,6,1393464759,1393464879,1,1,120
58966352@N08,4425,1,1301993554,1301993614,1,1,60
58982814@N07,4426,18,1376198694,1376199234,1,1,540
59028125@N00,4427,12,1321638688,1321638958,1,1,270
59184099@N06,4428,12,1311066616,1311066886,3,2,270
59184099@N06,4428,7,1311068566,1311068686,3,2,120
59184099@N06,4429,16,1312271045,1312271465,1,1,420
59184099@N06,4430,5,1312875802,1312875922,1,1,120
59184099@N06,4431,16,1313569153,1313569573,2,3,420
59184099@N06,4431,24,1313570730,1313570984,2,3,254
59184099@N06,4431,20,1313570984,1313571584,1,3,600
59184099@N06,4432,23,1315816025,1315817225,1,1,1200
59184099@N06,4433,7,1317464446,1317464566,1,1,120
59184099@N06,4434,12,1319604565,1319604835,2,2,270
59184099@N06,4434,22,1319604851,1319605871,1,2,1020
59184099@N06,4435,10,1319797261,1319797411,2,3,150
59184099@N06,4435,16,1319797873,1319798293,3,3,420
59184099@N06,4435,13,1319799978,1319800278,1,3,300
59184099@N06,4436,16,1320397068,1320397488,1,1,420
59184099@N06,4437,11,1320990983,1320991223,1,1,240
59184099@N06,4438,11,1321197993,1321198233,1,1,240
59184099@N06,4439,11,1321963714,1321963954,2,1,240
59184099@N06,4440,19,1322317649,1322318189,1,1,540
59184099@N06,4441,16,1322807363,1322807783,1,1,420
59184099@N06,4442,23,1323425129,1323426329,2,2,1200
59184099@N06,4442,11,1323431592,1323431832,1,2,240
59184099@N06,4443,7,1323525414,1323525534,1,1,120
59184099@N06,4444,17,1324008026,1324008446,1,1,420
59184099@N06,4445,17,1325400828,1325401248,1,1,420
59184099@N06,4446,16,1326172689,1326173109,1,1,420
59184099@N06,4447,5,1327044749,1327044869,1,1,120
59184099@N06,4448,22,1327907647,1327908667,1,1,1020
59184099@N06,4449,16,1328803910,1328804330,1,1,420
59184099@N06,4450,10,1329385985,1329386135,2,2,150
59184099@N06,4450,19,1329387684,1329388224,1,2,540
59184099@N06,4451,18,1330455272,1330455812,1,1,540
59184099@N06,4452,20,1331870639,1331871239,2,1,600
59184099@N06,4453,12,1332993341,1332993611,2,2,270
59184099@N06,4453,16,1332998084,1332998504,1,2,420
59184099@N06,4454,16,1333463663,1333464083,2,2,420
59184099@N06,4454,20,1333468392,1333468992,1,2,600
59184099@N06,4455,23,1333645817,1333647017,1,1,1200
59184099@N06,4456,24,1339349200,1339350700,1,1,1500
59184099@N06,4457,16,1339559895,1339560315,1,1,420
59184099@N06,4458,24,1339694553,1339696053,1,1,1500
59184099@N06,4459,24,1340087663,1340089163,1,1,1500
59184099@N06,4460,14,1340454812,1340455172,2,1,360
59184099@N06,4461,16,1340840122,1340840542,1,1,420
59184099@N06,4462,14,1340984937,1340985297,1,1,360
59184099@N06,4463,14,1341909547,1341909907,3,2,360
59184099@N06,4463,16,1341920853,1341921273,1,2,420
59184099@N06,4464,14,1342016866,1342017226,1,1,360
59184099@N06,4465,24,1342598900,1342600400,2,3,1500
59184099@N06,4465,20,1342601325,1342601925,2,3,600
59184099@N06,4465,22,1342607122,1342608142,1,3,1020
59184099@N06,4466,14,1343234118,1343234478,1,1,360
59184099@N06,4467,13,1343819537,1343819601,2,3,64
59184099@N06,4467,25,1343819601,1343821221,2,3,1620
59184099@N06,4467,24,1343821221,1343822721,1,3,1500
59184099@N06,4468,14,1344226968,1344227328,1,1,360
59184099@N06,4469,14,1355825662,1355826022,2,1,360
59184099@N06,4470,13,1371209038,1371209338,1,1,300
59184099@N06,4471,23,1376026589,1376027789,1,1,1200
59184099@N06,4472,19,1400824106,1400824646,1,1,540
59184099@N06,4473,14,1407867376,1407867736,1,1,360
59184099@N06,4474,10,1410510881,1410511031,1,1,150
59184099@N06,4475,20,1420288960,1420289560,1,1,600
59184099@N06,4476,19,1428227235,1428227775,1,1,540
59184099@N06,4477,17,1442660728,1442661148,1,1,420
59184099@N06,4478,16,1462083536,1462083956,1,1,420
59186794@N00,4479,14,1467322619,1467322979,2,6,360
59186794@N00,4479,18,1467324090,1467324630,2,6,540
59186794@N00,4479,17,1467325677,1467326097,2,6,420
59186794@N00,4479,23,1467326806,1467328006,2,6,1200
59186794@N00,4479,10,1467328093,1467328243,2,6,150
59186794@N00,4479,8,1467335580,1467335700,1,6,120
59263913@N00,4480,23,1329454586,1329455786,2,3,1200
59263913@N00,4480,18,1329455836,1329456095,2,3,259
59263913@N00,4480,1,1329456095,1329456155,1,3,60
59263913@N00,4481,23,1329520880,1329522080,4,2,1200
59263913@N00,4481,13,1329557740,1329558040,1,2,300
59263913@N00,4482,17,1329618067,1329618487,2,2,420
59263913@N00,4482,24,1329618593,1329620093,1,2,1500
59263913@N00,4483,23,1329682874,1329684074,1,1,1200
59263913@N00,4484,10,1329726793,1329726943,1,1,150
59323491@N00,4485,11,1380892743,1380892958,2,2,215
59323491@N00,4485,3,1380892958,1380893048,1,2,90
59323491@N00,4486,24,1380961661,1380963161,3,3,1500
59323491@N00,4486,14,1380969975,1380970335,2,3,360
59323491@N00,4486,16,1380971134,1380971554,1,3,420
59323491@N00,4487,24,1381026508,1381028008,1,1,1500
59323491@N00,4488,24,1381123958,1381125458,1,1,1500
59323491@N00,4489,15,1381364756,1381365116,3,2,360
59323491@N00,4489,4,1381365248,1381365338,1,2,90
59329108@N03,4490,21,1295594096,1295594996,1,1,900
59350481@N07,4491,24,1302777416,1302778916,1,1,1500
59350481@N07,4492,15,1306641161,1306641521,1,1,360
59350481@N07,4493,17,1306740616,1306741036,1,1,420
59350481@N07,4494,14,1349323199,1349323559,1,1,360
59350481@N07,4495,23,1350784068,1350785268,1,1,1200
59350481@N07,4496,7,1351484860,1351484980,1,1,120
59350481@N07,4497,7,1361497302,1361497332,2,2,30
59350481@N07,4497,14,1361497332,1361497692,1,2,360
59390981@N04,4498,12,1325423462,1325423732,2,1,270
59390981@N04,4499,12,1329037618,1329037888,5,4,270
59390981@N04,4499,20,1329038017,1329038617,2,4,600
59390981@N04,4499,25,1329040934,1329041610,3,4,676
59390981@N04,4499,12,1329041610,1329041880,2,4,270
59391018@N07,4500,25,1449667990,1449670090,1,1,2100
59392555@N00,4501,12,1243150383,1243150653,1,1,270
59457417@N00,4502,16,1297591269,1297591689,61,1,420
59457417@N00,4503,16,1297667663,1297668083,94,1,420
59457417@N00,4504,19,1398334611,1398334845,2,4,234
59457417@N00,4504,6,1398334845,1398334913,2,4,68
59457417@N00,4504,14,1398334913,1398335273,6,4,360
59457417@N00,4504,19,1398335408,1398335948,2,4,540
59487718@N00,4505,16,1258874582,1258875002,1,1,420
59499041@N03,4506,7,1209564000,1209564120,1,1,120
59508646@N03,4507,11,1324837270,1324837510,1,1,240
59525461@N00,4508,24,1283682808,1283684308,1,1,1500
59538487@N00,4509,7,1325936429,1325936549,1,1,120
59538487@N00,4510,7,1344760703,1344760823,2,3,120
59538487@N00,4510,18,1344762110,1344762650,5,3,540
59538487@N00,4510,14,1344769386,1344769746,1,3,360
59538487@N00,4511,8,1347750522,1347750552,3,9,30
59538487@N00,4511,14,1347750552,1347750912,19,9,360
59538487@N00,4511,8,1347755284,1347755383,2,9,99
59538487@N00,4511,14,1347755383,1347755743,5,9,360
59538487@N00,4511,12,1347766310,1347766580,2,9,270
59538487@N00,4511,16,1347767424,1347767844,14,9,420
59538487@N00,4511,11,1347774250,1347774490,2,9,240
59538487@N00,4511,19,1347775485,1347776025,2,9,540
59538487@N00,4511,12,1347787172,1347787442,1,9,270
59538487@N00,4512,19,1349596940,1349597480,2,2,540
59538487@N00,4512,14,1349603928,1349604288,1,2,360
59538487@N00,4513,14,1349672104,1349672464,1,1,360
59538487@N00,4514,6,1351000625,1351000745,2,1,120
59538487@N00,4515,7,1355005447,1355005567,2,4,120
59538487@N00,4515,8,1355008419,1355008539,8,4,120
59538487@N00,4515,25,1355011602,1355013702,11,4,2100
59538487@N00,4515,5,1355018252,1355018372,1,4,120
59538487@N00,4516,5,1355293141,1355293261,2,4,120
59538487@N00,4516,7,1355306368,1355306488,4,4,120
59538487@N00,4516,5,1355306579,1355306699,6,4,120
59538487@N00,4516,13,1355315265,1355315565,1,4,300
59538487@N00,4517,6,1363318658,1363318741,3,14,83
59538487@N00,4517,20,1363318741,1363319037,5,14,296
59538487@N00,4517,16,1363319037,1363319457,16,14,420
59538487@N00,4517,23,1363321058,1363322258,23,14,1200
59538487@N00,4517,16,1363324699,1363325119,3,14,420
59538487@N00,4517,7,1363325841,1363325961,7,14,120
59538487@N00,4517,19,1363328417,1363328957,3,14,540
59538487@N00,4517,6,1363329696,1363329780,3,14,84
59538487@N00,4517,19,1363329780,1363329793,3,14,13
59538487@N00,4517,6,1363329793,1363329908,3,14,115
59538487@N00,4517,19,1363329908,1363330448,2,14,540
59538487@N00,4517,13,1363333067,1363333367,13,14,300
59538487@N00,4517,25,1363334551,1363336651,3,14,2100
59538487@N00,4517,15,1363339365,1363339725,2,14,360
59538487@N00,4518,23,1363436475,1363436572,3,2,97
59538487@N00,4518,7,1363436572,1363436692,4,2,120
59538487@N00,4519,7,1364387499,1364387619,5,2,120
59538487@N00,4519,23,1364387627,1364388827,2,2,1200
59538487@N00,4520,23,1365643802,1365645002,1,1,1200
59538487@N00,4521,16,1369625916,1369626336,2,3,420
59538487@N00,4521,6,1369634762,1369634882,2,3,120
59538487@N00,4521,15,1369636395,1369636755,1,3,360
59538487@N00,4522,12,1385794092,1385794362,2,3,270
59538487@N00,4522,22,1385795660,1385796680,3,3,1020
59538487@N00,4522,13,1385797513,1385797813,1,3,300
59538487@N00,4523,12,1387242736,1387243006,1,1,270
59538487@N00,4524,6,1396741947,1396742067,5,4,120
59538487@N00,4524,14,1396766643,1396767003,2,4,360
59538487@N00,4524,19,1396768960,1396769162,2,4,202
59538487@N00,4524,6,1396769162,1396769282,1,4,120
59538487@N00,4525,19,1400396601,1400397141,13,2,540
59538487@N00,4525,6,1400401176,1400401296,3,2,120
59538487@N00,4526,16,1401601154,1401601574,3,9,420
59538487@N00,4526,7,1401602451,1401602571,8,9,120
59538487@N00,4526,16,1401605989,1401606124,2,9,135
59538487@N00,4526,10,1401606124,1401606274,3,9,150
59538487@N00,4526,11,1401608314,1401608400,4,9,86
59538487@N00,4526,7,1401608400,1401608520,2,9,120
59538487@N00,4526,11,1401608588,1401608828,3,9,240
59538487@N00,4526,10,1401609117,1401609267,4,9,150
59538487@N00,4526,6,1401610673,1401610793,14,9,120
59538487@N00,4527,18,1412500833,1412501373,1,1,540
59553958@N05,4528,19,1307836295,1307836835,1,1,540
59567508@N06,4529,9,1344204978,1344205098,1,1,120
59642062@N00,4530,16,1341965051,1341965471,1,1,420
59642062@N00,4531,7,1355621031,1355621151,3,5,120
59642062@N00,4531,11,1355621657,1355621897,3,5,240
59642062@N00,4531,23,1355625621,1355625636,2,5,15
59642062@N00,4531,4,1355625636,1355625726,2,5,90
59642062@N00,4531,8,1355626762,1355626882,14,5,120
59646076@N00,4532,12,1238347474,1238347744,2,3,270
59646076@N00,4532,7,1238349717,1238349837,2,3,120
59646076@N00,4532,12,1238350942,1238351212,5,3,270
59646076@N00,4533,13,1244016566,1244016866,2,3,300
59646076@N00,4533,18,1244020592,1244020914,3,3,322
59646076@N00,4533,17,1244020914,1244021334,1,3,420
59646076@N00,4534,12,1245586477,1245586747,3,1,270
59646076@N00,4535,12,1245619990,1245620260,19,1,270
59646076@N00,4536,12,1245703058,1245703328,1,1,270
59717996@N00,4537,18,1405120540,1405121080,1,1,540
59717996@N00,4538,5,1414829661,1414829781,1,1,120
59717996@N00,4539,24,1414875257,1414876757,1,1,1500
59735909@N00,4540,6,1350060789,1350060909,9,1,120
59740245@N04,4541,12,1340348781,1340349051,3,7,270
59740245@N04,4541,19,1340350293,1340350489,7,7,196
59740245@N04,4541,14,1340350489,1340350849,7,7,360
59740245@N04,4541,19,1340351297,1340351382,3,7,85
59740245@N04,4541,6,1340351382,1340351409,3,7,27
59740245@N04,4541,8,1340351409,1340351419,2,7,10
59740245@N04,4541,6,1340351419,1340351539,1,7,120
59742495@N00,4542,13,1213188855,1213189155,1,1,300
59743095@N08,4543,4,1301352149,1301352239,1,1,90
59751404@N08,4544,19,1392705622,1392706162,2,2,540
59751404@N08,4544,7,1392708740,1392708860,1,2,120
59753021@N00,4545,15,1238272298,1238272658,1,1,360
59753021@N00,4546,15,1238357921,1238358281,15,1,360
59753021@N00,4547,15,1238701803,1238702163,4,1,360
59753021@N00,4548,3,1314502436,1314502526,2,1,90
59753021@N00,4549,16,1457418907,1457419327,3,2,420
59753021@N00,4549,15,1457422882,1457423242,2,2,360
59753021@N00,4550,16,1459874088,1459874508,2,1,420
59753021@N00,4551,21,1461766487,1461767387,1,1,900
59753021@N00,4552,12,1463519889,1463520159,1,1,270
59753021@N00,4553,16,1465221630,1465222050,1,1,420
59753021@N00,4554,12,1465418913,1465419183,1,1,270
59753021@N00,4555,16,1466023540,1466023960,1,1,420
59753021@N00,4556,16,1467735768,1467736188,1,1,420
59888866@N00,4557,3,1192170046,1192170136,7,1,90
59888866@N00,4558,13,1287304819,1287305119,2,1,300
59888866@N00,4559,16,1294999232,1294999652,2,2,420
59888866@N00,4559,24,1295003914,1295005414,1,2,1500
59888866@N00,4560,7,1325479624,1325479744,2,1,120
59888866@N00,4561,16,1332232586,1332233006,1,1,420
59888866@N00,4562,12,1334913254,1334913524,1,1,270
59888866@N00,4563,12,1339224631,1339224901,2,5,270
59888866@N00,4563,19,1339225791,1339226331,2,5,540
59888866@N00,4563,14,1339226719,1339227079,2,5,360
59888866@N00,4563,6,1339236862,1339236982,2,5,120
59888866@N00,4563,14,1339248180,1339248540,1,5,360
59888866@N00,4564,22,1357141727,1357142747,1,1,1020
59925672@N03,4565,7,1376010657,1376010777,4,1,120
59969758@N08,4566,3,1317443223,1317443313,1,1,90
59983818@N06,4567,24,1407204700,1407206200,3,6,1500
59983818@N06,4567,25,1407214306,1407216406,5,6,2100
59983818@N06,4567,13,1407219596,1407219896,4,6,300
59983818@N06,4567,19,1407220765,1407221305,2,6,540
59983818@N06,4567,14,1407240731,1407241091,3,6,360
59983818@N06,4567,6,1407246857,1407246977,1,6,120
60108630@N08,4568,23,1309332273,1309333473,1,1,1200
60143933@N02,4569,12,1353112334,1353112604,1,1,270
60245040@N04,4570,10,1394939410,1394939560,2,2,150
60245040@N04,4570,14,1394941127,1394941487,1,2,360
60302029@N08,4571,24,1395055765,1395057265,1,1,1500
60377953@N00,4572,6,1391642859,1391642979,3,3,120
60377953@N00,4572,7,1391650894,1391651014,2,3,120
60377953@N00,4572,11,1391652103,1391652343,1,3,240
60377953@N00,4573,9,1391730233,1391730353,2,3,120
60377953@N00,4573,6,1391730807,1391730927,2,3,120
60377953@N00,4573,11,1391736378,1391736618,1,3,240
60385541@N00,4574,15,1389661902,1389662262,4,2,360
60385541@N00,4574,24,1389674828,1389676328,6,2,1500
60448671@N07,4575,13,1326864856,1326865156,10,1,300
60448671@N07,4576,18,1357626995,1357627535,2,3,540
60448671@N07,4576,14,1357630517,1357630877,12,3,360
60448671@N07,4576,24,1357635138,1357636638,2,3,1500
60448671@N07,4577,24,1357898191,1357899691,2,1,1500
60456299@N00,4578,24,1196736498,1196737998,1,1,1500
60468005@N00,4579,12,1352876619,1352876889,1,1,270
60541665@N03,4580,14,1337763550,1337763910,1,1,360
60594882@N02,4581,8,1294323025,1294323145,1,1,120
60627979@N02,4582,16,1437796485,1437796905,1,1,420
60703488@N00,4583,12,1416918326,1416918596,2,1,270
60703488@N00,4584,24,1417239363,1417240863,19,15,1500
60703488@N00,4584,22,1417241095,1417241095,2,15,0
60703488@N00,4584,24,1417241095,1417241116,2,15,21
60703488@N00,4584,22,1417241116,1417241116,2,15,0
60703488@N00,4584,24,1417241116,1417242616,34,15,1500
60703488@N00,4584,25,1417243150,1417244613,4,15,1463
60703488@N00,4584,15,1417244613,1417244973,3,15,360
60703488@N00,4584,24,1417245337,1417246837,3,15,1500
60703488@N00,4584,15,1417247255,1417247255,2,15,0
60703488@N00,4584,24,1417247255,1417247256,6,15,1
60703488@N00,4584,15,1417247256,1417247616,3,15,360
60703488@N00,4584,24,1417269381,1417269476,30,15,95
60703488@N00,4584,15,1417269476,1417269528,3,15,52
60703488@N00,4584,25,1417269528,1417269531,2,15,3
60703488@N00,4584,15,1417269531,1417269891,1,15,360
60703488@N00,4585,24,1417312578,1417314078,2,1,1500
60703488@N00,4586,24,1417740036,1417741536,1,1,1500
60703488@N00,4587,24,1419545954,1419547454,1,1,1500
60717337@N05,4588,8,1307420435,1307420555,1,1,120
60744963@N02,4589,16,1295259471,1295259891,5,2,420
60744963@N02,4589,12,1295266764,1295267034,1,2,270
60792472@N00,4590,19,1357252888,1357253428,2,2,540
60792472@N00,4590,16,1357270001,1357270421,1,2,420
60823682@N05,4591,14,1313450029,1313450389,1,1,360
60988928@N06,4592,18,1311395123,1311395663,4,1,540
60988928@N06,4593,18,1311510806,1311511095,2,4,289
60988928@N06,4593,10,1311511095,1311511152,2,4,57
60988928@N06,4593,18,1311511152,1311511369,4,4,217
60988928@N06,4593,16,1311511369,1311511789,1,4,420
61023603@N00,4594,13,1224221879,1224222179,1,1,300
61026350@N06,4595,16,1391163483,1391163903,1,1,420
61102903@N02,4596,16,1376234145,1376234163,2,5,18
61102903@N02,4596,7,1376234163,1376234197,2,5,34
61102903@N02,4596,24,1376234197,1376234204,2,5,7
61102903@N02,4596,14,1376234204,1376234233,2,5,29
61102903@N02,4596,7,1376234233,1376234353,1,5,120
61207566@N00,4597,14,1421549478,1421549838,2,2,360
61207566@N00,4597,24,1421561877,1421563377,1,2,1500
61207928@N04,4598,9,1354233231,1354233351,1,1,120
61228464@N03,4599,24,1381034664,1381036164,1,1,1500
61228464@N03,4600,14,1381108658,1381109018,1,1,360
61228464@N03,4601,14,1381180253,1381180613,1,1,360
61258745@N03,4602,17,1275210139,1275210559,2,1,420
61258745@N03,4603,1,1276302632,1276302692,1,1,60
61258745@N03,4604,19,1276334598,1276335138,2,2,540
61258745@N03,4604,7,1276347310,1276347430,1,2,120
61258745@N03,4605,6,1276948365,1276948485,1,1,120
61258745@N03,4606,16,1277459392,1277459812,1,1,420
61258745@N03,4607,12,1281086872,1281087142,3,1,270
61258745@N03,4608,15,1284205902,1284206262,1,1,360
61258745@N03,4609,13,1286611929,1286612229,1,1,300
61258745@N03,4610,16,1289973801,1289974221,1,1,420
61258745@N03,4611,12,1296274391,1296274661,2,4,270
61258745@N03,4611,19,1296282283,1296282400,2,4,117
61258745@N03,4611,7,1296282400,1296282520,4,4,120
61258745@N03,4611,18,1296284323,1296284863,2,4,540
61258745@N03,4612,14,1298270964,1298271317,2,2,353
61258745@N03,4612,19,1298271317,1298271857,1,2,540
61258745@N03,4613,12,1298696785,1298697055,1,1,270
61258745@N03,4614,12,1298732663,1298732933,1,1,270
61258745@N03,4615,16,1300168888,1300169308,3,4,420
61258745@N03,4615,22,1300169948,1300170968,2,4,1020
61258745@N03,4615,23,1300185405,1300186220,2,4,815
61258745@N03,4615,12,1300186220,1300186490,1,4,270
61258745@N03,4616,18,1305974455,1305974995,2,2,540
61258745@N03,4616,13,1305977370,1305977670,1,2,300
61258745@N03,4617,16,1306715645,1306716065,1,1,420
61258745@N03,4618,12,1306987315,1306987585,1,1,270
61261095@N02,4619,16,1330936875,1330937295,4,4,420
61261095@N02,4619,25,1330941395,1330943495,3,4,2100
61261095@N02,4619,16,1330955162,1330955177,2,4,15
61261095@N02,4619,18,1330955177,1330955717,1,4,540
61261095@N02,4620,16,1331041541,1331041575,2,2,34
61261095@N02,4620,18,1331041575,1331042115,1,2,540
61261095@N02,4621,18,1331095915,1331096455,2,2,540
61261095@N02,4621,15,1331100864,1331101224,2,2,360
61342516@N02,4622,25,1342057805,1342059905,1,1,2100
61349054@N00,4623,10,1297928732,1297928882,3,1,150
61357453@N02,4624,18,1231993659,1231994199,1,1,540
61363312@N00,4625,18,1387060205,1387060745,1,1,540
61517165@N00,4626,17,1354171309,1354171729,4,1,420
61600824@N08,4627,17,1214810944,1214811364,1,1,420
61600824@N08,4628,12,1278486687,1278486957,2,3,270
61600824@N08,4628,17,1278496754,1278497174,3,3,420
61600824@N08,4628,23,1278504972,1278506172,1,3,1200
61601523@N00,4629,24,1450768609,1450770109,2,2,1500
61601523@N00,4629,7,1450770995,1450771115,1,2,120
61644290@N00,4630,12,1346583004,1346583274,1,1,270
61702169@N02,4631,12,1357985955,1357986225,1,1,270
61761579@N00,4632,17,1428560508,1428560928,1,1,420
61827589@N06,4633,14,1352982861,1352983221,1,1,360
61827589@N06,4634,3,1378450322,1378450412,2,1,90
61827589@N06,4635,3,1378672708,1378672798,2,1,90
61905010@N03,4636,8,1409701588,1409701708,2,2,120
61905010@N03,4636,17,1409707875,1409708295,1,2,420
61906163@N00,4637,25,1293852372,1293854361,3,6,1989
61906163@N00,4637,17,1293854361,1293854781,3,6,420
61906163@N00,4637,23,1293854790,1293855241,2,6,451
61906163@N00,4637,16,1293855241,1293855454,6,6,213
61906163@N00,4637,11,1293855454,1293855694,5,6,240
61906163@N00,4637,18,1293855921,1293856461,4,6,540
61938758@N08,4638,25,1420335659,1420337759,1,1,2100
61938758@N08,4639,14,1420371098,1420371458,1,1,360
61938758@N08,4640,25,1420523887,1420525987,2,1,2100
61938758@N08,4641,11,1420619041,1420619281,1,1,240
61938758@N08,4642,16,1420688128,1420688548,1,1,420
62001041@N08,4643,18,1342786647,1342787187,2,2,540
62001041@N08,4643,13,1342788915,1342789215,1,2,300
62053346@N08,4644,6,1306302724,1306302844,1,1,120
62101907@N00,4645,12,1362008166,1362008436,1,1,270
62101907@N00,4646,15,1389347697,1389348057,1,1,360
62102776@N02,4647,12,1331989150,1331989420,1,1,270
62102776@N02,4648,14,1344306037,1344306397,3,2,360
62102776@N02,4648,12,1344309958,1344310228,1,2,270
62102776@N02,4649,13,1344344097,1344344397,2,2,300
62102776@N02,4649,16,1344351923,1344352343,1,2,420
62102776@N02,4650,22,1344425820,1344426840,2,4,1020
62102776@N02,4650,14,1344427876,1344428236,2,4,360
62102776@N02,4650,7,1344434132,1344434252,2,4,120
62102776@N02,4650,19,1344439297,1344439837,1,4,540
62102776@N02,4651,14,1344521380,1344521740,1,1,360
62102776@N02,4652,14,1344682596,1344682956,1,1,360
62102776@N02,4653,22,1344775038,1344776058,1,1,1020
62102776@N02,4654,14,1344856813,1344857173,1,1,360
62102776@N02,4655,16,1344918503,1344918923,2,2,420
62102776@N02,4655,12,1344937153,1344937423,1,2,270
62102776@N02,4656,7,1345013247,1345013367,1,1,120
62102776@N02,4657,14,1345173709,1345174069,1,1,360
62102776@N02,4658,14,1345445382,1345445742,1,1,360
62102776@N02,4659,16,1345540667,1345541087,1,1,420
62102776@N02,4660,14,1345698124,1345698484,1,1,360
62102776@N02,4661,16,1346315684,1346316104,1,1,420
62102776@N02,4662,14,1346562865,1346563225,1,1,360
62102776@N02,4663,13,1346666395,1346666695,1,1,300
62102776@N02,4664,16,1347008953,1347009373,1,1,420
62102776@N02,4665,13,1347172412,1347172712,1,1,300
62102776@N02,4666,14,1347266620,1347266980,1,1,360
62102776@N02,4667,14,1362223771,1362224131,1,1,360
62102776@N02,4668,7,1362269002,1362269122,1,1,120
62102776@N02,4669,14,1362363065,1362363425,1,1,360
62102776@N02,4670,7,1362538198,1362538318,1,1,120
62121361@N03,4671,1,1313518410,1313518470,2,2,60
62121361@N03,4671,15,1313520903,1313521263,1,2,360
62121361@N03,4672,20,1325484988,1325485588,2,2,600
62121361@N03,4672,23,1325486787,1325487987,1,2,1200
62121361@N03,4673,16,1326175486,1326175906,2,2,420
62121361@N03,4673,4,1326181516,1326181606,1,2,90
62121361@N03,4674,10,1332747036,1332747186,1,1,150
62121361@N03,4675,23,1332984094,1332985294,2,2,1200
62121361@N03,4675,15,1332999694,1333000054,2,2,360
62121361@N03,4676,11,1334220402,1334220642,2,2,240
62121361@N03,4676,13,1334224691,1334224991,2,2,300
62121361@N03,4677,24,1338955508,1338957008,2,1,1500
62121361@N03,4678,14,1339720605,1339720965,2,7,360
62121361@N03,4678,6,1339734863,1339734983,2,7,120
62121361@N03,4678,14,1339736382,1339736639,2,7,257
62121361@N03,4678,6,1339736639,1339736759,2,7,120
62121361@N03,4678,19,1339738904,1339739444,2,7,540
62121361@N03,4678,14,1339753066,1339753426,3,7,360
62121361@N03,4678,6,1339760856,1339760976,1,7,120
62121361@N03,4679,19,1340089064,1340089604,2,5,540
62121361@N03,4679,14,1340108621,1340108981,2,5,360
62121361@N03,4679,19,1340109787,1340110327,3,5,540
62121361@N03,4679,14,1340111149,1340111509,3,5,360
62121361@N03,4679,19,1340112458,1340112998,1,5,540
62121361@N03,4680,19,1341997675,1341998215,1,1,540
62121361@N03,4681,24,1345006440,1345007940,1,1,1500
62121361@N03,4682,7,1346146107,1346146227,2,2,120
62121361@N03,4682,23,1346146381,1346147581,1,2,1200
62121361@N03,4683,2,1346403635,1346403695,1,1,60
62121361@N03,4684,24,1352451094,1352452594,1,1,1500
62121361@N03,4685,16,1364458281,1364458701,1,1,420
62121361@N03,4686,14,1380613416,1380613776,2,2,360
62121361@N03,4686,9,1380615372,1380615492,1,2,120
62208823@N00,4687,12,1366527023,1366527293,2,2,270
62208823@N00,4687,14,1366531195,1366531555,1,2,360
62208823@N00,4688,12,1366639352,1366639622,1,1,270
62236593@N04,4689,24,1393153502,1393155002,1,1,1500
62236593@N04,4690,5,1440763688,1440763808,1,1,120
62294367@N08,4691,12,1303131214,1303131484,1,1,270
62297532@N00,4692,16,1355928596,1355929016,1,1,420
62297532@N00,4693,14,1356078631,1356078933,2,2,302
62297532@N00,4693,16,1356078933,1356079353,1,2,420
62348735@N06,4694,19,1343174305,1343174845,2,3,540
62348735@N06,4694,3,1343185502,1343185592,2,3,90
62348735@N06,4694,17,1343187310,1343187730,1,3,420
62358639@N06,4695,16,1241485143,1241485461,3,2,318
62358639@N06,4695,7,1241485461,1241485581,1,2,120
62392176@N00,4696,7,1227608106,1227608226,1,1,120
62392176@N00,4697,24,1227669374,1227670874,3,7,1500
62392176@N00,4697,9,1227671571,1227671691,3,7,120
62392176@N00,4697,24,1227673466,1227674966,5,7,1500
62392176@N00,4697,13,1227675043,1227675343,5,7,300
62392176@N00,4697,24,1227676565,1227678065,4,7,1500
62392176@N00,4697,6,1227678853,1227678973,3,7,120
62392176@N00,4697,11,1227697543,1227697783,1,7,240
62392176@N00,4698,12,1227749284,1227749554,3,1,270
62392176@N00,4699,7,1281091130,1281091250,1,1,120
62392176@N00,4700,7,1281137393,1281137513,2,4,120
62392176@N00,4700,16,1281143201,1281143621,2,4,420
62392176@N00,4700,7,1281145938,1281146058,6,4,120
62392176@N00,4700,16,1281175179,1281175599,1,4,420
62392176@N00,4701,7,1281619609,1281619729,1,1,120
62392176@N00,4702,14,1407829623,1407829983,3,1,360
62392176@N00,4703,24,1407886009,1407887509,2,2,1500
62392176@N00,4703,10,1407890783,1407890933,1,2,150
62392176@N00,4704,25,1407992243,1407994343,2,4,2100
62392176@N00,4704,2,1408010763,1408010823,2,4,60
62392176@N00,4704,14,1408011579,1408011939,10,4,360
62392176@N00,4704,19,1408012525,1408013065,1,4,540
62413873@N03,4705,6,1297277105,1297277225,1,1,120
62443344@N00,4706,6,1259815879,1259815999,1,1,120
62443344@N00,4707,12,1265674941,1265675211,4,2,270
62443344@N00,4707,11,1265686185,1265686425,2,2,240
62443344@N00,4708,16,1277116341,1277116761,3,1,420
62443344@N00,4709,11,1288140853,1288141093,4,6,240
62443344@N00,4709,13,1288144887,1288145187,2,6,300
62443344@N00,4709,16,1288164491,1288164911,3,6,420
62443344@N00,4709,23,1288166496,1288166764,2,6,268
62443344@N00,4709,17,1288166764,1288167184,2,6,420
62443344@N00,4709,16,1288168009,1288168429,8,6,420
62443344@N00,4710,13,1298616590,1298616890,14,1,300
62443344@N00,4711,16,1328657209,1328657629,14,1,420
62443344@N00,4712,16,1331612699,1331613119,6,2,420
62443344@N00,4712,24,1331619930,1331621430,10,2,1500
62443344@N00,4713,14,1350842345,1350842625,3,2,280
62443344@N00,4713,22,1350842625,1350843645,27,2,1020
62443344@N00,4714,22,1350897816,1350898836,1,1,1020
62443344@N00,4715,22,1350943926,1350944946,3,2,1020
62443344@N00,4715,24,1350969112,1350970612,1,2,1500
62443344@N00,4716,24,1357282007,1357283507,1,1,1500
62443344@N00,4717,24,1400212612,1400214112,4,1,1500
62443344@N00,4718,24,1444820374,1444821874,41,1,1500
62446464@N00,4719,16,1462429514,1462429934,1,1,420
62460908@N07,4720,11,1355012331,1355012571,2,2,240
62460908@N07,4720,12,1355015806,1355016076,1,2,270
62460908@N07,4721,6,1360367192,1360367312,2,5,120
62460908@N07,4721,19,1360371599,1360372139,2,5,540
62460908@N07,4721,18,1360373805,1360374345,2,5,540
62460908@N07,4721,12,1360380837,1360381107,2,5,270
62460908@N07,4721,25,1360388382,1360390482,1,5,2100
62460908@N07,4722,11,1360476746,1360476986,1,1,240
62460908@N07,4723,14,1360559708,1360560068,1,1,360
62460908@N07,4724,12,1360974963,1360975233,1,1,270
62460908@N07,4725,16,1361341066,1361341486,1,1,420
62460908@N07,4726,11,1363475834,1363476074,2,1,240
62460908@N07,4727,12,1363756157,1363756427,1,1,270
62460908@N07,4728,15,1364878572,1364878932,1,1,360
62460908@N07,4729,12,1365298918,1365299188,1,1,270
62460908@N07,4730,24,1369545346,1369546846,1,1,1500
62460908@N07,4731,24,1370067399,1370068899,1,1,1500
62460908@N07,4732,24,1372831566,1372833066,1,1,1500
62460908@N07,4733,14,1374719207,1374719567,1,1,360
62460908@N07,4734,7,1374980760,1374980880,1,1,120
62460908@N07,4735,24,1375321050,1375322550,1,1,1500
62460908@N07,4736,15,1377307778,1377308138,1,1,360
62460908@N07,4737,16,1378550969,1378551389,1,1,420
62460908@N07,4738,24,1378619299,1378620799,2,1,1500
62460908@N07,4739,16,1379209677,1379210097,1,1,420
62460908@N07,4740,17,1384763446,1384763866,1,1,420
62460908@N07,4741,24,1385425172,1385426672,1,1,1500
62460908@N07,4742,11,1386284143,1386284383,1,1,240
62460908@N07,4743,6,1400305656,1400305776,1,1,120
62460908@N07,4744,24,1402556489,1402557989,1,1,1500
62499372@N07,4745,7,1264773333,1264773453,1,1,120
62552018@N06,4746,15,1370350059,1370350419,1,1,360
62552018@N06,4747,6,1371783455,1371783575,2,3,120
62552018@N06,4747,22,1371799702,1371800722,2,3,1020
62552018@N06,4747,18,1371815003,1371815543,1,3,540
62552018@N06,4748,14,1378275317,1378275677,1,1,360
62566937@N00,4749,10,1395619173,1395619323,2,6,150
62566937@N00,4749,16,1395619339,1395619759,2,6,420
62566937@N00,4749,24,1395625424,1395626924,2,6,1500
62566937@N00,4749,23,1395627448,1395628648,2,6,1200
62566937@N00,4749,13,1395630073,1395630192,2,6,119
62566937@N00,4749,25,1395630192,1395632292,1,6,2100
62647068@N00,4750,17,1380274770,1380275190,1,1,420
62783804@N05,4751,17,1286327561,1286327981,1,1,420
62783804@N05,4752,12,1286393314,1286393584,1,1,270
62783804@N05,4753,12,1310985007,1310985277,1,1,270
62783804@N05,4754,23,1312367357,1312368557,1,1,1200
62792097@N00,4755,20,1334373666,1334374266,5,5,600
62792097@N00,4755,23,1334375533,1334376733,3,5,1200
62792097@N00,4755,18,1334386743,1334387283,6,5,540
62792097@N00,4755,25,1334392309,1334392403,2,5,94
62792097@N00,4755,15,1334392403,1334392763,1,5,360
62831368@N08,4756,16,1315115095,1315115515,19,1,420
62841817@N05,4757,18,1388920822,1388921362,1,1,540
62901115@N00,4758,6,1351077223,1351077343,1,1,120
62986558@N05,4759,11,1333358113,1333358353,1,1,240
62986558@N05,4760,22,1333937925,1333938945,1,1,1020
62986558@N05,4761,22,1336127134,1336128154,1,1,1020
62986558@N05,4762,5,1337323537,1337323657,1,1,120
62986558@N05,4763,14,1337514393,1337514753,1,1,360
62986558@N05,4764,25,1337846379,1337848479,1,1,2100
62986558@N05,4765,22,1338188124,1338189144,1,1,1020
62986558@N05,4766,14,1339371949,1339372309,2,1,360
62986558@N05,4767,14,1339713193,1339713553,1,1,360
62986558@N05,4768,24,1340006408,1340007908,2,1,1500
63011490@N03,4769,9,1356605076,1356605196,2,3,120
63011490@N03,4769,12,1356606203,1356606473,2,3,270
63011490@N03,4769,17,1356606795,1356607215,2,3,420
63014850@N00,4770,8,1403138846,1403138966,2,3,120
63014850@N00,4770,14,1403139104,1403139464,4,3,360
63014850@N00,4770,18,1403140537,1403141077,1,3,540
63014850@N00,4771,18,1403187446,1403187986,3,1,540
63104689@N03,4772,14,1397169438,1397169798,2,5,360
63104689@N03,4772,11,1397170378,1397170618,2,5,240
63104689@N03,4772,21,1397171067,1397171967,2,5,900
63104689@N03,4772,25,1397173891,1397175085,4,5,1194
63104689@N03,4772,24,1397175085,1397176585,1,5,1500
63104689@N03,4773,19,1411291901,1411292441,3,4,540
63104689@N03,4773,25,1411294248,1411294272,3,4,24
63104689@N03,4773,22,1411294272,1411294666,5,4,394
63104689@N03,4773,12,1411294666,1411294936,1,4,270
63104689@N03,4774,24,1414717413,1414718913,12,1,1500
63104689@N03,4775,20,1416100499,1416101099,36,3,600
63104689@N03,4775,19,1416107536,1416108076,2,3,540
63104689@N03,4775,25,1416113477,1416115577,11,3,2100
63104689@N03,4776,17,1416701072,1416701492,3,1,420
63104689@N03,4777,25,1417302336,1417304436,3,2,2100
63104689@N03,4777,24,1417307036,1417308536,2,2,1500
63106298@N02,4778,12,1315634115,1315634385,1,1,270
63106298@N02,4779,23,1320325134,1320325667,2,9,533
63106298@N02,4779,17,1320325667,1320326087,2,9,420
63106298@N02,4779,11,1320326169,1320326409,3,9,240
63106298@N02,4779,18,1320326701,1320327174,4,9,473
63106298@N02,4779,6,1320327174,1320327279,2,9,105
63106298@N02,4779,19,1320327279,1320327487,3,9,208
63106298@N02,4779,16,1320327487,1320327907,4,9,420
63106298@N02,4779,13,1320328055,1320328355,2,9,300
63106298@N02,4779,24,1320331641,1320333141,3,9,1500
63106298@N02,4780,13,1322921717,1322922017,3,2,300
63106298@N02,4780,22,1322923342,1322924362,1,2,1020
63106298@N02,4781,4,1323516592,1323516682,2,4,90
63106298@N02,4781,15,1323516802,1323517162,2,4,360
63106298@N02,4781,19,1323517637,1323518165,2,4,528
63106298@N02,4781,15,1323518165,1323518525,1,4,360
63106298@N02,4782,12,1328279571,1328279841,1,1,270
63106298@N02,4783,6,1329642954,1329643074,2,1,120
63106298@N02,4784,12,1331261923,1331262193,1,1,270
63106298@N02,4785,4,1334134033,1334134078,2,2,45
63106298@N02,4785,6,1334134078,1334134198,1,2,120
63106298@N02,4786,12,1334215880,1334216150,2,1,270
63106298@N02,4787,19,1334915046,1334915586,1,1,540
63106298@N02,4788,24,1340210395,1340210447,3,5,52
63106298@N02,4788,22,1340210447,1340210490,2,5,43
63106298@N02,4788,24,1340210490,1340210524,2,5,34
63106298@N02,4788,15,1340210524,1340210690,2,5,166
63106298@N02,4788,24,1340210690,1340212190,1,5,1500
63106298@N02,4789,16,1340338589,1340339009,2,1,420
63202442@N00,4790,15,1286239900,1286240260,1,1,360
63202442@N00,4791,22,1286350813,1286351833,1,1,1020
63383881@N07,4792,17,1379898087,1379898507,2,6,420
63383881@N07,4792,3,1379901280,1379901370,2,6,90
63383881@N07,4792,7,1379907443,1379907563,2,6,120
63383881@N07,4792,14,1379910511,1379910871,3,6,360
63383881@N07,4792,13,1379915329,1379915629,2,6,300
63383881@N07,4792,22,1379917849,1379918869,1,6,1020
63383881@N07,4793,14,1414281962,1414282322,2,3,360
63383881@N07,4793,7,1414286799,1414286919,2,3,120
63383881@N07,4793,18,1414290882,1414291422,1,3,540
63395608@N02,4794,14,1296276013,1296276373,1,1,360
63437796@N00,4795,7,1351066376,1351066496,1,1,120
63437796@N00,4796,19,1377922950,1377923490,8,1,540
63443853@N00,4797,16,1313913829,1313914249,1,1,420
63455570@N07,4798,24,1377746063,1377747563,1,1,1500
63461379@N00,4799,6,1360966604,1360966724,2,1,120
63483900@N03,4800,3,1386906301,1386906391,1,1,90
63488513@N00,4801,14,1378257998,1378258358,1,1,360
63520495@N08,4802,22,1357432244,1357433264,3,3,1020
63520495@N08,4802,14,1357457328,1357457688,2,3,360
63520495@N08,4802,22,1357469404,1357470424,1,3,1020
63520495@N08,4803,18,1358558622,1358559162,2,1,540
63520495@N08,4804,19,1364022875,1364023415,2,1,540
63520495@N08,4805,24,1364882524,1364884024,2,1,1500
63520495@N08,4806,7,1365035257,1365035377,1,1,120
63520495@N08,4807,11,1379141551,1379141791,2,3,240
63520495@N08,4807,8,1379145092,1379145212,2,3,120
63520495@N08,4807,22,1379146094,1379147114,1,3,1020
63520495@N08,4808,10,1382772128,1382772278,1,1,150
63520495@N08,4809,13,1385799051,1385799351,1,1,300
63520495@N08,4810,13,1385879507,1385879807,1,1,300
63520495@N08,4811,5,1400917773,1400917893,4,7,120
63520495@N08,4811,18,1400918727,1400918894,3,7,167
63520495@N08,4811,11,1400918894,1400918986,4,7,92
63520495@N08,4811,7,1400918986,1400919106,2,7,120
63520495@N08,4811,16,1400919177,1400919352,2,7,175
63520495@N08,4811,17,1400919352,1400919561,2,7,209
63520495@N08,4811,12,1400919561,1400919831,1,7,270
63520495@N08,4812,19,1401345355,1401345895,1,1,540
63520495@N08,4813,19,1413782375,1413782915,1,1,540
63520495@N08,4814,17,1423983828,1423984248,1,1,420
63520495@N08,4815,17,1456051693,1456052113,1,1,420
63520495@N08,4816,12,1471258508,1471258778,1,1,270
63579498@N08,4817,11,1214827548,1214827585,2,2,37
63579498@N08,4817,7,1214827585,1214827705,1,2,120
63631877@N00,4818,15,1249100933,1249101293,1,1,360
63631877@N00,4819,7,1275565027,1275565147,1,1,120
63631877@N00,4820,17,1277617895,1277618315,1,1,420
63631877@N00,4821,16,1278296891,1278297311,1,1,420
63674444@N05,4822,24,1437302584,1437304084,1,1,1500
63689406@N00,4823,16,1268987523,1268987658,2,3,135
63689406@N00,4823,11,1268987658,1268987898,2,3,240
63689406@N00,4823,10,1268991926,1268992076,1,3,150
63689406@N00,4824,18,1269049181,1269049721,2,2,540
63689406@N00,4824,7,1269050598,1269050718,1,2,120
63689406@N00,4825,12,1269157601,1269157871,2,4,270
63689406@N00,4825,16,1269160692,1269161112,2,4,420
63689406@N00,4825,4,1269164048,1269164138,2,4,90
63689406@N00,4825,18,1269167842,1269168382,1,4,540
63773896@N03,4826,12,1432343661,1432343928,3,3,267
63773896@N03,4826,24,1432343928,1432345428,2,3,1500
63773896@N03,4826,12,1432345446,1432345716,2,3,270
63903226@N06,4827,13,1337512724,1337513024,1,1,300
63903226@N06,4828,12,1340661584,1340661854,1,1,270
63903226@N06,4829,25,1351232209,1351234309,1,1,2100
63903226@N06,4830,2,1374320401,1374320461,1,1,60
63903226@N06,4831,14,1376864154,1376864514,3,2,360
63903226@N06,4831,20,1376868489,1376869089,1,2,600
63903226@N06,4832,6,1378382119,1378382239,1,1,120
63903226@N06,4833,25,1383542803,1383544903,2,1,2100
63903226@N06,4834,24,1398060356,1398061856,1,1,1500
63903226@N06,4835,19,1408441915,1408442455,1,1,540
63950273@N08,4836,16,1328424019,1328424439,1,1,420
63955107@N08,4837,18,1424676431,1424676971,1,1,540
63955107@N08,4838,18,1424739888,1424740428,1,1,540
63968574@N03,4839,14,1345497812,1345498172,2,2,360
63968574@N03,4839,6,1345498319,1345498439,2,2,120
63968574@N03,4840,19,1349170044,1349170584,2,2,540
63968574@N03,4840,14,1349170725,1349171085,1,2,360
63968574@N03,4841,7,1353986513,1353986633,2,1,120
63968574@N03,4842,23,1362037812,1362039012,2,2,1200
63968574@N03,4842,6,1362041279,1362041399,10,2,120
63968574@N03,4843,6,1362470571,1362470691,4,1,120
63968574@N03,4844,6,1362645341,1362645461,1,1,120
63968574@N03,4845,19,1370314379,1370314919,21,3,540
63968574@N03,4845,6,1370324357,1370324477,6,3,120
63968574@N03,4845,19,1370331231,1370331771,2,3,540
63968574@N03,4846,19,1376264098,1376264638,13,1,540
63968574@N03,4847,19,1386974136,1386974676,12,1,540
63968574@N03,4848,19,1390190575,1390191115,16,1,540
63968574@N03,4849,19,1391557409,1391557949,17,1,540
63968574@N03,4850,19,1409650725,1409651265,39,1,540
63971589@N00,4851,14,1349588261,1349588621,1,1,360
63971589@N00,4852,12,1349624475,1349624745,1,1,270
63971589@N00,4853,7,1349677303,1349677423,1,1,120
63971589@N00,4854,11,1349707922,1349708162,1,1,240
63971589@N00,4855,16,1380894931,1380895351,1,1,420
63971589@N00,4856,17,1433413463,1433413883,1,1,420
63971589@N00,4857,11,1434605760,1434606000,1,1,240
63971589@N00,4858,23,1444001821,1444003021,1,1,1200
63971589@N00,4859,17,1444046702,1444047122,1,1,420
64008250@N00,4860,15,1353299594,1353299954,1,1,360
64098965@N00,4861,10,1205491545,1205491548,2,5,3
64098965@N00,4861,18,1205491548,1205491551,2,5,3
64098965@N00,4861,7,1205491551,1205491559,2,5,8
64098965@N00,4861,16,1205491559,1205491819,2,5,260
64098965@N00,4861,15,1205491819,1205492179,2,5,360
64098965@N00,4862,17,1206787983,1206787987,2,3,4
64098965@N00,4862,18,1206787987,1206787998,2,3,11
64098965@N00,4862,16,1206787998,1206788418,1,3,420
64111181@N00,4863,7,1278249354,1278249474,2,4,120
64111181@N00,4863,10,1278249612,1278249762,2,4,150
64111181@N00,4863,16,1278250926,1278250928,2,4,2
64111181@N00,4863,10,1278250928,1278251078,1,4,150
64202793@N00,4864,12,1393900429,1393900699,3,1,270
64202793@N00,4865,25,1393974379,1393974748,2,23,369
64202793@N00,4865,13,1393974748,1393975048,4,23,300
64202793@N00,4865,25,1393975778,1393975780,2,23,2
64202793@N00,4865,15,1393975780,1393975781,2,23,1
64202793@N00,4865,25,1393975781,1393976012,8,23,231
64202793@N00,4865,15,1393976012,1393976016,2,23,4
64202793@N00,4865,25,1393976016,1393977757,8,23,1741
64202793@N00,4865,15,1393977757,1393978117,5,23,360
64202793@N00,4865,2,1393978239,1393978299,4,23,60
64202793@N00,4865,19,1393986034,1393986574,2,23,540
64202793@N00,4865,14,1393989116,1393989399,4,23,283
64202793@N00,4865,3,1393989399,1393989489,3,23,90
64202793@N00,4865,6,1393989620,1393989740,2,23,120
64202793@N00,4865,8,1393989942,1393990062,2,23,120
64202793@N00,4865,16,1393991527,1393991947,2,23,420
64202793@N00,4865,11,1393995085,1393995325,3,23,240
64202793@N00,4865,16,1393997829,1393998081,2,23,252
64202793@N00,4865,18,1393998081,1393998621,8,23,540
64202793@N00,4865,5,1393999109,1393999229,5,23,120
64202793@N00,4865,24,1394002484,1394003085,11,23,601
64202793@N00,4865,6,1394003085,1394003205,6,23,120
64202793@N00,4865,16,1394005262,1394005440,3,23,178
64202793@N00,4865,10,1394005440,1394005590,12,23,150
64202793@N00,4866,12,1394061404,1394061674,6,1,270
64222010@N05,4867,10,1413879185,1413879335,1,1,150
64286385@N06,4868,5,1368951597,1368951717,1,1,120
64286456@N00,4869,13,1373626399,1373626699,1,1,300
64286456@N00,4870,24,1375441526,1375443026,1,1,1500
64286456@N00,4871,16,1385471764,1385472184,1,1,420
64405577@N00,4872,12,1295613717,1295613987,2,2,270
64405577@N00,4872,25,1295617900,1295620000,1,2,2100
64405577@N00,4873,13,1296877866,1296878166,5,2,300
64405577@N00,4873,12,1296880818,1296881088,1,2,270
64453831@N08,4874,16,1460965593,1460966013,2,1,420
64482733@N02,4875,12,1315213093,1315213363,1,1,270
64560041@N04,4876,12,1346459438,1346459708,2,2,270
64560041@N04,4876,18,1346459939,1346460479,3,2,540
64560041@N04,4877,12,1346555067,1346555337,1,1,270
64560041@N04,4878,16,1346629339,1346629759,1,1,420
64560041@N04,4879,7,1357024105,1357024225,1,1,120
64569741@N00,4880,22,1310288063,1310289083,2,2,1020
64569741@N00,4880,15,1310290083,1310290443,1,2,360
64569741@N00,4881,14,1340444233,1340444593,3,2,360
64569741@N00,4881,13,1340447301,1340447601,1,2,300
64569741@N00,4882,24,1341788092,1341788867,2,8,775
64569741@N00,4882,12,1341788867,1341789137,2,8,270
64569741@N00,4882,14,1341791315,1341791675,2,8,360
64569741@N00,4882,11,1341792696,1341792936,2,8,240
64569741@N00,4882,18,1341795216,1341795756,3,8,540
64569741@N00,4882,16,1341801558,1341801978,2,8,420
64569741@N00,4882,19,1341826408,1341826948,2,8,540
64569741@N00,4882,14,1341827026,1341827386,1,8,360
64569741@N00,4883,16,1342432476,1342432896,2,2,420
64569741@N00,4883,6,1342433433,1342433553,1,2,120
64569741@N00,4884,13,1342527811,1342528111,1,1,300
64569741@N00,4885,19,1345629065,1345629605,1,1,540
64569741@N00,4886,19,1346069272,1346069812,1,1,540
64569741@N00,4887,12,1347177826,1347178096,2,3,270
64569741@N00,4887,7,1347180174,1347180294,2,3,120
64569741@N00,4887,19,1347185994,1347186534,1,3,540
64569741@N00,4888,13,1348398915,1348399215,4,1,300
64569741@N00,4889,13,1351418031,1351418331,1,1,300
64569741@N00,4890,12,1353119959,1353120229,1,1,270
64569741@N00,4891,13,1353666980,1353667280,1,1,300
64569741@N00,4892,13,1360492602,1360492902,1,1,300
64576282@N00,4893,25,1189917087,1189919187,1,1,2100
64576282@N00,4894,13,1256901229,1256901529,1,1,300
64576282@N00,4895,19,1278839310,1278839850,2,3,540
64576282@N00,4895,18,1278846768,1278847308,2,3,540
64576282@N00,4895,16,1278847642,1278848062,1,3,420
64576282@N00,4896,13,1280660902,1280661202,2,2,300
64576282@N00,4896,25,1280663894,1280665994,1,2,2100
64576282@N00,4897,17,1284374975,1284375395,1,1,420
64576282@N00,4898,25,1291081621,1291083146,2,2,1525
64576282@N00,4898,12,1291083146,1291083416,1,2,270
64576282@N00,4899,12,1291530758,1291531028,2,2,270
64576282@N00,4899,25,1291538106,1291540206,10,2,2100
64576282@N00,4900,18,1305630316,1305630856,2,1,540
64576282@N00,4901,24,1339039255,1339040755,3,2,1500
64576282@N00,4901,14,1339041667,1339042027,5,2,360
64576282@N00,4902,23,1362380674,1362381874,5,1,1200
64579523@N02,4903,17,1288341596,1288342016,1,1,420
64579523@N02,4904,17,1297414938,1297415358,3,1,420
64579523@N02,4905,17,1303552934,1303553354,1,1,420
64579523@N02,4906,17,1306936260,1306936680,1,1,420
64591327@N00,4907,17,1427795680,1427796100,1,1,420
64591327@N00,4908,17,1435055850,1435056270,1,1,420
64604717@N03,4909,23,1218094691,1218095891,1,1,1200
64604717@N03,4910,17,1218183676,1218183881,2,3,205
64604717@N03,4910,12,1218183881,1218184151,2,3,270
64604717@N03,4910,18,1218195651,1218196191,1,3,540
64604717@N03,4911,6,1218255065,1218255185,2,3,120
64604717@N03,4911,3,1218259349,1218259405,2,3,56
64604717@N03,4911,17,1218259405,1218259825,1,3,420
64658966@N06,4912,16,1329749083,1329749503,1,1,420
64661221@N00,4913,17,1274888375,1274888795,1,1,420
64724295@N08,4914,19,1313623704,1313624244,1,1,540
64724295@N08,4915,16,1325442211,1325442631,1,1,420
64724295@N08,4916,8,1326137832,1326137952,1,1,120
64724295@N08,4917,20,1332987479,1332988079,2,1,600
64724295@N08,4918,19,1337599701,1337600241,1,1,540
64724295@N08,4919,24,1338802266,1338803766,1,1,1500
64769814@N00,4920,12,1225620912,1225621182,1,1,270
64822977@N00,4921,24,1333603274,1333603384,4,11,110
64822977@N00,4921,16,1333603384,1333603804,8,11,420
64822977@N00,4921,5,1333604666,1333604786,3,11,120
64822977@N00,4921,16,1333605034,1333605327,2,11,293
64822977@N00,4921,17,1333605327,1333605747,2,11,420
64822977@N00,4921,18,1333614727,1333615267,5,11,540
64822977@N00,4921,16,1333617258,1333617678,6,11,420
64822977@N00,4921,10,1333620017,1333620022,2,11,5
64822977@N00,4921,6,1333620022,1333620142,6,11,120
64822977@N00,4921,17,1333623356,1333623401,3,11,45
64822977@N00,4921,10,1333623401,1333623551,4,11,150
64822977@N00,4922,17,1333683019,1333683439,8,1,420
64822977@N00,4923,17,1333758433,1333758853,17,9,420
64822977@N00,4923,19,1333765860,1333766400,21,9,540
64822977@N00,4923,7,1333770238,1333770358,2,9,120
64822977@N00,4923,17,1333770798,1333770802,2,9,4
64822977@N00,4923,18,1333770802,1333771342,14,9,540
64822977@N00,4923,16,1333772931,1333773351,21,9,420
64822977@N00,4923,18,1333778712,1333779252,5,9,540
64822977@N00,4923,17,1333782668,1333782951,3,9,283
64822977@N00,4923,20,1333782951,1333783551,1,9,600
64823004@N05,4924,6,1330645326,1330645446,1,1,120
64882335@N00,4925,14,1364219348,1364219708,1,1,360
64882335@N00,4926,12,1364286771,1364287041,1,1,270
64985588@N06,4927,13,1310987808,1310988108,1,1,300
64985588@N06,4928,18,1327702210,1327702750,1,1,540
64985588@N06,4929,13,1329029164,1329029464,2,2,300
64985588@N06,4929,16,1329030069,1329030489,1,2,420
64985588@N06,4930,24,1338294035,1338295535,1,1,1500
64985588@N06,4931,14,1341144428,1341144788,1,1,360
65009812@N02,4932,18,1429180560,1429181100,2,1,540
65067917@N00,4933,23,1368841499,1368842699,1,1,1200
65067917@N00,4934,20,1368919700,1368919726,2,3,26
65067917@N00,4934,16,1368919726,1368919750,2,3,24
65067917@N00,4934,23,1368919750,1368920950,1,3,1200
65086656@N08,4935,25,1452404316,1452406416,1,1,2100
65105672@N00,4936,16,1284620240,1284620660,8,1,420
65218660@N03,4937,16,1319880619,1319881039,1,1,420
65222004@N00,4938,12,1214571543,1214571813,1,1,270
65321004@N02,4939,12,1325060005,1325060275,1,1,270
65374071@N00,4940,12,1341882982,1341883252,2,5,270
65374071@N00,4940,14,1341903582,1341903942,2,5,360
65374071@N00,4940,16,1341907480,1341907900,2,5,420
65374071@N00,4940,24,1341908004,1341909504,2,5,1500
65374071@N00,4940,25,1341910231,1341912331,2,5,2100
65374071@N00,4941,22,1341952725,1341953745,1,1,1020
65374071@N00,4942,24,1371908750,1371910250,1,1,1500
65404669@N02,4943,12,1347497677,1347497947,3,11,270
65404669@N02,4943,25,1347498584,1347498964,2,11,380
65404669@N02,4943,2,1347498964,1347499024,2,11,60
65404669@N02,4943,19,1347499374,1347499914,4,11,540
65404669@N02,4943,14,1347500431,1347500791,5,11,360
65404669@N02,4943,8,1347500997,1347501117,2,11,120
65404669@N02,4943,19,1347504125,1347504665,3,11,540
65404669@N02,4943,23,1347505392,1347506197,3,11,805
65404669@N02,4943,19,1347506197,1347506737,2,11,540
65404669@N02,4943,8,1347511460,1347511580,3,11,120
65404669@N02,4943,24,1347513068,1347514568,1,11,1500
65404669@N02,4944,12,1347579158,1347579428,2,22,270
65404669@N02,4944,19,1347583453,1347583719,3,22,266
65404669@N02,4944,14,1347583719,1347584079,12,22,360
65404669@N02,4944,18,1347585567,1347585930,2,22,363
65404669@N02,4944,14,1347585930,1347586290,9,22,360
65404669@N02,4944,6,1347593234,1347593354,3,22,120
65404669@N02,4944,14,1347594326,1347594686,2,22,360
65404669@N02,4944,12,1347613399,1347613399,2,22,0
65404669@N02,4944,24,1347613399,1347614899,2,22,1500
65404669@N02,4944,16,1347615695,1347615856,2,22,161
65404669@N02,4944,19,1347615856,1347616139,2,22,283
65404669@N02,4944,6,1347616139,1347616233,2,22,94
65404669@N02,4944,19,1347616233,1347616427,3,22,194
65404669@N02,4944,14,1347616427,1347616787,12,22,360
65404669@N02,4944,19,1347618024,1347618564,2,22,540
65404669@N02,4944,14,1347619128,1347619458,3,22,330
65404669@N02,4944,19,1347619458,1347619998,3,22,540
65404669@N02,4944,16,1347620302,1347620396,4,22,94
65404669@N02,4944,10,1347620396,1347620526,2,22,130
65404669@N02,4944,16,1347620526,1347620946,3,22,420
65404669@N02,4944,10,1347621091,1347621204,2,22,113
65404669@N02,4944,16,1347621204,1347621624,15,22,420
65404669@N02,4945,16,1347671266,1347671686,1,1,420
65404669@N02,4946,14,1348126544,1348126904,1,1,360
65404669@N02,4947,19,1355991875,1355992415,1,1,540
65404669@N02,4948,14,1356065906,1356066266,1,1,360
65404669@N02,4949,6,1356567484,1356567604,1,1,120
65515841@N05,4950,16,1355721335,1355721583,2,2,248
65515841@N05,4950,7,1355721583,1355721703,1,2,120
65515841@N05,4951,18,1375262864,1375263404,1,1,540
65515841@N05,4952,14,1378788239,1378788599,6,1,360
65543500@N00,4953,12,1445980854,1445981124,1,1,270
65543500@N00,4954,24,1446065403,1446066442,2,13,1039
65543500@N00,4954,16,1446066442,1446066862,2,13,420
65543500@N00,4954,18,1446067334,1446067874,2,13,540
65543500@N00,4954,19,1446074173,1446074713,5,13,540
65543500@N00,4954,14,1446076122,1446076482,4,13,360
65543500@N00,4954,17,1446082399,1446082819,4,13,420
65543500@N00,4954,23,1446085587,1446086291,2,13,704
65543500@N00,4954,16,1446086291,1446086711,2,13,420
65543500@N00,4954,19,1446090210,1446090750,4,13,540
65543500@N00,4954,8,1446092043,1446092163,2,13,120
65543500@N00,4954,13,1446098844,1446099144,5,13,300
65543500@N00,4954,11,1446101685,1446101876,2,13,191
65543500@N00,4954,19,1446101876,1446102416,6,13,540
65568471@N00,4955,8,1323399960,1323400080,1,1,120
65627981@N06,4956,11,1412095161,1412095401,1,1,240
65645597@N00,4957,11,1442114089,1442114329,2,12,240
65645597@N00,4957,16,1442116003,1442116423,3,12,420
65645597@N00,4957,15,1442117483,1442117843,3,12,360
65645597@N00,4957,6,1442119968,1442120088,3,12,120
65645597@N00,4957,15,1442120799,1442121159,2,12,360
65645597@N00,4957,22,1442121592,1442122612,2,12,1020
65645597@N00,4957,25,1442130388,1442130615,2,12,227
65645597@N00,4957,5,1442130615,1442130735,2,12,120
65645597@N00,4957,16,1442130984,1442131404,3,12,420
65645597@N00,4957,19,1442132529,1442132713,2,12,184
65645597@N00,4957,7,1442132713,1442132833,2,12,120
65645597@N00,4957,14,1442133066,1442133426,2,12,360
65651806@N00,4958,7,1293520505,1293520625,1,1,120
65679275@N02,4959,3,1369293236,1369293326,1,1,90
65679275@N02,4960,24,1369407336,1369408836,1,1,1500
65679275@N02,4961,16,1370932209,1370932629,1,1,420
65679275@N02,4962,24,1371290347,1371291847,1,1,1500
65679275@N02,4963,7,1376000331,1376000451,1,1,120
65784570@N00,4964,11,1387163188,1387163428,1,1,240
65883612@N08,4965,7,1362362895,1362363015,2,2,120
65883612@N08,4965,6,1362384041,1362384161,1,2,120
65883612@N08,4966,16,1362536842,1362537262,2,2,420
65883612@N08,4966,24,1362559919,1362561419,1,2,1500
65925308@N02,4967,24,1373801870,1373803370,1,1,1500
65925308@N02,4968,14,1375907312,1375907672,1,1,360
65925308@N02,4969,24,1376257900,1376259400,1,1,1500
65945527@N00,4970,12,1205288316,1205288345,3,4,29
65945527@N00,4970,24,1205288345,1205288383,2,4,38
65945527@N00,4970,23,1205288383,1205288505,4,4,122
65945527@N00,4970,16,1205288505,1205288925,1,4,420
65945527@N00,4971,18,1210088317,1210088857,1,1,540
65959869@N08,4972,7,1343096198,1343096318,2,5,120
65959869@N08,4972,11,1343098014,1343098254,3,5,240
65959869@N08,4972,7,1343101287,1343101407,2,5,120
65959869@N08,4972,24,1343129204,1343130704,2,5,1500
65959869@N08,4972,14,1343130720,1343131080,1,5,360
65959869@N08,4973,19,1343211626,1343212166,2,4,540
65959869@N08,4973,14,1343219332,1343219692,2,4,360
65959869@N08,4973,25,1343219770,1343220067,2,4,297
65959869@N08,4973,9,1343220067,1343220187,1,4,120
65959869@N08,4974,18,1343384474,1343385014,1,1,540
65997263@N08,4975,16,1352918039,1352918459,2,2,420
65997263@N08,4975,8,1352945735,1352945855,1,2,120
65997263@N08,4976,17,1408520467,1408520887,1,1,420
66008314@N00,4977,3,1216517512,1216517602,1,1,90
66008314@N00,4978,13,1223096881,1223097181,2,1,300
66008314@N00,4979,15,1275099095,1275099455,1,1,360
66008314@N00,4980,11,1292643430,1292643670,3,5,240
66008314@N00,4980,18,1292649262,1292649269,2,5,7
66008314@N00,4980,5,1292649269,1292649389,5,5,120
66008314@N00,4980,13,1292654481,1292654781,3,5,300
66008314@N00,4980,25,1292655464,1292657564,1,5,2100
66008314@N00,4981,7,1321073414,1321073534,1,1,120
66008314@N00,4982,7,1322972427,1322972547,2,2,120
66008314@N00,4982,18,1322972590,1322973130,1,2,540
66008314@N00,4983,19,1342234354,1342234894,3,2,540
66008314@N00,4983,14,1342235557,1342235917,1,2,360
66008314@N00,4984,11,1342314622,1342314862,2,3,240
66008314@N00,4984,10,1342327777,1342327877,2,3,100
66008314@N00,4984,16,1342327877,1342328297,1,3,420
66008314@N00,4985,12,1349427982,1349428252,3,3,270
66008314@N00,4985,25,1349432621,1349434721,6,3,2100
66008314@N00,4985,12,1349441097,1349441367,2,3,270
66008314@N00,4986,23,1349516106,1349517306,2,1,1200
66008314@N00,4987,14,1349554427,1349554787,2,3,360
66008314@N00,4987,19,1349558073,1349558613,3,3,540
66008314@N00,4987,23,1349577342,1349578542,2,3,1200
66026223@N08,4988,4,1378024422,1378024512,2,3,90
66026223@N08,4988,14,1378034002,1378034105,2,3,103
66026223@N08,4988,6,1378034105,1378034225,1,3,120
66026223@N08,4989,14,1378086028,1378086388,1,1,360
66026223@N08,4990,7,1382662152,1382662272,2,3,120
66026223@N08,4990,15,1382678351,1382678711,2,3,360
66026223@N08,4990,24,1382686187,1382687687,1,3,1500
66026223@N08,4991,7,1382742507,1382742627,2,2,120
66026223@N08,4991,24,1382744309,1382745809,1,2,1500
66026223@N08,4992,7,1382958419,1382958539,1,1,120
66064257@N08,4993,2,1405241621,1405241681,2,2,60
66064257@N08,4993,18,1405247518,1405248058,1,2,540
66064257@N08,4994,18,1409376105,1409376645,1,1,540
66064257@N08,4995,17,1429404954,1429405374,2,1,420
66103198@N07,4996,24,1386808326,1386809826,1,1,1500
66160101@N03,4997,11,1313902818,1313903058,1,1,240
66234998@N00,4998,19,1299750381,1299750921,1,1,540
66292766@N05,4999,17,1451523325,1451523745,1,1,420
66294030@N00,5000,19,1297125708,1297126248,1,1,540
66304943@N00,5001,12,1196769239,1196769240,3,2,1
66304943@N00,5001,16,1196769240,1196769660,1,2,420
66313469@N06,5002,22,1329851661,1329852681,13,1,1020
66313469@N06,5003,23,1330013148,1330014348,4,1,1200
66313469@N06,5004,13,1332792350,1332792650,1,1,300
66313469@N06,5005,24,1333480926,1333482426,14,1,1500
66313469@N06,5006,24,1333567133,1333568633,6,1,1500
66316766@N06,5007,17,1350647935,1350648355,1,1,420
66316766@N06,5008,24,1353044278,1353045778,1,1,1500
66316766@N06,5009,17,1353810633,1353811053,1,1,420
66316766@N06,5010,6,1355309231,1355309351,1,1,120
66316766@N06,5011,8,1355895226,1355895346,2,1,120
66316766@N06,5012,25,1357032559,1357034659,1,1,2100
66316766@N06,5013,24,1357441350,1357442850,2,1,1500
66316766@N06,5014,8,1363917136,1363917256,1,1,120
66316766@N06,5015,10,1367298983,1367299133,2,1,150
66370462@N07,5016,19,1311648593,1311649133,1,1,540
66406888@N08,5017,19,1334309159,1334309699,1,1,540
66406888@N08,5018,19,1337920488,1337920555,2,3,67
66406888@N08,5018,24,1337920555,1337920572,2,3,17
66406888@N08,5018,19,1337920572,1337921112,5,3,540
66406888@N08,5019,12,1338272903,1338273173,1,1,270
66406888@N08,5020,20,1341723324,1341723924,1,1,600
66406888@N08,5021,14,1342094389,1342094749,1,1,360
66406888@N08,5022,19,1342264318,1342264858,1,1,540
66406888@N08,5023,19,1343781424,1343781964,2,1,540
66406888@N08,5024,19,1344930503,1344931043,1,1,540
66406888@N08,5025,19,1345859546,1345860086,2,2,540
66406888@N08,5025,24,1345862018,1345863518,2,2,1500
66406888@N08,5026,19,1346310527,1346311067,4,2,540
66406888@N08,5026,12,1346312939,1346313209,1,2,270
66406888@N08,5027,20,1346999213,1346999813,1,1,600
66406888@N08,5028,14,1347697590,1347697950,1,1,360
66406888@N08,5029,20,1347968365,1347968965,1,1,600
66406888@N08,5030,14,1348533647,1348534007,1,1,360
66406888@N08,5031,24,1349424999,1349426499,1,1,1500
66406888@N08,5032,16,1387717200,1387717620,1,1,420
66406888@N08,5033,16,1388408400,1388408820,1,1,420
66478195@N00,5034,24,1277838471,1277839971,25,1,1500
66626894@N06,5035,14,1345426539,1345426899,1,1,360
66626894@N06,5036,6,1345455957,1345456077,4,2,120
66626894@N06,5036,14,1345457013,1345457373,3,2,360
66709589@N08,5037,23,1324271471,1324272671,1,1,1200
66718423@N03,5038,19,1365207816,1365207839,2,4,23
66718423@N03,5038,14,1365207839,1365207891,2,4,52
66718423@N03,5038,19,1365207891,1365208431,2,4,540
66718423@N03,5038,7,1365209352,1365209472,1,4,120
66729316@N00,5039,17,1253927292,1253927712,20,5,420
66729316@N00,5039,11,1253936413,1253936653,2,5,240
66729316@N00,5039,17,1253936836,1253937256,2,5,420
66729316@N00,5039,16,1253939358,1253939778,2,5,420
66729316@N00,5039,17,1253940291,1253940711,4,5,420
66729316@N00,5040,17,1254016564,1254016984,12,2,420
66729316@N00,5040,24,1254030110,1254031610,2,2,1500
66729316@N00,5041,17,1254101178,1254101598,1,1,420
66729316@N00,5042,12,1254195271,1254195541,2,2,270
66729316@N00,5042,11,1254199434,1254199674,1,2,240
66729316@N00,5043,12,1254253025,1254253295,2,3,270
66729316@N00,5043,17,1254254047,1254254467,10,3,420
66729316@N00,5043,12,1254267417,1254267687,1,3,270
66729316@N00,5044,12,1306104261,1306104531,3,1,270
66729316@N00,5045,18,1306141832,1306141851,2,5,19
66729316@N00,5045,10,1306141851,1306142001,2,5,150
66729316@N00,5045,11,1306143792,1306144032,2,5,240
66729316@N00,5045,7,1306144425,1306144446,2,5,21
66729316@N00,5045,11,1306144446,1306144686,1,5,240
66729316@N00,5046,12,1306277543,1306277813,3,5,270
66729316@N00,5046,17,1306284149,1306284569,3,5,420
66729316@N00,5046,7,1306286929,1306287049,2,5,120
66729316@N00,5046,17,1306287535,1306287955,5,5,420
66729316@N00,5046,7,1306293296,1306293416,1,5,120
66729316@N00,5047,11,1306401728,1306401968,5,1,240
66729316@N00,5048,17,1306486122,1306486542,1,1,420
66729316@N00,5049,13,1343944800,1343944868,3,4,68
66729316@N00,5049,25,1343944868,1343946803,3,4,1935
66729316@N00,5049,15,1343946803,1343947163,3,4,360
66729316@N00,5049,11,1343955379,1343955619,1,4,240
66729316@N00,5050,22,1344118985,1344119097,2,7,112
66729316@N00,5050,25,1344119097,1344121197,2,7,2100
66729316@N00,5050,16,1344125275,1344125695,2,7,420
66729316@N00,5050,22,1344127970,1344128990,4,7,1020
66729316@N00,5050,15,1344129183,1344129543,2,7,360
66729316@N00,5050,1,1344130003,1344130063,3,7,60
66729316@N00,5050,20,1344133265,1344133865,1,7,600
66736603@N00,5051,7,1390712317,1390712437,1,1,120
66759343@N00,5052,16,1281095683,1281096103,1,1,420
66787548@N00,5053,12,1297392345,1297392615,2,2,270
66787548@N00,5053,5,1297393941,1297394061,1,2,120
66787548@N00,5054,12,1298086812,1298087082,1,1,270
66787548@N00,5055,13,1298175096,1298175396,2,2,300
66787548@N00,5055,5,1298178025,1298178145,4,2,120
66787548@N00,5056,14,1355555569,1355555929,1,1,360
66787548@N00,5057,14,1355989857,1355990217,2,2,360
66787548@N00,5057,6,1355992880,1355993000,1,2,120
66787548@N00,5058,19,1356663010,1356663550,2,4,540
66787548@N00,5058,11,1356665669,1356665909,2,4,240
66787548@N00,5058,14,1356683510,1356683870,3,4,360
66787548@N00,5058,15,1356688753,1356689113,1,4,360
66787548@N00,5059,15,1361440901,1361441261,1,1,360
66804874@N04,5060,14,1335953755,1335954115,2,2,360
66804874@N04,5060,19,1335956913,1335957453,1,2,540
66826171@N06,5061,14,1321571330,1321571690,3,1,360
66826171@N06,5062,14,1322075887,1322076247,1,1,360
66826171@N06,5063,14,1332256235,1332256595,1,1,360
66899692@N05,5064,11,1315194025,1315194265,1,1,240
66905940@N00,5065,15,1327210498,1327210858,2,3,360
66905940@N00,5065,22,1327211170,1327212190,2,3,1020
66905940@N00,5065,20,1327222531,1327223131,1,3,600
66905940@N00,5066,20,1358911753,1358912353,3,1,600
66905940@N00,5067,20,1358976049,1358976649,4,1,600
66905940@N00,5068,12,1359064661,1359064931,1,1,270
66905940@N00,5069,6,1359156415,1359156535,1,1,120
66994870@N00,5070,17,1256705776,1256706196,3,2,420
66994870@N00,5070,12,1256712955,1256713225,2,2,270
66994870@N00,5071,16,1393124639,1393124864,2,2,225
66994870@N00,5071,10,1393124864,1393125014,1,2,150
67038547@N08,5072,14,1419092296,1419092478,2,2,182
67038547@N08,5072,12,1419092478,1419092748,1,2,270
67093054@N00,5073,5,1367138755,1367138780,2,2,25
67093054@N00,5073,18,1367138780,1367139320,1,2,540
67093054@N00,5074,24,1394356840,1394356901,3,9,61
67093054@N00,5074,22,1394356901,1394356967,3,9,66
67093054@N00,5074,25,1394356967,1394357494,3,9,527
67093054@N00,5074,2,1394357494,1394357554,3,9,60
67093054@N00,5074,14,1394357703,1394358063,16,9,360
67093054@N00,5074,6,1394362693,1394362726,3,9,33
67093054@N00,5074,8,1394362726,1394362758,2,9,32
67093054@N00,5074,6,1394362758,1394362878,2,9,120
67093054@N00,5074,20,1394363245,1394363845,1,9,600
67246822@N00,5075,18,1237963068,1237963608,2,2,540
67246822@N00,5075,17,1237967764,1237968184,5,2,420
67246822@N00,5076,24,1238021593,1238023093,2,3,1500
67246822@N00,5076,25,1238023472,1238025572,4,3,2100
67246822@N00,5076,15,1238045716,1238046076,5,3,360
67246822@N00,5077,17,1355177094,1355177514,2,4,420
67246822@N00,5077,16,1355177652,1355178072,2,4,420
67246822@N00,5077,12,1355198532,1355198802,2,4,270
67246822@N00,5077,14,1355199752,1355200112,2,4,360
67246822@N00,5078,6,1355293899,1355293977,2,3,78
67246822@N00,5078,19,1355293977,1355294517,2,3,540
67246822@N00,5078,7,1355300131,1355300251,1,3,120
67246822@N00,5079,17,1355365297,1355365405,2,2,108
67246822@N00,5079,7,1355365405,1355365525,1,2,120
67260043@N04,5080,25,1324686078,1324688178,2,14,2100
67260043@N04,5080,20,1324689918,1324690518,2,14,600
67260043@N04,5080,21,1324690677,1324691577,2,14,900
67260043@N04,5080,4,1324696099,1324696189,2,14,90
67260043@N04,5080,16,1324698548,1324698968,2,14,420
67260043@N04,5080,17,1324699209,1324699629,2,14,420
67260043@N04,5080,11,1324701023,1324701116,2,14,93
67260043@N04,5080,18,1324701116,1324701523,2,14,407
67260043@N04,5080,11,1324701523,1324701763,2,14,240
67260043@N04,5080,18,1324702254,1324702794,3,14,540
67260043@N04,5080,7,1324703074,1324703194,2,14,120
67260043@N04,5080,22,1324718059,1324718723,3,14,664
67260043@N04,5080,24,1324718723,1324720223,4,14,1500
67260043@N04,5080,16,1324721415,1324721835,11,14,420
67357106@N00,5081,23,1245546564,1245547764,1,1,1200
67358831@N00,5082,13,1259901446,1259901746,1,1,300
67406704@N00,5083,5,1287706995,1287707115,1,1,120
67406704@N00,5084,18,1287810280,1287810820,1,1,540
67406704@N00,5085,13,1291188390,1291188690,2,1,300
67414260@N04,5086,11,1359893829,1359893925,2,2,96
67414260@N04,5086,19,1359893925,1359894465,1,2,540
67414260@N04,5087,11,1374926644,1374926884,1,1,240
67506747@N00,5088,24,1262226557,1262228057,1,1,1500
67582642@N00,5089,18,1260340767,1260341307,1,1,540
67582642@N00,5090,18,1294549663,1294550203,1,1,540
67596892@N00,5091,16,1450693359,1450693779,1,1,420
67601202@N00,5092,18,1190003473,1190004013,2,1,540
67621043@N00,5093,6,1369204438,1369204558,1,1,120
67621043@N00,5094,19,1427597049,1427597589,1,1,540
67764891@N00,5095,24,1259621471,1259622971,1,1,1500
67839741@N06,5096,12,1390702343,1390702613,1,1,270
67839741@N06,5097,7,1391304849,1391304969,1,1,120
67839741@N06,5098,24,1391826937,1391828437,3,1,1500
67839741@N06,5099,3,1392606782,1392606872,1,1,90
67839741@N06,5100,12,1401498364,1401498634,1,1,270
67839741@N06,5101,7,1402105366,1402105486,2,1,120
67839741@N06,5102,6,1403132178,1403132298,1,1,120
67839741@N06,5103,19,1411264099,1411264639,1,1,540
67839741@N06,5104,3,1416266071,1416266161,1,1,90
67839741@N06,5105,18,1420075846,1420076386,1,1,540
67839741@N06,5106,3,1422751165,1422751255,1,1,90
67839741@N06,5107,1,1428486345,1428486405,1,1,60
67839741@N06,5108,19,1436431061,1436431601,1,1,540
67839741@N06,5109,19,1438334464,1438335004,1,1,540
67839741@N06,5110,19,1441181458,1441181998,1,1,540
68010983@N07,5111,19,1346579759,1346580299,1,1,540
68092559@N06,5112,24,1383066041,1383067541,1,1,1500
68092559@N06,5113,6,1399932477,1399932597,1,1,120
68092559@N06,5114,18,1406010659,1406011199,1,1,540
68092559@N06,5115,18,1411905933,1411906473,1,1,540
68092559@N06,5116,17,1432265730,1432266150,1,1,420
68126271@N03,5117,17,1431773888,1431774308,1,1,420
68135081@N00,5118,15,1403359215,1403359575,1,1,360
68217111@N00,5119,19,1329011431,1329011971,11,7,540
68217111@N00,5119,10,1329015240,1329015390,3,7,150
68217111@N00,5119,18,1329017229,1329017769,6,7,540
68217111@N00,5119,7,1329018215,1329018335,36,7,120
68217111@N00,5119,11,1329020038,1329020278,18,7,240
68217111@N00,5119,8,1329021841,1329021961,4,7,120
68217111@N00,5119,12,1329023067,1329023337,1,7,270
68217111@N00,5120,23,1330221982,1330223182,1,1,1200
68217111@N00,5121,12,1333238136,1333238406,7,9,270
68217111@N00,5121,10,1333240120,1333240270,4,9,150
68217111@N00,5121,5,1333240611,1333240731,13,9,120
68217111@N00,5121,18,1333242854,1333243394,7,9,540
68217111@N00,5121,16,1333243773,1333244193,31,9,420
68217111@N00,5121,6,1333246066,1333246174,9,9,108
68217111@N00,5121,20,1333246174,1333246774,4,9,600
68217111@N00,5121,4,1333246823,1333246913,3,9,90
68217111@N00,5121,22,1333247328,1333248348,7,9,1020
68217111@N00,5122,14,1340493174,1340493194,2,6,20
68217111@N00,5122,6,1340493194,1340493314,2,6,120
68217111@N00,5122,16,1340494000,1340494420,9,6,420
68217111@N00,5122,11,1340495991,1340496231,2,6,240
68217111@N00,5122,7,1340496525,1340496645,2,6,120
68217111@N00,5122,18,1340498164,1340498704,4,6,540
68255606@N00,5123,19,1358745526,1358746066,2,3,540
68255606@N00,5123,24,1358750109,1358751609,2,3,1500
68255606@N00,5123,16,1358755545,1358755965,1,3,420
68276252@N06,5124,24,1337476272,1337477772,2,1,1500
68276252@N06,5125,20,1337676163,1337676763,1,1,600
68276252@N06,5126,20,1347540433,1347541033,1,1,600
68313075@N02,5127,19,1340989951,1340990491,1,1,540
68324071@N07,5128,22,1328712501,1328713521,1,1,1020
68324071@N07,5129,6,1344411053,1344411173,1,1,120
68324071@N07,5130,7,1351065727,1351065847,1,1,120
68339996@N00,5131,18,1398641830,1398642370,1,1,540
68339996@N00,5132,18,1398672938,1398673478,1,1,540
68398783@N00,5133,20,1269768754,1269769354,1,1,600
68398783@N00,5134,24,1355313226,1355314726,1,1,1500
68431505@N00,5135,12,1281954325,1281954595,2,2,270
68431505@N00,5135,11,1281957999,1281958239,1,2,240
68431505@N00,5136,1,1283694307,1283694367,2,3,60
68431505@N00,5136,7,1283694852,1283694972,2,3,120
68431505@N00,5136,11,1283695123,1283695363,1,3,240
68549815@N07,5137,19,1349479878,1349480418,1,1,540
68669924@N08,5138,14,1245796734,1245797094,1,1,360
68669924@N08,5139,14,1288356233,1288356593,1,1,360
68669924@N08,5140,14,1301685787,1301686147,1,1,360
68669924@N08,5141,14,1324184961,1324185321,4,1,360
68669924@N08,5142,14,1325757891,1325758251,2,1,360
68669924@N08,5143,14,1337347564,1337347924,2,1,360
68669924@N08,5144,14,1337381760,1337382120,1,1,360
68759124@N05,5145,16,1319456329,1319456749,1,1,420
68769844@N07,5146,14,1429142184,1429142544,3,2,360
68769844@N07,5146,5,1429157466,1429157586,1,2,120
68769844@N07,5147,18,1429323943,1429324483,2,2,540
68769844@N07,5147,5,1429335836,1429335956,1,2,120
68896549@N07,5148,19,1373531352,1373531892,1,1,540
68896886@N05,5149,20,1360278016,1360278550,2,2,534
68896886@N05,5149,17,1360278550,1360278970,1,2,420
68896886@N05,5150,19,1360315947,1360316487,1,1,540
68896886@N05,5151,11,1369313027,1369313267,2,1,240
68905036@N04,5152,5,1364719922,1364720042,3,1,120
68926559@N00,5153,9,1358643823,1358643943,1,1,120
68931954@N00,5154,16,1344222563,1344222967,5,19,404
68931954@N00,5154,10,1344222967,1344223117,6,19,150
68931954@N00,5154,1,1344223363,1344223423,2,19,60
68931954@N00,5154,5,1344226294,1344226414,4,19,120
68931954@N00,5154,18,1344226491,1344227031,2,19,540
68931954@N00,5154,6,1344229244,1344229364,9,19,120
68931954@N00,5154,20,1344230459,1344230785,2,19,326
68931954@N00,5154,6,1344230785,1344230905,8,19,120
68931954@N00,5154,14,1344231821,1344232033,4,19,212
68931954@N00,5154,6,1344232033,1344232153,14,19,120
68931954@N00,5154,19,1344232541,1344233081,2,19,540
68931954@N00,5154,8,1344236635,1344236755,4,19,120
68931954@N00,5154,12,1344239345,1344239615,5,19,270
68931954@N00,5154,19,1344250190,1344250397,7,19,207
68931954@N00,5154,6,1344250397,1344250517,5,19,120
68931954@N00,5154,14,1344250606,1344250966,31,19,360
68931954@N00,5154,8,1344252264,1344252384,3,19,120
68931954@N00,5154,6,1344252667,1344252787,2,19,120
68931954@N00,5154,16,1344254504,1344254924,4,19,420
68931954@N00,5155,17,1344287303,1344287573,2,5,270
68931954@N00,5155,14,1344287573,1344287933,22,5,360
68931954@N00,5155,19,1344289760,1344290052,8,5,292
68931954@N00,5155,14,1344290052,1344290248,2,5,196
68931954@N00,5155,6,1344290248,1344290368,2,5,120
68931954@N00,5156,13,1344333440,1344333740,10,1,300
68931954@N00,5157,14,1344375098,1344375458,4,6,360
68931954@N00,5157,11,1344377166,1344377406,5,6,240
68931954@N00,5157,7,1344377749,1344377869,5,6,120
68931954@N00,5157,14,1344379393,1344379447,2,6,54
68931954@N00,5157,6,1344379447,1344379567,3,6,120
68931954@N00,5157,24,1344379708,1344381208,2,6,1500
68947259@N00,5158,6,1299714459,1299714579,1,1,120
68947259@N00,5159,6,1299747525,1299747645,3,1,120
68947259@N00,5160,12,1299797340,1299797610,4,6,270
68947259@N00,5160,23,1299799066,1299799817,2,6,751
68947259@N00,5160,17,1299799817,1299800237,2,6,420
68947259@N00,5160,15,1299804051,1299804411,3,6,360
68947259@N00,5160,25,1299804479,1299806579,2,6,2100
68947259@N00,5160,6,1299809531,1299809651,9,6,120
68947259@N00,5161,6,1299849454,1299849574,3,1,120
68947259@N00,5162,6,1299892362,1299892482,8,1,120
68947259@N00,5163,25,1299971811,1299973911,11,2,2100
68947259@N00,5163,6,1299980756,1299980876,2,2,120
68947259@N00,5164,14,1366158933,1366159293,2,3,360
68947259@N00,5164,6,1366159555,1366159675,2,3,120
68947259@N00,5164,14,1366165469,1366165829,2,3,360
68967983@N00,5165,19,1363394822,1363395362,2,4,540
68967983@N00,5165,7,1363397316,1363397436,2,4,120
68967983@N00,5165,18,1363397766,1363398306,2,4,540
68967983@N00,5165,17,1363403429,1363403849,2,4,420
68989113@N00,5166,7,1303618530,1303618650,1,1,120
68989113@N00,5167,6,1339144803,1339144923,2,2,120
68989113@N00,5167,13,1339145792,1339146092,2,2,300
68989113@N00,5168,12,1339226409,1339226679,2,3,270
68989113@N00,5168,19,1339227541,1339228081,2,3,540
68989113@N00,5168,14,1339228146,1339228506,1,3,360
68989113@N00,5169,4,1339890271,1339890361,2,3,90
68989113@N00,5169,6,1339890453,1339890573,2,3,120
68989113@N00,5169,24,1339890592,1339892092,1,3,1500
68989113@N00,5170,13,1362908129,1362908429,1,1,300
68989113@N00,5171,7,1371339407,1371339527,1,1,120
68989113@N00,5172,7,1376639974,1376640094,1,1,120
68989113@N00,5173,13,1379063098,1379063398,2,1,300
68989113@N00,5174,24,1383460762,1383461347,2,3,585
68989113@N00,5174,12,1383461347,1383461617,2,3,270
68989113@N00,5174,13,1383463056,1383463356,1,3,300
68989113@N00,5175,24,1388456116,1388457616,4,2,1500
68989113@N00,5175,14,1388458844,1388459204,1,2,360
68989113@N00,5176,12,1388535108,1388535378,1,1,270
69024677@N00,5177,24,1202186851,1202188351,2,8,1500
69024677@N00,5177,18,1202190608,1202190617,2,8,9
69024677@N00,5177,5,1202190617,1202190737,2,8,120
69024677@N00,5177,18,1202192101,1202192561,2,8,460
69024677@N00,5177,10,1202192561,1202192578,2,8,17
69024677@N00,5177,18,1202192578,1202192739,2,8,161
69024677@N00,5177,1,1202192739,1202192799,2,8,60
69024677@N00,5177,5,1202193496,1202193616,5,8,120
69026149@N00,5178,16,1298068044,1298068464,30,1,420
69031678@N00,5179,17,1247002820,1247003240,4,1,420
69031754@N06,5180,17,1425159987,1425160407,4,2,420
69031754@N06,5180,24,1425191148,1425192648,1,2,1500
69031754@N06,5181,17,1425243850,1425244270,1,1,420
69114926@N00,5182,13,1321604199,1321604499,2,3,300
69114926@N00,5182,9,1321605889,1321606009,3,3,120
69114926@N00,5182,4,1321609245,1321609335,3,3,90
69114926@N00,5183,23,1321663882,1321665082,2,4,1200
69114926@N00,5183,7,1321665346,1321665466,9,4,120
69114926@N00,5183,18,1321667651,1321667926,2,4,275
69114926@N00,5183,10,1321667926,1321668076,2,4,150
69271250@N00,5184,11,1364705037,1364705277,2,2,240
69271250@N00,5184,18,1364716775,1364717315,1,2,540
69271250@N00,5185,11,1396144824,1396145064,1,1,240
69271250@N00,5186,18,1396176172,1396176712,1,1,540
69271250@N00,5187,25,1396316778,1396318583,2,2,1805
69271250@N00,5187,11,1396318583,1396318823,1,2,240
69271250@N00,5188,6,1396474662,1396474782,3,7,120
69271250@N00,5188,19,1396476133,1396476673,2,7,540
69271250@N00,5188,14,1396477195,1396477555,2,7,360
69271250@N00,5188,5,1396479030,1396479150,2,7,120
69271250@N00,5188,17,1396480650,1396481070,2,7,420
69271250@N00,5188,19,1396496204,1396496744,2,7,540
69271250@N00,5188,6,1396510042,1396510162,1,7,120
69455267@N07,5189,6,1458173363,1458173483,1,1,120
69574134@N00,5190,17,1270019974,1270020061,2,21,87
69574134@N00,5190,16,1270020061,1270020100,2,21,39
69574134@N00,5190,18,1270020100,1270020316,2,21,216
69574134@N00,5190,5,1270020316,1270020436,5,21,120
69574134@N00,5190,20,1270027075,1270027675,7,21,600
69574134@N00,5190,8,1270028315,1270028435,3,21,120
69574134@N00,5190,4,1270028464,1270028498,2,21,34
69574134@N00,5190,15,1270028498,1270028858,13,21,360
69574134@N00,5190,25,1270031474,1270033574,2,21,2100
69574134@N00,5190,12,1270048506,1270048776,2,21,270
69574134@N00,5190,17,1270051121,1270051541,2,21,420
69574134@N00,5190,1,1270051716,1270051743,2,21,27
69574134@N00,5190,3,1270051743,1270051833,2,21,90
69574134@N00,5190,18,1270052133,1270052673,7,21,540
69574134@N00,5190,5,1270053726,1270053846,2,21,120
69574134@N00,5190,7,1270053864,1270053984,2,21,120
69574134@N00,5190,18,1270054606,1270055146,3,21,540
69574134@N00,5190,11,1270058634,1270058874,4,21,240
69574134@N00,5190,18,1270060226,1270060420,5,21,194
69574134@N00,5190,23,1270060420,1270060839,2,21,419
69574134@N00,5190,24,1270060839,1270062339,3,21,1500
69574134@N00,5191,23,1270558473,1270559673,7,7,1200
69574134@N00,5191,17,1270560389,1270560809,9,7,420
69574134@N00,5191,23,1270562702,1270563902,2,7,1200
69574134@N00,5191,16,1270565288,1270565582,3,7,294
69574134@N00,5191,23,1270565582,1270565633,2,7,51
69574134@N00,5191,17,1270565633,1270566053,2,7,420
69574134@N00,5191,20,1270566346,1270566946,23,7,600
69872582@N00,5192,17,1308390292,1308390712,1,1,420
69872582@N00,5193,1,1338618512,1338618572,1,1,60
69872582@N00,5194,7,1338686611,1338686731,3,4,120
69872582@N00,5194,16,1338687068,1338687488,4,4,420
69872582@N00,5194,23,1338691070,1338692270,3,4,1200
69872582@N00,5194,13,1338714288,1338714588,3,4,300
69883003@N00,5195,16,1306750798,1306751218,1,1,420
69883003@N00,5196,11,1309054332,1309054572,1,1,240
69883003@N00,5197,16,1309086097,1309086517,1,1,420
69883003@N00,5198,14,1309422820,1309423180,1,1,360
69883003@N00,5199,5,1314504638,1314504758,1,1,120
69883003@N00,5200,15,1316837549,1316837909,2,2,360
69883003@N00,5200,12,1316855178,1316855448,1,2,270
69883003@N00,5201,12,1333274516,1333274786,1,1,270
69883003@N00,5202,12,1339293975,1339294245,3,11,270
69883003@N00,5202,14,1339296760,1339297120,3,11,360
69883003@N00,5202,12,1339297326,1339297596,2,11,270
69883003@N00,5202,6,1339300842,1339300962,2,11,120
69883003@N00,5202,14,1339301903,1339302263,7,11,360
69883003@N00,5202,7,1339302299,1339302419,2,11,120
69883003@N00,5202,14,1339302424,1339302784,2,11,360
69883003@N00,5202,25,1339304217,1339306033,2,11,1816
69883003@N00,5202,14,1339306033,1339306301,3,11,268
69883003@N00,5202,19,1339306301,1339306841,2,11,540
69883003@N00,5202,14,1339308835,1339309195,2,11,360
69883003@N00,5203,14,1341015778,1341016138,2,5,360
69883003@N00,5203,7,1341035790,1341035910,2,5,120
69883003@N00,5203,12,1341041969,1341042239,3,5,270
69883003@N00,5203,11,1341048292,1341048532,2,5,240
69883003@N00,5203,13,1341058343,1341058643,1,5,300
69883003@N00,5204,14,1341530167,1341530527,1,1,360
69883003@N00,5205,14,1341562276,1341562636,2,2,360
69883003@N00,5205,12,1341578640,1341578910,1,2,270
69883003@N00,5206,24,1357447572,1357449049,2,3,1477
69883003@N00,5206,11,1357449049,1357449075,2,3,26
69883003@N00,5206,7,1357449075,1357449195,2,3,120
69883003@N00,5207,22,1360462821,1360463841,1,1,1020
69883003@N00,5208,15,1371551048,1371551408,1,1,360
70024191@N00,5209,13,1216352856,1216353156,1,1,300
70059755@N00,5210,12,1224151565,1224151835,1,1,270
70059755@N00,5211,15,1224248448,1224248764,2,2,316
70059755@N00,5211,12,1224248764,1224249034,1,2,270
70059755@N00,5212,14,1349065763,1349066123,1,1,360
70059755@N00,5213,14,1380528270,1380528630,1,1,360
70059755@N00,5214,14,1413095494,1413095660,3,3,166
70059755@N00,5214,19,1413095660,1413096200,2,3,540
70059755@N00,5214,16,1413101407,1413101827,1,3,420
70084804@N00,5215,14,1393423489,1393423849,1,1,360
70229871@N06,5216,18,1415510746,1415511286,1,1,540
70319699@N05,5217,7,1328794881,1328795001,2,1,120
70319699@N05,5218,14,1343393707,1343394067,2,2,360
70319699@N05,5218,23,1343394230,1343395430,1,2,1200
70341093@N00,5219,4,1292057964,1292058054,1,1,90
70584662@N00,5220,6,1380008875,1380008995,2,3,120
70584662@N00,5220,11,1380010737,1380010977,2,3,240
70584662@N00,5220,16,1380017450,1380017870,2,3,420
70698203@N00,5221,17,1216632439,1216632859,1,1,420
70698203@N00,5222,6,1216780628,1216780748,2,2,120
70698203@N00,5222,12,1216805814,1216806084,2,2,270
70698203@N00,5223,12,1308269436,1308269706,3,6,270
70698203@N00,5223,19,1308275125,1308275665,2,6,540
70698203@N00,5223,12,1308276237,1308276507,2,6,270
70698203@N00,5223,19,1308294778,1308295149,2,6,371
70698203@N00,5223,17,1308295149,1308295569,3,6,420
70698203@N00,5223,12,1308307741,1308308011,1,6,270
70698203@N00,5224,7,1308356227,1308356347,2,7,120
70698203@N00,5224,19,1308362880,1308363420,2,7,540
70698203@N00,5224,18,1308366133,1308366673,2,7,540
70698203@N00,5224,20,1308375070,1308375102,2,7,32
70698203@N00,5224,12,1308375102,1308375372,2,7,270
70698203@N00,5224,17,1308378975,1308379395,2,7,420
70698203@N00,5224,12,1308379613,1308379883,1,7,270
70698203@N00,5225,6,1308448590,1308448710,2,1,120
70698203@N00,5226,6,1308533999,1308534003,2,4,4
70698203@N00,5226,17,1308534003,1308534423,2,4,420
70698203@N00,5226,12,1308534428,1308534698,2,4,270
70698203@N00,5226,17,1308541388,1308541808,1,4,420
70698203@N00,5227,6,1447803434,1447803448,2,4,14
70698203@N00,5227,14,1447803448,1447803808,3,4,360
70698203@N00,5227,17,1447807018,1447807438,2,4,420
70698203@N00,5227,18,1447821666,1447822206,2,4,540
70698203@N00,5228,6,1447887752,1447887872,1,1,120
70731501@N00,5229,8,1340878777,1340878897,2,2,120
70731501@N00,5229,21,1340878993,1340879893,2,2,900
70731501@N00,5230,20,1351133870,1351134470,7,1,600
70779799@N00,5231,16,1386305115,1386305535,2,2,420
70779799@N00,5231,11,1386311577,1386311817,1,2,240
70786875@N00,5232,16,1335410136,1335410556,2,1,420
70827934@N08,5233,24,1306654352,1306655852,19,1,1500
70862502@N00,5234,10,1322148307,1322148457,2,2,150
70862502@N00,5234,24,1322150088,1322151588,1,2,1500
70862502@N00,5235,15,1322195672,1322196032,2,2,360
70862502@N00,5235,7,1322212166,1322212286,1,2,120
70862502@N00,5236,10,1327827160,1327827310,1,1,150
70862502@N00,5237,12,1351955842,1351956112,2,2,270
70862502@N00,5237,13,1351957974,1351958274,2,2,300
70862502@N00,5238,14,1352011724,1352012084,1,1,360
70862502@N00,5239,15,1352051897,1352052257,1,1,360
70862502@N00,5240,10,1353143452,1353143602,1,1,150
70862502@N00,5241,14,1353252042,1353252402,2,2,360
70862502@N00,5241,13,1353257778,1353258078,1,2,300
70862502@N00,5242,14,1358534810,1358535170,1,1,360
70862502@N00,5243,13,1358704719,1358705019,2,1,300
70862502@N00,5244,14,1367625706,1367626066,1,1,360
70862502@N00,5245,14,1367660811,1367661171,3,2,360
70862502@N00,5245,13,1367665913,1367666213,1,2,300
70862502@N00,5246,14,1367748168,1367748528,1,1,360
70862502@N00,5247,18,1367800430,1367800970,1,1,540
70862502@N00,5248,3,1390077392,1390077482,1,1,90
70862502@N00,5249,13,1415959824,1415960124,1,1,300
70862502@N00,5250,18,1416017623,1416018163,3,2,540
70862502@N00,5250,13,1416043224,1416043524,1,2,300
70862502@N00,5251,18,1421616752,1421617292,1,1,540
70862502@N00,5252,17,1446963842,1446964262,2,2,420
70862502@N00,5252,14,1446967338,1446967698,1,2,360
70862502@N00,5253,25,1447016686,1447018786,1,1,2100
70891215@N05,5254,23,1238612492,1238613692,1,1,1200
70969739@N00,5255,18,1309260537,1309261077,1,1,540
71048666@N00,5256,16,1243348282,1243348702,1,1,420
71079304@N04,5257,20,1262158128,1262158728,2,2,600
71079304@N04,5257,21,1262160816,1262161716,1,2,900
71079304@N04,5258,24,1373929840,1373931340,1,1,1500
71101989@N02,5259,24,1422475452,1422476952,5,1,1500
71103764@N00,5260,14,1394425489,1394425849,2,3,360
71103764@N00,5260,15,1394427442,1394427802,2,3,360
71103764@N00,5260,7,1394429662,1394429782,2,3,120
71103764@N00,5261,10,1394526778,1394526928,1,1,150
71103764@N00,5262,7,1394577345,1394577465,3,2,120
71103764@N00,5262,14,1394586793,1394587153,1,2,360
71121295@N00,5263,5,1233463256,1233463376,3,3,120
71121295@N00,5263,23,1233470507,1233470994,2,3,487
71121295@N00,5263,24,1233470994,1233472494,1,3,1500
71121295@N00,5264,3,1270365464,1270365554,2,1,90
71121295@N00,5265,7,1272682583,1272682703,2,3,120
71121295@N00,5265,18,1272691210,1272691750,4,3,540
71121295@N00,5265,5,1272693383,1272693503,1,3,120
71121295@N00,5266,3,1339239575,1339239665,5,1,90
71121295@N00,5267,12,1339278580,1339278850,2,6,270
71121295@N00,5267,14,1339279295,1339279655,32,6,360
71121295@N00,5267,19,1339288231,1339288499,2,6,268
71121295@N00,5267,11,1339288499,1339288739,2,6,240
71121295@N00,5267,10,1339289443,1339289593,2,6,150
71121295@N00,5267,24,1339290277,1339291777,1,6,1500
71214537@N00,5268,18,1441968497,1441969037,2,1,540
71300344@N04,5269,14,1339582468,1339582828,1,1,360
71300344@N04,5270,22,1353197820,1353198840,1,1,1020
71356371@N00,5271,4,1337500652,1337500742,1,1,90
71356371@N00,5272,6,1363755555,1363755675,1,1,120
71356371@N00,5273,7,1385881144,1385881264,1,1,120
71362404@N00,5274,5,1223596827,1223596947,2,1,120
71416221@N02,5275,18,1435104682,1435105222,1,1,540
71416221@N02,5276,5,1435141869,1435141989,2,2,120
71416221@N02,5276,10,1435145113,1435145263,1,2,150
71486434@N00,5277,12,1215568349,1215568619,2,12,270
71486434@N00,5277,17,1215580038,1215580458,2,12,420
71486434@N00,5277,12,1215587016,1215587286,2,12,270
71486434@N00,5277,24,1215587352,1215587475,2,12,123
71486434@N00,5277,13,1215587475,1215587775,13,12,300
71486434@N00,5277,10,1215592260,1215592410,2,12,150
71486434@N00,5277,18,1215595223,1215595719,5,12,496
71486434@N00,5277,7,1215595719,1215595839,4,12,120
71486434@N00,5277,16,1215596162,1215596582,3,12,420
71486434@N00,5277,1,1215599745,1215599805,2,12,60
71486434@N00,5277,7,1215600022,1215600142,2,12,120
71486434@N00,5277,1,1215601638,1215601698,6,12,60
71486434@N00,5278,24,1215650608,1215652108,8,6,1500
71486434@N00,5278,22,1215654317,1215655337,11,6,1020
71486434@N00,5278,24,1215657379,1215658565,2,6,1186
71486434@N00,5278,12,1215658565,1215658835,4,6,270
71486434@N00,5278,7,1215663401,1215663521,2,6,120
71486434@N00,5278,17,1215665214,1215665634,2,6,420
71486434@N00,5279,22,1223006368,1223007369,4,7,1001
71486434@N00,5279,25,1223007369,1223007449,2,7,80
71486434@N00,5279,24,1223007449,1223008949,6,7,1500
71486434@N00,5279,15,1223010973,1223011333,5,7,360
71486434@N00,5279,25,1223011960,1223012356,3,7,396
71486434@N00,5279,6,1223012356,1223012476,8,7,120
71486434@N00,5279,20,1223013234,1223013834,1,7,600
71486434@N00,5280,18,1236826796,1236827336,3,5,540
71486434@N00,5280,24,1236827980,1236829480,2,5,1500
71486434@N00,5280,15,1236830952,1236831312,4,5,360
71486434@N00,5280,10,1236832614,1236832764,2,5,150
71486434@N00,5280,16,1236834557,1236834977,1,5,420
71486434@N00,5281,11,1237195074,1237195314,2,2,240
71486434@N00,5281,15,1237195518,1237195878,1,2,360
71486434@N00,5282,17,1254452045,1254452465,2,1,420
71486434@N00,5283,12,1254532521,1254532791,2,9,270
71486434@N00,5283,22,1254532906,1254533027,3,9,121
71486434@N00,5283,24,1254533027,1254533754,2,9,727
71486434@N00,5283,13,1254533754,1254534054,4,9,300
71486434@N00,5283,25,1254535719,1254535916,2,9,197
71486434@N00,5283,24,1254535916,1254537367,7,9,1451
71486434@N00,5283,7,1254537367,1254537487,18,9,120
71486434@N00,5283,15,1254544808,1254545168,6,9,360
71486434@N00,5283,22,1254549448,1254550468,2,9,1020
71486434@N00,5284,6,1254649595,1254649715,1,1,120
71486434@N00,5285,7,1255762012,1255762132,2,2,120
71486434@N00,5285,11,1255762393,1255762633,1,2,240
71486434@N00,5286,24,1286063401,1286063657,3,4,256
71486434@N00,5286,17,1286063657,1286064077,6,4,420
71486434@N00,5286,11,1286066753,1286066993,3,4,240
71486434@N00,5286,18,1286089448,1286089988,2,4,540
71502979@N00,5287,18,1199106000,1199106540,2,1,540
71502979@N00,5288,19,1247016126,1247016666,3,1,540
71502979@N00,5289,17,1264128723,1264129143,3,3,420
71502979@N00,5289,22,1264130273,1264131293,2,3,1020
71502979@N00,5289,17,1264133717,1264134137,2,3,420
71502979@N00,5290,15,1264392797,1264393157,4,3,360
71502979@N00,5290,24,1264393845,1264395345,2,3,1500
71502979@N00,5290,18,1264395565,1264396105,1,3,540
71502979@N00,5291,22,1266809911,1266810931,5,2,1020
71502979@N00,5291,17,1266812749,1266813169,3,2,420
71502979@N00,5292,15,1268878589,1268878949,1,1,360
71502979@N00,5293,15,1285313158,1285313518,1,1,360
71502979@N00,5294,13,1286790477,1286790777,3,2,300
71502979@N00,5294,25,1286792873,1286794973,1,2,2100
71502979@N00,5295,18,1299904988,1299905479,3,3,491
71502979@N00,5295,16,1299905479,1299905690,2,3,211
71502979@N00,5295,23,1299905690,1299906890,1,3,1200
71502979@N00,5296,12,1300166404,1300166674,2,1,270
7154330@N03,5297,12,1255314014,1255314284,1,1,270
71574801@N00,5298,7,1277859631,1277859751,4,1,120
71597211@N00,5299,6,1358124059,1358124179,2,12,120
71597211@N00,5299,19,1358124195,1358124735,2,12,540
71597211@N00,5299,7,1358126090,1358126210,3,12,120
71597211@N00,5299,18,1358127521,1358128061,4,12,540
71597211@N00,5299,23,1358133379,1358134579,6,12,1200
71597211@N00,5299,25,1358139060,1358141087,2,12,2027
71597211@N00,5299,19,1358141087,1358141535,3,12,448
71597211@N00,5299,6,1358141535,1358141655,2,12,120
71597211@N00,5299,19,1358141664,1358142204,3,12,540
71597211@N00,5299,14,1358143072,1358143432,2,12,360
71597211@N00,5299,19,1358149640,1358150173,3,12,533
71597211@N00,5299,14,1358150173,1358150533,7,12,360
71597211@N00,5300,12,1358207757,1358208027,1,1,270
71769073@N03,5301,17,1332296201,1332296621,1,1,420
71781509@N00,5302,15,1418619137,1418619497,2,2,360
71781509@N00,5302,16,1418623815,1418624235,3,2,420
71781509@N00,5303,7,1418682174,1418682294,5,3,120
71781509@N00,5303,18,1418683024,1418683564,2,3,540
71781509@N00,5303,14,1418687674,1418688034,1,3,360
71781509@N00,5304,18,1418727924,1418728464,1,1,540
71821835@N02,5305,21,1360381966,1360382866,1,1,900
71969256@N00,5306,16,1351902340,1351902760,5,2,420
71969256@N00,5306,12,1351907823,1351908093,5,2,270
72002381@N00,5307,19,1214199960,1214200500,29,1,540
7202153@N03,5308,24,1281066542,1281068042,2,1,1500
72171460@N00,5309,19,1377848124,1377848664,1,1,540
72171460@N00,5310,12,1385082755,1385083025,1,1,270
72171460@N00,5311,17,1386220673,1386221093,1,1,420
72246018@N04,5312,18,1411784125,1411784665,1,1,540
72246018@N04,5313,17,1439618539,1439618959,2,3,420
72246018@N04,5313,7,1439630196,1439630316,2,3,120
72246018@N04,5313,17,1439636625,1439637045,1,3,420
7229930@N07,5314,6,1207261142,1207261262,2,1,120
7229930@N07,5315,6,1333217708,1333217828,1,1,120
7231700@N07,5316,24,1203066539,1203068039,1,1,1500
7231700@N07,5317,16,1225271363,1225271783,2,1,420
7231700@N07,5318,10,1295282648,1295282798,1,1,150
72333664@N00,5319,10,1188371248,1188371398,1,1,150
7235065@N08,5320,24,1370211905,1370213405,2,1,1500
72409673@N00,5321,16,1294301475,1294301895,1,1,420
72409673@N00,5322,16,1324030384,1324030804,1,1,420
72409673@N00,5323,7,1340886526,1340886646,1,1,120
72453942@N04,5324,14,1428744978,1428745338,1,1,360
7256454@N05,5325,18,1263612136,1263612676,7,2,540
7256454@N05,5325,17,1263617031,1263617451,1,2,420
72589879@N00,5326,25,1320813128,1320813305,2,8,177
72589879@N00,5326,15,1320813305,1320813665,4,8,360
72589879@N00,5326,18,1320817714,1320817942,2,8,228
72589879@N00,5326,5,1320817942,1320818062,2,8,120
72589879@N00,5326,10,1320819087,1320819237,2,8,150
72589879@N00,5326,16,1320819430,1320819655,3,8,225
72589879@N00,5326,7,1320819655,1320819775,2,8,120
72589879@N00,5326,25,1320820446,1320822546,1,8,2100
72589879@N00,5327,14,1444786418,1444786510,3,12,92
72589879@N00,5327,19,1444786510,1444787050,2,12,540
72589879@N00,5327,18,1444790551,1444791091,2,12,540
72589879@N00,5327,10,1444791196,1444791346,2,12,150
72589879@N00,5327,19,1444791362,1444791902,2,12,540
72589879@N00,5327,15,1444792834,1444793194,3,12,360
72589879@N00,5327,25,1444793946,1444796046,3,12,2100
72589879@N00,5327,23,1444800679,1444801369,5,12,690
72589879@N00,5327,17,1444801369,1444801789,2,12,420
72589879@N00,5327,14,1444802411,1444802771,7,12,360
72589879@N00,5327,19,1444805874,1444806159,2,12,285
72589879@N00,5327,11,1444806159,1444806399,2,12,240
7260327@N06,5328,18,1299050655,1299051195,4,1,540
72658777@N07,5329,11,1346705639,1346705879,2,1,240
72658777@N07,5330,19,1355772417,1355772957,2,3,540
72658777@N07,5330,11,1355773009,1355773249,2,3,240
72658777@N07,5330,19,1355775309,1355775849,1,3,540
72658777@N07,5331,9,1364066641,1364066761,1,1,120
72755761@N00,5332,23,1333086975,1333088175,3,1,1200
72755761@N00,5333,19,1333161156,1333161696,1,1,540
7282277@N07,5334,23,1404202502,1404203702,4,5,1200
7282277@N07,5334,16,1404207818,1404208168,2,5,350
7282277@N07,5334,19,1404208168,1404208393,3,5,225
7282277@N07,5334,20,1404208393,1404208490,3,5,97
7282277@N07,5334,24,1404208490,1404209990,2,5,1500
7282277@N07,5335,25,1404260682,1404262782,5,2,2100
7282277@N07,5335,24,1404263258,1404264758,1,2,1500
72872155@N00,5336,13,1289551413,1289551713,1,1,300
72872155@N00,5337,24,1291974748,1291976248,1,1,1500
72872155@N00,5338,5,1322973541,1322973661,1,1,120
72872155@N00,5339,14,1358049754,1358050114,1,1,360
72915363@N00,5340,6,1272010463,1272010583,1,1,120
72915363@N00,5341,25,1298200158,1298202258,2,1,2100
72915363@N00,5342,14,1355270872,1355271232,2,1,360
72915363@N00,5343,12,1355371439,1355371709,1,1,270
7296328@N07,5344,10,1310817670,1310817820,2,5,150
7296328@N07,5344,15,1310821529,1310821775,2,5,246
7296328@N07,5344,25,1310821775,1310823875,2,5,2100
7296328@N07,5344,1,1310824756,1310824816,2,5,60
7296328@N07,5344,24,1310825461,1310826961,1,5,1500
73105116@N00,5345,23,1241948345,1241949545,2,4,1200
73105116@N00,5345,18,1241958411,1241958951,2,4,540
73105116@N00,5345,24,1241959638,1241960794,2,4,1156
73105116@N00,5345,15,1241960794,1241961154,1,4,360
73105116@N00,5346,18,1242003536,1242004076,2,2,540
73105116@N00,5346,15,1242005345,1242005705,1,2,360
73105116@N00,5347,11,1244194601,1244194841,1,1,240
73276357@N00,5348,24,1364185495,1364186995,1,1,1500
73276357@N00,5349,24,1368504534,1368506034,2,2,1500
73276357@N00,5349,25,1368509782,1368511882,1,2,2100
73276357@N00,5350,14,1370772202,1370772562,1,1,360
73276357@N00,5351,17,1370995764,1370996184,2,2,420
73276357@N00,5351,25,1371003885,1371005985,1,2,2100
73293249@N00,5352,12,1221037050,1221037320,1,1,270
7330503@N04,5353,17,1454308050,1454308470,1,1,420
73310709@N05,5354,16,1356656374,1356656794,2,2,420
73310709@N05,5354,18,1356669766,1356670306,1,2,540
73315492@N00,5355,18,1315973226,1315973766,17,1,540
73320694@N04,5356,19,1363659161,1363659701,2,2,540
73320694@N04,5356,18,1363681362,1363681902,1,2,540
7337318@N05,5357,19,1316223738,1316223950,2,2,212
7337318@N05,5357,6,1316223950,1316224070,1,2,120
7337318@N05,5358,23,1353841643,1353842843,1,1,1200
7337318@N05,5359,23,1353981561,1353982761,1,1,1200
73392257@N00,5360,13,1407662932,1407663232,2,1,300
7340027@N06,5361,12,1353747543,1353747813,2,4,270
7340027@N06,5361,24,1353747846,1353748149,2,4,303
7340027@N06,5361,19,1353748149,1353748689,2,4,540
7340027@N06,5361,14,1353750474,1353750834,1,4,360
7346406@N06,5362,12,1314770284,1314770554,1,1,270
7346406@N06,5363,19,1316762277,1316762817,1,1,540
7346406@N06,5364,12,1327024512,1327024782,1,1,270
7346406@N06,5365,22,1359245151,1359246171,1,1,1020
7354209@N08,5366,24,1309416937,1309418437,1,1,1500
73613627@N06,5367,24,1417858121,1417859621,1,1,1500
73621375@N00,5368,13,1214106451,1214106751,2,4,300
73621375@N00,5368,24,1214108775,1214109494,3,4,719
73621375@N00,5368,17,1214109494,1214109914,2,4,420
73621375@N00,5368,25,1214114963,1214117063,4,4,2100
73621375@N00,5369,20,1214202083,1214202683,1,1,600
73621375@N00,5370,24,1228523641,1228523766,2,9,125
73621375@N00,5370,22,1228523766,1228523828,2,9,62
73621375@N00,5370,25,1228523828,1228524341,3,9,513
73621375@N00,5370,13,1228524341,1228524641,5,9,300
73621375@N00,5370,22,1228525083,1228526103,19,9,1020
73621375@N00,5370,15,1228529431,1228529791,6,9,360
73621375@N00,5370,24,1228531255,1228532755,2,9,1500
73621375@N00,5370,6,1228536072,1228536192,13,9,120
73621375@N00,5370,12,1228537385,1228537655,12,9,270
73621375@N00,5371,15,1292052368,1292052728,3,2,360
73621375@N00,5371,16,1292054574,1292054994,16,2,420
73621375@N00,5372,22,1292139850,1292140870,16,1,1020
73666782@N00,5373,22,1361687072,1361688092,2,3,1020
73666782@N00,5373,12,1361688366,1361688636,2,3,270
73666782@N00,5373,10,1361697489,1361697639,1,3,150
73666782@N00,5374,13,1393224478,1393224778,1,1,300
7371869@N05,5375,12,1315105772,1315106042,1,1,270
73802184@N00,5376,7,1355444085,1355444205,2,1,120
73802184@N00,5377,15,1361523350,1361523710,5,2,360
73802184@N00,5377,25,1361523862,1361525962,2,2,2100
73802184@N00,5378,6,1361658333,1361658336,3,8,3
73802184@N00,5378,19,1361658336,1361658463,5,8,127
73802184@N00,5378,14,1361658463,1361658680,5,8,217
73802184@N00,5378,19,1361658680,1361659220,5,8,540
73802184@N00,5378,16,1361660371,1361660791,3,8,420
73802184@N00,5378,14,1361663523,1361663883,6,8,360
73802184@N00,5378,22,1361666521,1361667541,5,8,1020
73802184@N00,5378,13,1361667932,1361668232,10,8,300
73802184@N00,5379,19,1394873940,1394874480,14,1,540
73864973@N06,5380,7,1312104842,1312104962,1,1,120
7387461@N02,5381,10,1282001283,1282001433,1,1,150
73883362@N00,5382,18,1419007593,1419008133,1,1,540
73889777@N00,5383,19,1432350014,1432350554,2,2,540
73889777@N00,5383,17,1432375427,1432375847,1,2,420
7398381@N04,5384,23,1291323186,1291324386,1,1,1200
74014506@N00,5385,23,1245481492,1245481845,2,2,353
74014506@N00,5385,18,1245481845,1245482385,2,2,540
7401887@N02,5386,5,1453009334,1453009454,1,1,120
74025099@N03,5387,20,1388478459,1388479059,1,1,600
74164239@N00,5388,24,1216791205,1216792705,1,1,1500
74164239@N00,5389,5,1245917016,1245917136,1,1,120
74216903@N00,5390,16,1449305315,1449305735,1,1,420
74285955@N00,5391,12,1338202509,1338202779,2,1,270
74285955@N00,5392,14,1345969389,1345969749,1,1,360
74285955@N00,5393,24,1377423744,1377424168,2,2,424
74285955@N00,5393,14,1377424168,1377424528,1,2,360
74311588@N00,5394,7,1366611998,1366612118,1,1,120
74328426@N08,5395,8,1352196458,1352196578,1,1,120
74328426@N08,5396,14,1352333818,1352334178,2,2,360
74328426@N08,5396,9,1352336911,1352337031,1,2,120
74354559@N05,5397,18,1426208395,1426208804,2,5,409
74354559@N05,5397,14,1426208804,1426209164,3,5,360
74354559@N05,5397,25,1426214366,1426216466,2,5,2100
74354559@N05,5397,7,1426238105,1426238225,2,5,120
74354559@N05,5397,16,1426245217,1426245637,2,5,420
74403697@N02,5398,22,1418334459,1418334794,2,6,335
74403697@N02,5398,14,1418334794,1418335154,2,6,360
74403697@N02,5398,12,1418336733,1418337003,5,6,270
74403697@N02,5398,11,1418355860,1418356100,2,6,240
74403697@N02,5398,17,1418365516,1418365936,2,6,420
74403697@N02,5398,14,1418379594,1418379954,1,6,360
74403697@N02,5399,11,1418418644,1418418644,2,4,0
74403697@N02,5399,12,1418418644,1418418644,5,4,0
74403697@N02,5399,14,1418418644,1418418644,3,4,0
74403697@N02,5399,17,1418418644,1418419064,1,4,420
74471986@N00,5400,25,1402127537,1402129637,3,1,2100
74501739@N05,5401,16,1463480349,1463480769,2,1,420
7451795@N03,5402,6,1397456462,1397456582,2,2,120
7451795@N03,5402,24,1397462467,1397463967,1,2,1500
74594655@N00,5403,19,1245993741,1245994281,8,2,540
74594655@N00,5403,17,1246000475,1246000895,1,2,420
74616830@N00,5404,15,1327108362,1327108722,3,3,360
74616830@N00,5404,6,1327111602,1327111722,3,3,120
74616830@N00,5404,19,1327112290,1327112830,1,3,540
74712199@N00,5405,11,1319958623,1319958863,1,1,240
74712199@N00,5406,12,1344598752,1344599022,1,1,270
74712199@N00,5407,12,1345847422,1345847692,1,1,270
74712199@N00,5408,18,1349586062,1349586602,1,1,540
74712199@N00,5409,14,1354252721,1354253081,1,1,360
74712199@N00,5410,14,1363511765,1363512125,1,1,360
74712199@N00,5411,15,1381016161,1381016521,1,1,360
74712199@N00,5412,24,1395654571,1395656071,1,1,1500
74712199@N00,5413,14,1412466393,1412466753,2,2,360
74712199@N00,5413,25,1412466907,1412469007,1,2,2100
74712199@N00,5414,1,1417926871,1417926931,1,1,60
7474477@N08,5415,11,1203339627,1203339628,2,2,1
7474477@N08,5415,10,1203339628,1203339778,4,2,150
74836867@N00,5416,6,1468585908,1468586028,1,1,120
74836867@N00,5417,6,1468815058,1468815178,2,1,120
75070889@N07,5418,24,1308637667,1308639167,1,1,1500
75070889@N07,5419,7,1368597545,1368597665,1,1,120
75070889@N07,5420,11,1371088206,1371088446,1,1,240
7517023@N04,5421,14,1369961890,1369962250,2,4,360
7517023@N04,5421,19,1369964950,1369964956,2,4,6
7517023@N04,5421,7,1369964956,1369965076,2,4,120
7517023@N04,5421,23,1369971697,1369972897,1,4,1200
75197009@N00,5422,12,1402107339,1402107609,2,1,270
75229645@N00,5423,12,1317419642,1317419912,2,1,270
75229645@N00,5424,11,1443844308,1443844548,2,2,240
75229645@N00,5424,13,1443849314,1443849614,1,2,300
75322313@N00,5425,18,1356071205,1356071745,1,1,540
75455896@N05,5426,14,1416218955,1416219315,1,1,360
75558245@N00,5427,12,1243565792,1243566062,1,1,270
75611073@N07,5428,12,1427946206,1427946476,3,1,270
75666721@N08,5429,14,1392543948,1392544308,1,1,360
75666721@N08,5430,25,1399189637,1399191737,2,2,2100
75666721@N08,5430,18,1399198258,1399198798,1,2,540
75666721@N08,5431,24,1402293331,1402294831,1,1,1500
75674173@N00,5432,10,1316090726,1316090876,1,1,150
75683070@N00,5433,12,1430691685,1430691955,4,1,270
75683070@N00,5434,12,1430786263,1430786342,5,73,79
75683070@N00,5434,24,1430786342,1430786512,8,73,170
75683070@N00,5434,20,1430786512,1430786598,7,73,86
75683070@N00,5434,6,1430786598,1430786718,6,73,120
75683070@N00,5434,19,1430786764,1430786806,4,73,42
75683070@N00,5434,6,1430786806,1430786832,3,73,26
75683070@N00,5434,19,1430786832,1430786878,3,73,46
75683070@N00,5434,14,1430786878,1430787238,24,73,360
75683070@N00,5434,11,1430790037,1430790237,3,73,200
75683070@N00,5434,14,1430790237,1430790597,16,73,360
75683070@N00,5434,6,1430790972,1430791092,9,73,120
75683070@N00,5434,19,1430791216,1430791254,2,73,38
75683070@N00,5434,6,1430791254,1430791280,2,73,26
75683070@N00,5434,19,1430791280,1430791820,19,73,540
75683070@N00,5434,14,1430791821,1430792167,12,73,346
75683070@N00,5434,6,1430792167,1430792287,3,73,120
75683070@N00,5434,19,1430792457,1430792736,2,73,279
75683070@N00,5434,6,1430792736,1430792856,4,73,120
75683070@N00,5434,20,1430792995,1430793005,2,73,10
75683070@N00,5434,6,1430793005,1430793038,3,73,33
75683070@N00,5434,20,1430793038,1430793077,4,73,39
75683070@N00,5434,6,1430793077,1430793197,7,73,120
75683070@N00,5434,20,1430793878,1430794478,7,73,600
75683070@N00,5434,19,1430794805,1430794875,4,73,70
75683070@N00,5434,16,1430794875,1430794976,4,73,101
75683070@N00,5434,10,1430794976,1430795126,2,73,150
75683070@N00,5434,1,1430795369,1430795429,10,73,60
75683070@N00,5434,10,1430797026,1430797087,2,73,61
75683070@N00,5434,3,1430797087,1430797177,4,73,90
75683070@N00,5434,18,1430797441,1430797610,2,73,169
75683070@N00,5434,3,1430797610,1430797700,5,73,90
75683070@N00,5434,10,1430797823,1430797841,2,73,18
75683070@N00,5434,1,1430797841,1430797901,3,73,60
75683070@N00,5434,3,1430797964,1430798054,4,73,90
75683070@N00,5434,5,1430798152,1430798272,11,73,120
75683070@N00,5434,1,1430798426,1430798486,6,73,60
75683070@N00,5434,5,1430799289,1430799310,2,73,21
75683070@N00,5434,18,1430799310,1430799850,16,73,540
75683070@N00,5434,7,1430801598,1430801718,4,73,120
75683070@N00,5434,11,1430804681,1430804786,6,73,105
75683070@N00,5434,7,1430804786,1430804823,2,73,37
75683070@N00,5434,16,1430804823,1430805243,13,73,420
75683070@N00,5434,23,1430806235,1430806416,8,73,181
75683070@N00,5434,17,1430806416,1430806836,18,73,420
75683070@N00,5434,23,1430808005,1430808498,2,73,493
75683070@N00,5434,19,1430808498,1430808676,3,73,178
75683070@N00,5434,6,1430808676,1430808731,2,73,55
75683070@N00,5434,20,1430808731,1430808738,2,73,7
75683070@N00,5434,8,1430808738,1430808780,2,73,42
75683070@N00,5434,4,1430808780,1430808828,3,73,48
75683070@N00,5434,2,1430808828,1430808888,3,73,60
75683070@N00,5434,15,1430809110,1430809470,3,73,360
75683070@N00,5434,25,1430810128,1430810228,8,73,100
75683070@N00,5434,22,1430810228,1430810285,5,73,57
75683070@N00,5434,24,1430810285,1430810456,9,73,171
75683070@N00,5434,20,1430810456,1430810484,3,73,28
75683070@N00,5434,24,1430810484,1430810586,6,73,102
75683070@N00,5434,20,1430810586,1430810695,2,73,109
75683070@N00,5434,24,1430810695,1430810733,2,73,38
75683070@N00,5434,22,1430810733,1430810758,3,73,25
75683070@N00,5434,25,1430810758,1430811329,26,73,571
75683070@N00,5434,2,1430811329,1430811389,2,73,60
75683070@N00,5434,25,1430811438,1430811651,10,73,213
75683070@N00,5434,15,1430811651,1430812011,5,73,360
75683070@N00,5434,22,1430812088,1430813108,3,73,1020
75683070@N00,5434,24,1430813494,1430814112,6,73,618
75683070@N00,5434,22,1430814112,1430814171,2,73,59
75683070@N00,5434,13,1430814171,1430814471,2,73,300
75683070@N00,5434,23,1430815225,1430815881,2,73,656
75683070@N00,5434,11,1430815881,1430816121,3,73,240
75683070@N00,5434,7,1430817442,1430817562,2,73,120
75683070@N00,5434,18,1430818437,1430818977,3,73,540
75683070@N00,5434,10,1430820951,1430821101,19,73,150
75722661@N00,5435,25,1301277700,1301279800,1,1,2100
75806696@N00,5436,19,1292143671,1292144211,1,1,540
75806696@N00,5437,19,1301906928,1301907468,1,1,540
75806696@N00,5438,24,1356869875,1356871375,2,1,1500
7585404@N05,5439,14,1458980285,1458980645,1,1,360
7595156@N05,5440,12,1373103402,1373103672,1,1,270
75966129@N00,5441,7,1338535709,1338535829,72,1,120
75992475@N02,5442,6,1434842338,1434842458,2,2,120
75992475@N02,5442,20,1434848229,1434848829,1,2,600
76024515@N07,5443,15,1333679992,1333680352,2,4,360
76024515@N07,5443,17,1333702886,1333703306,2,4,420
76024515@N07,5443,13,1333705794,1333706094,2,4,300
76024515@N07,5443,18,1333710990,1333711530,1,4,540
76024515@N07,5444,6,1354836097,1354836217,4,5,120
76024515@N07,5444,7,1354840060,1354840180,2,5,120
76024515@N07,5444,16,1354864999,1354865419,2,5,420
76024515@N07,5444,13,1354875250,1354875550,2,5,300
76024515@N07,5444,10,1354878972,1354879122,1,5,150
76024515@N07,5445,15,1363737153,1363737513,1,1,360
76132995@N07,5446,19,1352587494,1352588034,1,1,540
76151808@N00,5447,13,1203376910,1203377210,3,13,300
76151808@N00,5447,20,1203383915,1203384515,2,13,600
76151808@N00,5447,10,1203385918,1203385975,2,13,57
76151808@N00,5447,18,1203385975,1203386512,3,13,537
76151808@N00,5447,3,1203386512,1203386602,3,13,90
76151808@N00,5447,18,1203389477,1203390017,2,13,540
76151808@N00,5447,16,1203391793,1203392213,2,13,420
76151808@N00,5447,20,1203396266,1203396866,2,13,600
76151808@N00,5447,24,1203398227,1203399727,2,13,1500
76151808@N00,5447,23,1203400692,1203401892,2,13,1200
76151808@N00,5447,19,1203405794,1203406055,2,13,261
76151808@N00,5447,24,1203406055,1203406543,2,13,488
76151808@N00,5447,25,1203406543,1203408643,5,13,2100
76151808@N00,5448,25,1203485964,1203487473,2,2,1509
76151808@N00,5448,13,1203487473,1203487773,1,2,300
76151808@N00,5449,24,1203672655,1203673572,2,2,917
76151808@N00,5449,12,1203673572,1203673842,3,2,270
76151808@N00,5450,19,1276857347,1276857887,4,4,540
76151808@N00,5450,18,1276860477,1276861017,2,4,540
76151808@N00,5450,5,1276874192,1276874312,4,4,120
76151808@N00,5450,7,1276876319,1276876439,1,4,120
76151808@N00,5451,10,1276947835,1276947985,2,3,150
76151808@N00,5451,16,1276956071,1276956491,3,3,420
76151808@N00,5451,7,1276958757,1276958877,1,3,120
76151808@N00,5452,24,1377061331,1377062831,4,4,1500
76151808@N00,5452,12,1377068561,1377068831,2,4,270
76151808@N00,5452,19,1377073191,1377073731,2,4,540
76151808@N00,5452,16,1377086252,1377086672,2,4,420
76151808@N00,5453,11,1436954056,1436954296,1,1,240
76225887@N00,5454,24,1275804930,1275806430,24,1,1500
76225887@N00,5455,24,1275984481,1275985981,13,1,1500
76225887@N00,5456,24,1276061318,1276062818,1,1,1500
76281306@N00,5457,23,1441496020,1441497220,1,1,1200
76297493@N02,5458,19,1354938950,1354939490,1,1,540
7630487@N08,5459,23,1373616059,1373616984,2,4,925
7630487@N08,5459,16,1373616984,1373617404,2,4,420
7630487@N08,5459,3,1373618922,1373619012,2,4,90
7630487@N08,5459,22,1373624977,1373625997,1,4,1020
7630487@N08,5460,7,1379819959,1379820079,2,4,120
7630487@N08,5460,19,1379829122,1379829662,2,4,540
7630487@N08,5460,18,1379829663,1379830203,2,4,540
7630487@N08,5460,3,1379831282,1379831372,1,4,90
7642077@N04,5461,16,1370763071,1370763491,2,2,420
7642077@N04,5461,15,1370769940,1370770300,1,2,360
7642077@N04,5462,17,1370811679,1370812099,3,8,420
7642077@N04,5462,16,1370812285,1370812705,3,8,420
7642077@N04,5462,6,1370813283,1370813403,3,8,120
7642077@N04,5462,14,1370814662,1370815022,2,8,360
7642077@N04,5462,17,1370822488,1370822908,4,8,420
7642077@N04,5462,10,1370823620,1370823770,5,8,150
7642077@N04,5462,5,1370824450,1370824570,3,8,120
7642077@N04,5462,24,1370826649,1370828149,2,8,1500
7642077@N04,5463,16,1370863669,1370864089,6,1,420
7642077@N04,5464,5,1370991804,1370991924,1,1,120
76454708@N06,5465,14,1332452443,1332452803,1,1,360
7655603@N02,5466,18,1214780443,1214780983,7,1,540
76619232@N00,5467,4,1362097273,1362097363,3,2,90
76619232@N00,5467,18,1362100155,1362100695,1,2,540
76626185@N00,5468,8,1222600874,1222600994,1,1,120
76665138@N00,5469,12,1240028288,1240028558,6,1,270
76665138@N00,5470,7,1240112633,1240112657,3,16,24
76665138@N00,5470,25,1240112657,1240113265,2,16,608
76665138@N00,5470,13,1240113265,1240113565,7,16,300
76665138@N00,5470,24,1240113684,1240115184,13,16,1500
76665138@N00,5470,25,1240115800,1240115831,2,16,31
76665138@N00,5470,24,1240115831,1240115925,2,16,94
76665138@N00,5470,25,1240115925,1240118025,11,16,2100
76665138@N00,5470,24,1240119440,1240120150,3,16,710
76665138@N00,5470,6,1240120150,1240120270,5,16,120
76665138@N00,5470,10,1240122085,1240122132,6,16,47
76665138@N00,5470,3,1240122132,1240122143,2,16,11
76665138@N00,5470,16,1240122143,1240122168,2,16,25
76665138@N00,5470,7,1240122168,1240122288,5,16,120
76665138@N00,5470,6,1240125296,1240125416,12,16,120
76665138@N00,5470,12,1240126288,1240126558,3,16,270
76665138@N00,5470,24,1240126958,1240128458,3,16,1500
76665138@N00,5471,5,1240286160,1240286280,2,17,120
76665138@N00,5471,3,1240287016,1240287106,2,17,90
76665138@N00,5471,12,1240287115,1240287385,2,17,270
76665138@N00,5471,17,1240287603,1240288023,16,17,420
76665138@N00,5471,12,1240289300,1240289378,3,17,78
76665138@N00,5471,7,1240289378,1240289498,2,17,120
76665138@N00,5471,19,1240291567,1240292107,23,17,540
76665138@N00,5471,6,1240294150,1240294176,3,17,26
76665138@N00,5471,16,1240294176,1240294183,2,17,7
76665138@N00,5471,6,1240294183,1240294303,5,17,120
76665138@N00,5471,24,1240294871,1240294965,3,17,94
76665138@N00,5471,25,1240294965,1240295103,8,17,138
76665138@N00,5471,24,1240295103,1240295146,3,17,43
76665138@N00,5471,25,1240295146,1240295184,2,17,38
76665138@N00,5471,24,1240295184,1240295251,2,17,67
76665138@N00,5471,12,1240295251,1240295264,2,17,13
76665138@N00,5471,24,1240295264,1240296764,13,17,1500
76684578@N00,5472,3,1340339773,1340339863,1,1,90
76701708@N00,5473,7,1448928438,1448928558,1,1,120
76749155@N06,5474,5,1373156850,1373156970,2,2,120
76749155@N06,5474,14,1373167710,1373168070,1,2,360
76752765@N06,5475,24,1285509600,1285511100,50,1,1500
76825970@N02,5476,24,1394204599,1394206099,1,1,1500
7687866@N07,5477,17,1266018037,1266018457,1,1,420
7687866@N07,5478,17,1266097921,1266098341,1,1,420
76959737@N00,5479,12,1325767557,1325767827,1,1,270
76959737@N00,5480,7,1339242206,1339242326,1,1,120
76959737@N00,5481,14,1339374417,1339374777,2,2,360
76959737@N00,5481,19,1339383560,1339384100,1,2,540
76959737@N00,5482,14,1340631296,1340631656,1,1,360
76959737@N00,5483,13,1345293932,1345294232,1,1,300
76988315@N07,5484,24,1368157795,1368159295,1,1,1500
77084926@N06,5485,14,1379537454,1379537814,1,1,360
77120147@N06,5486,20,1328849101,1328849701,1,1,600
77120147@N06,5487,17,1333411617,1333412037,2,5,420
77120147@N06,5487,23,1333412171,1333412351,2,5,180
77120147@N06,5487,16,1333412351,1333412771,2,5,420
77120147@N06,5487,18,1333413735,1333414275,2,5,540
77120147@N06,5487,15,1333418149,1333418509,1,5,360
77120147@N06,5488,18,1337336457,1337336997,3,1,540
77120147@N06,5489,7,1338856825,1338856945,2,8,120
77120147@N06,5489,5,1338857481,1338857576,2,8,95
77120147@N06,5489,18,1338857576,1338858116,2,8,540
77120147@N06,5489,24,1338860192,1338861692,2,8,1500
77120147@N06,5489,11,1338862365,1338862605,2,8,240
77120147@N06,5489,18,1338862849,1338863055,2,8,206
77120147@N06,5489,7,1338863055,1338863175,3,8,120
77120147@N06,5489,23,1338863663,1338864863,1,8,1200
77120147@N06,5490,14,1339745177,1339745537,1,1,360
77120147@N06,5491,14,1340150514,1340150874,2,1,360
77120147@N06,5492,14,1340401164,1340401524,5,1,360
77120147@N06,5493,14,1340446437,1340446797,5,1,360
77120147@N06,5494,14,1341043364,1341043724,4,1,360
77154890@N02,5495,16,1334371350,1334371770,1,1,420
77154962@N00,5496,12,1274139408,1274139678,4,4,270
77154962@N00,5496,7,1274149782,1274149902,10,4,120
77154962@N00,5496,19,1274167575,1274168115,8,4,540
77154962@N00,5496,7,1274178759,1274178879,1,4,120
77179348@N00,5497,12,1339136870,1339137140,4,27,270
77179348@N00,5497,24,1339137744,1339137851,6,27,107
77179348@N00,5497,22,1339137851,1339137881,3,27,30
77179348@N00,5497,25,1339137881,1339137955,5,27,74
77179348@N00,5497,4,1339137955,1339137992,4,27,37
77179348@N00,5497,2,1339137992,1339138028,2,27,36
77179348@N00,5497,8,1339138028,1339138053,2,27,25
77179348@N00,5497,20,1339138053,1339138119,2,27,66
77179348@N00,5497,6,1339138119,1339138239,5,27,120
77179348@N00,5497,19,1339138398,1339138514,3,27,116
77179348@N00,5497,16,1339138514,1339138580,5,27,66
77179348@N00,5497,11,1339138580,1339138702,8,27,122
77179348@N00,5497,7,1339138702,1339138788,3,27,86
77179348@N00,5497,18,1339138788,1339138913,5,27,125
77179348@N00,5497,5,1339138913,1339138958,2,27,45
77179348@N00,5497,1,1339138958,1339138997,3,27,39
77179348@N00,5497,10,1339138997,1339139046,3,27,49
77179348@N00,5497,16,1339139046,1339139466,3,27,420
77179348@N00,5497,23,1339139960,1339140031,4,27,71
77179348@N00,5497,17,1339140031,1339140204,4,27,173
77179348@N00,5497,12,1339140204,1339140474,4,27,270
77179348@N00,5497,17,1339141620,1339142040,2,27,420
77179348@N00,5497,16,1339142288,1339142707,3,27,419
77179348@N00,5497,7,1339142707,1339142827,2,27,120
77179348@N00,5497,19,1339144226,1339144766,2,27,540
77179348@N00,5497,4,1339158745,1339158835,2,27,90
77179348@N00,5497,12,1339159278,1339159548,1,27,270
77179348@N00,5498,17,1339407617,1339408037,2,1,420
77179348@N00,5499,12,1340236500,1340236770,3,1,270
77179348@N00,5500,13,1340267041,1340267054,2,16,13
77179348@N00,5500,24,1340267054,1340267059,2,16,5
77179348@N00,5500,12,1340267059,1340267075,4,16,16
77179348@N00,5500,17,1340267075,1340267495,2,16,420
77179348@N00,5500,12,1340275838,1340276108,4,16,270
77179348@N00,5500,6,1340276747,1340276867,7,16,120
77179348@N00,5500,19,1340276894,1340276948,2,16,54
77179348@N00,5500,6,1340276948,1340277012,2,16,64
77179348@N00,5500,14,1340277012,1340277372,7,16,360
77179348@N00,5500,19,1340277525,1340278065,10,16,540
77179348@N00,5500,24,1340278655,1340279475,4,16,820
77179348@N00,5500,10,1340279475,1340279625,2,16,150
77179348@N00,5500,16,1340279720,1340280140,13,16,420
77179348@N00,5500,15,1340282992,1340283074,2,16,82
77179348@N00,5500,25,1340283074,1340284418,7,16,1344
77179348@N00,5500,13,1340284418,1340284718,5,16,300
77179348@N00,5501,24,1344732766,1344734266,25,6,1500
77179348@N00,5501,17,1344737110,1344737530,5,6,420
77179348@N00,5501,24,1344744277,1344744585,3,6,308
77179348@N00,5501,25,1344744585,1344745638,2,6,1053
77179348@N00,5501,6,1344745638,1344745758,2,6,120
77179348@N00,5501,15,1344747846,1344748206,41,6,360
77207999@N08,5502,25,1366451570,1366453670,1,1,2100
77217620@N08,5503,25,1331198714,1331200814,1,1,2100
77217620@N08,5504,13,1333361077,1333361377,2,2,300
77217620@N08,5504,18,1333366108,1333366648,1,2,540
77217620@N08,5505,12,1333537364,1333537634,1,1,270
77217620@N08,5506,22,1334831444,1334832464,1,1,1020
77217620@N08,5507,6,1336356198,1336356318,1,1,120
77217620@N08,5508,12,1338367834,1338368104,2,4,270
77217620@N08,5508,20,1338368821,1338369421,2,4,600
77217620@N08,5508,8,1338369651,1338369771,2,4,120
77217620@N08,5508,18,1338371566,1338372106,1,4,540
77217620@N08,5509,6,1340254989,1340255109,1,1,120
77217620@N08,5510,6,1340403944,1340404064,1,1,120
77217620@N08,5511,12,1340772654,1340772924,2,2,270
77217620@N08,5511,24,1340774230,1340775730,1,2,1500
77217620@N08,5512,14,1340933468,1340933828,2,2,360
77217620@N08,5512,6,1340942963,1340943083,1,2,120
77217620@N08,5513,12,1341049383,1341049653,2,4,270
77217620@N08,5513,19,1341056776,1341057316,2,4,540
77217620@N08,5513,6,1341058170,1341058290,2,4,120
77217620@N08,5513,14,1341059766,1341060126,1,4,360
77217620@N08,5514,12,1342398842,1342399112,1,1,270
77217620@N08,5515,12,1342987705,1342987975,2,1,270
77217620@N08,5516,6,1343685546,1343685666,1,1,120
77217620@N08,5517,6,1343796618,1343796738,1,1,120
77217620@N08,5518,19,1344755920,1344756460,1,1,540
77237839@N07,5519,10,1393657546,1393657696,2,6,150
77237839@N07,5519,18,1393661561,1393662101,8,6,540
77237839@N07,5519,12,1393663891,1393664161,6,6,270
77237839@N07,5519,6,1393669742,1393669862,6,6,120
77237839@N07,5519,7,1393670754,1393670874,14,6,120
77237839@N07,5519,24,1393671603,1393673103,4,6,1500
77249045@N07,5520,13,1317977904,1317978204,5,1,300
77249045@N07,5521,13,1324195341,1324195641,2,1,300
77249045@N07,5522,13,1328947436,1328947736,22,1,300
77249045@N07,5523,13,1332491174,1332491474,12,1,300
77249045@N07,5524,16,1334905785,1334906205,4,2,420
77249045@N07,5524,20,1334906501,1334907101,5,2,600
77249045@N07,5525,24,1338551877,1338553377,2,1,1500
77249045@N07,5526,9,1339715125,1339715245,6,2,120
77249045@N07,5526,24,1339737233,1339738733,1,2,1500
77249045@N07,5527,13,1346300764,1346301064,1,1,300
77249045@N07,5528,13,1348829543,1348829843,12,1,300
77253973@N07,5529,22,1329875377,1329876397,1,1,1020
7730953@N08,5530,14,1418089982,1418090342,1,1,360
7732814@N08,5531,13,1319275631,1319275931,1,1,300
7735629@N05,5532,7,1369116263,1369116383,1,1,120
77403773@N08,5533,19,1333261840,1333262380,2,1,540
77403773@N08,5534,25,1333673192,1333673788,2,3,596
77403773@N08,5534,20,1333673788,1333674388,2,3,600
77403773@N08,5534,16,1333675311,1333675731,1,3,420
77466107@N00,5535,25,1353109899,1353111999,7,6,2100
77466107@N00,5535,3,1353112938,1353113028,2,6,90
77466107@N00,5535,16,1353113394,1353113814,2,6,420
77466107@N00,5535,11,1353119054,1353119294,2,6,240
77466107@N00,5535,14,1353128540,1353128564,2,6,24
77466107@N00,5535,19,1353128564,1353129104,3,6,540
7751128@N02,5536,24,1237766699,1237768199,12,1,1500
7771611@N06,5537,14,1249899754,1249900114,4,2,360
7771611@N06,5537,23,1249925286,1249926486,1,2,1200
7771611@N06,5538,19,1317826228,1317826768,2,2,540
7771611@N06,5538,11,1317830337,1317830577,1,2,240
7771611@N06,5539,7,1317902972,1317903092,2,1,120
7771611@N06,5540,14,1317984420,1317984780,2,2,360
7771611@N06,5540,12,1317999866,1318000136,1,2,270
77723504@N00,5541,17,1289001018,1289001438,1,1,420
7784816@N03,5542,18,1334542005,1334542545,1,1,540
7784816@N03,5543,22,1334640710,1334641730,1,1,1020
77906206@N00,5544,16,1197612922,1197613342,1,1,420
77923960@N08,5545,18,1387319649,1387320189,2,2,540
77923960@N08,5545,6,1387323727,1387323847,1,2,120
77967578@N00,5546,17,1213616103,1213616523,1,1,420
77967578@N00,5547,7,1214054010,1214054130,2,3,120
77967578@N00,5547,18,1214054842,1214055382,2,3,540
77967578@N00,5547,25,1214059907,1214062007,4,3,2100
77977639@N00,5548,22,1367653331,1367654351,1,1,1020
78013771@N00,5549,14,1352668170,1352668530,5,11,360
78013771@N00,5549,8,1352670731,1352670851,3,11,120
78013771@N00,5549,6,1352670963,1352671083,2,11,120
78013771@N00,5549,19,1352671223,1352671763,3,11,540
78013771@N00,5549,11,1352671969,1352672209,2,11,240
78013771@N00,5549,18,1352673547,1352674087,3,11,540
78013771@N00,5549,19,1352674888,1352675428,2,11,540
78013771@N00,5549,5,1352676443,1352676563,3,11,120
78013771@N00,5549,17,1352678599,1352679019,2,11,420
78013771@N00,5549,12,1352679092,1352679362,2,11,270
78013771@N00,5549,25,1352681319,1352683419,8,11,2100
78013771@N00,5550,12,1352787762,1352788032,5,5,270
78013771@N00,5550,25,1352788089,1352788283,3,5,194
78013771@N00,5550,4,1352788283,1352788373,2,5,90
78013771@N00,5550,25,1352789244,1352790590,2,5,1346
78013771@N00,5550,9,1352790590,1352790710,1,5,120
78013771@N00,5551,8,1352846250,1352846370,3,10,120
78013771@N00,5551,14,1352848115,1352848475,2,10,360
78013771@N00,5551,25,1352848591,1352849816,2,10,1225
78013771@N00,5551,18,1352849816,1352850356,3,10,540
78013771@N00,5551,16,1352851570,1352851990,4,10,420
78013771@N00,5551,23,1352852726,1352853926,7,10,1200
78013771@N00,5551,6,1352877638,1352877758,2,10,120
78013771@N00,5551,19,1352877854,1352878394,2,10,540
78013771@N00,5551,3,1352883234,1352883324,2,10,90
78013771@N00,5551,16,1352884422,1352884842,2,10,420
78013771@N00,5552,12,1352965580,1352965850,2,2,270
78013771@N00,5552,17,1352970406,1352970826,1,2,420
78025158@N00,5553,15,1237443028,1237443388,2,3,360
78025158@N00,5553,1,1237448369,1237448429,2,3,60
78025158@N00,5553,12,1237452125,1237452395,1,3,270
78025158@N00,5554,19,1249901268,1249901808,2,2,540
78025158@N00,5554,7,1249904015,1249904135,1,2,120
78025158@N00,5555,15,1260524101,1260524461,2,4,360
78025158@N00,5555,7,1260525063,1260525183,6,4,120
78025158@N00,5555,18,1260528754,1260529294,2,4,540
78025158@N00,5555,16,1260529767,1260530187,2,4,420
78025158@N00,5556,15,1261390126,1261390486,2,2,360
78025158@N00,5556,19,1261391253,1261391793,1,2,540
78025158@N00,5557,7,1296976844,1296976964,1,1,120
78025158@N00,5558,24,1339734826,1339736326,6,1,1500
78025158@N00,5559,24,1340020274,1340021774,1,1,1500
78027754@N00,5560,15,1437871905,1437872265,11,3,360
78027754@N00,5560,8,1437873809,1437873929,12,3,120
78027754@N00,5560,25,1437891926,1437894026,15,3,2100
78086333@N04,5561,18,1417435176,1417435716,1,1,540
78127908@N04,5562,11,1363992678,1363992918,2,3,240
78127908@N04,5562,15,1363996665,1363997025,2,3,360
78127908@N04,5562,14,1364006228,1364006588,1,3,360
78137955@N00,5563,17,1324700784,1324701204,2,4,420
78137955@N00,5563,21,1324703150,1324704050,2,4,900
78137955@N00,5563,7,1324706523,1324706643,5,4,120
78137955@N00,5563,10,1324711334,1324711484,1,4,150
78137955@N00,5564,5,1324793961,1324794081,2,2,120
78137955@N00,5564,18,1324794265,1324794805,1,2,540
78175333@N00,5565,12,1238393997,1238394267,7,1,270
7849988@N04,5566,23,1379111964,1379113164,2,1,1200
78672040@N00,5567,24,1272582019,1272583519,29,3,1500
78672040@N00,5567,19,1272607285,1272607825,2,3,540
78672040@N00,5567,24,1272612106,1272613606,4,3,1500
78672040@N00,5568,24,1272660566,1272662066,25,1,1500
78672040@N00,5569,12,1272827802,1272828072,2,1,270
78672040@N00,5570,12,1273021532,1273021802,1,1,270
78720487@N02,5571,16,1416183967,1416184387,1,1,420
78720487@N02,5572,12,1416215578,1416215848,1,1,270
7874766@N02,5573,12,1356988702,1356988940,2,35,238
7874766@N02,5573,24,1356988940,1356988942,2,35,2
7874766@N02,5573,12,1356988942,1356988952,3,35,10
7874766@N02,5573,24,1356988952,1356989232,2,35,280
7874766@N02,5573,17,1356989232,1356989243,4,35,11
7874766@N02,5573,12,1356989243,1356989243,2,35,0
7874766@N02,5573,17,1356989243,1356989603,2,35,360
7874766@N02,5573,12,1356989603,1356989873,3,35,270
7874766@N02,5573,14,1356991705,1356992033,2,35,328
7874766@N02,5573,12,1356992033,1356992033,2,35,0
7874766@N02,5573,25,1356992033,1356993138,2,35,1105
7874766@N02,5573,6,1356993138,1356993258,2,35,120
7874766@N02,5573,19,1356994123,1356994663,2,35,540
7874766@N02,5573,14,1356995066,1356995426,3,35,360
7874766@N02,5573,12,1357000571,1357000571,2,35,0
7874766@N02,5573,19,1357000571,1357000969,2,35,398
7874766@N02,5573,7,1357000969,1357001089,2,35,120
7874766@N02,5573,12,1357003552,1357003552,2,35,0
7874766@N02,5573,18,1357003552,1357004092,2,35,540
7874766@N02,5573,16,1357005070,1357005490,3,35,420
7874766@N02,5573,17,1357006670,1357006671,2,35,1
7874766@N02,5573,12,1357006671,1357006671,2,35,0
7874766@N02,5573,17,1357006671,1357006973,2,35,302
7874766@N02,5573,24,1357006973,1357008473,2,35,1500
7874766@N02,5573,19,1357009975,1357009980,2,35,5
7874766@N02,5573,12,1357009980,1357009980,2,35,0
7874766@N02,5573,19,1357009980,1357010520,2,35,540
7874766@N02,5573,12,1357011075,1357011075,2,35,0
7874766@N02,5573,16,1357011075,1357011495,3,35,420
7874766@N02,5573,12,1357036752,1357036783,2,35,31
7874766@N02,5573,19,1357036783,1357036970,4,35,187
7874766@N02,5573,12,1357036970,1357036970,2,35,0
7874766@N02,5573,14,1357036970,1357037330,2,35,360
7874766@N02,5573,12,1357040429,1357040429,2,35,0
7874766@N02,5573,14,1357040429,1357040789,1,35,360
7874766@N02,5574,12,1357189897,1357190167,1,1,270
78750974@N06,5575,10,1339584229,1339584379,10,1,150
78765381@N07,5576,10,1431229613,1431229763,1,1,150
78765381@N07,5577,19,1431854964,1431855504,1,1,540
7881305@N03,5578,16,1308302203,1308302623,3,1,420
78832226@N00,5579,12,1211243356,1211243626,4,11,270
78832226@N00,5579,6,1211245858,1211245896,2,11,38
78832226@N00,5579,19,1211245896,1211246436,2,11,540
78832226@N00,5579,7,1211246606,1211246726,2,11,120
78832226@N00,5579,11,1211246726,1211246966,4,11,240
78832226@N00,5579,19,1211252827,1211253367,2,11,540
78832226@N00,5579,6,1211255325,1211255445,2,11,120
78832226@N00,5579,12,1211255725,1211255995,4,11,270
78832226@N00,5579,17,1211256324,1211256744,2,11,420
78832226@N00,5579,24,1211257455,1211258955,4,11,1500
78832226@N00,5579,15,1211260151,1211260511,5,11,360
78832226@N00,5580,22,1224200429,1224201449,2,12,1020
78832226@N00,5580,24,1224201470,1224201921,2,12,451
78832226@N00,5580,16,1224201921,1224202341,2,12,420
78832226@N00,5580,11,1224203390,1224203630,2,12,240
78832226@N00,5580,7,1224205979,1224206099,2,12,120
78832226@N00,5580,18,1224206873,1224207413,2,12,540
78832226@N00,5580,7,1224208562,1224208682,2,12,120
78832226@N00,5580,18,1224209878,1224210157,2,12,279
78832226@N00,5580,5,1224210157,1224210277,2,12,120
78832226@N00,5580,23,1224211356,1224211425,2,12,69
78832226@N00,5580,17,1224211425,1224211845,2,12,420
78832226@N00,5580,12,1224212526,1224212796,1,12,270
78832226@N00,5581,15,1235444761,1235445121,2,9,360
78832226@N00,5581,12,1235446402,1235446672,2,9,270
78832226@N00,5581,6,1235450431,1235450551,2,9,120
78832226@N00,5581,7,1235451091,1235451211,2,9,120
78832226@N00,5581,18,1235452918,1235453458,2,9,540
78832226@N00,5581,5,1235456348,1235456468,2,9,120
78832226@N00,5581,18,1235458738,1235458770,2,9,32
78832226@N00,5581,7,1235458770,1235458792,2,9,22
78832226@N00,5581,18,1235458792,1235459332,1,9,540
78832226@N00,5582,12,1235517924,1235518194,1,1,270
78832226@N00,5583,12,1242087010,1242087280,3,5,270
78832226@N00,5583,8,1242099689,1242099809,3,5,120
78832226@N00,5583,9,1242100826,1242100946,2,5,120
78832226@N00,5583,22,1242102484,1242103504,2,5,1020
78832226@N00,5583,25,1242103523,1242105623,2,5,2100
78832226@N00,5584,3,1322888362,1322888452,2,6,90
78832226@N00,5584,16,1322889993,1322890413,2,6,420
78832226@N00,5584,7,1322892237,1322892357,3,6,120
78832226@N00,5584,15,1322894575,1322894935,2,6,360
78832226@N00,5584,12,1322898324,1322898594,2,6,270
78832226@N00,5584,11,1322902837,1322903077,1,6,240
7890449@N03,5585,24,1439174560,1439174726,2,2,166
7890449@N03,5585,11,1439174726,1439174966,1,2,240
79023626@N00,5586,3,1380877239,1380877329,1,1,90
7906627@N04,5587,12,1345896939,1345897151,2,5,212
7906627@N04,5587,13,1345897151,1345897271,2,5,120
7906627@N04,5587,6,1345897271,1345897391,2,5,120
7906627@N04,5587,19,1345897837,1345897916,2,5,79
7906627@N04,5587,14,1345897916,1345898276,2,5,360
7906627@N04,5588,12,1365572720,1365572990,1,1,270
7906627@N04,5589,7,1365606956,1365607076,1,1,120
7906627@N04,5590,24,1371883488,1371884988,1,1,1500
7906627@N04,5591,6,1375570535,1375570655,2,7,120
7906627@N04,5591,11,1375571840,1375572080,2,7,240
7906627@N04,5591,14,1375591080,1375591297,2,7,217
7906627@N04,5591,6,1375591297,1375591417,2,7,120
7906627@N04,5591,22,1375595395,1375595538,2,7,143
7906627@N04,5591,13,1375595538,1375595838,2,7,300
7906627@N04,5591,17,1375596433,1375596853,1,7,420
7906627@N04,5592,4,1378357642,1378357732,2,4,90
7906627@N04,5592,9,1378362505,1378362577,2,4,72
7906627@N04,5592,22,1378362577,1378363597,2,4,1020
7906627@N04,5592,18,1378365938,1378366478,2,4,540
7906627@N04,5593,11,1396943582,1396943822,1,1,240
79106425@N05,5594,16,1317273088,1317273508,1,1,420
7914705@N02,5595,18,1314439196,1314439736,1,1,540
79147296@N06,5596,11,1405386852,1405386938,2,3,86
79147296@N06,5596,18,1405386938,1405387478,2,3,540
79147296@N06,5596,11,1405388205,1405388445,1,3,240
79148915@N03,5597,14,1340683751,1340684111,8,1,360
79172203@N00,5598,12,1234678794,1234679064,14,2,270
79172203@N00,5598,25,1234682286,1234684386,1,2,2100
79172203@N00,5599,25,1234742178,1234744278,2,1,2100
79172203@N00,5600,20,1250247907,1250248507,30,1,600
79172203@N00,5601,20,1250420492,1250421092,32,1,600
79172203@N00,5602,24,1255311232,1255312732,15,4,1500
79172203@N00,5602,22,1255313216,1255314236,3,4,1020
79172203@N00,5602,12,1255328303,1255328573,34,4,270
79172203@N00,5602,24,1255331097,1255332597,1,4,1500
79172203@N00,5603,12,1261135356,1261135626,1,1,270
79172203@N00,5604,12,1261266324,1261266594,2,3,270
79172203@N00,5604,20,1261279799,1261280399,7,3,600
79172203@N00,5604,12,1261281164,1261281434,1,3,270
79172203@N00,5605,20,1270983970,1270984570,13,1,600
79172203@N00,5606,6,1271125172,1271125191,2,4,19
79172203@N00,5606,20,1271125191,1271125791,7,4,600
79172203@N00,5606,25,1271130062,1271130723,4,4,661
79172203@N00,5606,22,1271130723,1271131743,4,4,1020
79172203@N00,5607,16,1278743908,1278744328,2,3,420
79172203@N00,5607,7,1278751209,1278751329,3,3,120
79172203@N00,5607,16,1278757269,1278757689,15,3,420
79172203@N00,5608,13,1278810764,1278811064,2,11,300
79172203@N00,5608,7,1278816539,1278816659,2,11,120
79172203@N00,5608,5,1278817900,1278818020,5,11,120
79172203@N00,5608,1,1278818089,1278818149,4,11,60
79172203@N00,5608,10,1278818270,1278818414,5,11,144
79172203@N00,5608,16,1278818414,1278818834,18,11,420
79172203@N00,5608,19,1278819108,1278819648,4,11,540
79172203@N00,5608,17,1278826388,1278826808,5,11,420
79172203@N00,5608,19,1278834118,1278834658,3,11,540
79172203@N00,5608,16,1278843097,1278843517,9,11,420
79172203@N00,5608,17,1278849379,1278849799,2,11,420
79172203@N00,5609,22,1281749305,1281750325,9,4,1020
79172203@N00,5609,7,1281773326,1281773446,7,4,120
79172203@N00,5609,10,1281776302,1281776452,3,4,150
79172203@N00,5609,7,1281788835,1281788955,1,4,120
79172203@N00,5610,12,1281841134,1281841347,4,3,213
79172203@N00,5610,24,1281841347,1281841587,4,3,240
79172203@N00,5610,13,1281841587,1281841887,4,3,300
79172203@N00,5611,7,1297502159,1297502279,2,3,120
79172203@N00,5611,13,1297504290,1297504590,4,3,300
79172203@N00,5611,16,1297505676,1297506096,23,3,420
79172203@N00,5612,16,1297595257,1297595677,69,1,420
79172203@N00,5613,22,1302333045,1302334065,10,2,1020
79172203@N00,5613,16,1302352417,1302352837,6,2,420
79172203@N00,5614,7,1302405820,1302405940,3,7,120
79172203@N00,5614,11,1302407781,1302408021,2,7,240
79172203@N00,5614,7,1302408380,1302408500,2,7,120
79172203@N00,5614,18,1302409282,1302409535,2,7,253
79172203@N00,5614,16,1302409535,1302409875,4,7,340
79172203@N00,5614,20,1302409875,1302410265,3,7,390
79172203@N00,5614,13,1302410265,1302410565,3,7,300
79172203@N00,5615,24,1306033363,1306034036,2,14,673
79172203@N00,5615,15,1306034036,1306034396,5,14,360
79172203@N00,5615,4,1306035144,1306035234,2,14,90
79172203@N00,5615,16,1306036825,1306037107,5,14,282
79172203@N00,5615,10,1306037107,1306037257,4,14,150
79172203@N00,5615,19,1306038981,1306039254,2,14,273
79172203@N00,5615,12,1306039254,1306039524,2,14,270
79172203@N00,5615,19,1306042751,1306043291,2,14,540
79172203@N00,5615,16,1306044134,1306044554,26,14,420
79172203@N00,5615,19,1306045108,1306045313,4,14,205
79172203@N00,5615,6,1306045313,1306045433,2,14,120
79172203@N00,5615,4,1306045481,1306045550,2,14,69
79172203@N00,5615,15,1306045550,1306045654,5,14,104
79172203@N00,5615,25,1306045654,1306047754,1,14,2100
79172203@N00,5616,20,1313203082,1313203399,2,6,317
79172203@N00,5616,16,1313203399,1313203819,21,6,420
79172203@N00,5616,17,1313205898,1313206318,5,6,420
79172203@N00,5616,3,1313209726,1313209816,2,6,90
79172203@N00,5616,25,1313213013,1313215113,2,6,2100
79172203@N00,5616,16,1313233191,1313233611,1,6,420
79172203@N00,5617,16,1313282750,1313283170,12,6,420
79172203@N00,5617,7,1313285220,1313285340,3,6,120
79172203@N00,5617,15,1313288351,1313288711,2,6,360
79172203@N00,5617,22,1313290454,1313291474,6,6,1020
79172203@N00,5617,12,1313292437,1313292582,2,6,145
79172203@N00,5617,17,1313292582,1313293002,1,6,420
79172203@N00,5618,25,1313379169,1313381269,1,1,2100
79172203@N00,5619,24,1325381792,1325381984,4,3,192
79172203@N00,5619,13,1325381984,1325382284,2,3,300
79172203@N00,5619,4,1325384189,1325384279,1,3,90
79172203@N00,5620,13,1330592911,1330593211,3,4,300
79172203@N00,5620,22,1330593213,1330594233,3,4,1020
79172203@N00,5620,16,1330598130,1330598550,6,4,420
79172203@N00,5620,19,1330598719,1330599259,4,4,540
79172203@N00,5621,24,1330741109,1330741138,4,11,29
79172203@N00,5621,12,1330741138,1330741184,2,11,46
79172203@N00,5621,24,1330741184,1330741399,5,11,215
79172203@N00,5621,22,1330741399,1330742161,7,11,762
79172203@N00,5621,25,1330742161,1330742248,3,11,87
79172203@N00,5621,15,1330742248,1330742490,3,11,242
79172203@N00,5621,4,1330742490,1330742580,8,11,90
79172203@N00,5621,20,1330742686,1330742808,4,11,122
79172203@N00,5621,6,1330742808,1330742928,2,11,120
79172203@N00,5621,16,1330743238,1330743658,6,11,420
79172203@N00,5621,12,1330743961,1330744231,45,11,270
79172203@N00,5622,12,1339287215,1339287485,36,18,270
79172203@N00,5622,24,1339290191,1339291691,20,18,1500
79172203@N00,5622,12,1339291717,1339291987,43,18,270
79172203@N00,5622,24,1339293303,1339294803,14,18,1500
79172203@N00,5622,12,1339294834,1339294976,6,18,142
79172203@N00,5622,24,1339294976,1339296476,6,18,1500
79172203@N00,5622,12,1339296978,1339297248,73,18,270
79172203@N00,5622,24,1339298512,1339300012,15,18,1500
79172203@N00,5622,19,1339315554,1339315721,4,18,167
79172203@N00,5622,14,1339315721,1339316081,27,18,360
79172203@N00,5622,6,1339317919,1339318039,79,18,120
79172203@N00,5622,14,1339324666,1339325026,13,18,360
79172203@N00,5622,6,1339326885,1339327005,63,18,120
79172203@N00,5622,19,1339328821,1339329361,16,18,540
79172203@N00,5622,16,1339330574,1339330994,84,18,420
79172203@N00,5622,19,1339332433,1339332678,2,18,245
79172203@N00,5622,24,1339332678,1339333143,4,18,465
79172203@N00,5622,12,1339333143,1339333413,1,18,270
79172203@N00,5623,12,1339390006,1339390082,3,16,76
79172203@N00,5623,24,1339390082,1339390744,10,16,662
79172203@N00,5623,13,1339390744,1339391038,7,16,294
79172203@N00,5623,15,1339391038,1339391158,5,16,120
79172203@N00,5623,4,1339391158,1339391248,8,16,90
79172203@N00,5623,19,1339391495,1339392035,14,16,540
79172203@N00,5623,16,1339394350,1339394770,28,16,420
79172203@N00,5623,11,1339396113,1339396339,8,16,226
79172203@N00,5623,7,1339396339,1339396459,2,16,120
79172203@N00,5623,18,1339396507,1339396613,2,16,106
79172203@N00,5623,1,1339396613,1339396673,4,16,60
79172203@N00,5623,3,1339396717,1339396766,3,16,49
79172203@N00,5623,10,1339396766,1339396899,5,16,133
79172203@N00,5623,16,1339396899,1339397274,2,16,375
79172203@N00,5623,23,1339397274,1339398474,11,16,1200
79172203@N00,5623,17,1339398516,1339398936,3,16,420
79172203@N00,5624,24,1345877957,1345879457,17,3,1500
79172203@N00,5624,6,1345887103,1345887223,4,3,120
79172203@N00,5624,19,1345887383,1345887923,5,3,540
79172203@N00,5625,24,1345933678,1345934793,4,5,1115
79172203@N00,5625,6,1345934793,1345934913,28,5,120
79172203@N00,5625,24,1345943200,1345944700,34,5,1500
79172203@N00,5625,19,1345954166,1345954207,3,5,41
79172203@N00,5625,14,1345954207,1345954567,29,5,360
79172203@N00,5626,12,1346031564,1346031643,2,5,79
79172203@N00,5626,24,1346031643,1346031779,4,5,136
79172203@N00,5626,19,1346031779,1346032319,2,5,540
79172203@N00,5626,16,1346032418,1346032747,5,5,329
79172203@N00,5626,19,1346032747,1346033287,1,5,540
79172203@N00,5627,6,1348725849,1348725969,3,1,120
79172203@N00,5628,6,1348871472,1348871592,3,6,120
79172203@N00,5628,12,1348892961,1348893231,5,6,270
79172203@N00,5628,19,1348907719,1348907923,6,6,204
79172203@N00,5628,6,1348907923,1348908043,17,6,120
79172203@N00,5628,19,1348910670,1348911210,7,6,540
79172203@N00,5628,15,1348915600,1348915960,1,6,360
79172203@N00,5629,12,1355305591,1355305733,2,6,142
79172203@N00,5629,24,1355305733,1355306234,9,6,501
79172203@N00,5629,19,1355306234,1355306294,3,6,60
79172203@N00,5629,6,1355306294,1355306414,27,6,120
79172203@N00,5629,19,1355307726,1355308266,11,6,540
79172203@N00,5629,1,1355308556,1355308616,21,6,60
79172203@N00,5630,14,1355365949,1355366309,6,16,360
79172203@N00,5630,4,1355366546,1355366636,3,16,90
79172203@N00,5630,24,1355367141,1355367941,20,16,800
79172203@N00,5630,12,1355367941,1355368093,2,16,152
79172203@N00,5630,17,1355368093,1355368513,3,16,420
79172203@N00,5630,23,1355373936,1355375120,8,16,1184
79172203@N00,5630,16,1355375120,1355375540,14,16,420
79172203@N00,5630,6,1355375881,1355375977,3,16,96
79172203@N00,5630,24,1355375977,1355376242,13,16,265
79172203@N00,5630,12,1355376242,1355376512,41,16,270
79172203@N00,5630,24,1355377838,1355379082,16,16,1244
79172203@N00,5630,12,1355379082,1355379352,30,16,270
79172203@N00,5630,24,1355387889,1355389389,7,16,1500
79172203@N00,5630,12,1355389733,1355390003,2,16,270
79172203@N00,5630,23,1355391886,1355393086,2,16,1200
79172203@N00,5630,16,1355393170,1355393590,2,16,420
79172203@N00,5631,24,1355446392,1355447184,3,2,792
79172203@N00,5631,12,1355447184,1355447454,3,2,270
79172203@N00,5632,24,1355532989,1355533376,7,15,387
79172203@N00,5632,12,1355533376,1355533646,7,15,270
79172203@N00,5632,24,1355536313,1355536914,5,15,601
79172203@N00,5632,12,1355536914,1355537184,4,15,270
79172203@N00,5632,24,1355538218,1355538360,5,15,142
79172203@N00,5632,19,1355538360,1355538900,2,15,540
79172203@N00,5632,11,1355538901,1355539141,3,15,240
79172203@N00,5632,7,1355540273,1355540393,2,15,120
79172203@N00,5632,5,1355540708,1355540828,2,15,120
79172203@N00,5632,1,1355541719,1355541779,5,15,60
79172203@N00,5632,16,1355542660,1355543080,7,15,420
79172203@N00,5632,6,1355544164,1355544284,85,15,120
79172203@N00,5632,24,1355547669,1355549169,7,15,1500
79172203@N00,5632,7,1355563920,1355564040,6,15,120
79172203@N00,5632,13,1355569709,1355570009,5,15,300
79172203@N00,5633,6,1362042352,1362042472,5,4,120
79172203@N00,5633,16,1362047604,1362048024,19,4,420
79172203@N00,5633,19,1362052686,1362053017,2,4,331
79172203@N00,5633,15,1362053017,1362053377,3,4,360
79172203@N00,5634,19,1362108976,1362109516,6,7,540
79172203@N00,5634,24,1362114765,1362115001,3,7,236
79172203@N00,5634,12,1362115001,1362115271,2,7,270
79172203@N00,5634,19,1362132571,1362132922,10,7,351
79172203@N00,5634,6,1362132922,1362133042,4,7,120
79172203@N00,5634,19,1362133658,1362133928,2,7,270
79172203@N00,5634,16,1362133928,1362134348,78,7,420
79172203@N00,5635,14,1367106861,1367107221,16,2,360
79172203@N00,5635,24,1367123140,1367124640,42,2,1500
79172203@N00,5636,19,1367214871,1367215411,6,8,540
79172203@N00,5636,6,1367220326,1367220446,35,8,120
79172203@N00,5636,24,1367222181,1367222231,2,8,50
79172203@N00,5636,22,1367222231,1367222280,5,8,49
79172203@N00,5636,13,1367222280,1367222546,8,8,266
79172203@N00,5636,22,1367222546,1367222724,3,8,178
79172203@N00,5636,24,1367222724,1367223471,7,8,747
79172203@N00,5636,12,1367223471,1367223741,5,8,270
79172203@N00,5637,12,1376437582,1376437852,2,3,270
79172203@N00,5637,6,1376440453,1376440573,2,3,120
79172203@N00,5637,16,1376441105,1376441525,10,3,420
79172203@N00,5638,6,1376710956,1376711076,4,3,120
79172203@N00,5638,24,1376712978,1376713033,3,3,55
79172203@N00,5638,12,1376713033,1376713303,3,3,270
79172203@N00,5639,24,1378046147,1378047647,8,1,1500
79172203@N00,5640,17,1388437622,1388438042,2,7,420
79172203@N00,5640,6,1388446588,1388446708,16,7,120
79172203@N00,5640,19,1388466053,1388466593,30,7,540
79172203@N00,5640,24,1388467042,1388468542,2,7,1500
79172203@N00,5640,19,1388474968,1388475508,5,7,540
79172203@N00,5640,25,1388480060,1388482160,51,7,2100
79172203@N00,5640,16,1388494811,1388495231,4,7,420
79172203@N00,5641,3,1388562204,1388562294,17,1,90
79172203@N00,5642,19,1388623951,1388624491,2,9,540
79172203@N00,5642,4,1388635278,1388635368,4,9,90
79172203@N00,5642,6,1388635432,1388635552,61,9,120
79172203@N00,5642,24,1388637619,1388637769,13,9,150
79172203@N00,5642,12,1388637769,1388638039,4,9,270
79172203@N00,5642,24,1388641638,1388643138,6,9,1500
79172203@N00,5642,6,1388659519,1388659639,46,9,120
79172203@N00,5642,19,1388660853,1388661377,2,9,524
79172203@N00,5642,16,1388661377,1388661797,84,9,420
79172203@N00,5643,24,1388726577,1388726830,8,2,253
79172203@N00,5643,12,1388726830,1388727100,1,2,270
79172203@N00,5644,7,1392457551,1392457671,2,1,120
79172203@N00,5645,14,1392504144,1392504504,2,10,360
79172203@N00,5645,19,1392507283,1392507823,2,10,540
79172203@N00,5645,5,1392518738,1392518858,2,10,120
79172203@N00,5645,24,1392529261,1392530761,3,10,1500
79172203@N00,5645,6,1392532208,1392532328,24,10,120
79172203@N00,5645,19,1392532891,1392533431,18,10,540
79172203@N00,5645,6,1392533836,1392533944,4,10,108
79172203@N00,5645,24,1392533944,1392534325,7,10,381
79172203@N00,5645,12,1392534325,1392534595,2,10,270
79172203@N00,5645,13,1392545837,1392546137,61,10,300
79172203@N00,5646,17,1397261490,1397261910,4,4,420
79172203@N00,5646,6,1397285227,1397285347,42,4,120
79172203@N00,5646,19,1397286890,1397287430,2,4,540
79172203@N00,5646,12,1397287439,1397287709,1,4,270
79172203@N00,5647,12,1397362966,1397363236,1,1,270
79172203@N00,5648,16,1397431400,1397431820,1,1,420
79172203@N00,5649,24,1397460296,1397461796,6,2,1500
79172203@N00,5649,16,1397477573,1397477993,12,2,420
79172203@N00,5650,19,1407979453,1407979993,2,3,540
79172203@N00,5650,14,1407982371,1407982731,3,3,360
79172203@N00,5650,24,1408007981,1408009481,2,3,1500
79172203@N00,5651,4,1412999101,1412999191,2,2,90
79172203@N00,5651,13,1413016961,1413017261,36,2,300
79172203@N00,5652,16,1413061781,1413062201,1,1,420
79172203@N00,5653,19,1413101439,1413101979,4,4,540
79172203@N00,5653,6,1413105749,1413105869,8,4,120
79172203@N00,5653,19,1413107423,1413107963,5,4,540
79172203@N00,5653,16,1413111104,1413111524,37,4,420
79172203@N00,5654,24,1416527113,1416528613,3,4,1500
79172203@N00,5654,14,1416530239,1416530599,3,4,360
79172203@N00,5654,6,1416539910,1416540030,2,4,120
79172203@N00,5654,24,1416554142,1416555642,4,4,1500
79172203@N00,5655,12,1416623734,1416624004,41,7,270
79172203@N00,5655,24,1416624689,1416624855,9,7,166
79172203@N00,5655,20,1416624855,1416625074,2,7,219
79172203@N00,5655,6,1416625074,1416625194,41,7,120
79172203@N00,5655,19,1416626134,1416626584,2,7,450
79172203@N00,5655,16,1416626584,1416627004,7,7,420
79172203@N00,5655,22,1416628071,1416629091,1,7,1020
79172203@N00,5656,25,1423979632,1423981732,22,3,2100
79172203@N00,5656,19,1423985905,1423986445,2,3,540
79172203@N00,5656,14,1423988913,1423989273,1,3,360
79172203@N00,5657,12,1424051373,1424051507,3,4,134
79172203@N00,5657,24,1424051507,1424052723,9,4,1216
79172203@N00,5657,19,1424052723,1424053263,7,4,540
79172203@N00,5657,16,1424055304,1424055724,7,4,420
79172203@N00,5658,14,1427499273,1427499633,4,16,360
79172203@N00,5658,6,1427502416,1427502536,3,16,120
79172203@N00,5658,20,1427502879,1427503105,2,16,226
79172203@N00,5658,25,1427503105,1427503391,2,16,286
79172203@N00,5658,15,1427503391,1427503751,3,16,360
79172203@N00,5658,13,1427504867,1427505167,8,16,300
79172203@N00,5658,12,1427509452,1427509588,2,16,136
79172203@N00,5658,24,1427509588,1427511053,2,16,1465
79172203@N00,5658,13,1427511053,1427511353,2,16,300
79172203@N00,5658,12,1427511691,1427511864,2,16,173
79172203@N00,5658,19,1427511864,1427512235,2,16,371
79172203@N00,5658,7,1427512235,1427512355,2,16,120
79172203@N00,5658,18,1427512450,1427512579,2,16,129
79172203@N00,5658,5,1427512579,1427512699,2,16,120
79172203@N00,5658,16,1427513088,1427513508,6,16,420
79172203@N00,5658,19,1427515477,1427516017,2,16,540
79172203@N00,5659,14,1427675415,1427675775,3,2,360
79172203@N00,5659,19,1427676521,1427677061,1,2,540
79172203@N00,5660,19,1432300283,1432300404,7,2,121
79172203@N00,5660,6,1432300404,1432300524,2,2,120
79172203@N00,5661,24,1432422196,1432423696,4,14,1500
79172203@N00,5661,22,1432431356,1432432376,19,14,1020
79172203@N00,5661,15,1432433265,1432433517,8,14,252
79172203@N00,5661,4,1432433517,1432433607,7,14,90
79172203@N00,5661,8,1432433732,1432433852,8,14,120
79172203@N00,5661,19,1432434008,1432434304,7,14,296
79172203@N00,5661,16,1432434304,1432434345,2,14,41
79172203@N00,5661,19,1432434345,1432434633,4,14,288
79172203@N00,5661,24,1432434633,1432434764,5,14,131
79172203@N00,5661,12,1432434764,1432435034,22,14,270
79172203@N00,5661,24,1432435317,1432435434,2,14,117
79172203@N00,5661,12,1432435434,1432435704,7,14,270
79172203@N00,5661,24,1432451110,1432452610,19,14,1500
79172203@N00,5661,16,1432465457,1432465877,2,14,420
79172203@N00,5662,19,1439518070,1439518610,2,2,540
79172203@N00,5662,25,1439526514,1439528614,53,2,2100
79172203@N00,5663,15,1439623080,1439623440,41,1,360
79172203@N00,5664,12,1441852697,1441852967,2,1,270
79172203@N00,5665,24,1441945216,1441946716,17,2,1500
79172203@N00,5665,13,1441948098,1441948398,5,2,300
79172203@N00,5666,19,1442020684,1442020968,11,7,284
79172203@N00,5666,14,1442020968,1442021328,11,7,360
79172203@N00,5666,19,1442021851,1442022391,2,7,540
79172203@N00,5666,16,1442024680,1442025100,13,7,420
79172203@N00,5666,24,1442025566,1442026403,14,7,837
79172203@N00,5666,12,1442026403,1442026673,7,7,270
79172203@N00,5666,13,1442052014,1442052314,28,7,300
79172203@N00,5667,15,1444507623,1444507983,2,3,360
79172203@N00,5667,14,1444508373,1444508733,3,3,360
79172203@N00,5667,5,1444509084,1444509204,2,3,120
79172203@N00,5668,19,1444548830,1444549370,3,4,540
79172203@N00,5668,16,1444559795,1444560215,4,4,420
79172203@N00,5668,12,1444563976,1444564064,3,4,88
79172203@N00,5668,24,1444564064,1444565564,5,4,1500
79172203@N00,5669,17,1451508687,1451509107,2,14,420
79172203@N00,5669,14,1451515418,1451515778,2,14,360
79172203@N00,5669,24,1451516189,1451516487,2,14,298
79172203@N00,5669,15,1451516487,1451516847,13,14,360
79172203@N00,5669,12,1451526145,1451526415,2,14,270
79172203@N00,5669,13,1451530950,1451531250,11,14,300
79172203@N00,5669,22,1451533088,1451534108,17,14,1020
79172203@N00,5669,24,1451535047,1451535761,17,14,714
79172203@N00,5669,12,1451535761,1451536031,49,14,270
79172203@N00,5669,22,1451537615,1451538635,10,14,1020
79172203@N00,5669,24,1451548061,1451549561,9,14,1500
79172203@N00,5669,25,1451556649,1451556907,2,14,258
79172203@N00,5669,22,1451556907,1451557927,2,14,1020
79172203@N00,5669,16,1451570569,1451570989,51,14,420
79172203@N00,5670,12,1451708821,1451708902,2,9,81
79172203@N00,5670,24,1451708902,1451709000,3,9,98
79172203@N00,5670,20,1451709000,1451709130,3,9,130
79172203@N00,5670,19,1451709130,1451709670,22,9,540
79172203@N00,5670,16,1451710080,1451710500,3,9,420
79172203@N00,5670,12,1451731845,1451732115,9,9,270
79172203@N00,5670,24,1451732473,1451732747,2,9,274
79172203@N00,5670,19,1451732747,1451733287,29,9,540
79172203@N00,5670,14,1451733783,1451734143,2,9,360
79172203@N00,5671,14,1455325338,1455325698,1,1,360
79172203@N00,5672,7,1455497913,1455498033,2,3,120
79172203@N00,5672,6,1455524411,1455524531,2,3,120
79172203@N00,5672,14,1455524588,1455524948,6,3,360
79172203@N00,5673,6,1459461493,1459461613,18,7,120
79172203@N00,5673,12,1459470710,1459470980,2,7,270
79172203@N00,5673,6,1459477872,1459477992,6,7,120
79172203@N00,5673,24,1459482738,1459482833,5,7,95
79172203@N00,5673,6,1459482833,1459482953,16,7,120
79172203@N00,5673,20,1459483379,1459483979,8,7,600
79172203@N00,5673,16,1459489329,1459489749,1,7,420
79172203@N00,5674,6,1459582830,1459582950,4,1,120
79172203@N00,5675,14,1465727150,1465727510,1,1,360
79209019@N00,5676,14,1356005382,1356005742,1,1,360
79244640@N06,5677,17,1311157825,1311158245,1,1,420
79254752@N08,5678,17,1327235467,1327235887,2,1,420
79336992@N07,5679,24,1391159338,1391160838,1,1,1500
79416801@N03,5680,14,1383981883,1383982243,2,2,360
79416801@N03,5680,13,1383988806,1383989106,1,2,300
79416801@N03,5681,17,1387076583,1387077003,1,1,420
7945637@N07,5682,13,1192846846,1192847146,2,10,300
7945637@N07,5682,25,1192847181,1192847241,2,10,60
7945637@N07,5682,13,1192847241,1192847367,2,10,126
7945637@N07,5682,21,1192847367,1192847528,2,10,161
7945637@N07,5682,16,1192847528,1192847948,5,10,420
7945637@N07,5682,21,1192852291,1192852980,2,10,689
7945637@N07,5682,17,1192852980,1192853400,3,10,420
7945637@N07,5682,16,1192856584,1192857004,2,10,420
7945637@N07,5682,3,1192857736,1192857826,2,10,90
7945637@N07,5682,13,1192863829,1192864129,4,10,300
7945637@N07,5683,16,1226817376,1226817796,2,2,420
7945637@N07,5683,25,1226833118,1226835218,1,2,2100
7945637@N07,5684,13,1242374916,1242375216,1,1,300
7945637@N07,5685,16,1252757306,1252757726,1,1,420
7945637@N07,5686,16,1314865957,1314866377,2,1,420
7945637@N07,5687,6,1315021822,1315021942,1,1,120
7945637@N07,5688,16,1315118397,1315118817,2,1,420
7945637@N07,5689,6,1386139904,1386140024,1,1,120
79470585@N07,5690,12,1375345664,1375345904,2,6,240
79470585@N07,5690,24,1375345904,1375346351,2,6,447
79470585@N07,5690,19,1375346351,1375346891,6,6,540
79470585@N07,5690,11,1375348769,1375349009,4,6,240
79470585@N07,5690,18,1375349967,1375350507,7,6,540
79470585@N07,5690,12,1375357209,1375357479,1,6,270
79489120@N04,5691,14,1336690260,1336690620,2,1,360
79551604@N00,5692,12,1275285568,1275285838,1,1,270
79551604@N00,5693,7,1291964644,1291964764,1,1,120
79551604@N00,5694,14,1369443969,1369444144,4,7,175
79551604@N00,5694,6,1369444144,1369444264,2,7,120
79551604@N00,5694,12,1369445187,1369445361,2,7,174
79551604@N00,5694,17,1369445361,1369445569,2,7,208
79551604@N00,5694,16,1369445569,1369445809,3,7,240
79551604@N00,5694,5,1369445809,1369445904,3,7,95
79551604@N00,5694,18,1369445904,1369446444,5,7,540
79551604@N00,5695,12,1369545270,1369545540,2,6,270
79551604@N00,5695,22,1369545942,1369545988,2,6,46
79551604@N00,5695,25,1369545988,1369547121,7,6,1133
79551604@N00,5695,12,1369547121,1369547391,3,6,270
79551604@N00,5695,6,1369565722,1369565771,2,6,49
79551604@N00,5695,19,1369565771,1369566311,2,6,540
79620942@N06,5696,12,1466342337,1466342607,1,1,270
79761301@N00,5697,12,1197652276,1197652546,2,4,270
79761301@N00,5697,3,1197654522,1197654612,2,4,90
79761301@N00,5697,13,1197656624,1197656725,2,4,101
79761301@N00,5697,24,1197656725,1197658225,2,4,1500
79761301@N00,5698,15,1201964819,1201965179,1,1,360
79761301@N00,5699,12,1207083665,1207083935,1,1,270
79761301@N00,5700,12,1212325999,1212326269,1,1,270
79761301@N00,5701,12,1293981049,1293981319,6,1,270
7977582@N06,5702,14,1374590045,1374590405,1,1,360
79781814@N00,5703,4,1316069509,1316069599,1,1,90
79781814@N00,5704,23,1352579887,1352581087,2,2,1200
79781814@N00,5704,14,1352587849,1352588209,1,2,360
79781814@N00,5705,16,1352624397,1352624817,1,1,420
79846068@N03,5706,10,1353395943,1353396093,1,1,150
7988769@N08,5707,25,1425693283,1425693504,2,3,221
7988769@N08,5707,18,1425693504,1425693797,2,3,293
7988769@N08,5707,25,1425693797,1425695897,1,3,2100
7988769@N08,5708,4,1426566578,1426566668,1,1,90
7988769@N08,5709,25,1426942609,1426944709,1,1,2100
7988769@N08,5710,25,1427064110,1427066210,1,1,2100
7988769@N08,5711,17,1431873181,1431873601,1,1,420
7988769@N08,5712,24,1458733091,1458734591,1,1,1500
7988769@N08,5713,13,1460857963,1460858263,1,1,300
79900374@N03,5714,24,1335660456,1335661956,1,1,1500
79959485@N00,5715,24,1225366100,1225367600,1,1,1500
79978100@N04,5716,7,1427580909,1427581029,10,6,120
79978100@N04,5716,18,1427589953,1427590493,2,6,540
79978100@N04,5716,19,1427592441,1427592981,2,6,540
79978100@N04,5716,14,1427594006,1427594366,2,6,360
79978100@N04,5716,25,1427610215,1427610913,5,6,698
79978100@N04,5716,20,1427610913,1427611513,2,6,600
80028591@N00,5717,24,1209523841,1209524527,2,4,686
80028591@N00,5717,11,1209524527,1209524600,2,4,73
80028591@N00,5717,7,1209524600,1209524720,2,4,120
80028591@N00,5717,12,1209525285,1209525555,1,4,270
80028591@N00,5718,10,1212140073,1212140077,3,3,4
80028591@N00,5718,5,1212140077,1212140079,2,3,2
80028591@N00,5718,18,1212140079,1212140619,1,3,540
80028591@N00,5719,18,1405858704,1405859244,1,1,540
80028591@N00,5720,17,1432126787,1432127207,1,1,420
80028591@N00,5721,17,1446518210,1446518630,1,1,420
80028591@N00,5722,19,1457211676,1457212216,1,1,540
80113172@N00,5723,24,1416723187,1416724687,2,1,1500
8021465@N08,5724,24,1274410271,1274411771,1,1,1500
8021465@N08,5725,12,1274505675,1274505945,1,1,270
80292103@N00,5726,24,1299057241,1299058741,1,1,1500
80292103@N00,5727,24,1299215945,1299217445,1,1,1500
80292103@N00,5728,17,1322959503,1322959923,2,5,420
80292103@N00,5728,16,1322961291,1322961711,2,5,420
80292103@N00,5728,6,1322970858,1322970978,9,5,120
80292103@N00,5728,19,1322971317,1322971818,2,5,501
80292103@N00,5728,1,1322971818,1322971878,1,5,60
80292103@N00,5729,17,1323661181,1323661601,3,2,420
80292103@N00,5729,7,1323665132,1323665252,1,2,120
80292103@N00,5730,3,1324703258,1324703348,1,1,90
80292103@N00,5731,4,1329450253,1329450343,3,2,90
80292103@N00,5731,12,1329457700,1329457970,1,2,270
80292103@N00,5732,8,1329638696,1329638816,1,1,120
80292103@N00,5733,23,1332038268,1332039468,2,3,1200
80292103@N00,5733,3,1332055503,1332055593,2,3,90
80292103@N00,5733,23,1332057269,1332058469,1,3,1200
80292103@N00,5734,20,1348539390,1348539990,2,2,600
80292103@N00,5734,11,1348547524,1348547764,2,2,240
80292103@N00,5735,23,1366977939,1366979139,1,1,1200
80292103@N00,5736,14,1367120296,1367120656,2,2,360
80292103@N00,5736,11,1367126945,1367127185,1,2,240
80325659@N00,5737,12,1362906431,1362906701,1,1,270
80325659@N00,5738,24,1367136685,1367138185,2,1,1500
80325659@N00,5739,18,1376194992,1376195532,1,1,540
8034015@N04,5740,14,1383872197,1383872557,2,2,360
8034015@N04,5740,24,1383874601,1383876101,1,2,1500
8034015@N04,5741,11,1383951828,1383952068,1,1,240
80371340@N00,5742,12,1350718698,1350718968,1,1,270
8039913@N05,5743,9,1275108542,1275108662,1,1,120
8039966@N05,5744,13,1375525396,1375525696,2,4,300
8039966@N05,5744,15,1375526732,1375527092,2,4,360
8039966@N05,5744,24,1375527260,1375528399,2,4,1139
8039966@N05,5744,19,1375528399,1375528939,1,4,540
8039966@N05,5745,24,1385157057,1385158557,2,2,1500
8039966@N05,5745,18,1385159227,1385159767,1,2,540
8039966@N05,5746,14,1390093292,1390093652,1,1,360
80499359@N04,5747,14,1392695597,1392695957,1,1,360
80569089@N04,5748,18,1408822223,1408822763,1,1,540
80569089@N04,5749,6,1448168544,1448168664,1,1,120
80639660@N00,5750,24,1384954469,1384955969,11,1,1500
80639660@N00,5751,24,1385044848,1385046348,17,1,1500
80687988@N00,5752,25,1217012372,1217013267,2,4,895
80687988@N00,5752,24,1217013267,1217014767,2,4,1500
80687988@N00,5752,13,1217026114,1217026414,2,4,300
80687988@N00,5752,24,1217028001,1217029501,6,4,1500
8068835@N04,5753,14,1264308931,1264309291,1,1,360
80692547@N00,5754,18,1306112567,1306113107,1,1,540
8071066@N04,5755,7,1315786337,1315786457,2,2,120
8071066@N04,5755,3,1315787597,1315787687,1,2,90
8088503@N03,5756,14,1345613271,1345613631,3,2,360
8088503@N03,5756,10,1345631755,1345631905,1,2,150
8088503@N03,5757,14,1345699820,1345700180,2,3,360
8088503@N03,5757,8,1345717142,1345717262,2,3,120
8088503@N03,5757,17,1345717648,1345718068,1,3,420
8088503@N03,5758,10,1345975900,1345976050,1,1,150
8088503@N03,5759,14,1355120171,1355120531,2,1,360
8090409@N08,5760,22,1364437989,1364439009,3,4,1020
8090409@N08,5760,15,1364439764,1364440124,3,4,360
8090409@N08,5760,25,1364441225,1364443325,2,4,2100
8090409@N08,5760,14,1364444956,1364445316,1,4,360
8090769@N06,5761,14,1360375863,1360376223,3,1,360
80907784@N00,5762,25,1230348581,1230350681,1,1,2100
80907784@N00,5763,14,1343467966,1343468326,1,1,360
80973446@N02,5764,3,1386130806,1386130896,2,3,90
80973446@N02,5764,23,1386130914,1386132114,2,3,1200
80973446@N02,5764,11,1386135099,1386135339,1,3,240
8100317@N02,5765,12,1371812335,1371812605,2,4,270
8100317@N02,5765,11,1371827098,1371827338,2,4,240
8100317@N02,5765,14,1371830294,1371830654,2,4,360
8100317@N02,5765,24,1371836904,1371838404,1,4,1500
8100317@N02,5766,14,1386927971,1386928331,1,1,360
8100317@N02,5767,18,1400670728,1400671268,2,3,540
8100317@N02,5767,24,1400673317,1400674817,2,3,1500
8100317@N02,5767,19,1400678853,1400679393,1,3,540
8100317@N02,5768,17,1407140122,1407140542,2,2,420
8100317@N02,5768,23,1407141467,1407142667,1,2,1200
8100317@N02,5769,17,1415473253,1415473673,1,1,420
8101809@N08,5770,23,1329610477,1329611677,12,3,1200
8101809@N08,5770,16,1329613223,1329613643,7,3,420
8101809@N08,5770,7,1329614891,1329615011,10,3,120
8101809@N08,5771,1,1356922369,1356922429,3,5,60
8101809@N08,5771,19,1356931318,1356931858,3,5,540
8101809@N08,5771,18,1356931948,1356932488,3,5,540
8101809@N08,5771,1,1356933158,1356933218,2,5,60
8101809@N08,5771,2,1356939217,1356939277,1,5,60
8101809@N08,5772,20,1357022220,1357022820,4,1,600
81065540@N00,5773,18,1325307812,1325308352,1,1,540
81068258@N02,5774,16,1325481241,1325481661,1,1,420
8109836@N08,5775,13,1310732369,1310732669,1,1,300
8122723@N02,5776,11,1310295136,1310295376,2,2,240
8122723@N02,5776,16,1310299276,1310299696,2,2,420
8122866@N06,5777,19,1294031778,1294032318,2,2,540
8122866@N06,5777,16,1294032417,1294032837,1,2,420
81232363@N00,5778,17,1251521647,1251521763,2,8,116
81232363@N00,5778,23,1251521763,1251521950,2,8,187
81232363@N00,5778,10,1251521950,1251522100,2,8,150
81232363@N00,5778,11,1251522701,1251522737,2,8,36
81232363@N00,5778,7,1251522737,1251522857,5,8,120
81232363@N00,5778,16,1251525991,1251526411,2,8,420
81232363@N00,5778,24,1251531287,1251532787,2,8,1500
81232363@N00,5778,18,1251532882,1251533422,1,8,540
81232363@N00,5779,23,1299286240,1299287440,4,4,1200
81232363@N00,5779,7,1299289857,1299289977,5,4,120
81232363@N00,5779,22,1299302130,1299303150,2,4,1020
81232363@N00,5779,4,1299304359,1299304449,1,4,90
81236047@N00,5780,7,1355466270,1355466390,1,1,120
81291546@N02,5781,20,1372060136,1372060736,2,5,600
81291546@N02,5781,24,1372072742,1372074242,2,5,1500
81291546@N02,5781,14,1372077745,1372078105,2,5,360
81291546@N02,5781,15,1372080715,1372080760,2,5,45
81291546@N02,5781,9,1372080760,1372080880,1,5,120
81322238@N00,5782,12,1257468887,1257468945,3,9,58
81322238@N00,5782,24,1257468945,1257469138,2,9,193
81322238@N00,5782,25,1257469138,1257470491,3,9,1353
81322238@N00,5782,24,1257470491,1257470556,5,9,65
81322238@N00,5782,20,1257470556,1257471156,2,9,600
81322238@N00,5782,16,1257472405,1257472825,6,9,420
81322238@N00,5782,18,1257473044,1257473584,2,9,540
81322238@N00,5782,7,1257473933,1257474053,3,9,120
81322238@N00,5782,18,1257476031,1257476571,15,9,540
81348276@N05,5783,11,1462171926,1462172166,2,1,240
81348276@N05,5784,25,1465180683,1465182783,1,1,2100
81465266@N00,5785,16,1358042645,1358043065,1,1,420
81549686@N02,5786,12,1341887045,1341887315,2,3,270
81549686@N02,5786,6,1341913627,1341913747,2,3,120
81549686@N02,5786,20,1341913834,1341914434,1,3,600
81549686@N02,5787,6,1342325184,1342325304,2,2,120
81549686@N02,5787,11,1342325330,1342325570,1,2,240
81553852@N00,5788,18,1364528562,1364529102,3,1,540
81704044@N06,5789,14,1350884909,1350885269,1,1,360
81704044@N06,5790,12,1354084408,1354084678,1,1,270
81704044@N06,5791,19,1362823218,1362823758,1,1,540
81704044@N06,5792,15,1364077722,1364078082,1,1,360
81704044@N06,5793,19,1364887002,1364887542,1,1,540
81704044@N06,5794,6,1365495233,1365495353,1,1,120
81704044@N06,5795,19,1367582109,1367582649,1,1,540
81704044@N06,5796,14,1370430077,1370430437,1,1,360
81704044@N06,5797,14,1371638173,1371638533,2,1,360
81704044@N06,5798,7,1371806854,1371806974,3,1,120
81704044@N06,5799,14,1375696797,1375697157,1,1,360
81704044@N06,5800,19,1378292929,1378293469,1,1,540
81704044@N06,5801,6,1379800589,1379800709,1,1,120
81704044@N06,5802,12,1380882488,1380882758,1,1,270
81704044@N06,5803,23,1384056301,1384057501,1,1,1200
81704044@N06,5804,6,1384151703,1384151823,1,1,120
81704044@N06,5805,14,1384842200,1384842560,1,1,360
81704044@N06,5806,19,1391678902,1391679442,1,1,540
81704044@N06,5807,12,1405754423,1405754693,1,1,270
8171888@N03,5808,6,1374893894,1374894014,2,3,120
8171888@N03,5808,18,1374898945,1374899485,2,3,540
8171888@N03,5808,7,1374900405,1374900525,1,3,120
81723626@N00,5809,18,1464730731,1464731271,5,2,540
81723626@N00,5809,14,1464731819,1464732179,1,2,360
8176893@N08,5810,9,1371282503,1371282623,2,2,120
8176893@N08,5810,19,1371289600,1371290140,1,2,540
8176936@N07,5811,4,1188117469,1188117559,1,1,90
81794205@N00,5812,16,1352022721,1352023141,1,1,420
81818363@N00,5813,17,1429525408,1429525828,1,1,420
81827168@N00,5814,23,1334014319,1334014366,3,2,47
81827168@N00,5814,16,1334014366,1334014786,4,2,420
81827168@N00,5815,10,1334108717,1334108867,2,6,150
81827168@N00,5815,7,1334117659,1334117779,2,6,120
81827168@N00,5815,11,1334118721,1334118961,2,6,240
81827168@N00,5815,7,1334122663,1334122783,2,6,120
81827168@N00,5815,10,1334137759,1334137864,2,6,105
81827168@N00,5815,1,1334137864,1334137924,1,6,60
81831164@N06,5816,6,1354660652,1354660772,2,1,120
8188436@N08,5817,24,1245550039,1245551539,2,7,1500
8188436@N08,5817,19,1245561834,1245561892,2,7,58
8188436@N08,5817,7,1245561892,1245562012,6,7,120
8188436@N08,5817,18,1245565322,1245565862,4,7,540
8188436@N08,5817,7,1245566859,1245566979,7,7,120
8188436@N08,5817,17,1245571617,1245572037,4,7,420
8188436@N08,5817,23,1245573064,1245574264,4,7,1200
8188436@N08,5818,3,1245720253,1245720343,3,4,90
8188436@N08,5818,17,1245729384,1245729804,2,4,420
8188436@N08,5818,24,1245737262,1245738488,5,4,1226
8188436@N08,5818,17,1245738488,1245738908,2,4,420
8188436@N08,5819,11,1245809617,1245809857,2,2,240
8188436@N08,5819,17,1245810612,1245811032,1,2,420
8188436@N08,5820,18,1359015283,1359015823,3,3,540
8188436@N08,5820,3,1359016915,1359017005,2,3,90
8188436@N08,5820,14,1359021479,1359021839,1,3,360
8188436@N08,5821,11,1359072802,1359073042,2,6,240
8188436@N08,5821,10,1359079718,1359079868,2,6,150
8188436@N08,5821,16,1359079927,1359080347,3,6,420
8188436@N08,5821,14,1359081525,1359081885,5,6,360
8188436@N08,5821,15,1359083516,1359083876,2,6,360
8188436@N08,5821,12,1359086646,1359086916,1,6,270
8188436@N08,5822,8,1359154279,1359154399,4,4,120
8188436@N08,5822,7,1359157591,1359157711,3,4,120
8188436@N08,5822,19,1359159447,1359159987,2,4,540
8188436@N08,5822,10,1359166052,1359166202,1,4,150
8192409@N06,5823,8,1331195296,1331195416,1,1,120
8192409@N06,5824,12,1332758997,1332759267,1,1,270
8192409@N06,5825,23,1337071802,1337073002,4,2,1200
8192409@N06,5825,18,1337081239,1337081779,1,2,540
8192409@N06,5826,12,1340885737,1340886007,1,1,270
8192409@N06,5827,7,1347510720,1347510840,2,1,120
8192409@N06,5828,16,1347701506,1347701926,1,1,420
8192409@N06,5829,14,1353308475,1353308835,2,2,360
8192409@N06,5829,11,1353313842,1353314082,2,2,240
8192409@N06,5830,19,1356068973,1356069237,2,3,264
8192409@N06,5830,22,1356069237,1356070257,2,3,1020
8192409@N06,5830,14,1356079051,1356079411,1,3,360
8192409@N06,5831,12,1362120136,1362120406,1,1,270
8192409@N06,5832,11,1362999383,1362999623,2,1,240
8192409@N06,5833,12,1366113754,1366114024,3,1,270
8192409@N06,5834,18,1369728501,1369729041,2,2,540
8192409@N06,5834,7,1369738085,1369738205,1,2,120
8192409@N06,5835,8,1372314801,1372314921,1,1,120
82001455@N00,5836,24,1379151360,1379152860,1,1,1500
82022162@N05,5837,6,1370127441,1370127561,2,15,120
82022162@N05,5837,19,1370127893,1370128433,4,15,540
82022162@N05,5837,11,1370130926,1370131026,4,15,100
82022162@N05,5837,16,1370131026,1370131083,2,15,57
82022162@N05,5837,3,1370131083,1370131173,6,15,90
82022162@N05,5837,18,1370132615,1370133155,2,15,540
82022162@N05,5837,16,1370134808,1370135228,4,15,420
82022162@N05,5837,20,1370139977,1370140577,3,15,600
82022162@N05,5837,19,1370146899,1370147234,4,15,335
82022162@N05,5837,3,1370147234,1370147324,2,15,90
82022162@N05,5837,11,1370147449,1370147452,2,15,3
82022162@N05,5837,16,1370147452,1370147872,4,15,420
82022162@N05,5837,24,1370158008,1370159508,5,15,1500
82022162@N05,5837,16,1370174786,1370174817,4,15,31
82022162@N05,5837,11,1370174817,1370175057,2,15,240
82064146@N00,5838,14,1345111260,1345111620,1,1,360
82297923@N00,5839,24,1369820777,1369822277,3,3,1500
82297923@N00,5839,19,1369822548,1369823088,4,3,540
82297923@N00,5839,10,1369824439,1369824589,1,3,150
82297923@N00,5840,25,1369873146,1369875246,2,4,2100
82297923@N00,5840,19,1369880897,1369881437,2,4,540
82297923@N00,5840,18,1369884450,1369884677,2,4,227
82297923@N00,5840,19,1369884677,1369885217,1,4,540
82333187@N00,5841,19,1444601372,1444601912,3,9,540
82333187@N00,5841,20,1444602724,1444602994,2,9,270
82333187@N00,5841,19,1444602994,1444603534,6,9,540
82333187@N00,5841,17,1444607595,1444607625,3,9,30
82333187@N00,5841,19,1444607625,1444608165,5,9,540
82333187@N00,5841,24,1444610842,1444611192,2,9,350
82333187@N00,5841,19,1444611192,1444611732,8,9,540
82333187@N00,5841,24,1444614214,1444614280,2,9,66
82333187@N00,5841,19,1444614280,1444614820,12,9,540
82333187@N00,5842,17,1445487099,1445487519,1,1,420
82418556@N00,5843,24,1289637257,1289637896,2,2,639
82418556@N00,5843,13,1289637896,1289638196,3,2,300
82418556@N00,5844,24,1307357994,1307359494,2,5,1500
82418556@N00,5844,16,1307360353,1307360773,3,5,420
82418556@N00,5844,15,1307360903,1307361263,2,5,360
82418556@N00,5844,24,1307367063,1307367155,2,5,92
82418556@N00,5844,15,1307367155,1307367515,1,5,360
82418556@N00,5845,7,1307873329,1307873444,2,4,115
82418556@N00,5845,18,1307873444,1307873537,2,4,93
82418556@N00,5845,16,1307873537,1307873957,2,4,420
82418556@N00,5845,18,1307875181,1307875721,3,4,540
82418556@N00,5846,7,1310461187,1310461307,2,7,120
82418556@N00,5846,18,1310461800,1310462340,4,7,540
82418556@N00,5846,22,1310465545,1310465592,2,7,47
82418556@N00,5846,25,1310465592,1310466083,3,7,491
82418556@N00,5846,22,1310466083,1310466212,2,7,129
82418556@N00,5846,24,1310466212,1310467712,2,7,1500
82418556@N00,5846,22,1310468014,1310469034,1,7,1020
82418556@N00,5847,12,1340270405,1340270406,2,15,1
82418556@N00,5847,18,1340270406,1340270454,2,15,48
82418556@N00,5847,14,1340270454,1340270814,3,15,360
82418556@N00,5847,20,1340271306,1340271906,2,15,600
82418556@N00,5847,24,1340271960,1340273187,2,15,1227
82418556@N00,5847,13,1340273187,1340273487,7,15,300
82418556@N00,5847,14,1340274125,1340274485,2,15,360
82418556@N00,5847,12,1340274985,1340275255,3,15,270
82418556@N00,5847,6,1340275659,1340275750,2,15,91
82418556@N00,5847,19,1340275750,1340275838,2,15,88
82418556@N00,5847,24,1340275838,1340277338,2,15,1500
82418556@N00,5847,13,1340277872,1340278172,3,15,300
82418556@N00,5847,14,1340278275,1340278635,3,15,360
82418556@N00,5847,18,1340278843,1340279383,3,15,540
82418556@N00,5847,16,1340279697,1340280117,3,15,420
82418556@N00,5848,12,1342092037,1342092307,2,5,270
82418556@N00,5848,13,1342092694,1342092994,4,5,300
82418556@N00,5848,14,1342093538,1342093898,6,5,360
82418556@N00,5848,19,1342097163,1342097217,2,5,54
82418556@N00,5848,6,1342097217,1342097337,1,5,120
82418556@N00,5849,12,1346532704,1346532974,2,1,270
82418556@N00,5850,12,1356688703,1356688973,1,1,270
82418556@N00,5851,12,1361070250,1361070304,2,3,54
82418556@N00,5851,18,1361070304,1361070333,2,3,29
82418556@N00,5851,11,1361070333,1361070573,1,3,240
82418556@N00,5852,14,1364708334,1364708436,2,3,102
82418556@N00,5852,12,1364708436,1364708706,2,3,270
82418556@N00,5852,14,1364710096,1364710456,1,3,360
82418556@N00,5853,15,1364801136,1364801496,1,1,360
82418556@N00,5854,13,1369412608,1369412908,2,1,300
82418556@N00,5855,18,1377895464,1377896004,3,3,540
82418556@N00,5855,13,1377896544,1377896844,2,3,300
82418556@N00,5855,14,1377908569,1377908929,1,3,360
82418556@N00,5856,18,1393925960,1393926500,1,1,540
82418556@N00,5857,25,1397024303,1397026403,2,2,2100
82418556@N00,5857,16,1397046313,1397046733,1,2,420
82418556@N00,5858,6,1400394164,1400394284,2,3,120
82418556@N00,5858,16,1400397338,1400397758,2,3,420
82418556@N00,5858,11,1400400277,1400400517,1,3,240
82418556@N00,5859,13,1400854126,1400854426,2,2,300
82418556@N00,5859,24,1400855794,1400857294,2,2,1500
82418556@N00,5860,16,1401021307,1401021727,1,1,420
82418556@N00,5861,7,1401105160,1401105280,2,2,120
82418556@N00,5861,14,1401110804,1401111164,1,2,360
82418556@N00,5862,13,1402238706,1402239006,1,1,300
82418556@N00,5863,14,1403352867,1403353227,1,1,360
82418556@N00,5864,14,1403429193,1403429553,2,2,360
82418556@N00,5864,13,1403443101,1403443401,1,2,300
82418556@N00,5865,24,1404016388,1404017888,2,5,1500
82418556@N00,5865,7,1404018247,1404018367,2,5,120
82418556@N00,5865,18,1404024142,1404024682,2,5,540
82418556@N00,5865,11,1404036334,1404036574,2,5,240
82418556@N00,5865,14,1404043867,1404044227,1,5,360
82418556@N00,5866,13,1405244661,1405244961,1,1,300
82418556@N00,5867,13,1405414929,1405415229,1,1,300
82418556@N00,5868,18,1405587413,1405587953,2,1,540
82418556@N00,5869,13,1405849201,1405849501,3,1,300
82418556@N00,5870,18,1407043327,1407043867,2,3,540
82418556@N00,5870,25,1407067917,1407070017,2,3,2100
82418556@N00,5870,13,1407073550,1407073850,1,3,300
82418556@N00,5871,14,1408875431,1408875791,1,1,360
82418556@N00,5872,18,1409256128,1409256668,1,1,540
82418556@N00,5873,14,1409342137,1409342497,2,2,360
82418556@N00,5873,16,1409342557,1409342977,1,2,420
82418556@N00,5874,18,1409428300,1409428539,2,2,239
82418556@N00,5874,14,1409428539,1409428899,1,2,360
82418556@N00,5875,11,1409467034,1409467274,2,2,240
82418556@N00,5875,25,1409472530,1409474630,1,2,2100
82418556@N00,5876,24,1410138962,1410140462,1,1,1500
82418556@N00,5877,18,1410665120,1410665660,1,1,540
82418556@N00,5878,12,1411273345,1411273615,2,4,270
82418556@N00,5878,18,1411286382,1411286922,2,4,540
82418556@N00,5878,25,1411291327,1411293427,2,4,2100
82418556@N00,5878,18,1411304825,1411305365,1,4,540
82418556@N00,5879,18,1411797781,1411798321,1,1,540
82418556@N00,5880,25,1411882694,1411884794,2,3,2100
82418556@N00,5880,7,1411891840,1411891960,2,3,120
82418556@N00,5880,13,1411905368,1411905668,1,3,300
82418556@N00,5881,11,1412407911,1412408151,2,3,240
82418556@N00,5881,18,1412408939,1412409479,2,3,540
82418556@N00,5881,14,1412413512,1412413872,1,3,360
82418556@N00,5882,18,1412473952,1412474492,3,3,540
82418556@N00,5882,19,1412490950,1412491490,2,3,540
82418556@N00,5882,13,1412496667,1412496967,1,3,300
82418556@N00,5883,12,1412666907,1412667177,1,1,270
82418556@N00,5884,16,1413196257,1413196677,2,1,420
82418556@N00,5885,13,1413706997,1413707297,1,1,300
82418556@N00,5886,25,1425817935,1425820035,1,1,2100
82418556@N00,5887,19,1436091244,1436091784,1,1,540
82418556@N00,5888,25,1451211922,1451214022,1,1,2100
82418556@N00,5889,12,1466927617,1466927887,1,1,270
82432080@N00,5890,16,1315283625,1315284045,1,1,420
82467308@N06,5891,15,1376994009,1376994369,2,2,360
82467308@N06,5891,16,1377001327,1377001747,1,2,420
8251903@N03,5892,14,1340859416,1340859776,1,1,360
8251903@N03,5893,16,1340906257,1340906677,1,1,420
82671817@N00,5894,13,1307194360,1307194660,1,1,300
82744213@N00,5895,12,1345936901,1345937171,1,1,270
82744213@N00,5896,12,1346578888,1346579158,1,1,270
82782849@N00,5897,18,1245737311,1245737851,1,1,540
82792996@N07,5898,19,1405159642,1405160182,1,1,540
82841979@N04,5899,19,1457827042,1457827582,2,1,540
82841979@N04,5900,19,1458000754,1458001294,1,1,540
82878973@N08,5901,16,1358665613,1358666033,1,1,420
82878973@N08,5902,20,1370749456,1370750056,2,2,600
82878973@N08,5902,10,1370751829,1370751979,1,2,150
82878973@N08,5903,16,1374926686,1374927106,2,1,420
82878973@N08,5904,10,1415926368,1415926518,2,5,150
82878973@N08,5904,16,1415926648,1415926897,2,5,249
82878973@N08,5904,23,1415926897,1415928097,2,5,1200
82878973@N08,5904,12,1415928676,1415928708,2,5,32
82878973@N08,5904,16,1415928708,1415929128,1,5,420
82878973@N08,5905,4,1422771398,1422771488,2,2,90
82878973@N08,5905,24,1422774035,1422775535,1,2,1500
82878973@N08,5906,12,1430276620,1430276890,1,1,270
82878973@N08,5907,6,1433404214,1433404334,1,1,120
82895447@N08,5908,14,1348827880,1348828240,1,1,360
8289999@N07,5909,13,1230002216,1230002516,1,1,300
82919069@N04,5910,25,1434154865,1434156965,2,1,2100
8298711@N08,5911,24,1223169622,1223171122,4,2,1500
8298711@N08,5911,25,1223174100,1223176200,2,2,2100
8298711@N08,5912,12,1233470195,1233470465,1,1,270
83005153@N00,5913,12,1350888435,1350888705,1,1,270
8312262@N03,5914,25,1451282450,1451283424,3,4,974
8312262@N03,5914,19,1451283424,1451283433,2,4,9
8312262@N03,5914,6,1451283433,1451283553,2,4,120
8312262@N03,5914,16,1451283559,1451283979,18,4,420
8312262@N03,5915,6,1451372401,1451372521,3,3,120
8312262@N03,5915,16,1451377410,1451377830,2,3,420
8312262@N03,5915,17,1451378811,1451379231,1,3,420
8312262@N03,5916,14,1451421628,1451421988,2,4,360
8312262@N03,5916,16,1451422094,1451422193,3,4,99
8312262@N03,5916,11,1451422193,1451422433,2,4,240
8312262@N03,5916,7,1451423259,1451423379,1,4,120
83209367@N00,5917,12,1211076000,1211076270,1,1,270
83275916@N06,5918,18,1355031837,1355032377,1,1,540
83286805@N00,5919,24,1217122207,1217123600,2,3,1393
83286805@N00,5919,5,1217123600,1217123644,2,3,44
83286805@N00,5919,1,1217123644,1217123704,1,3,60
83286805@N00,5920,16,1237690132,1237690552,2,3,420
83286805@N00,5920,6,1237690805,1237690821,2,3,16
83286805@N00,5920,20,1237690821,1237691421,2,3,600
83286805@N00,5921,19,1242387301,1242387841,1,1,540
83286805@N00,5922,19,1244429528,1244430068,1,1,540
83286805@N00,5923,13,1248577803,1248577999,2,2,196
83286805@N00,5923,22,1248577999,1248579019,1,2,1020
83286805@N00,5924,19,1253336541,1253337081,2,2,540
83286805@N00,5924,7,1253338226,1253338346,1,2,120
83286805@N00,5925,5,1277547080,1277547200,2,3,120
83286805@N00,5925,11,1277551289,1277551529,2,3,240
83286805@N00,5925,19,1277552269,1277552809,1,3,540
83286805@N00,5926,12,1281139436,1281139706,1,1,270
83286805@N00,5927,22,1286698008,1286699028,1,1,1020
83286805@N00,5928,12,1287198845,1287199115,1,1,270
83286805@N00,5929,19,1289700346,1289700886,3,3,540
83286805@N00,5929,25,1289702210,1289703152,2,3,942
83286805@N00,5929,20,1289703152,1289703752,3,3,600
83286805@N00,5930,22,1303624059,1303625079,1,1,1020
83286805@N00,5931,19,1350024673,1350025113,2,3,440
83286805@N00,5931,14,1350025113,1350025473,2,3,360
83286805@N00,5931,15,1350025635,1350025995,1,3,360
83286805@N00,5932,14,1355354163,1355354523,2,4,360
83286805@N00,5932,8,1355374871,1355374991,2,4,120
83286805@N00,5932,19,1355376505,1355377045,3,4,540
83286805@N00,5932,20,1355379046,1355379646,1,4,600
83286805@N00,5933,14,1370736060,1370736420,3,2,360
83286805@N00,5933,11,1370739994,1370740234,1,2,240
83286805@N00,5934,24,1407730984,1407732484,1,1,1500
83286805@N00,5935,14,1462701466,1462701826,1,1,360
8331103@N07,5936,25,1319337642,1319339742,1,1,2100
8331103@N07,5937,16,1319956198,1319956618,1,1,420
8331103@N07,5938,16,1322968674,1322969094,1,1,420
8331103@N07,5939,16,1339381143,1339381563,1,1,420
83434203@N00,5940,12,1195617265,1195617535,8,1,270
8347765@N06,5941,12,1385498900,1385499170,2,27,270
8347765@N06,5941,6,1385514691,1385514811,2,27,120
8347765@N06,5941,14,1385514960,1385515320,11,27,360
8347765@N06,5941,19,1385517119,1385517135,2,27,16
8347765@N06,5941,14,1385517135,1385517454,3,27,319
8347765@N06,5941,19,1385517454,1385517908,2,27,454
8347765@N06,5941,6,1385517908,1385517934,2,27,26
8347765@N06,5941,19,1385517934,1385517982,2,27,48
8347765@N06,5941,6,1385517982,1385518099,5,27,117
8347765@N06,5941,19,1385518099,1385518108,2,27,9
8347765@N06,5941,6,1385518108,1385518209,3,27,101
8347765@N06,5941,19,1385518209,1385518749,3,27,540
8347765@N06,5941,23,1385520738,1385520895,2,27,157
8347765@N06,5941,17,1385520895,1385521315,8,27,420
8347765@N06,5941,16,1385524950,1385525350,3,27,400
8347765@N06,5941,11,1385525350,1385525590,3,27,240
8347765@N06,5941,7,1385525613,1385525733,2,27,120
8347765@N06,5941,18,1385527288,1385527828,10,27,540
8347765@N06,5941,5,1385529025,1385529145,3,27,120
8347765@N06,5941,18,1385529583,1385529756,2,27,173
8347765@N06,5941,1,1385529756,1385529816,3,27,60
8347765@N06,5941,10,1385531042,1385531121,3,27,79
8347765@N06,5941,16,1385531121,1385531350,3,27,229
8347765@N06,5941,19,1385531350,1385531455,4,27,105
8347765@N06,5941,6,1385531455,1385531534,3,27,79
8347765@N06,5941,20,1385531534,1385531610,2,27,76
8347765@N06,5941,24,1385531610,1385533110,2,27,1500
8347765@N06,5942,19,1392616351,1392616891,1,1,540
8347765@N06,5943,24,1392675133,1392676633,1,1,1500
8347765@N06,5944,14,1395441274,1395441634,5,4,360
8347765@N06,5944,19,1395448983,1395449523,2,4,540
8347765@N06,5944,14,1395477278,1395477638,2,4,360
8347765@N06,5944,24,1395486092,1395487592,1,4,1500
8347765@N06,5945,14,1403923491,1403923851,2,5,360
8347765@N06,5945,19,1403930061,1403930601,2,5,540
8347765@N06,5945,25,1403932995,1403935095,2,5,2100
8347765@N06,5945,14,1403945105,1403945465,4,5,360
8347765@N06,5945,16,1403952793,1403953213,3,5,420
8347765@N06,5946,22,1404010914,1404011934,2,2,1020
8347765@N06,5946,14,1404017576,1404017936,2,2,360
8347765@N06,5947,19,1426887649,1426888189,2,9,540
8347765@N06,5947,14,1426890179,1426890539,5,9,360
8347765@N06,5947,8,1426891609,1426891729,2,9,120
8347765@N06,5947,11,1426892375,1426892615,2,9,240
8347765@N06,5947,7,1426893558,1426893678,2,9,120
8347765@N06,5947,10,1426893873,1426894023,2,9,150
8347765@N06,5947,23,1426895777,1426896815,2,9,1038
8347765@N06,5947,12,1426896815,1426897085,4,9,270
8347765@N06,5947,6,1426902689,1426902809,1,9,120
8347765@N06,5948,15,1443741597,1443741606,2,8,9
8347765@N06,5948,25,1443741606,1443741628,2,8,22
8347765@N06,5948,15,1443741628,1443741665,2,8,37
8347765@N06,5948,25,1443741665,1443742741,2,8,1076
8347765@N06,5948,15,1443742741,1443743101,4,8,360
8347765@N06,5948,25,1443743319,1443743470,2,8,151
8347765@N06,5948,15,1443743470,1443743830,2,8,360
8347765@N06,5948,14,1443758783,1443759143,5,8,360
8348059@N02,5949,13,1307668923,1307669223,1,1,300
8348059@N02,5950,12,1307748724,1307748898,2,19,174
8348059@N02,5950,20,1307748898,1307748992,2,19,94
8348059@N02,5950,12,1307748992,1307749242,2,19,250
8348059@N02,5950,23,1307749242,1307749664,3,19,422
8348059@N02,5950,16,1307749664,1307750084,7,19,420
8348059@N02,5950,18,1307751921,1307752461,6,19,540
8348059@N02,5950,16,1307754771,1307754882,3,19,111
8348059@N02,5950,19,1307754882,1307755422,8,19,540
8348059@N02,5950,8,1307758425,1307758545,2,19,120
8348059@N02,5950,25,1307758683,1307760783,32,19,2100
8348059@N02,5950,13,1307763792,1307764092,3,19,300
8348059@N02,5950,24,1307764605,1307764866,5,19,261
8348059@N02,5950,13,1307764866,1307765166,3,19,300
8348059@N02,5950,24,1307765892,1307766043,3,19,151
8348059@N02,5950,12,1307766043,1307766313,4,19,270
8348059@N02,5950,24,1307768251,1307769751,6,19,1500
8348059@N02,5950,12,1307786104,1307786374,2,19,270
8348059@N02,5950,16,1307787570,1307787990,30,19,420
8348059@N02,5950,24,1307794185,1307795685,2,19,1500
8348059@N02,5951,12,1307923340,1307923610,3,1,270
8348059@N02,5952,24,1370837301,1370837391,2,3,90
8348059@N02,5952,20,1370837391,1370837536,2,3,145
8348059@N02,5952,24,1370837536,1370839036,2,3,1500
8348059@N02,5953,19,1370912513,1370913053,2,14,540
8348059@N02,5953,12,1370919540,1370919810,3,14,270
8348059@N02,5953,24,1370920085,1370920151,2,14,66
8348059@N02,5953,25,1370920151,1370920416,4,14,265
8348059@N02,5953,4,1370920416,1370920506,6,14,90
8348059@N02,5953,8,1370921637,1370921757,2,14,120
8348059@N02,5953,14,1370921759,1370921889,2,14,130
8348059@N02,5953,19,1370921889,1370922429,3,14,540
8348059@N02,5953,16,1370925320,1370925443,2,14,123
8348059@N02,5953,11,1370925443,1370925683,2,14,240
8348059@N02,5953,23,1370926444,1370926653,5,14,209
8348059@N02,5953,17,1370926653,1370927073,3,14,420
8348059@N02,5953,24,1370930225,1370931119,31,14,894
8348059@N02,5953,12,1370931119,1370931389,1,14,270
8348059@N02,5954,14,1370988492,1370988852,7,12,360
8348059@N02,5954,8,1370991775,1370991895,4,12,120
8348059@N02,5954,14,1370995021,1370995381,2,12,360
8348059@N02,5954,19,1370997477,1370998017,8,12,540
8348059@N02,5954,16,1371003011,1371003431,3,12,420
8348059@N02,5954,24,1371003771,1371004932,5,12,1161
8348059@N02,5954,22,1371004932,1371005952,2,12,1020
8348059@N02,5954,24,1371031751,1371032614,4,12,863
8348059@N02,5954,20,1371032614,1371032736,2,12,122
8348059@N02,5954,13,1371032736,1371033036,2,12,300
8348059@N02,5954,20,1371035146,1371035746,3,12,600
8348059@N02,5954,24,1371037476,1371038976,3,12,1500
8348059@N02,5955,12,1371383199,1371383469,1,1,270
8348059@N02,5956,12,1402221519,1402221789,1,1,270
8348059@N02,5957,25,1402305606,1402307501,2,5,1895
8348059@N02,5957,19,1402307501,1402308041,2,5,540
8348059@N02,5957,8,1402308191,1402308311,3,5,120
8348059@N02,5957,19,1402308845,1402309385,16,5,540
8348059@N02,5957,24,1402310042,1402311542,1,5,1500
8348059@N02,5958,12,1402390557,1402390827,3,7,270
8348059@N02,5958,17,1402392409,1402392829,2,7,420
8348059@N02,5958,16,1402393004,1402393352,2,7,348
8348059@N02,5958,3,1402393352,1402393442,4,7,90
8348059@N02,5958,10,1402396553,1402396703,2,7,150
8348059@N02,5958,8,1402397252,1402397372,2,7,120
8348059@N02,5958,24,1402400734,1402402234,1,7,1500
8348059@N02,5959,19,1402439210,1402439750,2,16,540
8348059@N02,5959,14,1402439941,1402440301,5,16,360
8348059@N02,5959,19,1402440850,1402441390,2,16,540
8348059@N02,5959,8,1402446899,1402447019,2,16,120
8348059@N02,5959,4,1402447919,1402447988,2,16,69
8348059@N02,5959,8,1402447988,1402448108,2,16,120
8348059@N02,5959,4,1402448621,1402448711,2,16,90
8348059@N02,5959,6,1402449314,1402449434,2,16,120
8348059@N02,5959,19,1402450753,1402451293,4,16,540
8348059@N02,5959,25,1402453978,1402454082,2,16,104
8348059@N02,5959,24,1402454082,1402455423,4,16,1341
8348059@N02,5959,25,1402455423,1402457523,9,16,2100
8348059@N02,5959,24,1402458733,1402460233,4,16,1500
8348059@N02,5959,8,1402477772,1402477892,2,16,120
8348059@N02,5959,20,1402482526,1402483126,3,16,600
8348059@N02,5959,24,1402487424,1402488924,2,16,1500
8348059@N02,5960,12,1402822516,1402822786,3,1,270
83612144@N00,5961,25,1241328040,1241330140,2,2,2100
83612144@N00,5961,19,1241332711,1241333251,1,2,540
83612144@N00,5962,12,1258874726,1258874996,2,1,270
83612144@N00,5963,2,1266214657,1266214688,2,2,31
83612144@N00,5963,4,1266214688,1266214778,2,2,90
83612144@N00,5964,10,1277461468,1277461618,2,1,150
83612144@N00,5965,6,1278482687,1278482807,2,2,120
83612144@N00,5965,23,1278483492,1278484692,1,2,1200
83612144@N00,5966,7,1282293534,1282293654,1,1,120
83612144@N00,5967,6,1309134033,1309134153,3,3,120
83612144@N00,5967,4,1309134323,1309134413,2,3,90
83612144@N00,5967,13,1309135808,1309136108,1,3,300
83612144@N00,5968,8,1309846983,1309847103,1,1,120
83612144@N00,5969,6,1311294268,1311294388,2,1,120
83612144@N00,5970,10,1315000067,1315000217,2,2,150
83612144@N00,5970,17,1315000992,1315001412,1,2,420
83612144@N00,5971,1,1318382280,1318382340,2,3,60
83612144@N00,5971,6,1318384110,1318384230,2,3,120
83612144@N00,5971,4,1318386726,1318386816,1,3,90
83612144@N00,5972,12,1337740693,1337740963,1,1,270
83612144@N00,5973,13,1338965750,1338966050,2,2,300
83612144@N00,5973,25,1338966161,1338968261,1,2,2100
83612144@N00,5974,4,1339918561,1339918651,3,3,90
83612144@N00,5974,6,1339919416,1339919536,8,3,120
83612144@N00,5974,19,1339925998,1339926538,1,3,540
83612144@N00,5975,14,1340485950,1340486310,2,9,360
83612144@N00,5975,22,1340489412,1340490432,2,9,1020
83612144@N00,5975,14,1340495959,1340496319,3,9,360
83612144@N00,5975,8,1340498114,1340498234,2,9,120
83612144@N00,5975,10,1340499939,1340500089,2,9,150
83612144@N00,5975,23,1340508976,1340510176,6,9,1200
83612144@N00,5975,12,1340531417,1340531687,2,9,270
83612144@N00,5975,19,1340535510,1340536050,2,9,540
83612144@N00,5975,23,1340541666,1340542866,3,9,1200
83612144@N00,5976,18,1365897764,1365898304,3,2,540
83612144@N00,5976,23,1365900152,1365901352,1,2,1200
83612144@N00,5977,2,1368345345,1368345359,2,2,14
83612144@N00,5977,8,1368345359,1368345479,1,2,120
83612144@N00,5978,18,1371337035,1371337575,1,1,540
83612144@N00,5979,23,1382058406,1382059606,1,1,1200
83612144@N00,5980,14,1383286270,1383286630,1,1,360
83612144@N00,5981,8,1394329086,1394329206,1,1,120
83612144@N00,5982,1,1396742663,1396742723,1,1,60
83612144@N00,5983,18,1414879658,1414880198,6,2,540
83612144@N00,5983,7,1414882473,1414882593,1,2,120
83612144@N00,5984,23,1418516027,1418517227,2,3,1200
83612144@N00,5984,10,1418518145,1418518295,2,3,150
83612144@N00,5984,17,1418519148,1418519568,2,3,420
8372025@N06,5985,16,1287210428,1287210848,1,1,420
83722986@N00,5986,14,1436936096,1436936456,3,3,360
83722986@N00,5986,3,1436942368,1436942458,2,3,90
83722986@N00,5986,18,1436942597,1436943137,1,3,540
83789207@N00,5987,11,1250932103,1250932343,1,1,240
83789207@N00,5988,7,1268361276,1268361396,1,1,120
83789207@N00,5989,13,1275034814,1275035114,3,2,300
83789207@N00,5989,24,1275037585,1275039085,6,2,1500
8379824@N07,5990,18,1324974554,1324974976,2,4,422
8379824@N07,5990,1,1324974976,1324975036,2,4,60
8379824@N07,5990,16,1324975573,1324975597,2,4,24
8379824@N07,5990,10,1324975597,1324975747,1,4,150
8386875@N06,5991,12,1210318743,1210319013,1,1,270
8386875@N06,5992,12,1215674865,1215675135,1,1,270
8386875@N06,5993,12,1215761494,1215761764,1,1,270
8386875@N06,5994,12,1221176925,1221177195,1,1,270
8386875@N06,5995,20,1221809540,1221810140,4,1,600
8386875@N06,5996,4,1222657997,1222658087,1,1,90
8386875@N06,5997,12,1224731993,1224732263,2,1,270
8386875@N06,5998,16,1263089012,1263089432,2,1,420
8386875@N06,5999,19,1276241407,1276241947,1,1,540
8386875@N06,6000,19,1276328409,1276328949,1,1,540
8386875@N06,6001,19,1276501098,1276501638,2,1,540
8386875@N06,6002,16,1310191126,1310191546,34,1,420
8386875@N06,6003,16,1310364047,1310364467,3,1,420
83871406@N00,6004,6,1387663484,1387663604,2,24,120
83871406@N00,6004,19,1387664403,1387664650,2,24,247
83871406@N00,6004,14,1387664650,1387665010,4,24,360
83871406@N00,6004,8,1387665534,1387665654,2,24,120
83871406@N00,6004,6,1387665748,1387665868,2,24,120
83871406@N00,6004,16,1387670931,1387671351,2,24,420
83871406@N00,6004,23,1387674287,1387674454,2,24,167
83871406@N00,6004,16,1387674454,1387674874,2,24,420
83871406@N00,6004,13,1387676785,1387677085,2,24,300
83871406@N00,6004,8,1387678526,1387678646,5,24,120
83871406@N00,6004,25,1387679912,1387682012,2,24,2100
83871406@N00,6004,22,1387683585,1387684522,2,24,937
83871406@N00,6004,13,1387684522,1387684822,2,24,300
83871406@N00,6004,25,1387685106,1387685397,3,24,291
83871406@N00,6004,22,1387685397,1387686053,3,24,656
83871406@N00,6004,7,1387686053,1387686173,3,24,120
83871406@N00,6004,17,1387687450,1387687870,2,24,420
83871406@N00,6004,11,1387688145,1387688385,2,24,240
83871406@N00,6004,14,1387688793,1387689153,2,24,360
83871406@N00,6004,7,1387689604,1387689724,5,24,120
83871406@N00,6004,16,1387690276,1387690570,2,24,294
83871406@N00,6004,19,1387690570,1387691110,2,24,540
83871406@N00,6004,20,1387695014,1387695614,3,24,600
83871406@N00,6004,7,1387703989,1387704109,3,24,120
83959210@N02,6005,25,1430722418,1430723103,2,2,685
83959210@N02,6005,13,1430723103,1430723403,1,2,300
83959210@N02,6006,18,1430784588,1430785128,1,1,540
8398190@N02,6007,19,1270931503,1270932043,1,1,540
8398190@N02,6008,17,1271054848,1271055268,1,1,420
8398190@N02,6009,17,1271343722,1271344142,1,1,420
8398190@N02,6010,16,1274114427,1274114847,2,1,420
8398190@N02,6011,13,1287914650,1287914950,2,1,300
8398190@N02,6012,13,1289025152,1289025452,2,1,300
84057763@N00,6013,18,1368424830,1368425370,2,2,540
84057763@N00,6013,11,1368430465,1368430705,1,2,240
84057763@N00,6014,9,1368508493,1368508613,1,1,120
84057763@N00,6015,16,1370358268,1370358688,1,1,420
84057763@N00,6016,24,1382416748,1382418248,2,2,1500
84057763@N00,6016,19,1382427657,1382428197,1,2,540
84057763@N00,6017,16,1385981532,1385981952,1,1,420
84077048@N00,6018,5,1287012992,1287013112,1,1,120
84108876@N00,6019,10,1211797634,1211797750,3,4,116
84108876@N00,6019,7,1211797750,1211797870,2,4,120
84108876@N00,6019,19,1211798046,1211798586,5,4,540
84108876@N00,6019,7,1211799168,1211799288,2,4,120
84108876@N00,6020,7,1212668762,1212668882,7,4,120
84108876@N00,6020,11,1212669232,1212669252,2,4,20
84108876@N00,6020,7,1212669252,1212669372,2,4,120
84108876@N00,6020,11,1212669436,1212669676,1,4,240
8423871@N06,6021,11,1397973210,1397973450,1,1,240
84263554@N00,6022,11,1327880535,1327880775,1,1,240
84269601@N00,6023,12,1200941355,1200941625,3,1,270
84269601@N00,6024,12,1206981275,1206981545,1,1,270
84269601@N00,6025,12,1226597610,1226597880,1,1,270
84269601@N00,6026,12,1252999942,1253000212,1,1,270
84322304@N07,6027,14,1421238345,1421238572,2,2,227
84322304@N07,6027,19,1421238572,1421239112,1,2,540
84345058@N00,6028,19,1404019373,1404019749,2,2,376
84345058@N00,6028,18,1404019749,1404020289,1,2,540
84363535@N00,6029,8,1292975846,1292975966,1,1,120
8437808@N05,6030,16,1231569928,1231570348,1,1,420
84393770@N00,6031,6,1202783408,1202783528,4,2,120
84393770@N00,6031,11,1202787973,1202788213,3,2,240
84496208@N00,6032,24,1191035339,1191036839,34,1,1500
84496208@N00,6033,24,1193933989,1193935489,69,1,1500
84496208@N00,6034,24,1199757308,1199758808,2,1,1500
84496208@N00,6035,24,1201925557,1201927057,2,1,1500
84538865@N00,6036,15,1321263621,1321263981,1,1,360
8455331@N08,6037,25,1465543670,1465545770,1,1,2100
84601962@N00,6038,8,1388201335,1388201455,2,4,120
84601962@N00,6038,4,1388202315,1388202405,2,4,90
84601962@N00,6038,14,1388204702,1388205062,2,4,360
84601962@N00,6038,13,1388210413,1388210713,1,4,300
84601962@N00,6039,24,1401511490,1401512877,2,3,1387
84601962@N00,6039,25,1401512877,1401512885,2,3,8
84601962@N00,6039,22,1401512885,1401513905,1,3,1020
84601962@N00,6040,2,1420161207,1420161267,2,4,60
84601962@N00,6040,24,1420170171,1420171671,2,4,1500
84601962@N00,6040,1,1420176616,1420176676,2,4,60
84601962@N00,6040,17,1420195399,1420195819,2,4,420
84601962@N00,6041,14,1420230470,1420230830,3,7,360
84601962@N00,6041,18,1420231001,1420231167,2,7,166
84601962@N00,6041,14,1420231167,1420231527,3,7,360
84601962@N00,6041,25,1420253308,1420253330,2,7,22
84601962@N00,6041,2,1420253330,1420253390,2,7,60
84601962@N00,6041,25,1420253687,1420255787,4,7,2100
84601962@N00,6041,10,1420278111,1420278261,3,7,150
84601962@N00,6042,7,1452817169,1452817289,6,12,120
84601962@N00,6042,19,1452818612,1452818894,2,12,282
84601962@N00,6042,14,1452818894,1452819254,2,12,360
84601962@N00,6042,24,1452819721,1452821221,9,12,1500
84601962@N00,6042,13,1452825747,1452826047,2,12,300
84601962@N00,6042,24,1452829039,1452830539,2,12,1500
84601962@N00,6042,6,1452833072,1452833192,4,12,120
84601962@N00,6042,8,1452836145,1452836265,2,12,120
84601962@N00,6042,4,1452838496,1452838586,7,12,90
84601962@N00,6042,8,1452839001,1452839121,2,12,120
84601962@N00,6042,19,1452839448,1452839454,2,12,6
84601962@N00,6042,6,1452839454,1452839574,11,12,120
84601962@N00,6043,12,1452922928,1452923198,2,2,270
84601962@N00,6043,10,1452938837,1452938987,3,2,150
84601962@N00,6044,17,1452979412,1452979832,2,1,420
84651114@N00,6045,16,1455233371,1455233791,2,2,420
84651114@N00,6045,11,1455249575,1455249815,1,2,240
84652765@N00,6046,8,1418944009,1418944129,3,5,120
84652765@N00,6046,14,1418945648,1418946008,8,5,360
84652765@N00,6046,6,1418950684,1418950804,2,5,120
84652765@N00,6046,4,1418952842,1418952932,4,5,90
84652765@N00,6046,7,1418967178,1418967298,12,5,120
84658322@N02,6047,24,1449803941,1449805441,2,4,1500
84658322@N02,6047,25,1449811267,1449813367,2,4,2100
84658322@N02,6047,19,1449817767,1449818307,2,4,540
84658322@N02,6047,16,1449828705,1449829125,1,4,420
84738389@N00,6048,12,1375985243,1375985513,1,1,270
84765974@N00,6049,18,1404522595,1404523135,1,1,540
84765974@N00,6050,25,1404637238,1404639338,1,1,2100
84807303@N08,6051,11,1369671670,1369671910,1,1,240
8497732@N03,6052,22,1349597649,1349598669,1,1,1020
8502118@N08,6053,20,1375918215,1375918295,2,45,80
8502118@N08,6053,24,1375918295,1375919795,3,45,1500
8502118@N08,6053,17,1375920000,1375920420,2,45,420
8502118@N08,6053,23,1375921550,1375921781,3,45,231
8502118@N08,6053,16,1375921781,1375922201,29,45,420
8502118@N08,6053,23,1375922801,1375922880,2,45,79
8502118@N08,6053,17,1375922880,1375922956,4,45,76
8502118@N08,6053,12,1375922956,1375923226,4,45,270
8502118@N08,6053,23,1375924794,1375924915,3,45,121
8502118@N08,6053,10,1375924915,1375925065,2,45,150
8502118@N08,6053,5,1375925793,1375925913,2,45,120
8502118@N08,6053,18,1375925916,1375926157,4,45,241
8502118@N08,6053,7,1375926157,1375926277,3,45,120
8502118@N08,6053,19,1375927247,1375927530,7,45,283
8502118@N08,6053,14,1375927530,1375927590,3,45,60
8502118@N08,6053,8,1375927590,1375927710,5,45,120
8502118@N08,6053,19,1375927839,1375928018,5,45,179
8502118@N08,6053,6,1375928018,1375928138,2,45,120
8502118@N08,6053,24,1375929648,1375931148,2,45,1500
8502118@N08,6053,25,1375935924,1375938024,55,45,2100
8502118@N08,6053,14,1375939077,1375939437,7,45,360
8502118@N08,6053,6,1375942630,1375942750,5,45,120
8502118@N08,6053,20,1375942844,1375943332,2,45,488
8502118@N08,6053,15,1375943332,1375943425,2,45,93
8502118@N08,6053,4,1375943425,1375943470,3,45,45
8502118@N08,6053,8,1375943470,1375943537,3,45,67
8502118@N08,6053,6,1375943537,1375943657,4,45,120
8502118@N08,6053,19,1375944454,1375944994,5,45,540
8502118@N08,6053,16,1375945047,1375945467,64,45,420
8502118@N08,6053,17,1375947745,1375948140,7,45,395
8502118@N08,6053,12,1375948140,1375948410,2,45,270
8502118@N08,6053,25,1375949998,1375951682,16,45,1684
8502118@N08,6053,16,1375951682,1375952102,39,45,420
8502118@N08,6053,6,1375953958,1375954023,2,45,65
8502118@N08,6053,19,1375954023,1375954121,2,45,98
8502118@N08,6053,14,1375954121,1375954481,2,45,360
8502118@N08,6053,11,1375954973,1375955213,13,45,240
8502118@N08,6053,19,1375955622,1375956066,3,45,444
8502118@N08,6053,22,1375956066,1375956109,2,45,43
8502118@N08,6053,13,1375956109,1375956409,33,45,300
8502118@N08,6053,22,1375957623,1375958194,2,45,571
8502118@N08,6053,10,1375958194,1375958344,70,45,150
8502118@N08,6053,16,1375961404,1375961824,3,45,420
8502118@N08,6053,17,1375961841,1375962090,2,45,249
8502118@N08,6053,12,1375962090,1375962360,1,45,270
85093364@N00,6054,12,1362303733,1362304003,1,1,270
85218196@N00,6055,24,1197912935,1197914435,12,1,1500
85218196@N00,6056,14,1362036174,1362036534,1,1,360
85218196@N00,6057,14,1362120666,1362121026,1,1,360
85218196@N00,6058,1,1362288776,1362288836,1,1,60
85218196@N00,6059,18,1362451600,1362452140,2,2,540
85218196@N00,6059,11,1362458546,1362458786,1,2,240
85369290@N03,6060,16,1353129369,1353129789,1,1,420
8551571@N02,6061,14,1353847131,1353847491,1,1,360
85583013@N04,6062,24,1386629883,1386631383,6,5,1500
85583013@N04,6062,18,1386636611,1386637151,2,5,540
85583013@N04,6062,11,1386640603,1386640843,2,5,240
85583013@N04,6062,8,1386648085,1386648205,2,5,120
85583013@N04,6062,7,1386664680,1386664800,1,5,120
85583013@N04,6063,19,1386715161,1386715701,2,4,540
85583013@N04,6063,6,1386720935,1386721055,2,4,120
85583013@N04,6063,18,1386737553,1386738093,2,4,540
85583013@N04,6063,12,1386752803,1386753073,1,4,270
85585249@N08,6064,16,1340979130,1340979550,1,1,420
8565602@N03,6065,25,1194241773,1194241974,4,8,201
8565602@N03,6065,24,1194241974,1194242265,4,8,291
8565602@N03,6065,6,1194242265,1194242385,4,8,120
8565602@N03,6065,20,1194242641,1194243241,2,8,600
8565602@N03,6065,12,1194247376,1194247646,2,8,270
8565602@N03,6065,2,1194247913,1194247973,2,8,60
8565602@N03,6065,24,1194249148,1194249763,2,8,615
8565602@N03,6065,13,1194249763,1194250063,1,8,300
85665489@N00,6066,22,1364438013,1364439033,3,3,1020
85665489@N00,6066,15,1364440740,1364441100,2,3,360
85665489@N00,6066,24,1364445462,1364446962,1,3,1500
85669531@N00,6067,14,1343356143,1343356503,3,2,360
85669531@N00,6067,18,1343367202,1343367742,1,2,540
8570639@N04,6068,18,1383468644,1383469184,1,1,540
85793123@N00,6069,16,1330237549,1330237969,2,1,420
85793123@N00,6070,22,1330483015,1330484035,1,1,1020
85864407@N08,6071,8,1347063148,1347063268,5,33,120
85864407@N08,6071,14,1347070502,1347070862,2,33,360
85864407@N08,6071,2,1347072189,1347072249,2,33,60
85864407@N08,6071,4,1347073966,1347074004,2,33,38
85864407@N08,6071,8,1347074004,1347074124,2,33,120
85864407@N08,6071,19,1347075467,1347076007,3,33,540
85864407@N08,6071,18,1347080406,1347080946,2,33,540
85864407@N08,6071,23,1347084283,1347084482,2,33,199
85864407@N08,6071,17,1347084482,1347084902,2,33,420
85864407@N08,6071,12,1347088113,1347088213,2,33,100
85864407@N08,6071,17,1347088213,1347088291,2,33,78
85864407@N08,6071,23,1347088291,1347089491,2,33,1200
85864407@N08,6071,1,1347089691,1347089751,2,33,60
85864407@N08,6071,24,1347090063,1347091563,3,33,1500
85864407@N08,6071,13,1347102166,1347102210,2,33,44
85864407@N08,6071,22,1347102210,1347102612,5,33,402
85864407@N08,6071,13,1347102612,1347102912,4,33,300
85864407@N08,6071,14,1347104520,1347104880,2,33,360
85864407@N08,6071,8,1347105424,1347105544,2,33,120
85864407@N08,6071,9,1347106601,1347106721,4,33,120
85864407@N08,6071,14,1347110314,1347110674,3,33,360
85864407@N08,6071,6,1347111042,1347111162,2,33,120
85864407@N08,6071,7,1347112603,1347112723,2,33,120
85864407@N08,6071,11,1347112755,1347112995,2,33,240
85864407@N08,6071,10,1347115571,1347115721,2,33,150
85864407@N08,6071,17,1347116000,1347116417,2,33,417
85864407@N08,6071,9,1347116417,1347116537,2,33,120
85864407@N08,6071,14,1347116688,1347116840,2,33,152
85864407@N08,6071,19,1347116840,1347116945,2,33,105
85864407@N08,6071,14,1347116945,1347117084,2,33,139
85864407@N08,6071,19,1347117084,1347117483,2,33,399
85864407@N08,6071,20,1347117483,1347117940,2,33,457
85864407@N08,6071,24,1347117940,1347119440,1,33,1500
85864407@N08,6072,13,1347272564,1347272864,4,1,300
85864407@N08,6073,24,1349262086,1349263586,1,1,1500
85864407@N08,6074,15,1349689453,1349689813,2,1,360
85864407@N08,6075,11,1354149380,1354149620,1,1,240
85864407@N08,6076,20,1379663207,1379663807,1,1,600
85882671@N00,6077,22,1257567561,1257568581,2,7,1020
85882671@N00,6077,3,1257571269,1257571359,7,7,90
85882671@N00,6077,18,1257572005,1257572545,6,7,540
85882671@N00,6077,7,1257573509,1257573598,3,7,89
85882671@N00,6077,16,1257573598,1257573778,2,7,180
85882671@N00,6077,19,1257573778,1257574318,12,7,540
85882671@N00,6077,24,1257575404,1257576904,1,7,1500
85882671@N00,6078,12,1257668329,1257668563,2,10,234
85882671@N00,6078,24,1257668563,1257668804,4,10,241
85882671@N00,6078,22,1257668804,1257668962,3,10,158
85882671@N00,6078,25,1257668962,1257669101,2,10,139
85882671@N00,6078,15,1257669101,1257669461,3,10,360
85882671@N00,6078,25,1257670641,1257671672,2,10,1031
85882671@N00,6078,19,1257671672,1257672189,2,10,517
85882671@N00,6078,16,1257672189,1257672609,3,10,420
85882671@N00,6078,18,1257674135,1257674675,2,10,540
85882671@N00,6078,19,1257676270,1257676810,1,10,540
85977134@N00,6079,15,1322270405,1322270765,2,2,360
85977134@N00,6079,12,1322276994,1322277264,1,2,270
85977134@N00,6080,12,1346550346,1346550616,1,1,270
8601478@N02,6081,16,1311589794,1311590214,1,1,420
86063712@N00,6082,17,1274050920,1274051340,2,1,420
86063712@N00,6083,25,1274158932,1274161032,1,1,2100
86063712@N00,6084,24,1274244194,1274245694,1,1,1500
8610602@N06,6085,18,1361327408,1361327948,1,1,540
86111910@N03,6086,12,1309972637,1309972907,1,1,270
86192884@N00,6087,25,1413784986,1413787086,2,2,2100
86192884@N00,6087,14,1413795829,1413796189,1,2,360
86249551@N00,6088,19,1371891990,1371892530,1,1,540
86278660@N00,6089,22,1351308994,1351309859,4,6,865
86278660@N00,6089,13,1351309859,1351310159,5,6,300
86278660@N00,6089,6,1351310619,1351310739,2,6,120
86278660@N00,6089,16,1351311628,1351312048,8,6,420
86278660@N00,6089,12,1351317708,1351317978,2,6,270
86278660@N00,6089,22,1351325998,1351327018,4,6,1020
86278660@N00,6090,12,1351392732,1351393002,1,1,270
8628154@N06,6091,11,1398379576,1398379816,2,2,240
8628154@N06,6091,18,1398379839,1398380379,1,2,540
86333958@N00,6092,19,1287815344,1287815884,26,3,540
86333958@N00,6092,7,1287817171,1287817291,6,3,120
86333958@N00,6092,18,1287820155,1287820695,1,3,540
86333958@N00,6093,13,1288515637,1288515937,4,2,300
86333958@N00,6093,16,1288522289,1288522709,25,2,420
86333958@N00,6094,7,1292656658,1292656778,2,1,120
86333958@N00,6095,20,1299908284,1299908884,4,3,600
86333958@N00,6095,5,1299912403,1299912523,2,3,120
86333958@N00,6095,18,1299912997,1299913537,1,3,540
86333958@N00,6096,7,1306060214,1306060334,3,16,120
86333958@N00,6096,5,1306062173,1306062179,2,16,6
86333958@N00,6096,7,1306062179,1306062184,2,16,5
86333958@N00,6096,11,1306062184,1306062261,4,16,77
86333958@N00,6096,5,1306062261,1306062273,2,16,12
86333958@N00,6096,7,1306062273,1306062368,2,16,95
86333958@N00,6096,5,1306062368,1306062378,2,16,10
86333958@N00,6096,7,1306062378,1306062498,3,16,120
86333958@N00,6096,5,1306062702,1306062719,3,16,17
86333958@N00,6096,7,1306062719,1306062839,11,16,120
86333958@N00,6096,5,1306063019,1306063037,3,16,18
86333958@N00,6096,7,1306063037,1306063157,4,16,120
86333958@N00,6096,5,1306063167,1306063176,2,16,9
86333958@N00,6096,7,1306063176,1306063242,6,16,66
86333958@N00,6096,5,1306063242,1306063247,2,16,5
86333958@N00,6096,7,1306063247,1306063367,33,16,120
86333958@N00,6097,6,1337707114,1337707234,1,1,120
86333958@N00,6098,18,1338219280,1338219820,4,5,540
86333958@N00,6098,7,1338222084,1338222204,2,5,120
86333958@N00,6098,15,1338222879,1338223136,2,5,257
86333958@N00,6098,22,1338223136,1338223199,2,5,63
86333958@N00,6098,13,1338223199,1338223499,4,5,300
86333958@N00,6099,19,1338728571,1338729111,1,1,540
86333958@N00,6100,15,1339176054,1339176414,1,1,360
86333958@N00,6101,12,1339389313,1339389583,2,4,270
86333958@N00,6101,14,1339391478,1339391838,4,4,360
86333958@N00,6101,19,1339401897,1339402437,2,4,540
86333958@N00,6101,12,1339415936,1339416206,1,4,270
86333958@N00,6102,24,1340031728,1340033228,1,1,1500
86333958@N00,6103,12,1345297010,1345297280,3,1,270
86333958@N00,6104,14,1346594059,1346594365,2,2,306
86333958@N00,6104,19,1346594365,1346594905,2,2,540
86333958@N00,6105,16,1349544762,1349545182,1,1,420
86355905@N04,6106,7,1374141572,1374141692,4,2,120
86355905@N04,6106,13,1374146404,1374146704,1,2,300
86387045@N04,6107,17,1351849315,1351849735,1,1,420
8639610@N04,6108,7,1254913019,1254913139,1,1,120
86456516@N00,6109,15,1234332501,1234332861,5,3,360
86456516@N00,6109,6,1234334010,1234334130,6,3,120
86456516@N00,6109,18,1234338421,1234338961,11,3,540
86459399@N00,6110,23,1286692344,1286693544,4,3,1200
86459399@N00,6110,10,1286701485,1286701635,2,3,150
86459399@N00,6110,20,1286702512,1286703112,2,3,600
86459399@N00,6111,15,1339324329,1339324689,2,2,360
86459399@N00,6111,3,1339326108,1339326198,1,2,90
86459399@N00,6112,3,1339495413,1339495503,1,1,90
86459399@N00,6113,15,1339577266,1339577626,2,2,360
86459399@N00,6113,23,1339587819,1339589019,1,2,1200
86476099@N00,6114,1,1396599209,1396599269,2,3,60
86476099@N00,6114,19,1396599985,1396600073,2,3,88
86476099@N00,6114,14,1396600073,1396600433,3,3,360
86476099@N00,6115,3,1396639858,1396639948,1,1,90
86476099@N00,6116,3,1396692820,1396692910,1,1,90
86604283@N00,6117,15,1225606289,1225606649,3,8,360
86604283@N00,6117,24,1225607135,1225607925,2,8,790
86604283@N00,6117,16,1225607925,1225608345,4,8,420
86604283@N00,6117,6,1225609475,1225609595,3,8,120
86604283@N00,6117,19,1225610906,1225611446,14,8,540
86604283@N00,6117,11,1225612869,1225613109,2,8,240
86604283@N00,6117,19,1225613351,1225613891,2,8,540
86604283@N00,6117,12,1225629953,1225630223,1,8,270
8661008@N04,6118,19,1341974668,1341975208,2,11,540
8661008@N04,6118,21,1341977086,1341977940,2,11,854
8661008@N04,6118,20,1341977940,1341978049,6,11,109
8661008@N04,6118,21,1341978049,1341978949,9,11,900
8661008@N04,6118,20,1341979041,1341979641,11,11,600
8661008@N04,6118,21,1341979897,1341980797,6,11,900
8661008@N04,6118,20,1341980956,1341981556,3,11,600
8661008@N04,6118,16,1341982816,1341983236,5,11,420
8661008@N04,6118,10,1341986635,1341986785,3,11,150
8661008@N04,6118,16,1341987499,1341987919,3,11,420
8661008@N04,6118,18,1341988256,1341988796,7,11,540
86672131@N04,6119,16,1433466624,1433466843,3,12,219
86672131@N04,6119,7,1433466843,1433466963,2,12,120
86672131@N04,6119,24,1433486943,1433487164,2,12,221
86672131@N04,6119,13,1433487164,1433487464,2,12,300
86672131@N04,6119,25,1433487669,1433489168,2,12,1499
86672131@N04,6119,1,1433489168,1433489228,3,12,60
86672131@N04,6119,21,1433491245,1433491272,2,12,27
86672131@N04,6119,4,1433491272,1433491362,2,12,90
86672131@N04,6119,6,1433494086,1433494201,2,12,115
86672131@N04,6119,14,1433494201,1433494561,2,12,360
86672131@N04,6119,11,1433497319,1433497559,4,12,240
86672131@N04,6119,5,1433497927,1433498047,3,12,120
86684445@N00,6120,7,1263885243,1263885363,1,1,120
86684445@N00,6121,20,1263952815,1263953239,2,2,424
86684445@N00,6121,11,1263953239,1263953479,1,2,240
8673897@N08,6122,19,1359777177,1359777717,2,1,540
8674970@N04,6123,25,1276917276,1276919376,3,1,2100
8674970@N04,6124,25,1410509339,1410511439,1,1,2100
8674970@N04,6125,16,1422170917,1422171337,3,1,420
8674970@N04,6126,13,1441267730,1441268030,9,1,300
86851412@N03,6127,16,1356959034,1356959454,1,1,420
8685536@N06,6128,19,1306213031,1306213571,1,1,540
86908163@N08,6129,16,1369712765,1369713185,2,4,420
86908163@N08,6129,17,1369715534,1369715954,2,4,420
86908163@N08,6129,14,1369726114,1369726474,2,4,360
86908163@N08,6129,25,1369734463,1369736563,1,4,2100
86931317@N00,6130,11,1344039952,1344040192,2,1,240
87059281@N00,6131,13,1214912622,1214912922,1,1,300
87067940@N00,6132,16,1200984073,1200984493,1,1,420
87067940@N00,6133,12,1204415513,1204415783,1,1,270
87112387@N00,6134,19,1402535810,1402536350,29,1,540
87174243@N04,6135,17,1369909020,1369909440,1,1,420
87258154@N00,6136,14,1360446812,1360447172,1,1,360
8733897@N04,6137,12,1198546681,1198546951,3,13,270
8733897@N04,6137,18,1198546998,1198547538,4,13,540
8733897@N04,6137,5,1198547590,1198547710,3,13,120
8733897@N04,6137,16,1198548657,1198549077,4,13,420
8733897@N04,6137,19,1198550001,1198550541,4,13,540
8733897@N04,6137,25,1198557493,1198557753,2,13,260
8733897@N04,6137,15,1198557753,1198557911,2,13,158
8733897@N04,6137,25,1198557911,1198560011,3,13,2100
8733897@N04,6137,13,1198560774,1198561074,2,13,300
8733897@N04,6137,25,1198562768,1198564868,3,13,2100
8733897@N04,6137,24,1198567008,1198568096,7,13,1088
8733897@N04,6137,16,1198568096,1198568516,10,13,420
8733897@N04,6137,12,1198574866,1198575136,18,13,270
87358743@N00,6138,14,1379915679,1379915978,2,2,299
87358743@N00,6138,24,1379915978,1379917478,1,2,1500
8738888@N04,6139,16,1324869807,1324870227,1,1,420
8741255@N04,6140,12,1257645015,1257645285,1,1,270
87447493@N00,6141,14,1423263280,1423263640,2,5,360
87447493@N00,6141,19,1423263901,1423264441,2,5,540
87447493@N00,6141,6,1423265096,1423265216,2,5,120
87447493@N00,6141,24,1423277912,1423279412,5,5,1500
87447493@N00,6141,11,1423289355,1423289595,4,5,240
87473564@N00,6142,11,1437031075,1437031315,1,1,240
87478675@N00,6143,12,1362179663,1362179933,2,2,270
87478675@N00,6143,22,1362180410,1362181430,1,2,1020
87505833@N08,6144,18,1407373833,1407374373,5,2,540
87505833@N08,6144,16,1407413881,1407414301,1,2,420
87527417@N04,6145,24,1393073783,1393075283,1,1,1500
87625715@N00,6146,12,1294722104,1294722374,2,1,270
87639371@N00,6147,25,1306109146,1306111246,1,1,2100
87639371@N00,6148,16,1306143841,1306144261,4,2,420
87639371@N00,6148,23,1306145690,1306146890,1,2,1200
87657273@N00,6149,12,1270528667,1270528937,4,4,270
87657273@N00,6149,17,1270532439,1270532859,7,4,420
87657273@N00,6149,23,1270536332,1270537532,3,4,1200
87657273@N00,6149,15,1270542401,1270542761,1,4,360
8771559@N05,6150,2,1290512687,1290512747,1,1,60
8771559@N05,6151,7,1337323383,1337323503,1,1,120
87789817@N00,6152,14,1378968944,1378969304,1,1,360
8786056@N07,6153,24,1394540420,1394540781,3,2,361
8786056@N07,6153,14,1394540781,1394541141,1,2,360
87889801@N00,6154,16,1198564564,1198564984,4,2,420
87889801@N00,6154,11,1198569999,1198570239,1,2,240
87889801@N00,6155,16,1199955842,1199956262,1,1,420
87895332@N08,6156,11,1373791807,1373792047,1,1,240
87895332@N08,6157,3,1375931371,1375931461,1,1,90
87895332@N08,6158,3,1387670112,1387670202,1,1,90
87942779@N00,6159,25,1201920403,1201922503,6,1,2100
87942779@N00,6160,5,1285410265,1285410385,2,2,120
87942779@N00,6160,1,1285411003,1285411063,2,2,60
87974483@N02,6161,19,1283645656,1283646196,206,1,540
87974483@N02,6162,19,1283727604,1283728144,1,1,540
8802344@N03,6163,18,1307090365,1307090905,2,2,540
8802344@N03,6163,6,1307093522,1307093642,1,2,120
8805434@N06,6164,10,1191718642,1191718792,1,1,150
8805434@N06,6165,10,1209867641,1209867791,1,1,150
88073012@N00,6166,16,1296205352,1296205772,1,1,420
88073012@N00,6167,24,1305453612,1305455112,1,1,1500
88074728@N02,6168,22,1350025068,1350026088,2,2,1020
88074728@N02,6168,16,1350035906,1350036326,1,2,420
88158593@N00,6169,12,1302515101,1302515371,2,2,270
88158593@N00,6169,24,1302516332,1302517832,2,2,1500
88242284@N03,6170,8,1364431892,1364432012,3,6,120
88242284@N03,6170,6,1364432079,1364432199,10,6,120
88242284@N03,6170,16,1364438323,1364438743,4,6,420
88242284@N03,6170,11,1364440700,1364440940,3,6,240
88242284@N03,6170,18,1364442387,1364442927,2,6,540
88242284@N03,6170,10,1364462598,1364462748,2,6,150
88242284@N03,6171,19,1396052540,1396053080,3,6,540
88242284@N03,6171,17,1396054293,1396054713,2,6,420
88242284@N03,6171,4,1396074772,1396074862,4,6,90
88242284@N03,6171,9,1396075593,1396075713,3,6,120
88242284@N03,6171,7,1396078725,1396078845,3,6,120
88242284@N03,6171,16,1396079221,1396079641,1,6,420
88346269@N07,6172,16,1432723528,1432723948,2,3,420
88346269@N07,6172,10,1432724800,1432724813,2,3,13
88346269@N07,6172,16,1432724813,1432725233,12,3,420
88411530@N00,6173,24,1204500163,1204500175,3,3,12
88411530@N00,6173,7,1204500175,1204500201,5,3,26
88411530@N00,6173,10,1204500201,1204500351,2,3,150
88494442@N00,6174,7,1410762245,1410762365,1,1,120
88511321@N00,6175,24,1377922746,1377924246,3,1,1500
88537228@N00,6176,22,1300839400,1300840002,3,9,602
88537228@N00,6176,4,1300840002,1300840009,3,9,7
88537228@N00,6176,21,1300840009,1300840909,3,9,900
88537228@N00,6176,4,1300841569,1300841578,2,9,9
88537228@N00,6176,21,1300841578,1300842478,3,9,900
88537228@N00,6176,20,1300846040,1300846640,4,9,600
88537228@N00,6176,19,1300847412,1300847952,2,9,540
88537228@N00,6176,7,1300848371,1300848491,3,9,120
88537228@N00,6176,18,1300850327,1300850867,2,9,540
8865630@N06,6177,11,1307855794,1307856034,1,1,240
88664007@N06,6178,12,1355823027,1355823297,1,1,270
88719648@N00,6179,24,1393989145,1393990215,2,5,1070
88719648@N00,6179,6,1393990215,1393990335,5,5,120
88719648@N00,6179,4,1394009995,1394010085,5,5,90
88719648@N00,6179,10,1394018037,1394018187,3,5,150
88719648@N00,6179,16,1394026198,1394026618,7,5,420
88719648@N00,6180,17,1394092025,1394092445,4,2,420
88719648@N00,6180,18,1394102628,1394103168,2,2,540
88773568@N00,6181,18,1210477767,1210478307,2,2,540
88773568@N00,6181,24,1210487454,1210488954,1,2,1500
88787599@N00,6182,12,1244878683,1244878953,5,1,270
88787599@N00,6183,25,1252740781,1252742881,4,2,2100
88787599@N00,6183,6,1252744071,1252744191,1,2,120
88805731@N00,6184,25,1258868311,1258870411,1,1,2100
88850477@N03,6185,12,1374394302,1374394572,2,1,270
88850477@N03,6186,24,1374444601,1374445945,2,13,1344
88850477@N03,6186,6,1374445945,1374446065,2,13,120
88850477@N03,6186,12,1374451425,1374451695,3,13,270
88850477@N03,6186,8,1374455534,1374455654,2,13,120
88850477@N03,6186,14,1374456938,1374457231,3,13,293
88850477@N03,6186,19,1374457231,1374457508,2,13,277
88850477@N03,6186,16,1374457508,1374457928,3,13,420
88850477@N03,6186,1,1374464721,1374464781,2,13,60
88850477@N03,6186,5,1374465896,1374466016,3,13,120
88850477@N03,6186,10,1374468072,1374468222,2,13,150
88850477@N03,6186,16,1374469209,1374469629,2,13,420
88850477@N03,6186,18,1374471116,1374471656,2,13,540
88850477@N03,6186,24,1374480704,1374482204,3,13,1500
8885561@N03,6187,10,1272179621,1272179771,1,1,150
88859913@N00,6188,25,1366679170,1366681270,2,4,2100
88859913@N00,6188,16,1366683401,1366683821,2,4,420
88859913@N00,6188,7,1366685090,1366685210,3,4,120
88859913@N00,6188,17,1366693213,1366693633,1,4,420
88891730@N00,6189,7,1313025448,1313025568,2,2,120
88891730@N00,6189,18,1313029210,1313029750,1,2,540
88937309@N00,6190,17,1434938363,1434938783,1,1,420
88955553@N00,6191,19,1412633446,1412633986,2,16,540
88955553@N00,6191,18,1412634823,1412635363,2,16,540
88955553@N00,6191,7,1412635505,1412635580,3,16,75
88955553@N00,6191,18,1412635580,1412636120,4,16,540
88955553@N00,6191,10,1412637228,1412637378,2,16,150
88955553@N00,6191,7,1412639047,1412639167,4,16,120
88955553@N00,6191,24,1412642226,1412643726,4,16,1500
88955553@N00,6191,25,1412645293,1412647393,2,16,2100
88955553@N00,6191,6,1412651173,1412651293,2,16,120
88955553@N00,6191,8,1412653995,1412654115,3,16,120
88955553@N00,6191,6,1412655835,1412655955,3,16,120
88955553@N00,6191,4,1412656755,1412656808,2,16,53
88955553@N00,6191,2,1412656808,1412656868,2,16,60
88955553@N00,6191,14,1412659320,1412659680,5,16,360
88955553@N00,6191,22,1412660616,1412661636,2,16,1020
88955553@N00,6191,24,1412662988,1412664488,1,16,1500
88984016@N00,6192,17,1313596500,1313596920,2,6,420
88984016@N00,6192,6,1313598058,1313598178,2,6,120
88984016@N00,6192,24,1313607581,1313609081,2,6,1500
88984016@N00,6192,22,1313609831,1313610851,2,6,1020
88984016@N00,6192,13,1313622562,1313622862,2,6,300
88984016@N00,6192,12,1313644046,1313644316,1,6,270
89046328@N00,6193,9,1315726051,1315726171,1,1,120
89046328@N00,6194,5,1315790459,1315790579,1,1,120
8906043@N08,6195,24,1339989724,1339991224,113,1,1500
89072528@N00,6196,24,1393755753,1393757253,2,2,1500
89072528@N00,6196,13,1393767410,1393767710,1,2,300
89091370@N03,6197,15,1371721903,1371722263,2,5,360
89091370@N03,6197,19,1371732383,1371732497,6,5,114
89091370@N03,6197,14,1371732497,1371732857,7,5,360
89091370@N03,6197,19,1371734299,1371734566,6,5,267
89091370@N03,6197,16,1371734566,1371734986,3,5,420
89091370@N03,6198,13,1375766970,1375767270,2,5,300
89091370@N03,6198,5,1375780579,1375780604,4,5,25
89091370@N03,6198,1,1375780604,1375780664,8,5,60
89091370@N03,6198,15,1375785413,1375785773,3,5,360
89091370@N03,6198,16,1375792998,1375793418,10,5,420
89181533@N00,6199,25,1349837288,1349837603,2,7,315
89181533@N00,6199,24,1349837603,1349838149,2,7,546
89181533@N00,6199,12,1349838149,1349838419,2,7,270
89181533@N00,6199,19,1349841275,1349841815,3,7,540
89181533@N00,6199,24,1349842313,1349842698,4,7,385
89181533@N00,6199,22,1349842698,1349842949,2,7,251
89181533@N00,6199,25,1349842949,1349845049,1,7,2100
89181533@N00,6200,8,1350016197,1350016317,1,1,120
8922611@N07,6201,14,1380323189,1380323549,2,4,360
8922611@N07,6201,18,1380328912,1380329452,2,4,540
8922611@N07,6201,11,1380331558,1380331798,2,4,240
8922611@N07,6201,7,1380341592,1380341712,1,4,120
89286166@N02,6202,13,1340066446,1340066746,1,1,300
89286166@N02,6203,8,1345903343,1345903463,1,1,120
89286166@N02,6204,13,1346274643,1346274943,6,1,300
89286166@N02,6205,13,1348175383,1348175683,2,1,300
89286166@N02,6206,25,1350401614,1350403714,2,1,2100
89286166@N02,6207,18,1351206712,1351207252,4,1,540
89286166@N02,6208,25,1364067079,1364069179,4,1,2100
8928810@N02,6209,22,1286072102,1286073122,1,1,1020
8928810@N02,6210,18,1286354411,1286354951,1,1,540
89388079@N07,6211,16,1332995367,1332995787,2,1,420
89414761@N00,6212,6,1306121395,1306121515,1,1,120
89414761@N00,6213,10,1306375898,1306376048,2,3,150
89414761@N00,6213,18,1306376584,1306377124,2,3,540
89414761@N00,6213,16,1306381200,1306381620,1,3,420
8949620@N08,6214,23,1220968806,1220970006,2,1,1200
8949620@N08,6215,23,1221055215,1221056415,2,1,1200
8949620@N08,6216,3,1303526130,1303526220,4,1,90
89616268@N00,6217,25,1219551921,1219554021,1,1,2100
89804841@N00,6218,16,1296879012,1296879432,2,5,420
89804841@N00,6218,7,1296883076,1296883196,2,5,120
89804841@N00,6218,17,1296888186,1296888606,2,5,420
89804841@N00,6218,25,1296894735,1296895579,2,5,844
89804841@N00,6218,4,1296895579,1296895669,2,5,90
89804841@N00,6219,16,1296980791,1296981149,2,2,358
89804841@N00,6219,4,1296981149,1296981239,3,2,90
89804841@N00,6220,12,1297047615,1297047885,1,1,270
89847248@N03,6221,16,1405944920,1405945340,1,1,420
89857381@N04,6222,24,1378030443,1378031943,1,1,1500
89857381@N04,6223,13,1379417397,1379417697,1,1,300
89857381@N04,6224,12,1379582388,1379582658,2,1,270
89857381@N04,6225,3,1383382724,1383382814,3,3,90
89857381@N04,6225,6,1383385611,1383385731,2,3,120
89857381@N04,6225,13,1383389011,1383389311,1,3,300
89857381@N04,6226,24,1384725516,1384727016,1,1,1500
89857381@N04,6227,24,1385595765,1385596043,2,7,278
89857381@N04,6227,22,1385596043,1385596198,2,7,155
89857381@N04,6227,13,1385596198,1385596498,3,7,300
89857381@N04,6227,25,1385596667,1385598767,2,7,2100
89857381@N04,6227,14,1385599154,1385599514,3,7,360
89857381@N04,6227,24,1385616170,1385616277,2,7,107
89857381@N04,6227,14,1385616277,1385616637,1,7,360
89857381@N04,6228,24,1386221647,1386223147,1,1,1500
89857381@N04,6229,13,1386926329,1386926629,2,1,300
89857381@N04,6230,18,1389861303,1389861843,1,1,540
89857381@N04,6231,24,1389951393,1389952188,3,2,795
89857381@N04,6231,22,1389952188,1389953208,2,2,1020
89857381@N04,6232,24,1392588658,1392590158,1,1,1500
89857381@N04,6233,25,1406193641,1406195741,2,2,2100
89857381@N04,6233,11,1406202729,1406202969,1,2,240
89857381@N04,6234,14,1406799932,1406800292,1,1,360
89857381@N04,6235,14,1409917068,1409917428,1,1,360
89857381@N04,6236,18,1411979979,1411980519,1,1,540
89873814@N00,6237,25,1206086172,1206088272,1,1,2100
8996989@N02,6238,12,1215577570,1215577650,2,3,80
8996989@N02,6238,15,1215577650,1215577832,2,3,182
8996989@N02,6238,24,1215577832,1215579332,1,3,1500
90008840@N00,6239,16,1351079811,1351080231,1,1,420
90008840@N00,6240,19,1449389545,1449389719,3,2,174
90008840@N00,6240,17,1449389719,1449390139,2,2,420
90008840@N00,6241,19,1449706329,1449706869,2,2,540
90008840@N00,6241,17,1449708483,1449708903,1,2,420
90015401@N00,6242,16,1367619425,1367619845,1,1,420
90214320@N00,6243,24,1200031165,1200032665,2,1,1500
90258264@N00,6244,25,1344644925,1344647025,1,1,2100
90258264@N00,6245,24,1344678324,1344679824,1,1,1500
90269418@N00,6246,21,1382736116,1382737016,37,1,900
90269418@N00,6247,21,1382870476,1382871376,1,1,900
90272587@N00,6248,17,1440223102,1440223522,2,1,420
90289831@N00,6249,12,1241143519,1241143660,3,19,141
90289831@N00,6249,17,1241143660,1241144080,6,19,420
90289831@N00,6249,23,1241144359,1241145559,16,19,1200
90289831@N00,6249,19,1241148638,1241149122,4,19,484
90289831@N00,6249,11,1241149122,1241149362,4,19,240
90289831@N00,6249,18,1241149468,1241150008,6,19,540
90289831@N00,6249,5,1241150331,1241150451,3,19,120
90289831@N00,6249,1,1241150528,1241150588,16,19,60
90289831@N00,6249,18,1241152588,1241153128,2,19,540
90289831@N00,6249,6,1241153454,1241153574,28,19,120
90289831@N00,6249,8,1241155643,1241155763,4,19,120
90289831@N00,6249,4,1241156302,1241156392,4,19,90
90289831@N00,6249,20,1241157030,1241157630,2,19,600
90289831@N00,6249,24,1241162081,1241162514,2,19,433
90289831@N00,6249,12,1241162514,1241162773,2,19,259
90289831@N00,6249,24,1241162773,1241164273,49,19,1500
90289831@N00,6249,25,1241165367,1241166893,3,19,1526
90289831@N00,6249,13,1241166893,1241167193,4,19,300
90289831@N00,6249,24,1241167290,1241168790,1,19,1500
90289831@N00,6250,12,1241314475,1241314745,1,1,270
90328132@N00,6251,14,1347409702,1347410062,4,16,360
90328132@N00,6251,13,1347414934,1347415234,2,16,300
90328132@N00,6251,24,1347415583,1347417083,2,16,1500
90328132@N00,6251,12,1347417104,1347417374,2,16,270
90328132@N00,6251,17,1347418459,1347418640,2,16,181
90328132@N00,6251,7,1347418640,1347418760,2,16,120
90328132@N00,6251,16,1347419264,1347419384,2,16,120
90328132@N00,6251,18,1347419384,1347419591,2,16,207
90328132@N00,6251,3,1347419591,1347419681,2,16,90
90328132@N00,6251,18,1347421522,1347422062,2,16,540
90328132@N00,6251,11,1347423035,1347423144,2,16,109
90328132@N00,6251,7,1347423144,1347423264,2,16,120
90328132@N00,6251,14,1347423345,1347423705,4,16,360
90328132@N00,6251,6,1347424787,1347424907,2,16,120
90328132@N00,6251,15,1347426903,1347427263,3,16,360
90328132@N00,6251,12,1347434961,1347435231,1,16,270
90328132@N00,6252,24,1391225727,1391226373,2,4,646
90328132@N00,6252,15,1391226373,1391226733,2,4,360
90328132@N00,6252,14,1391228227,1391228587,2,4,360
90328132@N00,6252,6,1391245373,1391245493,1,4,120
90328132@N00,6253,7,1404193331,1404193406,2,3,75
90328132@N00,6253,25,1404193406,1404195506,3,3,2100
90328132@N00,6253,14,1404218490,1404218850,1,3,360
90328132@N00,6254,25,1411795940,1411798040,3,3,2100
90328132@N00,6254,14,1411799295,1411799655,4,3,360
90328132@N00,6254,17,1411804190,1411804610,1,3,420
90328132@N00,6255,14,1419223431,1419223541,2,4,110
90328132@N00,6255,24,1419223541,1419223592,2,4,51
90328132@N00,6255,14,1419223592,1419223952,2,4,360
90328132@N00,6255,18,1419224536,1419225076,1,4,540
9036889@N06,6256,16,1385682837,1385683257,4,4,420
9036889@N06,6256,7,1385708697,1385708817,3,4,120
9036889@N06,6256,16,1385716166,1385716586,8,4,420
9036889@N06,6256,14,1385721527,1385721887,2,4,360
9036889@N06,6257,12,1447365397,1447365667,8,10,270
9036889@N06,6257,16,1447365851,1447366182,2,10,331
9036889@N06,6257,7,1447366182,1447366302,5,10,120
9036889@N06,6257,14,1447369324,1447369684,5,10,360
9036889@N06,6257,19,1447370955,1447371495,3,10,540
9036889@N06,6257,14,1447371591,1447371951,2,10,360
9036889@N06,6257,8,1447372016,1447372136,2,10,120
9036889@N06,6257,24,1447373085,1447374585,6,10,1500
9036889@N06,6257,15,1447375458,1447375818,2,10,360
9036889@N06,6257,24,1447377789,1447379289,8,10,1500
90372544@N03,6258,14,1387273224,1387273584,1,1,360
90405256@N00,6259,13,1227423367,1227423667,1,1,300
90414083@N04,6260,7,1376299601,1376299721,1,1,120
90427028@N00,6261,22,1201752179,1201753199,3,3,1020
90427028@N00,6261,20,1201754620,1201755220,2,3,600
90427028@N00,6261,16,1201757392,1201757812,1,3,420
90428271@N00,6262,14,1375348159,1375348519,2,1,360
9053157@N02,6263,5,1194141959,1194142079,3,2,120
9053157@N02,6263,3,1194142376,1194142466,1,2,90
9053157@N02,6264,16,1196415784,1196416204,1,1,420
9053157@N02,6265,19,1201911100,1201911640,1,1,540
9053157@N02,6266,5,1204331470,1204331590,1,1,120
9053157@N02,6267,12,1205532570,1205532840,2,13,270
9053157@N02,6267,7,1205535343,1205535463,2,13,120
9053157@N02,6267,18,1205535645,1205535910,3,13,265
9053157@N02,6267,5,1205535910,1205536030,4,13,120
9053157@N02,6267,1,1205536332,1205536392,2,13,60
9053157@N02,6267,18,1205536954,1205537494,2,13,540
9053157@N02,6267,12,1205540033,1205540303,2,13,270
9053157@N02,6267,20,1205558722,1205559322,6,13,600
9053157@N02,6267,25,1205562718,1205564818,2,13,2100
9053157@N02,6267,12,1205566568,1205566838,2,13,270
9053157@N02,6267,7,1205567178,1205567298,2,13,120
9053157@N02,6267,6,1205567817,1205567937,2,13,120
9053157@N02,6267,13,1205569917,1205570217,1,13,300
9053157@N02,6268,7,1209020557,1209020677,2,1,120
9053157@N02,6269,11,1211702887,1211703127,1,1,240
9053157@N02,6270,16,1212905621,1212906041,2,1,420
9053157@N02,6271,13,1215144294,1215144594,1,1,300
9053157@N02,6272,13,1215176760,1215177060,5,1,300
9053157@N02,6273,13,1262241404,1262241704,2,2,300
9053157@N02,6273,25,1262243831,1262245931,1,2,2100
9053157@N02,6274,7,1271583027,1271583147,2,2,120
9053157@N02,6274,16,1271589617,1271590037,5,2,420
9053157@N02,6275,16,1275991796,1275992216,5,4,420
9053157@N02,6275,7,1275997592,1275997712,6,4,120
9053157@N02,6275,18,1276000565,1276001105,2,4,540
9053157@N02,6275,12,1276004590,1276004860,1,4,270
9053157@N02,6276,18,1288247603,1288247637,2,5,34
9053157@N02,6276,5,1288247637,1288247757,2,5,120
9053157@N02,6276,12,1288249364,1288249634,3,5,270
9053157@N02,6276,13,1288258180,1288258480,3,5,300
9053157@N02,6276,12,1288260285,1288260555,1,5,270
9053157@N02,6277,18,1308725719,1308726259,2,2,540
9053157@N02,6277,11,1308730048,1308730288,1,2,240
9053157@N02,6278,16,1325332858,1325333278,1,1,420
9053157@N02,6279,11,1328792638,1328792878,1,1,240
9053157@N02,6280,18,1328832370,1328832910,1,1,540
9053157@N02,6281,6,1335838271,1335838391,1,1,120
9053157@N02,6282,9,1355233023,1355233143,1,1,120
9053157@N02,6283,22,1359355168,1359356188,1,1,1020
9053157@N02,6284,8,1360461100,1360461220,1,1,120
9053908@N06,6285,13,1219383001,1219383301,1,1,300
90603938@N07,6286,12,1435555736,1435556006,5,1,270
90621377@N00,6287,19,1273743452,1273743992,1,1,540
90621377@N00,6288,16,1273829905,1273830325,2,2,420
90621377@N00,6288,4,1273834623,1273834713,1,2,90
90621377@N00,6289,16,1273910558,1273910978,1,1,420
9063165@N03,6290,17,1217674524,1217674944,1,1,420
90755543@N00,6291,19,1371773973,1371774513,1,1,540
90755543@N00,6292,24,1371805655,1371807155,2,5,1500
90755543@N00,6292,16,1371816373,1371816793,3,5,420
90755543@N00,6292,10,1371817022,1371817110,3,5,88
90755543@N00,6292,5,1371817110,1371817230,2,5,120
90755543@N00,6292,16,1371817283,1371817703,1,5,420
90761069@N08,6293,25,1385961302,1385963402,2,3,2100
90761069@N08,6293,8,1385965497,1385965617,2,3,120
90761069@N08,6293,24,1385974838,1385976338,1,3,1500
90761069@N08,6294,18,1386034009,1386034549,2,2,540
90761069@N08,6294,19,1386034637,1386035177,1,2,540
9078049@N05,6295,6,1340517959,1340518079,2,4,120
9078049@N05,6295,14,1340521978,1340522338,5,4,360
9078049@N05,6295,17,1340522541,1340522729,2,4,188
9078049@N05,6295,14,1340522729,1340523089,1,4,360
9078049@N05,6296,11,1343383275,1343383515,2,2,240
9078049@N05,6296,22,1343386123,1343387143,1,2,1020
90783480@N02,6297,15,1334217897,1334218257,1,1,360
90783480@N02,6298,15,1336118454,1336118814,2,1,360
90798029@N02,6299,24,1430742898,1430743302,3,21,404
90798029@N02,6299,6,1430743302,1430743422,3,21,120
90798029@N02,6299,8,1430743492,1430743574,2,21,82
90798029@N02,6299,9,1430743574,1430743694,2,21,120
90798029@N02,6299,2,1430743726,1430743786,2,21,60
90798029@N02,6299,8,1430743924,1430744044,2,21,120
90798029@N02,6299,14,1430744060,1430744132,2,21,72
90798029@N02,6299,19,1430744132,1430744151,2,21,19
90798029@N02,6299,14,1430744151,1430744400,2,21,249
90798029@N02,6299,19,1430744400,1430744465,2,21,65
90798029@N02,6299,14,1430744465,1430744825,3,21,360
90798029@N02,6299,8,1430744932,1430744962,2,21,30
90798029@N02,6299,19,1430744962,1430745502,7,21,540
90798029@N02,6299,16,1430745635,1430745813,2,21,178
90798029@N02,6299,11,1430745813,1430746053,3,21,240
90798029@N02,6299,18,1430746191,1430746731,3,21,540
90798029@N02,6299,8,1430747115,1430747235,3,21,120
90798029@N02,6299,15,1430747450,1430747573,2,21,123
90798029@N02,6299,25,1430747573,1430747678,2,21,105
90798029@N02,6299,22,1430747678,1430747826,2,21,148
90798029@N02,6299,24,1430747826,1430749326,1,21,1500
90810256@N08,6300,25,1362138808,1362138847,2,2,39
90810256@N08,6300,15,1362138847,1362139207,2,2,360
90966710@N07,6301,18,1402801689,1402802229,1,1,540
91033481@N00,6302,12,1319944200,1319944470,2,2,270
91033481@N00,6302,19,1319951415,1319951955,1,2,540
91033481@N00,6303,16,1320138359,1320138779,1,1,420
91087719@N08,6304,11,1362053880,1362054120,3,1,240
91087719@N08,6305,11,1375864477,1375864717,1,1,240
91110081@N03,6306,7,1375695807,1375695927,1,1,120
91110081@N03,6307,24,1375741201,1375742701,2,1,1500
91132276@N07,6308,11,1290762327,1290762567,1,1,240
91132276@N07,6309,15,1294792937,1294793297,1,1,360
91132276@N07,6310,16,1363001474,1363001894,4,1,420
91132276@N07,6311,15,1436137081,1436137441,1,1,360
91132404@N00,6312,12,1331967652,1331967922,1,1,270
91158338@N00,6313,16,1205567805,1205568225,1,1,420
91196251@N05,6314,10,1359961138,1359961288,2,3,150
91196251@N05,6314,1,1359962031,1359962091,2,3,60
91196251@N05,6314,14,1359966359,1359966719,1,3,360
91196251@N05,6315,14,1360121754,1360122114,2,1,360
91218125@N07,6316,17,1421495537,1421495957,1,1,420
91218125@N07,6317,17,1427285723,1427286143,1,1,420
91218125@N07,6318,25,1433247338,1433249438,1,1,2100
91218125@N07,6319,17,1441501101,1441501521,1,1,420
91219241@N05,6320,9,1368308446,1368308566,3,1,120
91219241@N05,6321,24,1368347077,1368348577,1,1,1500
91219241@N05,6322,9,1391305735,1391305855,7,1,120
91219241@N05,6323,9,1394349302,1394349422,3,1,120
91219241@N05,6324,9,1394403394,1394403514,8,1,120
91219241@N05,6325,9,1399759503,1399759623,3,1,120
91219241@N05,6326,9,1399800167,1399800287,2,1,120
91219241@N05,6327,9,1399848688,1399848808,7,1,120
91227166@N06,6328,7,1381319308,1381319428,1,1,120
91227166@N06,6329,19,1381404219,1381404759,1,1,540
91227767@N04,6330,3,1391044616,1391044706,7,1,90
91230196@N02,6331,12,1355988524,1355988794,2,2,270
91230196@N02,6331,10,1355991749,1355991899,1,2,150
91230196@N02,6332,22,1365467140,1365467802,2,2,662
91230196@N02,6332,15,1365467802,1365468162,1,2,360
9123577@N06,6333,7,1258873161,1258873281,5,1,120
91262748@N08,6334,7,1391471700,1391471820,2,2,120
91262748@N08,6334,18,1391497529,1391498069,6,2,540
91262748@N08,6335,10,1391588302,1391588452,2,2,150
91262748@N08,6335,18,1391593537,1391594077,1,2,540
91262748@N08,6336,18,1391741289,1391741829,1,1,540
91269855@N06,6337,24,1385170174,1385171674,1,1,1500
91281831@N05,6338,12,1360553161,1360553431,1,1,270
91313049@N04,6339,18,1380863197,1380863737,1,1,540
91358779@N02,6340,14,1357584323,1357584683,2,1,360
91379604@N00,6341,19,1431656799,1431657339,2,1,540
91379604@N00,6342,12,1431751112,1431751382,4,2,270
91379604@N00,6342,19,1431760072,1431760612,1,2,540
91398043@N03,6343,11,1351838976,1351839216,2,1,240
91398168@N02,6344,19,1372683163,1372683703,1,1,540
91405970@N00,6345,24,1295257864,1295259364,1,1,1500
91405970@N00,6346,23,1310957838,1310959038,1,1,1200
91405970@N00,6347,3,1322372366,1322372456,1,1,90
91407458@N00,6348,24,1343296333,1343297833,1,1,1500
91407458@N00,6349,14,1346060006,1346060366,1,1,360
9146295@N07,6350,12,1367414662,1367414932,1,1,270
91466877@N00,6351,18,1388238654,1388239194,1,1,540
91466877@N00,6352,7,1389006895,1389007015,1,1,120
91488079@N06,6353,25,1248919544,1248921644,1,1,2100
91509272@N00,6354,17,1289435535,1289435955,1,1,420
91535662@N06,6355,19,1361145667,1361146207,3,4,540
91535662@N06,6355,25,1361150003,1361152103,3,4,2100
91535662@N06,6355,16,1361154551,1361154971,2,4,420
91535662@N06,6355,12,1361160780,1361161050,4,4,270
91535662@N06,6356,19,1361350501,1361350611,2,3,110
91535662@N06,6356,14,1361350611,1361350971,4,3,360
91535662@N06,6356,16,1361354636,1361355056,8,3,420
91550294@N08,6357,16,1406279196,1406279388,3,9,192
91550294@N08,6357,11,1406279388,1406279628,4,9,240
91550294@N08,6357,18,1406279736,1406280094,6,9,358
91550294@N08,6357,10,1406280094,1406280244,3,9,150
91550294@N08,6357,16,1406280324,1406280528,5,9,204
91550294@N08,6357,23,1406280528,1406281040,3,9,512
91550294@N08,6357,12,1406281040,1406281310,2,9,270
91550294@N08,6357,19,1406285340,1406285880,3,9,540
91550294@N08,6357,17,1406287036,1406287456,1,9,420
9155758@N04,6358,11,1293064611,1293064851,3,1,240
91559203@N08,6359,19,1362906741,1362907281,3,1,540
91564758@N06,6360,24,1457839631,1457841131,1,1,1500
91564758@N06,6361,18,1458211474,1458212014,2,1,540
91604003@N02,6362,9,1444272933,1444273053,1,1,120
91604003@N02,6363,24,1444431761,1444432778,2,7,1017
91604003@N02,6363,17,1444432778,1444433198,2,7,420
91604003@N02,6363,5,1444435543,1444435663,2,7,120
91604003@N02,6363,18,1444438799,1444439339,3,7,540
91604003@N02,6363,7,1444439992,1444440112,2,7,120
91604003@N02,6363,16,1444465549,1444465969,4,7,420
91604003@N02,6363,11,1444467281,1444467521,1,7,240
91605234@N05,6364,24,1360481225,1360482725,3,1,1500
91605234@N05,6365,17,1363679337,1363679757,1,1,420
91673635@N00,6366,16,1307835539,1307835959,1,1,420
91691825@N00,6367,4,1272625048,1272625138,1,1,90
91711653@N00,6368,6,1272594061,1272594181,2,2,120
91711653@N00,6368,19,1272612045,1272612585,2,2,540
9171499@N02,6369,15,1200873601,1200873961,3,6,360
9171499@N02,6369,17,1200879327,1200879747,4,6,420
9171499@N02,6369,18,1200880566,1200881106,7,6,540
9171499@N02,6369,19,1200881318,1200881676,2,6,358
9171499@N02,6369,24,1200881676,1200883176,3,6,1500
9171499@N02,6369,12,1200885905,1200886175,1,6,270
91730208@N02,6370,24,1357418917,1357420417,2,2,1500
91730208@N02,6370,16,1357422236,1357422656,1,2,420
9173558@N05,6371,15,1395875184,1395875264,2,21,80
9173558@N05,6371,13,1395875264,1395875564,2,21,300
9173558@N05,6371,15,1395876153,1395876155,2,21,2
9173558@N05,6371,14,1395876155,1395876515,2,21,360
9173558@N05,6371,20,1395876818,1395877418,3,21,600
9173558@N05,6371,4,1395877675,1395877765,2,21,90
9173558@N05,6371,12,1395884472,1395884742,3,21,270
9173558@N05,6371,14,1395887431,1395887459,2,21,28
9173558@N05,6371,19,1395887459,1395887999,3,21,540
9173558@N05,6371,6,1395888184,1395888304,2,21,120
9173558@N05,6371,3,1395889253,1395889343,2,21,90
9173558@N05,6371,18,1395891733,1395891734,2,21,1
9173558@N05,6371,16,1395891734,1395892154,2,21,420
9173558@N05,6371,24,1395906771,1395908271,6,21,1500
9173558@N05,6371,14,1395908874,1395909102,2,21,228
9173558@N05,6371,18,1395909102,1395909111,2,21,9
9173558@N05,6371,14,1395909111,1395909299,13,21,188
9173558@N05,6371,19,1395909299,1395909361,7,21,62
9173558@N05,6371,6,1395909361,1395909481,3,21,120
9173558@N05,6371,19,1395910532,1395911072,3,21,540
9173558@N05,6371,24,1395917274,1395918774,1,21,1500
91746475@N06,6372,11,1380788857,1380789097,1,1,240
91746475@N06,6373,16,1383706238,1383706658,1,1,420
91746475@N06,6374,20,1387447013,1387447613,1,1,600
91773836@N03,6375,6,1360650828,1360650948,2,2,120
91773836@N03,6375,22,1360661064,1360662084,1,2,1020
91773836@N03,6376,7,1360751863,1360751983,1,1,120
91773836@N03,6377,14,1360850528,1360850888,1,1,360
91773836@N03,6378,15,1362829943,1362830303,1,1,360
91773836@N03,6379,17,1366808946,1366809366,1,1,420
91773836@N03,6380,7,1366861153,1366861273,1,1,120
91773836@N03,6381,15,1367380562,1367380922,1,1,360
91773836@N03,6382,4,1367750910,1367751000,1,1,90
91773836@N03,6383,12,1367834071,1367834341,1,1,270
91773836@N03,6384,7,1368605375,1368605495,1,1,120
9180370@N05,6385,19,1342234053,1342234593,1,1,540
91805633@N04,6386,23,1382138780,1382138943,3,12,163
91805633@N04,6386,18,1382138943,1382139000,3,12,57
91805633@N04,6386,5,1382139000,1382139120,2,12,120
91805633@N04,6386,7,1382139358,1382139478,2,12,120
91805633@N04,6386,18,1382142557,1382143097,3,12,540
91805633@N04,6386,16,1382143196,1382143616,5,12,420
91805633@N04,6386,19,1382143972,1382144464,5,12,492
91805633@N04,6386,8,1382144464,1382144584,3,12,120
91805633@N04,6386,13,1382146363,1382146663,2,12,300
91805633@N04,6386,25,1382147465,1382149565,13,12,2100
91805633@N04,6386,19,1382177804,1382178344,2,12,540
91805633@N04,6386,18,1382178592,1382179132,3,12,540
91824565@N00,6387,24,1250702137,1250703637,2,2,1500
91824565@N00,6387,25,1250705382,1250707482,1,2,2100
91827603@N00,6388,17,1196469462,1196469882,23,1,420
91827603@N00,6389,17,1259889217,1259889637,53,1,420
91828361@N00,6390,12,1356920789,1356921059,2,2,270
91828361@N00,6390,19,1356932400,1356932940,3,2,540
91828361@N00,6391,6,1357094069,1357094189,3,1,120
91852742@N00,6392,25,1210073728,1210073940,2,2,212
91852742@N00,6392,22,1210073940,1210074960,1,2,1020
91852742@N00,6393,15,1243911905,1243912265,2,2,360
91852742@N00,6393,9,1243935285,1243935405,1,2,120
9187766@N05,6394,14,1408366544,1408366904,4,1,360
91889496@N02,6395,22,1364355497,1364356446,2,2,949
91889496@N02,6395,25,1364356446,1364358546,1,2,2100
91889496@N02,6396,19,1383095409,1383095949,1,1,540
91889496@N02,6397,22,1384131152,1384132172,1,1,1020
91889496@N02,6398,14,1387185284,1387185644,2,3,360
91889496@N02,6398,16,1387187389,1387187694,2,3,305
91889496@N02,6398,1,1387187694,1387187754,1,3,60
91889496@N02,6399,10,1393146845,1393146995,1,1,150
91889496@N02,6400,19,1418031061,1418031601,1,1,540
91889496@N02,6401,12,1419554767,1419555037,1,1,270
91991505@N00,6402,18,1320701834,1320702374,1,1,540
92025065@N00,6403,17,1347242578,1347242998,1,1,420
92025065@N00,6404,19,1348185692,1348186232,4,3,540
92025065@N00,6404,14,1348186437,1348186797,2,3,360
92025065@N00,6404,16,1348187605,1348188025,16,3,420
92148649@N00,6405,4,1368009518,1368009608,1,1,90
9215253@N08,6406,12,1293153550,1293153820,3,1,270
92171126@N00,6407,19,1370060761,1370061301,3,7,540
92171126@N00,6407,18,1370063181,1370063721,3,7,540
92171126@N00,6407,5,1370066246,1370066366,2,7,120
92171126@N00,6407,19,1370066611,1370067151,2,7,540
92171126@N00,6407,25,1370069109,1370069280,2,7,171
92171126@N00,6407,24,1370069280,1370070780,2,7,1500
92171126@N00,6407,12,1370087102,1370087372,1,7,270
92201248@N02,6408,9,1366965232,1366965352,3,1,120
92237387@N00,6409,23,1317881052,1317882252,2,3,1200
92237387@N00,6409,5,1317883233,1317883353,2,3,120
92237387@N00,6409,16,1317888797,1317889217,1,3,420
92237387@N00,6410,23,1336807132,1336808332,1,1,1200
92237387@N00,6411,23,1336887670,1336888870,3,2,1200
92237387@N00,6411,8,1336906402,1336906522,1,2,120
92237387@N00,6412,19,1363387792,1363388332,2,2,540
92237387@N00,6412,18,1363389767,1363390307,1,2,540
92237387@N00,6413,7,1396651554,1396651674,2,2,120
92237387@N00,6413,5,1396652283,1396652403,1,2,120
92237387@N00,6414,19,1412307141,1412307681,1,1,540
92248782@N00,6415,12,1412926774,1412927044,2,6,270
92248782@N00,6415,4,1412928029,1412928119,2,6,90
92248782@N00,6415,19,1412929666,1412930206,3,6,540
92248782@N00,6415,22,1412932211,1412932266,2,6,55
92248782@N00,6415,24,1412932266,1412933766,4,6,1500
92248782@N00,6415,19,1412934793,1412935333,1,6,540
92248782@N00,6416,20,1412981497,1412982097,2,15,600
92248782@N00,6416,4,1412982791,1412982881,3,15,90
92248782@N00,6416,2,1412983220,1412983280,5,15,60
92248782@N00,6416,6,1412984025,1412984145,4,15,120
92248782@N00,6416,7,1412987735,1412987855,3,15,120
92248782@N00,6416,1,1412994100,1412994106,2,15,6
92248782@N00,6416,3,1412994106,1412994196,2,15,90
92248782@N00,6416,13,1413005393,1413005693,9,15,300
92248782@N00,6416,8,1413006679,1413006799,2,15,120
92248782@N00,6416,6,1413007056,1413007176,2,15,120
92248782@N00,6416,14,1413007652,1413008012,4,15,360
92248782@N00,6416,6,1413009177,1413009297,2,15,120
92248782@N00,6416,14,1413009305,1413009665,4,15,360
92248782@N00,6416,23,1413012680,1413013017,2,15,337
92248782@N00,6416,17,1413013017,1413013437,2,15,420
92248782@N00,6417,2,1413190076,1413190136,2,5,60
92248782@N00,6417,8,1413190219,1413190339,3,5,120
92248782@N00,6417,6,1413190440,1413190560,3,5,120
92248782@N00,6417,14,1413190565,1413190925,8,5,360
92248782@N00,6417,15,1413193848,1413194208,1,5,360
92281047@N00,6418,16,1296975006,1296975426,1,1,420
92318075@N00,6419,24,1444036295,1444037795,2,1,1500
92328493@N00,6420,16,1437958056,1437958476,2,3,420
92328493@N00,6420,18,1437958994,1437959534,2,3,540
92328493@N00,6420,7,1437960115,1437960235,1,3,120
92328493@N00,6421,12,1438073181,1438073451,2,2,270
92328493@N00,6421,25,1438078596,1438080696,1,2,2100
92334226@N00,6422,23,1438080688,1438081888,4,1,1200
92334226@N00,6423,13,1438218721,1438219021,1,1,300
92334226@N00,6424,18,1438296572,1438296677,3,11,105
92334226@N00,6424,11,1438296677,1438296917,2,11,240
92334226@N00,6424,20,1438300048,1438300648,2,11,600
92334226@N00,6424,16,1438301849,1438302269,2,11,420
92334226@N00,6424,12,1438302996,1438303266,2,11,270
92334226@N00,6424,25,1438330871,1438332971,2,11,2100
92334226@N00,6424,13,1438334373,1438334422,2,11,49
92334226@N00,6424,19,1438334422,1438334962,2,11,540
92334226@N00,6424,17,1438338033,1438338136,2,11,103
92334226@N00,6424,23,1438338136,1438339274,2,11,1138
92334226@N00,6424,13,1438339274,1438339574,1,11,300
9255029@N04,6425,24,1313394076,1313395576,15,1,1500
92599451@N08,6426,12,1234571536,1234571806,2,4,270
92599451@N08,6426,4,1234575647,1234575737,3,4,90
92599451@N08,6426,23,1234585316,1234586516,2,4,1200
92599451@N08,6426,12,1234588728,1234588998,2,4,270
92599451@N08,6427,18,1312686290,1312686830,2,4,540
92599451@N08,6427,7,1312689527,1312689647,3,4,120
92599451@N08,6427,19,1312692679,1312692755,2,4,76
92599451@N08,6427,14,1312692755,1312693115,1,4,360
92599451@N08,6428,12,1356216907,1356217177,3,8,270
92599451@N08,6428,14,1356218007,1356218367,5,8,360
92599451@N08,6428,9,1356225260,1356225380,2,8,120
92599451@N08,6428,17,1356226560,1356226576,2,8,16
92599451@N08,6428,21,1356226576,1356226612,2,8,36
92599451@N08,6428,15,1356226612,1356226972,2,8,360
92599451@N08,6428,23,1356238463,1356239663,4,8,1200
92599451@N08,6428,12,1356245958,1356246228,1,8,270
92599451@N08,6429,24,1356661564,1356663064,2,4,1500
92599451@N08,6429,23,1356670875,1356670985,2,4,110
92599451@N08,6429,17,1356670985,1356671405,3,4,420
92599451@N08,6429,12,1356683803,1356684073,2,4,270
92662849@N00,6430,10,1198916745,1198916895,2,1,150
92662849@N00,6431,6,1203122452,1203122541,2,4,89
92662849@N00,6431,20,1203122541,1203123141,2,4,600
92662849@N00,6431,6,1203124758,1203124878,2,4,120
92662849@N00,6431,18,1203128733,1203129273,1,4,540
92692548@N02,6432,16,1437961655,1437962075,2,9,420
92692548@N02,6432,18,1437965080,1437965620,3,9,540
92692548@N02,6432,11,1437968699,1437968939,2,9,240
92692548@N02,6432,8,1437969976,1437970096,2,9,120
92692548@N02,6432,13,1437971665,1437971965,2,9,300
92692548@N02,6432,21,1437973444,1437974344,2,9,900
92692548@N02,6432,16,1437978056,1437978476,3,9,420
92692548@N02,6432,11,1437978556,1437978796,2,9,240
92692548@N02,6432,25,1437988846,1437990946,2,9,2100
92692548@N02,6433,15,1438127468,1438127828,3,2,360
92692548@N02,6433,18,1438131439,1438131979,1,2,540
92692548@N02,6434,7,1438163758,1438163878,1,1,120
92695692@N00,6435,18,1416105878,1416106418,4,1,540
92787786@N02,6436,18,1378777738,1378778278,1,1,540
92787786@N02,6437,16,1378806713,1378807133,1,1,420
92804699@N00,6438,7,1332404801,1332404921,1,1,120
9282070@N02,6439,18,1304220220,1304220760,2,2,540
9282070@N02,6439,7,1304222676,1304222796,1,2,120
92859439@N06,6440,6,1346229042,1346229162,2,4,120
92859439@N06,6440,12,1346229281,1346229551,2,4,270
92859439@N06,6440,6,1346231625,1346231745,2,4,120
92859439@N06,6440,16,1346241455,1346241875,1,4,420
92859439@N06,6441,16,1346273538,1346273958,1,1,420
92859439@N06,6442,12,1346568387,1346568398,2,4,11
92859439@N06,6442,23,1346568398,1346568399,2,4,1
92859439@N06,6442,6,1346568399,1346568402,2,4,3
92859439@N06,6442,23,1346568402,1346569602,2,4,1200
92859439@N06,6443,22,1349436035,1349437055,2,6,1020
92859439@N06,6443,1,1349440801,1349440861,2,6,60
92859439@N06,6443,5,1349441553,1349441673,2,6,120
92859439@N06,6443,7,1349442044,1349442164,2,6,120
92859439@N06,6443,16,1349446944,1349447035,2,6,91
92859439@N06,6443,1,1349447035,1349447095,1,6,60
92859439@N06,6444,22,1350665557,1350666577,3,2,1020
92859439@N06,6444,13,1350670652,1350670952,2,2,300
92859439@N06,6445,12,1352644275,1352644299,2,7,24
92859439@N06,6445,14,1352644299,1352644659,2,7,360
92859439@N06,6445,6,1352644695,1352644815,2,7,120
92859439@N06,6445,19,1352644890,1352645430,2,7,540
92859439@N06,6445,14,1352648681,1352649041,3,7,360
92859439@N06,6445,6,1352654848,1352654968,2,7,120
92859439@N06,6445,14,1352658148,1352658508,1,7,360
92859439@N06,6446,19,1354292761,1354293301,1,1,540
92859439@N06,6447,12,1354872524,1354872794,1,1,270
92859439@N06,6448,14,1357896558,1357896918,3,2,360
92859439@N06,6448,22,1357898846,1357899866,1,2,1020
92859439@N06,6449,17,1358500484,1358500544,2,2,60
92859439@N06,6449,19,1358500544,1358501084,1,2,540
92859439@N06,6450,14,1358703582,1358703942,1,1,360
92859439@N06,6451,12,1359217054,1359217324,2,2,270
92859439@N06,6451,6,1359220903,1359221023,1,2,120
92859439@N06,6452,17,1359903983,1359904403,2,1,420
92859439@N06,6453,16,1360323600,1360324020,1,1,420
92859439@N06,6454,15,1360429366,1360429726,2,2,360
92859439@N06,6454,14,1360431812,1360432172,1,2,360
92904347@N03,6455,22,1375839435,1375840455,1,1,1020
92919323@N00,6456,14,1405126016,1405126376,3,3,360
92919323@N00,6456,18,1405149639,1405150179,2,3,540
92919323@N00,6456,16,1405167586,1405168006,1,3,420
92919323@N00,6457,14,1405334905,1405335265,3,1,360
92942546@N03,6458,15,1445678410,1445678770,1,1,360
92987904@N00,6459,18,1214652083,1214652623,3,1,540
93042417@N04,6460,24,1454475192,1454476692,2,2,1500
93042417@N04,6460,14,1454476947,1454477307,1,2,360
93098533@N08,6461,24,1390646169,1390647669,1,1,1500
93098533@N08,6462,14,1390682327,1390682687,4,2,360
93098533@N08,6462,7,1390711359,1390711479,2,2,120
93113881@N08,6463,7,1380781203,1380781323,2,1,120
93118760@N00,6464,14,1351467594,1351467954,2,2,360
93118760@N00,6464,22,1351475079,1351476099,1,2,1020
93118760@N00,6465,15,1351563768,1351564128,1,1,360
93228469@N03,6466,14,1371187281,1371187641,2,1,360
93228742@N02,6467,6,1385282971,1385283091,1,1,120
93273458@N00,6468,23,1299817277,1299818477,3,2,1200
93273458@N00,6468,16,1299840304,1299840724,1,2,420
93273458@N00,6469,16,1345896444,1345896864,2,2,420
93273458@N00,6469,6,1345902535,1345902655,1,2,120
93273458@N00,6470,14,1345939217,1345939577,2,2,360
93273458@N00,6470,13,1345956345,1345956645,1,2,300
93273458@N00,6471,12,1357279405,1357279536,2,3,131
93273458@N00,6471,14,1357279536,1357279896,2,3,360
93273458@N00,6471,16,1357288750,1357289170,1,3,420
93273458@N00,6472,15,1357343753,1357344113,2,5,360
93273458@N00,6472,14,1357368618,1357368978,2,5,360
93273458@N00,6472,19,1357370682,1357371222,2,5,540
93273458@N00,6472,16,1357387445,1357387865,2,5,420
93273458@N00,6472,14,1357391760,1357392120,1,5,360
93273458@N00,6473,6,1371432650,1371432770,1,1,120
93273458@N00,6474,6,1377907793,1377907913,2,2,120
93273458@N00,6474,14,1377910045,1377910405,1,2,360
93273458@N00,6475,15,1377944219,1377944579,1,1,360
93294881@N00,6476,17,1427002258,1427002678,1,1,420
9329852@N08,6477,10,1193823868,1193824018,2,2,150
9329852@N08,6477,15,1193826237,1193826597,2,2,360
93315816@N00,6478,17,1228134629,1228135049,1,1,420
93427598@N00,6479,19,1275088272,1275088812,6,1,540
93467796@N03,6480,14,1377037775,1377038135,4,3,360
93467796@N03,6480,6,1377041996,1377042116,2,3,120
93467796@N03,6480,24,1377044222,1377045722,1,3,1500
93467796@N03,6481,24,1377086369,1377086851,2,5,482
93467796@N03,6481,16,1377086851,1377087271,7,5,420
93467796@N03,6481,19,1377089396,1377089431,2,5,35
93467796@N03,6481,6,1377089431,1377089459,2,5,28
93467796@N03,6481,14,1377089459,1377089819,1,5,360
93472335@N02,6482,24,1438851282,1438852782,5,1,1500
93509642@N04,6483,16,1388335349,1388335769,2,2,420
93509642@N04,6483,20,1388344333,1388344933,1,2,600
93509642@N04,6484,12,1388599725,1388599995,2,3,270
93509642@N04,6484,15,1388601179,1388601539,2,3,360
93509642@N04,6484,16,1388611183,1388611603,3,3,420
93525156@N00,6485,24,1354663895,1354665395,3,1,1500
93525156@N00,6486,24,1354772829,1354774329,2,1,1500
93538039@N06,6487,11,1365860783,1365861023,1,1,240
93538039@N06,6488,24,1370171116,1370172616,1,1,1500
93629101@N05,6489,12,1403344442,1403344712,10,4,270
93629101@N05,6489,23,1403345837,1403345851,2,4,14
93629101@N05,6489,17,1403345851,1403345929,4,4,78
93629101@N05,6489,23,1403345929,1403347129,4,4,1200
93629101@N05,6490,12,1432349226,1432349308,2,6,82
93629101@N05,6490,24,1432349308,1432349531,5,6,223
93629101@N05,6490,19,1432349531,1432350071,3,6,540
93629101@N05,6490,16,1432353130,1432353550,12,6,420
93629101@N05,6490,24,1432355403,1432355693,3,6,290
93629101@N05,6490,22,1432355693,1432356713,4,6,1020
93649382@N00,6491,6,1427840413,1427840533,4,2,120
93649382@N00,6491,10,1427842370,1427842520,22,2,150
93677566@N00,6492,14,1385023191,1385023392,3,10,201
93677566@N00,6492,24,1385023392,1385023605,5,10,213
93677566@N00,6492,4,1385023605,1385023695,2,10,90
93677566@N00,6492,3,1385023699,1385023789,2,10,90
93677566@N00,6492,14,1385023886,1385024246,5,10,360
93677566@N00,6492,7,1385026915,1385027035,2,10,120
93677566@N00,6492,18,1385029802,1385029856,2,10,54
93677566@N00,6492,7,1385029856,1385029976,3,10,120
93677566@N00,6492,17,1385034227,1385034647,3,10,420
93677566@N00,6492,24,1385042957,1385044457,1,10,1500
93677566@N00,6493,3,1385079590,1385079680,3,2,90
93677566@N00,6493,24,1385079837,1385081337,1,2,1500
93677566@N00,6494,24,1385176429,1385176479,2,6,50
93677566@N00,6494,18,1385176479,1385176713,5,6,234
93677566@N00,6494,24,1385176713,1385178213,3,6,1500
93677566@N00,6494,13,1385190643,1385190943,4,6,300
93677566@N00,6494,14,1385205085,1385205293,2,6,208
93677566@N00,6494,24,1385205293,1385206793,2,6,1500
93677566@N00,6495,14,1385254452,1385254812,1,1,360
93677566@N00,6496,24,1385550946,1385552446,1,1,1500
93706115@N02,6497,19,1372433040,1372433580,2,2,540
93706115@N02,6497,12,1372434913,1372435183,1,2,270
93807460@N00,6498,14,1340835092,1340835452,1,1,360
93819556@N05,6499,5,1382308919,1382309039,1,1,120
93886527@N06,6500,1,1415856639,1415856699,1,1,60
93886527@N06,6501,1,1416047355,1416047415,1,1,60
93913117@N00,6502,17,1450601905,1450602325,1,1,420
93929791@N08,6503,24,1429086853,1429087985,9,7,1132
93929791@N08,6503,14,1429087985,1429088345,8,7,360
93929791@N08,6503,24,1429090679,1429091769,3,7,1090
93929791@N08,6503,7,1429091769,1429091889,5,7,120
93929791@N08,6503,14,1429092502,1429092862,5,7,360
93929791@N08,6503,15,1429094263,1429094623,3,7,360
93929791@N08,6503,22,1429095713,1429096733,1,7,1020
94037364@N04,6504,10,1362867799,1362867949,1,1,150
94037364@N04,6505,14,1362899690,1362900050,1,1,360
94049683@N04,6506,14,1417160137,1417160497,2,3,360
94049683@N04,6506,16,1417161251,1417161671,2,3,420
94049683@N04,6506,10,1417170295,1417170445,1,3,150
94063583@N03,6507,24,1388800635,1388800713,2,2,78
94063583@N03,6507,19,1388800713,1388801253,2,2,540
94107540@N00,6508,3,1369614784,1369614874,3,1,90
94107540@N00,6509,3,1369649957,1369650047,1,1,90
94107540@N00,6510,14,1369904525,1369904885,3,2,360
94107540@N00,6510,3,1369907734,1369907824,1,2,90
9414486@N03,6511,19,1396227841,1396228381,4,7,540
9414486@N03,6511,16,1396236980,1396237400,2,7,420
9414486@N03,6511,5,1396239509,1396239629,2,7,120
9414486@N03,6511,18,1396239641,1396239713,2,7,72
9414486@N03,6511,5,1396239713,1396239833,2,7,120
9414486@N03,6511,23,1396243802,1396245002,7,7,1200
9414486@N03,6511,11,1396250135,1396250375,1,7,240
9414677@N06,6512,16,1200190955,1200191375,5,2,420
9414677@N06,6512,15,1200214996,1200215356,3,2,360
9414677@N06,6513,18,1205641148,1205641688,3,5,540
9414677@N06,6513,25,1205652844,1205654861,5,5,2017
9414677@N06,6513,5,1205654861,1205654981,5,5,120
9414677@N06,6513,7,1205656262,1205656382,2,5,120
9414677@N06,6513,11,1205656408,1205656648,1,5,240
9414677@N06,6514,24,1205721950,1205723450,6,5,1500
9414677@N06,6514,15,1205724768,1205725128,2,5,360
9414677@N06,6514,5,1205729105,1205729225,2,5,120
9414677@N06,6514,1,1205729720,1205729780,3,5,60
9414677@N06,6514,7,1205748413,1205748533,3,5,120
9421954@N06,6515,12,1245303594,1245303864,1,1,270
94257881@N04,6516,13,1365157011,1365157311,1,1,300
94291835@N00,6517,24,1202194457,1202195957,1,1,1500
94363051@N00,6518,20,1266650302,1266650888,5,2,586
94363051@N00,6518,12,1266650888,1266651158,2,2,270
94473144@N00,6519,14,1428967866,1428968226,6,2,360
94473144@N00,6519,17,1428985543,1428985963,5,2,420
94518441@N00,6520,24,1223446833,1223447654,24,3,821
94518441@N00,6520,22,1223447654,1223447983,2,3,329
94518441@N00,6520,25,1223447983,1223450083,1,3,2100
94528619@N00,6521,6,1444546829,1444546949,1,1,120
94598369@N06,6522,17,1437021642,1437022062,1,1,420
94608516@N07,6523,25,1401053868,1401055968,2,2,2100
94608516@N07,6523,18,1401068445,1401068985,1,2,540
94608516@N07,6524,14,1401099131,1401099491,2,1,360
94610972@N06,6525,8,1368070140,1368070260,1,1,120
94628763@N00,6526,24,1348759555,1348761055,3,1,1500
94628763@N00,6527,24,1350139570,1350141070,1,1,1500
94628763@N00,6528,24,1352449768,1352451268,1,1,1500
94689127@N02,6529,16,1399681159,1399681579,1,1,420
94734319@N00,6530,25,1238478523,1238480623,1,1,2100
94734319@N00,6531,4,1238546547,1238546637,15,3,90
94734319@N00,6531,8,1238546637,1238546668,8,3,31
94734319@N00,6531,4,1238546668,1238546758,2,3,90
94752424@N00,6532,12,1429506402,1429506672,29,1,270
94774760@N00,6533,14,1376792351,1376792711,1,1,360
94774760@N00,6534,19,1387085845,1387086385,2,2,540
94774760@N00,6534,13,1387091858,1387092158,1,2,300
94774760@N00,6535,24,1404025004,1404026504,1,1,1500
94774760@N00,6536,25,1447233905,1447236005,1,1,2100
94775257@N05,6537,21,1386797382,1386797847,2,4,465
94775257@N05,6537,6,1386797847,1386797967,3,4,120
94775257@N05,6537,19,1386803773,1386804313,2,4,540
94775257@N05,6537,14,1386806095,1386806455,2,4,360
9480786@N07,6538,18,1281526392,1281526932,1,1,540
94808878@N00,6539,18,1348620730,1348621270,2,8,540
94808878@N00,6539,6,1348630638,1348630758,5,8,120
94808878@N00,6539,14,1348632862,1348632955,3,8,93
94808878@N00,6539,6,1348632955,1348633010,2,8,55
94808878@N00,6539,14,1348633010,1348633370,2,8,360
94808878@N00,6539,19,1348633604,1348633716,2,8,112
94808878@N00,6539,14,1348633716,1348634076,2,8,360
94808878@N00,6539,12,1348634730,1348635000,1,8,270
94812957@N00,6540,7,1207462223,1207462343,2,2,120
94812957@N00,6540,19,1207465259,1207465799,2,2,540
94849839@N08,6541,7,1361684126,1361684246,1,1,120
94865168@N00,6542,15,1317529107,1317529434,2,3,327
94865168@N00,6542,8,1317529434,1317529507,2,3,73
94865168@N00,6542,12,1317529507,1317529777,1,3,270
9487094@N05,6543,12,1226185735,1226186005,2,5,270
9487094@N05,6543,24,1226186011,1226186126,2,5,115
9487094@N05,6543,22,1226186126,1226187146,2,5,1020
9487094@N05,6543,25,1226188347,1226190447,5,5,2100
9487094@N05,6543,7,1226192882,1226193002,6,5,120
9487094@N05,6544,7,1226622913,1226623033,1,1,120
94900569@N03,6545,20,1365121630,1365122230,1,1,600
94935685@N00,6546,24,1189432031,1189433531,2,1,1500
94935685@N00,6547,12,1189869399,1189869669,2,3,270
94935685@N00,6547,4,1189870336,1189870426,2,3,90
94935685@N00,6547,18,1189872300,1189872840,2,3,540
94935685@N00,6548,13,1190413936,1190414236,4,1,300
94935685@N00,6549,13,1191016886,1191017186,3,9,300
94935685@N00,6549,17,1191020082,1191020502,7,9,420
94935685@N00,6549,3,1191021041,1191021131,5,9,90
94935685@N00,6549,7,1191021632,1191021752,6,9,120
94935685@N00,6549,16,1191021758,1191021801,2,9,43
94935685@N00,6549,7,1191021801,1191021850,3,9,49
94935685@N00,6549,11,1191021850,1191021888,2,9,38
94935685@N00,6549,7,1191021888,1191022008,2,9,120
94935685@N00,6549,16,1191022340,1191022760,6,9,420
94935685@N00,6550,12,1195894105,1195894375,5,5,270
94935685@N00,6550,16,1195894670,1195895090,5,5,420
94935685@N00,6550,10,1195895240,1195895390,3,5,150
94935685@N00,6550,22,1195898205,1195898954,2,5,749
94935685@N00,6550,24,1195898954,1195900454,3,5,1500
94935685@N00,6551,10,1196574261,1196574411,13,1,150
94935685@N00,6552,25,1199413281,1199415381,4,5,2100
94935685@N00,6552,15,1199418835,1199419195,4,5,360
94935685@N00,6552,11,1199421354,1199421594,2,5,240
94935685@N00,6552,20,1199423136,1199423736,2,5,600
94935685@N00,6552,24,1199424964,1199426464,2,5,1500
94935685@N00,6553,18,1276432843,1276433383,1,1,540
94942666@N00,6554,11,1210630141,1210630381,4,1,240
94942666@N00,6555,11,1258424347,1258424587,1,1,240
94942666@N00,6556,11,1258465407,1258465647,1,1,240
9496161@N07,6557,14,1327201014,1327201374,1,1,360
95050769@N05,6558,14,1367289558,1367289918,45,1,360
95050769@N05,6559,14,1367495060,1367495420,1,1,360
95050769@N05,6560,13,1367557184,1367557484,2,4,300
95050769@N05,6560,14,1367558626,1367558986,2,4,360
95050769@N05,6560,11,1367561154,1367561394,2,4,240
95050769@N05,6560,14,1367571282,1367571642,4,4,360
95061722@N00,6561,12,1393195665,1393195935,2,10,270
95061722@N00,6561,24,1393197573,1393198147,3,10,574
95061722@N00,6561,25,1393198147,1393200247,2,10,2100
95061722@N00,6561,9,1393200794,1393200914,2,10,120
95061722@N00,6561,2,1393201024,1393201084,3,10,60
95061722@N00,6561,15,1393202363,1393202723,2,10,360
95061722@N00,6561,16,1393203628,1393204048,2,10,420
95061722@N00,6561,19,1393205866,1393206406,4,10,540
95061722@N00,6561,6,1393206916,1393207036,8,10,120
95061722@N00,6561,19,1393208861,1393209401,1,10,540
95061722@N00,6562,19,1393313640,1393313707,2,3,67
95061722@N00,6562,14,1393313707,1393314067,4,3,360
95061722@N00,6562,8,1393318604,1393318724,5,3,120
95061722@N00,6563,12,1393370230,1393370459,2,11,229
95061722@N00,6563,24,1393370459,1393371959,3,11,1500
95061722@N00,6563,7,1393373571,1393373691,5,11,120
95061722@N00,6563,18,1393375872,1393376412,4,11,540
95061722@N00,6563,16,1393378268,1393378688,8,11,420
95061722@N00,6563,24,1393392806,1393393801,2,11,995
95061722@N00,6563,7,1393393801,1393393921,2,11,120
95061722@N00,6563,14,1393394352,1393394712,5,11,360
95061722@N00,6563,1,1393397663,1393397723,2,11,60
95061722@N00,6563,19,1393403665,1393403962,2,11,297
95061722@N00,6563,6,1393403962,1393404082,1,11,120
95061722@N00,6564,25,1393482642,1393484742,3,2,2100
95061722@N00,6564,6,1393486459,1393486579,1,2,120
95063789@N00,6565,20,1201943237,1201943837,3,1,600
95063789@N00,6566,6,1360311903,1360312023,1,1,120
95101667@N00,6567,24,1428323529,1428325029,5,5,1500
95101667@N00,6567,19,1428325760,1428326300,3,5,540
95101667@N00,6567,8,1428326406,1428326526,2,5,120
95101667@N00,6567,2,1428326555,1428326615,2,5,60
95101667@N00,6567,14,1428333518,1428333878,1,5,360
9510444@N08,6568,6,1450302032,1450302152,3,6,120
9510444@N08,6568,14,1450302774,1450303086,2,6,312
9510444@N08,6568,6,1450303086,1450303206,5,6,120
9510444@N08,6568,14,1450303272,1450303632,2,6,360
9510444@N08,6568,12,1450313945,1450314215,2,6,270
9510444@N08,6568,18,1450317606,1450318146,1,6,540
95118343@N00,6569,10,1262743225,1262743375,1,1,150
95133089@N00,6570,15,1294702610,1294702620,2,8,10
95133089@N00,6570,12,1294702620,1294702706,3,8,86
95133089@N00,6570,20,1294702706,1294702784,2,8,78
95133089@N00,6570,19,1294702784,1294703324,6,8,540
95133089@N00,6570,7,1294704348,1294704468,7,8,120
95133089@N00,6570,12,1294723909,1294724179,38,8,270
95133089@N00,6570,16,1294732063,1294732483,2,8,420
95133089@N00,6570,18,1294734180,1294734720,1,8,540
95133089@N00,6571,7,1294765690,1294765810,2,2,120
95133089@N00,6571,16,1294767928,1294768348,1,2,420
95142644@N00,6572,14,1468793531,1468793684,3,6,153
95142644@N00,6572,8,1468793684,1468793804,2,6,120
95142644@N00,6572,19,1468794140,1468794680,2,6,540
95142644@N00,6572,7,1468796111,1468796231,2,6,120
95142644@N00,6572,25,1468801867,1468803967,3,6,2100
95142644@N00,6572,16,1468807434,1468807854,1,6,420
95186740@N08,6573,22,1376163787,1376164184,2,4,397
95186740@N08,6573,25,1376164184,1376166284,2,4,2100
95186740@N08,6573,17,1376168309,1376168729,2,4,420
95186740@N08,6573,14,1376172981,1376173341,1,4,360
95230267@N07,6574,14,1398015951,1398016311,3,3,360
95230267@N07,6574,25,1398017066,1398017688,2,3,622
95230267@N07,6574,19,1398017688,1398018228,1,3,540
95341382@N05,6575,18,1435702992,1435703532,1,1,540
95383339@N07,6576,7,1388628393,1388628513,1,1,120
95383339@N07,6577,7,1388737402,1388737522,1,1,120
95383339@N07,6578,23,1444601401,1444602601,1,1,1200
95383339@N07,6579,19,1444640619,1444641159,4,2,540
95383339@N07,6579,16,1444649286,1444649706,2,2,420
95383339@N07,6580,12,1445032151,1445032421,1,1,270
95400904@N02,6581,23,1378870920,1378872120,2,3,1200
95400904@N02,6581,15,1378888832,1378889192,8,3,360
95400904@N02,6581,18,1378892717,1378893257,1,3,540
95428663@N03,6582,24,1233376450,1233377950,1,1,1500
95428663@N03,6583,14,1233470729,1233471089,1,1,360
95461076@N00,6584,15,1281746125,1281746485,3,1,360
95461076@N00,6585,18,1281818631,1281819171,2,1,540
95508147@N03,6586,14,1369209002,1369209362,1,1,360
95508147@N03,6587,6,1401443859,1401443979,1,1,120
95559818@N00,6588,23,1207334564,1207335687,2,2,1123
95559818@N00,6588,17,1207335687,1207336107,1,2,420
95559818@N00,6589,12,1207377187,1207377457,3,6,270
95559818@N00,6589,17,1207377764,1207378184,2,6,420
95559818@N00,6589,24,1207378388,1207379586,2,6,1198
95559818@N00,6589,25,1207379586,1207381686,2,6,2100
95559818@N00,6589,23,1207381902,1207382342,2,6,440
95559818@N00,6589,18,1207382342,1207382882,5,6,540
95601478@N00,6590,7,1279934731,1279934851,2,3,120
95601478@N00,6590,1,1279935847,1279935907,3,3,60
95601478@N00,6590,5,1279936840,1279936960,4,3,120
95601478@N00,6591,15,1280036247,1280036607,1,1,360
95701812@N00,6592,7,1308304027,1308304147,2,9,120
95701812@N00,6592,10,1308307891,1308308041,2,9,150
95701812@N00,6592,16,1308308513,1308308613,2,9,100
95701812@N00,6592,10,1308308613,1308308711,3,9,98
95701812@N00,6592,16,1308308711,1308308934,3,9,223
95701812@N00,6592,10,1308308934,1308308984,2,9,50
95701812@N00,6592,16,1308308984,1308309404,2,9,420
95701812@N00,6592,10,1308310058,1308310208,3,9,150
95701812@N00,6592,11,1308311987,1308312227,2,9,240
95708853@N00,6593,24,1371516591,1371518091,1,1,1500
95724996@N04,6594,6,1466837423,1466837543,2,10,120
95724996@N04,6594,7,1466837736,1466837856,2,10,120
95724996@N04,6594,11,1466839326,1466839552,3,10,226
95724996@N04,6594,7,1466839552,1466839672,2,10,120
95724996@N04,6594,11,1466840213,1466840453,2,10,240
95724996@N04,6594,18,1466842828,1466843368,3,10,540
95724996@N04,6594,7,1466843877,1466843997,2,10,120
95724996@N04,6594,18,1466844436,1466844596,2,10,160
95724996@N04,6594,7,1466844596,1466844716,2,10,120
95724996@N04,6594,6,1466845366,1466845486,1,10,120
95785110@N00,6595,16,1357213291,1357213711,1,1,420
95785110@N00,6596,2,1357272520,1357272580,1,1,60
95851176@N00,6597,16,1298624050,1298624470,1,1,420
95867639@N03,6598,24,1376661937,1376663437,2,1,1500
95867639@N03,6599,24,1376995741,1376997241,2,1,1500
95867639@N03,6600,24,1377343843,1377345343,1,1,1500
95867639@N03,6601,24,1378026007,1378027507,5,1,1500
95867639@N03,6602,24,1378541978,1378543478,1,1,1500
95867639@N03,6603,24,1378595886,1378597386,1,1,1500
95867639@N03,6604,24,1380358595,1380360095,1,1,1500
95867639@N03,6605,24,1381495343,1381496843,4,1,1500
95867639@N03,6606,24,1382767143,1382768643,2,1,1500
9588819@N06,6607,19,1399569826,1399570366,1,1,540
9588819@N06,6608,14,1399604081,1399604441,1,1,360
9588819@N06,6609,22,1399652021,1399653041,2,4,1020
9588819@N06,6609,24,1399654812,1399656312,2,4,1500
9588819@N06,6609,19,1399671163,1399671703,2,4,540
9588819@N06,6609,16,1399689459,1399689879,1,4,420
9588819@N06,6610,22,1399722655,1399723675,1,1,1020
95904983@N03,6611,1,1356938895,1356938955,4,2,60
95904983@N03,6611,16,1356940772,1356941192,1,2,420
96004001@N00,6612,12,1422226546,1422226816,2,7,270
96004001@N00,6612,3,1422234331,1422234421,3,7,90
96004001@N00,6612,7,1422237385,1422237505,4,7,120
96004001@N00,6612,5,1422240117,1422240237,5,7,120
96004001@N00,6612,10,1422242175,1422242325,2,7,150
96004001@N00,6612,9,1422245061,1422245181,8,7,120
96004001@N00,6612,25,1422257283,1422259383,7,7,2100
96004001@N00,6613,14,1422400458,1422400818,4,6,360
96004001@N00,6613,15,1422413214,1422413574,5,6,360
96004001@N00,6613,25,1422415344,1422417444,6,6,2100
96004001@N00,6613,3,1422436898,1422436988,3,6,90
96004001@N00,6613,14,1422439039,1422439399,6,6,360
96004001@N00,6613,8,1422447730,1422447850,4,6,120
96015175@N04,6614,12,1321617386,1321617656,2,1,270
96045537@N00,6615,16,1194507559,1194507979,2,2,420
96045537@N00,6615,17,1194511715,1194512135,2,2,420
96045537@N00,6616,12,1194577244,1194577514,2,7,270
96045537@N00,6616,17,1194578689,1194578949,2,7,260
96045537@N00,6616,16,1194578949,1194579369,2,7,420
96045537@N00,6616,18,1194580856,1194581396,2,7,540
96045537@N00,6616,3,1194581447,1194581537,2,7,90
96045537@N00,6616,4,1194583074,1194583164,3,7,90
96045537@N00,6616,13,1194589254,1194589554,2,7,300
96067265@N02,6617,12,1356902961,1356903231,1,1,270
96156793@N00,6618,14,1412290418,1412290743,2,2,325
96156793@N00,6618,17,1412290743,1412291163,3,2,420
96156793@N00,6619,25,1412342542,1412344642,2,1,2100
96175708@N06,6620,20,1381706858,1381707458,2,11,600
96175708@N06,6620,23,1381710021,1381710289,2,11,268
96175708@N06,6620,16,1381710289,1381710709,2,11,420
96175708@N06,6620,19,1381711295,1381711835,2,11,540
96175708@N06,6620,6,1381714091,1381714211,2,11,120
96175708@N06,6620,18,1381719038,1381719404,2,11,366
96175708@N06,6620,14,1381719404,1381719764,2,11,360
96175708@N06,6620,17,1381728005,1381728425,2,11,420
96175708@N06,6620,12,1381729354,1381729624,2,11,270
96175708@N06,6620,25,1381743658,1381743998,3,11,340
96175708@N06,6620,13,1381743998,1381744298,1,11,300
96175708@N06,6621,16,1381915498,1381915918,6,1,420
96227783@N04,6622,18,1427968806,1427969346,1,1,540
9623805@N05,6623,3,1367486062,1367486152,1,1,90
9623805@N05,6624,14,1367572210,1367572570,3,2,360
9623805@N05,6624,13,1367574045,1367574345,2,2,300
96312503@N08,6625,14,1377992011,1377992371,1,1,360
96318226@N08,6626,16,1270256809,1270257229,3,1,420
96326655@N08,6627,17,1428673539,1428673959,1,1,420
96353274@N00,6628,24,1361498158,1361499658,1,1,1500
96387804@N07,6629,4,1409306714,1409306804,1,1,90
96387804@N07,6630,24,1463364900,1463366082,2,5,1182
96387804@N07,6630,13,1463366082,1463366117,2,5,35
96387804@N07,6630,12,1463366117,1463366137,3,5,20
96387804@N07,6630,13,1463366137,1463366437,2,5,300
96387804@N07,6630,25,1463368386,1463370486,6,5,2100
96430093@N05,6631,19,1375689264,1375689804,1,1,540
96430093@N05,6632,19,1375793502,1375794042,1,1,540
96430093@N05,6633,12,1375859665,1375859935,3,2,270
96430093@N05,6633,19,1375861543,1375862083,3,2,540
96430093@N05,6634,14,1375931022,1375931382,2,3,360
96430093@N05,6634,1,1375933511,1375933571,2,3,60
96430093@N05,6634,19,1375936328,1375936868,1,3,540
96430093@N05,6635,12,1376265855,1376266125,2,4,270
96430093@N05,6635,24,1376266640,1376268140,2,4,1500
96430093@N05,6635,6,1376269621,1376269741,3,4,120
96430093@N05,6635,19,1376281422,1376281962,2,4,540
96430093@N05,6636,13,1376621507,1376621807,1,1,300
96430093@N05,6637,6,1376698853,1376698973,2,2,120
96430093@N05,6637,14,1376700264,1376700624,3,2,360
96430093@N05,6638,19,1390359232,1390359772,2,4,540
96430093@N05,6638,5,1390361022,1390361142,2,4,120
96430093@N05,6638,6,1390363892,1390364012,2,4,120
96430093@N05,6638,22,1390371402,1390372422,1,4,1020
96430093@N05,6639,18,1390435529,1390436069,2,3,540
96430093@N05,6639,12,1390452541,1390452811,3,3,270
96430093@N05,6639,24,1390456602,1390458102,1,3,1500
96430093@N05,6640,19,1390537369,1390537909,1,1,540
96430093@N05,6641,1,1390724319,1390724379,1,1,60
96430093@N05,6642,19,1390783640,1390784180,2,1,540
96430093@N05,6643,12,1391076579,1391076849,2,1,270
96430093@N05,6644,4,1394520936,1394521026,1,1,90
96430093@N05,6645,24,1421807446,1421808946,2,2,1500
96430093@N05,6645,17,1421812726,1421813146,2,2,420
96430093@N05,6646,19,1421909568,1421910108,3,1,540
96430093@N05,6647,12,1421975107,1421975377,3,2,270
96430093@N05,6647,17,1421979974,1421980394,1,2,420
96430093@N05,6648,24,1422067064,1422068564,3,2,1500
96430093@N05,6648,19,1422085679,1422086219,1,2,540
96430093@N05,6649,25,1422177239,1422179339,2,2,2100
96430093@N05,6649,19,1422181063,1422181603,1,2,540
96430093@N05,6650,19,1422232375,1422232915,2,1,540
96430093@N05,6651,14,1422614629,1422614989,3,2,360
96430093@N05,6651,19,1422615106,1422615646,3,2,540
96430093@N05,6652,19,1439362048,1439362588,2,2,540
96430093@N05,6652,17,1439366862,1439367282,1,2,420
96453045@N03,6653,16,1394273475,1394273895,1,1,420
96479915@N00,6654,12,1311668751,1311669021,13,7,270
96479915@N00,6654,23,1311671873,1311673068,21,7,1195
96479915@N00,6654,16,1311673068,1311673488,31,7,420
96479915@N00,6654,19,1311674343,1311674883,4,7,540
96479915@N00,6654,16,1311676946,1311677366,8,7,420
96479915@N00,6654,24,1311677466,1311677501,2,7,35
96479915@N00,6654,13,1311677501,1311677801,2,7,300
9654765@N06,6655,7,1276511244,1276511364,1,1,120
96567588@N02,6656,19,1371431678,1371432218,1,1,540
96567588@N02,6657,13,1371471633,1371471933,1,1,300
96581740@N03,6658,12,1364205518,1364205788,5,2,270
96581740@N03,6658,13,1364206346,1364206646,4,2,300
96626588@N07,6659,17,1387194581,1387194927,5,3,346
96626588@N07,6659,23,1387194927,1387195244,5,3,317
96626588@N07,6659,12,1387195244,1387195514,14,3,270
96722532@N03,6660,17,1337911142,1337911562,4,1,420
96722532@N03,6661,24,1354230417,1354231917,5,4,1500
96722532@N03,6661,17,1354239646,1354239648,2,4,2
96722532@N03,6661,24,1354239648,1354241148,7,4,1500
96722532@N03,6661,17,1354244445,1354244865,2,4,420
96722532@N03,6662,24,1364015135,1364016635,1,1,1500
96722532@N03,6663,24,1364112226,1364113726,56,1,1500
96722532@N03,6664,24,1369945827,1369947327,6,1,1500
96722532@N03,6665,17,1372489235,1372489655,1,1,420
96722532@N03,6666,24,1372522942,1372522945,3,3,3
96722532@N03,6666,17,1372522945,1372523016,2,3,71
96722532@N03,6666,24,1372523016,1372524516,1,3,1500
96722532@N03,6667,24,1373345071,1373346571,1,1,1500
96722532@N03,6668,3,1384421239,1384421329,1,1,90
96722532@N03,6669,24,1384494836,1384496336,8,1,1500
96722532@N03,6670,7,1391154894,1391155014,2,2,120
96722532@N03,6670,1,1391155119,1391155179,2,2,60
96722532@N03,6671,14,1401025815,1401026175,2,4,360
96722532@N03,6671,7,1401026359,1401026479,2,4,120
96722532@N03,6671,19,1401026604,1401026916,2,4,312
96722532@N03,6671,16,1401026916,1401027336,3,4,420
96722532@N03,6672,23,1401063114,1401064314,2,1,1200
9672978@N08,6673,13,1236925321,1236925621,1,1,300
9672978@N08,6674,25,1237002154,1237002174,2,3,20
9672978@N08,6674,18,1237002174,1237002714,2,3,540
9672978@N08,6674,2,1237020835,1237020895,1,3,60
9672978@N08,6675,13,1237542845,1237543145,1,1,300
96763382@N02,6676,18,1412930140,1412930680,1,1,540
96799583@N00,6677,12,1290311395,1290311665,2,3,270
96799583@N00,6677,22,1290329312,1290329443,2,3,131
96799583@N00,6677,13,1290329443,1290329743,4,3,300
96836086@N05,6678,12,1370398738,1370399008,2,3,270
96836086@N05,6678,3,1370400221,1370400311,2,3,90
96836086@N05,6678,14,1370408710,1370409070,1,3,360
96895247@N05,6679,14,1392531007,1392531367,1,1,360
96961309@N00,6680,17,1255124551,1255124971,66,1,420
9698245@N05,6681,3,1189045451,1189045541,1,1,90
96985020@N07,6682,7,1376551102,1376551222,1,1,120
96985020@N07,6683,11,1389586579,1389586819,1,1,240
96985020@N07,6684,23,1395635936,1395637136,1,1,1200
97019381@N00,6685,6,1467016853,1467016973,1,1,120
97058136@N00,6686,5,1242824622,1242824742,1,1,120
9708101@N02,6687,24,1191039547,1191041047,3,1,1500
9708101@N02,6688,6,1206773011,1206773131,4,1,120
9708101@N02,6689,6,1214637879,1214637999,4,2,120
9708101@N02,6689,3,1214642474,1214642564,1,2,90
9708101@N02,6690,16,1215136834,1215137254,1,1,420
97106978@N00,6691,23,1356588897,1356588907,2,8,10
97106978@N00,6691,16,1356588907,1356589011,5,8,104
97106978@N00,6691,23,1356589011,1356589203,3,8,192
97106978@N00,6691,16,1356589203,1356589623,4,8,420
97106978@N00,6691,3,1356591149,1356591239,3,8,90
97106978@N00,6691,18,1356592064,1356592604,13,8,540
97106978@N00,6691,5,1356599010,1356599056,2,8,46
97106978@N00,6691,1,1356599056,1356599116,1,8,60
97106978@N00,6692,6,1356648164,1356648284,5,5,120
97106978@N00,6692,11,1356649315,1356649555,2,5,240
97106978@N00,6692,18,1356650922,1356651462,2,5,540
97106978@N00,6692,7,1356654211,1356654331,3,5,120
97106978@N00,6692,5,1356655459,1356655579,3,5,120
97137858@N00,6693,12,1416935207,1416935477,2,9,270
97137858@N00,6693,17,1416941702,1416942122,4,9,420
97137858@N00,6693,24,1416942287,1416942387,3,9,100
97137858@N00,6693,22,1416942387,1416942463,3,9,76
97137858@N00,6693,25,1416942463,1416942539,5,9,76
97137858@N00,6693,15,1416942539,1416942899,3,9,360
97137858@N00,6693,4,1416942965,1416943055,2,9,90
97137858@N00,6693,21,1416943120,1416943920,3,9,800
97137858@N00,6693,24,1416943920,1416945420,6,9,1500
97137858@N00,6694,23,1417274771,1417275877,2,17,1106
97137858@N00,6694,7,1417275877,1417275997,3,17,120
97137858@N00,6694,11,1417276059,1417276299,4,17,240
97137858@N00,6694,19,1417277487,1417277637,4,17,150
97137858@N00,6694,6,1417277637,1417277757,2,17,120
97137858@N00,6694,25,1417278073,1417278145,2,17,72
97137858@N00,6694,13,1417278145,1417278445,2,17,300
97137858@N00,6694,24,1417278540,1417279413,2,17,873
97137858@N00,6694,17,1417279413,1417279592,2,17,179
97137858@N00,6694,23,1417279592,1417279666,2,17,74
97137858@N00,6694,17,1417279666,1417280086,2,17,420
97137858@N00,6694,16,1417280092,1417280512,3,17,420
97137858@N00,6694,14,1417280738,1417280883,2,17,145
97137858@N00,6694,9,1417280883,1417280990,2,17,107
97137858@N00,6694,2,1417280990,1417281050,3,17,60
97137858@N00,6694,15,1417281111,1417281471,2,17,360
97137858@N00,6694,24,1417281626,1417283126,1,17,1500
97161736@N02,6695,16,1383195266,1383195686,2,2,420
97161736@N02,6695,17,1383196031,1383196451,3,2,420
97161736@N02,6696,10,1383296120,1383296206,2,4,86
97161736@N02,6696,16,1383296206,1383296589,2,4,383
97161736@N02,6696,17,1383296589,1383296754,3,4,165
97161736@N02,6696,12,1383296754,1383297024,1,4,270
97161736@N02,6697,20,1383359852,1383360038,3,10,186
97161736@N02,6697,24,1383360038,1383361538,2,10,1500
97161736@N02,6697,19,1383376816,1383376960,6,10,144
97161736@N02,6697,6,1383376960,1383376974,2,10,14
97161736@N02,6697,19,1383376974,1383377005,3,10,31
97161736@N02,6697,6,1383377005,1383377021,2,10,16
97161736@N02,6697,14,1383377021,1383377381,7,10,360
97161736@N02,6697,8,1383378735,1383378855,2,10,120
97161736@N02,6697,6,1383379241,1383379361,2,10,120
97161736@N02,6697,13,1383379712,1383380012,2,10,300
97161736@N02,6698,6,1383461014,1383461134,2,3,120
97161736@N02,6698,16,1383461215,1383461635,2,3,420
97161736@N02,6698,6,1383465371,1383465491,8,3,120
97161736@N02,6699,10,1383531073,1383531223,2,4,150
97161736@N02,6699,7,1383531666,1383531786,3,4,120
97161736@N02,6699,19,1383554072,1383554612,3,4,540
97161736@N02,6699,16,1383557699,1383558119,4,4,420
97161736@N02,6700,3,1416724066,1416724156,1,1,90
9717980@N08,6701,17,1296888515,1296888935,1,1,420
97225209@N00,6702,14,1386290128,1386290488,1,1,360
97225209@N00,6703,19,1386324076,1386324616,1,1,540
97225209@N00,6704,24,1386378212,1386379712,2,2,1500
97225209@N00,6704,7,1386382574,1386382694,1,2,120
97286705@N07,6705,14,1456520709,1456521069,2,8,360
97286705@N07,6705,9,1456521573,1456521693,2,8,120
97286705@N07,6705,14,1456521704,1456522064,3,8,360
97286705@N07,6705,11,1456523040,1456523280,3,8,240
97286705@N07,6705,7,1456523336,1456523456,4,8,120
97286705@N07,6705,18,1456526157,1456526697,2,8,540
97286705@N07,6705,16,1456527225,1456527645,5,8,420
97286705@N07,6705,8,1456528252,1456528372,6,8,120
97286705@N07,6706,15,1456567833,1456568193,3,2,360
97286705@N07,6706,4,1456568236,1456568326,1,2,90
9728779@N03,6707,22,1340445799,1340446819,5,6,1020
9728779@N03,6707,24,1340448422,1340448591,2,6,169
9728779@N03,6707,25,1340448591,1340448866,3,6,275
9728779@N03,6707,24,1340448866,1340449439,2,6,573
9728779@N03,6707,8,1340449439,1340449559,2,6,120
9728779@N03,6707,14,1340449681,1340450041,1,6,360
97289872@N08,6708,22,1376013362,1376013392,2,2,30
97289872@N08,6708,24,1376013392,1376014892,1,2,1500
97289872@N08,6709,12,1376120633,1376120903,2,1,270
97405121@N08,6710,7,1381635616,1381635736,5,2,120
97405121@N08,6710,18,1381637885,1381638425,2,2,540
9744114@N08,6711,22,1218613806,1218614826,2,2,1020
9744114@N08,6711,25,1218628896,1218630996,1,2,2100
9744114@N08,6712,19,1315083028,1315083568,1,1,540
9744114@N08,6713,14,1390553749,1390554109,2,3,360
9744114@N08,6713,6,1390555435,1390555555,3,3,120
9744114@N08,6713,1,1390557557,1390557617,4,3,60
9744114@N08,6714,16,1400843488,1400843592,2,13,104
9744114@N08,6714,23,1400843592,1400844284,4,13,692
9744114@N08,6714,6,1400844284,1400844404,5,13,120
9744114@N08,6714,19,1400844835,1400844889,2,13,54
9744114@N08,6714,6,1400844889,1400845009,4,13,120
9744114@N08,6714,14,1400845253,1400845613,3,13,360
9744114@N08,6714,8,1400846738,1400846858,8,13,120
9744114@N08,6714,25,1400849775,1400849941,2,13,166
9744114@N08,6714,13,1400849941,1400850241,12,13,300
9744114@N08,6714,10,1400862415,1400862565,3,13,150
9744114@N08,6714,16,1400864643,1400865028,4,13,385
9744114@N08,6714,10,1400865028,1400865113,2,13,85
9744114@N08,6714,16,1400865113,1400865533,9,13,420
9744114@N08,6715,14,1402714702,1402715062,1,1,360
9744114@N08,6716,7,1429873560,1429873680,5,1,120
9744114@N08,6717,11,1440302457,1440302697,2,1,240
9744114@N08,6718,10,1444897610,1444897760,2,1,150
97460734@N07,6719,14,1390429781,1390430141,1,1,360
97460734@N07,6720,14,1421999796,1422000156,2,1,360
97463056@N00,6721,7,1380423391,1380423488,2,3,97
97463056@N00,6721,18,1380423488,1380424028,2,3,540
97463056@N00,6721,24,1380424123,1380425623,2,3,1500
97463056@N00,6722,24,1380456150,1380456664,3,2,514
97463056@N00,6722,13,1380456664,1380456964,1,2,300
97472023@N04,6723,23,1461998574,1461999774,1,1,1200
97472023@N04,6724,24,1462411474,1462412974,2,5,1500
97472023@N04,6724,13,1462416813,1462417113,2,5,300
97472023@N04,6724,25,1462417523,1462419623,2,5,2100
97472023@N04,6724,19,1462441526,1462442066,2,5,540
97472023@N04,6724,24,1462443467,1462444967,1,5,1500
97472023@N04,6725,24,1462506378,1462507878,1,1,1500
97522816@N08,6726,19,1395458831,1395459371,1,1,540
97527209@N00,6727,16,1390021624,1390022044,2,4,420
97527209@N00,6727,5,1390025428,1390025548,2,4,120
97527209@N00,6727,23,1390030629,1390031829,2,4,1200
97527209@N00,6727,14,1390038568,1390038928,1,4,360
97527209@N00,6728,24,1390181048,1390182548,3,1,1500
97543060@N07,6729,19,1346544000,1346544540,8,1,540
97623972@N06,6730,14,1422167627,1422167987,2,2,360
97623972@N06,6730,19,1422168112,1422168652,1,2,540
9762956@N03,6731,14,1348543286,1348543646,1,1,360
97632346@N06,6732,19,1363838414,1363838954,3,3,540
97632346@N06,6732,18,1363845526,1363846066,2,3,540
97632346@N06,6732,11,1363849872,1363850112,2,3,240
97632346@N06,6733,10,1418271104,1418271254,2,3,150
97632346@N06,6733,11,1418275157,1418275397,3,3,240
97632346@N06,6733,14,1418281187,1418281547,2,3,360
97637284@N08,6734,19,1399671378,1399671918,3,1,540
9766803@N05,6735,17,1432698844,1432699244,2,3,400
9766803@N05,6735,19,1432699244,1432699784,4,3,540
9766803@N05,6735,24,1432705732,1432707232,1,3,1500
9766803@N05,6736,14,1436663273,1436663633,1,1,360
9766803@N05,6737,17,1440704388,1440704808,1,1,420
9766803@N05,6738,17,1445216123,1445216543,1,1,420
97761705@N00,6739,16,1395379854,1395380274,15,1,420
97761705@N00,6740,5,1395529092,1395529212,2,4,120
97761705@N00,6740,24,1395552289,1395553789,9,4,1500
97761705@N00,6740,10,1395559908,1395560058,3,4,150
97761705@N00,6740,19,1395561618,1395562158,1,4,540
97862183@N05,6741,6,1375518353,1375518473,1,1,120
97862183@N05,6742,6,1417853255,1417853375,1,1,120
97864553@N00,6743,12,1369872582,1369872852,1,1,270
97879914@N04,6744,12,1372096365,1372096635,2,5,270
97879914@N04,6744,22,1372101549,1372102569,2,5,1020
97879914@N04,6744,18,1372106173,1372106713,3,5,540
97879914@N04,6744,12,1372123265,1372123535,2,5,270
97879914@N04,6744,23,1372128740,1372129940,1,5,1200
97879914@N04,6745,10,1372164341,1372164491,1,1,150
97907761@N00,6746,11,1361686393,1361686633,2,1,240
97987383@N02,6747,24,1394835924,1394837424,1,1,1500
98071415@N05,6748,24,1373233140,1373234640,2,1,1500
98071415@N05,6749,14,1373320129,1373320489,1,1,360
98071415@N05,6750,11,1373538283,1373538523,2,2,240
98071415@N05,6750,15,1373549371,1373549731,1,2,360
98071415@N05,6751,24,1373600480,1373601980,1,1,1500
98071415@N05,6752,24,1379744461,1379745961,2,2,1500
98071415@N05,6752,19,1379750395,1379750935,1,2,540
98071415@N05,6753,24,1379919844,1379921344,1,1,1500
98071415@N05,6754,18,1379981800,1379982340,1,1,540
98071415@N05,6755,24,1380055565,1380057065,1,1,1500
98071415@N05,6756,24,1380141965,1380143465,1,1,1500
98071415@N05,6757,24,1380241913,1380243413,2,1,1500
98071415@N05,6758,24,1380579960,1380581460,1,1,1500
98071415@N05,6759,24,1380621782,1380623282,1,1,1500
98071415@N05,6760,24,1381093831,1381095331,1,1,1500
98071415@N05,6761,24,1381347076,1381348576,1,1,1500
98093098@N00,6762,12,1230365904,1230366174,1,1,270
98148330@N06,6763,17,1368179040,1368179460,1,1,420
98172165@N05,6764,15,1377135398,1377135758,8,8,360
98172165@N05,6764,11,1377139541,1377139781,3,8,240
98172165@N05,6764,10,1377142766,1377142916,3,8,150
98172165@N05,6764,19,1377143769,1377143865,3,8,96
98172165@N05,6764,6,1377143865,1377143925,3,8,60
98172165@N05,6764,14,1377143925,1377144285,5,8,360
98172165@N05,6764,25,1377148951,1377151051,10,8,2100
98172165@N05,6764,20,1377155685,1377156285,1,8,600
98172165@N05,6765,19,1377526301,1377526841,1,1,540
98182088@N03,6766,7,1400146826,1400146946,2,2,120
98182088@N03,6766,16,1400151523,1400151943,1,2,420
98182088@N03,6767,16,1430187275,1430187695,2,3,420
98182088@N03,6767,7,1430192724,1430192844,2,3,120
98182088@N03,6767,24,1430202419,1430203919,1,3,1500
98192675@N08,6768,7,1364198003,1364198123,3,1,120
98192675@N08,6769,7,1373295761,1373295881,3,1,120
9821843@N08,6770,24,1215147107,1215148607,1,1,1500
9821843@N08,6771,12,1215241262,1215241532,1,1,270
9821843@N08,6772,7,1246850144,1246850264,2,2,120
9821843@N08,6772,19,1246853847,1246854387,1,2,540
9821843@N08,6773,19,1252198100,1252198640,2,2,540
9821843@N08,6773,7,1252221278,1252221398,1,2,120
9821843@N08,6774,15,1278054972,1278055332,1,1,360
9821843@N08,6775,23,1278132415,1278133615,1,1,1200
9821843@N08,6776,23,1278224259,1278225459,4,1,1200
98235322@N00,6777,7,1353471357,1353471477,1,1,120
98258748@N06,6778,24,1413951060,1413952560,1,1,1500
98258748@N06,6779,24,1414622023,1414623523,2,1,1500
98258748@N06,6780,24,1429250034,1429251534,5,1,1500
98258748@N06,6781,13,1435128718,1435129018,1,1,300
98258748@N06,6782,24,1445212361,1445213861,1,1,1500
98258748@N06,6783,24,1470714118,1470715618,1,1,1500
98274023@N00,6784,12,1193332347,1193332617,1,1,270
98274023@N00,6785,19,1246010018,1246010558,1,1,540
98274023@N00,6786,8,1296375953,1296376073,2,2,120
98274023@N00,6786,24,1296378267,1296379767,1,2,1500
98274023@N00,6787,24,1296463427,1296464927,1,1,1500
98274023@N00,6788,17,1305447566,1305447986,1,1,420
98274023@N00,6789,14,1343202801,1343203161,1,1,360
98274023@N00,6790,17,1351852840,1351853260,1,1,420
98278862@N00,6791,14,1362865905,1362866265,3,3,360
98278862@N00,6791,12,1362873846,1362874116,4,3,270
98278862@N00,6791,13,1362907804,1362908104,1,3,300
98278862@N00,6792,24,1372719710,1372721210,3,2,1500
98278862@N00,6792,12,1372723992,1372724262,1,2,270
98278862@N00,6793,24,1372754743,1372756243,1,1,1500
98278862@N00,6794,14,1380421988,1380422348,2,2,360
98278862@N00,6794,23,1380439244,1380440444,1,2,1200
98278862@N00,6795,14,1412480642,1412481002,2,2,360
98278862@N00,6795,13,1412500124,1412500424,1,2,300
98278862@N00,6796,13,1417346095,1417346395,1,1,300
98278862@N00,6797,6,1434268886,1434269006,1,1,120
98278862@N00,6798,23,1434853876,1434855076,2,2,1200
98278862@N00,6798,17,1434859850,1434860270,1,2,420
98308974@N02,6799,12,1369378601,1369378871,2,1,270
98308974@N02,6800,15,1369461470,1369461830,1,1,360
98308974@N02,6801,11,1375411978,1375411981,3,5,3
98308974@N02,6801,7,1375411981,1375412101,28,5,120
98308974@N02,6801,11,1375416637,1375416646,2,5,9
98308974@N02,6801,7,1375416646,1375416766,11,5,120
98308974@N02,6801,18,1375419042,1375419582,2,5,540
98308974@N02,6802,14,1375659096,1375659456,5,8,360
98308974@N02,6802,19,1375670314,1375670854,8,8,540
98308974@N02,6802,23,1375673437,1375674637,34,8,1200
98308974@N02,6802,5,1375689173,1375689293,11,8,120
98308974@N02,6802,14,1375695793,1375696153,23,8,360
98308974@N02,6802,6,1375696924,1375697044,7,8,120
98308974@N02,6802,10,1375699791,1375699941,4,8,150
98308974@N02,6802,6,1375703471,1375703591,10,8,120
98323495@N00,6803,17,1433848081,1433848501,2,1,420
98337673@N07,6804,10,1359110704,1359110854,1,1,150
98352952@N02,6805,25,1403742684,1403744784,2,5,2100
98352952@N02,6805,15,1403750882,1403751242,2,5,360
98352952@N02,6805,17,1403762961,1403763381,3,5,420
98352952@N02,6805,24,1403764943,1403766443,2,5,1500
98352952@N02,6805,16,1403783316,1403783736,8,5,420
98538941@N00,6806,12,1318285893,1318286163,3,5,270
98538941@N00,6806,17,1318286646,1318287066,9,5,420
98538941@N00,6806,25,1318288723,1318289013,2,5,290
98538941@N00,6806,21,1318289013,1318289913,8,5,900
98538941@N00,6806,2,1318289982,1318290042,10,5,60
98583319@N04,6807,24,1391642811,1391644311,1,1,1500
9858951@N03,6808,7,1211724979,1211725099,1,1,120
9858951@N03,6809,12,1211791116,1211791386,13,24,270
9858951@N03,6809,17,1211791586,1211791595,2,24,9
9858951@N03,6809,12,1211791595,1211791865,19,24,270
9858951@N03,6809,16,1211792138,1211792558,12,24,420
9858951@N03,6809,10,1211794259,1211794409,16,24,150
9858951@N03,6809,1,1211794981,1211795041,26,24,60
9858951@N03,6809,5,1211795220,1211795257,10,24,37
9858951@N03,6809,1,1211795257,1211795257,2,24,0
9858951@N03,6809,5,1211795257,1211795259,2,24,2
9858951@N03,6809,1,1211795259,1211795259,2,24,0
9858951@N03,6809,5,1211795259,1211795260,2,24,1
9858951@N03,6809,1,1211795260,1211795260,2,24,0
9858951@N03,6809,5,1211795260,1211795380,15,24,120
9858951@N03,6809,7,1211795501,1211795621,7,24,120
9858951@N03,6809,11,1211795997,1211796131,2,24,134
9858951@N03,6809,7,1211796131,1211796251,5,24,120
9858951@N03,6809,11,1211796569,1211796809,52,24,240
9858951@N03,6809,16,1211797602,1211797878,3,24,276
9858951@N03,6809,19,1211797878,1211798259,46,24,381
9858951@N03,6809,6,1211798259,1211798379,40,24,120
9858951@N03,6809,20,1211798524,1211798635,12,24,111
9858951@N03,6809,24,1211798635,1211798680,6,24,45
9858951@N03,6809,12,1211798680,1211798709,6,24,29
9858951@N03,6809,24,1211798709,1211800209,40,24,1500
9858951@N03,6810,7,1212137931,1212138051,4,7,120
9858951@N03,6810,18,1212138850,1212139390,2,7,540
9858951@N03,6810,6,1212142789,1212142909,2,7,120
9858951@N03,6810,4,1212143276,1212143366,11,7,90
9858951@N03,6810,20,1212144647,1212145020,5,7,373
9858951@N03,6810,24,1212145020,1212145619,2,7,599
9858951@N03,6810,16,1212145619,1212146039,1,7,420
9858951@N03,6811,20,1212247094,1212247694,1,1,600
9858951@N03,6812,19,1212502180,1212502249,11,13,69
9858951@N03,6812,16,1212502249,1212502316,2,13,67
9858951@N03,6812,11,1212502316,1212502388,7,13,72
9858951@N03,6812,12,1212502388,1212502506,2,13,118
9858951@N03,6812,11,1212502506,1212502548,3,13,42
9858951@N03,6812,7,1212502548,1212502668,6,13,120
9858951@N03,6812,5,1212502680,1212502754,8,13,74
9858951@N03,6812,1,1212502754,1212502759,2,13,5
9858951@N03,6812,10,1212502759,1212502768,2,13,9
9858951@N03,6812,1,1212502768,1212502810,4,13,42
9858951@N03,6812,10,1212502810,1212502901,10,13,91
9858951@N03,6812,16,1212502901,1212502910,2,13,9
9858951@N03,6812,12,1212502910,1212503180,5,13,270
9858951@N03,6813,12,1212915853,1212916123,15,63,270
9858951@N03,6813,24,1212916780,1212916863,6,63,83
9858951@N03,6813,12,1212916863,1212916893,5,63,30
9858951@N03,6813,24,1212916893,1212917096,27,63,203
9858951@N03,6813,22,1212917096,1212917096,2,63,0
9858951@N03,6813,24,1212917096,1212917098,2,63,2
9858951@N03,6813,22,1212917098,1212917098,2,63,0
9858951@N03,6813,24,1212917098,1212917100,2,63,2
9858951@N03,6813,22,1212917100,1212917100,2,63,0
9858951@N03,6813,24,1212917100,1212917142,2,63,42
9858951@N03,6813,13,1212917142,1212917442,67,63,300
9858951@N03,6813,25,1212920065,1212920067,2,63,2
9858951@N03,6813,13,1212920067,1212920067,2,63,0
9858951@N03,6813,25,1212920067,1212920069,2,63,2
9858951@N03,6813,13,1212920069,1212920069,2,63,0
9858951@N03,6813,25,1212920069,1212920091,3,63,22
9858951@N03,6813,13,1212920091,1212920091,2,63,0
9858951@N03,6813,25,1212920091,1212920092,2,63,1
9858951@N03,6813,13,1212920092,1212920092,2,63,0
9858951@N03,6813,25,1212920092,1212921887,14,63,1795
9858951@N03,6813,15,1212921887,1212921887,2,63,0
9858951@N03,6813,25,1212921887,1212921889,2,63,2
9858951@N03,6813,15,1212921889,1212921889,2,63,0
9858951@N03,6813,25,1212921889,1212921894,2,63,5
9858951@N03,6813,15,1212921894,1212921894,2,63,0
9858951@N03,6813,25,1212921894,1212921896,2,63,2
9858951@N03,6813,15,1212921896,1212921896,2,63,0
9858951@N03,6813,25,1212921896,1212921901,2,63,5
9858951@N03,6813,15,1212921901,1212921901,2,63,0
9858951@N03,6813,25,1212921901,1212921903,2,63,2
9858951@N03,6813,15,1212921903,1212921903,2,63,0
9858951@N03,6813,25,1212921903,1212921905,2,63,2
9858951@N03,6813,15,1212921905,1212921905,2,63,0
9858951@N03,6813,25,1212921905,1212921906,2,63,1
9858951@N03,6813,15,1212921906,1212921906,2,63,0
9858951@N03,6813,25,1212921906,1212921908,2,63,2
9858951@N03,6813,15,1212921908,1212921908,2,63,0
9858951@N03,6813,25,1212921908,1212922035,2,63,127
9858951@N03,6813,15,1212922035,1212922035,2,63,0
9858951@N03,6813,25,1212922035,1212922037,2,63,2
9858951@N03,6813,15,1212922037,1212922037,2,63,0
9858951@N03,6813,25,1212922037,1212922038,2,63,1
9858951@N03,6813,15,1212922038,1212922038,2,63,0
9858951@N03,6813,25,1212922038,1212922530,2,63,492
9858951@N03,6813,15,1212922530,1212922530,2,63,0
9858951@N03,6813,25,1212922530,1212922532,2,63,2
9858951@N03,6813,15,1212922532,1212922532,2,63,0
9858951@N03,6813,25,1212922532,1212922533,2,63,1
9858951@N03,6813,15,1212922533,1212922533,2,63,0
9858951@N03,6813,25,1212922533,1212922534,2,63,1
9858951@N03,6813,15,1212922534,1212922534,2,63,0
9858951@N03,6813,25,1212922534,1212922537,2,63,3
9858951@N03,6813,15,1212922537,1212922537,2,63,0
9858951@N03,6813,25,1212922537,1212924288,2,63,1751
9858951@N03,6813,15,1212924288,1212924288,2,63,0
9858951@N03,6813,25,1212924288,1212924292,3,63,4
9858951@N03,6813,15,1212924292,1212924292,2,63,0
9858951@N03,6813,25,1212924292,1212924296,3,63,4
9858951@N03,6813,15,1212924296,1212924296,2,63,0
9858951@N03,6813,25,1212924296,1212926273,3,63,1977
9858951@N03,6813,15,1212926273,1212926347,8,63,74
9858951@N03,6813,24,1212926347,1212926525,12,63,178
9858951@N03,6813,12,1212926525,1212926795,27,63,270
9858951@N03,6814,12,1213380228,1213380229,2,16,1
9858951@N03,6814,24,1213380229,1213380238,8,16,9
9858951@N03,6814,20,1213380238,1213380241,3,16,3
9858951@N03,6814,12,1213380241,1213380243,3,16,2
9858951@N03,6814,24,1213380243,1213380245,3,16,2
9858951@N03,6814,19,1213380245,1213380276,27,16,31
9858951@N03,6814,20,1213380276,1213380279,2,16,3
9858951@N03,6814,11,1213380279,1213380290,4,16,11
9858951@N03,6814,17,1213380290,1213380308,2,16,18
9858951@N03,6814,11,1213380308,1213380314,3,16,6
9858951@N03,6814,7,1213380314,1213380336,2,16,22
9858951@N03,6814,5,1213380336,1213380351,7,16,15
9858951@N03,6814,1,1213380351,1213380357,5,16,6
9858951@N03,6814,5,1213380357,1213380359,3,16,2
9858951@N03,6814,10,1213380359,1213380367,6,16,8
9858951@N03,6814,16,1213380367,1213380787,5,16,420
9858951@N03,6815,12,1214205540,1214205810,6,1,270
9858951@N03,6816,12,1214606839,1214607109,6,1,270
9858951@N03,6817,12,1215615977,1215615981,3,8,4
9858951@N03,6817,24,1215615981,1215615990,5,8,9
9858951@N03,6817,13,1215615990,1215616006,13,8,16
9858951@N03,6817,25,1215616006,1215616007,2,8,1
9858951@N03,6817,15,1215616007,1215616012,6,8,5
9858951@N03,6817,24,1215616012,1215616347,5,8,335
9858951@N03,6817,12,1215616347,1215616463,3,8,116
9858951@N03,6817,7,1215616463,1215616583,3,8,120
9858951@N03,6818,18,1216659855,1216660395,3,1,540
9858951@N03,6819,12,1218204796,1218205066,5,1,270
9858951@N03,6820,7,1219366465,1219366585,3,10,120
9858951@N03,6820,13,1219381140,1219381368,3,10,228
9858951@N03,6820,25,1219381368,1219383468,2,10,2100
9858951@N03,6820,22,1219384938,1219385492,2,10,554
9858951@N03,6820,4,1219385492,1219385582,4,10,90
9858951@N03,6820,6,1219385640,1219385760,3,10,120
9858951@N03,6820,4,1219385905,1219385905,2,10,0
9858951@N03,6820,6,1219385905,1219385905,2,10,0
9858951@N03,6820,19,1219385905,1219386445,4,10,540
9858951@N03,6820,16,1219386868,1219387288,2,10,420
9858951@N03,6821,19,1222598954,1222599494,6,2,540
9858951@N03,6821,25,1222599870,1222601970,1,2,2100
9858951@N03,6822,9,1222675218,1222675338,2,2,120
9858951@N03,6822,17,1222677027,1222677447,2,2,420
9858951@N03,6823,16,1222853772,1222854192,13,1,420
9858951@N03,6824,10,1223016502,1223016652,8,2,150
9858951@N03,6824,17,1223017678,1223018098,1,2,420
9858951@N03,6825,19,1223613028,1223613317,12,2,289
9858951@N03,6825,23,1223613317,1223614517,5,2,1200
9858951@N03,6826,12,1226653127,1226653397,1,1,270
9858951@N03,6827,24,1227242334,1227243834,3,1,1500
9858951@N03,6828,6,1230074663,1230074783,61,23,120
9858951@N03,6828,16,1230076534,1230076538,3,23,4
9858951@N03,6828,19,1230076538,1230077078,2,23,540
9858951@N03,6828,16,1230079000,1230079420,4,23,420
9858951@N03,6828,11,1230081805,1230082045,6,23,240
9858951@N03,6828,7,1230083923,1230083960,5,23,37
9858951@N03,6828,18,1230083960,1230084500,13,23,540
9858951@N03,6828,10,1230085679,1230085829,7,23,150
9858951@N03,6828,16,1230087534,1230087891,10,23,357
9858951@N03,6828,17,1230087891,1230088311,10,23,420
9858951@N03,6828,12,1230088402,1230088672,15,23,270
9858951@N03,6828,24,1230092957,1230094457,2,23,1500
9858951@N03,6828,6,1230095639,1230095759,29,23,120
9858951@N03,6828,22,1230097365,1230097368,3,23,3
9858951@N03,6828,24,1230097368,1230097384,2,23,16
9858951@N03,6828,22,1230097384,1230098320,10,23,936
9858951@N03,6828,15,1230098320,1230098342,5,23,22
9858951@N03,6828,24,1230098342,1230098695,2,23,353
9858951@N03,6828,15,1230098695,1230098985,13,23,290
9858951@N03,6828,25,1230098985,1230099405,7,23,420
9858951@N03,6828,12,1230099405,1230099603,19,23,198
9858951@N03,6828,24,1230099603,1230099615,2,23,12
9858951@N03,6828,12,1230099615,1230099885,3,23,270
9858951@N03,6829,13,1236668848,1236669148,6,1,300
9858951@N03,6830,7,1236928191,1236928311,2,2,120
9858951@N03,6830,13,1236930228,1236930528,2,2,300
9858951@N03,6831,12,1239376304,1239376574,2,1,270
9858951@N03,6832,24,1243138684,1243139400,4,19,716
9858951@N03,6832,22,1243139400,1243139422,4,19,22
9858951@N03,6832,13,1243139422,1243139456,8,19,34
9858951@N03,6832,22,1243139456,1243140476,16,19,1020
9858951@N03,6832,25,1243140721,1243142821,99,19,2100
9858951@N03,6832,13,1243144160,1243144460,64,19,300
9858951@N03,6832,25,1243144950,1243146337,34,19,1387
9858951@N03,6832,22,1243146337,1243146380,3,19,43
9858951@N03,6832,21,1243146380,1243147280,2,19,900
9858951@N03,6832,20,1243147549,1243147666,2,19,117
9858951@N03,6832,24,1243147666,1243148236,4,19,570
9858951@N03,6832,20,1243148236,1243148836,9,19,600
9858951@N03,6832,16,1243148929,1243149318,13,19,389
9858951@N03,6832,23,1243149318,1243150070,10,19,752
9858951@N03,6832,16,1243150070,1243150264,22,19,194
9858951@N03,6832,23,1243150264,1243150300,4,19,36
9858951@N03,6832,16,1243150300,1243150409,9,19,109
9858951@N03,6832,19,1243150409,1243150683,2,19,274
9858951@N03,6832,17,1243150683,1243151103,23,19,420
9858951@N03,6833,16,1243307261,1243307681,1,1,420
9858951@N03,6834,4,1255102430,1255102520,2,1,90
9858951@N03,6835,23,1255732964,1255734164,7,1,1200
9858951@N03,6836,23,1274258240,1274259440,6,1,1200
9858951@N03,6837,15,1316254307,1316254667,2,1,360
98636389@N06,6838,7,1382832224,1382832344,1,1,120
98636389@N06,6839,18,1394505170,1394505473,2,2,303
98636389@N06,6839,7,1394505473,1394505593,1,2,120
98636389@N06,6840,24,1409192061,1409193561,2,1,1500
98663457@N00,6841,9,1359972174,1359972294,1,1,120
98672552@N00,6842,24,1190353385,1190354885,6,1,1500
98672552@N00,6843,24,1191571803,1191573303,1,1,1500
98684111@N07,6844,12,1372214629,1372214899,5,1,270
98755122@N00,6845,17,1300073117,1300073537,1,1,420
98778319@N05,6846,16,1363663604,1363664024,2,2,420
98778319@N05,6846,6,1363671369,1363671489,1,2,120
98798579@N00,6847,8,1347070044,1347070062,2,4,18
98798579@N00,6847,14,1347070062,1347070422,3,4,360
98798579@N00,6847,19,1347070530,1347070685,2,4,155
98798579@N00,6847,6,1347070685,1347070805,1,4,120
98798579@N00,6848,6,1347450088,1347450208,2,4,120
98798579@N00,6848,14,1347456527,1347456887,2,4,360
98798579@N00,6848,8,1347470418,1347470538,2,4,120
98798579@N00,6848,19,1347473106,1347473646,1,4,540
98798579@N00,6849,14,1347534014,1347534374,1,1,360
98798579@N00,6850,6,1347696629,1347696749,1,1,120
98798579@N00,6851,18,1354975649,1354976189,1,1,540
98798579@N00,6852,23,1355139282,1355140482,2,2,1200
98798579@N00,6852,12,1355146986,1355147256,1,2,270
98798579@N00,6853,18,1355202332,1355202872,2,3,540
98798579@N00,6853,11,1355205593,1355205833,2,3,240
98798579@N00,6853,16,1355229790,1355230210,1,3,420
98820993@N04,6854,24,1373099112,1373100612,1,1,1500
9885001@N08,6855,16,1311327166,1311327586,1,1,420
9887264@N02,6856,16,1350690475,1350690895,1,1,420
9889112@N02,6857,10,1336219954,1336220104,1,1,150
9889112@N02,6858,10,1337303405,1337303555,1,1,150
9889112@N02,6859,10,1337339832,1337339982,1,1,150
9889112@N02,6860,10,1337472946,1337473096,6,1,150
9889112@N02,6861,10,1337809235,1337809385,1,1,150
9889112@N02,6862,10,1337847564,1337847714,1,1,150
9889112@N02,6863,10,1337933672,1337933822,1,1,150
9889112@N02,6864,10,1338040255,1338040405,1,1,150
9889112@N02,6865,10,1338293086,1338293236,3,1,150
9889112@N02,6866,10,1338462081,1338462231,2,1,150
9889112@N02,6867,10,1344635626,1344635776,1,1,150
98988031@N02,6868,19,1218763566,1218764106,1,1,540
98988031@N02,6869,9,1238797585,1238797705,1,1,120
98988031@N02,6870,5,1238834023,1238834143,6,1,120
98988031@N02,6871,18,1302945687,1302946227,1,1,540
99016667@N00,6872,10,1326595424,1326595574,2,3,150
99016667@N00,6872,11,1326596446,1326596686,2,3,240
99016667@N00,6872,10,1326598202,1326598352,4,3,150
99025610@N05,6873,19,1386387941,1386388481,1,1,540
99108562@N04,6874,19,1379144775,1379145315,1,1,540
99162408@N00,6875,16,1325937202,1325937622,1,1,420
99253695@N00,6876,7,1317606528,1317606648,2,1,120
99253695@N00,6877,7,1317678555,1317678675,4,1,120
9926279@N03,6878,19,1416078700,1416079240,1,1,540
9926279@N03,6879,25,1421436890,1421438990,1,1,2100
9926279@N03,6880,6,1421522174,1421522294,1,1,120
9926279@N03,6881,22,1441397388,1441398408,1,1,1020
9926279@N03,6882,25,1452972104,1452974204,1,1,2100
99395292@N02,6883,10,1413880271,1413880421,1,1,150
99416116@N00,6884,7,1289550966,1289551086,3,1,120
99416116@N00,6885,11,1295760079,1295760319,1,1,240
9943904@N03,6886,12,1261649030,1261649300,1,1,270
9946119@N05,6887,17,1315225290,1315225710,1,1,420
9946119@N05,6888,16,1315264273,1315264693,1,1,420
99471343@N00,6889,7,1313723430,1313723550,8,8,120
99471343@N00,6889,20,1313728660,1313728990,2,8,330
99471343@N00,6889,6,1313728990,1313729110,4,8,120
99471343@N00,6889,7,1313730365,1313730424,4,8,59
99471343@N00,6889,2,1313730424,1313730484,2,8,60
99471343@N00,6889,18,1313730581,1313731121,2,8,540
99471343@N00,6889,7,1313734224,1313734344,11,8,120
99471343@N00,6889,25,1313742065,1313744165,9,8,2100
99471343@N00,6890,25,1313808419,1313808815,2,7,396
99471343@N00,6890,7,1313808815,1313808935,4,7,120
99471343@N00,6890,25,1313812723,1313814823,2,7,2100
99471343@N00,6890,16,1313818244,1313818420,2,7,176
99471343@N00,6890,17,1313818420,1313818840,2,7,420
99471343@N00,6890,16,1313819019,1313819439,3,7,420
99471343@N00,6890,5,1313821364,1313821484,1,7,120
99526257@N05,6891,14,1340018000,1340018360,2,1,360
99552910@N00,6892,6,1236340648,1236340768,1,1,120
99552910@N00,6893,16,1273791908,1273792328,1,1,420
99578286@N04,6894,19,1372213520,1372214060,3,2,540
99578286@N04,6894,25,1372222432,1372224532,2,2,2100
99578286@N04,6895,6,1380187646,1380187657,2,4,11
99578286@N04,6895,19,1380187657,1380187685,6,4,28
99578286@N04,6895,14,1380187685,1380188045,17,4,360
99578286@N04,6895,6,1380191005,1380191125,5,4,120
99591369@N06,6896,9,1361776330,1361776450,1,1,120
99608747@N00,6897,7,1374391889,1374392009,1,1,120
99632250@N07,6898,12,1314674402,1314674672,2,1,270
99632250@N07,6899,19,1324771874,1324772414,1,1,540
99804076@N02,6900,19,1444371959,1444372499,1,1,540
99825479@N04,6901,14,1375684009,1375684369,1,1,360
99855129@N00,6902,14,1386474195,1386474555,3,2,360
99855129@N00,6902,13,1386477976,1386478276,1,2,300
99855129@N00,6903,19,1427150214,1427150754,3,6,540
99855129@N00,6903,17,1427158958,1427159378,2,6,420
99855129@N00,6903,24,1427164040,1427165540,5,6,1500
99855129@N00,6903,18,1427174678,1427175218,2,6,540
99855129@N00,6903,25,1427189232,1427191089,2,6,1857
99855129@N00,6903,16,1427191089,1427191509,18,6,420
99867456@N08,6904,19,1431205025,1431205565,1,1,540
99894217@N02,6905,6,1379098175,1379098295,2,2,120
99894217@N02,6905,19,1379104136,1379104676,1,2,540
99961547@N00,6906,12,1462282851,1462283121,1,1,270
99987318@N03,6907,6,1424501689,1424501809,2,1,120
