userID,trajID,poiID,startTime,endTime,#photo,trajLen,poiDuration
10005149@N03,1,21,1273189220,1273189670,2,2,450
10005149@N03,1,19,1273196253,1273196673,1,2,420
10005149@N03,2,2,1273281442,1273281532,2,2,90
10005149@N03,2,4,1273291600,1273292500,1,2,900
100063617@N06,3,27,1450997221,1450998421,1,1,1200
10008488@N07,4,10,1353803001,1353803421,2,4,420
10008488@N07,4,14,1353805071,1353805191,2,4,120
10008488@N07,4,9,1353805944,1353806184,2,4,240
10008488@N07,4,27,1353816367,1353817567,2,4,1200
10008488@N07,5,23,1354149324,1354149414,1,1,90
10008488@N07,6,27,1354428271,1354429471,4,8,1200
10008488@N07,6,14,1354434439,1354434559,2,8,120
10008488@N07,6,15,1354435579,1354435759,2,8,180
10008488@N07,6,14,1354435843,1354435963,2,8,120
10008488@N07,6,15,1354436727,1354436907,2,8,180
10008488@N07,6,16,1354439014,1354439734,3,8,720
10008488@N07,6,18,1354439892,1354441692,2,8,1800
10008488@N07,6,27,1354445825,1354447025,13,8,1200
10019322@N03,7,16,1257065143,1257065863,1,1,720
10024384@N04,8,9,1263720566,1263720608,2,2,42
10024384@N04,8,16,1263720608,1263721328,1,2,720
10024384@N04,9,6,1299204515,1299204770,2,2,255
10024384@N04,9,2,1299204970,1299205060,1,2,90
10024384@N04,10,24,1367998824,1367999304,1,1,480
10024384@N04,11,27,1381740690,1381741890,4,1,1200
100346942@N08,12,27,1376898876,1376900076,1,1,1200
100354657@N04,13,27,1363422344,1363423544,1,1,1200
100363554@N07,14,27,1471729077,1471730277,1,1,1200
100436193@N03,15,20,1419285841,1419286921,3,4,1080
100436193@N03,15,4,1419300133,1419301033,2,4,900
100436193@N03,15,3,1419305479,1419305749,2,4,270
100436193@N03,15,17,1419315205,1419316585,1,4,1380
100448554@N06,16,14,1370860298,1370860322,2,3,24
100448554@N06,16,12,1370860322,1370860404,3,3,82
100448554@N06,16,13,1370860404,1370861004,1,3,600
100448554@N06,17,14,1370916583,1370916703,3,1,120
100448554@N06,18,27,1371063855,1371065055,2,1,1200
100448554@N06,19,27,1371108291,1371109491,1,1,1200
100448554@N06,20,14,1371180587,1371180707,2,3,120
100448554@N06,20,10,1371207566,1371207986,2,3,420
100448554@N06,20,14,1371215943,1371216063,1,3,120
100448554@N06,21,14,1371395012,1371395132,1,1,120
100448554@N06,22,14,1376723103,1376723223,12,1,120
100448554@N06,23,27,1376818230,1376819430,3,1,1200
100459519@N02,24,10,1430571542,1430571962,2,2,420
100459519@N02,24,14,1430575063,1430575183,1,2,120
100459519@N02,25,9,1462269575,1462269815,1,1,240
100459519@N02,26,27,1462312739,1462313939,1,1,1200
100459519@N02,27,26,1462460505,1462460685,1,1,180
100459519@N02,28,23,1462792291,1462792381,1,1,90
10047035@N00,29,16,1302118486,1302119206,22,1,720
100483258@N08,30,16,1407673826,1407674546,1,1,720
10048675@N02,31,26,1234302592,1234302772,3,1,180
10048675@N02,32,17,1234568662,1234570004,3,2,1342
10048675@N02,32,4,1234570004,1234570904,4,2,900
100506822@N02,33,27,1387666161,1387667361,1,1,1200
100506822@N02,34,15,1387696062,1387696242,3,1,180
100506822@N02,35,16,1388007949,1388008050,3,4,101
100506822@N02,35,14,1388008050,1388008170,5,4,120
100506822@N02,35,16,1388008499,1388009219,6,4,720
100506822@N02,35,14,1388009369,1388009489,12,4,120
100597270@N04,36,27,1430889471,1430890671,1,1,1200
100606614@N05,37,16,1406739929,1406740649,3,1,720
10061441@N03,38,3,1229532977,1229533247,2,1,270
100620414@N03,39,27,1461887277,1461888477,3,10,1200
100620414@N03,39,14,1461889222,1461889342,4,10,120
100620414@N03,39,10,1461891328,1461891748,5,10,420
100620414@N03,39,11,1461892174,1461892354,6,10,180
100620414@N03,39,3,1461895537,1461895807,2,10,270
100620414@N03,39,19,1461904107,1461904527,3,10,420
100620414@N03,39,20,1461904633,1461905713,2,10,1080
100620414@N03,39,27,1461906893,1461908093,13,10,1200
100620414@N03,39,14,1461926851,1461926971,3,10,120
100620414@N03,39,27,1461933034,1461934234,2,10,1200
100620414@N03,40,27,1467257231,1467258431,1,1,1200
100657680@N02,41,16,1383996109,1383996829,1,1,720
100657680@N02,42,16,1392462154,1392462874,1,1,720
100691062@N08,43,27,1403163483,1403164683,5,1,1200
100691062@N08,44,27,1403227687,1403228887,10,1,1200
100691062@N08,45,27,1403296202,1403297402,2,1,1200
100747900@N02,46,27,1322270664,1322271864,1,1,1200
100775193@N08,47,13,1386364147,1386364747,1,1,600
100775193@N08,48,27,1393227213,1393228413,1,1,1200
100775193@N08,49,14,1397600255,1397600375,2,2,120
100775193@N08,49,6,1397613439,1397613694,1,2,255
100775237@N03,50,17,1309442400,1309442400,2,3,0
100775237@N03,50,20,1309442400,1309442400,2,3,0
100775237@N03,50,27,1309442400,1309443600,1,3,1200
100775237@N03,51,17,1341064800,1341064800,3,2,0
100775237@N03,51,27,1341064800,1341066000,2,2,1200
100775237@N03,52,8,1372600800,1372600800,2,3,0
100775237@N03,52,18,1372600800,1372600800,2,3,0
100775237@N03,52,27,1372600800,1372602000,4,3,1200
100775237@N03,53,4,1373064754,1373065654,2,2,900
100775237@N03,53,27,1373078565,1373079765,2,2,1200
100775237@N03,54,17,1373285945,1373287325,2,2,1380
100775237@N03,54,27,1373290977,1373292177,1,2,1200
100775237@N03,55,27,1405584680,1405585812,2,3,1132
100775237@N03,55,14,1405585812,1405585932,2,3,120
100775237@N03,55,26,1405590389,1405590569,2,3,180
100775237@N03,56,27,1405680539,1405681739,1,1,1200
100775237@N03,57,9,1405900379,1405900619,3,6,240
100775237@N03,57,14,1405901957,1405902077,2,6,120
100775237@N03,57,9,1405902093,1405902333,2,6,240
100775237@N03,57,21,1405906221,1405906671,2,6,450
100775237@N03,57,20,1405909839,1405910919,2,6,1080
100775237@N03,57,17,1405911450,1405912830,1,6,1380
100822654@N07,58,10,1400800209,1400800378,3,8,169
100822654@N07,58,9,1400800378,1400800618,2,8,240
100822654@N07,58,10,1400800685,1400800772,2,8,87
100822654@N07,58,9,1400800772,1400801012,5,8,240
100822654@N07,58,21,1400823196,1400823646,3,8,450
100822654@N07,58,4,1400835334,1400836234,2,8,900
100822654@N07,58,27,1400839678,1400840878,4,8,1200
100822654@N07,58,14,1400847860,1400847980,1,8,120
100822654@N07,59,9,1401154720,1401154957,4,3,237
100822654@N07,59,19,1401154957,1401155187,2,3,230
100822654@N07,59,20,1401155187,1401156267,4,3,1080
10084809@N04,60,16,1459927510,1459928230,1,1,720
10084825@N03,61,26,1319170801,1319170981,2,1,180
10084825@N03,62,9,1319278736,1319278976,3,1,240
100948027@N07,63,15,1315117798,1315117978,2,5,180
100948027@N07,63,18,1315124664,1315124902,2,5,238
100948027@N07,63,13,1315124902,1315125502,3,5,600
100948027@N07,63,17,1315126610,1315127990,3,5,1380
100948027@N07,63,1,1315131370,1315131970,2,5,600
100948027@N07,64,9,1315454263,1315454326,2,2,63
100948027@N07,64,16,1315454326,1315455046,1,2,720
100948027@N07,65,22,1315697201,1315697801,2,1,600
101036843@N06,66,27,1392978519,1392979719,2,1,1200
10104201@N00,67,12,1416365010,1416365850,1,1,840
10104201@N00,68,17,1416452830,1416454210,1,1,1380
101044534@N02,69,2,1381057538,1381057628,1,1,90
101068170@N05,70,7,1372493796,1372493886,3,2,90
101068170@N05,70,8,1372494015,1372494135,1,2,120
101118128@N08,71,10,1446593686,1446594106,2,1,420
101195207@N02,72,27,1466375699,1466376899,2,4,1200
101195207@N02,72,6,1466382999,1466383254,3,4,255
101195207@N02,72,3,1466398969,1466399239,2,4,270
101195207@N02,72,2,1466410721,1466410811,1,4,90
101195207@N02,73,26,1467338964,1467339144,2,4,180
101195207@N02,73,6,1467351475,1467351616,3,4,141
101195207@N02,73,4,1467351616,1467352343,2,4,727
101195207@N02,73,27,1467352343,1467353543,2,4,1200
10120262@N06,74,27,1240780578,1240781778,3,1,1200
101256016@N07,75,27,1381888618,1381889818,19,3,1200
101256016@N07,75,14,1381902719,1381902839,35,3,120
101256016@N07,75,11,1381912641,1381912821,48,3,180
101324125@N05,76,14,1372914337,1372914457,2,4,120
101324125@N05,76,22,1372927735,1372928335,2,4,600
101324125@N05,76,26,1372929913,1372930093,4,4,180
101324125@N05,76,2,1372945147,1372945237,1,4,90
10135048@N06,77,2,1316494478,1316494568,1,1,90
10139125@N03,78,20,1345691303,1345692383,2,2,1080
10139125@N03,78,22,1345695322,1345695922,1,2,600
101402820@N02,79,17,1420336486,1420337866,2,3,1380
101402820@N02,79,20,1420344311,1420345391,3,3,1080
101402820@N02,79,18,1420351656,1420353456,1,3,1800
101445497@N05,80,10,1221974404,1221974824,2,3,420
101445497@N05,80,13,1221982916,1221983516,2,3,600
101445497@N05,80,27,1221990133,1221991333,1,3,1200
101445497@N05,81,27,1222158487,1222158839,2,4,352
101445497@N05,81,16,1222158839,1222159559,2,4,720
101445497@N05,81,17,1222179058,1222179510,2,4,452
101445497@N05,81,26,1222179510,1222179690,1,4,180
101445497@N05,82,16,1264330017,1264330737,1,1,720
101445497@N05,83,27,1316759711,1316760911,2,3,1200
101445497@N05,83,6,1316771264,1316771519,2,3,255
101445497@N05,83,16,1316777647,1316778367,1,3,720
101445497@N05,84,27,1353205446,1353206646,3,3,1200
101445497@N05,84,7,1353219477,1353219567,2,3,90
101445497@N05,84,17,1353230477,1353231857,1,3,1380
101445497@N05,85,2,1353470935,1353471025,1,1,90
101445497@N05,86,16,1369707750,1369708470,2,5,720
101445497@N05,86,26,1369711090,1369711270,2,5,180
101445497@N05,86,7,1369734986,1369735076,2,5,90
101445497@N05,86,9,1369745318,1369745558,2,5,240
101445497@N05,86,4,1369749692,1369750592,1,5,900
101445497@N05,87,27,1380948276,1380949476,3,2,1200
101445497@N05,87,14,1380953172,1380953292,1,2,120
101445497@N05,88,27,1401748483,1401749683,2,2,1200
101445497@N05,88,14,1401750767,1401750887,3,2,120
101445497@N05,89,16,1401788752,1401789472,9,2,720
101445497@N05,89,27,1401792404,1401793604,1,2,1200
101445497@N05,90,24,1410758329,1410758809,2,3,480
101445497@N05,90,10,1410767416,1410767836,3,3,420
101445497@N05,90,27,1410783776,1410784976,1,3,1200
101445497@N05,91,16,1432971116,1432971728,2,10,612
101445497@N05,91,19,1432971728,1432972148,2,10,420
101445497@N05,91,22,1432973596,1432974099,2,10,503
101445497@N05,91,13,1432974099,1432974699,5,10,600
101445497@N05,91,15,1432977724,1432977870,2,10,146
101445497@N05,91,14,1432977870,1432977990,2,10,120
101445497@N05,91,17,1432978135,1432979515,2,10,1380
101445497@N05,91,3,1432979729,1432979775,2,10,46
101445497@N05,91,2,1432979775,1432979865,3,10,90
101445497@N05,91,4,1432983140,1432984040,1,10,900
101445497@N05,92,11,1433211242,1433211422,2,3,180
101445497@N05,92,17,1433213207,1433214587,2,3,1380
101445497@N05,92,27,1433216480,1433217680,2,3,1200
101445497@N05,93,14,1464593525,1464593645,2,2,120
101445497@N05,93,20,1464604427,1464605507,1,2,1080
101445497@N05,94,22,1464851405,1464852005,2,3,600
101445497@N05,94,5,1464855730,1464856450,2,3,720
101445497@N05,94,17,1464858891,1464860271,1,3,1380
101473404@N07,95,1,1388525190,1388525790,1,1,600
101473404@N07,96,14,1388656314,1388656434,2,3,120
101473404@N07,96,2,1388660574,1388660664,2,3,90
101473404@N07,96,27,1388667866,1388669066,1,3,1200
101473404@N07,97,3,1453724106,1453724343,2,2,237
101473404@N07,97,14,1453724343,1453724463,1,2,120
10152427@N08,98,26,1229874074,1229874254,1,1,180
10152427@N08,99,26,1239503886,1239504066,1,1,180
10152427@N08,100,26,1239624622,1239624802,2,1,180
10152427@N08,101,26,1261652609,1261652789,1,1,180
10152427@N08,102,26,1302745029,1302745209,1,1,180
10156308@N03,103,8,1418814998,1418815118,1,1,120
10156308@N03,104,24,1418863338,1418863818,1,1,480
10156308@N03,105,10,1419075046,1419075466,1,1,420
10156308@N03,106,27,1419160476,1419161676,3,4,1200
10156308@N03,106,23,1419162447,1419162537,2,4,90
10156308@N03,106,22,1419164113,1419164713,2,4,600
10156308@N03,106,27,1419166413,1419167613,3,4,1200
101593101@N02,107,27,1427497269,1427498469,1,1,1200
101593101@N02,108,13,1458730557,1458731157,2,2,600
101593101@N02,108,27,1458733140,1458734340,1,2,1200
101593101@N02,109,27,1458796949,1458798149,2,3,1200
101593101@N02,109,16,1458799868,1458800588,2,3,720
101593101@N02,109,10,1458802416,1458802836,1,3,420
101682305@N06,110,27,1363395864,1363397064,5,1,1200
101682305@N06,111,27,1363480600,1363481800,3,1,1200
101682305@N06,112,27,1364521814,1364523014,2,1,1200
10173248@N05,113,27,1299979390,1299980590,1,1,1200
10175710@N03,114,27,1374020581,1374021781,2,5,1200
10175710@N03,114,15,1374030391,1374030571,2,5,180
10175710@N03,114,27,1374033678,1374034878,3,5,1200
10175710@N03,114,16,1374039803,1374040523,4,5,720
10175710@N03,114,27,1374076224,1374077424,3,5,1200
101766828@N04,115,5,1301883619,1301883966,2,4,347
101766828@N04,115,9,1301883966,1301884206,2,4,240
101766828@N04,115,18,1301892395,1301894195,4,4,1800
101766828@N04,115,27,1301901272,1301902472,2,4,1200
10182842@N08,116,1,1214800805,1214801405,2,5,600
10182842@N08,116,4,1214802356,1214803256,2,5,900
10182842@N08,116,22,1214806049,1214806649,2,5,600
10182842@N08,116,16,1214806695,1214807415,2,5,720
10182842@N08,116,27,1214812976,1214814176,1,5,1200
10183691@N07,117,12,1236507731,1236508571,11,4,840
10183691@N07,117,5,1236513455,1236514175,2,4,720
10183691@N07,117,16,1236519971,1236520025,3,4,54
10183691@N07,117,4,1236520025,1236520925,1,4,900
101878598@N03,118,27,1455663227,1455664427,1,1,1200
101878598@N03,119,16,1455692379,1455693099,2,3,720
101878598@N03,119,14,1455694040,1455694056,2,3,16
101878598@N03,119,15,1455694056,1455694236,1,3,180
101924327@N08,120,15,1416486814,1416486994,1,1,180
10196023@N00,121,14,1221477770,1221477890,1,1,120
10196023@N00,122,27,1343150268,1343151468,1,1,1200
10196023@N00,123,27,1343269130,1343270330,1,1,1200
10196023@N00,124,22,1401589456,1401590056,1,1,600
10196023@N00,125,8,1422173266,1422173386,1,1,120
10215206@N08,126,16,1277619700,1277620420,1,1,720
10215206@N08,127,16,1277952807,1277953527,1,1,720
102284959@N03,128,27,1378157833,1378159033,2,3,1200
102284959@N03,128,16,1378159617,1378160337,2,3,720
102284959@N03,128,13,1378179665,1378180265,1,3,600
102284959@N03,129,22,1378770362,1378770962,1,1,600
102284959@N03,130,16,1380404101,1380404331,2,3,230
102284959@N03,130,27,1380404331,1380404507,2,3,176
102284959@N03,130,16,1380404507,1380405227,3,3,720
102284959@N03,131,20,1380985944,1380985967,2,3,23
102284959@N03,131,13,1380985967,1380986113,4,3,146
102284959@N03,131,16,1380986113,1380986833,1,3,720
102284959@N03,132,27,1398445340,1398446540,1,1,1200
102284959@N03,133,13,1442808517,1442809117,1,1,600
102284959@N03,134,13,1443537488,1443538088,2,2,600
102284959@N03,134,15,1443540285,1443540465,1,2,180
102284959@N03,135,22,1443623455,1443624055,2,3,600
102284959@N03,135,18,1443625480,1443627280,2,3,1800
102284959@N03,135,16,1443631259,1443631979,1,3,720
102284959@N03,136,16,1458544061,1458544781,1,1,720
10250618@N06,137,16,1207660115,1207660835,1,1,720
10259875@N03,138,11,1231421252,1231421432,2,17,180
10259875@N03,138,16,1231421464,1231422184,2,17,720
10259875@N03,138,27,1231426970,1231428170,2,17,1200
10259875@N03,138,26,1231431604,1231431784,2,17,180
10259875@N03,138,16,1231440616,1231441336,4,17,720
10259875@N03,138,24,1231446352,1231446832,2,17,480
10259875@N03,138,20,1231447142,1231448222,2,17,1080
10259875@N03,138,27,1231448368,1231449568,5,17,1200
10259875@N03,138,17,1231454023,1231455403,3,17,1380
10259875@N03,138,11,1231458713,1231458893,3,17,180
10259875@N03,138,23,1231465125,1231465215,3,17,90
10259875@N03,138,19,1231469684,1231469749,2,17,65
10259875@N03,138,11,1231469749,1231469929,2,17,180
10259875@N03,138,27,1231473485,1231474555,2,17,1070
10259875@N03,138,14,1231474555,1231474675,2,17,120
10259875@N03,138,16,1231475693,1231476413,2,17,720
10259875@N03,138,27,1231491090,1231492290,1,17,1200
10259875@N03,139,14,1239688279,1239688399,1,1,120
10259875@N03,140,27,1262469290,1262470490,5,10,1200
10259875@N03,140,5,1262471114,1262471834,2,10,720
10259875@N03,140,1,1262473018,1262473618,2,10,600
10259875@N03,140,16,1262475558,1262476278,2,10,720
10259875@N03,140,14,1262478370,1262478490,2,10,120
10259875@N03,140,9,1262478659,1262478899,2,10,240
10259875@N03,140,8,1262480281,1262480401,2,10,120
10259875@N03,140,14,1262480606,1262480659,2,10,53
10259875@N03,140,16,1262480659,1262480991,2,10,332
10259875@N03,140,27,1262480991,1262482191,4,10,1200
10259875@N03,141,27,1262554504,1262555704,4,10,1200
10259875@N03,141,1,1262556534,1262557134,2,10,600
10259875@N03,141,27,1262573402,1262573683,2,10,281
10259875@N03,141,16,1262573683,1262573751,2,10,68
10259875@N03,141,17,1262573751,1262575131,4,10,1380
10259875@N03,141,26,1262579080,1262579260,2,10,180
10259875@N03,141,17,1262579427,1262579894,2,10,467
10259875@N03,141,19,1262579894,1262580048,2,10,154
10259875@N03,141,17,1262580048,1262580839,2,10,791
10259875@N03,141,27,1262580839,1262582039,1,10,1200
10259875@N03,142,19,1262824800,1262825220,3,23,420
10259875@N03,142,13,1262825636,1262826236,6,23,600
10259875@N03,142,20,1262827030,1262828110,2,23,1080
10259875@N03,142,23,1262828537,1262828627,2,23,90
10259875@N03,142,26,1262828717,1262828897,2,23,180
10259875@N03,142,16,1262830246,1262830966,4,23,720
10259875@N03,142,14,1262832676,1262832796,5,23,120
10259875@N03,142,12,1262834687,1262834710,2,23,23
10259875@N03,142,16,1262834710,1262835278,2,23,568
10259875@N03,142,14,1262835278,1262835398,2,23,120
10259875@N03,142,19,1262837300,1262837720,4,23,420
10259875@N03,142,27,1262838893,1262839172,2,23,279
10259875@N03,142,4,1262839172,1262839395,2,23,223
10259875@N03,142,1,1262839395,1262839995,2,23,600
10259875@N03,142,14,1262845110,1262845230,2,23,120
10259875@N03,142,9,1262845509,1262845649,2,23,140
10259875@N03,142,14,1262845649,1262845769,4,23,120
10259875@N03,142,16,1262846627,1262847347,2,23,720
10259875@N03,142,14,1262847780,1262847900,4,23,120
10259875@N03,142,9,1262848899,1262849139,2,23,240
10259875@N03,142,3,1262850421,1262850691,2,23,270
10259875@N03,142,4,1262850796,1262851696,2,23,900
10259875@N03,142,27,1262852039,1262853239,3,23,1200
10259875@N03,143,27,1274091749,1274092949,5,1,1200
10259875@N03,144,27,1274144614,1274145814,2,21,1200
10259875@N03,144,16,1274145934,1274146051,2,21,117
10259875@N03,144,17,1274146051,1274147431,2,21,1380
10259875@N03,144,19,1274147603,1274148023,2,21,420
10259875@N03,144,18,1274151102,1274152209,2,21,1107
10259875@N03,144,24,1274152209,1274152421,2,21,212
10259875@N03,144,23,1274152421,1274152511,2,21,90
10259875@N03,144,19,1274157144,1274157564,2,21,420
10259875@N03,144,17,1274159440,1274159602,2,21,162
10259875@N03,144,21,1274159602,1274160052,2,21,450
10259875@N03,144,15,1274161836,1274162016,2,21,180
10259875@N03,144,16,1274162182,1274162892,2,21,710
10259875@N03,144,14,1274162892,1274162990,2,21,98
10259875@N03,144,9,1274162990,1274163230,2,21,240
10259875@N03,144,1,1274168773,1274169373,2,21,600
10259875@N03,144,3,1274170747,1274171017,2,21,270
10259875@N03,144,8,1274174327,1274174447,2,21,120
10259875@N03,144,14,1274175424,1274175544,2,21,120
10259875@N03,144,9,1274176976,1274177063,2,21,87
10259875@N03,144,17,1274177063,1274178169,2,21,1106
10259875@N03,144,27,1274178169,1274179369,5,21,1200
10259875@N03,145,16,1302991403,1302992123,2,2,720
10259875@N03,145,27,1302995233,1302996433,1,2,1200
10259875@N03,146,27,1303161639,1303162839,2,9,1200
10259875@N03,146,1,1303185317,1303185917,2,9,600
10259875@N03,146,9,1303201346,1303201451,2,9,105
10259875@N03,146,14,1303201451,1303201571,2,9,120
10259875@N03,146,17,1303201952,1303202604,2,9,652
10259875@N03,146,20,1303202604,1303203684,2,9,1080
10259875@N03,146,27,1303203744,1303204471,2,9,727
10259875@N03,146,19,1303204471,1303204891,2,9,420
10259875@N03,146,16,1303204934,1303205654,1,9,720
10259875@N03,147,27,1322199226,1322200063,4,10,837
10259875@N03,147,17,1322200063,1322201293,2,10,1230
10259875@N03,147,20,1322201293,1322201963,2,10,670
10259875@N03,147,27,1322201963,1322203163,2,10,1200
10259875@N03,147,14,1322204010,1322204130,3,10,120
10259875@N03,147,9,1322204622,1322204862,2,10,240
10259875@N03,147,16,1322206114,1322206834,2,10,720
10259875@N03,147,14,1322217430,1322217550,2,10,120
10259875@N03,147,15,1322218212,1322218392,2,10,180
10259875@N03,147,27,1322220836,1322222036,1,10,1200
10259875@N03,148,27,1364776226,1364777426,8,13,1200
10259875@N03,148,17,1364780392,1364781544,2,13,1152
10259875@N03,148,20,1364781544,1364782624,2,13,1080
10259875@N03,148,25,1364786843,1364787593,2,13,750
10259875@N03,148,17,1364787899,1364787998,2,13,99
10259875@N03,148,16,1364787998,1364788214,2,13,216
10259875@N03,148,10,1364788214,1364788634,5,13,420
10259875@N03,148,3,1364799467,1364799737,2,13,270
10259875@N03,148,2,1364800211,1364800301,2,13,90
10259875@N03,148,9,1364800579,1364800819,4,13,240
10259875@N03,148,12,1364801791,1364802631,2,13,840
10259875@N03,148,14,1364804279,1364804399,2,13,120
10259875@N03,148,27,1364812040,1364813240,2,13,1200
10259875@N03,149,10,1392596672,1392597092,2,19,420
10259875@N03,149,27,1392603848,1392605048,2,19,1200
10259875@N03,149,12,1392612773,1392613613,2,19,840
10259875@N03,149,23,1392617491,1392617581,4,19,90
10259875@N03,149,19,1392619865,1392620285,2,19,420
10259875@N03,149,22,1392620939,1392621539,2,19,600
10259875@N03,149,10,1392621760,1392622180,2,19,420
10259875@N03,149,15,1392622533,1392622713,2,19,180
10259875@N03,149,17,1392626752,1392628132,2,19,1380
10259875@N03,149,14,1392628447,1392628567,3,19,120
10259875@N03,149,10,1392630782,1392631202,3,19,420
10259875@N03,149,7,1392631911,1392632001,2,19,90
10259875@N03,149,8,1392632217,1392632337,2,19,120
10259875@N03,149,9,1392633653,1392633893,2,19,240
10259875@N03,149,10,1392634413,1392634833,2,19,420
10259875@N03,149,14,1392635528,1392635648,5,19,120
10259875@N03,149,5,1392638164,1392638884,3,19,720
10259875@N03,149,25,1392641226,1392641976,2,19,750
10259875@N03,149,15,1392643024,1392643204,2,19,180
10259875@N03,150,27,1428608724,1428609924,5,17,1200
10259875@N03,150,15,1428610784,1428610964,3,17,180
10259875@N03,150,10,1428612514,1428612934,3,17,420
10259875@N03,150,7,1428613298,1428613388,2,17,90
10259875@N03,150,9,1428614197,1428614437,2,17,240
10259875@N03,150,17,1428616846,1428618226,3,17,1380
10259875@N03,150,2,1428620624,1428620714,2,17,90
10259875@N03,150,7,1428621607,1428621697,2,17,90
10259875@N03,150,10,1428626619,1428627039,2,17,420
10259875@N03,150,27,1428653264,1428654302,3,17,1038
10259875@N03,150,25,1428654302,1428655052,2,17,750
10259875@N03,150,19,1428655671,1428656091,2,17,420
10259875@N03,150,17,1428657854,1428659234,2,17,1380
10259875@N03,150,4,1428661101,1428662001,5,17,900
10259875@N03,150,23,1428666073,1428666163,3,17,90
10259875@N03,150,26,1428666508,1428666688,2,17,180
10259875@N03,150,21,1428667607,1428668057,1,17,450
10295241@N02,151,9,1235899820,1235900060,1,1,240
10295241@N02,152,6,1236152000,1236152255,5,2,255
10295241@N02,152,9,1236156636,1236156876,1,2,240
10295241@N02,153,27,1447035111,1447036311,2,1,1200
103400918@N03,154,25,1370731444,1370732194,3,3,750
103400918@N03,154,16,1370742960,1370743680,3,3,720
103400918@N03,154,27,1370754483,1370755683,1,3,1200
10350193@N07,155,26,1224890040,1224890220,1,1,180
10350193@N07,156,20,1289054138,1289055218,1,1,1080
10350193@N07,157,16,1298703774,1298704494,1,1,720
103690791@N02,158,15,1356325807,1356325987,1,1,180
103845490@N03,159,13,1381743307,1381743907,1,1,600
103845490@N03,160,16,1391407213,1391407933,1,1,720
10386262@N00,161,27,1289345457,1289346657,2,2,1200
10386262@N00,161,1,1289360553,1289361153,1,2,600
104019882@N04,162,16,1463687354,1463687363,3,4,9
104019882@N04,162,21,1463687363,1463687368,2,4,5
104019882@N04,162,12,1463687368,1463687376,3,4,8
104019882@N04,162,16,1463687376,1463688096,1,4,720
10403093@N06,163,27,1339195530,1339196730,1,1,1200
10403093@N06,164,20,1353288237,1353289317,1,1,1080
10403093@N06,165,27,1402094437,1402095637,4,5,1200
10403093@N06,165,9,1402097835,1402098075,7,5,240
10403093@N06,165,3,1402099367,1402099637,2,5,270
10403093@N06,165,9,1402100463,1402100703,2,5,240
10403093@N06,165,10,1402109439,1402109859,8,5,420
10414404@N08,166,19,1405895350,1405895770,1,1,420
104174605@N06,167,27,1403770755,1403771955,1,1,1200
10420619@N06,168,27,1353913876,1353915076,10,1,1200
10427995@N00,169,26,1450625754,1450625934,1,1,180
10429949@N00,170,27,1469663274,1469664474,1,1,1200
10485077@N06,171,13,1202774460,1202774460,3,2,0
10485077@N06,171,25,1202774460,1202775210,2,2,750
104911618@N08,172,6,1433589008,1433589263,12,8,255
104911618@N08,172,9,1433590753,1433590993,4,8,240
104911618@N08,172,14,1433593420,1433593540,6,8,120
104911618@N08,172,8,1433594276,1433594352,2,8,76
104911618@N08,172,12,1433594352,1433595031,2,8,679
104911618@N08,172,14,1433595031,1433595151,3,8,120
104911618@N08,172,3,1433596402,1433596672,5,8,270
104911618@N08,172,14,1433599425,1433599545,1,8,120
10494136@N02,173,18,1388026196,1388027996,1,1,1800
10495641@N00,174,14,1336201366,1336201486,2,2,120
10495641@N00,174,7,1336203684,1336203774,1,2,90
10495641@N00,175,7,1336263490,1336263580,1,1,90
10500812@N04,176,27,1326791840,1326793040,1,1,1200
105156445@N06,177,27,1408231102,1408232302,4,6,1200
105156445@N06,177,14,1408233585,1408233705,3,6,120
105156445@N06,177,8,1408235827,1408235947,3,6,120
105156445@N06,177,15,1408239526,1408239545,2,6,19
105156445@N06,177,17,1408239545,1408239553,2,6,8
105156445@N06,177,15,1408239553,1408239733,2,6,180
105156445@N06,178,27,1408321663,1408322863,3,7,1200
105156445@N06,178,23,1408323028,1408323118,3,7,90
105156445@N06,178,1,1408323756,1408324356,2,7,600
105156445@N06,178,2,1408325315,1408325405,4,7,90
105156445@N06,178,4,1408326273,1408327173,2,7,900
105156445@N06,178,6,1408331311,1408331566,2,7,255
105156445@N06,178,3,1408337764,1408338034,2,7,270
10529536@N05,179,16,1299117944,1299118664,3,3,720
10529536@N05,179,17,1299128979,1299130359,4,3,1380
10529536@N05,179,16,1299142552,1299143272,5,3,720
10529536@N05,180,16,1299400085,1299400805,2,2,720
10529536@N05,180,27,1299413606,1299414806,3,2,1200
10540666@N07,181,27,1292207722,1292208922,1,1,1200
10570686@N02,182,14,1268446742,1268446862,10,1,120
105763347@N06,183,10,1356937802,1356938222,1,1,420
10577359@N08,184,17,1299209822,1299211202,1,1,1380
10577359@N08,185,18,1309231425,1309233225,1,1,1800
10583070@N05,186,27,1228474970,1228475410,10,6,440
10583070@N05,186,2,1228475410,1228475500,12,6,90
10583070@N05,186,18,1228481520,1228483320,37,6,1800
10583070@N05,186,17,1228483337,1228483706,2,6,369
10583070@N05,186,4,1228483706,1228484606,2,6,900
10583070@N05,186,27,1228486656,1228487856,6,6,1200
106041775@N07,187,16,1448254605,1448255325,1,1,720
106045902@N02,188,27,1366505831,1366507031,1,1,1200
10606860@N02,189,27,1313455941,1313457141,6,12,1200
10606860@N02,189,4,1313470563,1313471184,15,12,621
10606860@N02,189,17,1313471184,1313471237,2,12,53
10606860@N02,189,4,1313471237,1313472137,7,12,900
10606860@N02,189,14,1313472383,1313472503,2,12,120
10606860@N02,189,18,1313478892,1313478996,3,12,104
10606860@N02,189,20,1313478996,1313480076,16,12,1080
10606860@N02,189,24,1313480573,1313480616,2,12,43
10606860@N02,189,25,1313480616,1313481366,2,12,750
10606860@N02,189,16,1313486874,1313487158,4,12,284
10606860@N02,189,17,1313487158,1313488137,6,12,979
10606860@N02,189,4,1313488137,1313489037,2,12,900
10617321@N00,190,23,1464516616,1464516706,1,1,90
106331106@N07,191,27,1432237986,1432239186,1,1,1200
106474616@N07,192,6,1382550775,1382550831,2,2,56
106474616@N07,192,9,1382550831,1382551071,1,2,240
106558608@N06,193,15,1463012102,1463012120,3,8,18
106558608@N06,193,12,1463012120,1463012125,2,8,5
106558608@N06,193,15,1463012125,1463012213,2,8,88
106558608@N06,193,17,1463012213,1463012222,2,8,9
106558608@N06,193,15,1463012222,1463012267,2,8,45
106558608@N06,193,12,1463012267,1463013107,2,8,840
106558608@N06,193,10,1463038416,1463038836,10,8,420
106558608@N06,193,4,1463047898,1463048798,2,8,900
106558608@N06,194,27,1463092797,1463093997,2,4,1200
106558608@N06,194,21,1463096929,1463097379,2,4,450
106558608@N06,194,18,1463101478,1463103278,2,4,1800
106558608@N06,194,27,1463114789,1463115989,46,4,1200
106558608@N06,195,27,1463441144,1463441940,6,4,796
106558608@N06,195,3,1463441940,1463442210,4,4,270
106558608@N06,195,12,1463443066,1463443906,2,4,840
106558608@N06,195,14,1463449185,1463449305,3,4,120
10670886@N08,196,8,1397611093,1397611213,1,1,120
10673595@N00,197,27,1463276943,1463278143,1,1,1200
10687935@N04,198,16,1336214428,1336215148,1,1,720
106918343@N02,199,27,1413158403,1413159603,32,3,1200
106918343@N02,199,16,1413161017,1413161737,3,3,720
106918343@N02,199,27,1413163151,1413164351,18,3,1200
106980455@N06,200,7,1384213061,1384213151,2,2,90
106980455@N06,200,27,1384241002,1384242202,1,2,1200
10703707@N07,201,27,1320440623,1320441823,6,4,1200
10703707@N07,201,9,1320476584,1320476824,2,4,240
10703707@N07,201,18,1320479204,1320479490,2,4,286
10703707@N07,201,17,1320479490,1320480870,3,4,1380
107434985@N05,202,27,1368353353,1368354553,1,1,1200
10766128@N07,203,9,1194925962,1194926202,3,3,240
10766128@N07,203,15,1194927674,1194927854,2,3,180
10766128@N07,203,24,1194929087,1194929567,1,3,480
10766128@N07,204,27,1195860439,1195861639,3,8,1200
10766128@N07,204,6,1195861863,1195862118,2,8,255
10766128@N07,204,3,1195866794,1195867064,2,8,270
10766128@N07,204,9,1195875894,1195876134,3,8,240
10766128@N07,204,18,1195881858,1195883658,3,8,1800
10766128@N07,204,15,1195886825,1195887005,2,8,180
10766128@N07,204,14,1195887393,1195887513,2,8,120
10766128@N07,204,4,1195896330,1195897230,2,8,900
10774763@N05,205,27,1251968226,1251968961,3,15,735
10774763@N05,205,16,1251968961,1251969059,3,15,98
10774763@N05,205,13,1251969059,1251969659,4,15,600
10774763@N05,205,17,1251970489,1251970760,2,15,271
10774763@N05,205,20,1251970760,1251971840,5,15,1080
10774763@N05,205,19,1251972213,1251972633,3,15,420
10774763@N05,205,16,1251974688,1251974739,2,15,51
10774763@N05,205,9,1251974739,1251974786,2,15,47
10774763@N05,205,8,1251974786,1251974906,5,15,120
10774763@N05,205,6,1251975303,1251975442,3,15,139
10774763@N05,205,1,1251975442,1251975518,3,15,76
10774763@N05,205,5,1251975518,1251975946,6,15,428
10774763@N05,205,3,1251975946,1251976216,3,15,270
10774763@N05,205,22,1251977203,1251977803,2,15,600
10774763@N05,205,21,1251978255,1251978705,3,15,450
10782871@N00,206,14,1399789394,1399789514,2,1,120
107853262@N02,207,27,1403484646,1403485846,5,3,1200
107853262@N02,207,11,1403500750,1403500930,13,3,180
107853262@N02,207,27,1403521314,1403522514,4,3,1200
107905375@N06,208,10,1454989101,1454989521,1,1,420
107905375@N06,209,11,1455065347,1455065527,2,9,180
107905375@N06,209,2,1455075967,1455076057,4,9,90
107905375@N06,209,23,1455094104,1455094118,2,9,14
107905375@N06,209,26,1455094118,1455094298,2,9,180
107905375@N06,209,21,1455095365,1455095815,2,9,450
107905375@N06,209,22,1455106460,1455106746,2,9,286
107905375@N06,209,15,1455106746,1455106926,6,9,180
107905375@N06,209,10,1455107365,1455107785,2,9,420
107905375@N06,209,27,1455109737,1455110937,2,9,1200
10857883@N05,210,19,1271145965,1271146385,7,4,420
10857883@N05,210,18,1271146813,1271147447,3,4,634
10857883@N05,210,19,1271147447,1271147867,2,4,420
10857883@N05,210,16,1271152026,1271152746,1,4,720
10858077@N00,211,15,1207093274,1207093454,3,3,180
10858077@N00,211,4,1207098926,1207099826,3,3,900
10858077@N00,211,6,1207101000,1207101255,2,3,255
108611835@N05,212,27,1383559285,1383560485,1,1,1200
10871340@N02,213,3,1361674183,1361674453,2,3,270
10871340@N02,213,15,1361691463,1361691643,2,3,180
10871340@N02,213,16,1361694782,1361695502,1,3,720
108906145@N05,214,17,1395135523,1395136903,1,1,1380
108918961@N02,215,18,1428308266,1428310066,2,2,1800
108918961@N02,215,4,1428312122,1428313022,1,2,900
10899502@N05,216,2,1271818768,1271818858,1,1,90
10910455@N04,217,16,1320471304,1320472024,1,1,720
10925918@N03,218,9,1277162106,1277162346,1,1,240
10925918@N03,219,16,1277778674,1277779394,2,2,720
10925918@N03,219,18,1277802235,1277804035,1,2,1800
10925918@N03,220,27,1362384708,1362385908,1,1,1200
10925918@N03,221,8,1362437865,1362437985,2,10,120
10925918@N03,221,27,1362439054,1362439805,2,10,751
10925918@N03,221,19,1362439805,1362440225,2,10,420
10925918@N03,221,20,1362443318,1362444398,2,10,1080
10925918@N03,221,8,1362447105,1362447225,2,10,120
10925918@N03,221,9,1362450618,1362450858,3,10,240
10925918@N03,221,21,1362456092,1362456542,2,10,450
10925918@N03,221,23,1362457442,1362457532,2,10,90
10925918@N03,221,16,1362466999,1362467719,2,10,720
10925918@N03,221,10,1362474858,1362475278,1,10,420
109402089@N08,222,16,1381720607,1381721327,1,1,720
109402089@N08,223,26,1382691012,1382691192,1,1,180
10944271@N07,224,22,1307507635,1307508235,1,1,600
109492309@N03,225,16,1385686604,1385687324,2,1,720
109511520@N03,226,14,1431898305,1431898425,2,1,120
109554486@N07,227,27,1384207787,1384208880,2,19,1093
109554486@N07,227,14,1384208880,1384209000,2,19,120
109554486@N07,227,16,1384209418,1384210138,5,19,720
109554486@N07,227,15,1384212410,1384212590,3,19,180
109554486@N07,227,10,1384218502,1384218922,2,19,420
109554486@N07,227,9,1384223104,1384223344,2,19,240
109554486@N07,227,6,1384223491,1384223746,5,19,255
109554486@N07,227,14,1384231737,1384231857,6,19,120
109554486@N07,227,16,1384237056,1384237476,3,19,420
109554486@N07,227,14,1384237476,1384237586,3,19,110
109554486@N07,227,16,1384237586,1384237827,2,19,241
109554486@N07,227,14,1384237827,1384237947,4,19,120
109554486@N07,227,16,1384239016,1384239058,4,19,42
109554486@N07,227,14,1384239058,1384239178,5,19,120
109554486@N07,227,16,1384242373,1384242989,4,19,616
109554486@N07,227,14,1384242989,1384243109,2,19,120
109554486@N07,227,16,1384243227,1384243232,2,19,5
109554486@N07,227,14,1384243232,1384243352,4,19,120
109554486@N07,227,21,1384247399,1384247849,1,19,450
109702501@N02,228,4,1449921717,1449922617,1,1,900
10983978@N03,229,19,1207570183,1207570603,1,1,420
10983978@N03,230,26,1218090353,1218090533,1,1,180
10983978@N03,231,19,1220238152,1220238572,2,3,420
10983978@N03,231,17,1220241198,1220241654,2,3,456
10983978@N03,231,27,1220241654,1220242854,1,3,1200
10983978@N03,232,20,1227673390,1227674470,1,1,1080
10983978@N03,233,16,1230542992,1230543712,3,1,720
10983978@N03,234,18,1230606971,1230608771,1,1,1800
10983978@N03,235,19,1257239175,1257239595,1,1,420
10983978@N03,236,16,1270622471,1270623191,1,1,720
10983978@N03,237,9,1278844526,1278844766,1,1,240
10983978@N03,238,16,1283005131,1283005851,1,1,720
10983978@N03,239,22,1292080623,1292081223,1,1,600
10983978@N03,240,18,1292112476,1292114276,1,1,1800
10983978@N03,241,1,1292942813,1292943262,2,2,449
10983978@N03,241,8,1292943262,1292943382,2,2,120
10983978@N03,242,1,1294139474,1294139751,4,3,277
10983978@N03,242,19,1294139751,1294140171,2,3,420
10983978@N03,242,15,1294141502,1294141682,1,3,180
10983978@N03,243,1,1300885200,1300885800,2,1,600
10983978@N03,244,4,1307714400,1307714400,2,4,0
10983978@N03,244,16,1307714400,1307714400,5,4,0
10983978@N03,244,21,1307714400,1307714400,2,4,0
10983978@N03,244,27,1307714400,1307715600,1,4,1200
10989907@N07,245,8,1385949148,1385949268,4,7,120
10989907@N07,245,24,1385964882,1385965038,2,7,156
10989907@N07,245,23,1385965038,1385965128,2,7,90
10989907@N07,245,17,1385969116,1385970496,2,7,1380
10989907@N07,245,21,1385983688,1385984010,3,7,322
10989907@N07,245,1,1385984010,1385984068,2,7,58
10989907@N07,245,2,1385984068,1385984158,2,7,90
10989907@N07,246,27,1386202006,1386203206,5,5,1200
10989907@N07,246,4,1386223824,1386224724,2,5,900
10989907@N07,246,16,1386229098,1386229818,2,5,720
10989907@N07,246,17,1386245151,1386246531,2,5,1380
10989907@N07,246,27,1386246741,1386247941,1,5,1200
10989907@N07,247,23,1417232649,1417232739,1,1,90
109920749@N03,248,9,1409715785,1409716025,2,3,240
109920749@N03,248,19,1409729350,1409729770,2,3,420
109920749@N03,248,14,1409737522,1409737642,1,3,120
11011638@N02,249,27,1400914838,1400916038,4,1,1200
11011638@N02,250,27,1401325463,1401326663,1,1,1200
11014059@N02,251,5,1210790541,1210791261,2,2,720
11014059@N02,251,9,1210795173,1210795413,1,2,240
110166673@N02,252,14,1385251106,1385251226,6,11,120
110166673@N02,252,4,1385254592,1385255492,6,11,900
110166673@N02,252,2,1385257188,1385257278,2,11,90
110166673@N02,252,17,1385265577,1385265640,2,11,63
110166673@N02,252,13,1385265640,1385265866,3,11,226
110166673@N02,252,18,1385265866,1385267666,4,11,1800
110166673@N02,252,2,1385280507,1385280597,3,11,90
110166673@N02,252,1,1385281077,1385281677,5,11,600
110166673@N02,252,2,1385281748,1385281838,2,11,90
110166673@N02,252,7,1385282841,1385282931,3,11,90
110166673@N02,252,9,1385289117,1385289357,4,11,240
110166673@N02,253,14,1385625605,1385625725,4,2,120
110166673@N02,253,16,1385625951,1385626671,11,2,720
11017709@N07,254,16,1318652829,1318653549,2,3,720
11017709@N07,254,22,1318656742,1318657039,2,3,297
11017709@N07,254,21,1318657039,1318657489,1,3,450
110223705@N07,255,27,1463784527,1463785459,10,45,932
110223705@N07,255,16,1463785459,1463785723,16,45,264
110223705@N07,255,14,1463785723,1463785843,10,45,120
110223705@N07,255,9,1463785898,1463785998,6,45,100
110223705@N07,255,14,1463785998,1463786118,2,45,120
110223705@N07,255,10,1463786131,1463786551,2,45,420
110223705@N07,255,9,1463789585,1463789825,2,45,240
110223705@N07,255,15,1463789900,1463790080,5,45,180
110223705@N07,255,13,1463791533,1463792133,3,45,600
110223705@N07,255,9,1463792606,1463792846,6,45,240
110223705@N07,255,10,1463794218,1463794638,2,45,420
110223705@N07,255,14,1463795969,1463796089,3,45,120
110223705@N07,255,16,1463796574,1463797294,2,45,720
110223705@N07,255,27,1463800230,1463801430,3,45,1200
110223705@N07,255,25,1463802070,1463802820,5,45,750
110223705@N07,255,17,1463806764,1463806798,2,45,34
110223705@N07,255,16,1463806798,1463806975,2,45,177
110223705@N07,255,14,1463806975,1463807095,4,45,120
110223705@N07,255,12,1463807573,1463807745,5,45,172
110223705@N07,255,17,1463807745,1463807856,2,45,111
110223705@N07,255,12,1463807856,1463808420,4,45,564
110223705@N07,255,10,1463808420,1463808840,11,45,420
110223705@N07,255,15,1463810366,1463810384,2,45,18
110223705@N07,255,13,1463810384,1463810450,4,45,66
110223705@N07,255,15,1463810450,1463810602,2,45,152
110223705@N07,255,17,1463810602,1463810852,5,45,250
110223705@N07,255,22,1463810852,1463810921,5,45,69
110223705@N07,255,20,1463810921,1463811326,3,45,405
110223705@N07,255,24,1463811326,1463811390,4,45,64
110223705@N07,255,21,1463811390,1463811473,3,45,83
110223705@N07,255,24,1463811473,1463811667,3,45,194
110223705@N07,255,25,1463811667,1463811698,4,45,31
110223705@N07,255,24,1463811698,1463812178,8,45,480
110223705@N07,255,26,1463813218,1463813398,2,45,180
110223705@N07,255,23,1463813721,1463813811,2,45,90
110223705@N07,255,17,1463818430,1463819064,3,45,634
110223705@N07,255,26,1463819064,1463819217,2,45,153
110223705@N07,255,17,1463819217,1463820315,2,45,1098
110223705@N07,255,21,1463820315,1463820765,5,45,450
110223705@N07,255,20,1463822709,1463822935,2,45,226
110223705@N07,255,17,1463822935,1463824315,4,45,1380
110223705@N07,255,16,1463833502,1463833765,2,45,263
110223705@N07,255,2,1463833765,1463833855,2,45,90
110223705@N07,255,3,1463835067,1463835337,3,45,270
110223705@N07,255,27,1463838109,1463839309,2,45,1200
110270294@N05,256,14,1409907931,1409908051,1,1,120
110333758@N06,257,27,1386317476,1386318676,2,3,1200
110333758@N06,257,6,1386323439,1386323694,3,3,255
110333758@N06,257,14,1386326020,1386326140,1,3,120
11041171@N06,258,9,1277609906,1277610146,1,1,240
11041171@N06,259,17,1297297701,1297299081,1,1,1380
11041171@N06,260,27,1302483941,1302485141,1,1,1200
11041171@N06,261,9,1352245194,1352245434,1,1,240
11041171@N06,262,9,1352767985,1352768225,2,3,240
11041171@N06,262,18,1352777869,1352779669,2,3,1800
11041171@N06,262,27,1352781006,1352782206,1,3,1200
11041171@N06,263,3,1358131675,1358131945,1,1,270
11041171@N06,264,9,1358294025,1358294265,2,2,240
11041171@N06,264,18,1358301349,1358303149,1,2,1800
11041171@N06,265,19,1372484084,1372484504,2,2,420
11041171@N06,265,18,1372484541,1372486341,1,2,1800
11041171@N06,266,4,1404523282,1404524182,1,1,900
11041171@N06,267,9,1404912032,1404912272,1,1,240
110670053@N07,268,27,1424992176,1424993376,1,1,1200
110670053@N07,269,27,1425032219,1425033419,1,1,1200
110670053@N07,270,27,1425339460,1425340660,1,1,1200
110670053@N07,271,27,1470484088,1470485288,1,1,1200
110708467@N08,272,16,1392864950,1392865670,2,1,720
111075106@N05,273,17,1386601812,1386603192,4,1,1380
111107017@N08,274,16,1371806374,1371807094,1,1,720
111107017@N08,275,22,1378510823,1378511423,1,1,600
111107017@N08,276,13,1386470946,1386471546,1,1,600
111364633@N02,277,4,1321915904,1321916804,2,3,900
111364633@N02,277,5,1321917323,1321918043,5,3,720
111364633@N02,277,4,1321929763,1321930663,2,3,900
11137977@N00,278,22,1234834429,1234835029,1,1,600
111417007@N03,279,27,1277026810,1277028010,1,1,1200
11145342@N04,280,16,1212837007,1212837727,1,1,720
11145342@N04,281,16,1272283134,1272283854,51,1,720
11145342@N04,282,27,1352724350,1352725550,2,1,1200
11145342@N04,283,16,1352763619,1352764339,5,3,720
11145342@N04,283,14,1352767876,1352767996,2,3,120
11145342@N04,283,16,1352780114,1352780834,1,3,720
11145342@N04,284,14,1353065240,1353065360,1,1,120
11145342@N04,285,6,1369135744,1369135999,1,1,255
11149127@N05,286,1,1300026025,1300026625,3,2,600
11149127@N05,286,3,1300027834,1300028104,1,2,270
111581625@N04,287,4,1354155764,1354156664,1,1,900
111603867@N06,288,27,1390377802,1390379002,3,1,1200
111603867@N06,289,18,1390872773,1390874573,1,1,1800
11171054@N04,290,26,1440154591,1440154597,4,3,6
11171054@N04,290,16,1440154597,1440154622,2,3,25
11171054@N04,290,27,1440154622,1440155822,1,3,1200
111797858@N08,291,27,1386402652,1386403852,1,1,1200
111797858@N08,292,27,1386469381,1386470581,1,1,1200
111797858@N08,293,27,1386572074,1386573274,2,1,1200
111797858@N08,294,27,1386649705,1386650905,1,1,1200
111797858@N08,295,27,1386680552,1386681752,1,1,1200
111797858@N08,296,27,1386894403,1386895603,2,1,1200
111858879@N03,297,7,1305007150,1305007240,2,1,90
11201728@N02,298,27,1215340806,1215342006,1,1,1200
11202847@N00,299,24,1370180505,1370180985,1,1,480
11218233@N00,300,12,1276037103,1276037943,1,1,840
11218233@N00,301,9,1276069141,1276069381,2,3,240
11218233@N00,301,14,1276078479,1276078599,4,3,120
11218233@N00,301,16,1276080436,1276081156,1,3,720
11230373@N02,302,27,1189136969,1189138169,2,2,1200
11230373@N02,302,21,1189138897,1189139347,3,2,450
11230735@N07,303,27,1194175500,1194175671,2,3,171
11230735@N07,303,1,1194175671,1194176149,2,3,478
11230735@N07,303,4,1194176149,1194177049,1,3,900
11230735@N07,304,20,1220422068,1220423148,1,1,1080
11240815@N03,305,2,1366856064,1366856154,1,1,90
11253577@N05,306,16,1262715958,1262716678,2,2,720
11253577@N05,306,27,1262721035,1262722235,2,2,1200
11260538@N06,307,14,1291772570,1291772690,1,1,120
11260538@N06,308,27,1344043365,1344044565,1,1,1200
11260538@N06,309,2,1344117845,1344117935,2,2,90
11260538@N06,309,3,1344118206,1344118476,1,2,270
11260538@N06,310,27,1348648836,1348650036,2,2,1200
11260538@N06,310,1,1348650200,1348650800,1,2,600
11260538@N06,311,14,1350168705,1350168825,1,1,120
11260538@N06,312,14,1352524017,1352524137,1,1,120
11260538@N06,313,8,1352667899,1352668019,2,4,120
11260538@N06,313,26,1352681873,1352682053,3,4,180
11260538@N06,313,19,1352689366,1352689786,2,4,420
11260538@N06,313,27,1352699308,1352700508,1,4,1200
11260538@N06,314,2,1355554063,1355554153,1,1,90
11260538@N06,315,27,1355686204,1355687404,1,1,1200
11260538@N06,316,14,1355741980,1355742100,1,1,120
11260538@N06,317,27,1355821903,1355823103,1,1,1200
11260538@N06,318,17,1355869867,1355869992,2,2,125
11260538@N06,318,15,1355869992,1355870172,1,2,180
11260538@N06,319,27,1381021016,1381022216,1,1,1200
11260538@N06,320,8,1384139849,1384139969,1,1,120
11260538@N06,321,27,1384649290,1384650490,2,2,1200
11260538@N06,321,25,1384656936,1384657686,1,2,750
112691972@N02,322,27,1399251705,1399252905,2,3,1200
112691972@N02,322,13,1399256579,1399257179,4,3,600
112691972@N02,322,9,1399258826,1399259066,1,3,240
11269849@N03,323,17,1305962511,1305963891,16,1,1380
11269849@N03,324,3,1338610620,1338610890,2,1,270
112709393@N04,325,27,1364882846,1364884046,2,1,1200
112709393@N04,326,3,1365124272,1365124351,2,2,79
112709393@N04,326,2,1365124351,1365124441,8,2,90
112729643@N07,327,22,1324167312,1324167912,1,1,600
112734542@N02,328,4,1396606646,1396607546,18,1,900
112734542@N02,329,8,1396746625,1396746745,5,4,120
112734542@N02,329,14,1396748178,1396748298,2,4,120
112734542@N02,329,12,1396750218,1396751058,3,4,840
112734542@N02,329,27,1396752654,1396753854,2,4,1200
112734542@N02,330,14,1396939225,1396939345,6,3,120
112734542@N02,330,16,1396950481,1396951201,4,3,720
112734542@N02,330,14,1396952251,1396952371,3,3,120
112734542@N02,331,16,1397253371,1397254091,1,1,720
112791996@N05,332,16,1388833896,1388834616,1,1,720
11279883@N00,333,21,1258280651,1258281101,1,1,450
11279883@N00,334,15,1361675570,1361675750,1,1,180
11284258@N08,335,23,1343526324,1343526414,1,1,90
112858164@N04,336,27,1358379382,1358380582,1,1,1200
112861324@N05,337,12,1388209856,1388210696,2,2,840
112861324@N05,337,27,1388220773,1388221973,1,2,1200
113022206@N08,338,27,1373067124,1373068324,2,2,1200
113022206@N08,338,16,1373090193,1373090913,1,2,720
11315654@N06,339,9,1261437655,1261437895,2,2,240
11315654@N06,339,19,1261442126,1261442546,1,2,420
113200565@N07,340,10,1388231758,1388232178,3,2,420
113200565@N07,340,3,1388235887,1388236157,1,2,270
113200565@N07,341,25,1388412002,1388412752,21,1,750
11342926@N04,342,27,1269072533,1269073733,2,1,1200
11342926@N04,343,16,1305606996,1305607716,1,1,720
11346978@N05,344,2,1353653010,1353653100,1,1,90
113472825@N06,345,27,1416285264,1416286464,1,1,1200
113531893@N05,346,16,1376270273,1376270993,1,1,720
113552105@N07,347,27,1458083082,1458084282,2,1,1200
113558476@N06,348,2,1426755672,1426755762,1,1,90
11355999@N08,349,16,1374379376,1374380096,1,1,720
11355999@N08,350,16,1374708226,1374708946,1,1,720
11355999@N08,351,18,1374830512,1374831937,2,2,1425
11355999@N08,351,13,1374831937,1374832537,1,2,600
11374644@N06,352,27,1257573652,1257574852,6,5,1200
11374644@N06,352,17,1257576146,1257577526,4,5,1380
11374644@N06,352,11,1257580269,1257580449,2,5,180
11374644@N06,352,17,1257585023,1257586403,6,5,1380
11374644@N06,352,27,1257588711,1257589911,8,5,1200
11374644@N06,353,7,1351688400,1351688490,2,1,90
11374644@N06,354,16,1368231022,1368231581,9,2,559
11374644@N06,354,17,1368231581,1368232961,4,2,1380
11374644@N06,355,27,1368618297,1368619497,4,1,1200
11374644@N06,356,25,1412667966,1412668716,21,1,750
11374644@N06,357,10,1412810497,1412810917,10,2,420
11374644@N06,357,9,1412811753,1412811993,1,2,240
11374644@N06,358,15,1413080967,1413081147,7,6,180
11374644@N06,358,13,1413083031,1413083203,2,6,172
11374644@N06,358,12,1413083203,1413083428,2,6,225
11374644@N06,358,15,1413083428,1413083608,2,6,180
11374644@N06,358,17,1413085585,1413086965,33,6,1380
11374644@N06,358,27,1413089228,1413090428,4,6,1200
11374644@N06,359,27,1413188708,1413189908,2,4,1200
11374644@N06,359,16,1413189989,1413190709,13,4,720
11374644@N06,359,9,1413194214,1413194454,7,4,240
11374644@N06,359,17,1413198356,1413199736,33,4,1380
11374644@N06,360,21,1413244682,1413244692,2,4,10
11374644@N06,360,22,1413244692,1413245292,2,4,600
11374644@N06,360,17,1413245996,1413247376,2,4,1380
11374644@N06,360,16,1413253263,1413253983,1,4,720
113841608@N03,361,16,1325155278,1325155998,1,1,720
11396484@N04,362,4,1330938092,1330938992,2,2,900
11396484@N04,362,17,1330939564,1330940944,1,2,1380
114222594@N02,363,14,1388353905,1388354025,2,4,120
114222594@N02,363,26,1388362386,1388362566,2,4,180
114222594@N02,363,27,1388367706,1388368906,2,4,1200
114222594@N02,363,17,1388389341,1388390721,1,4,1380
114234625@N06,364,7,1470026070,1470026160,3,7,90
114234625@N06,364,14,1470029599,1470029719,3,7,120
114234625@N06,364,16,1470030403,1470030544,2,7,141
114234625@N06,364,14,1470030544,1470030664,2,7,120
114234625@N06,364,6,1470033451,1470033460,2,7,9
114234625@N06,364,7,1470033460,1470033550,2,7,90
114234625@N06,364,27,1470045954,1470047154,3,7,1200
114267358@N08,365,6,1424125533,1424125788,2,2,255
114267358@N08,365,27,1424127276,1424128476,1,2,1200
11438118@N00,366,27,1189652716,1189653916,23,10,1200
11438118@N00,366,25,1189655832,1189656028,2,10,196
11438118@N00,366,17,1189656028,1189656297,4,10,269
11438118@N00,366,15,1189656297,1189656477,10,10,180
11438118@N00,366,13,1189657046,1189657646,9,10,600
11438118@N00,366,15,1189659010,1189659190,2,10,180
11438118@N00,366,13,1189660492,1189660746,3,10,254
11438118@N00,366,15,1189660746,1189660926,7,10,180
11438118@N00,366,20,1189662146,1189662608,6,10,462
11438118@N00,366,27,1189662608,1189663808,8,10,1200
11438118@N00,367,16,1195021927,1195022647,27,1,720
11438118@N00,368,27,1249019771,1249019852,4,4,81
11438118@N00,368,16,1249019852,1249019880,2,4,28
11438118@N00,368,20,1249019880,1249020137,3,4,257
11438118@N00,368,16,1249020137,1249020857,3,4,720
11439401@N07,369,27,1232392536,1232393736,1,1,1200
11439401@N07,370,8,1234159818,1234159938,1,1,120
11441631@N00,371,14,1348723605,1348723725,2,2,120
11441631@N00,371,2,1348730901,1348730991,1,2,90
11441631@N00,372,17,1348876760,1348878140,1,1,1380
114434902@N04,373,27,1400896467,1400897667,4,12,1200
114434902@N04,373,25,1400898729,1400899479,2,12,750
114434902@N04,373,21,1400900169,1400900260,2,12,91
114434902@N04,373,24,1400900260,1400900305,3,12,45
114434902@N04,373,25,1400900305,1400900501,4,12,196
114434902@N04,373,24,1400900501,1400900981,12,12,480
114434902@N04,373,26,1400901470,1400901650,2,12,180
114434902@N04,373,14,1400909620,1400909740,5,12,120
114434902@N04,373,11,1400912615,1400912795,4,12,180
114434902@N04,373,4,1400916798,1400917698,3,12,900
114434902@N04,373,2,1400918672,1400918762,2,12,90
114434902@N04,373,11,1400921766,1400921946,3,12,180
11464750@N05,374,14,1400470790,1400470910,2,2,120
11464750@N05,374,18,1400486263,1400488063,3,2,1800
114677615@N06,375,10,1350272462,1350272882,4,1,420
114677615@N06,376,10,1368590009,1368590429,1,1,420
114685617@N08,377,15,1390291934,1390292114,1,1,180
11479795@N00,378,27,1191115526,1191116726,2,2,1200
11479795@N00,378,15,1191127903,1191128083,1,2,180
11496089@N08,379,16,1283685237,1283685957,1,1,720
11504889@N06,380,27,1446341382,1446342582,1,1,1200
11517266@N02,381,27,1188471861,1188473061,1,1,1200
115224926@N07,382,2,1431516576,1431516612,3,3,36
115224926@N07,382,3,1431516612,1431516882,2,3,270
115224926@N07,382,6,1431517757,1431518012,1,3,255
11524912@N05,383,27,1279744656,1279745856,2,2,1200
11524912@N05,383,13,1279748576,1279749176,1,2,600
115400338@N03,384,27,1401063671,1401064145,2,4,474
115400338@N03,384,4,1401064145,1401065045,2,4,900
115400338@N03,384,21,1401071268,1401071718,3,4,450
115400338@N03,384,13,1401075514,1401076114,1,4,600
11541209@N06,385,17,1193908465,1193909845,1,1,1380
11541209@N06,386,9,1249717149,1249717389,1,1,240
11541209@N06,387,16,1250242479,1250243199,2,2,720
11541209@N06,387,17,1250248474,1250249854,7,2,1380
115511286@N06,388,2,1392409539,1392409629,2,5,90
115511286@N06,388,6,1392411604,1392411772,2,5,168
115511286@N06,388,9,1392411772,1392412012,3,5,240
115511286@N06,388,11,1392412414,1392412594,2,5,180
115511286@N06,388,15,1392414646,1392414826,2,5,180
115688162@N04,389,16,1230086894,1230087614,1,1,720
11581147@N06,390,16,1432538640,1432539360,1,1,720
11581147@N06,391,27,1432688740,1432689940,2,1,1200
11581147@N06,392,14,1432719910,1432720030,1,1,120
11586403@N02,393,4,1213506214,1213507114,1,1,900
11632646@N02,394,16,1187949050,1187949770,1,1,720
11632646@N02,395,16,1188855763,1188856483,1,1,720
11654579@N07,396,9,1354233939,1354234179,1,1,240
11654579@N07,397,12,1362808386,1362809226,1,1,840
116615968@N03,398,13,1388792960,1388793560,1,1,600
11711539@N08,399,19,1263773500,1263773920,2,1,420
117362598@N08,400,27,1458781611,1458782811,2,2,1200
117362598@N08,400,8,1458786563,1458786683,1,2,120
117362598@N08,401,17,1458823844,1458824156,2,2,312
117362598@N08,401,15,1458824156,1458824336,2,2,180
11752574@N06,402,18,1187918299,1187920099,2,2,1800
11752574@N06,402,13,1187931471,1187932071,1,2,600
11752574@N06,403,9,1187963883,1187964123,1,1,240
11752574@N06,404,9,1188044798,1188045038,2,2,240
11752574@N06,404,27,1188045799,1188046999,3,2,1200
11752574@N06,405,16,1188342263,1188342983,4,1,720
11752574@N06,406,12,1189511455,1189512295,1,1,840
11752574@N06,407,12,1192232694,1192233534,1,1,840
11752574@N06,408,16,1194682121,1194682841,2,10,720
11752574@N06,408,13,1194683906,1194684506,5,10,600
11752574@N06,408,12,1194686011,1194686851,3,10,840
11752574@N06,408,21,1194688683,1194689133,2,10,450
11752574@N06,408,14,1194691457,1194691577,5,10,120
11752574@N06,408,9,1194692733,1194692973,2,10,240
11752574@N06,408,13,1194697182,1194697782,7,10,600
11752574@N06,408,15,1194699378,1194699558,2,10,180
11752574@N06,408,21,1194700126,1194700576,6,10,450
11752574@N06,408,13,1194703596,1194704196,1,10,600
11752574@N06,409,13,1194781890,1194782490,6,2,600
11752574@N06,409,16,1194786560,1194787280,1,2,720
11752574@N06,410,14,1194999849,1194999969,2,7,120
11752574@N06,410,9,1195002664,1195002904,10,7,240
11752574@N06,410,15,1195003618,1195003798,4,7,180
11752574@N06,410,21,1195012352,1195012802,2,7,450
11752574@N06,410,22,1195013601,1195014201,8,7,600
11752574@N06,410,19,1195016823,1195017243,3,7,420
11752574@N06,410,1,1195021196,1195021796,1,7,600
11752574@N06,411,1,1208665188,1208665788,1,1,600
11752574@N06,412,5,1214967772,1214968492,2,1,720
11752574@N06,413,23,1259803587,1259803677,2,6,90
11752574@N06,413,13,1259814315,1259814839,2,6,524
11752574@N06,413,17,1259814839,1259816219,2,6,1380
11752574@N06,413,15,1259834591,1259834771,2,6,180
11752574@N06,413,2,1259838601,1259838691,2,6,90
11752574@N06,413,4,1259841110,1259842010,1,6,900
11752574@N06,414,27,1318493361,1318494561,4,3,1200
11752574@N06,414,21,1318499686,1318500136,2,3,450
11752574@N06,414,13,1318501726,1318502326,1,3,600
11752574@N06,415,23,1348216226,1348216316,2,5,90
11752574@N06,415,15,1348219892,1348220048,3,5,156
11752574@N06,415,14,1348220048,1348220168,3,5,120
11752574@N06,415,22,1348222886,1348223486,2,5,600
11752574@N06,415,27,1348225893,1348227093,1,5,1200
11755553@N08,416,16,1452078804,1452079524,1,1,720
11755553@N08,417,16,1452503573,1452504293,1,1,720
117724367@N08,418,14,1429109130,1429109250,2,2,120
117724367@N08,418,9,1429109348,1429109588,1,2,240
11785705@N02,419,17,1291779658,1291781038,2,4,1380
11785705@N02,419,20,1291800240,1291801320,2,4,1080
11785705@N02,419,16,1291801518,1291801979,2,4,461
11785705@N02,419,4,1291801979,1291802879,1,4,900
11785705@N02,420,23,1294917232,1294917322,1,1,90
118043454@N05,421,13,1406469786,1406470386,1,1,600
11825945@N00,422,23,1372828398,1372828488,3,3,90
11825945@N00,422,21,1372829719,1372830169,2,3,450
11825945@N00,422,14,1372843701,1372843821,1,3,120
11825945@N00,423,27,1374136624,1374137824,3,2,1200
11825945@N00,423,10,1374139795,1374140215,1,2,420
11825945@N00,424,27,1374296297,1374297497,1,1,1200
11825945@N00,425,10,1377396278,1377396698,1,1,420
11825945@N00,426,3,1386805583,1386805853,2,3,270
11825945@N00,426,10,1386810199,1386810619,2,3,420
11825945@N00,426,14,1386810817,1386810937,1,3,120
11825945@N00,427,4,1395984536,1395985436,1,1,900
11831873@N00,428,27,1286351309,1286352509,26,4,1200
11831873@N00,428,14,1286353091,1286353211,9,4,120
11831873@N00,428,8,1286359807,1286359927,9,4,120
11831873@N00,428,27,1286381850,1286383050,6,4,1200
11832393@N04,429,12,1320711113,1320711953,2,2,840
11832393@N04,429,9,1320717887,1320718127,3,2,240
11874382@N02,430,14,1275733144,1275733264,1,1,120
11885107@N08,431,27,1388511792,1388512992,1,1,1200
11901577@N03,432,13,1432303157,1432303757,1,1,600
119106047@N03,433,1,1394168130,1394168730,1,1,600
11928454@N04,434,27,1244414769,1244415816,12,29,1047
11928454@N04,434,17,1244415816,1244415911,2,29,95
11928454@N04,434,26,1244415911,1244416091,2,29,180
11928454@N04,434,20,1244416210,1244416338,3,29,128
11928454@N04,434,26,1244416338,1244416411,3,29,73
11928454@N04,434,17,1244416411,1244416451,2,29,40
11928454@N04,434,15,1244416451,1244416506,2,29,55
11928454@N04,434,14,1244416506,1244416626,5,29,120
11928454@N04,434,12,1244420348,1244421188,8,29,840
11928454@N04,434,22,1244421470,1244422070,2,29,600
11928454@N04,434,20,1244423375,1244424455,2,29,1080
11928454@N04,434,19,1244428283,1244428523,4,29,240
11928454@N04,434,20,1244428523,1244428856,2,29,333
11928454@N04,434,21,1244428856,1244429306,8,29,450
11928454@N04,434,23,1244432512,1244432602,4,29,90
11928454@N04,434,26,1244434089,1244434269,3,29,180
11928454@N04,434,25,1244434491,1244434931,12,29,440
11928454@N04,434,23,1244434931,1244435021,4,29,90
11928454@N04,434,18,1244437122,1244438922,7,29,1800
11928454@N04,434,17,1244439013,1244439624,2,29,611
11928454@N04,434,22,1244439624,1244440224,2,29,600
11928454@N04,434,19,1244441029,1244441449,3,29,420
11928454@N04,434,24,1244444676,1244445088,3,29,412
11928454@N04,434,25,1244445088,1244445110,2,29,22
11928454@N04,434,24,1244445110,1244445225,2,29,115
11928454@N04,434,25,1244445225,1244445975,4,29,750
11928454@N04,434,27,1244447712,1244448912,5,29,1200
11928454@N04,434,26,1244457048,1244457228,20,29,180
11928454@N04,434,4,1244461514,1244462414,3,29,900
11928454@N04,435,4,1244590322,1244590388,2,26,66
11928454@N04,435,3,1244590388,1244590658,2,26,270
11928454@N04,435,2,1244591976,1244592066,5,26,90
11928454@N04,435,6,1244592619,1244592705,2,26,86
11928454@N04,435,8,1244592705,1244592825,3,26,120
11928454@N04,435,11,1244594395,1244594575,3,26,180
11928454@N04,435,8,1244594974,1244595094,5,26,120
11928454@N04,435,11,1244595249,1244595429,3,26,180
11928454@N04,435,8,1244595494,1244595614,3,26,120
11928454@N04,435,17,1244596194,1244596357,2,26,163
11928454@N04,435,20,1244596357,1244596733,2,26,376
11928454@N04,435,22,1244596733,1244596796,2,26,63
11928454@N04,435,26,1244596796,1244596921,6,26,125
11928454@N04,435,17,1244596921,1244597159,2,26,238
11928454@N04,435,9,1244597159,1244597399,6,26,240
11928454@N04,435,14,1244600804,1244600924,4,26,120
11928454@N04,435,16,1244601094,1244601814,2,26,720
11928454@N04,435,15,1244603386,1244603566,2,26,180
11928454@N04,435,14,1244603660,1244603780,3,26,120
11928454@N04,435,26,1244611626,1244611806,27,26,180
11928454@N04,435,4,1244622430,1244623330,2,26,900
11928454@N04,435,14,1244627981,1244628101,2,26,120
11928454@N04,435,16,1244628465,1244628882,4,26,417
11928454@N04,435,17,1244628882,1244630262,2,26,1380
11928454@N04,435,26,1244631100,1244631186,2,26,86
11928454@N04,435,21,1244631186,1244631636,1,26,450
11935368@N00,436,4,1292188567,1292189467,2,6,900
11935368@N00,436,6,1292191536,1292191791,2,6,255
11935368@N00,436,14,1292195334,1292195454,2,6,120
11935368@N00,436,19,1292200488,1292200908,2,6,420
11935368@N00,436,24,1292203706,1292204186,2,6,480
11935368@N00,436,17,1292206915,1292208295,1,6,1380
11935368@N00,437,21,1292833760,1292833767,2,2,7
11935368@N00,437,6,1292833767,1292834022,1,2,255
119422749@N03,438,22,1395285128,1395285728,4,3,600
119422749@N03,438,4,1395309053,1395309953,6,3,900
119422749@N03,438,10,1395312314,1395312734,1,3,420
119435566@N06,439,27,1457155512,1457156712,1,1,1200
11954862@N00,440,27,1394341547,1394342747,2,2,1200
11954862@N00,440,16,1394362123,1394362843,1,2,720
11954862@N00,441,8,1394412959,1394413079,2,3,120
11954862@N00,441,16,1394422585,1394423305,2,3,720
11954862@N00,441,21,1394425638,1394426088,1,3,450
11954862@N00,442,19,1394574976,1394575396,1,1,420
11958538@N02,443,6,1193468204,1193468459,2,1,255
11958538@N02,444,27,1193603884,1193604030,2,2,146
11958538@N02,444,16,1193604030,1193604750,2,2,720
119796978@N03,445,14,1393130044,1393130164,2,5,120
119796978@N03,445,10,1393132193,1393132613,2,5,420
119796978@N03,445,2,1393141125,1393141215,2,5,90
119796978@N03,445,3,1393141300,1393141570,3,5,270
119796978@N03,445,9,1393151038,1393151278,1,5,240
119796978@N03,446,2,1393376465,1393376555,6,6,90
119796978@N03,446,24,1393378404,1393378587,4,6,183
119796978@N03,446,25,1393378587,1393378694,2,6,107
119796978@N03,446,24,1393378694,1393379174,7,6,480
119796978@N03,446,2,1393382943,1393383033,8,6,90
119796978@N03,446,1,1393387318,1393387918,1,6,600
119796978@N03,447,8,1393577394,1393577514,1,1,120
119887304@N04,448,27,1330476881,1330478081,4,1,1200
119904538@N08,449,14,1390106632,1390106752,1,1,120
12008385@N00,450,27,1291510744,1291511944,1,1,1200
120147674@N05,451,20,1395709011,1395709763,3,3,752
120147674@N05,451,27,1395709763,1395710963,2,3,1200
120147674@N05,451,14,1395723784,1395723904,1,3,120
120147674@N05,452,3,1395776711,1395776981,2,3,270
120147674@N05,452,25,1395780373,1395781123,2,3,750
120147674@N05,452,16,1395790347,1395791067,1,3,720
120147674@N05,453,20,1395955960,1395957040,1,1,1080
12036424@N04,454,27,1271047308,1271048508,3,2,1200
12036424@N04,454,14,1271062518,1271062638,1,2,120
12036424@N04,455,18,1305772226,1305774026,5,13,1800
12036424@N04,455,13,1305780329,1305780929,9,13,600
12036424@N04,455,12,1305783170,1305784010,19,13,840
12036424@N04,455,6,1305786339,1305786594,2,13,255
12036424@N04,455,2,1305788548,1305788638,7,13,90
12036424@N04,455,3,1305790460,1305790730,3,13,270
12036424@N04,455,1,1305792431,1305793031,4,13,600
12036424@N04,455,3,1305793660,1305793930,3,13,270
12036424@N04,455,24,1305796088,1305796568,3,13,480
12036424@N04,455,13,1305797303,1305797415,2,13,112
12036424@N04,455,24,1305797415,1305797895,10,13,480
12036424@N04,455,14,1305813625,1305813745,2,13,120
12036424@N04,455,27,1305813785,1305814985,1,13,1200
12044368@N04,456,27,1395886197,1395887397,1,1,1200
120510795@N06,457,27,1224428254,1224429454,1,1,1200
120510795@N06,458,27,1229510238,1229511438,1,1,1200
120533378@N03,459,22,1443136254,1443136854,1,1,600
120568475@N07,460,16,1398414579,1398415299,1,1,720
12059076@N05,461,16,1188881319,1188881745,2,4,426
12059076@N05,461,24,1188881745,1188882225,2,4,480
12059076@N05,461,18,1188885039,1188886839,2,4,1800
12059076@N05,461,27,1188887880,1188889080,2,4,1200
120604622@N02,462,22,1261448803,1261449403,1,1,600
120718576@N08,463,15,1395124898,1395125078,3,2,180
120718576@N08,463,16,1395126086,1395126806,1,2,720
120756153@N05,464,4,1313987700,1313988600,1,1,900
12083014@N05,465,16,1222406823,1222407543,2,2,720
12083014@N05,465,18,1222409701,1222411501,1,2,1800
12083014@N05,466,14,1253509918,1253510038,2,1,120
12083014@N05,467,24,1253606962,1253607442,1,1,480
12083014@N05,468,9,1298293325,1298293565,2,3,240
12083014@N05,468,1,1298296463,1298297063,2,3,600
12083014@N05,468,27,1298298071,1298299271,2,3,1200
12084245@N08,469,27,1247667539,1247668739,6,1,1200
12084245@N08,470,27,1247745618,1247746818,2,1,1200
12084245@N08,471,27,1271751505,1271752705,1,1,1200
12084245@N08,472,27,1273118422,1273119622,1,1,1200
120888449@N03,473,16,1400120888,1400121608,1,1,720
120929088@N08,474,27,1426367712,1426368912,7,16,1200
120929088@N08,474,4,1426369597,1426369602,2,16,5
120929088@N08,474,5,1426369602,1426369691,2,16,89
120929088@N08,474,1,1426369691,1426369793,2,16,102
120929088@N08,474,12,1426369793,1426370517,2,16,724
120929088@N08,474,1,1426370517,1426371117,2,16,600
120929088@N08,474,17,1426373835,1426374326,5,16,491
120929088@N08,474,13,1426374326,1426374926,2,16,600
120929088@N08,474,10,1426375837,1426376257,2,16,420
120929088@N08,474,26,1426387870,1426388050,2,16,180
120929088@N08,474,4,1426389719,1426390619,3,16,900
120929088@N08,474,21,1426397154,1426397604,2,16,450
120929088@N08,474,3,1426407934,1426408204,2,16,270
120929088@N08,474,2,1426413977,1426414067,2,16,90
120929088@N08,474,3,1426418701,1426418971,3,16,270
120929088@N08,474,27,1426425928,1426427128,1,16,1200
12150532@N04,475,14,1426887456,1426887576,1,1,120
12150532@N04,476,4,1426924429,1426925329,1,1,900
121655138@N03,477,20,1395726874,1395727954,2,7,1080
121655138@N03,477,16,1395728808,1395729528,6,7,720
121655138@N03,477,14,1395737655,1395737775,4,7,120
121655138@N03,477,15,1395737842,1395737903,2,7,61
121655138@N03,477,13,1395737903,1395738503,2,7,600
121655138@N03,477,4,1395744244,1395745144,5,7,900
121655138@N03,477,27,1395746784,1395747984,1,7,1200
121684518@N03,478,27,1405546967,1405548167,1,1,1200
121684518@N03,479,27,1405612813,1405614013,1,1,1200
121710355@N07,480,17,1433727454,1433728834,1,1,1380
121710355@N07,481,16,1433768277,1433768997,1,1,720
121855015@N07,482,14,1399163177,1399163297,6,8,120
121855015@N07,482,7,1399164950,1399165040,4,8,90
121855015@N07,482,17,1399174657,1399176037,17,8,1380
121855015@N07,482,15,1399182168,1399182348,2,8,180
121855015@N07,482,12,1399183803,1399184117,9,8,314
121855015@N07,482,13,1399184117,1399184156,5,8,39
121855015@N07,482,12,1399184156,1399184996,4,8,840
121855015@N07,482,9,1399188783,1399189023,4,8,240
121861619@N03,483,27,1423343899,1423345099,9,21,1200
121861619@N03,483,6,1423347046,1423347239,2,21,193
121861619@N03,483,14,1423347239,1423347359,2,21,120
121861619@N03,483,15,1423348450,1423348586,2,21,136
121861619@N03,483,26,1423348586,1423348766,6,21,180
121861619@N03,483,22,1423348829,1423349429,2,21,600
121861619@N03,483,19,1423350572,1423350992,15,21,420
121861619@N03,483,10,1423353613,1423354033,10,21,420
121861619@N03,483,9,1423354359,1423354599,4,21,240
121861619@N03,483,14,1423355104,1423355224,2,21,120
121861619@N03,483,9,1423355258,1423355363,2,21,105
121861619@N03,483,10,1423355363,1423355783,8,21,420
121861619@N03,483,25,1423363596,1423364346,4,21,750
121861619@N03,483,21,1423365958,1423366408,2,21,450
121861619@N03,483,22,1423367604,1423368204,25,21,600
121861619@N03,483,17,1423380616,1423381996,6,21,1380
121861619@N03,483,4,1423382033,1423382933,3,21,900
121861619@N03,483,3,1423384405,1423384638,3,21,233
121861619@N03,483,2,1423384638,1423384728,3,21,90
121861619@N03,483,27,1423389940,1423391140,9,21,1200
121861619@N03,483,20,1423398083,1423399163,1,21,1080
121861619@N03,484,9,1423778323,1423778563,3,20,240
121861619@N03,484,14,1423778960,1423779051,8,20,91
121861619@N03,484,9,1423779051,1423779291,17,20,240
121861619@N03,484,17,1423781436,1423781568,4,20,132
121861619@N03,484,18,1423781568,1423783368,3,20,1800
121861619@N03,484,23,1423783772,1423783862,2,20,90
121861619@N03,484,26,1423785190,1423785370,11,20,180
121861619@N03,484,14,1423787540,1423787660,9,20,120
121861619@N03,484,15,1423788497,1423788677,3,20,180
121861619@N03,484,17,1423788681,1423790061,2,20,1380
121861619@N03,484,25,1423790501,1423790611,2,20,110
121861619@N03,484,24,1423790611,1423791091,3,20,480
121861619@N03,484,20,1423791742,1423792008,4,20,266
121861619@N03,484,19,1423792008,1423792262,2,20,254
121861619@N03,484,11,1423792262,1423792442,2,20,180
121861619@N03,484,20,1423793728,1423794808,5,20,1080
121861619@N03,484,14,1423815216,1423815336,3,20,120
121861619@N03,484,10,1423815472,1423815892,4,20,420
121861619@N03,484,20,1423818983,1423820063,2,20,1080
121861619@N03,484,3,1423821542,1423821812,1,20,270
121862207@N08,485,3,1396658365,1396658635,5,9,270
121862207@N08,485,2,1396661091,1396661181,2,9,90
121862207@N08,485,7,1396664410,1396664500,2,9,90
121862207@N08,485,10,1396667517,1396667937,12,9,420
121862207@N08,485,14,1396668290,1396668410,2,9,120
121862207@N08,485,13,1396670316,1396670916,8,9,600
121862207@N08,485,15,1396692103,1396692283,3,9,180
121862207@N08,485,17,1396693180,1396693360,2,9,180
121862207@N08,485,20,1396693360,1396694440,1,9,1080
12197785@N03,486,4,1213066407,1213067307,1,1,900
12197785@N03,487,26,1259728722,1259728902,1,1,180
12197785@N03,488,9,1259821855,1259822095,2,4,240
12197785@N03,488,27,1259825363,1259826563,2,4,1200
12197785@N03,488,17,1259835454,1259836834,2,4,1380
12197785@N03,488,4,1259840469,1259841369,1,4,900
12197785@N03,489,27,1287803118,1287804318,2,3,1200
12197785@N03,489,19,1287816059,1287816479,2,3,420
12197785@N03,489,9,1287818586,1287818826,1,3,240
12197785@N03,490,13,1287914389,1287914989,2,1,600
12197785@N03,491,16,1308214587,1308215267,2,4,680
12197785@N03,491,9,1308215267,1308215507,2,4,240
12197785@N03,491,17,1308215663,1308217043,3,4,1380
12197785@N03,491,23,1308217417,1308217507,1,4,90
12205233@N02,492,16,1227438126,1227438846,9,1,720
122353703@N02,493,27,1423176784,1423177984,2,2,1200
122353703@N02,493,3,1423199315,1423199585,1,2,270
122353703@N02,494,27,1423476322,1423477522,1,1,1200
122353703@N02,495,27,1424835747,1424836947,2,2,1200
122353703@N02,495,17,1424841833,1424843213,2,2,1380
12241674@N03,496,12,1324169189,1324170029,2,4,840
12241674@N03,496,16,1324170435,1324171155,2,4,720
12241674@N03,496,25,1324183002,1324183752,2,4,750
12241674@N03,496,3,1324196453,1324196723,1,4,270
12241674@N03,497,16,1324418915,1324419635,2,1,720
122536755@N07,498,27,1409549155,1409550355,51,9,1200
122536755@N07,498,9,1409550781,1409551021,5,9,240
122536755@N07,498,11,1409551483,1409551525,9,9,42
122536755@N07,498,9,1409551525,1409551765,3,9,240
122536755@N07,498,24,1409552794,1409552900,2,9,106
122536755@N07,498,25,1409552900,1409553008,2,9,108
122536755@N07,498,24,1409553008,1409553203,5,9,195
122536755@N07,498,21,1409553203,1409553653,4,9,450
122536755@N07,498,15,1409554575,1409554755,1,9,180
12256768@N03,499,18,1287145652,1287147452,1,1,1800
12256768@N03,500,19,1287185779,1287186199,2,6,420
12256768@N03,500,20,1287192457,1287193501,2,6,1044
12256768@N03,500,18,1287193501,1287193527,2,6,26
12256768@N03,500,13,1287193527,1287194127,3,6,600
12256768@N03,500,18,1287199969,1287200709,2,6,740
12256768@N03,500,17,1287200709,1287202089,1,6,1380
12256768@N03,501,18,1363104167,1363104172,2,3,5
12256768@N03,501,19,1363104172,1363104174,2,3,2
12256768@N03,501,18,1363104174,1363105974,1,3,1800
12261016@N00,502,16,1329608280,1329609000,6,3,720
12261016@N00,502,12,1329610038,1329610878,2,3,840
12261016@N00,502,9,1329625369,1329625609,2,3,240
12261016@N00,503,9,1329707330,1329707570,1,1,240
12261830@N04,504,9,1437885091,1437885331,1,1,240
12261830@N04,505,1,1441442049,1441442649,1,1,600
12277777@N04,506,27,1311041654,1311042854,2,2,1200
12277777@N04,506,17,1311055837,1311057217,1,2,1380
122876725@N05,507,27,1406063937,1406065137,40,21,1200
122876725@N05,507,1,1406066109,1406066709,8,21,600
122876725@N05,507,5,1406068196,1406068916,6,21,720
122876725@N05,507,4,1406071905,1406072091,3,21,186
122876725@N05,507,25,1406072091,1406072841,2,21,750
122876725@N05,507,23,1406074228,1406074318,2,21,90
122876725@N05,507,24,1406074410,1406074735,5,21,325
122876725@N05,507,21,1406074735,1406074910,5,21,175
122876725@N05,507,24,1406074910,1406075390,7,21,480
122876725@N05,507,20,1406075813,1406076893,14,21,1080
122876725@N05,507,19,1406081936,1406082356,7,21,420
122876725@N05,507,20,1406083565,1406084645,7,21,1080
122876725@N05,507,15,1406084934,1406085114,2,21,180
122876725@N05,507,18,1406089113,1406090913,2,21,1800
122876725@N05,507,25,1406092057,1406092807,2,21,750
122876725@N05,507,2,1406093347,1406093437,2,21,90
122876725@N05,507,27,1406095824,1406097024,3,21,1200
122876725@N05,507,16,1406102285,1406102471,5,21,186
122876725@N05,507,9,1406102471,1406102711,10,21,240
122876725@N05,507,14,1406103043,1406103163,5,21,120
122876725@N05,507,10,1406103290,1406103710,8,21,420
122876725@N05,508,20,1406623907,1406624987,2,6,1080
122876725@N05,508,21,1406625824,1406626274,3,6,450
122876725@N05,508,24,1406627972,1406628452,3,6,480
122876725@N05,508,4,1406632736,1406632857,6,6,121
122876725@N05,508,3,1406632857,1406633127,2,6,270
122876725@N05,508,27,1406634511,1406635711,6,6,1200
122876725@N05,509,27,1407726624,1407727824,16,38,1200
122876725@N05,509,1,1407728097,1407728697,3,38,600
122876725@N05,509,2,1407729213,1407729303,4,38,90
122876725@N05,509,5,1407729380,1407729419,3,38,39
122876725@N05,509,2,1407729419,1407729509,8,38,90
122876725@N05,509,5,1407730068,1407730126,10,38,58
122876725@N05,509,6,1407730126,1407730153,4,38,27
122876725@N05,509,1,1407730153,1407730443,5,38,290
122876725@N05,509,3,1407730443,1407730713,2,38,270
122876725@N05,509,9,1407732510,1407732750,2,38,240
122876725@N05,509,15,1407736269,1407736297,3,38,28
122876725@N05,509,17,1407736297,1407736516,2,38,219
122876725@N05,509,22,1407736516,1407736625,5,38,109
122876725@N05,509,20,1407736625,1407737705,3,38,1080
122876725@N05,509,18,1407738719,1407740079,6,38,1360
122876725@N05,509,13,1407740079,1407740679,2,38,600
122876725@N05,509,21,1407744026,1407744369,3,38,343
122876725@N05,509,23,1407744369,1407744429,4,38,60
122876725@N05,509,24,1407744429,1407744545,4,38,116
122876725@N05,509,21,1407744545,1407744618,4,38,73
122876725@N05,509,24,1407744618,1407744648,2,38,30
122876725@N05,509,22,1407744648,1407744714,3,38,66
122876725@N05,509,23,1407744714,1407744755,2,38,41
122876725@N05,509,22,1407744755,1407744776,2,38,21
122876725@N05,509,23,1407744776,1407744819,4,38,43
122876725@N05,509,24,1407744819,1407744856,2,38,37
122876725@N05,509,25,1407744856,1407745114,2,38,258
122876725@N05,509,23,1407745114,1407745141,3,38,27
122876725@N05,509,24,1407745141,1407745621,2,38,480
122876725@N05,509,7,1407750805,1407750838,2,38,33
122876725@N05,509,8,1407750838,1407750958,14,38,120
122876725@N05,509,7,1407751410,1407751500,11,38,90
122876725@N05,509,2,1407752603,1407752693,6,38,90
122876725@N05,509,5,1407752827,1407752881,2,38,54
122876725@N05,509,6,1407752881,1407753136,4,38,255
122876725@N05,509,15,1407756168,1407756348,2,38,180
122876725@N05,509,16,1407758353,1407759073,15,38,720
122876725@N05,509,27,1407761821,1407763021,7,38,1200
12316147@N05,510,27,1304127751,1304128951,17,14,1200
12316147@N05,510,21,1304129501,1304129951,4,14,450
12316147@N05,510,8,1304130415,1304130535,4,14,120
12316147@N05,510,6,1304137017,1304137272,12,14,255
12316147@N05,510,2,1304138993,1304139083,16,14,90
12316147@N05,510,9,1304141154,1304141394,16,14,240
12316147@N05,510,12,1304143535,1304144375,22,14,840
12316147@N05,510,17,1304145741,1304146533,8,14,792
12316147@N05,510,18,1304146533,1304146646,2,14,113
12316147@N05,510,13,1304146646,1304146651,2,14,5
12316147@N05,510,18,1304146651,1304147940,15,14,1289
12316147@N05,510,22,1304147940,1304148164,3,14,224
12316147@N05,510,17,1304148164,1304149544,10,14,1380
12316147@N05,510,27,1304150409,1304151609,7,14,1200
123349668@N03,511,13,1366353801,1366354401,2,3,600
123349668@N03,511,17,1366356075,1366357455,2,3,1380
123349668@N03,511,21,1366361986,1366362436,1,3,450
12336562@N08,512,23,1294358621,1294358711,1,1,90
12336562@N08,513,27,1294557459,1294558659,3,2,1200
12336562@N08,513,22,1294560241,1294560841,1,2,600
123398648@N02,514,4,1349604032,1349604932,4,2,900
123398648@N02,514,17,1349608614,1349609994,46,2,1380
123475115@N06,515,27,1353469987,1353471187,1,1,1200
123519116@N08,516,14,1408586355,1408586475,1,1,120
12353441@N02,517,4,1191044147,1191045047,2,1,900
12361801@N05,518,4,1283826508,1283827408,53,1,900
12381123@N06,519,27,1324167966,1324169166,6,12,1200
12381123@N06,519,16,1324169192,1324169903,3,12,711
12381123@N06,519,4,1324169903,1324170803,2,12,900
12381123@N06,519,9,1324172866,1324173106,2,12,240
12381123@N06,519,14,1324175751,1324175871,2,12,120
12381123@N06,519,16,1324178469,1324179037,3,12,568
12381123@N06,519,17,1324179037,1324180417,2,12,1380
12381123@N06,519,5,1324185893,1324186274,2,12,381
12381123@N06,519,2,1324186274,1324186364,2,12,90
12381123@N06,519,1,1324186366,1324186966,2,12,600
12381123@N06,519,4,1324189501,1324190401,2,12,900
12381123@N06,519,27,1324190692,1324191892,1,12,1200
12395214@N08,520,21,1262928024,1262928474,1,1,450
12395214@N08,521,21,1263001580,1263002030,7,1,450
124125208@N07,522,10,1372753061,1372753481,1,1,420
124125208@N07,523,13,1372900850,1372901450,1,1,600
124235757@N05,524,27,1342391349,1342392549,4,2,1200
124235757@N05,524,4,1342400288,1342401188,1,2,900
12440183@N04,525,17,1345954338,1345955718,1,1,1380
124495835@N08,526,27,1409341942,1409342838,2,4,896
124495835@N08,526,16,1409342838,1409343288,2,4,450
124495835@N08,526,13,1409343288,1409343888,2,4,600
124495835@N08,526,19,1409344433,1409344853,1,4,420
124495835@N08,527,27,1409434499,1409435632,2,2,1133
124495835@N08,527,19,1409435632,1409436052,2,2,420
12456985@N00,528,27,1396742258,1396743458,1,1,1200
124601595@N06,529,27,1398420037,1398421040,2,2,1003
124601595@N06,529,14,1398421040,1398421160,3,2,120
124601595@N06,530,27,1398750607,1398750988,2,15,381
124601595@N06,530,4,1398750988,1398751168,2,15,180
124601595@N06,530,5,1398751168,1398751888,2,15,720
124601595@N06,530,9,1398755911,1398755995,2,15,84
124601595@N06,530,14,1398755995,1398756115,2,15,120
124601595@N06,530,10,1398756178,1398756291,2,15,113
124601595@N06,530,14,1398756291,1398756411,2,15,120
124601595@N06,530,16,1398756440,1398756710,2,15,270
124601595@N06,530,14,1398756710,1398756830,2,15,120
124601595@N06,530,16,1398757021,1398757109,2,15,88
124601595@N06,530,17,1398757109,1398757199,3,15,90
124601595@N06,530,26,1398757199,1398757379,3,15,180
124601595@N06,530,20,1398757407,1398757454,3,15,47
124601595@N06,530,21,1398757454,1398757554,4,15,100
124601595@N06,530,23,1398757554,1398757644,3,15,90
124948917@N04,531,27,1433301802,1433303002,1,1,1200
12508217@N08,532,9,1192152564,1192152804,1,1,240
12508217@N08,533,12,1192264093,1192264933,1,1,840
12508217@N08,534,27,1198907354,1198908554,2,1,1200
12508217@N08,535,3,1201342941,1201343211,1,1,270
12508217@N08,536,14,1201987987,1201988107,3,2,120
12508217@N08,536,6,1201990222,1201990477,1,2,255
12508217@N08,537,13,1313399673,1313400273,12,2,600
12508217@N08,537,17,1313401260,1313402640,1,2,1380
12508217@N08,538,22,1330222256,1330222856,12,1,600
12508217@N08,539,22,1330517993,1330518593,14,1,600
12508217@N08,540,27,1347752920,1347754120,2,5,1200
12508217@N08,540,17,1347755111,1347756491,2,5,1380
12508217@N08,540,22,1347756969,1347757569,26,5,600
12508217@N08,540,24,1347759818,1347760298,17,5,480
12508217@N08,540,7,1347762558,1347762648,1,5,90
12508217@N08,541,10,1348796999,1348797419,1,1,420
12508217@N08,542,27,1352971641,1352972730,2,8,1089
12508217@N08,542,22,1352972730,1352973330,5,8,600
12508217@N08,542,13,1352974065,1352974665,6,8,600
12508217@N08,542,10,1352975284,1352975704,22,8,420
12508217@N08,542,9,1352979307,1352979547,4,8,240
12508217@N08,542,17,1352983283,1352984663,28,8,1380
12508217@N08,542,9,1352984843,1352985083,6,8,240
12508217@N08,542,17,1352985501,1352986881,4,8,1380
12508217@N08,543,27,1369337935,1369339135,17,9,1200
12508217@N08,543,16,1369340275,1369340995,5,9,720
12508217@N08,543,22,1369342333,1369342933,14,9,600
12508217@N08,543,16,1369351866,1369352586,2,9,720
12508217@N08,543,10,1369352628,1369353048,13,9,420
12508217@N08,543,27,1369360127,1369360795,2,9,668
12508217@N08,543,22,1369360795,1369361395,14,9,600
12508217@N08,543,26,1369362081,1369362261,2,9,180
12508217@N08,543,27,1369368038,1369369238,2,9,1200
12531737@N04,544,6,1366273131,1366273336,2,3,205
12531737@N04,544,1,1366273336,1366273936,2,3,600
12531737@N04,544,4,1366276040,1366276940,1,3,900
125486816@N06,545,18,1465529807,1465531607,1,1,1800
12554088@N00,546,27,1288540819,1288542019,1,1,1200
12561037@N06,547,27,1235619758,1235620958,1,1,1200
125837856@N05,548,27,1404082133,1404083333,6,23,1200
125837856@N05,548,17,1404084036,1404084841,4,23,805
125837856@N05,548,15,1404084841,1404085021,13,23,180
125837856@N05,548,12,1404085146,1404085858,5,23,712
125837856@N05,548,15,1404085858,1404086038,2,23,180
125837856@N05,548,17,1404090597,1404091327,2,23,730
125837856@N05,548,9,1404091327,1404091567,6,23,240
125837856@N05,548,10,1404093354,1404093774,9,23,420
125837856@N05,548,7,1404097064,1404097154,15,23,90
125837856@N05,548,14,1404100808,1404100928,13,23,120
125837856@N05,548,16,1404105616,1404105625,3,23,9
125837856@N05,548,14,1404105625,1404105629,2,23,4
125837856@N05,548,15,1404105629,1404105640,2,23,11
125837856@N05,548,14,1404105640,1404105676,3,23,36
125837856@N05,548,15,1404105676,1404105679,2,23,3
125837856@N05,548,16,1404105679,1404105682,2,23,3
125837856@N05,548,14,1404105682,1404105683,2,23,1
125837856@N05,548,16,1404105683,1404105700,3,23,17
125837856@N05,548,14,1404105700,1404105820,2,23,120
125837856@N05,548,7,1404109247,1404109337,3,23,90
125837856@N05,548,24,1404120049,1404120529,5,23,480
125837856@N05,548,1,1404131382,1404131982,2,23,600
125837856@N05,548,27,1404132801,1404134001,2,23,1200
12586305@N04,549,27,1266704101,1266705301,2,13,1200
12586305@N04,549,24,1266705322,1266705802,2,13,480
12586305@N04,549,26,1266705871,1266705910,2,13,39
12586305@N04,549,17,1266705910,1266707290,2,13,1380
12586305@N04,549,22,1266708873,1266709473,4,13,600
12586305@N04,549,12,1266712087,1266712566,4,13,479
12586305@N04,549,13,1266712566,1266712681,2,13,115
12586305@N04,549,12,1266712681,1266712954,2,13,273
12586305@N04,549,14,1266712954,1266713074,2,13,120
12586305@N04,549,2,1266714878,1266714900,2,13,22
12586305@N04,549,5,1266714900,1266715620,2,13,720
12586305@N04,549,8,1266717676,1266717796,2,13,120
12586305@N04,549,27,1266717971,1266719171,2,13,1200
125863683@N08,550,1,1417736418,1417737018,2,6,600
125863683@N08,550,9,1417741850,1417742090,2,6,240
125863683@N08,550,17,1417747272,1417748652,4,6,1380
125863683@N08,550,18,1417750356,1417751916,2,6,1560
125863683@N08,550,15,1417751916,1417752096,4,6,180
125863683@N08,550,12,1417753489,1417754329,1,6,840
125863683@N08,551,9,1417937449,1417937689,1,1,240
12592520@N03,552,16,1231040297,1231041017,5,1,720
12619133@N07,553,24,1196290776,1196291256,1,1,480
126279852@N06,554,16,1419519202,1419519922,1,1,720
126299785@N02,555,27,1468325780,1468326980,1,1,1200
12650001@N08,556,3,1388189158,1388189428,5,2,270
12650001@N08,556,9,1388212259,1388212499,1,2,240
126521704@N08,557,17,1404551802,1404553182,1,1,1380
126527286@N03,558,27,1325975582,1325976782,3,5,1200
126527286@N03,558,17,1325979067,1325979207,3,5,140
126527286@N03,558,27,1325979207,1325980407,3,5,1200
126527286@N03,558,20,1325993966,1325995046,3,5,1080
126527286@N03,558,27,1326004471,1326005671,14,5,1200
126542481@N08,559,11,1388561546,1388561726,1,1,180
12658090@N00,560,16,1384243291,1384244011,1,1,720
12659736@N02,561,27,1209950532,1209950990,2,8,458
12659736@N02,561,26,1209950990,1209951170,3,8,180
12659736@N02,561,23,1209951188,1209951278,5,8,90
12659736@N02,561,20,1209952728,1209953504,9,8,776
12659736@N02,561,18,1209953504,1209955304,7,8,1800
12659736@N02,561,16,1209962865,1209963585,5,8,720
12659736@N02,561,25,1209964252,1209965002,19,8,750
12659736@N02,561,27,1209967365,1209968565,1,8,1200
12659736@N02,562,9,1294023582,1294023822,3,2,240
12659736@N02,562,20,1294035422,1294036502,1,2,1080
12659736@N02,563,6,1327877452,1327877707,40,2,255
12659736@N02,563,8,1327884187,1327884307,1,2,120
12659736@N02,564,7,1376874135,1376874225,2,1,90
12659736@N02,565,26,1376911367,1376911547,42,1,180
12659736@N02,566,25,1420584875,1420585625,15,5,750
12659736@N02,566,6,1420590776,1420590922,3,5,146
12659736@N02,566,2,1420590922,1420590936,9,5,14
12659736@N02,566,1,1420590936,1420591536,5,5,600
12659736@N02,566,27,1420606576,1420607776,4,5,1200
12667563@N04,567,3,1291090536,1291090806,2,3,270
12667563@N04,567,4,1291090957,1291091857,5,3,900
12667563@N04,567,3,1291101195,1291101465,1,3,270
126776752@N03,568,27,1434181294,1434182494,1,1,1200
12696073@N07,569,27,1378859176,1378860376,1,1,1200
126977796@N08,570,25,1460010214,1460010964,2,9,750
126977796@N08,570,24,1460013809,1460013889,2,9,80
126977796@N08,570,23,1460013889,1460013979,2,9,90
126977796@N08,570,17,1460014333,1460014729,3,9,396
126977796@N08,570,15,1460014729,1460014770,2,9,41
126977796@N08,570,12,1460014770,1460014792,2,9,22
126977796@N08,570,15,1460014792,1460014972,2,9,180
126977796@N08,570,12,1460018557,1460019397,3,9,840
126977796@N08,570,17,1460024177,1460025557,1,9,1380
12697993@N00,571,19,1351380154,1351380574,1,1,420
127015663@N02,572,27,1415409577,1415410777,7,3,1200
127015663@N02,572,9,1415414167,1415414407,2,3,240
127015663@N02,572,11,1415414458,1415414638,1,3,180
127099627@N03,573,17,1347712042,1347713422,1,1,1380
127099627@N03,574,9,1378683187,1378683427,1,1,240
12711998@N00,575,8,1424775842,1424775962,1,1,120
127121673@N05,576,10,1411567200,1411567620,1,1,420
12720495@N04,577,27,1378293929,1378295129,1,1,1200
127278883@N08,578,27,1439427165,1439428365,11,6,1200
127278883@N08,578,4,1439428648,1439429548,5,6,900
127278883@N08,578,2,1439430869,1439430959,2,6,90
127278883@N08,578,4,1439439335,1439440235,2,6,900
127278883@N08,578,6,1439442914,1439442924,2,6,10
127278883@N08,578,9,1439442924,1439443164,5,6,240
127278883@N08,579,27,1439503540,1439504740,1,1,1200
127278883@N08,580,17,1439794347,1439795727,9,6,1380
127278883@N08,580,15,1439798767,1439798810,5,6,43
127278883@N08,580,12,1439798810,1439798971,24,6,161
127278883@N08,580,15,1439798971,1439798975,2,6,4
127278883@N08,580,12,1439798975,1439799815,58,6,840
127278883@N08,580,10,1439801394,1439801814,3,6,420
127278883@N08,581,18,1463112349,1463114149,4,1,1800
12738795@N00,582,3,1231623624,1231623894,2,2,270
12738795@N00,582,20,1231624150,1231625230,2,2,1080
12738795@N00,583,16,1231673378,1231674098,1,1,720
12738795@N00,584,9,1231727044,1231727284,1,1,240
12738795@N00,585,17,1231759585,1231760965,1,1,1380
12742129@N00,586,15,1300624588,1300624768,1,1,180
12742129@N00,587,22,1300790958,1300791558,1,1,600
127429516@N03,588,7,1425949054,1425949144,1,1,90
127484878@N05,589,14,1452277513,1452277633,1,1,120
127484878@N05,590,26,1453078366,1453078546,1,1,180
127484878@N05,591,25,1453957377,1453958127,1,1,750
127662106@N04,592,27,1409357528,1409358728,19,1,1200
127662106@N04,593,16,1413038428,1413039148,10,1,720
127662106@N04,594,27,1413630236,1413631436,3,1,1200
127662106@N04,595,16,1414244884,1414245604,3,1,720
127662106@N04,596,27,1415263873,1415265073,2,3,1200
127662106@N04,596,2,1415271343,1415271433,7,3,90
127662106@N04,596,16,1415276562,1415277282,2,3,720
127662106@N04,597,27,1420854400,1420854783,2,4,383
127662106@N04,597,4,1420854783,1420855683,2,4,900
127662106@N04,597,2,1420856415,1420856505,2,4,90
127662106@N04,597,17,1420869844,1420871224,1,4,1380
127662106@N04,598,13,1421827477,1421828077,2,2,600
127662106@N04,598,27,1421831046,1421832246,2,2,1200
127662106@N04,599,8,1422698783,1422698903,21,1,120
127662106@N04,600,27,1423369910,1423371110,5,3,1200
127662106@N04,600,18,1423371826,1423373626,2,3,1800
127662106@N04,600,20,1423374929,1423376009,3,3,1080
127802961@N07,601,19,1401254808,1401255228,1,1,420
12784818@N04,602,27,1464990529,1464991729,2,7,1200
12784818@N04,602,13,1464999749,1465000349,3,7,600
12784818@N04,602,10,1465003228,1465003648,5,7,420
12784818@N04,602,8,1465005344,1465005464,2,7,120
12784818@N04,602,14,1465005639,1465005709,2,7,70
12784818@N04,602,16,1465005709,1465006429,3,7,720
12784818@N04,602,22,1465006739,1465007339,3,7,600
12786525@N08,603,17,1188435323,1188436703,1,1,1380
128025409@N08,604,17,1410069540,1410070920,1,1,1380
128025409@N08,605,17,1410274882,1410276262,2,1,1380
128266798@N07,606,27,1449993689,1449994889,2,2,1200
128266798@N07,606,17,1450012723,1450014103,1,2,1380
128266798@N07,607,9,1458457729,1458457969,1,1,240
12827319@N00,608,27,1194173995,1194175195,1,1,1200
128287982@N02,609,27,1442328172,1442329372,1,1,1200
12834171@N06,610,16,1192592260,1192592980,1,1,720
12834171@N06,611,12,1192688284,1192689124,1,1,840
12834171@N06,612,16,1192752855,1192753575,1,1,720
128509080@N04,613,14,1409511213,1409511333,1,1,120
128509080@N04,614,21,1417085107,1417085557,2,1,450
128509080@N04,615,24,1417128187,1417128667,2,4,480
128509080@N04,615,27,1417134706,1417135906,2,4,1200
128509080@N04,615,19,1417137796,1417138216,2,4,420
128509080@N04,615,27,1417163630,1417164830,2,4,1200
128509080@N04,616,5,1417438800,1417438800,2,15,0
128509080@N04,616,16,1417438800,1417438800,3,15,0
128509080@N04,616,17,1417438800,1417438800,3,15,0
128509080@N04,616,19,1417438800,1417438800,3,15,0
128509080@N04,616,27,1417438800,1417440000,3,15,1200
128509080@N04,616,16,1417451495,1417452215,4,15,720
128509080@N04,616,21,1417461682,1417462132,4,15,450
128509080@N04,616,20,1417464267,1417464561,2,15,294
128509080@N04,616,26,1417464561,1417464741,2,15,180
128509080@N04,616,2,1417469805,1417469895,2,15,90
128509080@N04,616,16,1417471845,1417472565,4,15,720
128509080@N04,616,27,1417475107,1417476307,2,15,1200
128509080@N04,616,16,1417496490,1417497210,4,15,720
128509080@N04,616,27,1417508866,1417510066,2,15,1200
128509080@N04,616,16,1417515467,1417516187,5,15,720
128509080@N04,617,13,1417734112,1417734712,2,3,600
128509080@N04,617,20,1417735919,1417736999,5,3,1080
128509080@N04,617,21,1417740214,1417740664,1,3,450
128526407@N07,618,19,1414915462,1414915882,1,1,420
128526407@N07,619,14,1415734047,1415734167,1,1,120
128526407@N07,620,22,1415909077,1415909677,1,1,600
128526407@N07,621,26,1416260807,1416260987,1,1,180
128526407@N07,622,16,1416455963,1416456683,1,1,720
128526407@N07,623,16,1416725422,1416726142,1,1,720
128526407@N07,624,18,1416818613,1416820413,1,1,1800
128526407@N07,625,6,1416895227,1416895482,1,1,255
128526407@N07,626,25,1416954398,1416955148,2,2,750
128526407@N07,626,26,1416971114,1416971294,1,2,180
128526407@N07,627,2,1417122037,1417122127,1,1,90
128526407@N07,628,10,1417218721,1417219141,2,2,420
128526407@N07,628,16,1417237425,1417238145,1,2,720
128526407@N07,629,11,1418072861,1418073041,1,1,180
128959272@N04,630,27,1421537837,1421539037,3,1,1200
129081011@N02,631,14,1353477379,1353477499,1,1,120
129438227@N06,632,14,1399214802,1399214922,1,1,120
129438227@N06,633,16,1415275923,1415276643,1,1,720
129438227@N06,634,17,1415366943,1415368323,1,1,1380
129438227@N06,635,27,1415531064,1415532264,1,1,1200
129438227@N06,636,14,1416838081,1416838201,1,1,120
129438227@N06,637,14,1417089230,1417089350,1,1,120
129438227@N06,638,14,1417525268,1417525388,1,1,120
129438227@N06,639,17,1435943161,1435944541,1,1,1380
129438227@N06,640,14,1449840657,1449840777,1,1,120
129451096@N08,641,16,1424057934,1424058654,3,6,720
129451096@N08,641,2,1424061131,1424061221,7,6,90
129451096@N08,641,14,1424063286,1424063406,3,6,120
129451096@N08,641,16,1424064370,1424065090,9,6,720
129451096@N08,641,18,1424067150,1424068904,6,6,1754
129451096@N08,641,19,1424068904,1424069324,5,6,420
129455250@N03,642,14,1438751806,1438751926,2,1,120
129456803@N08,643,3,1417495750,1417496020,1,1,270
12946812@N03,644,16,1203392643,1203393363,2,2,720
12946812@N03,644,20,1203397604,1203398684,3,2,1080
12982579@N00,645,27,1339753543,1339754431,8,14,888
12982579@N00,645,4,1339754431,1339754567,4,14,136
12982579@N00,645,5,1339754567,1339754746,2,14,179
12982579@N00,645,2,1339754746,1339754815,2,14,69
12982579@N00,645,1,1339754815,1339755415,4,14,600
12982579@N00,645,6,1339755869,1339755952,2,14,83
12982579@N00,645,9,1339755952,1339756130,2,14,178
12982579@N00,645,14,1339756130,1339756250,5,14,120
12982579@N00,645,12,1339756789,1339757090,16,14,301
12982579@N00,645,13,1339757090,1339757117,2,14,27
12982579@N00,645,12,1339757117,1339757957,6,14,840
12982579@N00,645,17,1339757994,1339758549,5,14,555
12982579@N00,645,24,1339758549,1339759029,3,14,480
12982579@N00,645,17,1339759334,1339760714,6,14,1380
12989776@N03,646,18,1222830992,1222832792,1,1,1800
12989776@N03,647,14,1291347429,1291347549,1,1,120
12989776@N03,648,27,1291776453,1291777653,1,1,1200
12989776@N03,649,8,1306286088,1306286208,1,1,120
130069612@N06,650,14,1433412814,1433412934,2,3,120
130069612@N06,650,4,1433419900,1433420800,2,3,900
130069612@N06,650,13,1433421351,1433421951,1,3,600
130069612@N06,651,16,1463436630,1463436973,2,2,343
130069612@N06,651,27,1463436973,1463438173,2,2,1200
130069612@N06,652,10,1463919168,1463919588,2,2,420
130069612@N06,652,16,1463920299,1463921019,3,2,720
130069612@N06,653,22,1464066268,1464066868,10,1,600
130127205@N04,654,27,1455667749,1455668949,4,6,1200
130127205@N04,654,8,1455673343,1455673463,5,6,120
130127205@N04,654,1,1455681632,1455682232,3,6,600
130127205@N04,654,27,1455693270,1455694470,2,6,1200
130127205@N04,654,22,1455699840,1455700440,4,6,600
130127205@N04,654,20,1455701556,1455702636,1,6,1080
13032456@N05,655,13,1381709831,1381710431,2,3,600
13032456@N05,655,17,1381714737,1381716117,2,3,1380
13032456@N05,655,12,1381721940,1381722780,1,3,840
13032456@N05,656,2,1381808549,1381808639,2,2,90
13032456@N05,656,10,1381818015,1381818435,1,2,420
130411095@N07,657,8,1430713270,1430713390,2,1,120
13051628@N00,658,3,1251354689,1251354959,1,1,270
13051628@N00,659,4,1251619164,1251620064,2,1,900
13051628@N00,660,4,1252756811,1252757064,2,2,253
13051628@N00,660,3,1252757064,1252757334,1,2,270
13051628@N00,661,4,1253617181,1253618081,1,1,900
13051628@N00,662,3,1253698944,1253699214,3,3,270
13051628@N00,662,4,1253707759,1253708659,2,3,900
13051628@N00,662,3,1253712503,1253712773,1,3,270
13051628@N00,663,27,1259652510,1259653710,3,1,1200
13051628@N00,664,27,1288496732,1288497932,1,1,1200
13051628@N00,665,27,1291794808,1291796008,6,1,1200
13051628@N00,666,27,1291893398,1291894598,3,4,1200
13051628@N00,666,3,1291894720,1291894990,2,4,270
13051628@N00,666,4,1291895056,1291895538,2,4,482
13051628@N00,666,27,1291895538,1291896738,4,4,1200
13051628@N00,667,3,1292996359,1292996629,2,3,270
13051628@N00,667,27,1293012959,1293014159,2,3,1200
13051628@N00,667,4,1293036020,1293036920,1,3,900
13051628@N00,668,27,1293076053,1293077253,1,1,1200
13051628@N00,669,4,1293116863,1293117763,1,1,900
13051628@N00,670,4,1293530993,1293531893,2,1,900
13051628@N00,671,4,1293617782,1293618682,1,1,900
13051628@N00,672,4,1294036430,1294037330,4,1,900
13051628@N00,673,4,1296456273,1296457173,5,2,900
13051628@N00,673,3,1296463773,1296464043,1,2,270
130829701@N04,674,23,1459218992,1459219082,2,2,90
130829701@N04,674,20,1459224320,1459225400,2,2,1080
130895783@N02,675,27,1424738942,1424740142,1,1,1200
13091463@N00,676,27,1194906655,1194907855,3,1,1200
13116303@N03,677,9,1330819986,1330820226,1,1,240
13120483@N03,678,27,1423261274,1423262474,2,3,1200
13120483@N03,678,2,1423263696,1423263786,2,3,90
13120483@N03,678,15,1423288382,1423288562,1,3,180
13120483@N03,679,27,1423432375,1423433058,2,5,683
13120483@N03,679,9,1423433058,1423433298,3,5,240
13120483@N03,679,1,1423441827,1423442427,3,5,600
13120483@N03,679,21,1423448448,1423448898,2,5,450
13120483@N03,679,10,1423460362,1423460782,1,5,420
13137063@N05,680,27,1370311770,1370312970,2,2,1200
13137063@N05,680,17,1370323985,1370325365,2,2,1380
131412080@N05,681,27,1450734377,1450735577,5,17,1200
131412080@N05,681,9,1450736030,1450736270,14,17,240
131412080@N05,681,14,1450738593,1450738713,7,17,120
131412080@N05,681,16,1450739008,1450739728,2,17,720
131412080@N05,681,8,1450741134,1450741254,3,17,120
131412080@N05,681,11,1450741731,1450741889,2,17,158
131412080@N05,681,10,1450741889,1450742309,3,17,420
131412080@N05,681,2,1450744534,1450744624,3,17,90
131412080@N05,681,5,1450747921,1450748641,2,17,720
131412080@N05,681,17,1450749670,1450750030,3,17,360
131412080@N05,681,19,1450750030,1450750450,2,17,420
131412080@N05,681,27,1450770173,1450770720,4,17,547
131412080@N05,681,4,1450770720,1450771054,2,17,334
131412080@N05,681,3,1450771054,1450771324,4,17,270
131412080@N05,681,24,1450780371,1450780738,2,17,367
131412080@N05,681,21,1450780738,1450781022,2,17,284
131412080@N05,681,24,1450781022,1450781502,5,17,480
131412080@N05,682,17,1450907914,1450908010,2,24,96
131412080@N05,682,22,1450908010,1450908112,5,24,102
131412080@N05,682,20,1450908112,1450908401,2,24,289
131412080@N05,682,19,1450908401,1450908821,3,24,420
131412080@N05,682,20,1450909236,1450909788,13,24,552
131412080@N05,682,19,1450909788,1450909876,4,24,88
131412080@N05,682,20,1450909876,1450910187,4,24,311
131412080@N05,682,21,1450910187,1450910218,2,24,31
131412080@N05,682,20,1450910218,1450911298,5,24,1080
131412080@N05,682,22,1450911860,1450911997,2,24,137
131412080@N05,682,18,1450911997,1450912954,3,24,957
131412080@N05,682,19,1450912954,1450913374,4,24,420
131412080@N05,682,13,1450914429,1450914464,3,24,35
131412080@N05,682,18,1450914464,1450915137,4,24,673
131412080@N05,682,13,1450915137,1450915737,10,24,600
131412080@N05,682,15,1450916269,1450916449,3,24,180
131412080@N05,682,12,1450916462,1450916531,3,24,69
131412080@N05,682,13,1450916531,1450916800,7,24,269
131412080@N05,682,12,1450916800,1450917640,2,24,840
131412080@N05,682,14,1450918541,1450918661,2,24,120
131412080@N05,682,10,1450918759,1450919179,22,24,420
131412080@N05,682,9,1450940300,1450940540,2,24,240
131412080@N05,682,8,1450940693,1450940813,2,24,120
131412080@N05,682,16,1450946156,1450946876,38,24,720
131412080@N05,683,24,1450995490,1450995662,2,17,172
131412080@N05,683,21,1450995662,1450995826,3,17,164
131412080@N05,683,24,1450995826,1450995965,3,17,139
131412080@N05,683,25,1450995965,1450996011,2,17,46
131412080@N05,683,24,1450996011,1450996354,3,17,343
131412080@N05,683,26,1450996354,1450996429,2,17,75
131412080@N05,683,25,1450996429,1450996965,7,17,536
131412080@N05,683,23,1450996965,1450997055,2,17,90
131412080@N05,683,20,1450997432,1450998200,2,17,768
131412080@N05,683,21,1450998200,1450998650,12,17,450
131412080@N05,683,22,1450999566,1451000166,2,17,600
131412080@N05,683,15,1451003363,1451003543,8,17,180
131412080@N05,683,14,1451003781,1451003901,5,17,120
131412080@N05,683,6,1451006941,1451007090,3,17,149
131412080@N05,683,2,1451007090,1451007180,2,17,90
131412080@N05,683,6,1451007226,1451007481,3,17,255
131412080@N05,683,27,1451009318,1451010518,1,17,1200
131437714@N07,684,3,1238131317,1238131587,13,1,270
13156986@N08,685,9,1392208756,1392208996,2,12,240
13156986@N08,685,17,1392213461,1392213503,2,12,42
13156986@N08,685,16,1392213503,1392214223,2,12,720
13156986@N08,685,13,1392225643,1392225769,2,12,126
13156986@N08,685,15,1392225769,1392225884,2,12,115
13156986@N08,685,16,1392225884,1392225910,2,12,26
13156986@N08,685,17,1392225910,1392226078,2,12,168
13156986@N08,685,26,1392226078,1392226258,2,12,180
13156986@N08,685,17,1392226693,1392228073,7,12,1380
13156986@N08,685,7,1392231015,1392231105,4,12,90
13156986@N08,685,14,1392233839,1392233959,2,12,120
13156986@N08,685,9,1392238081,1392238321,1,12,240
131849702@N06,686,22,1436144658,1436145258,2,7,600
131849702@N06,686,24,1436146339,1436146819,4,7,480
131849702@N06,686,17,1436153430,1436154810,3,7,1380
131849702@N06,686,9,1436157694,1436157934,3,7,240
131849702@N06,686,14,1436158350,1436158370,2,7,20
131849702@N06,686,16,1436158370,1436159090,2,7,720
131849702@N06,686,14,1436159848,1436159968,1,7,120
13191676@N07,687,4,1243778400,1243778400,2,5,0
13191676@N07,687,12,1243778400,1243778400,2,5,0
13191676@N07,687,13,1243778400,1243778400,2,5,0
13191676@N07,687,22,1243778400,1243778400,4,5,0
13191676@N07,687,27,1243778400,1243779600,4,5,1200
131918782@N02,688,27,1422133308,1422134508,2,15,1200
131918782@N02,688,2,1422142016,1422142106,4,15,90
131918782@N02,688,3,1422144804,1422145074,2,15,270
131918782@N02,688,5,1422148571,1422148573,2,15,2
131918782@N02,688,2,1422148573,1422148663,2,15,90
131918782@N02,688,9,1422149622,1422149862,6,15,240
131918782@N02,688,10,1422151006,1422151426,7,15,420
131918782@N02,688,9,1422151476,1422151716,2,15,240
131918782@N02,688,14,1422152623,1422152743,7,15,120
131918782@N02,688,23,1422157010,1422157034,3,15,24
131918782@N02,688,21,1422157034,1422157320,3,15,286
131918782@N02,688,23,1422157320,1422157410,3,15,90
131918782@N02,688,27,1422161824,1422163024,3,15,1200
131918782@N02,688,7,1422171859,1422171949,3,15,90
131918782@N02,688,26,1422178210,1422178390,4,15,180
131918782@N02,689,27,1422224408,1422225608,2,7,1200
131918782@N02,689,10,1422227045,1422227465,11,7,420
131918782@N02,689,27,1422246121,1422247321,7,7,1200
131918782@N02,689,21,1422251659,1422252109,4,7,450
131918782@N02,689,3,1422255575,1422255845,2,7,270
131918782@N02,689,16,1422258093,1422258813,3,7,720
131918782@N02,689,10,1422260029,1422260449,3,7,420
131918782@N02,690,14,1422408715,1422408835,17,12,120
131918782@N02,690,18,1422413452,1422414332,4,12,880
131918782@N02,690,13,1422414332,1422414364,3,12,32
131918782@N02,690,18,1422414364,1422414374,2,12,10
131918782@N02,690,13,1422414374,1422414409,2,12,35
131918782@N02,690,18,1422414409,1422416209,2,12,1800
131918782@N02,690,25,1422420470,1422420485,4,12,15
131918782@N02,690,17,1422420485,1422420494,2,12,9
131918782@N02,690,25,1422420494,1422420501,2,12,7
131918782@N02,690,26,1422420501,1422420607,2,12,106
131918782@N02,690,25,1422420607,1422421357,2,12,750
131918782@N02,690,6,1422426476,1422426731,2,12,255
131918782@N02,691,2,1442569544,1442569634,1,1,90
13199533@N04,692,18,1310984931,1310986731,1,1,1800
13205707@N00,693,16,1242043657,1242044377,3,1,720
132066133@N04,694,10,1461624830,1461625250,2,2,420
132066133@N04,694,27,1461646253,1461647453,1,2,1200
132132547@N04,695,15,1427756554,1427756734,3,2,180
132132547@N04,695,10,1427784070,1427784490,1,2,420
132132547@N04,696,27,1428558033,1428559233,2,4,1200
132132547@N04,696,15,1428566562,1428566742,2,4,180
132132547@N04,696,19,1428571400,1428571820,2,4,420
132132547@N04,696,15,1428575325,1428575505,1,4,180
132133260@N06,697,14,1435182851,1435182971,1,1,120
132357461@N07,698,15,1405750703,1405750883,1,1,180
132357461@N07,699,14,1405816518,1405816638,1,1,120
132472019@N05,700,23,1439950917,1439951007,2,3,90
132472019@N05,700,12,1439969526,1439970366,4,3,840
132472019@N05,700,17,1439974928,1439976308,1,3,1380
13259518@N00,701,16,1245300007,1245300451,3,5,444
13259518@N00,701,14,1245300451,1245300571,3,5,120
13259518@N00,701,15,1245301200,1245301380,2,5,180
13259518@N00,701,3,1245303923,1245304193,2,5,270
13259518@N00,701,27,1245314588,1245315788,2,5,1200
13269428@N04,702,9,1233649391,1233649631,1,1,240
132743212@N07,703,4,1372766628,1372767528,3,1,900
132959156@N02,704,15,1435407640,1435407820,2,2,180
132959156@N02,704,21,1435409734,1435410184,1,2,450
132959156@N02,705,14,1436531802,1436531922,1,1,120
132959156@N02,706,12,1439557048,1439557888,2,2,840
132959156@N02,706,14,1439558504,1439558624,1,2,120
132959156@N02,707,26,1443177074,1443177254,1,1,180
132959156@N02,708,1,1454640441,1454641041,1,1,600
132959156@N02,709,26,1455975077,1455975257,1,1,180
133471560@N03,710,27,1442030296,1442031496,1,1,1200
133471560@N03,711,27,1442474448,1442475648,1,1,1200
133471560@N03,712,27,1453248483,1453249683,1,1,1200
13353749@N06,713,16,1195699479,1195700199,1,1,720
13359849@N00,714,27,1383806670,1383807870,2,1,1200
13415254@N05,715,9,1192608234,1192608474,1,1,240
13417605@N00,716,16,1441247456,1441248176,1,1,720
13417605@N00,717,20,1441691332,1441692412,2,2,1080
13417605@N00,717,2,1441696779,1441696869,2,2,90
13444787@N08,718,14,1303368557,1303368677,1,1,120
134814033@N03,719,27,1452036186,1452036595,2,14,409
134814033@N03,719,4,1452036595,1452037495,2,14,900
134814033@N03,719,25,1452038878,1452039628,3,14,750
134814033@N03,719,20,1452042133,1452043213,3,14,1080
134814033@N03,719,19,1452043679,1452044099,3,14,420
134814033@N03,719,25,1452048821,1452049571,3,14,750
134814033@N03,719,17,1452053570,1452054950,8,14,1380
134814033@N03,719,18,1452055450,1452056503,2,14,1053
134814033@N03,719,13,1452056503,1452056825,2,14,322
134814033@N03,719,18,1452056825,1452058625,2,14,1800
134814033@N03,719,23,1452060724,1452060814,3,14,90
134814033@N03,719,14,1452063064,1452063184,2,14,120
134814033@N03,719,9,1452064224,1452064464,2,14,240
134814033@N03,719,6,1452064668,1452064923,4,14,255
13487696@N04,720,23,1378277735,1378277825,1,1,90
135134438@N07,721,4,1427879784,1427880684,1,1,900
13516406@N00,722,27,1367188670,1367189870,3,4,1200
13516406@N00,722,9,1367190178,1367190418,3,4,240
13516406@N00,722,21,1367195884,1367196334,2,4,450
13516406@N00,722,10,1367204930,1367205350,1,4,420
135322752@N06,723,19,1439704169,1439704589,2,4,420
135322752@N06,723,12,1439712628,1439713468,2,4,840
135322752@N06,723,16,1439736013,1439736733,2,4,720
135322752@N06,723,27,1439747754,1439748954,1,4,1200
135322752@N06,724,18,1440514949,1440516749,1,1,1800
135322752@N06,725,23,1440676388,1440676478,1,1,90
13533794@N00,726,27,1212794701,1212795901,18,24,1200
13533794@N00,726,13,1212797031,1212797631,16,24,600
13533794@N00,726,25,1212799182,1212799858,21,24,676
13533794@N00,726,23,1212799858,1212799948,5,24,90
13533794@N00,726,19,1212801507,1212801927,5,24,420
13533794@N00,726,15,1212802568,1212802748,8,24,180
13533794@N00,726,12,1212803064,1212803904,13,24,840
13533794@N00,726,14,1212804023,1212804143,2,24,120
13533794@N00,726,9,1212805344,1212805584,2,24,240
13533794@N00,726,1,1212807704,1212808304,6,24,600
13533794@N00,726,27,1212824055,1212825255,4,24,1200
13533794@N00,726,13,1212826186,1212826786,3,24,600
13533794@N00,726,21,1212828116,1212828315,2,24,199
13533794@N00,726,25,1212828315,1212828966,23,24,651
13533794@N00,726,23,1212828966,1212829056,7,24,90
13533794@N00,726,12,1212832091,1212832931,35,24,840
13533794@N00,726,9,1212834295,1212834535,14,24,240
13533794@N00,726,6,1212835016,1212835175,4,24,159
13533794@N00,726,7,1212835175,1212835265,11,24,90
13533794@N00,726,6,1212835313,1212835317,2,24,4
13533794@N00,726,7,1212835317,1212835391,5,24,74
13533794@N00,726,6,1212835391,1212835646,8,24,255
13533794@N00,726,1,1212836620,1212837220,5,24,600
13533794@N00,726,16,1212837710,1212838430,3,24,720
13599014@N08,727,27,1376952823,1376954023,6,1,1200
13604385@N00,728,25,1352596487,1352597237,4,6,750
13604385@N00,728,19,1352602131,1352602551,2,6,420
13604385@N00,728,13,1352604236,1352604836,2,6,600
13604385@N00,728,25,1352619282,1352620032,5,6,750
13604385@N00,728,16,1352625086,1352625806,2,6,720
13604385@N00,728,27,1352627607,1352628807,10,6,1200
13613904@N05,729,16,1210762998,1210763718,6,1,720
13613904@N05,730,16,1210936152,1210936872,2,1,720
13613904@N05,731,20,1274670990,1274671500,2,4,510
13613904@N05,731,19,1274671500,1274671920,2,4,420
13613904@N05,731,14,1274673186,1274673306,2,4,120
13613904@N05,731,1,1274680920,1274681520,1,4,600
13613904@N05,732,16,1274886608,1274887328,1,1,720
136325095@N07,733,17,1443007481,1443008861,1,1,1380
13636518@N05,734,21,1300185078,1300185528,3,1,450
13644648@N03,735,20,1254021522,1254021526,2,5,4
13644648@N03,735,13,1254021526,1254021527,2,5,1
13644648@N03,735,17,1254021527,1254021535,2,5,8
13644648@N03,735,8,1254021535,1254021536,2,5,1
13644648@N03,735,3,1254021536,1254021806,1,5,270
13644648@N03,736,13,1254643622,1254643626,4,10,4
13644648@N03,736,17,1254643626,1254645006,2,10,1380
13644648@N03,736,3,1254659291,1254659294,2,10,3
13644648@N03,736,15,1254659294,1254659302,2,10,8
13644648@N03,736,4,1254659302,1254659308,2,10,6
13644648@N03,736,21,1254659308,1254659316,2,10,8
13644648@N03,736,18,1254659316,1254659317,2,10,1
13644648@N03,736,19,1254659317,1254659319,2,10,2
13644648@N03,736,4,1254659319,1254659320,2,10,1
13644648@N03,736,3,1254659320,1254659590,1,10,270
13644648@N03,737,22,1287811533,1287811534,2,35,1
13644648@N03,737,15,1287811534,1287811535,2,35,1
13644648@N03,737,17,1287811535,1287811537,3,35,2
13644648@N03,737,14,1287811537,1287811537,2,35,0
13644648@N03,737,18,1287811537,1287811540,2,35,3
13644648@N03,737,15,1287811540,1287811540,2,35,0
13644648@N03,737,16,1287811540,1287811541,2,35,1
13644648@N03,737,24,1287811541,1287811542,2,35,1
13644648@N03,737,3,1287811542,1287811543,2,35,1
13644648@N03,737,16,1287811543,1287811544,2,35,1
13644648@N03,737,23,1287811544,1287811545,2,35,1
13644648@N03,737,18,1287811545,1287811547,3,35,2
13644648@N03,737,19,1287811547,1287811551,4,35,4
13644648@N03,737,20,1287811551,1287811552,2,35,1
13644648@N03,737,19,1287811552,1287811553,2,35,1
13644648@N03,737,22,1287811553,1287811554,2,35,1
13644648@N03,737,18,1287811554,1287811555,2,35,1
13644648@N03,737,20,1287811555,1287812623,2,35,1068
13644648@N03,737,6,1287812623,1287812624,2,35,1
13644648@N03,737,1,1287812624,1287812625,2,35,1
13644648@N03,737,27,1287812625,1287812628,4,35,3
13644648@N03,737,20,1287812628,1287812629,2,35,1
13644648@N03,737,14,1287812629,1287812631,2,35,2
13644648@N03,737,27,1287812631,1287812632,2,35,1
13644648@N03,737,14,1287812632,1287812634,2,35,2
13644648@N03,737,27,1287812634,1287812635,2,35,1
13644648@N03,737,4,1287812635,1287812636,2,35,1
13644648@N03,737,7,1287812636,1287812637,2,35,1
13644648@N03,737,26,1287812637,1287812640,3,35,3
13644648@N03,737,23,1287812640,1287812641,2,35,1
13644648@N03,737,22,1287812641,1287812644,4,35,3
13644648@N03,737,18,1287812644,1287812646,2,35,2
13644648@N03,737,20,1287812646,1287812650,5,35,4
13644648@N03,737,22,1287812650,1287812651,2,35,1
13644648@N03,737,14,1287812651,1287812771,1,35,120
13656125@N00,738,16,1361654958,1361655678,1,1,720
13656125@N00,739,16,1361696535,1361697255,1,1,720
136975147@N03,740,27,1458696058,1458697258,4,4,1200
136975147@N03,740,23,1458698931,1458699021,2,4,90
136975147@N03,740,13,1458708262,1458708862,3,4,600
136975147@N03,740,9,1458710005,1458710245,3,4,240
13703871@N00,741,21,1320626744,1320627194,1,1,450
13722851@N04,742,16,1302097187,1302097907,1,1,720
13725122@N02,743,27,1368853569,1368854769,1,1,1200
13726219@N06,744,17,1209124356,1209125736,1,1,1380
13726219@N06,745,17,1243079131,1243079188,2,2,57
13726219@N06,745,27,1243079188,1243080388,2,2,1200
13726219@N06,746,24,1291452464,1291452944,1,1,480
13726219@N06,747,25,1291552589,1291553339,1,1,750
13726219@N06,748,25,1291631066,1291631816,1,1,750
13726219@N06,749,4,1291791268,1291792168,1,1,900
13726219@N06,750,21,1350588772,1350589222,1,1,450
13726219@N06,751,21,1350733435,1350733885,1,1,450
13726219@N06,752,21,1350845442,1350845892,6,5,450
13726219@N06,752,22,1350857595,1350858195,2,5,600
13726219@N06,752,17,1350858425,1350859183,2,5,758
13726219@N06,752,13,1350859183,1350859783,2,5,600
13726219@N06,752,21,1350861045,1350861495,1,5,450
13764100@N05,753,27,1236991460,1236992660,5,1,1200
13764100@N05,754,27,1241854830,1241856030,1,1,1200
13764100@N05,755,27,1241928830,1241930030,1,1,1200
13764100@N05,756,27,1348728606,1348729806,7,1,1200
13775066@N00,757,27,1382738323,1382739523,29,1,1200
13813159@N00,758,10,1354172635,1354172891,3,5,256
13813159@N00,758,8,1354172891,1354173011,5,5,120
13813159@N00,758,20,1354174054,1354174139,2,5,85
13813159@N00,758,13,1354174139,1354174259,2,5,120
13813159@N00,758,16,1354174259,1354174979,2,5,720
13813159@N00,759,2,1354224390,1354224480,2,1,90
13818837@N05,760,16,1308601629,1308602011,2,3,382
13818837@N05,760,17,1308602011,1308603391,2,3,1380
13818837@N05,760,13,1308615558,1308616158,2,3,600
138748094@N04,761,15,1389682766,1389682946,1,1,180
13880897@N06,762,27,1360901354,1360902554,8,2,1200
13880897@N06,762,20,1360908432,1360909512,1,2,1080
13880897@N06,763,27,1360976645,1360977357,6,5,712
13880897@N06,763,9,1360977357,1360977597,6,5,240
13880897@N06,763,8,1360979893,1360979919,2,5,26
13880897@N06,763,7,1360979919,1360980009,5,5,90
13880897@N06,763,26,1360981734,1360981914,3,5,180
13880897@N06,764,14,1402801066,1402801186,3,3,120
13880897@N06,764,19,1402804350,1402804507,2,3,157
13880897@N06,764,7,1402804507,1402804597,1,3,90
13880897@N06,765,27,1402900907,1402902107,3,5,1200
13880897@N06,765,10,1402915352,1402915387,2,5,35
13880897@N06,765,14,1402915387,1402915507,3,5,120
13880897@N06,765,27,1402923089,1402923261,2,5,172
13880897@N06,765,10,1402923261,1402923681,1,5,420
13885531@N00,766,17,1226183206,1226183319,2,4,113
13885531@N00,766,15,1226183319,1226183499,2,4,180
13885531@N00,766,17,1226188782,1226190162,2,4,1380
13885531@N00,766,14,1226194397,1226194517,1,4,120
13901020@N02,767,27,1190416279,1190416563,33,4,284
13901020@N02,767,25,1190416563,1190416830,11,4,267
13901020@N02,767,27,1190416830,1190416871,2,4,41
13901020@N02,767,16,1190416871,1190417591,1,4,720
139081931@N05,768,20,1408609000,1408610080,1,1,1080
139081931@N05,769,22,1409039011,1409039035,2,2,24
139081931@N05,769,26,1409039035,1409039215,2,2,180
139081931@N05,770,27,1409179903,1409181103,1,1,1200
139081931@N05,771,14,1409632188,1409632308,3,2,120
139081931@N05,771,15,1409638528,1409638708,1,2,180
139081931@N05,772,14,1458382872,1458382992,2,1,120
13915720@N07,773,9,1345978848,1345979088,1,1,240
13929738@N04,774,26,1195099835,1195100015,1,1,180
13933131@N08,775,27,1316894550,1316895750,16,16,1200
13933131@N08,775,25,1316900064,1316900814,3,16,750
13933131@N08,775,21,1316901309,1316901372,2,16,63
13933131@N08,775,27,1316901372,1316902451,7,16,1079
13933131@N08,775,21,1316902451,1316902901,2,16,450
13933131@N08,775,27,1316903269,1316904469,3,16,1200
13933131@N08,775,25,1316906626,1316907018,3,16,392
13933131@N08,775,24,1316907018,1316907498,2,16,480
13933131@N08,775,14,1316912472,1316912592,2,16,120
13933131@N08,775,27,1316915148,1316916348,12,16,1200
13933131@N08,775,16,1316941259,1316941369,2,16,110
13933131@N08,775,4,1316941369,1316942269,4,16,900
13933131@N08,775,27,1316946727,1316946746,2,16,19
13933131@N08,775,20,1316946746,1316946814,2,16,68
13933131@N08,775,27,1316946814,1316948014,2,16,1200
13933131@N08,775,3,1316951283,1316951553,1,16,270
13933131@N08,776,17,1381542354,1381542454,2,3,100
13933131@N08,776,13,1381542454,1381543054,5,3,600
13933131@N08,776,11,1381547295,1381547475,1,3,180
13933131@N08,777,9,1381868349,1381868589,6,1,240
13933131@N08,778,27,1393660636,1393661836,2,2,1200
13933131@N08,778,7,1393664516,1393664606,1,2,90
13933131@N08,779,17,1393709887,1393711267,1,1,1380
13943185@N00,780,27,1225415221,1225416421,1,1,1200
13943185@N00,781,16,1229296415,1229297135,1,1,720
13959240@N08,782,27,1345939964,1345941164,2,2,1200
13959240@N08,782,17,1345947365,1345948745,1,2,1380
13959240@N08,783,3,1346059709,1346059979,1,1,270
13959240@N08,784,27,1346229983,1346231183,1,1,1200
13959240@N08,785,17,1346367812,1346369192,2,2,1380
13959240@N08,785,27,1346380612,1346381812,1,2,1200
13959240@N08,786,18,1346472165,1346473965,1,1,1800
13991097@N02,787,22,1323232536,1323233136,2,2,600
13991097@N02,787,17,1323254761,1323256141,3,2,1380
14003861@N06,788,16,1434570702,1434571422,3,1,720
140621810@N05,789,16,1460958998,1460959718,1,1,720
14125170@N02,790,22,1273413600,1273414200,16,1,600
14125170@N02,791,22,1273759200,1273759800,14,1,600
14129109@N07,792,27,1344580323,1344581523,9,1,1200
14130502@N07,793,27,1310112825,1310113082,2,4,257
14130502@N07,793,16,1310113082,1310113359,2,4,277
14130502@N07,793,27,1310113359,1310114559,14,4,1200
14130502@N07,793,21,1310118429,1310118879,2,4,450
14135751@N07,794,15,1365642911,1365643048,2,8,137
14135751@N07,794,10,1365643048,1365643468,8,8,420
14135751@N07,794,14,1365646163,1365646283,3,8,120
14135751@N07,794,12,1365646401,1365647241,2,8,840
14135751@N07,794,15,1365649744,1365649750,2,8,6
14135751@N07,794,17,1365649750,1365651130,2,8,1380
14135751@N07,794,20,1365652329,1365653409,2,8,1080
14135751@N07,794,21,1365655035,1365655485,1,8,450
14157787@N07,795,16,1369660199,1369660919,1,1,720
141774505@N07,796,6,1459312373,1459312628,2,1,255
14208013@N06,797,10,1392852787,1392853207,2,3,420
14208013@N06,797,9,1392853578,1392853818,2,3,240
14208013@N06,797,14,1392866954,1392867074,1,3,120
14233893@N02,798,27,1328482985,1328484185,2,2,1200
14233893@N02,798,16,1328506875,1328507595,1,2,720
14233893@N02,799,27,1328647890,1328649090,1,1,1200
14242929@N02,800,27,1190970748,1190971948,1,1,1200
14246866@N05,801,27,1296874758,1296875958,5,2,1200
14246866@N05,801,17,1296879427,1296880807,1,2,1380
14246866@N05,802,14,1331338079,1331338199,3,7,120
14246866@N05,802,9,1331338379,1331338619,2,7,240
14246866@N05,802,14,1331339022,1331339142,4,7,120
14246866@N05,802,1,1331347814,1331348414,5,7,600
14246866@N05,802,27,1331350472,1331351672,2,7,1200
14246866@N05,802,23,1331358153,1331358243,3,7,90
14246866@N05,802,18,1331361175,1331362975,1,7,1800
14249123@N02,803,4,1210843790,1210844690,1,1,900
14249123@N02,804,27,1211158279,1211158306,3,3,27
14249123@N02,804,4,1211158306,1211158315,2,3,9
14249123@N02,804,9,1211158315,1211158555,1,3,240
14261584@N00,805,27,1300067548,1300068748,2,11,1200
14261584@N00,805,21,1300071702,1300072152,2,11,450
14261584@N00,805,26,1300075153,1300075333,2,11,180
14261584@N00,805,17,1300077574,1300077703,2,11,129
14261584@N00,805,13,1300077703,1300077772,2,11,69
14261584@N00,805,17,1300077772,1300078738,8,11,966
14261584@N00,805,9,1300078738,1300078978,3,11,240
14261584@N00,805,17,1300079468,1300079521,2,11,53
14261584@N00,805,6,1300079521,1300079757,2,11,236
14261584@N00,805,1,1300079757,1300080357,4,11,600
14261584@N00,805,17,1300085886,1300087266,2,11,1380
14280234@N04,806,17,1330942746,1330944126,1,1,1380
14280458@N05,807,4,1284299378,1284299412,2,3,34
14280458@N05,807,5,1284299412,1284300132,2,3,720
14280458@N05,807,4,1284303925,1284304825,2,3,900
14280458@N05,808,27,1284473093,1284474293,2,4,1200
14280458@N05,808,26,1284476110,1284476263,3,4,153
14280458@N05,808,17,1284476263,1284477643,6,4,1380
14280458@N05,808,27,1284486220,1284487420,1,4,1200
14284806@N00,809,16,1256250324,1256251044,14,1,720
14286456@N07,810,16,1224914931,1224915651,1,1,720
14286456@N07,811,16,1225099498,1225100218,1,1,720
143025564@N02,812,22,1448671315,1448671915,1,1,600
14307363@N05,813,27,1308961934,1308963134,1,1,1200
14334279@N02,814,18,1420166482,1420168282,3,2,1800
14334279@N02,814,20,1420169358,1420170438,1,2,1080
14337325@N03,815,11,1237262176,1237262356,1,1,180
14342625@N04,816,20,1318300044,1318301124,1,1,1080
14344313@N05,817,9,1203889839,1203890079,2,3,240
14344313@N05,817,14,1203891514,1203891634,3,3,120
14344313@N05,817,12,1203894219,1203895059,1,3,840
14344313@N05,818,18,1204065008,1204066808,3,3,1800
14344313@N05,818,10,1204077706,1204078126,2,3,420
14344313@N05,818,20,1204080780,1204081860,1,3,1080
14344313@N05,819,2,1204939948,1204940038,1,1,90
14370802@N05,820,11,1402190664,1402190844,1,1,180
14399815@N07,821,10,1329179041,1329179063,2,2,22
14399815@N07,821,12,1329179063,1329179903,1,2,840
14399815@N07,822,2,1346130413,1346130503,1,1,90
14399815@N07,823,7,1348802852,1348802942,7,2,90
14399815@N07,823,12,1348807448,1348808288,6,2,840
14404008@N00,824,27,1223414345,1223415545,3,3,1200
14404008@N00,824,14,1223418090,1223418210,3,3,120
14404008@N00,824,24,1223426511,1223426991,9,3,480
14404008@N00,825,27,1223762304,1223763504,2,3,1200
14404008@N00,825,4,1223773998,1223774898,2,3,900
14404008@N00,825,27,1223777992,1223779192,1,3,1200
14404008@N00,826,27,1224277784,1224278984,2,1,1200
14428367@N00,827,16,1226794038,1226794758,11,3,720
14428367@N00,827,18,1226813350,1226815150,28,3,1800
14428367@N00,827,16,1226817310,1226818030,117,3,720
14428367@N00,828,18,1227395796,1227397596,1,1,1800
14447350@N05,829,2,1321684615,1321684705,2,1,90
144474523@N02,830,14,1247287280,1247287400,2,4,120
144474523@N02,830,21,1247288651,1247289101,2,4,450
144474523@N02,830,19,1247296942,1247297362,2,4,420
144474523@N02,830,18,1247299899,1247301699,1,4,1800
14449931@N08,831,16,1378531569,1378531922,2,3,353
14449931@N08,831,20,1378531922,1378533002,2,3,1080
14449931@N08,831,27,1378540931,1378542131,1,3,1200
14449931@N08,832,27,1378631144,1378632344,2,2,1200
14449931@N08,832,8,1378645140,1378645260,1,2,120
14449931@N08,833,15,1378772366,1378772546,2,3,180
14449931@N08,833,10,1378774073,1378774493,2,3,420
14449931@N08,833,9,1378785333,1378785573,1,3,240
14449931@N08,834,14,1379065599,1379065719,2,2,120
14449931@N08,834,8,1379074597,1379074717,1,2,120
14449931@N08,835,14,1400042691,1400042811,1,1,120
14449931@N08,836,10,1400370447,1400370867,2,1,420
14449931@N08,837,14,1400423762,1400423882,1,1,120
14449931@N08,838,27,1411118247,1411119447,1,1,1200
14449931@N08,839,11,1411254301,1411254481,2,1,180
14453171@N00,840,14,1322951444,1322951564,2,8,120
14453171@N00,840,24,1322959730,1322960210,4,8,480
14453171@N00,840,18,1322966794,1322968594,2,8,1800
14453171@N00,840,23,1322969062,1322969069,2,8,7
14453171@N00,840,22,1322969069,1322969669,2,8,600
14453171@N00,840,23,1322970628,1322970718,3,8,90
14453171@N00,840,10,1322973371,1322973377,2,8,6
14453171@N00,840,23,1322973377,1322973467,1,8,90
14472753@N02,841,15,1270191894,1270192074,1,1,180
14479515@N03,842,27,1199667891,1199669091,3,18,1200
14479515@N03,842,17,1199669161,1199669323,3,18,162
14479515@N03,842,25,1199669323,1199669980,15,18,657
14479515@N03,842,26,1199669980,1199670076,2,18,96
14479515@N03,842,24,1199670076,1199670556,24,18,480
14479515@N03,842,19,1199672677,1199673097,2,18,420
14479515@N03,842,13,1199677608,1199678208,5,18,600
14479515@N03,842,26,1199679460,1199679640,2,18,180
14479515@N03,842,18,1199680631,1199682431,6,18,1800
14479515@N03,842,17,1199682638,1199684002,4,18,1364
14479515@N03,842,14,1199684002,1199684122,7,18,120
14479515@N03,842,9,1199684413,1199684653,2,18,240
14479515@N03,842,8,1199684679,1199684799,2,18,120
14479515@N03,842,2,1199685553,1199685613,3,18,60
14479515@N03,842,3,1199685613,1199685883,5,18,270
14479515@N03,842,14,1199690322,1199690442,7,18,120
14479515@N03,842,9,1199691013,1199691253,2,18,240
14479515@N03,842,27,1199692906,1199694106,56,18,1200
14479515@N03,843,4,1254280171,1254281071,11,1,900
14479515@N03,844,4,1254379514,1254380414,7,1,900
14479515@N03,845,4,1254444378,1254445278,6,1,900
14484378@N08,846,27,1189851098,1189852298,1,1,1200
14484378@N08,847,27,1190023613,1190024813,2,1,1200
14484378@N08,848,27,1190371749,1190372949,13,1,1200
14484378@N08,849,27,1191017467,1191018667,5,1,1200
14484378@N08,850,27,1192377003,1192378203,5,1,1200
14484378@N08,851,27,1192749610,1192750810,3,1,1200
14484378@N08,852,27,1193125771,1193126971,1,1,1200
14484378@N08,853,27,1193941219,1193942419,1,1,1200
14484378@N08,854,27,1194127794,1194128994,3,1,1200
14484378@N08,855,27,1201969539,1201970739,6,1,1200
14484378@N08,856,27,1205758449,1205759649,2,1,1200
14484378@N08,857,27,1205855927,1205857127,1,1,1200
14484378@N08,858,27,1210177236,1210178436,4,1,1200
14484378@N08,859,27,1210919286,1210920486,8,1,1200
14484378@N08,860,27,1214321887,1214323087,1,1,1200
14484378@N08,861,27,1214410948,1214412148,11,1,1200
14484378@N08,862,27,1215449169,1215450369,2,1,1200
14484378@N08,863,27,1215534631,1215535831,1,1,1200
14484378@N08,864,27,1215706996,1215708196,2,1,1200
14484378@N08,865,27,1215987693,1215988893,1,1,1200
14484378@N08,866,27,1216227076,1216228276,1,1,1200
14484378@N08,867,27,1216916969,1216918169,3,1,1200
14484378@N08,868,27,1217349238,1217350438,2,1,1200
14484378@N08,869,27,1219256978,1219258178,2,1,1200
14484378@N08,870,27,1220047428,1220048628,2,1,1200
14484378@N08,871,27,1220544353,1220545553,4,1,1200
14484378@N08,872,27,1220973157,1220974357,10,1,1200
14484378@N08,873,27,1221062000,1221063200,10,1,1200
14484378@N08,874,27,1221321070,1221322270,3,1,1200
14484378@N08,875,27,1221667609,1221668809,5,1,1200
14484378@N08,876,27,1222014759,1222015959,4,1,1200
14484378@N08,877,27,1222100910,1222102110,2,1,1200
14484378@N08,878,27,1222440153,1222441353,13,1,1200
14484378@N08,879,27,1222526896,1222528096,2,1,1200
14484378@N08,880,27,1222982403,1222983603,1,1,1200
14484378@N08,881,27,1223238788,1223239988,3,1,1200
14484378@N08,882,11,1224789169,1224789349,4,1,180
14484378@N08,883,11,1224937988,1224938168,1,1,180
14484378@N08,884,11,1225990278,1225990458,5,1,180
14484378@N08,885,11,1226147617,1226147797,1,1,180
14484378@N08,886,11,1226232603,1226232783,1,1,180
14484378@N08,887,27,1226434891,1226436091,2,1,1200
14484378@N08,888,11,1226614270,1226614450,2,1,180
14484378@N08,889,11,1227220886,1227221066,1,1,180
14484378@N08,890,11,1227305349,1227305529,2,2,180
14484378@N08,890,27,1227310177,1227311377,1,2,1200
14484378@N08,891,11,1227714117,1227714297,1,1,180
14484378@N08,892,11,1230082754,1230082934,1,1,180
14484378@N08,893,11,1230176926,1230177106,1,1,180
14484378@N08,894,11,1234584295,1234584475,1,1,180
14487451@N00,895,14,1354666877,1354666997,1,1,120
14487451@N00,896,27,1354761661,1354762861,1,1,1200
14487451@N00,897,11,1354931903,1354932083,1,1,180
14489732@N00,898,16,1275817917,1275818637,1,1,720
14500034@N06,899,19,1388211003,1388211423,1,1,420
14504365@N00,900,16,1359060159,1359060879,2,4,720
14504365@N00,900,15,1359072765,1359072945,2,4,180
14504365@N00,900,11,1359076842,1359077022,2,4,180
14504365@N00,900,8,1359081719,1359081839,2,4,120
14504365@N00,901,26,1359240770,1359240950,2,9,180
14504365@N00,901,23,1359241883,1359241973,3,9,90
14504365@N00,901,24,1359242834,1359243314,2,9,480
14504365@N00,901,13,1359243569,1359244169,2,9,600
14504365@N00,901,14,1359253494,1359253614,4,9,120
14504365@N00,901,13,1359254301,1359254476,2,9,175
14504365@N00,901,18,1359254476,1359254557,2,9,81
14504365@N00,901,14,1359254557,1359254677,2,9,120
14504365@N00,901,27,1359256529,1359257729,1,9,1200
14506090@N06,902,17,1273289314,1273290694,1,1,1380
14514934@N04,903,16,1227158198,1227158918,1,1,720
14518451@N06,904,27,1394528230,1394529430,4,4,1200
14518451@N06,904,14,1394547411,1394547531,2,4,120
14518451@N06,904,10,1394554398,1394554818,2,4,420
14518451@N06,904,9,1394557931,1394558171,2,4,240
14572041@N08,905,17,1448253476,1448254856,1,1,1380
14580956@N08,906,27,1284507596,1284508096,6,14,500
14580956@N08,906,16,1284508096,1284508816,5,14,720
14580956@N08,906,14,1284509016,1284509136,6,14,120
14580956@N08,906,13,1284512963,1284513563,3,14,600
14580956@N08,906,9,1284514837,1284515077,4,14,240
14580956@N08,906,24,1284515359,1284515839,4,14,480
14580956@N08,906,17,1284523896,1284524148,2,14,252
14580956@N08,906,16,1284524148,1284524868,14,14,720
14580956@N08,906,17,1284525216,1284526596,13,14,1380
14580956@N08,906,21,1284529159,1284529609,2,14,450
14580956@N08,906,11,1284531062,1284531242,10,14,180
14580956@N08,906,18,1284535631,1284537431,9,14,1800
14580956@N08,906,2,1284540131,1284540221,2,14,90
14580956@N08,906,27,1284547131,1284548331,2,14,1200
14617498@N00,907,13,1227252001,1227252521,3,3,520
14617498@N00,907,14,1227252521,1227252641,2,3,120
14617498@N00,907,21,1227261676,1227262126,1,3,450
14617498@N00,908,9,1255681151,1255681391,2,2,240
14617498@N00,908,13,1255682796,1255683396,3,2,600
14617498@N00,909,11,1296264643,1296264823,2,2,180
14617498@N00,909,21,1296270725,1296271175,1,2,450
14621985@N05,910,16,1327379258,1327379978,2,4,720
14621985@N05,910,23,1327380259,1327380349,2,4,90
14621985@N05,910,27,1327380486,1327380769,2,4,283
14621985@N05,910,25,1327380769,1327381519,1,4,750
14621985@N05,911,9,1327430470,1327430710,1,1,240
14621985@N05,912,27,1327715398,1327715522,2,7,124
14621985@N05,912,23,1327715522,1327715612,2,7,90
14621985@N05,912,25,1327715851,1327715944,2,7,93
14621985@N05,912,26,1327715944,1327716038,2,7,94
14621985@N05,912,27,1327716038,1327717224,2,7,1186
14621985@N05,912,6,1327717224,1327717434,2,7,210
14621985@N05,912,16,1327717434,1327718154,2,7,720
14625004@N00,913,27,1195343433,1195344633,5,1,1200
14625004@N00,914,27,1195726817,1195728017,4,1,1200
14625004@N00,915,4,1195809599,1195810499,2,2,900
14625004@N00,915,6,1195812962,1195813217,1,2,255
14627430@N00,916,7,1258876374,1258876464,1,1,90
14631943@N08,917,16,1190512151,1190512871,6,1,720
14631943@N08,918,16,1192016139,1192016859,1,1,720
14764161@N00,919,15,1383224400,1383224580,1,1,180
14769156@N08,920,27,1414228694,1414229560,87,2,866
14769156@N08,920,4,1414229560,1414230460,1,2,900
14769156@N08,921,15,1417954028,1417954208,2,4,180
14769156@N08,921,24,1417954242,1417954722,2,4,480
14769156@N08,921,26,1417955338,1417955448,3,4,110
14769156@N08,921,22,1417955448,1417956048,6,4,600
14769156@N08,922,12,1423271708,1423272548,2,2,840
14769156@N08,922,21,1423272973,1423273423,2,2,450
14769156@N08,923,27,1439903688,1439903724,2,5,36
14769156@N08,923,9,1439903724,1439903739,2,5,15
14769156@N08,923,14,1439903739,1439903764,2,5,25
14769156@N08,923,8,1439903764,1439903765,2,5,1
14769156@N08,923,14,1439903765,1439903885,1,5,120
14769156@N08,924,9,1441889932,1441890172,1,1,240
14802142@N02,925,21,1421466274,1421466724,3,1,450
14805586@N03,926,16,1274152477,1274153197,6,4,720
14805586@N03,926,9,1274153558,1274153798,10,4,240
14805586@N03,926,17,1274165448,1274166828,10,4,1380
14805586@N03,926,26,1274170389,1274170569,1,4,180
14831331@N07,927,13,1420891888,1420892488,1,1,600
14831331@N07,928,8,1420948404,1420948524,1,1,120
14845075@N00,929,23,1407218720,1407218810,2,2,90
14845075@N00,929,14,1407236916,1407237036,3,2,120
14847653@N00,930,24,1324082395,1324082875,2,2,480
14847653@N00,930,18,1324097551,1324099351,1,2,1800
14852593@N00,931,16,1344568591,1344569311,2,1,720
14898307@N00,932,1,1360217107,1360217707,2,3,600
14898307@N00,932,2,1360223478,1360223568,2,3,90
14898307@N00,932,21,1360227483,1360227933,1,3,450
14898307@N00,933,15,1360276634,1360276814,1,1,180
14898307@N00,934,14,1360490841,1360490961,2,1,120
14898307@N00,935,20,1360632197,1360633277,1,1,1080
14904592@N04,936,2,1292048043,1292048133,1,1,90
14912537@N04,937,27,1394251262,1394252462,1,1,1200
14915921@N00,938,16,1196579428,1196580148,2,1,720
14934218@N03,939,27,1251584584,1251585784,5,5,1200
14934218@N03,939,26,1251592582,1251592762,4,5,180
14934218@N03,939,16,1251609595,1251610315,2,5,720
14934218@N03,939,14,1251622274,1251622394,2,5,120
14934218@N03,939,16,1251624176,1251624896,2,5,720
14934218@N03,940,16,1251668783,1251669503,1,1,720
14958748@N00,941,16,1380423268,1380423988,1,1,720
15021432@N00,942,24,1190332486,1190332966,1,1,480
15021432@N00,943,26,1193991513,1193991693,1,1,180
15021432@N00,944,26,1201940249,1201940429,2,2,180
15021432@N00,944,20,1201945211,1201946291,5,2,1080
15021432@N00,945,2,1222398958,1222399048,2,3,90
15021432@N00,945,16,1222405077,1222405797,3,3,720
15021432@N00,945,21,1222421624,1222422074,1,3,450
15021432@N00,946,20,1229386586,1229387666,2,3,1080
15021432@N00,946,14,1229397812,1229397932,2,3,120
15021432@N00,946,27,1229409712,1229410912,1,3,1200
15021432@N00,947,22,1229834352,1229834952,16,1,600
15021432@N00,948,2,1237027405,1237027495,1,1,90
15066420@N00,949,21,1208056603,1208057053,1,1,450
15066420@N00,950,23,1210630554,1210630644,1,1,90
15066420@N00,951,14,1212753080,1212753200,2,5,120
15066420@N00,951,17,1212754012,1212754922,2,5,910
15066420@N00,951,13,1212754922,1212755522,2,5,600
15066420@N00,951,26,1212756334,1212756514,4,5,180
15066420@N00,951,19,1212758573,1212758993,4,5,420
15079826@N00,952,27,1400788512,1400789712,4,34,1200
15079826@N00,952,14,1400790518,1400790638,5,34,120
15079826@N00,952,7,1400792932,1400793022,3,34,90
15079826@N00,952,9,1400794045,1400794285,13,34,240
15079826@N00,952,8,1400797874,1400797994,4,34,120
15079826@N00,952,2,1400798962,1400799052,7,34,90
15079826@N00,952,6,1400802267,1400802522,6,34,255
15079826@N00,952,9,1400803404,1400803644,2,34,240
15079826@N00,952,12,1400803996,1400804836,2,34,840
15079826@N00,952,19,1400805059,1400805479,8,34,420
15079826@N00,952,10,1400806839,1400807259,2,34,420
15079826@N00,952,16,1400807658,1400808378,2,34,720
15079826@N00,952,20,1400811236,1400812316,3,34,1080
15079826@N00,952,27,1400814519,1400815475,5,34,956
15079826@N00,952,25,1400815475,1400816225,2,34,750
15079826@N00,952,22,1400823300,1400823900,17,34,600
15079826@N00,952,23,1400824279,1400824369,3,34,90
15079826@N00,952,21,1400825194,1400825644,2,34,450
15079826@N00,952,25,1400829264,1400830014,3,34,750
15079826@N00,952,15,1400830935,1400831115,2,34,180
15079826@N00,952,18,1400834879,1400835267,6,34,388
15079826@N00,952,19,1400835267,1400835687,3,34,420
15079826@N00,952,18,1400835868,1400837668,6,34,1800
15079826@N00,952,27,1400841435,1400842635,2,34,1200
15079826@N00,952,6,1400843345,1400843600,5,34,255
15079826@N00,952,18,1400846032,1400847832,5,34,1800
15079826@N00,952,22,1400848042,1400848642,3,34,600
15079826@N00,952,20,1400853066,1400853900,3,34,834
15079826@N00,952,19,1400853900,1400854320,3,34,420
15079826@N00,952,17,1400859642,1400861022,3,34,1380
15079826@N00,952,27,1400861380,1400862580,7,34,1200
15079826@N00,952,16,1400866491,1400867211,11,34,720
15079826@N00,952,25,1400872934,1400873684,2,34,750
15079826@N00,952,27,1400875222,1400876422,1,34,1200
15102029@N00,953,2,1276483656,1276483746,3,1,90
15225068@N03,954,17,1292401083,1292401987,3,2,904
15225068@N03,954,16,1292401987,1292402707,1,2,720
15261067@N00,955,14,1401334040,1401334160,2,3,120
15261067@N00,955,25,1401344166,1401344916,2,3,750
15261067@N00,955,3,1401365388,1401365658,1,3,270
15261067@N00,956,3,1401451513,1401451783,1,1,270
15265115@N06,957,27,1359252220,1359253420,7,13,1200
15265115@N06,957,17,1359253966,1359255346,4,13,1380
15265115@N06,957,18,1359257301,1359257311,2,13,10
15265115@N06,957,13,1359257311,1359257320,2,13,9
15265115@N06,957,17,1359257320,1359257927,2,13,607
15265115@N06,957,18,1359257927,1359258157,3,13,230
15265115@N06,957,19,1359258157,1359258577,3,13,420
15265115@N06,957,18,1359258633,1359258715,2,13,82
15265115@N06,957,17,1359258715,1359259328,4,13,613
15265115@N06,957,16,1359259328,1359259916,5,13,588
15265115@N06,957,14,1359259916,1359259925,2,13,9
15265115@N06,957,16,1359259925,1359260645,7,13,720
15265115@N06,957,27,1359270691,1359271891,2,13,1200
15268966@N00,958,16,1212816845,1212817565,2,1,720
15268966@N00,959,12,1300359807,1300360647,1,1,840
15292348@N00,960,27,1200794537,1200795152,3,6,615
15292348@N00,960,4,1200795152,1200795562,4,6,410
15292348@N00,960,3,1200795562,1200795832,6,6,270
15292348@N00,960,16,1200797499,1200798219,2,6,720
15292348@N00,960,14,1200806033,1200806153,23,6,120
15292348@N00,960,16,1200809480,1200810200,1,6,720
15406459@N00,961,14,1210460379,1210460499,5,4,120
15406459@N00,961,8,1210461553,1210461673,2,4,120
15406459@N00,961,11,1210471836,1210472016,8,4,180
15406459@N00,961,27,1210473976,1210475176,1,4,1200
15406459@N00,962,11,1255771036,1255771216,1,1,180
15409357@N07,963,12,1393408169,1393409009,2,2,840
15409357@N07,963,16,1393413281,1393414001,1,2,720
15409357@N07,964,21,1393621699,1393622149,1,1,450
15409357@N07,965,3,1393681314,1393681584,1,1,270
15409357@N07,966,27,1393714426,1393715626,1,1,1200
15409357@N07,967,27,1420018458,1420019658,1,1,1200
15409357@N07,968,20,1420069356,1420070436,1,1,1080
15409357@N07,969,20,1431698943,1431700023,1,1,1080
15473418@N00,970,27,1212569995,1212571195,1,1,1200
15473418@N00,971,27,1212664013,1212665213,9,3,1200
15473418@N00,971,16,1212667251,1212667971,15,3,720
15473418@N00,971,27,1212668581,1212669781,1,3,1200
15473418@N00,972,4,1212749701,1212750601,3,7,900
15473418@N00,972,14,1212753695,1212753815,14,7,120
15473418@N00,972,17,1212755860,1212757240,4,7,1380
15473418@N00,972,6,1212759917,1212760172,4,7,255
15473418@N00,972,1,1212766220,1212766820,2,7,600
15473418@N00,972,26,1212767219,1212767399,3,7,180
15473418@N00,972,16,1212767953,1212768673,1,7,720
15473418@N00,973,27,1212801297,1212801628,2,2,331
15473418@N00,973,16,1212801628,1212802348,5,2,720
15473418@N00,974,16,1215831614,1215832334,2,1,720
15515205@N02,975,27,1226356999,1226358199,2,6,1200
15515205@N02,975,19,1226358977,1226359397,2,6,420
15515205@N02,975,24,1226360576,1226360717,2,6,141
15515205@N02,975,21,1226360717,1226361167,3,6,450
15515205@N02,975,12,1226364366,1226365206,2,6,840
15515205@N02,975,7,1226376319,1226376409,1,6,90
15515205@N02,976,21,1226536380,1226536830,1,1,450
15515205@N02,977,16,1226568650,1226569370,7,1,720
15525927@N04,978,17,1331085598,1331085602,2,2,4
15525927@N04,978,22,1331085602,1331086202,1,2,600
15530177@N05,979,27,1319057998,1319059198,9,5,1200
15530177@N05,979,25,1319059279,1319060029,14,5,750
15530177@N05,979,6,1319063122,1319063370,7,5,248
15530177@N05,979,14,1319063370,1319063490,13,5,120
15530177@N05,979,27,1319064856,1319066056,2,5,1200
15530177@N05,980,20,1319107586,1319108666,24,1,1080
15530177@N05,981,27,1319237535,1319238735,8,6,1200
15530177@N05,981,19,1319239568,1319239958,11,6,390
15530177@N05,981,21,1319239958,1319240408,6,6,450
15530177@N05,981,26,1319243174,1319243354,4,6,180
15530177@N05,981,4,1319246399,1319246614,5,6,215
15530177@N05,981,2,1319246614,1319246704,6,6,90
15531512@N00,982,7,1426636004,1426636094,2,3,90
15531512@N00,982,17,1426643551,1426644931,2,3,1380
15531512@N00,982,14,1426651839,1426651959,1,3,120
15531512@N00,983,23,1426723043,1426723133,4,17,90
15531512@N00,983,9,1426732226,1426732466,22,17,240
15531512@N00,983,10,1426735354,1426735774,2,17,420
15531512@N00,983,15,1426739667,1426739760,12,17,93
15531512@N00,983,12,1426739760,1426739792,2,17,32
15531512@N00,983,15,1426739792,1426739799,3,17,7
15531512@N00,983,12,1426739799,1426739979,25,17,180
15531512@N00,983,13,1426739979,1426740061,12,17,82
15531512@N00,983,12,1426740061,1426740095,4,17,34
15531512@N00,983,13,1426740095,1426740135,3,17,40
15531512@N00,983,12,1426740135,1426740975,2,17,840
15531512@N00,983,27,1426741888,1426743088,2,17,1200
15531512@N00,983,10,1426750682,1426751102,2,17,420
15531512@N00,983,9,1426756502,1426756742,2,17,240
15531512@N00,983,10,1426757560,1426757980,14,17,420
15531512@N00,983,9,1426758858,1426759098,3,17,240
15531512@N00,983,4,1426760657,1426761557,2,17,900
15531512@N00,984,14,1426808214,1426808334,2,1,120
15531512@N00,985,9,1458766963,1458767203,2,1,240
15533594@N00,986,17,1296942058,1296943426,2,2,1368
15533594@N00,986,27,1296943426,1296944626,1,2,1200
15551876@N04,987,16,1376820257,1376820977,1,1,720
15605437@N08,988,17,1203602129,1203603509,5,1,1380
15652554@N07,989,17,1224903267,1224904647,92,1,1380
15756745@N06,990,23,1271764525,1271764615,1,1,90
15790231@N02,991,27,1222294190,1222295390,1,1,1200
15790231@N02,992,4,1222654606,1222655506,3,15,900
15790231@N02,992,3,1222656834,1222657104,4,15,270
15790231@N02,992,16,1222660341,1222660502,2,15,161
15790231@N02,992,26,1222660502,1222660641,2,15,139
15790231@N02,992,16,1222660641,1222660665,2,15,24
15790231@N02,992,26,1222660665,1222660845,2,15,180
15790231@N02,992,13,1222660902,1222661502,8,15,600
15790231@N02,992,22,1222662482,1222663082,2,15,600
15790231@N02,992,21,1222668068,1222668084,2,15,16
15790231@N02,992,22,1222668084,1222668662,2,15,578
15790231@N02,992,23,1222668662,1222668752,3,15,90
15790231@N02,992,22,1222669105,1222669705,3,15,600
15790231@N02,992,21,1222670864,1222671314,10,15,450
15790231@N02,992,22,1222672730,1222673330,2,15,600
15790231@N02,992,27,1222674848,1222676048,3,15,1200
15790231@N02,993,27,1222725521,1222725852,4,15,331
15790231@N02,993,16,1222725852,1222725890,3,15,38
15790231@N02,993,14,1222725890,1222725993,2,15,103
15790231@N02,993,16,1222725993,1222726279,2,15,286
15790231@N02,993,14,1222726279,1222726313,3,15,34
15790231@N02,993,16,1222726313,1222726515,6,15,202
15790231@N02,993,17,1222726515,1222727895,3,15,1380
15790231@N02,993,11,1222737584,1222737764,6,15,180
15790231@N02,993,8,1222763261,1222763381,15,15,120
15790231@N02,993,12,1222769445,1222770285,2,15,840
15790231@N02,993,16,1222773751,1222773941,2,15,190
15790231@N02,993,14,1222773941,1222774022,2,15,81
15790231@N02,993,16,1222774022,1222774234,8,15,212
15790231@N02,993,14,1222774234,1222774254,3,15,20
15790231@N02,993,16,1222774254,1222774974,7,15,720
15790231@N02,994,19,1253797408,1253797828,3,1,420
15802258@N04,995,21,1360371849,1360372299,43,1,450
15802258@N04,996,27,1433561096,1433562296,1,1,1200
15802258@N04,997,27,1446332173,1446333373,2,5,1200
15802258@N04,997,21,1446334567,1446335017,2,5,450
15802258@N04,997,19,1446336451,1446336871,3,5,420
15802258@N04,997,12,1446351328,1446352168,2,5,840
15802258@N04,997,3,1446357171,1446357441,1,5,270
15802258@N04,998,18,1452902397,1452904197,1,1,1800
15823562@N00,999,14,1275977464,1275977584,1,1,120
15834837@N08,1000,10,1375703617,1375704037,7,1,420
15834837@N08,1001,27,1375752110,1375753310,3,2,1200
15834837@N08,1001,15,1375754852,1375755032,2,2,180
15834837@N08,1002,15,1376456364,1376456376,2,2,12
15834837@N08,1002,12,1376456376,1376457216,1,2,840
15834837@N08,1003,27,1381497473,1381498673,2,1,1200
15931336@N05,1004,9,1229127796,1229128036,2,2,240
15931336@N05,1004,14,1229129450,1229129570,1,2,120
15954126@N00,1005,6,1298772004,1298772259,3,1,255
16035349@N05,1006,16,1234735618,1234735684,2,5,66
16035349@N05,1006,14,1234735684,1234735804,13,5,120
16035349@N05,1006,17,1234742249,1234743629,2,5,1380
16035349@N05,1006,1,1234767563,1234768163,2,5,600
16035349@N05,1006,15,1234782044,1234782224,2,5,180
16088786@N03,1007,9,1402813387,1402813627,2,7,240
16088786@N03,1007,15,1402814878,1402815058,2,7,180
16088786@N03,1007,11,1402816474,1402816654,9,7,180
16088786@N03,1007,16,1402825280,1402826000,2,7,720
16088786@N03,1007,14,1402826247,1402826367,2,7,120
16088786@N03,1007,16,1402840535,1402841255,4,7,720
16088786@N03,1007,15,1402842928,1402843108,1,7,180
16088786@N03,1008,16,1403007076,1403007796,1,1,720
16088786@N03,1009,10,1403157042,1403157462,3,5,420
16088786@N03,1009,14,1403157862,1403157982,3,5,120
16088786@N03,1009,15,1403159439,1403159619,4,5,180
16088786@N03,1009,17,1403163276,1403164656,3,5,1380
16088786@N03,1009,16,1403170369,1403171089,1,5,720
16088786@N03,1010,10,1403414378,1403414798,3,4,420
16088786@N03,1010,19,1403419763,1403420183,4,4,420
16088786@N03,1010,11,1403420741,1403420921,3,4,180
16088786@N03,1010,7,1403422512,1403422602,1,4,90
16088786@N03,1011,16,1403711359,1403712079,28,1,720
16088786@N03,1012,15,1403765375,1403765555,3,1,180
16088786@N03,1013,16,1404521404,1404521407,2,7,3
16088786@N03,1013,19,1404521407,1404521418,2,7,11
16088786@N03,1013,16,1404521418,1404521434,2,7,16
16088786@N03,1013,27,1404521434,1404521439,2,7,5
16088786@N03,1013,16,1404521439,1404521442,2,7,3
16088786@N03,1013,19,1404521442,1404521445,2,7,3
16088786@N03,1013,16,1404521445,1404522165,1,7,720
16088786@N03,1014,20,1404729616,1404730696,2,1,1080
16088786@N03,1015,16,1455537839,1455538559,1,1,720
16093042@N00,1016,1,1351628675,1351629275,2,5,600
16093042@N00,1016,17,1351633739,1351635119,4,5,1380
16093042@N00,1016,13,1351641188,1351641788,2,5,600
16093042@N00,1016,25,1351652799,1351653549,2,5,750
16093042@N00,1016,23,1351654060,1351654150,1,5,90
16137863@N00,1017,26,1345447897,1345448071,2,2,174
16137863@N00,1017,22,1345448071,1345448671,1,2,600
16272116@N03,1018,9,1207041796,1207041798,2,2,2
16272116@N03,1018,4,1207041798,1207042698,3,2,900
16355945@N00,1019,14,1323498773,1323498893,1,1,120
16355945@N00,1020,14,1351802690,1351802810,2,3,120
16355945@N00,1020,19,1351813118,1351813538,2,3,420
16355945@N00,1020,27,1351816198,1351817398,1,3,1200
16355945@N00,1021,27,1397012161,1397013361,1,1,1200
16429538@N00,1022,16,1246609691,1246610411,7,3,720
16429538@N00,1022,25,1246615130,1246615880,3,3,750
16429538@N00,1022,27,1246619751,1246620951,3,3,1200
16429538@N00,1023,18,1246665535,1246667335,2,5,1800
16429538@N00,1023,12,1246670126,1246670966,4,5,840
16429538@N00,1023,3,1246673185,1246673455,3,5,270
16429538@N00,1023,16,1246697858,1246698578,2,5,720
16429538@N00,1023,27,1246705173,1246706373,10,5,1200
16429538@N00,1024,27,1246881826,1246883026,2,1,1200
16429538@N00,1025,19,1247092571,1247092991,10,2,420
16429538@N00,1025,27,1247104770,1247105970,11,2,1200
16605470@N00,1026,16,1348571953,1348572673,1,1,720
16644192@N02,1027,16,1217685600,1217686320,4,1,720
16691514@N07,1028,26,1411542967,1411543147,1,1,180
16717012@N00,1029,27,1382533393,1382534593,1,1,1200
16811913@N00,1030,1,1398218997,1398219597,1,1,600
16860181@N02,1031,16,1355477031,1355477751,1,1,720
16866921@N00,1032,16,1256347468,1256348188,4,4,720
16866921@N00,1032,19,1256365100,1256365520,3,4,420
16866921@N00,1032,17,1256369341,1256370721,3,4,1380
16866921@N00,1032,16,1256375597,1256376317,4,4,720
16878544@N06,1033,3,1353191772,1353192006,2,10,234
16878544@N06,1033,4,1353192006,1353192068,2,10,62
16878544@N06,1033,3,1353192068,1353192338,3,10,270
16878544@N06,1033,7,1353192784,1353192874,3,10,90
16878544@N06,1033,8,1353193213,1353193333,2,10,120
16878544@N06,1033,7,1353193908,1353193998,2,10,90
16878544@N06,1033,11,1353195765,1353195945,8,10,180
16878544@N06,1033,8,1353196096,1353196216,7,10,120
16878544@N06,1033,7,1353196762,1353196852,2,10,90
16878544@N06,1033,10,1353197340,1353197760,4,10,420
16935127@N04,1034,20,1423354453,1423355533,1,1,1080
16985502@N04,1035,22,1324099628,1324100228,1,1,600
16985502@N04,1036,27,1353759808,1353761008,1,1,1200
16994861@N08,1037,15,1380959041,1380959221,2,6,180
16994861@N08,1037,27,1380959511,1380959568,2,6,57
16994861@N08,1037,15,1380959568,1380959748,2,6,180
16994861@N08,1037,14,1380960587,1380960707,9,6,120
16994861@N08,1037,11,1380961275,1380961455,6,6,180
16994861@N08,1037,14,1380967883,1380968003,13,6,120
16994861@N08,1038,27,1381111403,1381111932,2,11,529
16994861@N08,1038,26,1381111932,1381112112,5,11,180
16994861@N08,1038,19,1381113815,1381114235,7,11,420
16994861@N08,1038,24,1381115398,1381115878,3,11,480
16994861@N08,1038,22,1381116675,1381117231,2,11,556
16994861@N08,1038,18,1381117231,1381118613,3,11,1382
16994861@N08,1038,16,1381118613,1381119333,7,11,720
16994861@N08,1038,19,1381121562,1381121982,2,11,420
16994861@N08,1038,1,1381139873,1381140473,2,11,600
16994861@N08,1038,14,1381143068,1381143188,4,11,120
16994861@N08,1038,27,1381149182,1381150382,4,11,1200
17007166@N00,1039,27,1346716817,1346718017,8,1,1200
17007166@N00,1040,27,1347259693,1347260893,7,1,1200
17007166@N00,1041,27,1348593876,1348595076,7,1,1200
17017714@N04,1042,27,1284514234,1284515434,2,2,1200
17017714@N04,1042,6,1284521497,1284521752,3,2,255
17057923@N06,1043,27,1311028791,1311029991,9,32,1200
17057923@N06,1043,9,1311030339,1311030579,29,32,240
17057923@N06,1043,27,1311032301,1311032848,2,32,547
17057923@N06,1043,6,1311032848,1311033076,6,32,228
17057923@N06,1043,27,1311033076,1311033702,3,32,626
17057923@N06,1043,6,1311033702,1311033888,5,32,186
17057923@N06,1043,9,1311033888,1311034128,18,32,240
17057923@N06,1043,3,1311034217,1311034229,2,32,12
17057923@N06,1043,9,1311034229,1311034469,5,32,240
17057923@N06,1043,3,1311034574,1311034632,2,32,58
17057923@N06,1043,9,1311034632,1311034854,2,32,222
17057923@N06,1043,3,1311034854,1311035124,9,32,270
17057923@N06,1043,9,1311035453,1311035693,4,32,240
17057923@N06,1043,6,1311036284,1311036539,6,32,255
17057923@N06,1043,3,1311037542,1311037812,3,32,270
17057923@N06,1043,4,1311038439,1311038803,2,32,364
17057923@N06,1043,3,1311038803,1311039073,4,32,270
17057923@N06,1043,6,1311039439,1311039694,3,32,255
17057923@N06,1043,24,1311040881,1311041361,15,32,480
17057923@N06,1043,21,1311041933,1311042383,2,32,450
17057923@N06,1043,24,1311042947,1311043427,25,32,480
17057923@N06,1043,21,1311045354,1311045780,4,32,426
17057923@N06,1043,22,1311045780,1311046380,6,32,600
17057923@N06,1043,18,1311046493,1311048293,6,32,1800
17057923@N06,1043,13,1311053261,1311053861,4,32,600
17057923@N06,1043,17,1311055317,1311056697,2,32,1380
17057923@N06,1043,12,1311059078,1311059918,3,32,840
17057923@N06,1043,14,1311060587,1311060707,4,32,120
17057923@N06,1043,12,1311061793,1311062290,2,32,497
17057923@N06,1043,8,1311062290,1311062410,5,32,120
17057923@N06,1043,14,1311064061,1311064181,2,32,120
17057923@N06,1043,8,1311066520,1311066640,1,32,120
17057923@N06,1044,27,1311406532,1311407732,27,8,1200
17057923@N06,1044,21,1311408831,1311409281,4,8,450
17057923@N06,1044,22,1311411696,1311412296,8,8,600
17057923@N06,1044,14,1311414213,1311414333,11,8,120
17057923@N06,1044,16,1311417209,1311417929,5,8,720
17057923@N06,1044,5,1311418531,1311419251,7,8,720
17057923@N06,1044,9,1311419344,1311419354,2,8,10
17057923@N06,1044,5,1311419354,1311420074,80,8,720
17057923@N06,1045,27,1311454123,1311455323,9,10,1200
17057923@N06,1045,9,1311458661,1311458901,17,10,240
17057923@N06,1045,3,1311460706,1311460976,3,10,270
17057923@N06,1045,2,1311461031,1311461121,2,10,90
17057923@N06,1045,9,1311461659,1311461899,14,10,240
17057923@N06,1045,3,1311464140,1311464410,6,10,270
17057923@N06,1045,2,1311464500,1311464590,3,10,90
17057923@N06,1045,1,1311464865,1311465465,5,10,600
17057923@N06,1045,21,1311473266,1311473716,3,10,450
17057923@N06,1045,23,1311476097,1311476187,19,10,90
17062172@N00,1046,16,1216086903,1216087623,1,1,720
17099253@N00,1047,17,1350091017,1350091042,2,12,25
17099253@N00,1047,27,1350091042,1350091243,2,12,201
17099253@N00,1047,17,1350091243,1350092623,2,12,1380
17099253@N00,1047,5,1350094222,1350094942,2,12,720
17099253@N00,1047,2,1350095040,1350095048,2,12,8
17099253@N00,1047,3,1350095048,1350095137,2,12,89
17099253@N00,1047,2,1350095137,1350095227,4,12,90
17099253@N00,1047,13,1350104795,1350105395,4,12,600
17099253@N00,1047,14,1350107663,1350107783,2,12,120
17099253@N00,1047,15,1350109155,1350109188,4,12,33
17099253@N00,1047,14,1350109188,1350109308,2,12,120
17099253@N00,1047,2,1350126582,1350126672,1,12,90
17099253@N00,1048,27,1350213704,1350214904,1,1,1200
17099253@N00,1049,2,1350283004,1350283094,2,6,90
17099253@N00,1049,1,1350284106,1350284706,2,6,600
17099253@N00,1049,13,1350286132,1350286732,2,6,600
17099253@N00,1049,17,1350292790,1350294170,5,6,1380
17099253@N00,1049,19,1350294410,1350294830,2,6,420
17099253@N00,1049,20,1350297001,1350298081,1,6,1080
17099253@N00,1050,17,1350780090,1350780244,2,2,154
17099253@N00,1050,9,1350780244,1350780484,1,2,240
17145135@N00,1051,27,1318477492,1318478692,2,6,1200
17145135@N00,1051,23,1318479090,1318479180,2,6,90
17145135@N00,1051,17,1318484201,1318485581,2,6,1380
17145135@N00,1051,3,1318487215,1318487485,2,6,270
17145135@N00,1051,6,1318490410,1318490665,2,6,255
17145135@N00,1051,13,1318493427,1318494027,1,6,600
17145135@N00,1052,27,1330453403,1330453697,2,16,294
17145135@N00,1052,2,1330453697,1330453787,3,16,90
17145135@N00,1052,15,1330459633,1330459813,2,16,180
17145135@N00,1052,25,1330460096,1330460846,2,16,750
17145135@N00,1052,21,1330462407,1330462857,2,16,450
17145135@N00,1052,20,1330462960,1330464040,2,16,1080
17145135@N00,1052,27,1330465798,1330466998,2,16,1200
17145135@N00,1052,18,1330469880,1330471680,2,16,1800
17145135@N00,1052,3,1330480439,1330480709,3,16,270
17145135@N00,1052,1,1330483804,1330484404,2,16,600
17145135@N00,1052,4,1330490830,1330491730,2,16,900
17145135@N00,1052,17,1330492324,1330493704,2,16,1380
17145135@N00,1052,6,1330518679,1330518934,2,16,255
17145135@N00,1052,14,1330531275,1330531395,2,16,120
17145135@N00,1052,9,1330532189,1330532429,2,16,240
17145135@N00,1052,27,1330536006,1330537206,1,16,1200
17221206@N00,1053,15,1336050615,1336050795,1,1,180
17299643@N00,1054,27,1301969644,1301970410,6,15,766
17299643@N00,1054,25,1301970410,1301970555,2,15,145
17299643@N00,1054,23,1301970555,1301970645,3,15,90
17299643@N00,1054,22,1301971199,1301971799,3,15,600
17299643@N00,1054,21,1301972943,1301973393,6,15,450
17299643@N00,1054,20,1301975221,1301976267,2,15,1046
17299643@N00,1054,18,1301976267,1301976287,2,15,20
17299643@N00,1054,20,1301976287,1301977367,5,15,1080
17299643@N00,1054,22,1301981121,1301981721,20,15,600
17299643@N00,1054,18,1301985658,1301985839,3,15,181
17299643@N00,1054,13,1301985839,1301986439,2,15,600
17299643@N00,1054,17,1301988954,1301990334,2,15,1380
17299643@N00,1054,14,1301990726,1301990846,4,15,120
17299643@N00,1054,9,1301992267,1301992507,2,15,240
17299643@N00,1054,6,1301996531,1301996786,1,15,255
17367211@N00,1055,21,1217806512,1217806953,2,4,441
17367211@N00,1055,23,1217806953,1217807043,2,4,90
17367211@N00,1055,22,1217812185,1217812785,2,4,600
17367211@N00,1055,11,1217815596,1217815776,2,4,180
17419748@N03,1056,14,1305363766,1305363886,1,1,120
17424601@N00,1057,4,1417566573,1417567473,2,4,900
17424601@N00,1057,17,1417580287,1417581667,2,4,1380
17424601@N00,1057,19,1417583786,1417584206,2,4,420
17424601@N00,1057,22,1417603146,1417603746,1,4,600
17567960@N00,1058,27,1322694204,1322695404,3,3,1200
17567960@N00,1058,3,1322695907,1322696177,2,3,270
17567960@N00,1058,17,1322702986,1322704366,4,3,1380
17599044@N08,1059,22,1220324526,1220325126,2,2,600
17599044@N08,1059,16,1220332875,1220333595,1,2,720
17599044@N08,1060,16,1220444002,1220444722,1,1,720
17599044@N08,1061,16,1262040953,1262041673,1,1,720
17620798@N08,1062,16,1279536791,1279537511,1,1,720
17657655@N00,1063,27,1193198483,1193199683,1,1,1200
17657655@N00,1064,17,1234163343,1234164723,1,1,1380
17657655@N00,1065,27,1308229368,1308230568,1,1,1200
17671095@N04,1066,17,1243427156,1243428536,4,2,1380
17671095@N04,1066,26,1243433060,1243433240,1,2,180
17725987@N00,1067,9,1353072450,1353072690,1,1,240
17725987@N00,1068,14,1386887435,1386887555,1,1,120
17725987@N00,1069,27,1400105872,1400107072,2,1,1200
17754571@N02,1070,14,1352930353,1352930473,2,4,120
17754571@N02,1070,19,1352932113,1352932533,2,4,420
17754571@N02,1070,13,1352936493,1352937093,2,4,600
17754571@N02,1070,16,1352961215,1352961935,1,4,720
17804775@N00,1071,16,1192782601,1192783321,1,1,720
17864008@N00,1072,17,1192833353,1192834733,3,1,1380
17963840@N07,1073,23,1337013239,1337013329,1,1,90
17982436@N03,1074,25,1319150574,1319151324,1,1,750
18081271@N00,1075,27,1324413980,1324415180,2,2,1200
18081271@N00,1075,18,1324422427,1324424227,1,2,1800
18081271@N00,1076,27,1324600323,1324601523,2,2,1200
18081271@N00,1076,17,1324601840,1324603220,1,2,1380
18097936@N00,1077,17,1330428981,1330430361,71,1,1380
18097936@N00,1078,17,1331006594,1331007974,2,1,1380
18214853@N00,1079,22,1345940959,1345941559,2,3,600
18214853@N00,1079,4,1345949946,1345950846,2,3,900
18214853@N00,1079,8,1345954138,1345954258,1,3,120
18291524@N00,1080,16,1291850748,1291851468,3,2,720
18291524@N00,1080,18,1291851515,1291853315,2,2,1800
18291524@N00,1081,16,1292059232,1292059952,1,1,720
18307147@N00,1082,27,1293067347,1293068547,6,8,1200
18307147@N00,1082,25,1293069903,1293070653,5,8,750
18307147@N00,1082,19,1293072788,1293073208,2,8,420
18307147@N00,1082,16,1293074590,1293075310,3,8,720
18307147@N00,1082,13,1293076393,1293076430,2,8,37
18307147@N00,1082,18,1293076430,1293078230,4,8,1800
18307147@N00,1082,17,1293078421,1293079600,2,8,1179
18307147@N00,1082,1,1293079600,1293080200,1,8,600
18307147@N00,1083,16,1387753929,1387754649,12,7,720
18307147@N00,1083,15,1387757130,1387757310,5,7,180
18307147@N00,1083,10,1387761201,1387761621,2,7,420
18307147@N00,1083,8,1387762401,1387762521,4,7,120
18307147@N00,1083,11,1387769774,1387769954,7,7,180
18307147@N00,1083,17,1387781320,1387782700,2,7,1380
18307147@N00,1083,27,1387782768,1387783968,6,7,1200
18334814@N00,1084,9,1461039757,1461039997,2,2,240
18334814@N00,1084,6,1461042766,1461043021,1,2,255
18384077@N00,1085,14,1381901011,1381901131,1,1,120
18425733@N00,1086,16,1399989616,1399990336,1,1,720
18581554@N04,1087,27,1304420547,1304421747,3,1,1200
18647653@N08,1088,11,1208671357,1208671537,1,1,180
18647653@N08,1089,4,1376961421,1376962321,1,1,900
18748204@N00,1090,27,1400982388,1400983588,2,10,1200
18748204@N00,1090,23,1400986257,1400986347,2,10,90
18748204@N00,1090,20,1400989583,1400990663,5,10,1080
18748204@N00,1090,22,1400994706,1400995306,9,10,600
18748204@N00,1090,17,1400996625,1400998005,3,10,1380
18748204@N00,1090,2,1400998763,1400998853,3,10,90
18748204@N00,1090,3,1400999232,1400999265,2,10,33
18748204@N00,1090,2,1400999265,1400999355,6,10,90
18748204@N00,1090,1,1401003180,1401003780,5,10,600
18748204@N00,1090,27,1401004209,1401005409,6,10,1200
18748204@N00,1091,9,1401510714,1401510954,9,5,240
18748204@N00,1091,6,1401511522,1401511777,6,5,255
18748204@N00,1091,14,1401516047,1401516167,2,5,120
18748204@N00,1091,7,1401523894,1401523984,4,5,90
18748204@N00,1091,8,1401524268,1401524388,4,5,120
18862724@N00,1092,2,1338866033,1338866123,1,1,90
19017254@N03,1093,17,1394429833,1394431213,1,1,1380
19026178@N00,1094,27,1194821199,1194822399,16,16,1200
19026178@N00,1094,4,1194823542,1194823597,2,16,55
19026178@N00,1094,3,1194823597,1194823867,3,16,270
19026178@N00,1094,6,1194823930,1194824185,2,16,255
19026178@N00,1094,3,1194824426,1194824696,8,16,270
19026178@N00,1094,27,1194827139,1194828339,3,16,1200
19026178@N00,1094,23,1194830555,1194830645,2,16,90
19026178@N00,1094,21,1194831844,1194832294,3,16,450
19026178@N00,1094,22,1194833261,1194833861,3,16,600
19026178@N00,1094,26,1194834490,1194834670,5,16,180
19026178@N00,1094,17,1194834747,1194836127,2,16,1380
19026178@N00,1094,12,1194837512,1194838352,2,16,840
19026178@N00,1094,14,1194839660,1194839780,3,16,120
19026178@N00,1094,16,1194839792,1194840512,4,16,720
19026178@N00,1094,27,1194841276,1194842476,8,16,1200
19026178@N00,1094,9,1194860268,1194860508,2,16,240
19026178@N00,1095,27,1194988321,1194989521,15,9,1200
19026178@N00,1095,17,1194997609,1194998989,2,9,1380
19026178@N00,1095,27,1195008137,1195008492,2,9,355
19026178@N00,1095,25,1195008492,1195008612,2,9,120
19026178@N00,1095,17,1195008612,1195009276,3,9,664
19026178@N00,1095,23,1195009276,1195009366,2,9,90
19026178@N00,1095,26,1195010322,1195010421,2,9,99
19026178@N00,1095,23,1195010421,1195010511,2,9,90
19026178@N00,1095,27,1195010952,1195012152,2,9,1200
19118140@N04,1096,15,1228532990,1228533170,2,4,180
19118140@N04,1096,4,1228540268,1228541168,2,4,900
19118140@N04,1096,5,1228543153,1228543873,2,4,720
19118140@N04,1096,16,1228547625,1228548345,2,4,720
19262297@N03,1097,22,1286953951,1286954551,2,1,600
19344501@N00,1098,27,1276467903,1276469103,2,4,1200
19344501@N00,1098,25,1276470358,1276471108,2,4,750
19344501@N00,1098,3,1276489789,1276490059,2,4,270
19344501@N00,1098,27,1276497620,1276498820,1,4,1200
19358630@N00,1099,27,1321996746,1321997946,24,1,1200
19555551@N00,1100,27,1198019786,1198020570,3,15,784
19555551@N00,1100,16,1198020570,1198020646,2,15,76
19555551@N00,1100,4,1198020646,1198021546,2,15,900
19555551@N00,1100,12,1198026949,1198027789,2,15,840
19555551@N00,1100,13,1198028188,1198028788,2,15,600
19555551@N00,1100,17,1198029855,1198031235,2,15,1380
19555551@N00,1100,16,1198033160,1198033359,2,15,199
19555551@N00,1100,13,1198033359,1198033755,2,15,396
19555551@N00,1100,19,1198033755,1198034017,2,15,262
19555551@N00,1100,21,1198034017,1198034467,3,15,450
19555551@N00,1100,19,1198040455,1198040875,2,15,420
19555551@N00,1100,24,1198041371,1198041851,2,15,480
19555551@N00,1100,16,1198042730,1198043450,2,15,720
19555551@N00,1100,27,1198043580,1198044780,2,15,1200
19555551@N00,1100,16,1198048287,1198049007,4,15,720
19555551@N00,1101,14,1277097569,1277097580,2,4,11
19555551@N00,1101,16,1277097580,1277098300,2,4,720
19555551@N00,1101,14,1277109014,1277109134,2,4,120
19555551@N00,1101,13,1277109925,1277110525,1,4,600
19555551@N00,1102,21,1277353491,1277353941,4,1,450
19585456@N00,1103,27,1323339207,1323340407,2,1,1200
19594436@N00,1104,14,1242643641,1242643761,4,1,120
19594436@N00,1105,14,1242773564,1242773684,46,1,120
19609393@N03,1106,24,1303267393,1303267796,3,5,403
19609393@N03,1106,14,1303267796,1303267916,2,5,120
19609393@N03,1106,17,1303273478,1303274858,2,5,1380
19609393@N03,1106,12,1303293821,1303293924,3,5,103
19609393@N03,1106,13,1303293924,1303294524,1,5,600
19682872@N00,1107,27,1451253453,1451254653,30,1,1200
19682872@N00,1108,27,1451514324,1451515524,15,1,1200
19709423@N04,1109,27,1278871265,1278872465,6,1,1200
19709423@N04,1110,27,1279047028,1279048194,2,11,1166
19709423@N04,1110,14,1279048194,1279048314,2,11,120
19709423@N04,1110,4,1279052383,1279053283,12,11,900
19709423@N04,1110,2,1279056639,1279056729,16,11,90
19709423@N04,1110,1,1279056822,1279056974,5,11,152
19709423@N04,1110,2,1279056974,1279057064,6,11,90
19709423@N04,1110,5,1279057719,1279058380,3,11,661
19709423@N04,1110,2,1279058380,1279058470,4,11,90
19709423@N04,1110,23,1279059484,1279059574,8,11,90
19709423@N04,1110,24,1279061481,1279061961,2,11,480
19709423@N04,1110,27,1279063342,1279064542,1,11,1200
19709423@N04,1111,7,1285133666,1285133756,4,5,90
19709423@N04,1111,9,1285133853,1285134093,5,5,240
19709423@N04,1111,14,1285134490,1285134610,24,5,120
19709423@N04,1111,20,1285141492,1285141696,3,5,204
19709423@N04,1111,18,1285141696,1285143496,1,5,1800
19731939@N00,1112,27,1400304926,1400306126,2,2,1200
19731939@N00,1112,4,1400329346,1400330246,1,2,900
19762975@N06,1113,16,1329865874,1329866594,1,1,720
19762975@N06,1114,27,1330043696,1330044896,2,1,1200
19763323@N00,1115,4,1285568721,1285569621,1,1,900
19787790@N08,1116,6,1369181024,1369181279,2,1,255
19860395@N08,1117,21,1372828556,1372829006,1,1,450
19887807@N00,1118,16,1329547070,1329547790,1,1,720
19932288@N00,1119,27,1225877998,1225879198,15,1,1200
19936517@N07,1120,27,1385897317,1385898517,1,1,1200
19944325@N00,1121,4,1463120610,1463121510,2,2,900
19944325@N00,1121,17,1463128705,1463130085,1,2,1380
19951106@N03,1122,3,1319935668,1319935938,2,5,270
19951106@N03,1122,2,1319937685,1319937775,4,5,90
19951106@N03,1122,6,1319941870,1319942125,2,5,255
19951106@N03,1122,2,1319953924,1319954014,2,5,90
19951106@N03,1122,16,1319955571,1319956291,1,5,720
19951106@N03,1123,27,1320041798,1320042998,6,3,1200
19951106@N03,1123,6,1320059362,1320059617,2,3,255
19951106@N03,1123,27,1320063434,1320064634,1,3,1200
19988671@N00,1124,4,1284390133,1284391033,1,1,900
20008009@N05,1125,21,1430708240,1430708690,1,1,450
20035490@N00,1126,15,1355802734,1355802914,1,1,180
20154444@N04,1127,27,1255658097,1255659297,1,1,1200
20154444@N04,1128,16,1261045739,1261046459,1,1,720
20154444@N04,1129,3,1265772891,1265773161,1,1,270
20154444@N04,1130,13,1272695904,1272696504,1,1,600
20154444@N04,1131,17,1307931132,1307932512,1,1,1380
20154444@N04,1132,13,1372989326,1372989926,1,1,600
20154444@N04,1133,13,1437705875,1437706475,1,1,600
20154444@N04,1134,10,1437738990,1437739410,1,1,420
20154444@N04,1135,14,1469355100,1469355220,1,1,120
20164875@N03,1136,14,1249481397,1249481517,1,1,120
20184646@N04,1137,13,1317171334,1317171934,4,4,600
20184646@N04,1137,6,1317180752,1317181007,2,4,255
20184646@N04,1137,9,1317181187,1317181427,12,4,240
20184646@N04,1137,20,1317186479,1317187559,9,4,1080
20184646@N04,1138,27,1317289763,1317290963,1,1,1200
20196064@N00,1139,14,1349676129,1349676249,2,2,120
20196064@N00,1139,16,1349679567,1349680287,1,2,720
20229609@N03,1140,27,1341270400,1341270917,2,9,517
20229609@N03,1140,22,1341270917,1341271282,2,9,365
20229609@N03,1140,20,1341271282,1341272362,2,9,1080
20229609@N03,1140,7,1341273523,1341273613,15,9,90
20229609@N03,1140,8,1341280364,1341280484,3,9,120
20229609@N03,1140,27,1341303451,1341304137,4,9,686
20229609@N03,1140,4,1341304137,1341304917,4,9,780
20229609@N03,1140,6,1341304917,1341305172,2,9,255
20229609@N03,1140,14,1341315285,1341315405,12,9,120
20229609@N03,1141,27,1341444480,1341445680,2,8,1200
20229609@N03,1141,7,1341445705,1341445795,2,8,90
20229609@N03,1141,27,1341449809,1341451009,14,8,1200
20229609@N03,1141,17,1341453352,1341454293,2,8,941
20229609@N03,1141,12,1341454293,1341455133,14,8,840
20229609@N03,1141,9,1341458436,1341458676,7,8,240
20229609@N03,1141,17,1341461265,1341462645,2,8,1380
20229609@N03,1141,27,1341463388,1341464588,2,8,1200
20279868@N06,1142,27,1344746691,1344747891,1,1,1200
20287222@N00,1143,6,1289770787,1289771042,2,2,255
20287222@N00,1143,26,1289773395,1289773575,1,2,180
20322483@N05,1144,16,1198792307,1198793027,2,2,720
20322483@N05,1144,12,1198794819,1198795659,1,2,840
20322483@N05,1145,3,1198962059,1198962329,1,1,270
20322483@N05,1146,13,1198998079,1198998679,3,6,600
20322483@N05,1146,9,1199008436,1199008676,2,6,240
20322483@N05,1146,25,1199009734,1199010028,2,6,294
20322483@N05,1146,24,1199010028,1199010508,3,6,480
20322483@N05,1146,25,1199039483,1199040233,2,6,750
20322483@N05,1146,16,1199056529,1199057249,1,6,720
20322483@N05,1147,12,1199086216,1199087056,1,1,840
20322483@N05,1148,1,1201702813,1201703413,1,1,600
20322483@N05,1149,27,1204262015,1204263215,1,1,1200
20322483@N05,1150,24,1204339378,1204339858,2,2,480
20322483@N05,1150,17,1204341332,1204342712,1,2,1380
20322483@N05,1151,25,1204421701,1204422451,1,1,750
20322483@N05,1152,25,1218419880,1218420630,3,3,750
20322483@N05,1152,13,1218421210,1218421810,2,3,600
20322483@N05,1152,5,1218422993,1218423713,1,3,720
20322483@N05,1153,3,1218582266,1218582536,4,3,270
20322483@N05,1153,1,1218589612,1218590212,2,3,600
20322483@N05,1153,3,1218595028,1218595298,1,3,270
20322483@N05,1154,27,1218679663,1218680863,2,8,1200
20322483@N05,1154,21,1218680932,1218681382,2,8,450
20322483@N05,1154,19,1218685065,1218685485,2,8,420
20322483@N05,1154,4,1218691149,1218692049,2,8,900
20322483@N05,1154,27,1218702127,1218703265,2,8,1138
20322483@N05,1154,8,1218703265,1218703385,2,8,120
20322483@N05,1154,27,1218709894,1218711094,2,8,1200
20322483@N05,1154,2,1218714940,1218715030,3,8,90
20322483@N05,1155,27,1225405231,1225406431,2,3,1200
20322483@N05,1155,20,1225406934,1225408014,2,3,1080
20322483@N05,1155,27,1225409601,1225410801,1,3,1200
20322483@N05,1156,13,1225490227,1225490827,3,3,600
20322483@N05,1156,6,1225492372,1225492627,2,3,255
20322483@N05,1156,27,1225503656,1225504856,1,3,1200
20322483@N05,1157,17,1225586922,1225588302,2,3,1380
20322483@N05,1157,24,1225591155,1225591635,2,3,480
20322483@N05,1157,27,1225591699,1225592899,1,3,1200
20494010@N00,1158,15,1414394891,1414395071,1,1,180
20544000@N00,1159,14,1363008193,1363008313,1,1,120
20544000@N00,1160,13,1367425210,1367425810,1,1,600
20544648@N06,1161,27,1285297101,1285297783,2,8,682
20544648@N06,1161,17,1285297783,1285297924,2,8,141
20544648@N06,1161,22,1285297924,1285298104,4,8,180
20544648@N06,1161,20,1285298104,1285298156,2,8,52
20544648@N06,1161,19,1285298156,1285298248,3,8,92
20544648@N06,1161,18,1285298248,1285298289,2,8,41
20544648@N06,1161,25,1285298289,1285298373,2,8,84
20544648@N06,1161,16,1285298373,1285299093,1,8,720
20544648@N06,1162,16,1285576268,1285576910,4,6,642
20544648@N06,1162,14,1285576910,1285577030,2,6,120
20544648@N06,1162,12,1285577075,1285577318,2,6,243
20544648@N06,1162,14,1285577318,1285577351,2,6,33
20544648@N06,1162,6,1285577351,1285577547,4,6,196
20544648@N06,1162,27,1285577547,1285578747,8,6,1200
20635459@N00,1163,14,1352457701,1352457821,1,1,120
20635459@N00,1164,23,1352703852,1352703942,1,1,90
20644717@N00,1165,4,1397217017,1397217145,3,2,128
20644717@N00,1165,2,1397217145,1397217235,4,2,90
20675126@N00,1166,14,1335742258,1335742378,2,11,120
20675126@N00,1166,9,1335742496,1335742736,2,11,240
20675126@N00,1166,5,1335742950,1335743092,4,11,142
20675126@N00,1166,9,1335743092,1335743332,6,11,240
20675126@N00,1166,6,1335744688,1335744943,2,11,255
20675126@N00,1166,8,1335745182,1335745302,2,11,120
20675126@N00,1166,22,1335757294,1335757894,3,11,600
20675126@N00,1166,20,1335758110,1335759190,3,11,1080
20675126@N00,1166,27,1335770924,1335771534,2,11,610
20675126@N00,1166,4,1335771534,1335772434,5,11,900
20675126@N00,1166,23,1335775542,1335775632,2,11,90
20675126@N00,1167,27,1335829750,1335830950,5,8,1200
20675126@N00,1167,6,1335832106,1335832361,2,8,255
20675126@N00,1167,9,1335834242,1335834270,2,8,28
20675126@N00,1167,6,1335834270,1335834525,2,8,255
20675126@N00,1167,7,1335834928,1335835018,2,8,90
20675126@N00,1167,18,1335841348,1335841352,2,8,4
20675126@N00,1167,26,1335841352,1335841532,5,8,180
20675126@N00,1167,6,1335852302,1335852557,3,8,255
20675126@N00,1168,27,1349574947,1349576147,2,2,1200
20675126@N00,1168,16,1349577218,1349577938,1,2,720
20677928@N06,1169,25,1236777645,1236778395,3,11,750
20677928@N06,1169,27,1236779094,1236780294,3,11,1200
20677928@N06,1169,16,1236781030,1236781750,2,11,720
20677928@N06,1169,26,1236785873,1236786053,2,11,180
20677928@N06,1169,25,1236786314,1236787064,4,11,750
20677928@N06,1169,23,1236791258,1236791348,3,11,90
20677928@N06,1169,17,1236797887,1236799267,2,11,1380
20677928@N06,1169,14,1236803524,1236803644,3,11,120
20677928@N06,1169,25,1236806942,1236807692,2,11,750
20677928@N06,1169,8,1236807754,1236807874,3,11,120
20677928@N06,1169,25,1236808421,1236809171,3,11,750
20677928@N06,1170,25,1236869272,1236870022,5,1,750
20677928@N06,1171,27,1237214976,1237216176,2,3,1200
20677928@N06,1171,25,1237233166,1237233916,2,3,750
20677928@N06,1171,14,1237249701,1237249821,1,3,120
20677928@N06,1172,27,1237527191,1237528391,1,1,1200
20677928@N06,1173,27,1237589757,1237590957,2,3,1200
20677928@N06,1173,21,1237594187,1237594637,2,3,450
20677928@N06,1173,23,1237599869,1237599959,1,3,90
20677928@N06,1174,25,1237631032,1237631782,8,6,750
20677928@N06,1174,23,1237646151,1237646241,2,6,90
20677928@N06,1174,17,1237652946,1237654326,2,6,1380
20677928@N06,1174,14,1237659922,1237660042,2,6,120
20677928@N06,1174,9,1237669479,1237669719,2,6,240
20677928@N06,1174,6,1237670655,1237670910,1,6,255
20677928@N06,1175,25,1237725132,1237725882,3,1,750
20677928@N06,1176,27,1238070360,1238071560,5,3,1200
20677928@N06,1176,25,1238081860,1238082610,2,3,750
20677928@N06,1176,23,1238103175,1238103265,2,3,90
20677928@N06,1177,25,1238294788,1238295538,1,1,750
20701570@N00,1178,1,1319074100,1319074700,1,1,600
20701570@N00,1179,22,1348912665,1348913265,2,1,600
20701570@N00,1180,20,1349060072,1349061152,2,2,1080
20701570@N00,1180,27,1349071358,1349072558,1,2,1200
20701570@N00,1181,10,1379844540,1379844960,1,1,420
20701570@N00,1182,21,1402198604,1402198607,2,6,3
20701570@N00,1182,18,1402198607,1402198607,2,6,0
20701570@N00,1182,22,1402198607,1402198610,2,6,3
20701570@N00,1182,2,1402198610,1402198610,2,6,0
20701570@N00,1182,4,1402198610,1402198651,2,6,41
20701570@N00,1182,14,1402198651,1402198771,1,6,120
20704576@N04,1183,22,1197970718,1197971318,3,2,600
20704576@N04,1183,27,1197982382,1197983582,1,2,1200
20715134@N00,1184,26,1237760602,1237760782,2,5,180
20715134@N00,1184,16,1237761014,1237761257,2,5,243
20715134@N00,1184,5,1237761257,1237761977,2,5,720
20715134@N00,1184,13,1237779129,1237779729,2,5,600
20715134@N00,1184,24,1237784147,1237784627,1,5,480
20719638@N00,1185,27,1206741433,1206742132,3,3,699
20719638@N00,1185,4,1206742132,1206742178,2,3,46
20719638@N00,1185,27,1206742178,1206743378,2,3,1200
20727999@N06,1186,4,1304893673,1304894573,2,17,900
20727999@N06,1186,16,1304895997,1304896306,3,17,309
20727999@N06,1186,26,1304896306,1304896486,2,17,180
20727999@N06,1186,21,1304898195,1304898645,2,17,450
20727999@N06,1186,13,1304900001,1304900601,2,17,600
20727999@N06,1186,16,1304906620,1304906687,2,17,67
20727999@N06,1186,17,1304906687,1304906775,2,17,88
20727999@N06,1186,13,1304906775,1304906930,2,17,155
20727999@N06,1186,20,1304906930,1304907601,2,17,671
20727999@N06,1186,19,1304907601,1304907924,4,17,323
20727999@N06,1186,20,1304907924,1304908181,2,17,257
20727999@N06,1186,22,1304908181,1304908203,2,17,22
20727999@N06,1186,21,1304908203,1304908653,2,17,450
20727999@N06,1186,26,1304928306,1304928486,2,17,180
20727999@N06,1186,14,1304928653,1304928773,2,17,120
20727999@N06,1186,16,1304928897,1304929617,4,17,720
20727999@N06,1186,4,1304935388,1304936288,3,17,900
20727999@N06,1187,27,1429333395,1429334595,2,5,1200
20727999@N06,1187,21,1429340596,1429341046,2,5,450
20727999@N06,1187,9,1429347122,1429347362,2,5,240
20727999@N06,1187,14,1429347690,1429347810,3,5,120
20727999@N06,1187,13,1429351215,1429351815,1,5,600
20727999@N06,1188,10,1429691531,1429691951,5,4,420
20727999@N06,1188,9,1429692009,1429692249,2,4,240
20727999@N06,1188,14,1429692515,1429692635,3,4,120
20727999@N06,1188,12,1429699689,1429700529,1,4,840
20741443@N00,1189,1,1272611971,1272612571,2,2,600
20741443@N00,1189,27,1272618752,1272619952,1,2,1200
20761691@N00,1190,2,1368091791,1368091881,1,1,90
20771338@N00,1191,27,1222147462,1222148662,94,1,1200
20835167@N00,1192,16,1298799890,1298800610,2,1,720
20885794@N00,1193,14,1467528505,1467528625,2,2,120
20885794@N00,1193,7,1467529664,1467529754,1,2,90
20895877@N04,1194,22,1194572574,1194573174,16,1,600
20895877@N04,1195,22,1198838482,1198839082,46,1,600
20895877@N04,1196,22,1212811618,1212812218,74,1,600
20895877@N04,1197,22,1218347062,1218347662,9,1,600
20895877@N04,1198,22,1245420000,1245420600,72,1,600
20895877@N04,1199,22,1265979600,1265980200,1,1,600
20895877@N04,1200,22,1267850168,1267850768,19,1,600
20895877@N04,1201,22,1267995839,1267996439,3,1,600
20895877@N04,1202,22,1268637935,1268638535,1,1,600
20911185@N07,1203,16,1428652377,1428653097,1,1,720
20925955@N03,1204,27,1208775385,1208776585,1,1,1200
20962532@N05,1205,17,1258870834,1258872214,1,1,1380
20962532@N05,1206,17,1259150457,1259151837,1,1,1380
21030940@N06,1207,27,1395955682,1395956882,3,5,1200
21030940@N06,1207,14,1395959407,1395959527,7,5,120
21030940@N06,1207,9,1395960591,1395960650,2,5,59
21030940@N06,1207,10,1395960650,1395961070,3,5,420
21030940@N06,1207,25,1395967629,1395968379,3,5,750
21030940@N06,1208,9,1396049902,1396050142,5,5,240
21030940@N06,1208,2,1396060899,1396060989,5,5,90
21030940@N06,1208,25,1396071476,1396072226,4,5,750
21030940@N06,1208,7,1396080156,1396080246,5,5,90
21030940@N06,1208,10,1396081439,1396081859,6,5,420
21038859@N08,1209,26,1209625799,1209625979,2,1,180
21038859@N08,1210,16,1210034954,1210035674,1,1,720
21068473@N06,1211,16,1408875740,1408876460,2,1,720
21122985@N02,1212,21,1202085726,1202086176,1,1,450
21122985@N02,1213,21,1360038251,1360038701,11,1,450
21122985@N02,1214,21,1360748356,1360748806,15,1,450
21122985@N02,1215,21,1382570747,1382571197,9,1,450
21122985@N02,1216,21,1399687868,1399688318,16,1,450
21134819@N00,1217,27,1259020762,1259021962,1,1,1200
21138471@N00,1218,3,1224803363,1224803633,2,1,270
21138471@N00,1219,27,1224914093,1224915293,2,1,1200
21138471@N00,1220,1,1224970695,1224971295,2,2,600
21138471@N00,1220,7,1224973616,1224973706,1,2,90
21138471@N00,1221,17,1348272493,1348273873,2,2,1380
21138471@N00,1221,27,1348285423,1348286623,1,2,1200
21143202@N08,1222,17,1262611446,1262612826,1,1,1380
21143202@N08,1223,15,1276177820,1276178000,1,1,180
21151445@N02,1224,15,1460599033,1460599213,3,7,180
21151445@N02,1224,19,1460607181,1460607601,9,7,420
21151445@N02,1224,20,1460610874,1460611954,5,7,1080
21151445@N02,1224,22,1460613081,1460613681,3,7,600
21151445@N02,1224,4,1460613870,1460614133,2,7,263
21151445@N02,1224,5,1460614133,1460614853,2,7,720
21151445@N02,1224,8,1460617197,1460617317,3,7,120
21159284@N08,1225,10,1447566710,1447567130,2,5,420
21159284@N08,1225,7,1447569636,1447569726,4,5,90
21159284@N08,1225,8,1447569812,1447569932,3,5,120
21159284@N08,1225,14,1447570378,1447570498,3,5,120
21159284@N08,1225,17,1447573089,1447574469,2,5,1380
21212744@N07,1226,27,1199144048,1199145248,9,2,1200
21212744@N07,1226,16,1199145747,1199146467,1,2,720
21242740@N00,1227,4,1263626655,1263627555,4,1,900
21242740@N00,1228,4,1263714159,1263715059,2,1,900
21242740@N00,1229,4,1266656870,1266657770,5,1,900
21254904@N02,1230,4,1219715784,1219716684,1,1,900
21299180@N02,1231,3,1364100627,1364100897,1,1,270
21301462@N02,1232,27,1311422415,1311423615,11,2,1200
21301462@N02,1232,16,1311429653,1311430373,11,2,720
21301462@N02,1233,13,1311646474,1311647074,6,2,600
21301462@N02,1233,21,1311651038,1311651488,2,2,450
21328392@N06,1234,27,1311289729,1311290929,3,10,1200
21328392@N06,1234,26,1311297474,1311297654,3,10,180
21328392@N06,1234,17,1311299195,1311300575,3,10,1380
21328392@N06,1234,23,1311302800,1311302890,2,10,90
21328392@N06,1234,24,1311306060,1311306540,2,10,480
21328392@N06,1234,5,1311314817,1311315492,2,10,675
21328392@N06,1234,4,1311315492,1311316392,2,10,900
21328392@N06,1234,18,1311319995,1311320363,4,10,368
21328392@N06,1234,19,1311320363,1311320783,2,10,420
21328392@N06,1234,27,1311343268,1311344468,1,10,1200
21329192@N06,1235,16,1249189837,1249190557,1,1,720
21361334@N02,1236,16,1255006288,1255007008,1,1,720
21369373@N00,1237,25,1353741279,1353741304,2,2,25
21369373@N00,1237,17,1353741304,1353742684,1,2,1380
21377282@N00,1238,20,1220835053,1220836133,1,1,1080
21383026@N06,1239,14,1244265299,1244265419,1,1,120
21383026@N06,1240,11,1248595709,1248595889,2,2,180
21383026@N06,1240,27,1248601371,1248602571,1,2,1200
21383026@N06,1241,11,1249044933,1249045113,5,1,180
21383026@N06,1242,11,1249184747,1249184927,1,1,180
21383026@N06,1243,11,1249819070,1249819250,5,1,180
21383026@N06,1244,11,1249898324,1249898504,2,1,180
21383026@N06,1245,11,1250423300,1250423480,2,1,180
21383026@N06,1246,18,1251017759,1251019559,1,1,1800
21383026@N06,1247,21,1255598280,1255598730,1,1,450
21383026@N06,1248,9,1256036914,1256037154,1,1,240
21383026@N06,1249,26,1257395711,1257395891,1,1,180
21383026@N06,1250,16,1259205792,1259206512,5,1,720
21383026@N06,1251,14,1259746524,1259746644,1,1,120
21383026@N06,1252,14,1260335154,1260335274,2,1,120
21383026@N06,1253,9,1262047142,1262047382,1,1,240
21383026@N06,1254,17,1281845057,1281846437,1,1,1380
21383026@N06,1255,11,1283748763,1283748943,1,1,180
21383026@N06,1256,11,1284607764,1284607944,1,1,180
21383026@N06,1257,27,1286672243,1286673443,1,1,1200
21383026@N06,1258,27,1287468291,1287469491,1,1,1200
21383026@N06,1259,11,1289042501,1289042681,3,1,180
21383026@N06,1260,17,1289121663,1289123043,2,1,1380
21383026@N06,1261,11,1289455692,1289455872,1,1,180
21383026@N06,1262,27,1292384984,1292386184,9,1,1200
21383026@N06,1263,11,1293853485,1293853665,1,1,180
21383026@N06,1264,9,1294195272,1294195512,1,1,240
21383026@N06,1265,14,1295310485,1295310605,1,1,120
21383026@N06,1266,9,1296546741,1296546981,2,1,240
21383026@N06,1267,8,1297328938,1297329058,1,1,120
21383026@N06,1268,27,1297569894,1297571094,3,2,1200
21383026@N06,1268,26,1297571320,1297571500,2,2,180
21383026@N06,1269,27,1298779541,1298780741,1,1,1200
21383026@N06,1270,9,1299636096,1299636336,3,1,240
21383026@N06,1271,26,1300416800,1300416980,1,1,180
21383026@N06,1272,25,1301109933,1301110683,2,3,750
21383026@N06,1272,21,1301111421,1301111871,2,3,450
21383026@N06,1272,9,1301122400,1301122640,2,3,240
21383026@N06,1273,25,1302516039,1302516789,2,2,750
21383026@N06,1273,16,1302528542,1302529262,1,2,720
21383026@N06,1274,16,1302669945,1302670665,16,1,720
21383026@N06,1275,14,1305196315,1305196435,2,2,120
21383026@N06,1275,9,1305197905,1305198145,1,2,240
21383026@N06,1276,16,1305602414,1305603134,11,9,720
21383026@N06,1276,14,1305606067,1305606187,2,9,120
21383026@N06,1276,20,1305610189,1305611269,6,9,1080
21383026@N06,1276,21,1305611612,1305612062,2,9,450
21383026@N06,1276,9,1305617645,1305617885,5,9,240
21383026@N06,1276,27,1305623192,1305624392,2,9,1200
21383026@N06,1276,13,1305629029,1305629264,3,9,235
21383026@N06,1276,18,1305629264,1305629867,2,9,603
21383026@N06,1276,13,1305629867,1305630467,2,9,600
21383026@N06,1277,21,1306372632,1306373082,2,2,450
21383026@N06,1277,16,1306380486,1306381206,2,2,720
21383026@N06,1278,15,1310035997,1310036177,2,2,180
21383026@N06,1278,21,1310050064,1310050514,1,2,450
21383026@N06,1279,27,1311254484,1311255684,1,1,1200
21383026@N06,1280,27,1315907350,1315907998,2,5,648
21383026@N06,1280,4,1315907998,1315908584,2,5,586
21383026@N06,1280,27,1315908584,1315909784,2,5,1200
21383026@N06,1280,17,1315918157,1315919537,4,5,1380
21383026@N06,1280,4,1315921613,1315922513,12,5,900
21383026@N06,1281,27,1320392124,1320393324,3,2,1200
21383026@N06,1281,16,1320395098,1320395818,1,2,720
21422300@N00,1282,15,1220096311,1220096491,1,1,180
21422300@N00,1283,16,1337074210,1337074930,1,1,720
21472383@N03,1284,14,1200554076,1200554196,2,1,120
21537074@N06,1285,19,1262184482,1262184902,1,1,420
21537772@N02,1286,27,1196092005,1196093205,2,8,1200
21537772@N02,1286,16,1196095047,1196095767,2,8,720
21537772@N02,1286,5,1196097283,1196098003,2,8,720
21537772@N02,1286,7,1196098875,1196098965,2,8,90
21537772@N02,1286,16,1196103016,1196103736,5,8,720
21537772@N02,1286,22,1196112037,1196112637,10,8,600
21537772@N02,1286,19,1196114415,1196114835,3,8,420
21537772@N02,1286,16,1196116336,1196117056,1,8,720
21541613@N06,1287,27,1434494470,1434495670,1,1,1200
21541613@N06,1288,27,1447906137,1447907337,1,1,1200
21591624@N00,1289,22,1215666550,1215667150,1,1,600
21591624@N00,1290,16,1345703677,1345704397,1,1,720
21592589@N00,1291,1,1460167355,1460167955,2,2,600
21592589@N00,1291,20,1460186084,1460187164,1,2,1080
21637807@N07,1292,4,1242347408,1242348133,2,11,725
21637807@N07,1292,6,1242348133,1242348388,6,11,255
21637807@N07,1292,11,1242353384,1242353564,8,11,180
21637807@N07,1292,14,1242356843,1242356963,6,11,120
21637807@N07,1292,16,1242360949,1242361669,2,11,720
21637807@N07,1292,12,1242362152,1242362992,4,11,840
21637807@N07,1292,20,1242365319,1242366399,3,11,1080
21637807@N07,1292,18,1242367275,1242367346,3,11,71
21637807@N07,1292,13,1242367346,1242367517,2,11,171
21637807@N07,1292,18,1242367517,1242369317,8,11,1800
21637807@N07,1292,20,1242374180,1242375260,2,11,1080
21637807@N07,1293,4,1242560679,1242561579,1,1,900
21641933@N00,1294,25,1377652159,1377652909,2,4,750
21641933@N00,1294,10,1377657060,1377657480,2,4,420
21641933@N00,1294,8,1377660680,1377660800,2,4,120
21641933@N00,1294,2,1377664033,1377664123,2,4,90
21652490@N06,1295,16,1217512800,1217513520,70,1,720
21652490@N06,1296,16,1228050000,1228050720,92,1,720
21652490@N06,1297,16,1254319200,1254319920,89,1,720
21652490@N06,1298,16,1275314400,1275315120,39,1,720
21667128@N00,1299,8,1293603387,1293603507,2,2,120
21667128@N00,1299,17,1293613697,1293615077,1,2,1380
21668671@N04,1300,17,1337484204,1337485584,2,2,1380
21668671@N04,1300,9,1337486935,1337487175,2,2,240
21685693@N02,1301,21,1195468990,1195469440,3,4,450
21685693@N02,1301,17,1195470704,1195472084,2,4,1380
21685693@N02,1301,26,1195485528,1195485708,16,4,180
21685693@N02,1301,12,1195493888,1195494728,1,4,840
21685693@N02,1302,26,1197159753,1197159933,1,1,180
21685693@N02,1303,27,1257111088,1257112288,3,6,1200
21685693@N02,1303,15,1257118783,1257118865,2,6,82
21685693@N02,1303,12,1257118865,1257119705,2,6,840
21685693@N02,1303,14,1257121096,1257121216,2,6,120
21685693@N02,1303,2,1257123031,1257123121,3,6,90
21685693@N02,1303,17,1257136389,1257137769,11,6,1380
21685693@N02,1304,19,1257202484,1257202904,2,2,420
21685693@N02,1304,11,1257208275,1257208455,1,2,180
21739162@N04,1305,27,1254089580,1254090780,19,19,1200
21739162@N04,1305,2,1254092598,1254092644,2,19,46
21739162@N04,1305,5,1254092644,1254092683,2,19,39
21739162@N04,1305,3,1254092683,1254092953,2,19,270
21739162@N04,1305,6,1254094043,1254094277,2,19,234
21739162@N04,1305,2,1254094277,1254094367,4,19,90
21739162@N04,1305,6,1254094703,1254094958,5,19,255
21739162@N04,1305,9,1254099737,1254099977,2,19,240
21739162@N04,1305,14,1254100200,1254100320,2,19,120
21739162@N04,1305,15,1254102199,1254102379,5,19,180
21739162@N04,1305,18,1254104917,1254105018,2,19,101
21739162@N04,1305,13,1254105018,1254105618,2,19,600
21739162@N04,1305,17,1254106191,1254107571,5,19,1380
21739162@N04,1305,26,1254108836,1254109016,2,19,180
21739162@N04,1305,22,1254110514,1254110756,3,19,242
21739162@N04,1305,20,1254110756,1254111836,2,19,1080
21739162@N04,1305,23,1254113486,1254113576,3,19,90
21739162@N04,1305,16,1254116473,1254117193,4,19,720
21739162@N04,1305,27,1254119404,1254120604,3,19,1200
21739162@N04,1306,2,1302304101,1302304191,3,12,90
21739162@N04,1306,1,1302304203,1302304803,2,12,600
21739162@N04,1306,6,1302306189,1302306429,2,12,240
21739162@N04,1306,2,1302306429,1302306519,2,12,90
21739162@N04,1306,7,1302306583,1302306618,2,12,35
21739162@N04,1306,6,1302306618,1302306873,2,12,255
21739162@N04,1306,2,1302307975,1302308065,4,12,90
21739162@N04,1306,17,1302315962,1302317342,2,12,1380
21739162@N04,1306,13,1302321029,1302321629,3,12,600
21739162@N04,1306,27,1302333531,1302334731,11,12,1200
21739162@N04,1306,6,1302355304,1302355322,2,12,18
21739162@N04,1306,9,1302355322,1302355562,1,12,240
21739162@N04,1307,27,1302564503,1302565703,2,5,1200
21739162@N04,1307,23,1302568917,1302569007,4,5,90
21739162@N04,1307,22,1302569543,1302570143,2,5,600
21739162@N04,1307,18,1302571354,1302572763,4,5,1409
21739162@N04,1307,13,1302572763,1302573363,1,5,600
21748548@N00,1308,27,1420617066,1420618266,5,3,1200
21748548@N00,1308,10,1420618902,1420619322,9,3,420
21748548@N00,1308,16,1420625810,1420626530,4,3,720
21748548@N00,1309,4,1420835768,1420836035,3,8,267
21748548@N00,1309,5,1420836035,1420836496,2,8,461
21748548@N00,1309,9,1420836496,1420836553,3,8,57
21748548@N00,1309,14,1420836553,1420836671,4,8,118
21748548@N00,1309,16,1420836671,1420836923,2,8,252
21748548@N00,1309,17,1420836923,1420837085,2,8,162
21748548@N00,1309,22,1420837085,1420837166,2,8,81
21748548@N00,1309,20,1420837166,1420838246,1,8,1080
21748548@N00,1310,4,1420922461,1420922715,3,10,254
21748548@N00,1310,14,1420922715,1420922730,3,10,15
21748548@N00,1310,16,1420922730,1420922740,2,10,10
21748548@N00,1310,14,1420922740,1420922769,2,10,29
21748548@N00,1310,16,1420922769,1420923011,2,10,242
21748548@N00,1310,22,1420923011,1420923136,3,10,125
21748548@N00,1310,20,1420923136,1420924216,2,10,1080
21748548@N00,1310,27,1420949360,1420950560,30,10,1200
21748548@N00,1310,21,1420955464,1420955867,3,10,403
21748548@N00,1310,24,1420955867,1420956347,1,10,480
21801897@N04,1311,21,1289354886,1289355336,1,1,450
21801897@N04,1312,1,1307520583,1307521183,1,1,600
21807174@N04,1313,27,1310094892,1310096092,2,3,1200
21807174@N04,1313,26,1310102004,1310102184,2,3,180
21807174@N04,1313,27,1310127368,1310128568,1,3,1200
21807174@N04,1314,27,1354781729,1354782929,2,1,1200
21893264@N00,1315,21,1236315367,1236315817,7,3,450
21893264@N00,1315,14,1236318361,1236318481,2,3,120
21893264@N00,1315,16,1236318573,1236319293,1,3,720
21920009@N05,1316,6,1303989075,1303989330,1,1,255
21933943@N02,1317,14,1379736669,1379736789,1,1,120
21933943@N02,1318,27,1379785279,1379786479,1,1,1200
21935793@N05,1319,4,1227947890,1227948790,1,1,900
21978090@N03,1320,27,1322702563,1322703763,3,1,1200
21978090@N03,1321,20,1322784989,1322786069,2,3,1080
21978090@N03,1321,26,1322790477,1322790657,3,3,180
21978090@N03,1321,17,1322792327,1322793707,1,3,1380
21978090@N03,1322,3,1323047503,1323047773,2,2,270
21978090@N03,1322,14,1323054993,1323055113,4,2,120
21978090@N03,1323,27,1323246588,1323247788,3,3,1200
21978090@N03,1323,22,1323248360,1323248960,4,3,600
21978090@N03,1323,17,1323252239,1323253619,1,3,1380
21978090@N03,1324,27,1323388096,1323388449,2,5,353
21978090@N03,1324,5,1323388449,1323388947,2,5,498
21978090@N03,1324,6,1323388947,1323389202,3,5,255
21978090@N03,1324,27,1323392006,1323393206,4,5,1200
21978090@N03,1324,26,1323404577,1323404757,2,5,180
22004642@N00,1325,2,1196166892,1196166982,1,1,90
22046456@N04,1326,1,1280142697,1280143297,1,1,600
22068918@N00,1327,20,1237843746,1237844826,2,7,1080
22068918@N00,1327,16,1237846614,1237847334,2,7,720
22068918@N00,1327,5,1237848575,1237849295,6,7,720
22068918@N00,1327,3,1237850674,1237850944,6,7,270
22068918@N00,1327,27,1237865250,1237866450,3,7,1200
22068918@N00,1327,26,1237871081,1237871261,4,7,180
22068918@N00,1327,27,1237876188,1237877388,6,7,1200
22093605@N05,1328,17,1317587563,1317588943,1,1,1380
22107206@N00,1329,7,1369436995,1369437085,2,3,90
22107206@N00,1329,14,1369442507,1369442627,3,3,120
22107206@N00,1329,20,1369445271,1369446351,1,3,1080
22119513@N00,1330,18,1251251253,1251253053,1,1,1800
22131083@N08,1331,14,1379130808,1379130928,1,1,120
22151340@N02,1332,13,1198641328,1198641928,1,1,600
22151340@N02,1333,1,1207833567,1207834167,2,2,600
22151340@N02,1333,13,1207834448,1207835048,1,2,600
22151340@N02,1334,20,1212286496,1212287576,2,7,1080
22151340@N02,1334,21,1212288298,1212288735,2,7,437
22151340@N02,1334,4,1212288735,1212289635,2,7,900
22151340@N02,1334,13,1212292414,1212293014,3,7,600
22151340@N02,1334,1,1212294587,1212295187,3,7,600
22151340@N02,1334,19,1212297739,1212298159,4,7,420
22151340@N02,1334,13,1212319278,1212319878,1,7,600
22151340@N02,1335,19,1215235566,1215235986,1,1,420
22151340@N02,1336,6,1216517528,1216517783,1,1,255
22151340@N02,1337,4,1217380925,1217381825,2,1,900
22151340@N02,1338,13,1217567072,1217567672,1,1,600
22151340@N02,1339,14,1235177258,1235177378,2,6,120
22151340@N02,1339,3,1235180891,1235181161,2,6,270
22151340@N02,1339,14,1235187100,1235187220,2,6,120
22151340@N02,1339,27,1235191543,1235192743,2,6,1200
22151340@N02,1339,14,1235197405,1235197525,3,6,120
22151340@N02,1339,3,1235207318,1235207588,1,6,270
22152932@N08,1340,16,1398241527,1398241727,2,3,200
22152932@N08,1340,26,1398241727,1398241907,2,3,180
22152932@N08,1340,19,1398246969,1398247389,1,3,420
22158588@N00,1341,27,1201322620,1201323820,2,3,1200
22158588@N00,1341,22,1201325295,1201325895,5,3,600
22158588@N00,1341,5,1201328794,1201329514,1,3,720
22158588@N00,1342,18,1203233656,1203234709,2,3,1053
22158588@N00,1342,17,1203234709,1203236089,2,3,1380
22158588@N00,1342,5,1203236921,1203237641,1,3,720
22158588@N00,1343,2,1204348120,1204348210,2,2,90
22158588@N00,1343,16,1204349407,1204350127,1,2,720
22158588@N00,1344,17,1206940115,1206941495,1,1,1380
22158588@N00,1345,17,1207376824,1207377277,2,4,453
22158588@N00,1345,26,1207377277,1207377457,2,4,180
22158588@N00,1345,20,1207380501,1207381581,5,4,1080
22158588@N00,1345,17,1207382377,1207383757,2,4,1380
22161498@N00,1346,27,1195262505,1195263358,7,12,853
22161498@N00,1346,16,1195263358,1195263713,3,12,355
22161498@N00,1346,23,1195263713,1195263803,3,12,90
22161498@N00,1346,21,1195264524,1195264974,3,12,450
22161498@N00,1346,23,1195267443,1195267533,8,12,90
22161498@N00,1346,26,1195269867,1195270047,7,12,180
22161498@N00,1346,25,1195270487,1195271237,4,12,750
22161498@N00,1346,24,1195272229,1195272709,9,12,480
22161498@N00,1346,11,1195276120,1195276300,13,12,180
22161498@N00,1346,16,1195278630,1195279350,6,12,720
22161498@N00,1346,2,1195280911,1195281001,2,12,90
22161498@N00,1346,3,1195282035,1195282305,1,12,270
22161498@N00,1347,17,1195526357,1195527737,2,3,1380
22161498@N00,1347,6,1195528636,1195528891,3,3,255
22161498@N00,1347,22,1195531226,1195531826,23,3,600
22175508@N08,1348,17,1431749507,1431750887,3,1,1380
22185077@N06,1349,14,1357111645,1357111765,2,1,120
22232518@N05,1350,12,1313138666,1313139506,2,1,840
22247605@N07,1351,27,1340690583,1340691783,1,1,1200
22255270@N04,1352,27,1194564358,1194565558,4,7,1200
22255270@N04,1352,4,1194568830,1194569730,2,7,900
22255270@N04,1352,27,1194571008,1194572208,2,7,1200
22255270@N04,1352,14,1194578519,1194578639,4,7,120
22255270@N04,1352,16,1194580553,1194581273,4,7,720
22255270@N04,1352,1,1194585752,1194586352,2,7,600
22255270@N04,1352,16,1194586996,1194587716,3,7,720
22261589@N00,1353,27,1194131576,1194132776,3,2,1200
22261589@N00,1353,16,1194144990,1194145710,1,2,720
22261589@N00,1354,27,1194514731,1194515931,1,1,1200
22261589@N00,1355,27,1194650592,1194651792,2,3,1200
22261589@N00,1355,16,1194652786,1194653506,2,3,720
22261589@N00,1355,2,1194653928,1194654018,1,3,90
22261589@N00,1356,16,1195108138,1195108858,2,1,720
22261589@N00,1357,9,1266656162,1266656402,1,1,240
22261589@N00,1358,27,1270030739,1270031939,1,1,1200
22261589@N00,1359,15,1291529156,1291529336,2,3,180
22261589@N00,1359,14,1291534505,1291534625,2,3,120
22261589@N00,1359,17,1291535695,1291537075,5,3,1380
22261589@N00,1360,27,1291961176,1291962376,1,1,1200
22261589@N00,1361,11,1292196389,1292196569,2,2,180
22261589@N00,1361,9,1292198523,1292198763,1,2,240
22261589@N00,1362,17,1292229010,1292230390,3,1,1380
22261589@N00,1363,12,1337217261,1337218101,4,6,840
22261589@N00,1363,5,1337219978,1337220698,3,6,720
22261589@N00,1363,9,1337221029,1337221269,2,6,240
22261589@N00,1363,22,1337225301,1337225901,2,6,600
22261589@N00,1363,21,1337229378,1337229828,2,6,450
22261589@N00,1363,27,1337232175,1337233375,2,6,1200
22261589@N00,1364,27,1337735284,1337736312,2,3,1028
22261589@N00,1364,17,1337736312,1337737692,3,3,1380
22261589@N00,1364,27,1337762344,1337763544,1,3,1200
22261589@N00,1365,9,1342168969,1342168980,2,3,11
22261589@N00,1365,27,1342168980,1342168992,2,3,12
22261589@N00,1365,14,1342168992,1342169112,2,3,120
22261589@N00,1366,18,1346764738,1346764761,2,4,23
22261589@N00,1366,12,1346764761,1346764773,2,4,12
22261589@N00,1366,27,1346764773,1346764784,2,4,11
22261589@N00,1366,21,1346764784,1346765234,1,4,450
22261589@N00,1367,12,1385879638,1385880478,2,4,840
22261589@N00,1367,26,1385883043,1385883049,2,4,6
22261589@N00,1367,19,1385883049,1385883469,2,4,420
22261589@N00,1367,20,1385893769,1385894849,1,4,1080
22261589@N00,1368,27,1386888674,1386889874,4,1,1200
22261589@N00,1369,15,1391161593,1391161773,1,1,180
22265703@N06,1370,15,1200142800,1200142800,2,2,0
22265703@N06,1370,16,1200142800,1200143520,2,2,720
22265703@N06,1371,13,1200186087,1200186453,3,19,366
22265703@N06,1371,15,1200186453,1200186633,4,19,180
22265703@N06,1371,13,1200187951,1200188551,4,19,600
22265703@N06,1371,15,1200189126,1200189148,2,19,22
22265703@N06,1371,16,1200189148,1200189224,2,19,76
22265703@N06,1371,15,1200189224,1200189404,30,19,180
22265703@N06,1371,4,1200203050,1200203950,5,19,900
22265703@N06,1371,16,1200204788,1200205508,96,19,720
22265703@N06,1371,26,1200207877,1200208051,2,19,174
22265703@N06,1371,25,1200208051,1200208733,40,19,682
22265703@N06,1371,23,1200208733,1200208823,9,19,90
22265703@N06,1371,17,1200210027,1200211170,3,19,1143
22265703@N06,1371,19,1200211170,1200211389,5,19,219
22265703@N06,1371,18,1200211389,1200211554,5,19,165
22265703@N06,1371,19,1200211554,1200211584,2,19,30
22265703@N06,1371,18,1200211584,1200213199,2,19,1615
22265703@N06,1371,20,1200213199,1200214279,6,19,1080
22265703@N06,1371,16,1200214566,1200215286,31,19,720
22265703@N06,1371,27,1200219674,1200220874,7,19,1200
22273519@N07,1372,27,1315363925,1315365125,3,3,1200
22273519@N07,1372,19,1315366018,1315366438,2,3,420
22273519@N07,1372,9,1315369603,1315369843,1,3,240
22287142@N02,1373,16,1239588589,1239589309,1,1,720
22311971@N04,1374,27,1322170051,1322171251,4,16,1200
22311971@N04,1374,17,1322173922,1322174037,2,16,115
22311971@N04,1374,25,1322174037,1322174203,3,16,166
22311971@N04,1374,24,1322174203,1322174683,2,16,480
22311971@N04,1374,25,1322175191,1322175941,6,16,750
22311971@N04,1374,21,1322176724,1322177174,2,16,450
22311971@N04,1374,19,1322179076,1322179496,4,16,420
22311971@N04,1374,13,1322183438,1322184038,4,16,600
22311971@N04,1374,14,1322188936,1322189056,2,16,120
22311971@N04,1374,16,1322189284,1322190004,2,16,720
22311971@N04,1374,4,1322195273,1322196173,3,16,900
22311971@N04,1374,2,1322198631,1322198721,2,16,90
22311971@N04,1374,9,1322198892,1322199132,2,16,240
22311971@N04,1374,2,1322199313,1322199403,4,16,90
22311971@N04,1374,9,1322201090,1322201330,3,16,240
22311971@N04,1374,4,1322202996,1322203896,1,16,900
22375931@N03,1375,1,1298695463,1298696063,1,1,600
22404194@N03,1376,27,1371295739,1371296939,2,1,1200
22416200@N05,1377,18,1270077498,1270079298,2,2,1800
22416200@N05,1377,3,1270089936,1270090206,1,2,270
22423587@N03,1378,2,1217653114,1217653204,2,14,90
22423587@N03,1378,14,1217656615,1217656735,3,14,120
22423587@N03,1378,21,1217657724,1217658174,3,14,450
22423587@N03,1378,13,1217660389,1217660989,5,14,600
22423587@N03,1378,15,1217665232,1217665412,2,14,180
22423587@N03,1378,12,1217665672,1217666512,3,14,840
22423587@N03,1378,5,1217667681,1217668401,2,14,720
22423587@N03,1378,1,1217670724,1217671101,2,14,377
22423587@N03,1378,4,1217671101,1217672001,3,14,900
22423587@N03,1378,17,1217676117,1217677497,7,14,1380
22423587@N03,1378,16,1217677750,1217678470,2,14,720
22423587@N03,1378,17,1217678560,1217679710,5,14,1150
22423587@N03,1378,16,1217679710,1217679755,2,14,45
22423587@N03,1378,15,1217679755,1217679935,1,14,180
22423587@N03,1379,14,1256303693,1256303813,1,1,120
22423587@N03,1380,16,1268292218,1268292938,1,1,720
22423587@N03,1381,11,1270959036,1270959216,2,2,180
22423587@N03,1381,8,1270959346,1270959466,1,2,120
22423587@N03,1382,1,1284864805,1284865405,2,4,600
22423587@N03,1382,11,1284865917,1284866097,2,4,180
22423587@N03,1382,18,1284867186,1284867340,2,4,154
22423587@N03,1382,13,1284867340,1284867940,1,4,600
22423587@N03,1383,17,1287229117,1287230497,2,2,1380
22423587@N03,1383,4,1287233174,1287234074,2,2,900
22423587@N03,1384,16,1291802844,1291803564,2,2,720
22423587@N03,1384,27,1291808660,1291809860,1,2,1200
22423587@N03,1385,13,1291872219,1291872819,1,1,600
22423587@N03,1386,22,1293254452,1293255052,1,1,600
22423587@N03,1387,16,1303458617,1303459337,2,3,720
22423587@N03,1387,17,1303459553,1303460619,2,3,1066
22423587@N03,1387,9,1303460619,1303460859,1,3,240
22423587@N03,1388,13,1307243175,1307243775,1,1,600
22423587@N03,1389,27,1317444745,1317445945,2,1,1200
22446827@N02,1390,8,1401075889,1401076009,2,2,120
22446827@N02,1390,17,1401077751,1401079131,1,2,1380
22462637@N00,1391,27,1301551760,1301552960,2,1,1200
22462637@N00,1392,17,1301699766,1301701146,3,4,1380
22462637@N00,1392,16,1301711662,1301712382,2,4,720
22462637@N00,1392,3,1301717704,1301717974,2,4,270
22462637@N00,1392,21,1301725439,1301725889,1,4,450
22473198@N00,1393,27,1319166709,1319167909,2,3,1200
22473198@N00,1393,21,1319168363,1319168813,2,3,450
22473198@N00,1393,27,1319181204,1319182404,1,3,1200
22474934@N00,1394,6,1382603539,1382603765,5,10,226
22474934@N00,1394,2,1382603765,1382603855,2,10,90
22474934@N00,1394,6,1382604141,1382604396,3,10,255
22474934@N00,1394,2,1382604557,1382604647,2,10,90
22474934@N00,1394,6,1382606019,1382606274,2,10,255
22474934@N00,1394,10,1382607126,1382607546,2,10,420
22474934@N00,1394,21,1382610743,1382611193,3,10,450
22474934@N00,1394,18,1382612623,1382612917,3,10,294
22474934@N00,1394,13,1382612917,1382613517,3,10,600
22474934@N00,1394,27,1382615842,1382617042,1,10,1200
22496843@N03,1395,27,1207717154,1207718354,28,9,1200
22496843@N03,1395,20,1207720419,1207721499,5,9,1080
22496843@N03,1395,4,1207732371,1207733271,2,9,900
22496843@N03,1395,5,1207733502,1207734222,3,9,720
22496843@N03,1395,27,1207736710,1207737910,2,9,1200
22496843@N03,1395,4,1207742470,1207742772,3,9,302
22496843@N03,1395,27,1207742772,1207742843,2,9,71
22496843@N03,1395,4,1207742843,1207743100,3,9,257
22496843@N03,1395,27,1207743100,1207744300,1,9,1200
22500161@N06,1396,17,1330499342,1330500722,1,1,1380
22507625@N00,1397,6,1385459375,1385459630,1,1,255
22541015@N00,1398,27,1212829675,1212830875,1,1,1200
22597539@N03,1399,16,1301818820,1301819540,1,1,720
22616926@N08,1400,16,1198835247,1198835967,3,1,720
22616926@N08,1401,16,1410237186,1410237906,2,1,720
22616926@N08,1402,16,1410317933,1410318653,1,1,720
22659528@N06,1403,27,1347170126,1347171326,2,3,1200
22659528@N06,1403,16,1347175192,1347175912,2,3,720
22659528@N06,1403,4,1347191728,1347192628,1,3,900
22659528@N06,1404,14,1347530307,1347530427,1,1,120
22659528@N06,1405,16,1348216535,1348217255,2,2,720
22659528@N06,1405,27,1348232325,1348233525,1,2,1200
22659528@N06,1406,10,1403679053,1403679473,1,1,420
22659528@N06,1407,14,1404211955,1404212075,1,1,120
22659528@N06,1408,10,1407665867,1407666287,1,1,420
22684438@N02,1409,27,1199319903,1199321103,3,7,1200
22684438@N02,1409,17,1199326184,1199326669,2,7,485
22684438@N02,1409,13,1199326669,1199327269,4,7,600
22684438@N02,1409,18,1199332699,1199333876,3,7,1177
22684438@N02,1409,19,1199333876,1199334296,6,7,420
22684438@N02,1409,16,1199343809,1199344529,5,7,720
22684438@N02,1409,21,1199356550,1199357000,1,7,450
22687691@N02,1410,16,1194168314,1194169034,2,2,720
22687691@N02,1410,27,1194173573,1194174773,1,2,1200
22687691@N02,1411,27,1195035923,1195037123,2,1,1200
22687691@N02,1412,4,1195898096,1195898996,1,1,900
22687691@N02,1413,6,1196075896,1196076151,1,1,255
22687691@N02,1414,22,1199606076,1199606676,1,1,600
22687691@N02,1415,14,1207829778,1207829898,1,1,120
22687691@N02,1416,14,1209468968,1209469088,1,1,120
22687691@N02,1417,9,1209811962,1209812202,1,1,240
22687691@N02,1418,27,1225580730,1225581930,3,2,1200
22687691@N02,1418,9,1225590705,1225590945,1,2,240
22687691@N02,1419,13,1225954479,1225955079,1,1,600
22696986@N08,1420,14,1283820097,1283820217,1,1,120
22707445@N00,1421,23,1409374587,1409374677,1,1,90
22720103@N06,1422,27,1345871149,1345872349,5,2,1200
22720103@N06,1422,7,1345874280,1345874370,2,2,90
22720103@N06,1423,27,1346020459,1346021659,4,6,1200
22720103@N06,1423,16,1346023101,1346023821,4,6,720
22720103@N06,1423,14,1346025348,1346025468,2,6,120
22720103@N06,1423,20,1346034074,1346035154,3,6,1080
22720103@N06,1423,23,1346059358,1346059448,2,6,90
22720103@N06,1423,17,1346063343,1346064723,1,6,1380
22721767@N08,1424,9,1358060369,1358060609,2,3,240
22721767@N08,1424,16,1358061739,1358062459,2,3,720
22721767@N08,1424,9,1358066427,1358066667,1,3,240
22737269@N05,1425,2,1265256460,1265256550,1,1,90
22742343@N00,1426,27,1373684143,1373685343,1,1,1200
22768390@N00,1427,27,1462838378,1462839578,8,37,1200
22768390@N00,1427,16,1462840122,1462840194,2,37,72
22768390@N00,1427,14,1462840194,1462840314,9,37,120
22768390@N00,1427,15,1462842805,1462842874,3,37,69
22768390@N00,1427,12,1462842874,1462843714,3,37,840
22768390@N00,1427,15,1462844236,1462844288,3,37,52
22768390@N00,1427,12,1462844288,1462844492,2,37,204
22768390@N00,1427,15,1462844492,1462844568,2,37,76
22768390@N00,1427,12,1462844568,1462844798,2,37,230
22768390@N00,1427,15,1462844798,1462844827,4,37,29
22768390@N00,1427,12,1462844827,1462845052,20,37,225
22768390@N00,1427,13,1462845052,1462845103,3,37,51
22768390@N00,1427,12,1462845103,1462845118,3,37,15
22768390@N00,1427,13,1462845118,1462845244,10,37,126
22768390@N00,1427,12,1462845244,1462845296,6,37,52
22768390@N00,1427,13,1462845296,1462845333,2,37,37
22768390@N00,1427,12,1462845333,1462846173,4,37,840
22768390@N00,1427,7,1462847774,1462847864,9,37,90
22768390@N00,1427,10,1462850543,1462850963,29,37,420
22768390@N00,1427,9,1462853334,1462853574,8,37,240
22768390@N00,1427,25,1462854871,1462855621,7,37,750
22768390@N00,1427,22,1462857141,1462857741,13,37,600
22768390@N00,1427,21,1462858228,1462858443,7,37,215
22768390@N00,1427,20,1462858443,1462858446,2,37,3
22768390@N00,1427,21,1462858446,1462858896,15,37,450
22768390@N00,1427,20,1462859819,1462860899,6,37,1080
22768390@N00,1427,25,1462863659,1462864409,5,37,750
22768390@N00,1427,6,1462866513,1462866768,2,37,255
22768390@N00,1427,4,1462868812,1462868856,3,37,44
22768390@N00,1427,3,1462868856,1462869126,6,37,270
22768390@N00,1427,2,1462869477,1462869567,12,37,90
22768390@N00,1427,4,1462871177,1462872077,2,37,900
22768390@N00,1427,2,1462872931,1462873021,6,37,90
22768390@N00,1427,6,1462874025,1462874249,2,37,224
22768390@N00,1427,9,1462874249,1462874376,3,37,127
22768390@N00,1427,6,1462874376,1462874631,2,37,255
22768390@N00,1427,14,1462875036,1462875156,1,37,120
22786107@N06,1428,20,1206876302,1206877382,18,1,1080
22791773@N07,1429,18,1280225213,1280227013,2,3,1800
22791773@N07,1429,22,1280229839,1280230439,2,3,600
22791773@N07,1429,16,1280231380,1280232100,1,3,720
22791773@N07,1430,16,1368007462,1368008182,1,1,720
22802028@N08,1431,27,1209675962,1209677162,5,4,1200
22802028@N08,1431,3,1209698215,1209698485,6,4,270
22802028@N08,1431,2,1209699626,1209699716,3,4,90
22802028@N08,1431,12,1209705986,1209706826,13,4,840
22802028@N08,1432,27,1209899436,1209900636,8,2,1200
22802028@N08,1432,13,1209907287,1209907887,1,2,600
22802028@N08,1433,20,1210124864,1210125944,4,7,1080
22802028@N08,1433,22,1210126818,1210127418,9,7,600
22802028@N08,1433,21,1210128335,1210128785,4,7,450
22802028@N08,1433,22,1210130622,1210131222,2,7,600
22802028@N08,1433,13,1210132835,1210132940,3,7,105
22802028@N08,1433,18,1210132940,1210134740,2,7,1800
22802028@N08,1433,3,1210141838,1210142108,1,7,270
22802028@N08,1434,27,1239054537,1239055737,2,12,1200
22802028@N08,1434,2,1239056284,1239056374,3,12,90
22802028@N08,1434,1,1239063918,1239064518,2,12,600
22802028@N08,1434,13,1239073408,1239073476,2,12,68
22802028@N08,1434,19,1239073476,1239073782,2,12,306
22802028@N08,1434,13,1239073782,1239074382,3,12,600
22802028@N08,1434,20,1239075887,1239076967,8,12,1080
22802028@N08,1434,16,1239084811,1239085531,3,12,720
22802028@N08,1434,21,1239099333,1239099783,2,12,450
22802028@N08,1434,13,1239102424,1239103024,3,12,600
22802028@N08,1434,19,1239103460,1239103880,2,12,420
22802028@N08,1434,9,1239107065,1239107305,2,12,240
22808487@N04,1435,27,1259987184,1259988384,6,3,1200
22808487@N04,1435,13,1259991676,1259992276,4,3,600
22808487@N04,1435,27,1260004091,1260005291,6,3,1200
22810906@N06,1436,27,1281533956,1281535156,1,1,1200
22810906@N06,1437,4,1324772939,1324773839,2,3,900
22810906@N06,1437,3,1324795966,1324796236,2,3,270
22810906@N06,1437,14,1324813756,1324813876,1,3,120
22810906@N06,1438,14,1325304223,1325304343,2,4,120
22810906@N06,1438,26,1325305739,1325305919,2,4,180
22810906@N06,1438,27,1325314208,1325315408,2,4,1200
22810906@N06,1438,4,1325320873,1325321773,1,4,900
22832552@N08,1439,14,1222679785,1222679905,2,3,120
22832552@N08,1439,20,1222690100,1222690646,2,3,546
22832552@N08,1439,16,1222690646,1222691366,2,3,720
22832552@N08,1440,14,1222936137,1222936257,1,1,120
22832552@N08,1441,16,1292590451,1292591171,1,1,720
22854594@N07,1442,14,1379933586,1379933706,2,2,120
22854594@N07,1442,27,1379933868,1379935068,1,2,1200
22854594@N07,1443,27,1379967215,1379968415,1,1,1200
22854594@N07,1444,27,1381886754,1381887954,1,1,1200
22854594@N07,1445,27,1382897505,1382898705,1,1,1200
22854594@N07,1446,27,1383156908,1383158108,6,1,1200
22866792@N00,1447,14,1291858586,1291858653,2,5,67
22866792@N00,1447,9,1291858653,1291858760,2,5,107
22866792@N00,1447,14,1291858760,1291858773,2,5,13
22866792@N00,1447,15,1291858773,1291858953,2,5,180
22866792@N00,1447,16,1291866334,1291867054,1,5,720
22884021@N06,1448,27,1262487299,1262488499,6,8,1200
22884021@N06,1448,26,1262488826,1262489006,2,8,180
22884021@N06,1448,21,1262489193,1262489205,3,8,12
22884021@N06,1448,23,1262489205,1262489269,2,8,64
22884021@N06,1448,21,1262489269,1262489719,2,8,450
22884021@N06,1448,16,1262510711,1262511431,2,8,720
22884021@N06,1448,27,1262511932,1262513132,3,8,1200
22884021@N06,1448,16,1262513269,1262513989,13,8,720
22884021@N06,1449,14,1262594413,1262594533,2,1,120
22925214@N04,1450,1,1420063361,1420063961,3,4,600
22925214@N04,1450,15,1420068897,1420069077,2,4,180
22925214@N04,1450,21,1420078152,1420078602,2,4,450
22925214@N04,1450,24,1420079075,1420079555,2,4,480
22925214@N04,1451,21,1420153704,1420154154,6,1,450
22937808@N04,1452,4,1367834047,1367834947,2,2,900
22937808@N04,1452,10,1367844795,1367845215,1,2,420
22937808@N04,1453,16,1399281980,1399282700,2,2,720
22937808@N04,1453,26,1399293774,1399293954,1,2,180
22937808@N04,1454,17,1430741053,1430742433,2,2,1380
22937808@N04,1454,15,1430747008,1430747188,1,2,180
22937808@N04,1455,15,1431126903,1431127083,1,1,180
22937808@N04,1456,26,1462269340,1462269520,2,2,180
22937808@N04,1456,27,1462274826,1462276026,1,2,1200
22938081@N06,1457,16,1214834400,1214834400,3,6,0
22938081@N06,1457,18,1214834400,1214834400,3,6,0
22938081@N06,1457,19,1214834400,1214834400,2,6,0
22938081@N06,1457,20,1214834400,1214834400,2,6,0
22938081@N06,1457,22,1214834400,1214834400,3,6,0
22938081@N06,1457,24,1214834400,1214834880,1,6,480
22938081@N06,1458,16,1232360799,1232360811,2,4,12
22938081@N06,1458,24,1232360811,1232360816,2,4,5
22938081@N06,1458,26,1232360816,1232360874,2,4,58
22938081@N06,1458,18,1232360874,1232362674,3,4,1800
23012921@N08,1459,16,1324550470,1324551190,1,1,720
23021321@N02,1460,20,1324604496,1324605576,2,2,1080
23021321@N02,1460,14,1324617792,1324617912,1,2,120
23031334@N00,1461,16,1296867351,1296868071,2,1,720
23036992@N08,1462,27,1264976916,1264977734,2,3,818
23036992@N08,1462,16,1264977734,1264978454,2,3,720
23036992@N08,1462,18,1264986188,1264987988,1,3,1800
23041412@N08,1463,27,1243140640,1243141840,8,4,1200
23041412@N08,1463,7,1243159627,1243159717,3,4,90
23041412@N08,1463,18,1243160534,1243162334,3,4,1800
23041412@N08,1463,26,1243165713,1243165893,1,4,180
23041412@N08,1464,27,1243413310,1243414510,3,1,1200
23041412@N08,1465,27,1243489037,1243490237,1,1,1200
23043254@N03,1466,14,1198048912,1198049032,1,1,120
23043254@N03,1467,22,1217018108,1217018708,1,1,600
23043254@N03,1468,14,1241488652,1241488772,1,1,120
23071360@N02,1469,16,1194478123,1194478843,3,1,720
23071360@N02,1470,16,1194849805,1194850525,20,1,720
23071450@N02,1471,4,1283841850,1283842750,1,1,900
23071450@N02,1472,27,1287986434,1287987634,1,1,1200
23071450@N02,1473,14,1288311846,1288311966,2,2,120
23071450@N02,1473,11,1288328942,1288329122,1,2,180
23074913@N00,1474,22,1298757681,1298758281,1,1,600
23074913@N00,1475,27,1299410110,1299411310,1,1,1200
23074913@N00,1476,8,1352850836,1352850956,1,1,120
23074913@N00,1477,26,1393118007,1393118187,1,1,180
23082655@N04,1478,19,1241156022,1241156442,1,1,420
23108813@N00,1479,19,1207115143,1207115563,2,2,420
23108813@N00,1479,1,1207132230,1207132830,1,2,600
23108813@N00,1480,8,1237620509,1237620629,1,1,120
23108813@N00,1481,27,1258876825,1258878025,1,1,1200
23108813@N00,1482,14,1264826348,1264826468,1,1,120
23108813@N00,1483,17,1264925178,1264926558,1,1,1380
23108813@N00,1484,17,1267078076,1267079456,1,1,1380
23108813@N00,1485,19,1273042181,1273042601,1,1,420
23108813@N00,1486,27,1275456564,1275457764,3,2,1200
23108813@N00,1486,6,1275465141,1275465396,1,2,255
23108813@N00,1487,14,1281080089,1281080209,1,1,120
23108813@N00,1488,20,1281313056,1281314136,1,1,1080
23108813@N00,1489,27,1281773835,1281775035,1,1,1200
23108813@N00,1490,1,1283591203,1283591803,1,1,600
23108813@N00,1491,8,1285225609,1285225729,1,1,120
23108813@N00,1492,27,1287367419,1287368619,1,1,1200
23108813@N00,1493,27,1291174086,1291175286,1,1,1200
23108813@N00,1494,9,1292484538,1292484778,1,1,240
23108813@N00,1495,24,1294023198,1294023678,1,1,480
23108813@N00,1496,2,1294464706,1294464796,1,1,90
23108813@N00,1497,14,1296188572,1296188692,1,1,120
23108813@N00,1498,27,1296293646,1296294846,1,1,1200
23108813@N00,1499,7,1297394700,1297394790,1,1,90
23108813@N00,1500,25,1306638138,1306638888,1,1,750
23108813@N00,1501,27,1309748172,1309749372,1,1,1200
23108813@N00,1502,17,1314858960,1314860340,1,1,1380
23108813@N00,1503,23,1315190113,1315190203,1,1,90
23108813@N00,1504,27,1317615229,1317616429,1,1,1200
23108813@N00,1505,27,1320121254,1320122454,1,1,1200
23108813@N00,1506,12,1320561971,1320562811,1,1,840
23108813@N00,1507,27,1322630136,1322631336,1,1,1200
23108813@N00,1508,27,1322796689,1322797889,1,1,1200
23108813@N00,1509,17,1323133694,1323135074,1,1,1380
23108813@N00,1510,17,1323239694,1323241074,1,1,1380
23108813@N00,1511,27,1324274873,1324276073,1,1,1200
23108813@N00,1512,27,1330488781,1330489981,1,1,1200
23108813@N00,1513,14,1338427525,1338427645,1,1,120
23108813@N00,1514,5,1346301405,1346302125,1,1,720
23108813@N00,1515,7,1349400398,1349400488,1,1,90
23108813@N00,1516,10,1351416917,1351417337,1,1,420
23108813@N00,1517,9,1354792075,1354792315,1,1,240
23108813@N00,1518,5,1365145804,1365146524,1,1,720
23108813@N00,1519,23,1367556352,1367556442,1,1,90
23108813@N00,1520,17,1367892798,1367894178,1,1,1380
23108813@N00,1521,8,1389854231,1389854351,1,1,120
23108813@N00,1522,10,1395906206,1395906626,1,1,420
23108813@N00,1523,9,1400742689,1400742929,1,1,240
23108813@N00,1524,9,1401423669,1401423909,1,1,240
23108813@N00,1525,14,1402368071,1402368191,1,1,120
23108813@N00,1526,20,1420337624,1420338704,1,1,1080
23108813@N00,1527,5,1437907042,1437907762,1,1,720
23108813@N00,1528,27,1439114457,1439115657,1,1,1200
23108813@N00,1529,27,1441708677,1441709877,1,1,1200
23108813@N00,1530,10,1442574728,1442575148,2,2,420
23108813@N00,1530,27,1442586381,1442587581,1,2,1200
23108813@N00,1531,27,1448082281,1448083481,1,1,1200
23108813@N00,1532,9,1450608158,1450608398,1,1,240
23108813@N00,1533,27,1451190567,1451191767,1,1,1200
23113465@N08,1534,23,1425335919,1425336009,2,6,90
23113465@N08,1534,21,1425336056,1425336506,2,6,450
23113465@N08,1534,27,1425340462,1425341662,2,6,1200
23113465@N08,1534,15,1425344505,1425344685,2,6,180
23113465@N08,1534,16,1425350712,1425351432,2,6,720
23113465@N08,1534,9,1425354373,1425354613,1,6,240
23113465@N08,1535,19,1453429347,1453429653,2,3,306
23113465@N08,1535,9,1453429653,1453429678,2,3,25
23113465@N08,1535,1,1453429678,1453430278,1,3,600
23117061@N05,1536,21,1331201103,1331201553,1,1,450
23126267@N02,1537,16,1411028981,1411029457,3,3,476
23126267@N02,1537,14,1411029457,1411029492,3,3,35
23126267@N02,1537,16,1411029492,1411030212,3,3,720
23126267@N02,1538,14,1411136457,1411136577,2,2,120
23126267@N02,1538,27,1411136916,1411138116,7,2,1200
23126267@N02,1539,26,1411251739,1411251919,2,4,180
23126267@N02,1539,27,1411261892,1411263092,2,4,1200
23126267@N02,1539,11,1411263654,1411263834,2,4,180
23126267@N02,1539,10,1411267267,1411267687,1,4,420
23156708@N02,1540,12,1362395371,1362396211,1,1,840
23172783@N07,1541,27,1339196152,1339197352,2,2,1200
23172783@N07,1541,19,1339200565,1339200985,1,2,420
23172783@N07,1542,27,1343388054,1343389254,1,1,1200
23172783@N07,1543,25,1344126149,1344126899,2,3,750
23172783@N07,1543,26,1344127817,1344127997,2,3,180
23172783@N07,1543,17,1344128016,1344129396,1,3,1380
23186244@N07,1544,16,1322295244,1322295964,1,1,720
23186244@N07,1545,27,1322352995,1322354195,1,1,1200
23186244@N07,1546,21,1450523230,1450523680,1,1,450
23198304@N02,1547,27,1189077501,1189078701,1,1,1200
23205379@N02,1548,5,1400780901,1400781621,2,2,720
23205379@N02,1548,14,1400802495,1400802615,1,2,120
23205379@N02,1549,15,1400887133,1400887313,2,3,180
23205379@N02,1549,14,1400893520,1400893640,2,3,120
23205379@N02,1549,25,1400901551,1400902301,1,3,750
23205379@N02,1550,14,1401080823,1401080943,1,1,120
23205379@N02,1551,25,1408693239,1408693989,1,1,750
23205379@N02,1552,26,1425009246,1425009426,1,1,180
23212779@N04,1553,27,1287707228,1287708428,1,1,1200
23212779@N04,1554,27,1287777091,1287778291,2,1,1200
23212779@N04,1555,27,1291869929,1291871129,3,2,1200
23212779@N04,1555,16,1291894052,1291894772,2,2,720
23212779@N04,1556,21,1298942557,1298943007,2,2,450
23212779@N04,1556,24,1298944413,1298944893,1,2,480
23212779@N04,1557,21,1301059019,1301059469,1,1,450
23212779@N04,1558,27,1301134704,1301135904,2,1,1200
23212779@N04,1559,21,1301214015,1301214465,1,1,450
23212779@N04,1560,2,1302384138,1302384228,1,1,90
23212779@N04,1561,27,1348864351,1348865551,1,1,1200
23212779@N04,1562,8,1348912166,1348912286,1,1,120
23214682@N06,1563,27,1377985305,1377986505,3,1,1200
23214682@N06,1564,27,1378038284,1378039484,2,1,1200
23214682@N06,1565,12,1378093468,1378094308,1,1,840
23258663@N00,1566,4,1324709721,1324710621,1,1,900
23288611@N00,1567,24,1232326422,1232326902,2,4,480
23288611@N00,1567,1,1232346000,1232346600,2,4,600
23288611@N00,1567,17,1232350720,1232352100,2,4,1380
23288611@N00,1567,16,1232367020,1232367740,1,4,720
23311397@N04,1568,14,1246832498,1246832618,149,1,120
23319775@N04,1569,16,1394363097,1394363817,3,2,720
23319775@N04,1569,14,1394370552,1394370672,2,2,120
23322134@N02,1570,27,1201307283,1201307975,4,22,692
23322134@N02,1570,5,1201307975,1201308695,2,22,720
23322134@N02,1570,2,1201308773,1201308824,2,22,51
23322134@N02,1570,5,1201308824,1201309488,2,22,664
23322134@N02,1570,3,1201309488,1201309758,2,22,270
23322134@N02,1570,18,1201310951,1201312201,3,22,1250
23322134@N02,1570,17,1201312201,1201313581,2,22,1380
23322134@N02,1570,18,1201314454,1201314985,2,22,531
23322134@N02,1570,26,1201314985,1201315165,2,22,180
23322134@N02,1570,13,1201320195,1201320795,4,22,600
23322134@N02,1570,16,1201321837,1201322557,5,22,720
23322134@N02,1570,27,1201325782,1201326982,3,22,1200
23322134@N02,1570,1,1201327308,1201327908,2,22,600
23322134@N02,1570,4,1201329520,1201329662,2,22,142
23322134@N02,1570,5,1201329662,1201330382,2,22,720
23322134@N02,1570,12,1201331282,1201332122,2,22,840
23322134@N02,1570,7,1201332765,1201332855,2,22,90
23322134@N02,1570,8,1201332885,1201333005,2,22,120
23322134@N02,1570,3,1201335091,1201335361,2,22,270
23322134@N02,1570,27,1201337678,1201338878,14,22,1200
23322134@N02,1570,21,1201342298,1201342748,3,22,450
23322134@N02,1570,19,1201343537,1201343957,3,22,420
23322134@N02,1571,27,1201688687,1201689887,1,1,1200
23322134@N02,1572,26,1201743599,1201743779,1,1,180
23322134@N02,1573,4,1202157377,1202158277,2,2,900
23322134@N02,1573,16,1202182936,1202183656,1,2,720
23322134@N02,1574,14,1202325909,1202326029,1,1,120
23322134@N02,1575,9,1202416018,1202416258,1,1,240
23322134@N02,1576,27,1202673144,1202674344,2,3,1200
23322134@N02,1576,14,1202675912,1202676032,2,3,120
23322134@N02,1576,27,1202676797,1202677997,1,3,1200
23322134@N02,1577,13,1202759405,1202760005,1,1,600
23322134@N02,1578,15,1203013872,1203014052,1,1,180
23322134@N02,1579,9,1209452387,1209452627,1,1,240
23322134@N02,1580,16,1213647598,1213648318,2,4,720
23322134@N02,1580,9,1213648479,1213648719,2,4,240
23322134@N02,1580,4,1213658550,1213658803,2,4,253
23322134@N02,1580,27,1213658803,1213660003,1,4,1200
23322134@N02,1581,27,1213691432,1213691883,2,7,451
23322134@N02,1581,17,1213691883,1213692017,2,7,134
23322134@N02,1581,26,1213692017,1213692197,2,7,180
23322134@N02,1581,20,1213693080,1213694160,2,7,1080
23322134@N02,1581,11,1213699198,1213699378,2,7,180
23322134@N02,1581,15,1213701085,1213701265,3,7,180
23322134@N02,1581,13,1213702249,1213702849,2,7,600
23322134@N02,1582,27,1213743423,1213743941,2,19,518
23322134@N02,1582,6,1213743941,1213744196,2,19,255
23322134@N02,1582,8,1213744324,1213744444,2,19,120
23322134@N02,1582,23,1213755087,1213755177,2,19,90
23322134@N02,1582,21,1213755872,1213756322,2,19,450
23322134@N02,1582,2,1213757345,1213757435,2,19,90
23322134@N02,1582,8,1213757533,1213757653,2,19,120
23322134@N02,1582,1,1213757979,1213758579,2,19,600
23322134@N02,1582,3,1213761027,1213761297,2,19,270
23322134@N02,1582,23,1213764743,1213764833,3,19,90
23322134@N02,1582,20,1213765712,1213766137,2,19,425
23322134@N02,1582,19,1213766137,1213766557,2,19,420
23322134@N02,1582,22,1213766830,1213767430,2,19,600
23322134@N02,1582,13,1213770169,1213770769,3,19,600
23322134@N02,1582,22,1213772051,1213772269,2,19,218
23322134@N02,1582,26,1213772269,1213772449,2,19,180
23322134@N02,1582,24,1213774005,1213774485,2,19,480
23322134@N02,1582,16,1213781546,1213782179,2,19,633
23322134@N02,1582,14,1213782179,1213782299,1,19,120
23322134@N02,1583,16,1226641758,1226642086,2,18,328
23322134@N02,1583,14,1226642086,1226642206,4,18,120
23322134@N02,1583,15,1226642627,1226642807,2,18,180
23322134@N02,1583,12,1226643537,1226644017,2,18,480
23322134@N02,1583,13,1226644017,1226644617,3,18,600
23322134@N02,1583,17,1226646304,1226647684,2,18,1380
23322134@N02,1583,22,1226647714,1226648314,2,18,600
23322134@N02,1583,5,1226649697,1226650341,2,18,644
23322134@N02,1583,2,1226650341,1226650431,2,18,90
23322134@N02,1583,1,1226650758,1226651358,2,18,600
23322134@N02,1583,27,1226655784,1226656984,2,18,1200
23322134@N02,1583,15,1226660607,1226660787,3,18,180
23322134@N02,1583,14,1226661030,1226661150,2,18,120
23322134@N02,1583,9,1226661782,1226662022,2,18,240
23322134@N02,1583,15,1226664718,1226664898,2,18,180
23322134@N02,1583,12,1226665608,1226666448,3,18,840
23322134@N02,1583,1,1226666878,1226667478,4,18,600
23322134@N02,1583,27,1226670181,1226671381,1,18,1200
23322134@N02,1584,27,1226714595,1226715795,2,3,1200
23322134@N02,1584,2,1226717938,1226718028,2,3,90
23322134@N02,1584,27,1226720296,1226721496,3,3,1200
23322134@N02,1585,16,1226804594,1226805314,3,6,720
23322134@N02,1585,18,1226805414,1226806317,2,6,903
23322134@N02,1585,20,1226806317,1226807397,5,6,1080
23322134@N02,1585,19,1226809083,1226809503,3,6,420
23322134@N02,1585,21,1226810942,1226811392,6,6,450
23322134@N02,1585,27,1226818440,1226819640,1,6,1200
23322134@N02,1586,19,1230027841,1230028261,2,4,420
23322134@N02,1586,14,1230031892,1230032012,2,4,120
23322134@N02,1586,20,1230036687,1230037434,2,4,747
23322134@N02,1586,19,1230037434,1230037854,1,4,420
23322134@N02,1587,12,1245026802,1245027642,3,8,840
23322134@N02,1587,21,1245035698,1245036148,2,8,450
23322134@N02,1587,5,1245043544,1245044264,2,8,720
23322134@N02,1587,14,1245056536,1245056656,2,8,120
23322134@N02,1587,13,1245059828,1245060428,3,8,600
23322134@N02,1587,14,1245065411,1245065531,2,8,120
23322134@N02,1587,13,1245071475,1245072075,2,8,600
23322134@N02,1587,9,1245073837,1245074077,1,8,240
23322134@N02,1588,27,1254461110,1254462310,3,8,1200
23322134@N02,1588,17,1254463828,1254464980,2,8,1152
23322134@N02,1588,13,1254464980,1254465580,2,8,600
23322134@N02,1588,21,1254468419,1254468869,2,8,450
23322134@N02,1588,6,1254470943,1254471198,2,8,255
23322134@N02,1588,27,1254472406,1254473606,7,8,1200
23322134@N02,1588,15,1254491131,1254491311,2,8,180
23322134@N02,1588,4,1254494360,1254495260,1,8,900
23322134@N02,1589,19,1254612972,1254613392,2,6,420
23322134@N02,1589,26,1254620103,1254620283,2,6,180
23322134@N02,1589,4,1254629318,1254630218,2,6,900
23322134@N02,1589,13,1254632553,1254633153,2,6,600
23322134@N02,1589,27,1254636746,1254637946,2,6,1200
23322134@N02,1589,13,1254649467,1254650067,1,6,600
23322134@N02,1590,18,1259882341,1259882615,2,2,274
23322134@N02,1590,13,1259882615,1259883215,1,2,600
23322134@N02,1591,27,1259919488,1259920688,1,1,1200
23322134@N02,1592,1,1265939340,1265939940,2,5,600
23322134@N02,1592,15,1265941150,1265941330,3,5,180
23322134@N02,1592,17,1265954349,1265954671,2,5,322
23322134@N02,1592,18,1265954671,1265956471,2,5,1800
23322134@N02,1592,26,1265965924,1265966104,1,5,180
23322134@N02,1593,27,1267650208,1267651308,3,10,1100
23322134@N02,1593,16,1267651308,1267652028,2,10,720
23322134@N02,1593,14,1267652779,1267652899,2,10,120
23322134@N02,1593,4,1267657873,1267658773,2,10,900
23322134@N02,1593,20,1267667365,1267668040,2,10,675
23322134@N02,1593,17,1267668040,1267669420,2,10,1380
23322134@N02,1593,27,1267674128,1267675328,2,10,1200
23322134@N02,1593,18,1267688737,1267690537,2,10,1800
23322134@N02,1593,4,1267695278,1267696178,2,10,900
23322134@N02,1593,27,1267697442,1267698642,2,10,1200
23322134@N02,1594,5,1273323889,1273324609,1,1,720
23322134@N02,1595,1,1273444274,1273444874,2,6,600
23322134@N02,1595,9,1273446735,1273446975,2,6,240
23322134@N02,1595,13,1273456271,1273456871,2,6,600
23322134@N02,1595,21,1273460007,1273460457,2,6,450
23322134@N02,1595,20,1273461522,1273462602,2,6,1080
23322134@N02,1595,3,1273464985,1273465255,1,6,270
23322134@N02,1596,9,1291443466,1291443706,2,4,240
23322134@N02,1596,27,1291458986,1291460186,2,4,1200
23322134@N02,1596,20,1291468020,1291469100,2,4,1080
23322134@N02,1596,4,1291472486,1291473386,1,4,900
23322134@N02,1597,5,1298098587,1298099307,1,1,720
23322134@N02,1598,9,1301435232,1301435472,2,7,240
23322134@N02,1598,13,1301439119,1301439719,2,7,600
23322134@N02,1598,20,1301441145,1301442225,2,7,1080
23322134@N02,1598,27,1301468206,1301469406,2,7,1200
23322134@N02,1598,21,1301469945,1301470395,2,7,450
23322134@N02,1598,3,1301480290,1301480560,2,7,270
23322134@N02,1598,2,1301481145,1301481235,1,7,90
23322134@N02,1599,22,1310138864,1310139464,2,3,600
23322134@N02,1599,17,1310141904,1310142937,2,3,1033
23322134@N02,1599,27,1310142937,1310144137,1,3,1200
23322134@N02,1600,27,1310245114,1310246314,2,2,1200
23322134@N02,1600,9,1310250862,1310251102,1,2,240
23322134@N02,1601,4,1331334016,1331334916,1,1,900
23322134@N02,1602,22,1331375810,1331376410,1,1,600
23337755@N02,1603,27,1469960429,1469961629,1,1,1200
23380822@N05,1604,27,1385086131,1385087331,50,1,1200
23380822@N05,1605,10,1385262945,1385263365,2,2,420
23380822@N05,1605,2,1385274851,1385274941,13,2,90
23385510@N00,1606,27,1220506244,1220507444,1,1,1200
23385510@N00,1607,9,1220576284,1220576524,21,7,240
23385510@N00,1607,14,1220581559,1220581679,5,7,120
23385510@N00,1607,20,1220591762,1220592842,4,7,1080
23385510@N00,1607,23,1220594851,1220594858,2,7,7
23385510@N00,1607,24,1220594858,1220595323,2,7,465
23385510@N00,1607,23,1220595323,1220595413,3,7,90
23385510@N00,1607,27,1220597467,1220598667,3,7,1200
23385595@N07,1608,27,1189826388,1189827588,1,1,1200
23385595@N07,1609,27,1205988552,1205989752,5,1,1200
23386094@N02,1610,12,1224544014,1224544854,1,1,840
23386796@N00,1611,27,1373179020,1373180220,1,1,1200
23400894@N08,1612,27,1419350468,1419351668,1,1,1200
23416852@N00,1613,16,1349422561,1349423281,1,1,720
23441093@N02,1614,16,1291295496,1291296216,1,1,720
23492103@N03,1615,4,1223260060,1223260390,2,2,330
23492103@N03,1615,19,1223260390,1223260810,1,2,420
23506877@N07,1616,17,1269139017,1269140397,1,1,1380
23531496@N02,1617,10,1407578670,1407579090,1,1,420
23539088@N07,1618,27,1399285965,1399287165,1,1,1200
23539088@N07,1619,27,1399337457,1399338657,22,1,1200
23539088@N07,1620,27,1399431254,1399432454,3,1,1200
23539088@N07,1621,27,1399503742,1399504942,81,1,1200
23566994@N06,1622,4,1233275355,1233276255,4,1,900
23567711@N06,1623,19,1363149171,1363149591,2,2,420
23567711@N06,1623,10,1363157732,1363158152,1,2,420
23573205@N05,1624,27,1278812955,1278814155,4,12,1200
23573205@N05,1624,4,1278815303,1278816203,2,12,900
23573205@N05,1624,1,1278819863,1278820463,2,12,600
23573205@N05,1624,2,1278822586,1278822676,2,12,90
23573205@N05,1624,4,1278822897,1278823797,2,12,900
23573205@N05,1624,1,1278824064,1278824664,5,12,600
23573205@N05,1624,16,1278826151,1278826251,2,12,100
23573205@N05,1624,14,1278826251,1278826371,2,12,120
23573205@N05,1624,12,1278826976,1278827816,2,12,840
23573205@N05,1624,15,1278828049,1278828229,3,12,180
23573205@N05,1624,26,1278831022,1278831202,4,12,180
23573205@N05,1624,16,1278831876,1278832596,2,12,720
23574966@N04,1625,12,1269366699,1269367539,1,1,840
23594107@N04,1626,22,1289730102,1289730702,6,1,600
23612601@N07,1627,19,1435207497,1435207917,1,1,420
23673310@N02,1628,27,1199935431,1199936631,26,1,1200
23673310@N02,1629,27,1200082927,1200083023,2,6,96
23673310@N02,1629,4,1200083023,1200083230,2,6,207
23673310@N02,1629,9,1200083230,1200083373,3,6,143
23673310@N02,1629,16,1200083373,1200083572,3,6,199
23673310@N02,1629,26,1200083572,1200083752,2,6,180
23673310@N02,1629,4,1200107581,1200108481,2,6,900
23673310@N02,1630,5,1200172520,1200172842,2,2,322
23673310@N02,1630,26,1200172842,1200173022,2,2,180
23673310@N02,1631,27,1200606903,1200608103,6,12,1200
23673310@N02,1631,9,1200611524,1200611764,4,12,240
23673310@N02,1631,15,1200611949,1200612129,5,12,180
23673310@N02,1631,12,1200613654,1200614494,20,12,840
23673310@N02,1631,13,1200614677,1200615277,6,12,600
23673310@N02,1631,21,1200617627,1200618077,5,12,450
23673310@N02,1631,19,1200619134,1200619554,2,12,420
23673310@N02,1631,21,1200621112,1200621562,6,12,450
23673310@N02,1631,18,1200621637,1200623437,2,12,1800
23673310@N02,1631,6,1200624033,1200624288,2,12,255
23673310@N02,1631,4,1200625508,1200626408,6,12,900
23673310@N02,1631,18,1200630764,1200632564,17,12,1800
23673310@N02,1632,27,1200723842,1200725042,2,5,1200
23673310@N02,1632,11,1200726335,1200726515,9,5,180
23673310@N02,1632,17,1200729060,1200730440,4,5,1380
23673310@N02,1632,21,1200732470,1200732920,9,5,450
23673310@N02,1632,24,1200733536,1200734016,2,5,480
23673310@N02,1633,16,1202113140,1202113386,3,3,246
23673310@N02,1633,2,1202113386,1202113437,2,3,51
23673310@N02,1633,16,1202113437,1202114157,1,3,720
23673310@N02,1634,16,1202677451,1202678171,1,1,720
23673310@N02,1635,9,1204375896,1204376136,8,2,240
23673310@N02,1635,11,1204376189,1204376369,18,2,180
23673310@N02,1636,11,1209286516,1209286545,5,2,29
23673310@N02,1636,3,1209286545,1209286815,1,2,270
23673310@N02,1637,25,1213352730,1213353480,6,8,750
23673310@N02,1637,24,1213354338,1213354818,6,8,480
23673310@N02,1637,20,1213357449,1213358529,10,8,1080
23673310@N02,1637,17,1213362717,1213364097,33,8,1380
23673310@N02,1637,12,1213364629,1213365377,5,8,748
23673310@N02,1637,14,1213365377,1213365497,3,8,120
23673310@N02,1637,9,1213369366,1213369606,2,8,240
23673310@N02,1637,17,1213369826,1213371206,1,8,1380
23673310@N02,1638,1,1213656587,1213656977,2,2,390
23673310@N02,1638,27,1213656977,1213658177,6,2,1200
23673310@N02,1639,9,1292108958,1292109198,6,5,240
23673310@N02,1639,12,1292112946,1292113786,8,5,840
23673310@N02,1639,15,1292118773,1292118953,3,5,180
23673310@N02,1639,21,1292121755,1292122205,3,5,450
23673310@N02,1639,17,1292125860,1292127240,21,5,1380
23673310@N02,1640,27,1292818419,1292819619,44,3,1200
23673310@N02,1640,16,1292839772,1292840492,77,3,720
23673310@N02,1640,24,1292848404,1292848884,1,3,480
23673310@N02,1641,20,1304146949,1304148029,6,3,1080
23673310@N02,1641,13,1304148829,1304149429,11,3,600
23673310@N02,1641,10,1304150096,1304150516,3,3,420
23673310@N02,1642,20,1339507434,1339508514,20,1,1080
23673310@N02,1643,9,1339720784,1339721024,4,6,240
23673310@N02,1643,11,1339721216,1339721396,2,6,180
23673310@N02,1643,9,1339722105,1339722345,3,6,240
23673310@N02,1643,6,1339722394,1339722649,2,6,255
23673310@N02,1643,26,1339726201,1339726381,2,6,180
23673310@N02,1643,23,1339726428,1339726518,1,6,90
23673310@N02,1644,27,1414661922,1414663122,3,5,1200
23673310@N02,1644,9,1414667048,1414667288,4,5,240
23673310@N02,1644,17,1414667845,1414669225,41,5,1380
23673310@N02,1644,14,1414670974,1414671094,2,5,120
23673310@N02,1644,27,1414672714,1414673914,6,5,1200
23673310@N02,1645,27,1415569436,1415570636,6,2,1200
23673310@N02,1645,10,1415571436,1415571856,2,2,420
23673310@N02,1646,27,1415604816,1415606016,3,3,1200
23673310@N02,1646,16,1415608144,1415608864,110,3,720
23673310@N02,1646,1,1415617886,1415618486,3,3,600
23673310@N02,1647,27,1415924972,1415926172,2,1,1200
23684642@N08,1648,6,1232683841,1232684096,1,1,255
23684642@N08,1649,6,1241738500,1241738755,3,1,255
23684642@N08,1650,5,1252979036,1252979756,4,6,720
23684642@N08,1650,25,1252980254,1252981004,2,6,750
23684642@N08,1650,5,1252981140,1252981860,5,6,720
23684642@N08,1650,24,1252987117,1252987597,2,6,480
23684642@N08,1650,18,1252988735,1252990535,4,6,1800
23684642@N08,1650,14,1252990742,1252990862,3,6,120
23684642@N08,1651,5,1254030211,1254030931,2,2,720
23684642@N08,1651,16,1254039597,1254040317,1,2,720
23684642@N08,1652,18,1254186106,1254187906,2,5,1800
23684642@N08,1652,23,1254196862,1254196952,2,5,90
23684642@N08,1652,26,1254197221,1254197401,2,5,180
23684642@N08,1652,27,1254199517,1254200717,2,5,1200
23684642@N08,1652,24,1254207414,1254207894,1,5,480
23684642@N08,1653,2,1259804153,1259804243,1,1,90
23684642@N08,1654,9,1260749233,1260749473,2,6,240
23684642@N08,1654,14,1260749603,1260749723,2,6,120
23684642@N08,1654,27,1260763771,1260764971,2,6,1200
23684642@N08,1654,17,1260770993,1260772373,2,6,1380
23684642@N08,1654,9,1260785665,1260785905,2,6,240
23684642@N08,1654,14,1260798306,1260798426,1,6,120
23684642@N08,1655,18,1261188522,1261190322,2,7,1800
23684642@N08,1655,8,1261193091,1261193110,2,7,19
23684642@N08,1655,11,1261193110,1261193290,2,7,180
23684642@N08,1655,8,1261193322,1261193416,2,7,94
23684642@N08,1655,11,1261193416,1261193503,2,7,87
23684642@N08,1655,8,1261193503,1261193623,6,7,120
23684642@N08,1655,6,1261196438,1261196693,1,7,255
23684642@N08,1656,4,1264550644,1264551544,2,7,900
23684642@N08,1656,2,1264551916,1264552006,2,7,90
23684642@N08,1656,13,1264557516,1264558116,2,7,600
23684642@N08,1656,18,1264562563,1264564363,2,7,1800
23684642@N08,1656,24,1264566767,1264567247,2,7,480
23684642@N08,1656,17,1264569732,1264571112,2,7,1380
23684642@N08,1656,25,1264577090,1264577840,1,7,750
23684642@N08,1657,2,1271901990,1271902080,3,2,90
23684642@N08,1657,14,1271910960,1271911080,2,2,120
23684642@N08,1658,26,1275281404,1275281584,2,5,180
23684642@N08,1658,9,1275282880,1275283120,3,5,240
23684642@N08,1658,14,1275286567,1275286687,2,5,120
23684642@N08,1658,2,1275295573,1275295663,2,5,90
23684642@N08,1658,9,1275298488,1275298728,1,5,240
23684642@N08,1659,17,1275382861,1275384241,3,2,1380
23684642@N08,1659,16,1275388548,1275389268,2,2,720
23684642@N08,1660,14,1285131497,1285131617,2,7,120
23684642@N08,1660,9,1285145247,1285145487,2,7,240
23684642@N08,1660,14,1285146915,1285147026,3,7,111
23684642@N08,1660,2,1285147026,1285147116,2,7,90
23684642@N08,1660,4,1285147263,1285148163,2,7,900
23684642@N08,1660,17,1285148499,1285149503,2,7,1004
23684642@N08,1660,9,1285149503,1285149743,2,7,240
23684642@N08,1661,9,1287981287,1287981527,2,1,240
23693999@N05,1662,1,1224925899,1224926499,1,1,600
23693999@N05,1663,2,1243292832,1243292884,2,2,52
23693999@N05,1663,3,1243292884,1243293154,1,2,270
23693999@N05,1664,27,1346066327,1346067527,1,1,1200
23693999@N05,1665,20,1346291549,1346292629,2,7,1080
23693999@N05,1665,19,1346293155,1346293575,3,7,420
23693999@N05,1665,16,1346297080,1346297800,6,7,720
23693999@N05,1665,4,1346298929,1346299829,2,7,900
23693999@N05,1665,5,1346300170,1346300890,2,7,720
23693999@N05,1665,9,1346301885,1346302125,3,7,240
23693999@N05,1665,16,1346302261,1346302981,1,7,720
23693999@N05,1666,12,1346463800,1346464640,2,3,840
23693999@N05,1666,13,1346466751,1346467351,3,3,600
23693999@N05,1666,6,1346487289,1346487544,1,3,255
23693999@N05,1667,1,1346662040,1346662137,3,2,97
23693999@N05,1667,20,1346662137,1346663217,1,2,1080
23693999@N05,1668,3,1346910118,1346910388,1,1,270
23716112@N06,1669,27,1408263879,1408265079,1,1,1200
23716112@N06,1670,14,1408299655,1408299775,1,1,120
23716112@N06,1671,10,1408587884,1408588304,2,1,420
23716112@N06,1672,26,1408708384,1408708564,1,1,180
23720661@N08,1673,27,1215305685,1215306885,1,1,1200
23720661@N08,1674,19,1244356468,1244356888,1,1,420
23720661@N08,1675,27,1244507326,1244507345,2,5,19
23720661@N08,1675,16,1244507345,1244508065,2,5,720
23720661@N08,1675,20,1244508256,1244509336,2,5,1080
23720661@N08,1675,8,1244522179,1244522299,2,5,120
23720661@N08,1675,27,1244523209,1244524409,1,5,1200
23720661@N08,1676,19,1244763501,1244763921,6,11,420
23720661@N08,1676,18,1244765941,1244766337,2,11,396
23720661@N08,1676,13,1244766337,1244766937,4,11,600
23720661@N08,1676,15,1244769197,1244769377,2,11,180
23720661@N08,1676,3,1244772097,1244772367,2,11,270
23720661@N08,1676,19,1244774324,1244774390,2,11,66
23720661@N08,1676,20,1244774390,1244774674,2,11,284
23720661@N08,1676,19,1244774674,1244774838,2,11,164
23720661@N08,1676,20,1244774838,1244775918,2,11,1080
23720661@N08,1676,21,1244777078,1244777528,2,11,450
23720661@N08,1676,15,1244786791,1244786971,1,11,180
23720661@N08,1677,16,1245199177,1245199205,2,6,28
23720661@N08,1677,27,1245199205,1245200405,2,6,1200
23720661@N08,1677,21,1245202558,1245203008,3,6,450
23720661@N08,1677,19,1245203809,1245204229,2,6,420
23720661@N08,1677,17,1245205395,1245205664,2,6,269
23720661@N08,1677,16,1245205664,1245206384,2,6,720
23720661@N08,1678,27,1262486068,1262487110,2,7,1042
23720661@N08,1678,23,1262487110,1262487200,2,7,90
23720661@N08,1678,21,1262489291,1262489741,2,7,450
23720661@N08,1678,26,1262491698,1262491878,2,7,180
23720661@N08,1678,2,1262496819,1262496909,2,7,90
23720661@N08,1678,27,1262497450,1262498650,4,7,1200
23720661@N08,1678,16,1262510607,1262511327,2,7,720
23720661@N08,1679,27,1262653558,1262653982,2,5,424
23720661@N08,1679,20,1262653982,1262654191,2,5,209
23720661@N08,1679,19,1262654191,1262654611,3,5,420
23720661@N08,1679,3,1262657319,1262657589,3,5,270
23720661@N08,1679,13,1262661973,1262662573,1,5,600
23720661@N08,1680,2,1262850212,1262850302,2,4,90
23720661@N08,1680,14,1262852412,1262852532,2,4,120
23720661@N08,1680,5,1262853110,1262853830,2,4,720
23720661@N08,1680,26,1262854947,1262855127,1,4,180
23720661@N08,1681,16,1262911471,1262912191,2,3,720
23720661@N08,1681,15,1262913831,1262914011,2,3,180
23720661@N08,1681,13,1262915874,1262916474,1,3,600
23720661@N08,1682,2,1263005640,1263005667,2,4,27
23720661@N08,1682,1,1263005667,1263006267,2,4,600
23720661@N08,1682,21,1263011357,1263011807,3,4,450
23720661@N08,1682,27,1263013894,1263015094,1,4,1200
23720661@N08,1683,20,1275185619,1275186699,2,6,1080
23720661@N08,1683,21,1275189559,1275190009,3,6,450
23720661@N08,1683,20,1275191221,1275192301,3,6,1080
23720661@N08,1683,24,1275193120,1275193600,3,6,480
23720661@N08,1683,13,1275197024,1275197624,2,6,600
23720661@N08,1683,27,1275200233,1275201433,1,6,1200
23720661@N08,1684,27,1275461979,1275462635,6,7,656
23720661@N08,1684,16,1275462635,1275463355,2,7,720
23720661@N08,1684,13,1275469587,1275470064,2,7,477
23720661@N08,1684,18,1275470064,1275470889,3,7,825
23720661@N08,1684,22,1275470889,1275471489,2,7,600
23720661@N08,1684,21,1275471606,1275472056,2,7,450
23720661@N08,1684,14,1275474266,1275474386,1,7,120
23720661@N08,1685,27,1275617745,1275618945,2,5,1200
23720661@N08,1685,21,1275620479,1275620929,2,5,450
23720661@N08,1685,26,1275621278,1275621391,2,5,113
23720661@N08,1685,20,1275621391,1275622457,2,5,1066
23720661@N08,1685,18,1275622457,1275624257,1,5,1800
23720661@N08,1686,27,1275798126,1275799326,2,5,1200
23720661@N08,1686,2,1275801380,1275801470,3,5,90
23720661@N08,1686,26,1275809792,1275809945,2,5,153
23720661@N08,1686,17,1275809945,1275810100,2,5,155
23720661@N08,1686,22,1275810100,1275810700,1,5,600
23720661@N08,1687,18,1301969608,1301971408,1,1,1800
23720661@N08,1688,27,1307064779,1307065979,4,11,1200
23720661@N08,1688,21,1307067428,1307067878,2,11,450
23720661@N08,1688,24,1307068014,1307068494,6,11,480
23720661@N08,1688,13,1307072185,1307072785,2,11,600
23720661@N08,1688,17,1307074384,1307074453,2,11,69
23720661@N08,1688,26,1307074453,1307074633,2,11,180
23720661@N08,1688,18,1307075078,1307076878,3,11,1800
23720661@N08,1688,21,1307079373,1307079823,2,11,450
23720661@N08,1688,18,1307083476,1307084481,2,11,1005
23720661@N08,1688,3,1307084481,1307084751,3,11,270
23720661@N08,1688,4,1307086308,1307087208,2,11,900
23720661@N08,1689,16,1307235464,1307236184,5,8,720
23720661@N08,1689,13,1307238132,1307238732,4,8,600
23720661@N08,1689,26,1307240274,1307240351,2,8,77
23720661@N08,1689,17,1307240351,1307241466,2,8,1115
23720661@N08,1689,19,1307241466,1307241886,2,8,420
23720661@N08,1689,13,1307242072,1307242672,2,8,600
23720661@N08,1689,18,1307242917,1307244717,2,8,1800
23720661@N08,1689,16,1307247635,1307248355,1,8,720
23720661@N08,1690,19,1307430545,1307430965,2,3,420
23720661@N08,1690,25,1307434420,1307435170,3,3,750
23720661@N08,1690,16,1307436206,1307436926,1,3,720
23720661@N08,1691,27,1307496681,1307497881,3,9,1200
23720661@N08,1691,22,1307498152,1307498752,2,9,600
23720661@N08,1691,13,1307501007,1307501607,2,9,600
23720661@N08,1691,14,1307503786,1307503906,2,9,120
23720661@N08,1691,2,1307507358,1307507448,2,9,90
23720661@N08,1691,16,1307507627,1307507703,2,9,76
23720661@N08,1691,4,1307507703,1307507776,2,9,73
23720661@N08,1691,16,1307507776,1307508496,2,9,720
23720661@N08,1691,27,1307514114,1307515314,1,9,1200
23720661@N08,1692,27,1330993976,1330994310,2,13,334
23720661@N08,1692,20,1330994310,1330995390,4,13,1080
23720661@N08,1692,21,1330997029,1330997479,2,13,450
23720661@N08,1692,22,1331001555,1331002155,3,13,600
23720661@N08,1692,21,1331008123,1331008573,3,13,450
23720661@N08,1692,25,1331008622,1331009372,2,13,750
23720661@N08,1692,4,1331009540,1331010440,2,13,900
23720661@N08,1692,3,1331011139,1331011409,4,13,270
23720661@N08,1692,4,1331013493,1331013736,2,13,243
23720661@N08,1692,16,1331013736,1331014456,2,13,720
23720661@N08,1692,24,1331014478,1331014958,3,13,480
23720661@N08,1692,16,1331015965,1331016277,3,13,312
23720661@N08,1692,27,1331016277,1331017477,2,13,1200
23720661@N08,1693,27,1331248959,1331249765,3,25,806
23720661@N08,1693,22,1331249765,1331250114,2,25,349
23720661@N08,1693,13,1331250114,1331250199,2,25,85
23720661@N08,1693,18,1331250199,1331250499,2,25,300
23720661@N08,1693,13,1331250499,1331251099,7,25,600
23720661@N08,1693,26,1331253714,1331253795,2,25,81
23720661@N08,1693,18,1331253795,1331254099,4,25,304
23720661@N08,1693,22,1331254099,1331254112,2,25,13
23720661@N08,1693,17,1331254112,1331254117,2,25,5
23720661@N08,1693,18,1331254117,1331255917,3,25,1800
23720661@N08,1693,16,1331257608,1331257710,3,25,102
23720661@N08,1693,17,1331257710,1331258143,4,25,433
23720661@N08,1693,2,1331258143,1331258233,4,25,90
23720661@N08,1693,6,1331259238,1331259300,2,25,62
23720661@N08,1693,1,1331259300,1331259900,3,25,600
23720661@N08,1693,3,1331260324,1331260594,2,25,270
23720661@N08,1693,4,1331262569,1331263469,2,25,900
23720661@N08,1693,1,1331263483,1331264083,2,25,600
23720661@N08,1693,27,1331280898,1331282063,2,25,1165
23720661@N08,1693,16,1331282063,1331282083,2,25,20
23720661@N08,1693,4,1331282083,1331282983,2,25,900
23720661@N08,1693,2,1331284565,1331284655,5,25,90
23720661@N08,1693,5,1331285333,1331285608,2,25,275
23720661@N08,1693,4,1331285608,1331286447,3,25,839
23720661@N08,1693,27,1331286447,1331287647,1,25,1200
23720661@N08,1694,27,1331430023,1331431223,2,6,1200
23720661@N08,1694,18,1331433393,1331434863,3,6,1470
23720661@N08,1694,21,1331434863,1331435313,7,6,450
23720661@N08,1694,13,1331437284,1331437884,2,6,600
23720661@N08,1694,15,1331437911,1331438091,2,6,180
23720661@N08,1694,17,1331438382,1331439762,1,6,1380
23720661@N08,1695,27,1369446027,1369447227,4,11,1200
23720661@N08,1695,21,1369447338,1369447788,2,11,450
23720661@N08,1695,19,1369447843,1369448263,5,11,420
23720661@N08,1695,11,1369448270,1369448450,2,11,180
23720661@N08,1695,27,1369448988,1369449985,2,11,997
23720661@N08,1695,13,1369449985,1369450585,3,11,600
23720661@N08,1695,18,1369453964,1369454892,2,11,928
23720661@N08,1695,19,1369454892,1369455312,8,11,420
23720661@N08,1695,18,1369456421,1369457837,2,11,1416
23720661@N08,1695,16,1369457837,1369457843,2,11,6
23720661@N08,1695,14,1369457843,1369457963,1,11,120
23720661@N08,1696,27,1369534894,1369535226,2,10,332
23720661@N08,1696,16,1369535226,1369535737,2,10,511
23720661@N08,1696,26,1369535737,1369535917,2,10,180
23720661@N08,1696,17,1369541400,1369542780,2,10,1380
23720661@N08,1696,3,1369543759,1369544029,2,10,270
23720661@N08,1696,4,1369549967,1369550500,2,10,533
23720661@N08,1696,13,1369550500,1369550862,2,10,362
23720661@N08,1696,18,1369550862,1369551409,2,10,547
23720661@N08,1696,13,1369551409,1369552009,2,10,600
23720661@N08,1696,21,1369556435,1369556885,1,10,450
23720661@N08,1697,27,1369711560,1369712760,1,1,1200
23720661@N08,1698,21,1369963585,1369964035,7,7,450
23720661@N08,1698,18,1369965539,1369965569,2,7,30
23720661@N08,1698,17,1369965569,1369965688,2,7,119
23720661@N08,1698,26,1369965688,1369965868,4,7,180
23720661@N08,1698,15,1369968321,1369968501,2,7,180
23720661@N08,1698,9,1369968557,1369968797,2,7,240
23720661@N08,1698,5,1369972790,1369973510,1,7,720
23727506@N07,1699,17,1241078652,1241080032,1,1,1380
23727506@N07,1700,26,1323942095,1323942275,2,1,180
23809141@N05,1701,16,1277521498,1277522218,1,1,720
23809141@N05,1702,16,1277637982,1277638702,1,1,720
23813932@N07,1703,27,1342774249,1342775449,1,1,1200
23828731@N02,1704,27,1226445719,1226446919,2,12,1200
23828731@N02,1704,20,1226452386,1226453466,3,12,1080
23828731@N02,1704,14,1226454626,1226454633,2,12,7
23828731@N02,1704,12,1226454633,1226455473,4,12,840
23828731@N02,1704,14,1226457830,1226457950,5,12,120
23828731@N02,1704,8,1226468046,1226468166,3,12,120
23828731@N02,1704,6,1226468964,1226469219,4,12,255
23828731@N02,1704,2,1226470122,1226470212,3,12,90
23828731@N02,1704,1,1226471854,1226472444,6,12,590
23828731@N02,1704,3,1226472444,1226472714,9,12,270
23828731@N02,1704,5,1226473914,1226474634,3,12,720
23828731@N02,1704,4,1226476268,1226477168,3,12,900
23828731@N02,1705,16,1340600286,1340601006,3,7,720
23828731@N02,1705,1,1340605664,1340605895,7,7,231
23828731@N02,1705,5,1340605895,1340605956,3,7,61
23828731@N02,1705,4,1340605956,1340606617,2,7,661
23828731@N02,1705,23,1340606617,1340606707,2,7,90
23828731@N02,1705,22,1340606983,1340607153,2,7,170
23828731@N02,1705,17,1340607153,1340608533,3,7,1380
23828731@N02,1706,27,1341305674,1341306768,2,8,1094
23828731@N02,1706,26,1341306768,1341306776,2,8,8
23828731@N02,1706,17,1341306776,1341306799,2,8,23
23828731@N02,1706,26,1341306799,1341306979,2,8,180
23828731@N02,1706,17,1341307845,1341309225,4,8,1380
23828731@N02,1706,15,1341311908,1341311952,2,8,44
23828731@N02,1706,14,1341311952,1341312072,3,8,120
23828731@N02,1706,9,1341312159,1341312399,4,8,240
23828731@N02,1707,27,1344841055,1344842255,1,1,1200
23828731@N02,1708,27,1347266939,1347268139,1,1,1200
23828731@N02,1709,10,1350527182,1350527602,117,1,420
23828731@N02,1710,27,1353225514,1353226203,2,4,689
23828731@N02,1710,1,1353226203,1353226803,2,4,600
23828731@N02,1710,10,1353227763,1353228183,2,4,420
23828731@N02,1710,22,1353229432,1353230032,1,4,600
23828731@N02,1711,1,1363508548,1363509148,1,1,600
23828731@N02,1712,27,1366267749,1366268949,3,3,1200
23828731@N02,1712,1,1366270854,1366271454,2,3,600
23828731@N02,1712,16,1366273030,1366273750,4,3,720
23828731@N02,1713,27,1367464398,1367465598,4,1,1200
23833168@N04,1714,27,1222656401,1222657402,3,9,1001
23833168@N04,1714,6,1222657402,1222657657,3,9,255
23833168@N04,1714,23,1222658449,1222658530,2,9,81
23833168@N04,1714,21,1222658530,1222658980,2,9,450
23833168@N04,1714,20,1222659436,1222659486,2,9,50
23833168@N04,1714,19,1222659486,1222659906,11,9,420
23833168@N04,1714,22,1222660387,1222660690,2,9,303
23833168@N04,1714,13,1222660690,1222661290,5,9,600
23833168@N04,1714,9,1222665086,1222665326,5,9,240
23833168@N04,1715,23,1354605855,1354605945,2,11,90
23833168@N04,1715,22,1354606284,1354606850,2,11,566
23833168@N04,1715,27,1354606850,1354607279,3,11,429
23833168@N04,1715,14,1354607279,1354607399,4,11,120
23833168@N04,1715,27,1354607864,1354608198,2,11,334
23833168@N04,1715,14,1354608198,1354608318,2,11,120
23833168@N04,1715,4,1354608358,1354608948,2,11,590
23833168@N04,1715,7,1354608948,1354609038,4,11,90
23833168@N04,1715,8,1354609222,1354609342,8,11,120
23833168@N04,1715,7,1354610160,1354610250,5,11,90
23833168@N04,1715,5,1354613652,1354614372,5,11,720
23833168@N04,1716,27,1354857065,1354858265,2,4,1200
23833168@N04,1716,3,1354859494,1354859764,15,4,270
23833168@N04,1716,11,1354861244,1354861250,2,4,6
23833168@N04,1716,8,1354861250,1354861370,36,4,120
23833168@N04,1717,9,1355283130,1355283370,2,10,240
23833168@N04,1717,25,1355291641,1355292391,6,10,750
23833168@N04,1717,17,1355293375,1355293494,4,10,119
23833168@N04,1717,8,1355293494,1355293509,4,10,15
23833168@N04,1717,7,1355293509,1355293599,4,10,90
23833168@N04,1717,9,1355294873,1355295113,16,10,240
23833168@N04,1717,27,1355299265,1355300465,48,10,1200
23833168@N04,1717,9,1355301800,1355302040,6,10,240
23833168@N04,1717,14,1355305350,1355305470,3,10,120
23833168@N04,1717,21,1355308189,1355308639,4,10,450
23833168@N04,1718,7,1355463322,1355463412,3,4,90
23833168@N04,1718,14,1355467438,1355467558,7,4,120
23833168@N04,1718,6,1355470746,1355470760,3,4,14
23833168@N04,1718,1,1355470760,1355471360,6,4,600
23870387@N06,1719,9,1294068445,1294068685,1,1,240
23942903@N00,1720,27,1326573195,1326574395,3,6,1200
23942903@N00,1720,15,1326586399,1326586579,2,6,180
23942903@N00,1720,5,1326596929,1326596995,2,6,66
23942903@N00,1720,6,1326596995,1326597250,3,6,255
23942903@N00,1720,9,1326598413,1326598653,3,6,240
23942903@N00,1720,4,1326600175,1326601075,1,6,900
23942903@N00,1721,27,1326832660,1326833860,1,1,1200
23942903@N00,1722,14,1326928963,1326929083,3,6,120
23942903@N00,1722,22,1326938674,1326939274,5,6,600
23942903@N00,1722,18,1326941060,1326942860,2,6,1800
23942903@N00,1722,27,1326946404,1326947604,7,6,1200
23942903@N00,1722,16,1326954123,1326954843,3,6,720
23942903@N00,1722,25,1326954873,1326955623,1,6,750
23953488@N03,1723,27,1226873900,1226875100,1,1,1200
23966768@N03,1724,14,1369030640,1369030760,1,1,120
23966768@N03,1725,14,1403403546,1403403666,3,4,120
23966768@N03,1725,12,1403424606,1403425446,2,4,840
23966768@N03,1725,14,1403427758,1403427878,3,4,120
23966768@N03,1725,26,1403435728,1403435908,4,4,180
23980087@N02,1726,27,1356385223,1356386423,1,1,1200
24004706@N00,1727,27,1208269058,1208269971,2,7,913
24004706@N00,1727,25,1208269971,1208270376,2,7,405
24004706@N00,1727,23,1208270376,1208270466,5,7,90
24004706@N00,1727,18,1208273196,1208273639,3,7,443
24004706@N00,1727,19,1208273639,1208274059,3,7,420
24004706@N00,1727,18,1208274412,1208276212,2,7,1800
24004706@N00,1727,14,1208280892,1208281012,1,7,120
24021297@N00,1728,16,1338605007,1338605727,1,1,720
24021297@N00,1729,3,1338813942,1338814212,1,1,270
24021297@N00,1730,27,1343395761,1343396961,3,3,1200
24021297@N00,1730,19,1343400588,1343401008,2,3,420
24021297@N00,1730,1,1343401805,1343402405,1,3,600
24021297@N00,1731,27,1350371115,1350372315,3,1,1200
24021297@N00,1732,17,1355564273,1355565653,2,2,1380
24021297@N00,1732,27,1355570267,1355571467,1,2,1200
24021297@N00,1733,14,1371262485,1371262605,1,1,120
24042252@N05,1734,27,1304221577,1304222777,3,3,1200
24042252@N05,1734,4,1304222861,1304223761,8,3,900
24042252@N05,1734,14,1304233388,1304233508,7,3,120
24048284@N02,1735,27,1204243785,1204244985,2,8,1200
24048284@N02,1735,4,1204256503,1204256593,2,8,90
24048284@N02,1735,2,1204256593,1204256683,2,8,90
24048284@N02,1735,3,1204258396,1204258666,3,8,270
24048284@N02,1735,1,1204263767,1204263947,5,8,180
24048284@N02,1735,25,1204263947,1204264036,2,8,89
24048284@N02,1735,22,1204264036,1204264095,2,8,59
24048284@N02,1735,27,1204264095,1204265295,1,8,1200
24083444@N03,1736,20,1192233664,1192234744,1,1,1080
24083444@N03,1737,14,1309297607,1309297727,1,1,120
24107582@N06,1738,2,1233485023,1233485113,1,1,90
24113932@N04,1739,2,1390029639,1390029729,6,7,90
24113932@N04,1739,9,1390032941,1390033181,2,7,240
24113932@N04,1739,8,1390033523,1390033643,2,7,120
24113932@N04,1739,16,1390035031,1390035751,2,7,720
24113932@N04,1739,13,1390040377,1390040977,2,7,600
24113932@N04,1739,16,1390041376,1390041622,2,7,246
24113932@N04,1739,27,1390041622,1390042822,3,7,1200
24143798@N08,1740,27,1199608776,1199609042,4,4,266
24143798@N08,1740,16,1199609042,1199609762,2,4,720
24143798@N08,1740,9,1199612635,1199612875,2,4,240
24143798@N08,1740,16,1199616326,1199617046,8,4,720
24143798@N08,1741,9,1418462619,1418462859,1,1,240
24152284@N06,1742,21,1211210724,1211211174,2,3,450
24152284@N06,1742,9,1211220193,1211220433,2,3,240
24152284@N06,1742,11,1211225405,1211225585,2,3,180
24153575@N00,1743,20,1239959963,1239961043,1,1,1080
24153575@N00,1744,13,1240392788,1240393388,1,1,600
24153575@N00,1745,13,1257325935,1257326535,1,1,600
24153575@N00,1746,16,1302394268,1302394988,1,1,720
24153575@N00,1747,18,1408159435,1408161235,1,1,1800
24230954@N06,1748,27,1265844967,1265846167,1,1,1200
24232695@N00,1749,12,1325204265,1325205105,1,1,840
24232695@N00,1750,17,1325243401,1325244781,2,5,1380
24232695@N00,1750,5,1325245713,1325246433,17,5,720
24232695@N00,1750,9,1325249743,1325249983,6,5,240
24232695@N00,1750,4,1325251626,1325251910,3,5,284
24232695@N00,1750,5,1325251910,1325252630,1,5,720
24232695@N00,1751,5,1325568698,1325569418,2,1,720
24254019@N08,1752,16,1217592196,1217592916,5,1,720
24276365@N03,1753,3,1388356920,1388357190,2,5,270
24276365@N03,1753,5,1388360772,1388361492,2,5,720
24276365@N03,1753,16,1388363106,1388363826,2,5,720
24276365@N03,1753,15,1388368880,1388369060,2,5,180
24276365@N03,1753,11,1388373385,1388373565,1,5,180
24306356@N00,1754,27,1386019945,1386021145,2,6,1200
24306356@N00,1754,3,1386031194,1386031464,2,6,270
24306356@N00,1754,26,1386036020,1386036200,2,6,180
24306356@N00,1754,23,1386037153,1386037243,2,6,90
24306356@N00,1754,20,1386040458,1386041538,2,6,1080
24306356@N00,1754,16,1386043383,1386044103,1,6,720
24309093@N06,1755,19,1373255272,1373255692,2,2,420
24309093@N06,1755,16,1373262343,1373263063,1,2,720
24332304@N08,1756,2,1272684369,1272684459,1,1,90
24364870@N00,1757,14,1277015664,1277015784,2,2,120
24364870@N00,1757,19,1277020331,1277020751,1,2,420
24385217@N00,1758,27,1238504400,1238505600,1,1,1200
24386268@N05,1759,27,1205034915,1205035967,3,4,1052
24386268@N05,1759,14,1205035967,1205036087,5,4,120
24386268@N05,1759,6,1205050617,1205050872,2,4,255
24386268@N05,1759,21,1205058290,1205058740,1,4,450
24386374@N00,1760,16,1378178051,1378178771,6,1,720
24386374@N00,1761,16,1378259531,1378260251,18,1,720
24386374@N00,1762,16,1378430969,1378431689,7,1,720
24391317@N05,1763,14,1252733156,1252733276,1,1,120
24435279@N00,1764,27,1193553367,1193554567,5,1,1200
24435279@N00,1765,26,1203137301,1203137481,3,4,180
24435279@N00,1765,20,1203144540,1203145620,21,4,1080
24435279@N00,1765,21,1203146488,1203146938,8,4,450
24435279@N00,1765,27,1203147498,1203148698,14,4,1200
24435279@N00,1766,20,1205642597,1205642600,5,10,3
24435279@N00,1766,26,1205642600,1205642638,2,10,38
24435279@N00,1766,5,1205642638,1205642641,5,10,3
24435279@N00,1766,1,1205642641,1205642644,4,10,3
24435279@N00,1766,5,1205642644,1205642644,2,10,0
24435279@N00,1766,9,1205642644,1205642650,7,10,6
24435279@N00,1766,14,1205642650,1205642651,2,10,1
24435279@N00,1766,13,1205642651,1205642656,5,10,5
24435279@N00,1766,27,1205642656,1205642658,2,10,2
24435279@N00,1766,14,1205642658,1205642778,2,10,120
24435279@N00,1767,6,1208737151,1208737406,4,11,255
24435279@N00,1767,9,1208737688,1208737810,6,11,122
24435279@N00,1767,14,1208737810,1208737930,3,11,120
24435279@N00,1767,22,1208738949,1208739549,6,11,600
24435279@N00,1767,1,1208739864,1208740464,5,11,600
24435279@N00,1767,8,1208742413,1208742533,10,11,120
24435279@N00,1767,11,1208742965,1208743145,4,11,180
24435279@N00,1767,9,1208743188,1208743296,2,11,108
24435279@N00,1767,14,1208743296,1208743416,5,11,120
24435279@N00,1767,15,1208743489,1208743669,4,11,180
24435279@N00,1767,22,1208745049,1208745649,1,11,600
24435279@N00,1768,4,1217590845,1217590875,2,4,30
24435279@N00,1768,5,1217590875,1217591595,5,4,720
24435279@N00,1768,13,1217593625,1217594225,4,4,600
24435279@N00,1768,27,1217595384,1217596584,5,4,1200
24435279@N00,1769,27,1217640063,1217641263,8,6,1200
24435279@N00,1769,26,1217645950,1217646130,20,6,180
24435279@N00,1769,21,1217651019,1217651469,10,6,450
24435279@N00,1769,20,1217652619,1217653699,14,6,1080
24435279@N00,1769,3,1217657708,1217657978,12,6,270
24435279@N00,1769,5,1217657994,1217658714,4,6,720
24435279@N00,1770,26,1222823053,1222823233,3,3,180
24435279@N00,1770,3,1222825179,1222825449,2,3,270
24435279@N00,1770,27,1222845297,1222846497,4,3,1200
24435279@N00,1771,1,1224224838,1224225438,4,2,600
24435279@N00,1771,20,1224225619,1224226699,3,2,1080
24435279@N00,1772,27,1224293013,1224294213,6,5,1200
24435279@N00,1772,20,1224297320,1224298400,3,5,1080
24435279@N00,1772,19,1224302023,1224302043,3,5,20
24435279@N00,1772,20,1224302043,1224303123,3,5,1080
24435279@N00,1772,4,1224306727,1224307627,2,5,900
24435279@N00,1773,4,1237615714,1237616497,5,3,783
24435279@N00,1773,1,1237616497,1237616591,17,3,94
24435279@N00,1773,3,1237616591,1237616861,6,3,270
24435279@N00,1774,26,1237694549,1237694729,4,2,180
24435279@N00,1774,14,1237700117,1237700237,16,2,120
24435279@N00,1775,2,1240660208,1240660298,5,4,90
24435279@N00,1775,1,1240660430,1240660735,4,4,305
24435279@N00,1775,11,1240660735,1240660915,2,4,180
24435279@N00,1775,27,1240665352,1240666552,9,4,1200
24435279@N00,1776,21,1241248353,1241248803,5,4,450
24435279@N00,1776,14,1241253502,1241253622,6,4,120
24435279@N00,1776,19,1241256908,1241257071,22,4,163
24435279@N00,1776,13,1241257071,1241257671,5,4,600
24435279@N00,1777,27,1241333542,1241333940,3,5,398
24435279@N00,1777,4,1241333940,1241334267,3,5,327
24435279@N00,1777,2,1241334267,1241334357,3,5,90
24435279@N00,1777,19,1241338084,1241338504,7,5,420
24435279@N00,1777,27,1241343887,1241345087,2,5,1200
24496852@N00,1778,13,1328090453,1328091053,1,1,600
24496852@N00,1779,16,1328367923,1328368643,2,2,720
24496852@N00,1779,13,1328371946,1328372546,1,2,600
24503701@N02,1780,9,1330825817,1330826057,1,1,240
24519194@N08,1781,2,1380961615,1380961705,2,2,90
24519194@N08,1781,25,1380964463,1380965213,1,2,750
24519194@N08,1782,27,1381316236,1381317436,1,1,1200
24519194@N08,1783,27,1381578179,1381579379,2,1,1200
24568538@N00,1784,27,1305407465,1305408665,5,1,1200
24616128@N00,1785,27,1286141326,1286142526,3,14,1200
24616128@N00,1785,19,1286144952,1286145372,3,14,420
24616128@N00,1785,20,1286147088,1286148168,2,14,1080
24616128@N00,1785,24,1286149172,1286149652,7,14,480
24616128@N00,1785,23,1286150648,1286150738,5,14,90
24616128@N00,1785,19,1286155165,1286155169,2,14,4
24616128@N00,1785,13,1286155169,1286155244,2,14,75
24616128@N00,1785,18,1286155244,1286157044,7,14,1800
24616128@N00,1785,19,1286158002,1286158422,5,14,420
24616128@N00,1785,11,1286160006,1286160186,8,14,180
24616128@N00,1785,4,1286181590,1286182490,4,14,900
24616128@N00,1785,25,1286187971,1286188721,12,14,750
24616128@N00,1785,14,1286192628,1286192748,4,14,120
24616128@N00,1785,16,1286193029,1286193749,1,14,720
24616128@N00,1786,17,1286354381,1286355761,29,1,1380
24626151@N06,1787,16,1445753606,1445754326,1,1,720
24638406@N08,1788,27,1377389883,1377391083,1,1,1200
24638406@N08,1789,20,1377952105,1377953185,1,1,1080
24640659@N05,1790,10,1188090340,1188090760,2,1,420
24640659@N05,1791,10,1188129777,1188130197,4,1,420
24675445@N00,1792,2,1352074614,1352074704,2,1,90
24701440@N07,1793,16,1215591544,1215591547,2,2,3
24701440@N07,1793,27,1215591547,1215592747,1,2,1200
24704473@N07,1794,27,1189319151,1189319730,5,8,579
24704473@N07,1794,21,1189319730,1189319738,2,8,8
24704473@N07,1794,23,1189319738,1189319828,2,8,90
24704473@N07,1794,19,1189322427,1189322847,2,8,420
24704473@N07,1794,24,1189323139,1189323171,5,8,32
24704473@N07,1794,21,1189323171,1189323205,2,8,34
24704473@N07,1794,24,1189323205,1189323685,4,8,480
24704473@N07,1794,21,1189324720,1189325170,1,8,450
24704473@N07,1795,3,1189636083,1189636353,14,29,270
24704473@N07,1795,2,1189638016,1189638106,3,29,90
24704473@N07,1795,3,1189638113,1189638151,3,29,38
24704473@N07,1795,2,1189638151,1189638170,2,29,19
24704473@N07,1795,3,1189638170,1189638170,2,29,0
24704473@N07,1795,4,1189638170,1189638199,2,29,29
24704473@N07,1795,5,1189638199,1189638919,7,29,720
24704473@N07,1795,9,1189640159,1189640200,2,29,41
24704473@N07,1795,4,1189640200,1189640411,3,29,211
24704473@N07,1795,9,1189640411,1189640651,10,29,240
24704473@N07,1795,14,1189640772,1189640892,5,29,120
24704473@N07,1795,12,1189642503,1189642510,2,29,7
24704473@N07,1795,15,1189642510,1189642690,2,29,180
24704473@N07,1795,12,1189644003,1189644826,10,29,823
24704473@N07,1795,15,1189644826,1189645006,2,29,180
24704473@N07,1795,17,1189645138,1189645138,2,29,0
24704473@N07,1795,18,1189645138,1189645228,2,29,90
24704473@N07,1795,17,1189645228,1189645280,2,29,52
24704473@N07,1795,13,1189645280,1189645464,3,29,184
24704473@N07,1795,18,1189645464,1189645474,2,29,10
24704473@N07,1795,13,1189645474,1189645533,2,29,59
24704473@N07,1795,18,1189645533,1189645554,2,29,21
24704473@N07,1795,17,1189645554,1189646340,2,29,786
24704473@N07,1795,13,1189646340,1189646940,6,29,600
24704473@N07,1795,15,1189647580,1189647643,2,29,63
24704473@N07,1795,17,1189647643,1189649023,7,29,1380
24704473@N07,1795,14,1189650208,1189650213,2,29,5
24704473@N07,1795,1,1189650213,1189650441,2,29,228
24704473@N07,1795,27,1189650441,1189651641,13,29,1200
24704473@N07,1796,27,1233040332,1233041532,1,1,1200
24704473@N07,1797,8,1237764739,1237764859,12,73,120
24704473@N07,1797,7,1237765289,1237765313,2,73,24
24704473@N07,1797,8,1237765313,1237765425,2,73,112
24704473@N07,1797,7,1237765425,1237765515,6,73,90
24704473@N07,1797,9,1237765711,1237765823,5,73,112
24704473@N07,1797,6,1237765823,1237766078,3,73,255
24704473@N07,1797,2,1237766397,1237766487,2,73,90
24704473@N07,1797,6,1237766503,1237766516,2,73,13
24704473@N07,1797,1,1237766516,1237766884,4,73,368
24704473@N07,1797,3,1237766884,1237766914,2,73,30
24704473@N07,1797,2,1237766914,1237767004,2,73,90
24704473@N07,1797,3,1237767244,1237767514,19,73,270
24704473@N07,1797,2,1237768627,1237768674,2,73,47
24704473@N07,1797,3,1237768674,1237768944,4,73,270
24704473@N07,1797,2,1237769647,1237769737,4,73,90
24704473@N07,1797,1,1237769757,1237769909,2,73,152
24704473@N07,1797,2,1237769909,1237769999,4,73,90
24704473@N07,1797,5,1237770131,1237770851,6,73,720
24704473@N07,1797,9,1237776244,1237776484,5,73,240
24704473@N07,1797,14,1237776787,1237776907,3,73,120
24704473@N07,1797,12,1237779408,1237780248,12,73,840
24704473@N07,1797,15,1237780503,1237780627,2,73,124
24704473@N07,1797,17,1237780627,1237780710,2,73,83
24704473@N07,1797,18,1237780710,1237780803,2,73,93
24704473@N07,1797,15,1237780803,1237780983,3,73,180
24704473@N07,1797,18,1237781048,1237781232,2,73,184
24704473@N07,1797,13,1237781232,1237781832,11,73,600
24704473@N07,1797,17,1237782398,1237782733,5,73,335
24704473@N07,1797,26,1237782733,1237782811,3,73,78
24704473@N07,1797,17,1237782811,1237782890,2,73,79
24704473@N07,1797,20,1237782890,1237782895,2,73,5
24704473@N07,1797,17,1237782895,1237782921,2,73,26
24704473@N07,1797,20,1237782921,1237782998,3,73,77
24704473@N07,1797,17,1237782998,1237783020,2,73,22
24704473@N07,1797,20,1237783020,1237783055,3,73,35
24704473@N07,1797,17,1237783055,1237783144,3,73,89
24704473@N07,1797,26,1237783144,1237783324,5,73,180
24704473@N07,1797,22,1237783348,1237783551,2,73,203
24704473@N07,1797,26,1237783551,1237783618,2,73,67
24704473@N07,1797,22,1237783618,1237783636,2,73,18
24704473@N07,1797,26,1237783636,1237783710,2,73,74
24704473@N07,1797,22,1237783710,1237783724,2,73,14
24704473@N07,1797,26,1237783724,1237783784,2,73,60
24704473@N07,1797,22,1237783784,1237783830,2,73,46
24704473@N07,1797,26,1237783830,1237783922,2,73,92
24704473@N07,1797,22,1237783922,1237784522,2,73,600
24704473@N07,1797,20,1237784889,1237785969,2,73,1080
24704473@N07,1797,21,1237786290,1237786740,18,73,450
24704473@N07,1797,23,1237789315,1237789405,9,73,90
24704473@N07,1797,22,1237790512,1237790512,2,73,0
24704473@N07,1797,23,1237790512,1237790538,3,73,26
24704473@N07,1797,22,1237790538,1237790775,2,73,237
24704473@N07,1797,23,1237790775,1237790865,6,73,90
24704473@N07,1797,26,1237790993,1237791137,2,73,144
24704473@N07,1797,25,1237791137,1237791311,3,73,174
24704473@N07,1797,26,1237791311,1237791483,4,73,172
24704473@N07,1797,25,1237791483,1237791483,2,73,0
24704473@N07,1797,26,1237791483,1237791497,2,73,14
24704473@N07,1797,25,1237791497,1237791536,2,73,39
24704473@N07,1797,26,1237791536,1237791584,2,73,48
24704473@N07,1797,25,1237791584,1237792334,19,73,750
24704473@N07,1797,23,1237792989,1237793066,4,73,77
24704473@N07,1797,26,1237793066,1237793232,2,73,166
24704473@N07,1797,25,1237793232,1237793982,2,73,750
24704473@N07,1797,26,1237794663,1237794832,3,73,169
24704473@N07,1797,23,1237794832,1237794922,4,73,90
24704473@N07,1797,25,1237795526,1237795957,5,73,431
24704473@N07,1797,24,1237795957,1237796437,8,73,480
24704473@N07,1797,25,1237796528,1237797278,3,73,750
24704473@N07,1797,2,1237797433,1237797481,2,73,48
24704473@N07,1797,25,1237797481,1237797642,2,73,161
24704473@N07,1797,4,1237797642,1237798530,2,73,888
24704473@N07,1797,27,1237798530,1237799730,14,73,1200
24704473@N07,1798,25,1238016154,1238016371,2,44,217
24704473@N07,1798,16,1238016371,1238016378,2,44,7
24704473@N07,1798,14,1238016378,1238016498,7,44,120
24704473@N07,1798,15,1238016600,1238016780,3,44,180
24704473@N07,1798,12,1238016993,1238017688,9,44,695
24704473@N07,1798,15,1238017688,1238017784,3,44,96
24704473@N07,1798,14,1238017784,1238017787,2,44,3
24704473@N07,1798,9,1238017787,1238017833,2,44,46
24704473@N07,1798,15,1238017833,1238017899,2,44,66
24704473@N07,1798,14,1238017899,1238018019,7,44,120
24704473@N07,1798,15,1238018092,1238018131,2,44,39
24704473@N07,1798,14,1238018131,1238018251,5,44,120
24704473@N07,1798,15,1238018258,1238018438,5,44,180
24704473@N07,1798,26,1238018658,1238018710,2,44,52
24704473@N07,1798,20,1238018710,1238019790,10,44,1080
24704473@N07,1798,22,1238021442,1238021451,2,44,9
24704473@N07,1798,20,1238021451,1238021468,3,44,17
24704473@N07,1798,22,1238021468,1238021469,2,44,1
24704473@N07,1798,20,1238021469,1238021469,2,44,0
24704473@N07,1798,22,1238021469,1238021655,6,44,186
24704473@N07,1798,26,1238021655,1238021835,14,44,180
24704473@N07,1798,20,1238023419,1238023445,2,44,26
24704473@N07,1798,22,1238023445,1238023512,2,44,67
24704473@N07,1798,19,1238023512,1238023932,17,44,420
24704473@N07,1798,8,1238026703,1238026823,6,44,120
24704473@N07,1798,1,1238027021,1238027269,4,44,248
24704473@N07,1798,5,1238027269,1238027399,2,44,130
24704473@N07,1798,3,1238027399,1238027459,2,44,60
24704473@N07,1798,2,1238027459,1238027492,2,44,33
24704473@N07,1798,4,1238027492,1238027599,2,44,107
24704473@N07,1798,2,1238027599,1238027689,4,44,90
24704473@N07,1798,5,1238027707,1238028008,2,44,301
24704473@N07,1798,1,1238028008,1238028202,2,44,194
24704473@N07,1798,2,1238028202,1238028292,2,44,90
24704473@N07,1798,3,1238028416,1238028441,2,44,25
24704473@N07,1798,5,1238028441,1238028528,2,44,87
24704473@N07,1798,4,1238028528,1238029428,7,44,900
24704473@N07,1798,25,1238029708,1238030458,2,44,750
24704473@N07,1798,23,1238031540,1238031630,3,44,90
24704473@N07,1798,21,1238031796,1238032246,4,44,450
24704473@N07,1798,4,1238032698,1238033596,5,44,898
24704473@N07,1798,1,1238033596,1238034165,2,44,569
24704473@N07,1798,16,1238034165,1238034589,3,44,424
24704473@N07,1798,27,1238034589,1238035789,9,44,1200
24733811@N04,1799,9,1218342724,1218342964,4,2,240
24733811@N04,1799,14,1218344781,1218344901,1,2,120
24733811@N04,1800,8,1218444874,1218444994,2,1,120
24733811@N04,1801,9,1218504993,1218505233,2,2,240
24733811@N04,1801,16,1218508465,1218509185,2,2,720
24733811@N04,1802,20,1218763929,1218765009,1,1,1080
24733811@N04,1803,9,1247278273,1247278513,1,1,240
24733811@N04,1804,14,1247309125,1247309245,1,1,120
24738734@N00,1805,27,1228281718,1228282918,1,1,1200
24738911@N08,1806,26,1218887187,1218887367,1,1,180
24738911@N08,1807,13,1221217998,1221218598,1,1,600
24738911@N08,1808,27,1254458508,1254459708,5,1,1200
24738911@N08,1809,27,1264977900,1264979100,1,1,1200
24738911@N08,1810,26,1266301968,1266302148,1,1,180
24738911@N08,1811,27,1297057448,1297058648,1,1,1200
24738911@N08,1812,16,1309899169,1309899889,2,1,720
24738911@N08,1813,27,1313579294,1313580494,1,1,1200
24738911@N08,1814,24,1331761301,1331761781,1,1,480
24738911@N08,1815,21,1365628702,1365629152,1,1,450
24745847@N00,1816,19,1330388043,1330388463,1,1,420
24745847@N00,1817,27,1330753302,1330754502,1,1,1200
24745847@N00,1818,17,1362191352,1362192732,2,1,1380
24751464@N06,1819,14,1385803638,1385803758,7,1,120
24756124@N02,1820,27,1357857724,1357858924,1,1,1200
24767349@N02,1821,16,1208005290,1208006010,3,1,720
24771256@N00,1822,27,1275443311,1275443527,3,3,216
24771256@N00,1822,17,1275443527,1275443566,2,3,39
24771256@N00,1822,16,1275443566,1275444286,2,3,720
24850040@N07,1823,17,1244974249,1244975629,1,1,1380
24850040@N07,1824,21,1245234123,1245234573,7,5,450
24850040@N07,1824,1,1245240108,1245240708,2,5,600
24850040@N07,1824,4,1245242504,1245243404,3,5,900
24850040@N07,1824,26,1245243545,1245243725,2,5,180
24850040@N07,1824,21,1245244965,1245245415,1,5,450
24850040@N07,1825,2,1245293311,1245293401,2,7,90
24850040@N07,1825,1,1245293439,1245294039,3,7,600
24850040@N07,1825,8,1245294990,1245295110,2,7,120
24850040@N07,1825,18,1245295673,1245296023,3,7,350
24850040@N07,1825,17,1245296023,1245297008,2,7,985
24850040@N07,1825,19,1245297008,1245297428,5,7,420
24850040@N07,1825,18,1245298183,1245299983,1,7,1800
24850040@N07,1826,26,1249994150,1249994194,2,3,44
24850040@N07,1826,21,1249994194,1249994334,2,3,140
24850040@N07,1826,2,1249994334,1249994424,1,3,90
24850040@N07,1827,4,1412140073,1412140276,3,6,203
24850040@N07,1827,3,1412140276,1412140546,2,6,270
24850040@N07,1827,4,1412140788,1412141621,2,6,833
24850040@N07,1827,10,1412141621,1412142041,2,6,420
24850040@N07,1827,17,1412142368,1412143725,2,6,1357
24850040@N07,1827,27,1412143725,1412144925,6,6,1200
24872311@N07,1828,27,1317426368,1317427568,3,3,1200
24872311@N07,1828,6,1317436238,1317436493,2,3,255
24872311@N07,1828,9,1317438014,1317438254,1,3,240
24872311@N07,1829,27,1317631622,1317632822,3,2,1200
24872311@N07,1829,16,1317635296,1317636016,3,2,720
24884155@N08,1830,27,1336550995,1336552195,1,1,1200
24889779@N03,1831,12,1253087562,1253087591,2,2,29
24889779@N03,1831,20,1253087591,1253088671,11,2,1080
24889779@N03,1832,12,1254702073,1254702913,3,1,840
24889779@N03,1833,20,1254892907,1254893987,1,1,1080
24897645@N04,1834,27,1207197460,1207198660,1,1,1200
24897645@N04,1835,21,1207360673,1207361123,1,1,450
24897645@N04,1836,16,1208675201,1208675921,4,1,720
24897645@N04,1837,11,1209097618,1209097798,2,1,180
24897645@N04,1838,21,1210832560,1210833010,2,2,450
24897645@N04,1838,16,1210834835,1210835555,10,2,720
24897645@N04,1839,9,1211290293,1211290533,3,1,240
24897645@N04,1840,27,1211494568,1211494569,2,2,1
24897645@N04,1840,2,1211494569,1211494659,1,2,90
24897645@N04,1841,16,1211698272,1211698992,6,1,720
24897645@N04,1842,16,1212047564,1212048284,17,1,720
24897645@N04,1843,16,1212465873,1212466593,2,1,720
24897645@N04,1844,21,1212563384,1212563834,3,4,450
24897645@N04,1844,14,1212578642,1212578762,2,4,120
24897645@N04,1844,9,1212581939,1212582179,2,4,240
24897645@N04,1844,21,1212585300,1212585750,1,4,450
24897645@N04,1845,21,1212819013,1212819463,1,1,450
24897645@N04,1846,18,1213590374,1213592174,1,1,1800
24897645@N04,1847,27,1214196532,1214197732,8,1,1200
24897645@N04,1848,16,1214376115,1214376835,2,3,720
24897645@N04,1848,1,1214378731,1214379331,2,3,600
24897645@N04,1848,16,1214379684,1214380404,6,3,720
24897645@N04,1849,21,1214896041,1214896491,1,1,450
24897645@N04,1850,21,1215068922,1215069372,2,4,450
24897645@N04,1850,4,1215071885,1215072785,2,4,900
24897645@N04,1850,15,1215073241,1215073421,2,4,180
24897645@N04,1850,16,1215074594,1215075314,46,4,720
24897645@N04,1851,16,1215401341,1215402061,1,1,720
24897645@N04,1852,27,1216177124,1216178324,3,2,1200
24897645@N04,1852,17,1216191630,1216193010,1,2,1380
24897645@N04,1853,17,1217467657,1217469037,1,1,1380
24897645@N04,1854,16,1217646200,1217646920,20,2,720
24897645@N04,1854,1,1217649303,1217649903,1,2,600
24897645@N04,1855,16,1217804686,1217805406,2,4,720
24897645@N04,1855,14,1217806318,1217806438,2,4,120
24897645@N04,1855,21,1217809327,1217809777,2,4,450
24897645@N04,1855,22,1217824664,1217825264,1,4,600
24897645@N04,1856,17,1218258808,1218260188,4,2,1380
24897645@N04,1856,16,1218264229,1218264949,16,2,720
24897645@N04,1857,21,1218353173,1218353623,1,1,450
24897645@N04,1858,16,1218437679,1218438399,23,1,720
24897645@N04,1859,21,1218611464,1218611914,9,1,450
24897645@N04,1860,16,1218793735,1218794455,7,1,720
24897645@N04,1861,27,1219662168,1219663368,2,1,1200
24897645@N04,1862,27,1223004454,1223005654,4,5,1200
24897645@N04,1862,20,1223010272,1223011352,2,5,1080
24897645@N04,1862,27,1223011747,1223012947,24,5,1200
24897645@N04,1862,21,1223015057,1223015507,7,5,450
24897645@N04,1862,16,1223018996,1223019716,94,5,720
24897645@N04,1863,21,1223104180,1223104630,2,12,450
24897645@N04,1863,11,1223115541,1223115721,2,12,180
24897645@N04,1863,21,1223118854,1223119304,2,12,450
24897645@N04,1863,9,1223122002,1223122242,2,12,240
24897645@N04,1863,22,1223127571,1223127681,2,12,110
24897645@N04,1863,8,1223127681,1223127761,2,12,80
24897645@N04,1863,21,1223127761,1223127966,3,12,205
24897645@N04,1863,8,1223127966,1223128086,2,12,120
24897645@N04,1863,21,1223128111,1223128561,3,12,450
24897645@N04,1863,11,1223129746,1223129926,3,12,180
24897645@N04,1863,15,1223133910,1223133973,2,12,63
24897645@N04,1863,14,1223133973,1223134093,2,12,120
24897645@N04,1864,17,1256525744,1256527124,1,1,1380
24897645@N04,1865,14,1275369921,1275370041,1,1,120
24897645@N04,1866,27,1280304153,1280304826,3,9,673
24897645@N04,1866,9,1280304826,1280304989,8,9,163
24897645@N04,1866,14,1280304989,1280305100,2,9,111
24897645@N04,1866,15,1280305100,1280305130,2,9,30
24897645@N04,1866,12,1280305130,1280305306,5,9,176
24897645@N04,1866,13,1280305306,1280305395,2,9,89
24897645@N04,1866,17,1280305395,1280305662,2,9,267
24897645@N04,1866,20,1280305662,1280305790,2,9,128
24897645@N04,1866,21,1280305790,1280306240,2,9,450
24897645@N04,1867,27,1280729017,1280729724,3,15,707
24897645@N04,1867,15,1280729724,1280729744,2,15,20
24897645@N04,1867,12,1280729744,1280729761,2,15,17
24897645@N04,1867,15,1280729761,1280729805,2,15,44
24897645@N04,1867,12,1280729805,1280729820,3,15,15
24897645@N04,1867,15,1280729820,1280729828,2,15,8
24897645@N04,1867,12,1280729828,1280730668,4,15,840
24897645@N04,1867,14,1280732373,1280732439,2,15,66
24897645@N04,1867,9,1280732439,1280732660,3,15,221
24897645@N04,1867,11,1280732660,1280732834,2,15,174
24897645@N04,1867,1,1280732834,1280733325,3,15,491
24897645@N04,1867,2,1280733325,1280733415,3,15,90
24897645@N04,1867,21,1280733803,1280733980,2,15,177
24897645@N04,1867,20,1280733980,1280734142,2,15,162
24897645@N04,1867,17,1280734142,1280735522,2,15,1380
24929160@N00,1868,16,1317683986,1317684706,2,2,720
24929160@N00,1868,26,1317707833,1317708013,1,2,180
24939177@N00,1869,16,1351320461,1351321181,2,2,720
24939177@N00,1869,27,1351332170,1351333370,1,2,1200
24942927@N03,1870,17,1238495032,1238496412,1,1,1380
25001372@N02,1871,24,1292553906,1292554386,1,1,480
25001998@N08,1872,27,1259400799,1259401325,2,2,526
25001998@N08,1872,2,1259401325,1259401415,1,2,90
25027171@N08,1873,27,1399803929,1399805087,12,32,1158
25027171@N08,1873,9,1399805087,1399805281,2,32,194
25027171@N08,1873,6,1399805281,1399805457,2,32,176
25027171@N08,1873,14,1399805457,1399805577,9,32,120
25027171@N08,1873,10,1399805774,1399806194,19,32,420
25027171@N08,1873,7,1399806699,1399806789,2,32,90
25027171@N08,1873,10,1399807053,1399807473,5,32,420
25027171@N08,1873,15,1399807930,1399807969,6,32,39
25027171@N08,1873,12,1399807969,1399807973,2,32,4
25027171@N08,1873,15,1399807973,1399807982,3,32,9
25027171@N08,1873,12,1399807982,1399807985,2,32,3
25027171@N08,1873,15,1399807985,1399808044,8,32,59
25027171@N08,1873,12,1399808044,1399808228,24,32,184
25027171@N08,1873,13,1399808228,1399808244,2,32,16
25027171@N08,1873,12,1399808244,1399808246,2,32,2
25027171@N08,1873,13,1399808246,1399808266,3,32,20
25027171@N08,1873,12,1399808266,1399808271,2,32,5
25027171@N08,1873,13,1399808271,1399808339,14,32,68
25027171@N08,1873,12,1399808339,1399808340,2,32,1
25027171@N08,1873,13,1399808340,1399808347,3,32,7
25027171@N08,1873,12,1399808347,1399808364,3,32,17
25027171@N08,1873,13,1399808364,1399808376,2,32,12
25027171@N08,1873,12,1399808376,1399808380,2,32,4
25027171@N08,1873,13,1399808380,1399808386,3,32,6
25027171@N08,1873,12,1399808386,1399808390,2,32,4
25027171@N08,1873,13,1399808390,1399808397,3,32,7
25027171@N08,1873,12,1399808397,1399808400,2,32,3
25027171@N08,1873,13,1399808400,1399808406,2,32,6
25027171@N08,1873,12,1399808406,1399808718,8,32,312
25027171@N08,1873,13,1399808718,1399809318,2,32,600
25027171@N08,1873,17,1399810489,1399811869,6,32,1380
25027171@N08,1873,27,1399816010,1399817210,18,32,1200
25027171@N08,1874,27,1399852308,1399852748,2,23,440
25027171@N08,1874,9,1399852748,1399852988,4,23,240
25027171@N08,1874,10,1399854551,1399854971,61,23,420
25027171@N08,1874,14,1399861053,1399861113,2,23,60
25027171@N08,1874,16,1399861113,1399861259,10,23,146
25027171@N08,1874,17,1399861259,1399861482,5,23,223
25027171@N08,1874,26,1399861482,1399861662,3,23,180
25027171@N08,1874,18,1399861842,1399861871,2,23,29
25027171@N08,1874,19,1399861871,1399862282,8,23,411
25027171@N08,1874,20,1399862282,1399863362,10,23,1080
25027171@N08,1874,27,1399863597,1399864618,2,23,1021
25027171@N08,1874,22,1399864618,1399865218,13,23,600
25027171@N08,1874,17,1399865605,1399866985,11,23,1380
25027171@N08,1874,18,1399868721,1399869943,4,23,1222
25027171@N08,1874,13,1399869943,1399870543,2,23,600
25027171@N08,1874,17,1399871330,1399872710,51,23,1380
25027171@N08,1874,4,1399875725,1399876625,4,23,900
25027171@N08,1874,27,1399876956,1399878156,28,23,1200
25027171@N08,1874,17,1399879303,1399880683,23,23,1380
25027171@N08,1874,16,1399886275,1399886630,2,23,355
25027171@N08,1874,10,1399886630,1399887050,2,23,420
25027171@N08,1874,12,1399888455,1399889295,3,23,840
25027171@N08,1874,21,1399891747,1399892197,6,23,450
25027171@N08,1875,9,1400113225,1400113465,5,4,240
25027171@N08,1875,10,1400113731,1400114150,3,4,419
25027171@N08,1875,14,1400114150,1400114270,3,4,120
25027171@N08,1875,9,1400120059,1400120299,1,4,240
25027171@N08,1876,27,1401457674,1401458874,1,1,1200
25027171@N08,1877,17,1449466574,1449467954,3,1,1380
25027171@N08,1878,27,1449532401,1449533601,1,1,1200
25027171@N08,1879,27,1449606242,1449607442,52,3,1200
25027171@N08,1879,24,1449629559,1449630039,10,3,480
25027171@N08,1879,27,1449634218,1449635418,2,3,1200
25027171@N08,1880,27,1449735733,1449736933,186,3,1200
25027171@N08,1880,2,1449742280,1449742370,4,3,90
25027171@N08,1880,27,1449745067,1449746267,209,3,1200
25027171@N08,1881,25,1449869876,1449870626,10,2,750
25027171@N08,1881,10,1449878703,1449879123,14,2,420
25050086@N07,1882,7,1389249947,1389250037,2,4,90
25050086@N07,1882,3,1389256558,1389256828,2,4,270
25050086@N07,1882,14,1389258498,1389258618,2,4,120
25050086@N07,1882,23,1389260695,1389260785,1,4,90
25050086@N07,1883,9,1389384866,1389385106,1,1,240
25052208@N00,1884,25,1382079261,1382080011,1,1,750
25112704@N05,1885,14,1264304330,1264304450,1,1,120
25126729@N00,1886,9,1228694313,1228694553,3,2,240
25126729@N00,1886,21,1228722621,1228723071,1,2,450
25126729@N00,1887,3,1228951037,1228951307,1,1,270
25126729@N00,1888,27,1228980008,1228981208,3,4,1200
25126729@N00,1888,22,1228982301,1228982901,4,4,600
25126729@N00,1888,8,1228987614,1228987734,2,4,120
25126729@N00,1888,2,1228988048,1228988138,1,4,90
25126729@N00,1889,27,1276034134,1276035334,1,1,1200
25126729@N00,1890,4,1276080918,1276081818,7,2,900
25126729@N00,1890,17,1276086018,1276087398,8,2,1380
25126729@N00,1891,27,1276427144,1276428344,2,1,1200
25126729@N00,1892,3,1307276912,1307277182,2,3,270
25126729@N00,1892,9,1307277647,1307277887,4,3,240
25126729@N00,1892,26,1307280786,1307280966,2,3,180
25126729@N00,1893,14,1307319719,1307319839,2,2,120
25126729@N00,1893,13,1307325149,1307325749,2,2,600
25126729@N00,1894,13,1307768515,1307769115,3,4,600
25126729@N00,1894,4,1307771078,1307771978,2,4,900
25126729@N00,1894,26,1307798488,1307798668,9,4,180
25126729@N00,1894,27,1307801497,1307802697,3,4,1200
25143581@N00,1895,6,1385340304,1385340559,1,1,255
25152546@N04,1896,25,1441759702,1441760452,2,4,750
25152546@N04,1896,24,1441760909,1441761389,2,4,480
25152546@N04,1896,17,1441769688,1441771068,2,4,1380
25152546@N04,1896,14,1441780174,1441780294,1,4,120
25166220@N02,1897,16,1195858987,1195859707,2,3,720
25166220@N02,1897,17,1195877574,1195878528,5,3,954
25166220@N02,1897,16,1195878528,1195879248,3,3,720
25203548@N00,1898,20,1428835185,1428836265,1,1,1080
25216059@N02,1899,21,1263532837,1263533287,1,1,450
25216419@N00,1900,16,1321265487,1321266207,1,1,720
25229032@N08,1901,27,1374732778,1374733978,1,1,1200
25248468@N08,1902,15,1210836053,1210836233,4,2,180
25248468@N08,1902,13,1210836826,1210837426,2,2,600
25248468@N08,1903,15,1211114448,1211114628,3,1,180
25343363@N05,1904,27,1325474801,1325476001,1,1,1200
25343363@N05,1905,27,1360277101,1360278301,2,2,1200
25343363@N05,1905,10,1360281965,1360282385,1,2,420
25358394@N00,1906,19,1296445815,1296446235,2,1,420
25360342@N02,1907,2,1352544372,1352544462,1,1,90
25360342@N02,1908,27,1395534363,1395535563,2,8,1200
25360342@N02,1908,20,1395537013,1395538093,2,8,1080
25360342@N02,1908,17,1395546071,1395547451,5,8,1380
25360342@N02,1908,20,1395552340,1395553420,2,8,1080
25360342@N02,1908,16,1395554549,1395555269,2,8,720
25360342@N02,1908,7,1395556484,1395556574,2,8,90
25360342@N02,1908,16,1395558562,1395559282,2,8,720
25360342@N02,1908,3,1395571582,1395571852,1,8,270
25360342@N02,1909,14,1395626806,1395626926,2,5,120
25360342@N02,1909,15,1395636833,1395637013,2,5,180
25360342@N02,1909,21,1395654249,1395654699,2,5,450
25360342@N02,1909,20,1395656744,1395657824,2,5,1080
25360342@N02,1909,19,1395658611,1395659031,2,5,420
25360342@N02,1910,27,1395907289,1395908489,1,1,1200
25360342@N02,1911,27,1408831987,1408833187,2,3,1200
25360342@N02,1911,9,1408834972,1408835212,2,3,240
25360342@N02,1911,25,1408839470,1408840220,1,3,750
25360342@N02,1912,27,1454565729,1454566929,2,1,1200
25360342@N02,1913,27,1454666709,1454667909,2,3,1200
25360342@N02,1913,21,1454669464,1454669914,2,3,450
25360342@N02,1913,27,1454676202,1454677402,1,3,1200
25360342@N02,1914,27,1455160180,1455161380,2,7,1200
25360342@N02,1914,17,1455162866,1455164246,16,7,1380
25360342@N02,1914,12,1455178412,1455178984,2,7,572
25360342@N02,1914,13,1455178984,1455179584,2,7,600
25360342@N02,1914,24,1455179828,1455180308,2,7,480
25360342@N02,1914,21,1455183297,1455183747,9,7,450
25360342@N02,1914,27,1455186606,1455187806,1,7,1200
25360342@N02,1915,9,1455226617,1455226857,7,3,240
25360342@N02,1915,15,1455228059,1455228239,3,3,180
25360342@N02,1915,27,1455231489,1455232689,1,3,1200
25361579@N08,1916,4,1321225815,1321226715,1,1,900
25387061@N06,1917,14,1326760507,1326760627,3,2,120
25387061@N06,1917,25,1326773422,1326774172,1,2,750
25387061@N06,1918,27,1327223656,1327224856,1,1,1200
25418288@N02,1919,16,1207538437,1207539157,1,1,720
25435542@N08,1920,13,1367743636,1367744236,10,2,600
25435542@N08,1920,17,1367750335,1367751715,10,2,1380
25437583@N00,1921,27,1232934762,1232935962,1,1,1200
25548984@N06,1922,27,1221673028,1221674228,9,3,1200
25548984@N06,1922,16,1221693556,1221694276,2,3,720
25548984@N06,1922,27,1221696604,1221697804,1,3,1200
25548984@N06,1923,27,1222969136,1222970336,2,1,1200
25548984@N06,1924,9,1225310166,1225310406,2,4,240
25548984@N06,1924,16,1225318467,1225319187,6,4,720
25548984@N06,1924,17,1225324178,1225325558,6,4,1380
25548984@N06,1924,13,1225326260,1225326860,1,4,600
25548984@N06,1925,2,1226259654,1226259744,1,1,90
25548984@N06,1926,27,1228782625,1228783825,2,2,1200
25548984@N06,1926,16,1228787599,1228788319,1,2,720
25548984@N06,1927,16,1232478299,1232479019,3,4,720
25548984@N06,1927,14,1232480928,1232481048,2,4,120
25548984@N06,1927,13,1232481159,1232481759,2,4,600
25548984@N06,1927,16,1232483414,1232484134,1,4,720
25548984@N06,1928,27,1232728259,1232729459,2,3,1200
25548984@N06,1928,26,1232731614,1232731794,14,3,180
25548984@N06,1928,9,1232737821,1232738061,1,3,240
25548984@N06,1929,19,1233851484,1233851904,2,3,420
25548984@N06,1929,18,1233852285,1233854085,2,3,1800
25548984@N06,1929,26,1233855091,1233855271,3,3,180
25548984@N06,1930,16,1234463325,1234464045,5,1,720
25555616@N02,1931,27,1317776647,1317777847,2,3,1200
25555616@N02,1931,16,1317778228,1317778948,3,3,720
25555616@N02,1931,14,1317809472,1317809592,1,3,120
25555616@N02,1932,16,1317897558,1317898278,1,1,720
25564364@N07,1933,16,1214910969,1214911689,2,1,720
25585962@N06,1934,27,1412552970,1412553261,4,21,291
25585962@N06,1934,16,1412553261,1412553482,2,21,221
25585962@N06,1934,21,1412553482,1412553932,4,21,450
25585962@N06,1934,20,1412556677,1412556959,2,21,282
25585962@N06,1934,17,1412556959,1412557012,2,21,53
25585962@N06,1934,26,1412557012,1412557162,2,21,150
25585962@N06,1934,17,1412557162,1412557258,2,21,96
25585962@N06,1934,18,1412557258,1412557728,2,21,470
25585962@N06,1934,19,1412557728,1412558148,3,21,420
25585962@N06,1934,18,1412558320,1412558598,2,21,278
25585962@N06,1934,15,1412558598,1412558778,3,21,180
25585962@N06,1934,2,1412566146,1412566236,2,21,90
25585962@N06,1934,8,1412569098,1412569218,2,21,120
25585962@N06,1934,21,1412571620,1412572070,2,21,450
25585962@N06,1934,2,1412592540,1412592630,2,21,90
25585962@N06,1934,1,1412593066,1412593666,2,21,600
25585962@N06,1934,15,1412593763,1412593943,2,21,180
25585962@N06,1934,26,1412594142,1412594248,2,21,106
25585962@N06,1934,20,1412594248,1412595028,3,21,780
25585962@N06,1934,26,1412595028,1412595208,2,21,180
25585962@N06,1934,27,1412595707,1412596907,2,21,1200
25595049@N08,1935,9,1240453901,1240454141,1,1,240
25601992@N00,1936,20,1413416935,1413418015,3,12,1080
25601992@N00,1936,22,1413418071,1413418082,3,12,11
25601992@N00,1936,20,1413418082,1413418333,21,12,251
25601992@N00,1936,21,1413418333,1413418489,2,12,156
25601992@N00,1936,20,1413418489,1413419569,6,12,1080
25601992@N00,1936,18,1413420455,1413422255,2,12,1800
25601992@N00,1936,9,1413422394,1413422634,2,12,240
25601992@N00,1936,3,1413427298,1413427568,3,12,270
25601992@N00,1936,10,1413432312,1413432732,27,12,420
25601992@N00,1936,9,1413435451,1413435691,2,12,240
25601992@N00,1936,15,1413435795,1413435975,2,12,180
25601992@N00,1936,26,1413439397,1413439577,1,12,180
25601992@N00,1937,3,1460333061,1460333331,2,4,270
25601992@N00,1937,19,1460335829,1460336249,10,4,420
25601992@N00,1937,14,1460347010,1460347130,2,4,120
25601992@N00,1937,27,1460360406,1460361606,1,4,1200
25635719@N00,1938,27,1193371641,1193372841,9,5,1200
25635719@N00,1938,16,1193378353,1193379073,2,5,720
25635719@N00,1938,8,1193382862,1193382982,7,5,120
25635719@N00,1938,16,1193391816,1193392536,12,5,720
25635719@N00,1938,22,1193395095,1193395695,16,5,600
25651350@N06,1939,14,1220579380,1220579500,7,1,120
25651350@N06,1940,21,1229833750,1229834063,2,4,313
25651350@N06,1940,9,1229834063,1229834118,2,4,55
25651350@N06,1940,25,1229834118,1229834868,2,4,750
25651350@N06,1940,9,1229843219,1229843459,4,4,240
25651350@N06,1941,5,1244251192,1244251912,3,5,720
25651350@N06,1941,6,1244256450,1244256705,3,5,255
25651350@N06,1941,5,1244262100,1244262820,6,5,720
25651350@N06,1941,27,1244264338,1244265538,6,5,1200
25651350@N06,1941,17,1244285909,1244287289,2,5,1380
25651350@N06,1942,17,1252807338,1252808718,2,2,1380
25651350@N06,1942,1,1252812455,1252813055,3,2,600
25651350@N06,1943,27,1307143805,1307144841,2,19,1036
25651350@N06,1943,4,1307144841,1307145741,4,19,900
25651350@N06,1943,5,1307146490,1307147210,10,19,720
25651350@N06,1943,4,1307147313,1307147492,2,19,179
25651350@N06,1943,5,1307147492,1307147669,2,19,177
25651350@N06,1943,9,1307147669,1307147909,3,19,240
25651350@N06,1943,6,1307148211,1307148295,11,19,84
25651350@N06,1943,9,1307148295,1307148435,7,19,140
25651350@N06,1943,6,1307148435,1307148690,2,19,255
25651350@N06,1943,15,1307149084,1307149264,13,19,180
25651350@N06,1943,13,1307150368,1307150968,16,19,600
25651350@N06,1943,15,1307151767,1307151947,12,19,180
25651350@N06,1943,16,1307154495,1307154535,3,19,40
25651350@N06,1943,14,1307154535,1307154655,3,19,120
25651350@N06,1943,5,1307154842,1307155562,3,19,720
25651350@N06,1943,17,1307158248,1307159285,6,19,1037
25651350@N06,1943,21,1307159285,1307159735,2,19,450
25651350@N06,1943,23,1307161020,1307161104,2,19,84
25651350@N06,1943,25,1307161104,1307161854,1,19,750
25651350@N06,1944,23,1338593365,1338593455,5,4,90
25651350@N06,1944,20,1338597842,1338598922,3,4,1080
25651350@N06,1944,17,1338599211,1338600591,8,4,1380
25651350@N06,1944,14,1338600791,1338600911,3,4,120
25698277@N06,1945,14,1374402330,1374402450,1,1,120
25698277@N06,1946,16,1375411777,1375412497,1,1,720
25703511@N06,1947,27,1241483589,1241484789,3,4,1200
25703511@N06,1947,16,1241487393,1241488113,21,4,720
25703511@N06,1947,19,1241490897,1241491317,2,4,420
25703511@N06,1947,11,1241513916,1241514096,1,4,180
25817217@N08,1948,10,1436425554,1436425974,1,1,420
25827417@N00,1949,21,1265083335,1265083785,1,1,450
25827417@N00,1950,4,1295522380,1295523280,1,1,900
25827417@N00,1951,4,1330855757,1330856657,12,1,900
25827417@N00,1952,4,1330897952,1330898852,1,1,900
25827417@N00,1953,4,1330928004,1330928904,41,1,900
25827417@N00,1954,4,1331153522,1331154422,144,1,900
25827417@N00,1955,4,1331242444,1331243344,42,1,900
25827417@N00,1956,4,1331290097,1331290997,1,1,900
25827417@N00,1957,21,1384399730,1384400180,2,1,450
25827417@N00,1958,21,1430346388,1430346838,5,2,450
25827417@N00,1958,16,1430385145,1430385865,3,2,720
25827417@N00,1959,21,1430524365,1430524815,2,1,450
25835520@N02,1960,27,1391157931,1391159131,1,1,1200
25839240@N08,1961,10,1354236429,1354236849,2,11,420
25839240@N08,1961,7,1354237180,1354237270,2,11,90
25839240@N08,1961,17,1354239150,1354240396,2,11,1246
25839240@N08,1961,15,1354240396,1354240576,5,11,180
25839240@N08,1961,23,1354243285,1354243375,2,11,90
25839240@N08,1961,25,1354244189,1354244939,7,11,750
25839240@N08,1961,22,1354245998,1354246598,2,11,600
25839240@N08,1961,10,1354247127,1354247434,3,11,307
25839240@N08,1961,9,1354247434,1354247674,2,11,240
25839240@N08,1961,2,1354248273,1354248363,3,11,90
25839240@N08,1961,14,1354250784,1354250904,6,11,120
25839240@N08,1962,27,1369097023,1369098223,12,2,1200
25839240@N08,1962,10,1369103881,1369104301,4,2,420
25846522@N00,1963,16,1360284808,1360285528,1,1,720
25846522@N00,1964,27,1360562151,1360563351,2,2,1200
25846522@N00,1964,17,1360565324,1360566704,1,2,1380
25854008@N00,1965,1,1352629095,1352629695,1,1,600
25854008@N00,1966,16,1352793856,1352794576,1,1,720
25854008@N00,1967,10,1352861250,1352861670,1,1,420
25858747@N02,1968,4,1284202740,1284203640,1,1,900
25865463@N00,1969,22,1400808467,1400809067,1,1,600
25865463@N00,1970,27,1400885584,1400886784,4,1,1200
25868826@N05,1971,3,1286187046,1286187316,1,1,270
25905065@N00,1972,27,1336946705,1336947905,28,16,1200
25905065@N00,1972,16,1336950431,1336951151,3,16,720
25905065@N00,1972,27,1336951625,1336952825,3,16,1200
25905065@N00,1972,17,1336955134,1336955170,4,16,36
25905065@N00,1972,14,1336955170,1336955187,2,16,17
25905065@N00,1972,22,1336955187,1336955198,2,16,11
25905065@N00,1972,18,1336955198,1336955358,7,16,160
25905065@N00,1972,19,1336955358,1336955489,2,16,131
25905065@N00,1972,18,1336955489,1336955546,2,16,57
25905065@N00,1972,15,1336955546,1336955558,3,16,12
25905065@N00,1972,14,1336955558,1336955678,2,16,120
25905065@N00,1972,27,1336957032,1336957150,2,16,118
25905065@N00,1972,14,1336957150,1336957217,2,16,67
25905065@N00,1972,4,1336957217,1336957429,2,16,212
25905065@N00,1972,27,1336957429,1336958629,4,16,1200
25905065@N00,1972,24,1336959909,1336960389,1,16,480
25905065@N00,1973,25,1363043521,1363044271,6,2,750
25905065@N00,1973,19,1363053669,1363054089,2,2,420
25961474@N06,1974,27,1293165293,1293166493,1,1,1200
25984179@N00,1975,19,1265853335,1265853755,1,1,420
26000176@N07,1976,25,1338182435,1338183185,2,1,750
26000176@N07,1977,8,1338242630,1338242750,2,1,120
26094090@N00,1978,22,1329562622,1329563222,1,1,600
26094090@N00,1979,14,1331773365,1331773485,1,1,120
26094090@N00,1980,15,1343214009,1343214189,2,1,180
26094090@N00,1981,13,1352067907,1352068507,2,2,600
26094090@N00,1981,27,1352071452,1352072652,1,2,1200
26094090@N00,1982,14,1355441381,1355441501,1,1,120
26116471@N03,1983,21,1428772391,1428772841,1,1,450
26143366@N00,1984,22,1205367211,1205367811,4,5,600
26143366@N00,1984,17,1205378242,1205379622,6,5,1380
26143366@N00,1984,2,1205396175,1205396233,2,5,58
26143366@N00,1984,5,1205396233,1205396953,2,5,720
26143366@N00,1984,6,1205399107,1205399362,1,5,255
26153219@N00,1985,27,1309121382,1309122271,10,3,889
26153219@N00,1985,20,1309122271,1309122376,2,3,105
26153219@N00,1985,18,1309122376,1309124176,1,3,1800
26176576@N07,1986,27,1444778799,1444779999,11,12,1200
26176576@N07,1986,17,1444780007,1444781387,5,12,1380
26176576@N07,1986,14,1444782097,1444782217,10,12,120
26176576@N07,1986,7,1444787076,1444787166,4,12,90
26176576@N07,1986,10,1444791552,1444791972,11,12,420
26176576@N07,1986,12,1444801054,1444801384,21,12,330
26176576@N07,1986,13,1444801384,1444801984,15,12,600
26176576@N07,1986,4,1444807309,1444808209,5,12,900
26176576@N07,1986,3,1444810168,1444810438,3,12,270
26176576@N07,1986,2,1444810464,1444810554,3,12,90
26176576@N07,1986,17,1444819120,1444820500,3,12,1380
26176576@N07,1986,27,1444823181,1444824381,3,12,1200
26176576@N07,1987,14,1444857077,1444857197,6,6,120
26176576@N07,1987,16,1444862510,1444862530,3,6,20
26176576@N07,1987,14,1444862530,1444862650,2,6,120
26176576@N07,1987,24,1444865710,1444865817,14,6,107
26176576@N07,1987,25,1444865817,1444866162,16,6,345
26176576@N07,1987,24,1444866162,1444866642,4,6,480
26197615@N00,1988,2,1433804135,1433804225,1,1,90
26211887@N07,1989,27,1223606457,1223607657,1,1,1200
26211887@N07,1990,9,1223973931,1223974171,3,2,240
26211887@N07,1990,17,1223979400,1223980780,1,2,1380
26211887@N07,1991,27,1224105342,1224106542,2,6,1200
26211887@N07,1991,14,1224106686,1224106745,2,6,59
26211887@N07,1991,16,1224106745,1224107152,3,6,407
26211887@N07,1991,9,1224107152,1224107220,2,6,68
26211887@N07,1991,14,1224107220,1224107254,2,6,34
26211887@N07,1991,9,1224107254,1224107494,1,6,240
26211887@N07,1992,19,1224213031,1224213451,2,9,420
26211887@N07,1992,24,1224222187,1224222667,2,9,480
26211887@N07,1992,9,1224240840,1224240993,2,9,153
26211887@N07,1992,14,1224240993,1224241113,10,9,120
26211887@N07,1992,15,1224241604,1224241784,5,9,180
26211887@N07,1992,26,1224241850,1224241868,2,9,18
26211887@N07,1992,23,1224241868,1224241892,2,9,24
26211887@N07,1992,24,1224241892,1224242054,4,9,162
26211887@N07,1992,21,1224242054,1224242504,9,9,450
26211887@N07,1993,27,1224333777,1224334977,1,1,1200
26211887@N07,1994,8,1224381188,1224381308,1,1,120
26236829@N00,1995,22,1354668800,1354669400,2,2,600
26236829@N00,1995,15,1354676426,1354676606,2,2,180
26247897@N03,1996,4,1338115443,1338116343,2,2,900
26247897@N03,1996,8,1338117040,1338117160,1,2,120
26284290@N05,1997,27,1189346400,1189347600,2,1,1200
26284290@N05,1998,14,1189605600,1189605720,1,1,120
26284290@N05,1999,22,1220709600,1220709602,3,2,2
26284290@N05,1999,26,1220709602,1220709782,2,2,180
26284290@N05,2000,8,1220882400,1220882520,5,1,120
26284290@N05,2001,17,1221055200,1221056580,2,1,1380
26284290@N05,2002,27,1221228000,1221229200,1,1,1200
26284290@N05,2003,20,1253282401,1253283481,1,1,1080
26284290@N05,2004,22,1284818400,1284818401,2,2,1
26284290@N05,2004,17,1284818401,1284819781,2,2,1380
26284290@N05,2005,14,1284991200,1284991201,3,4,1
26284290@N05,2005,22,1284991201,1284991202,2,4,1
26284290@N05,2005,14,1284991202,1284991203,3,4,1
26284290@N05,2005,26,1284991203,1284991383,1,4,180
26284290@N05,2006,26,1285164001,1285164181,2,1,180
26284290@N05,2007,16,1285336800,1285336800,2,3,0
26284290@N05,2007,27,1285336800,1285336801,2,3,1
26284290@N05,2007,11,1285336801,1285336981,1,3,180
26284290@N05,2008,2,1305295200,1305295290,1,1,90
26284290@N05,2009,1,1305381600,1305382200,1,1,600
26284290@N05,2010,9,1321607399,1321607406,2,2,7
26284290@N05,2010,17,1321607406,1321608786,1,2,1380
26284290@N05,2011,27,1328519536,1328520736,1,1,1200
26291243@N00,2012,9,1331425926,1331426166,1,1,240
26342127@N00,2013,9,1264299897,1264300137,3,3,240
26342127@N00,2013,17,1264308124,1264309504,4,3,1380
26342127@N00,2013,26,1264313465,1264313645,1,3,180
26361782@N03,2014,14,1415858631,1415858751,2,2,120
26361782@N03,2014,27,1415883388,1415884588,1,2,1200
26393454@N00,2015,17,1423015921,1423017301,2,2,1380
26393454@N00,2015,26,1423024795,1423024975,1,2,180
26393454@N00,2016,13,1423205073,1423205123,2,2,50
26393454@N00,2016,12,1423205123,1423205963,1,2,840
26393454@N00,2017,7,1423274380,1423274470,4,3,90
26393454@N00,2017,8,1423283644,1423283764,2,3,120
26393454@N00,2017,23,1423286888,1423286978,2,3,90
26393795@N00,2018,8,1355463973,1355464093,1,1,120
26393795@N00,2019,9,1356311972,1356312212,1,1,240
26449190@N00,2020,6,1223108215,1223108470,2,3,255
26449190@N00,2020,3,1223109647,1223109917,2,3,270
26449190@N00,2020,27,1223117790,1223118990,1,3,1200
26449984@N06,2021,16,1195040800,1195041064,2,2,264
26449984@N06,2021,1,1195041064,1195041664,1,2,600
26469338@N08,2022,27,1367106655,1367107855,2,3,1200
26469338@N08,2022,9,1367115515,1367115755,2,3,240
26469338@N08,2022,16,1367139967,1367140687,1,3,720
26469338@N08,2023,27,1367200525,1367201725,2,2,1200
26469338@N08,2023,6,1367216252,1367216507,1,2,255
26486487@N06,2024,27,1211333689,1211334889,2,9,1200
26486487@N06,2024,22,1211339461,1211340061,4,9,600
26486487@N06,2024,18,1211340762,1211340962,3,9,200
26486487@N06,2024,19,1211340962,1211341382,4,9,420
26486487@N06,2024,18,1211341474,1211342379,2,9,905
26486487@N06,2024,5,1211342379,1211342575,4,9,196
26486487@N06,2024,4,1211342575,1211343475,2,9,900
26486487@N06,2024,5,1211343974,1211344694,9,9,720
26486487@N06,2024,27,1211344874,1211346074,1,9,1200
26522673@N07,2025,16,1211550026,1211550078,2,2,52
26522673@N07,2025,2,1211550078,1211550168,1,2,90
26522673@N07,2026,25,1212286212,1212286237,6,2,25
26522673@N07,2026,20,1212286237,1212287317,1,2,1080
26522673@N07,2027,22,1212480704,1212481304,1,1,600
26522673@N07,2028,25,1212821242,1212821248,2,3,6
26522673@N07,2028,22,1212821248,1212821848,2,3,600
26522673@N07,2028,16,1212837360,1212838080,1,3,720
26522673@N07,2029,20,1217931557,1217931562,2,2,5
26522673@N07,2029,22,1217931562,1217932162,1,2,600
26522673@N07,2030,16,1218114645,1218115365,1,1,720
26522673@N07,2031,1,1218184808,1218185408,1,1,600
26522673@N07,2032,17,1219047628,1219049008,1,1,1380
26522673@N07,2033,1,1219407081,1219407681,1,1,600
26522673@N07,2034,25,1219631018,1219631768,1,1,750
26522673@N07,2035,2,1220699182,1220699272,1,1,90
26522673@N07,2036,17,1220964253,1220965633,2,1,1380
26522673@N07,2037,13,1221121466,1221121474,2,2,8
26522673@N07,2037,15,1221121474,1221121654,1,2,180
26522673@N07,2038,17,1221179702,1221181082,1,1,1380
26522673@N07,2039,3,1222484800,1222485070,1,1,270
26522673@N07,2040,14,1226389000,1226389120,1,1,120
26522673@N07,2041,12,1226468286,1226469126,1,1,840
26522673@N07,2042,16,1228815418,1228816138,1,1,720
26522673@N07,2043,25,1230710858,1230711608,1,1,750
26522673@N07,2044,2,1231999640,1231999686,2,2,46
26522673@N07,2044,3,1231999686,1231999956,1,2,270
26522673@N07,2045,16,1232279410,1232280130,1,1,720
26522673@N07,2046,24,1283160398,1283160878,2,8,480
26522673@N07,2046,25,1283161095,1283161845,6,8,750
26522673@N07,2046,21,1283162330,1283162780,2,8,450
26522673@N07,2046,2,1283167812,1283167902,2,8,90
26522673@N07,2046,1,1283169609,1283170008,2,8,399
26522673@N07,2046,5,1283170008,1283170192,3,8,184
26522673@N07,2046,16,1283170192,1283170581,2,8,389
26522673@N07,2046,27,1283170581,1283171781,1,8,1200
26522673@N07,2047,1,1283472407,1283473007,2,19,600
26522673@N07,2047,2,1283474647,1283474737,2,19,90
26522673@N07,2047,16,1283478690,1283479410,2,19,720
26522673@N07,2047,15,1283479815,1283479995,2,19,180
26522673@N07,2047,14,1283481219,1283481339,10,19,120
26522673@N07,2047,20,1283485730,1283485925,2,19,195
26522673@N07,2047,22,1283485925,1283486525,5,19,600
26522673@N07,2047,20,1283489211,1283490240,5,19,1029
26522673@N07,2047,19,1283490240,1283490660,3,19,420
26522673@N07,2047,22,1283490991,1283491591,6,19,600
26522673@N07,2047,18,1283493696,1283493832,2,19,136
26522673@N07,2047,24,1283493832,1283494312,2,19,480
26522673@N07,2047,18,1283495123,1283496141,2,19,1018
26522673@N07,2047,13,1283496141,1283496741,2,19,600
26522673@N07,2047,16,1283496917,1283497637,2,19,720
26522673@N07,2047,25,1283497753,1283498503,3,19,750
26522673@N07,2047,21,1283499476,1283499836,2,19,360
26522673@N07,2047,24,1283499836,1283500316,2,19,480
26522673@N07,2047,27,1283500478,1283501678,1,19,1200
26522673@N07,2048,27,1346298178,1346298458,2,9,280
26522673@N07,2048,2,1346298458,1346298548,2,9,90
26522673@N07,2048,25,1346299344,1346300094,5,9,750
26522673@N07,2048,26,1346302649,1346302829,2,9,180
26522673@N07,2048,25,1346304169,1346304919,3,9,750
26522673@N07,2048,24,1346305599,1346306079,3,9,480
26522673@N07,2048,21,1346310007,1346310457,2,9,450
26522673@N07,2048,13,1346314527,1346315127,4,9,600
26522673@N07,2048,19,1346317417,1346317837,1,9,420
26522673@N07,2049,27,1346539880,1346541080,7,11,1200
26522673@N07,2049,26,1346569250,1346569430,2,11,180
26522673@N07,2049,25,1346569801,1346570551,2,11,750
26522673@N07,2049,15,1346572348,1346572528,2,11,180
26522673@N07,2049,9,1346572969,1346573209,3,11,240
26522673@N07,2049,14,1346573399,1346573519,3,11,120
26522673@N07,2049,13,1346574114,1346574714,2,11,600
26522673@N07,2049,16,1346576073,1346576793,2,11,720
26522673@N07,2049,13,1346594550,1346595150,2,11,600
26522673@N07,2049,17,1346595539,1346596883,3,11,1344
26522673@N07,2049,25,1346596883,1346597633,1,11,750
26522673@N07,2050,27,1346810752,1346811952,4,6,1200
26522673@N07,2050,1,1346816596,1346817196,3,6,600
26522673@N07,2050,6,1346817321,1346817576,3,6,255
26522673@N07,2050,3,1346818958,1346819228,3,6,270
26522673@N07,2050,14,1346823090,1346823210,2,6,120
26522673@N07,2050,16,1346823223,1346823943,1,6,720
26522673@N07,2051,12,1382356725,1382357565,2,4,840
26522673@N07,2051,13,1382366820,1382367420,4,4,600
26522673@N07,2051,16,1382368419,1382369139,2,4,720
26522673@N07,2051,27,1382369339,1382370539,2,4,1200
26522673@N07,2052,27,1382410248,1382411448,5,14,1200
26522673@N07,2052,15,1382413606,1382413786,2,14,180
26522673@N07,2052,13,1382418377,1382418977,2,14,600
26522673@N07,2052,26,1382420411,1382420591,3,14,180
26522673@N07,2052,25,1382422862,1382423612,2,14,750
26522673@N07,2052,26,1382424196,1382424376,3,14,180
26522673@N07,2052,22,1382426487,1382427087,2,14,600
26522673@N07,2052,24,1382430351,1382430831,2,14,480
26522673@N07,2052,16,1382442714,1382443434,4,14,720
26522673@N07,2052,27,1382445909,1382447109,6,14,1200
26522673@N07,2052,13,1382450223,1382450823,2,14,600
26522673@N07,2052,14,1382451533,1382451653,2,14,120
26522673@N07,2052,16,1382452538,1382453258,2,14,720
26522673@N07,2052,27,1382453293,1382454493,1,14,1200
26522673@N07,2053,27,1382575641,1382576699,2,13,1058
26522673@N07,2053,25,1382576699,1382577449,2,13,750
26522673@N07,2053,26,1382577736,1382577916,4,13,180
26522673@N07,2053,24,1382580539,1382581019,5,13,480
26522673@N07,2053,20,1382582327,1382583407,4,13,1080
26522673@N07,2053,19,1382584187,1382584607,3,13,420
26522673@N07,2053,22,1382584813,1382585413,5,13,600
26522673@N07,2053,9,1382596951,1382597191,5,13,240
26522673@N07,2053,6,1382598795,1382599050,2,13,255
26522673@N07,2053,14,1382599149,1382599269,2,13,120
26522673@N07,2053,12,1382599408,1382600173,2,13,765
26522673@N07,2053,13,1382600173,1382600556,2,13,383
26522673@N07,2053,14,1382600556,1382600676,1,13,120
26531284@N02,2054,23,1320213487,1320213577,3,4,90
26531284@N02,2054,16,1320223966,1320224686,2,4,720
26531284@N02,2054,5,1320226286,1320227006,2,4,720
26531284@N02,2054,16,1320227387,1320228107,1,4,720
26531284@N02,2055,27,1320372551,1320372968,2,6,417
26531284@N02,2055,16,1320372968,1320373489,3,6,521
26531284@N02,2055,6,1320373489,1320373744,2,6,255
26531284@N02,2055,1,1320374430,1320375030,2,6,600
26531284@N02,2055,19,1320376851,1320377271,3,6,420
26531284@N02,2055,9,1320383299,1320383539,2,6,240
26531284@N02,2056,17,1352017752,1352019132,6,4,1380
26531284@N02,2056,5,1352026753,1352027473,4,4,720
26531284@N02,2056,17,1352028138,1352028878,3,4,740
26531284@N02,2056,19,1352028878,1352029298,1,4,420
26533304@N07,2057,27,1242526888,1242528088,11,9,1200
26533304@N07,2057,3,1242528802,1242529072,2,9,270
26533304@N07,2057,6,1242530527,1242530782,3,9,255
26533304@N07,2057,25,1242536068,1242536818,9,9,750
26533304@N07,2057,26,1242542112,1242542216,2,9,104
26533304@N07,2057,25,1242542216,1242542966,2,9,750
26533304@N07,2057,20,1242546379,1242547459,9,9,1080
26533304@N07,2057,17,1242551283,1242552663,2,9,1380
26533304@N07,2057,9,1242556030,1242556270,4,9,240
26536365@N00,2058,20,1386313999,1386315079,1,1,1080
26544897@N04,2059,27,1197766346,1197767546,42,1,1200
26551005@N08,2060,27,1305862195,1305862506,2,5,311
26551005@N08,2060,16,1305862506,1305863226,13,5,720
26551005@N08,2060,25,1305876087,1305876837,4,5,750
26551005@N08,2060,27,1305884756,1305885956,4,5,1200
26551005@N08,2060,16,1305889497,1305890217,10,5,720
26551005@N08,2061,14,1308207777,1308207897,1,1,120
26551005@N08,2062,17,1326777853,1326779233,2,2,1380
26551005@N08,2062,16,1326794766,1326795486,1,2,720
26559120@N06,2063,27,1391173200,1391174400,1,1,1200
26560604@N02,2064,27,1201248849,1201250049,9,1,1200
26573031@N05,2065,15,1465607897,1465608077,2,4,180
26573031@N05,2065,18,1465609087,1465610887,2,4,1800
26573031@N05,2065,17,1465625351,1465626731,2,4,1380
26573031@N05,2065,2,1465630015,1465630105,2,4,90
26573031@N05,2066,14,1465900523,1465900643,1,1,120
26573031@N05,2067,15,1466037375,1466037555,4,4,180
26573031@N05,2067,18,1466039147,1466040947,2,4,1800
26573031@N05,2067,7,1466042394,1466042484,2,4,90
26573031@N05,2067,10,1466043272,1466043692,1,4,420
26603119@N00,2068,27,1366844474,1366845674,2,1,1200
26603119@N00,2069,14,1400032295,1400032415,1,1,120
26603119@N00,2070,27,1400187747,1400188438,2,3,691
26603119@N00,2070,4,1400188438,1400189338,2,3,900
26603119@N00,2070,2,1400191502,1400191592,1,3,90
26603119@N00,2071,1,1400302411,1400303011,2,1,600
26603119@N00,2072,27,1463087239,1463088439,2,2,1200
26603119@N00,2072,3,1463091762,1463092032,1,2,270
26616207@N00,2073,27,1209084938,1209086138,2,1,1200
26619856@N00,2074,1,1350971837,1350972437,1,1,600
26652894@N06,2075,16,1195337096,1195337816,1,1,720
26652894@N06,2076,14,1199484357,1199484477,1,1,120
26670433@N07,2077,16,1232830035,1232830755,4,5,720
26670433@N07,2077,14,1232833102,1232833222,3,5,120
26670433@N07,2077,4,1232849505,1232850405,4,5,900
26670433@N07,2077,7,1232854360,1232854450,2,5,90
26670433@N07,2077,21,1232860319,1232860769,1,5,450
26678134@N04,2078,27,1333061377,1333062457,2,15,1080
26678134@N04,2078,2,1333062457,1333062547,2,15,90
26678134@N04,2078,4,1333063368,1333064268,5,15,900
26678134@N04,2078,22,1333064787,1333065387,2,15,600
26678134@N04,2078,20,1333065606,1333065777,4,15,171
26678134@N04,2078,18,1333065777,1333065809,2,15,32
26678134@N04,2078,19,1333065809,1333066229,2,15,420
26678134@N04,2078,25,1333067839,1333068589,7,15,750
26678134@N04,2078,23,1333068671,1333068703,2,15,32
26678134@N04,2078,24,1333068703,1333069183,2,15,480
26678134@N04,2078,21,1333073575,1333073807,2,15,232
26678134@N04,2078,25,1333073807,1333073925,2,15,118
26678134@N04,2078,24,1333073925,1333074378,2,15,453
26678134@N04,2078,25,1333074378,1333074459,2,15,81
26678134@N04,2078,17,1333074459,1333075839,1,15,1380
26678134@N04,2079,27,1333260510,1333261710,2,4,1200
26678134@N04,2079,6,1333271306,1333271561,3,4,255
26678134@N04,2079,9,1333271690,1333271930,2,4,240
26678134@N04,2079,26,1333277249,1333277429,1,4,180
26678134@N04,2080,17,1340009831,1340010581,2,4,750
26678134@N04,2080,19,1340010581,1340011001,2,4,420
26678134@N04,2080,20,1340011162,1340012242,2,4,1080
26678134@N04,2080,17,1340012489,1340013869,1,4,1380
26678134@N04,2081,27,1340957510,1340958710,2,4,1200
26678134@N04,2081,20,1340959732,1340960132,2,4,400
26678134@N04,2081,19,1340960132,1340960552,2,4,420
26678134@N04,2081,22,1340962446,1340963046,1,4,600
26678134@N04,2082,19,1349415014,1349415434,3,1,420
26678134@N04,2083,19,1350017774,1350018194,1,1,420
26678134@N04,2084,27,1354854259,1354855459,1,1,1200
26678134@N04,2085,14,1356946872,1356946992,4,4,120
26678134@N04,2085,17,1356948030,1356949410,2,4,1380
26678134@N04,2085,10,1356953803,1356954223,3,4,420
26678134@N04,2085,16,1356960272,1356960992,2,4,720
26678134@N04,2086,13,1360112488,1360113088,3,6,600
26678134@N04,2086,10,1360114646,1360115066,4,6,420
26678134@N04,2086,19,1360117440,1360117860,5,6,420
26678134@N04,2086,24,1360121181,1360121661,2,6,480
26678134@N04,2086,22,1360122873,1360123072,2,6,199
26678134@N04,2086,23,1360123072,1360123162,1,6,90
26678134@N04,2087,19,1363328010,1363328430,1,1,420
26678134@N04,2088,9,1364039741,1364039981,2,2,240
26678134@N04,2088,3,1364040288,1364040558,1,2,270
26678134@N04,2089,19,1364626601,1364627021,1,1,420
26678134@N04,2090,23,1379830402,1379830492,1,1,90
26678134@N04,2091,1,1380260232,1380260832,1,1,600
26678134@N04,2092,22,1382685064,1382685664,2,1,600
26678134@N04,2093,17,1388239165,1388239263,2,2,98
26678134@N04,2093,16,1388239263,1388239983,3,2,720
26678134@N04,2094,17,1397034150,1397034164,2,7,14
26678134@N04,2094,18,1397034164,1397034263,3,7,99
26678134@N04,2094,22,1397034263,1397034290,2,7,27
26678134@N04,2094,18,1397034290,1397034465,3,7,175
26678134@N04,2094,19,1397034465,1397034885,4,7,420
26678134@N04,2094,18,1397035029,1397035243,2,7,214
26678134@N04,2094,17,1397035243,1397036623,1,7,1380
26678134@N04,2095,3,1397726796,1397727066,2,2,270
26678134@N04,2095,13,1397734181,1397734781,1,2,600
26678134@N04,2096,3,1399709514,1399709784,2,2,270
26678134@N04,2096,9,1399723794,1399724034,2,2,240
26678134@N04,2097,27,1401265852,1401267052,2,10,1200
26678134@N04,2097,19,1401267449,1401267869,2,10,420
26678134@N04,2097,9,1401268685,1401268925,2,10,240
26678134@N04,2097,14,1401269329,1401269447,2,10,118
26678134@N04,2097,9,1401269447,1401269687,2,10,240
26678134@N04,2097,14,1401269878,1401269998,2,10,120
26678134@N04,2097,17,1401270873,1401271653,2,10,780
26678134@N04,2097,19,1401271653,1401272073,2,10,420
26678134@N04,2097,13,1401272080,1401272680,2,10,600
26678134@N04,2097,25,1401275499,1401276249,1,10,750
26678134@N04,2098,19,1403176326,1403176746,1,1,420
26678134@N04,2099,16,1406451922,1406452642,4,5,720
26678134@N04,2099,18,1406452861,1406453807,3,5,946
26678134@N04,2099,19,1406453807,1406454227,3,5,420
26678134@N04,2099,18,1406454457,1406456257,2,5,1800
26678134@N04,2099,23,1406456778,1406456868,1,5,90
26678134@N04,2100,23,1408700499,1408700589,2,1,90
26678134@N04,2101,27,1411804883,1411806083,1,1,1200
26678134@N04,2102,17,1412911934,1412912666,3,5,732
26678134@N04,2102,9,1412912666,1412912906,2,5,240
26678134@N04,2102,1,1412915617,1412916217,2,5,600
26678134@N04,2102,26,1412918547,1412918727,3,5,180
26678134@N04,2102,18,1412919769,1412921569,5,5,1800
26678134@N04,2103,15,1417261559,1417261739,1,1,180
26678134@N04,2104,27,1419066503,1419067703,2,3,1200
26678134@N04,2104,24,1419068396,1419068876,2,3,480
26678134@N04,2104,27,1419080935,1419082135,1,3,1200
26678134@N04,2105,10,1419846714,1419847134,1,1,420
26678134@N04,2106,7,1420284164,1420284254,1,1,90
26678134@N04,2107,23,1422599637,1422599720,3,5,83
26678134@N04,2107,21,1422599720,1422599828,2,5,108
26678134@N04,2107,20,1422599828,1422600297,2,5,469
26678134@N04,2107,18,1422600297,1422601000,2,5,703
26678134@N04,2107,19,1422601000,1422601420,1,5,420
26678134@N04,2108,20,1423195256,1423196336,9,3,1080
26678134@N04,2108,23,1423196426,1423196516,3,3,90
26678134@N04,2108,25,1423196772,1423197522,1,3,750
26678134@N04,2109,19,1425281706,1425282126,1,1,420
26678134@N04,2110,17,1426324659,1426326039,1,1,1380
26678134@N04,2111,27,1426917454,1426917966,2,2,512
26678134@N04,2111,25,1426917966,1426918716,1,2,750
26678134@N04,2112,27,1427665193,1427665532,2,21,339
26678134@N04,2112,16,1427665532,1427665823,3,21,291
26678134@N04,2112,15,1427665823,1427665934,2,21,111
26678134@N04,2112,26,1427665934,1427666114,3,21,180
26678134@N04,2112,19,1427666142,1427666562,6,21,420
26678134@N04,2112,20,1427666986,1427668066,5,21,1080
26678134@N04,2112,24,1427672108,1427672588,3,21,480
26678134@N04,2112,8,1427676236,1427676356,2,21,120
26678134@N04,2112,10,1427676429,1427676849,2,21,420
26678134@N04,2112,18,1427678532,1427679385,2,21,853
26678134@N04,2112,19,1427679385,1427679805,2,21,420
26678134@N04,2112,18,1427681294,1427681710,3,21,416
26678134@N04,2112,19,1427681710,1427682130,3,21,420
26678134@N04,2112,18,1427683073,1427684873,2,21,1800
26678134@N04,2112,27,1427691600,1427692800,2,21,1200
26678134@N04,2112,10,1427693404,1427693824,2,21,420
26678134@N04,2112,25,1427695893,1427696328,2,21,435
26678134@N04,2112,17,1427696328,1427696463,2,21,135
26678134@N04,2112,16,1427696463,1427697183,3,21,720
26678134@N04,2112,24,1427699497,1427699620,2,21,123
26678134@N04,2112,25,1427699620,1427700370,1,21,750
26678134@N04,2113,23,1428045350,1428045440,2,8,90
26678134@N04,2113,24,1428046318,1428046608,2,8,290
26678134@N04,2113,21,1428046608,1428047058,2,8,450
26678134@N04,2113,26,1428048076,1428048256,2,8,180
26678134@N04,2113,16,1428050140,1428050463,2,8,323
26678134@N04,2113,1,1428050463,1428050864,2,8,401
26678134@N04,2113,10,1428050864,1428051284,2,8,420
26678134@N04,2113,16,1428056773,1428057493,1,8,720
26678134@N04,2114,27,1428618003,1428618287,2,21,284
26678134@N04,2114,16,1428618287,1428618446,2,21,159
26678134@N04,2114,17,1428618446,1428618528,2,21,82
26678134@N04,2114,22,1428618528,1428619074,4,21,546
26678134@N04,2114,19,1428619074,1428619494,7,21,420
26678134@N04,2114,20,1428619653,1428619920,2,21,267
26678134@N04,2114,22,1428619920,1428620520,2,21,600
26678134@N04,2114,14,1428620628,1428620748,2,21,120
26678134@N04,2114,9,1428620852,1428621092,2,21,240
26678134@N04,2114,2,1428621216,1428621306,2,21,90
26678134@N04,2114,1,1428621559,1428622159,3,21,600
26678134@N04,2114,10,1428623710,1428624130,2,21,420
26678134@N04,2114,22,1428624798,1428624911,2,21,113
26678134@N04,2114,20,1428624911,1428625235,3,21,324
26678134@N04,2114,22,1428625235,1428625292,2,21,57
26678134@N04,2114,26,1428625292,1428625334,2,21,42
26678134@N04,2114,23,1428625334,1428625398,2,21,64
26678134@N04,2114,26,1428625398,1428625461,2,21,63
26678134@N04,2114,25,1428625461,1428625756,3,21,295
26678134@N04,2114,26,1428625756,1428625864,2,21,108
26678134@N04,2114,25,1428625864,1428626614,1,21,750
26678134@N04,2115,19,1432166359,1432166779,2,3,420
26678134@N04,2115,20,1432167513,1432168593,2,3,1080
26678134@N04,2115,27,1432175514,1432176714,1,3,1200
26678134@N04,2116,14,1433385638,1433385758,1,1,120
26678134@N04,2117,4,1438218286,1438218562,2,8,276
26678134@N04,2117,5,1438218562,1438219282,2,8,720
26678134@N04,2117,10,1438221453,1438221756,2,8,303
26678134@N04,2117,13,1438221756,1438221991,4,8,235
26678134@N04,2117,17,1438221991,1438223371,3,8,1380
26678134@N04,2117,24,1438224536,1438225016,2,8,480
26678134@N04,2117,9,1438226028,1438226268,2,8,240
26678134@N04,2117,27,1438228594,1438229794,1,8,1200
26678134@N04,2118,27,1439507133,1439507510,2,17,377
26678134@N04,2118,17,1439507510,1439507626,3,17,116
26678134@N04,2118,26,1439507626,1439507659,3,17,33
26678134@N04,2118,17,1439507659,1439509039,2,17,1380
26678134@N04,2118,19,1439509402,1439509822,2,17,420
26678134@N04,2118,26,1439510566,1439510746,2,17,180
26678134@N04,2118,24,1439510853,1439510922,2,17,69
26678134@N04,2118,22,1439510922,1439511003,4,17,81
26678134@N04,2118,24,1439511003,1439511155,2,17,152
26678134@N04,2118,21,1439511155,1439511248,3,17,93
26678134@N04,2118,24,1439511248,1439511490,2,17,242
26678134@N04,2118,25,1439511490,1439512240,2,17,750
26678134@N04,2118,12,1439514069,1439514094,2,17,25
26678134@N04,2118,13,1439514094,1439514694,4,17,600
26678134@N04,2118,24,1439516777,1439517257,2,17,480
26678134@N04,2118,14,1439517423,1439517523,2,17,100
26678134@N04,2118,9,1439517523,1439517763,1,17,240
26678134@N04,2119,6,1440724158,1440724413,1,1,255
26678134@N04,2120,27,1441927013,1441927404,2,5,391
26678134@N04,2120,4,1441927404,1441928304,2,5,900
26678134@N04,2120,13,1441929972,1441930572,4,5,600
26678134@N04,2120,19,1441931367,1441931787,5,5,420
26678134@N04,2120,24,1441933922,1441934402,1,5,480
26678134@N04,2121,19,1443138611,1443139031,1,1,420
26678134@N04,2122,27,1443310575,1443311775,2,4,1200
26678134@N04,2122,25,1443315639,1443316389,2,4,750
26678134@N04,2122,22,1443317674,1443318274,2,4,600
26678134@N04,2122,19,1443321375,1443321795,1,4,420
26678134@N04,2123,18,1443832530,1443834330,2,2,1800
26678134@N04,2123,4,1443834574,1443835474,1,2,900
26678134@N04,2124,20,1444342806,1444343886,3,5,1080
26678134@N04,2124,10,1444348863,1444349283,2,5,420
26678134@N04,2124,15,1444349645,1444349825,3,5,180
26678134@N04,2124,18,1444351643,1444353443,2,5,1800
26678134@N04,2124,27,1444353843,1444355043,4,5,1200
26678134@N04,2125,22,1445380470,1445381070,2,3,600
26678134@N04,2125,7,1445386820,1445386910,2,3,90
26678134@N04,2125,18,1445388742,1445390542,1,3,1800
26678134@N04,2126,19,1446331653,1446332073,2,6,420
26678134@N04,2126,2,1446333795,1446333828,2,6,33
26678134@N04,2126,4,1446333828,1446334682,2,6,854
26678134@N04,2126,10,1446334682,1446335102,2,6,420
26678134@N04,2126,24,1446338956,1446339436,2,6,480
26678134@N04,2126,3,1446346748,1446347018,3,6,270
26678134@N04,2127,19,1446769545,1446769965,2,2,420
26678134@N04,2127,27,1446777261,1446778461,1,2,1200
26678134@N04,2128,16,1447234974,1447235694,2,3,720
26678134@N04,2128,6,1447236327,1447236582,2,3,255
26678134@N04,2128,1,1447240340,1447240940,1,3,600
26678134@N04,2129,19,1448615564,1448615984,2,3,420
26678134@N04,2129,13,1448623732,1448624332,2,3,600
26678134@N04,2129,27,1448624908,1448626108,2,3,1200
26678134@N04,2130,27,1449291094,1449291466,5,2,372
26678134@N04,2130,16,1449291466,1449292186,1,2,720
26678134@N04,2131,16,1449921220,1449921778,2,2,558
26678134@N04,2131,27,1449921778,1449922978,3,2,1200
26678134@N04,2132,27,1450473269,1450474024,6,7,755
26678134@N04,2132,4,1450474024,1450474392,2,7,368
26678134@N04,2132,1,1450474392,1450474992,2,7,600
26678134@N04,2132,13,1450478390,1450478990,2,7,600
26678134@N04,2132,19,1450480477,1450480897,2,7,420
26678134@N04,2132,24,1450483738,1450484218,3,7,480
26678134@N04,2132,16,1450485357,1450486077,1,7,720
26678134@N04,2133,27,1450913417,1450914617,4,3,1200
26678134@N04,2133,24,1450915785,1450916265,4,3,480
26678134@N04,2133,3,1450919928,1450920198,2,3,270
26678134@N04,2134,27,1451203171,1451204371,3,2,1200
26678134@N04,2134,24,1451205429,1451205909,1,2,480
26678134@N04,2135,17,1451362967,1451364347,27,2,1380
26678134@N04,2135,24,1451367144,1451367624,4,2,480
26678134@N04,2136,27,1451715550,1451716750,2,1,1200
26678134@N04,2137,22,1451891568,1451892168,2,5,600
26678134@N04,2137,23,1451896410,1451896500,2,5,90
26678134@N04,2137,3,1451897843,1451898113,2,5,270
26678134@N04,2137,21,1451899270,1451899720,2,5,450
26678134@N04,2137,27,1451899863,1451901063,2,5,1200
26678134@N04,2138,10,1452033286,1452033706,2,8,420
26678134@N04,2138,17,1452038555,1452039935,3,8,1380
26678134@N04,2138,25,1452039958,1452040117,2,8,159
26678134@N04,2138,26,1452040117,1452040297,2,8,180
26678134@N04,2138,18,1452042582,1452043517,2,8,935
26678134@N04,2138,22,1452043517,1452043814,2,8,297
26678134@N04,2138,25,1452043814,1452044564,2,8,750
26678134@N04,2138,27,1452051070,1452052270,1,8,1200
26678134@N04,2139,9,1452842613,1452842853,2,3,240
26678134@N04,2139,11,1452843433,1452843613,2,3,180
26678134@N04,2139,19,1452844610,1452845030,1,3,420
26678134@N04,2140,23,1452986174,1452986264,2,3,90
26678134@N04,2140,18,1452991841,1452993641,2,3,1800
26678134@N04,2140,27,1453014464,1453015664,1,3,1200
26678134@N04,2141,18,1453069607,1453071407,2,2,1800
26678134@N04,2141,23,1453079711,1453079801,1,2,90
26678134@N04,2142,17,1455229198,1455230578,2,4,1380
26678134@N04,2142,24,1455230636,1455231116,5,4,480
26678134@N04,2142,19,1455233633,1455234053,4,4,420
26678134@N04,2142,25,1455241357,1455242107,1,4,750
26678134@N04,2143,2,1455315641,1455315731,2,4,90
26678134@N04,2143,11,1455318076,1455318256,2,4,180
26678134@N04,2143,27,1455318728,1455319928,2,4,1200
26678134@N04,2143,18,1455322820,1455324620,1,4,1800
26678134@N04,2144,27,1456004750,1456005697,2,14,947
26678134@N04,2144,1,1456005697,1456006297,2,14,600
26678134@N04,2144,10,1456007155,1456007285,2,14,130
26678134@N04,2144,14,1456007285,1456007394,2,14,109
26678134@N04,2144,13,1456007394,1456007527,4,14,133
26678134@N04,2144,17,1456007527,1456007677,2,14,150
26678134@N04,2144,22,1456007677,1456007881,2,14,204
26678134@N04,2144,19,1456007881,1456008301,2,14,420
26678134@N04,2144,18,1456009283,1456009333,2,14,50
26678134@N04,2144,19,1456009333,1456009753,2,14,420
26678134@N04,2144,18,1456014710,1456016510,2,14,1800
26678134@N04,2144,4,1456038699,1456039599,2,14,900
26678134@N04,2144,13,1456039614,1456039977,3,14,363
26678134@N04,2144,22,1456039977,1456040577,1,14,600
26678134@N04,2145,27,1456465244,1456466444,1,1,1200
26678134@N04,2146,27,1456610963,1456612163,1,1,1200
26678134@N04,2147,22,1457830647,1457831247,2,5,600
26678134@N04,2147,9,1457831609,1457831849,2,5,240
26678134@N04,2147,27,1457834499,1457835699,2,5,1200
26678134@N04,2147,16,1457843603,1457843868,2,5,265
26678134@N04,2147,13,1457843868,1457844468,1,5,600
26678134@N04,2148,1,1458339050,1458339650,2,2,600
26678134@N04,2148,16,1458342847,1458343567,1,2,720
26678134@N04,2149,16,1458423121,1458423568,2,3,447
26678134@N04,2149,10,1458423568,1458423988,2,3,420
26678134@N04,2149,15,1458427638,1458427818,1,3,180
26678134@N04,2150,17,1459664156,1459665536,2,2,1380
26678134@N04,2150,14,1459666136,1459666256,1,2,120
26678134@N04,2151,13,1460076271,1460076871,1,1,600
26678134@N04,2152,15,1460156433,1460156613,3,2,180
26678134@N04,2152,11,1460160714,1460160894,1,2,180
26678134@N04,2153,18,1460274602,1460276402,1,1,1800
26678134@N04,2154,7,1460801069,1460801159,1,1,90
26678134@N04,2155,19,1463299629,1463300049,1,1,420
26680632@N04,2156,21,1275700215,1275700665,3,2,450
26680632@N04,2156,1,1275716492,1275717092,1,2,600
26754165@N08,2157,4,1290337926,1290338826,2,2,900
26754165@N08,2157,27,1290341931,1290343131,1,2,1200
26824176@N00,2158,27,1203297079,1203298279,4,2,1200
26824176@N00,2158,16,1203299401,1203300121,1,2,720
26859501@N00,2159,27,1269037868,1269039068,10,39,1200
26859501@N00,2159,19,1269039671,1269040091,5,39,420
26859501@N00,2159,20,1269040485,1269040734,2,39,249
26859501@N00,2159,19,1269040734,1269041154,29,39,420
26859501@N00,2159,20,1269042423,1269043503,6,39,1080
26859501@N00,2159,22,1269044126,1269044275,2,39,149
26859501@N00,2159,26,1269044275,1269044440,2,39,165
26859501@N00,2159,17,1269044440,1269045256,5,39,816
26859501@N00,2159,18,1269045256,1269045661,3,39,405
26859501@N00,2159,13,1269045661,1269045793,3,39,132
26859501@N00,2159,18,1269045793,1269046002,3,39,209
26859501@N00,2159,13,1269046002,1269046602,5,39,600
26859501@N00,2159,17,1269046976,1269048356,4,39,1380
26859501@N00,2159,26,1269049558,1269049738,3,39,180
26859501@N00,2159,20,1269052124,1269053012,2,39,888
26859501@N00,2159,19,1269053012,1269053432,5,39,420
26859501@N00,2159,22,1269053510,1269053748,3,39,238
26859501@N00,2159,26,1269053748,1269053770,2,39,22
26859501@N00,2159,17,1269053770,1269054088,4,39,318
26859501@N00,2159,16,1269054088,1269054129,2,39,41
26859501@N00,2159,14,1269054129,1269054249,2,39,120
26859501@N00,2159,12,1269054328,1269054950,2,39,622
26859501@N00,2159,15,1269054950,1269055130,7,39,180
26859501@N00,2159,12,1269056269,1269056485,12,39,216
26859501@N00,2159,13,1269056485,1269056705,7,39,220
26859501@N00,2159,12,1269056705,1269056756,2,39,51
26859501@N00,2159,13,1269056756,1269056852,4,39,96
26859501@N00,2159,12,1269056852,1269056974,5,39,122
26859501@N00,2159,15,1269056974,1269057154,11,39,180
26859501@N00,2159,9,1269057613,1269057853,4,39,240
26859501@N00,2159,1,1269058710,1269059310,6,39,600
26859501@N00,2159,8,1269062590,1269062710,13,39,120
26859501@N00,2159,11,1269062865,1269063045,2,39,180
26859501@N00,2159,27,1269064523,1269065552,2,39,1029
26859501@N00,2159,20,1269065552,1269065764,4,39,212
26859501@N00,2159,21,1269065764,1269066214,3,39,450
26859501@N00,2159,24,1269067639,1269068119,4,39,480
26859501@N00,2159,11,1269071316,1269071496,2,39,180
26859501@N00,2159,27,1269072066,1269073266,11,39,1200
26859501@N00,2160,27,1281365936,1281366774,2,2,838
26859501@N00,2160,19,1281366774,1281367194,1,2,420
26874770@N06,2161,27,1188095710,1188096910,3,6,1200
26874770@N06,2161,4,1188113919,1188114819,2,6,900
26874770@N06,2161,27,1188122809,1188123097,2,6,288
26874770@N06,2161,4,1188123097,1188123997,2,6,900
26874770@N06,2161,17,1188128849,1188130229,2,6,1380
26874770@N06,2161,1,1188136200,1188136800,1,6,600
26874770@N06,2162,27,1191488945,1191490145,1,1,1200
26874770@N06,2163,27,1191751616,1191752816,2,3,1200
26874770@N06,2163,2,1191769029,1191769119,2,3,90
26874770@N06,2163,27,1191772861,1191774061,3,3,1200
26874770@N06,2164,27,1191826411,1191827611,4,1,1200
26874770@N06,2165,16,1197359302,1197360022,2,2,720
26874770@N06,2165,3,1197379376,1197379646,2,2,270
26874770@N06,2166,27,1204255847,1204257047,2,2,1200
26874770@N06,2166,18,1204261158,1204262958,1,2,1800
26874770@N06,2167,27,1204941029,1204942229,1,1,1200
26874770@N06,2168,25,1226642202,1226642346,3,32,144
26874770@N06,2168,22,1226642346,1226642357,2,32,11
26874770@N06,2168,23,1226642357,1226642371,2,32,14
26874770@N06,2168,14,1226642371,1226642373,2,32,2
26874770@N06,2168,22,1226642373,1226642386,2,32,13
26874770@N06,2168,23,1226642386,1226642389,2,32,3
26874770@N06,2168,14,1226642389,1226642453,3,32,64
26874770@N06,2168,23,1226642453,1226642503,3,32,50
26874770@N06,2168,24,1226642503,1226642545,3,32,42
26874770@N06,2168,23,1226642545,1226642611,2,32,66
26874770@N06,2168,21,1226642611,1226642669,4,32,58
26874770@N06,2168,14,1226642669,1226642789,4,32,120
26874770@N06,2168,19,1226642801,1226643221,3,32,420
26874770@N06,2168,17,1226643302,1226643321,2,32,19
26874770@N06,2168,26,1226643321,1226643385,3,32,64
26874770@N06,2168,17,1226643385,1226643649,9,32,264
26874770@N06,2168,13,1226643649,1226643855,6,32,206
26874770@N06,2168,12,1226643855,1226643875,2,32,20
26874770@N06,2168,15,1226643875,1226644017,4,32,142
26874770@N06,2168,14,1226644017,1226644137,3,32,120
26874770@N06,2168,12,1226644226,1226644311,2,32,85
26874770@N06,2168,14,1226644311,1226644417,2,32,106
26874770@N06,2168,9,1226644417,1226644647,2,32,230
26874770@N06,2168,7,1226644647,1226644737,2,32,90
26874770@N06,2168,2,1226645400,1226645490,2,32,90
26874770@N06,2168,16,1226648184,1226648904,3,32,720
26874770@N06,2168,3,1226649489,1226649759,3,32,270
26874770@N06,2168,14,1226651634,1226651754,3,32,120
26874770@N06,2168,16,1226652356,1226653076,10,32,720
26874770@N06,2168,12,1226653766,1226654606,4,32,840
26874770@N06,2168,3,1226656951,1226657221,2,32,270
26874770@N06,2168,13,1226660081,1226660681,8,32,600
26874770@N06,2169,25,1226814915,1226815113,2,12,198
26874770@N06,2169,17,1226815113,1226815152,2,12,39
26874770@N06,2169,15,1226815152,1226815225,3,12,73
26874770@N06,2169,9,1226815225,1226815243,2,12,18
26874770@N06,2169,12,1226815243,1226815260,2,12,17
26874770@N06,2169,14,1226815260,1226815298,3,12,38
26874770@N06,2169,9,1226815298,1226815510,2,12,212
26874770@N06,2169,16,1226815510,1226816230,2,12,720
26874770@N06,2169,15,1226818807,1226818987,2,12,180
26874770@N06,2169,14,1226819249,1226819321,2,12,72
26874770@N06,2169,16,1226819321,1226819583,2,12,262
26874770@N06,2169,21,1226819583,1226820033,2,12,450
26874770@N06,2170,27,1231538879,1231540079,1,1,1200
26874770@N06,2171,16,1234775843,1234776563,1,1,720
26874770@N06,2172,4,1235949941,1235950841,2,22,900
26874770@N06,2172,9,1235952316,1235952556,5,22,240
26874770@N06,2172,2,1235952718,1235952808,2,22,90
26874770@N06,2172,9,1235952940,1235953180,2,22,240
26874770@N06,2172,14,1235953671,1235953791,8,22,120
26874770@N06,2172,15,1235955523,1235955703,2,22,180
26874770@N06,2172,12,1235956470,1235957310,6,22,840
26874770@N06,2172,14,1235957728,1235957848,2,22,120
26874770@N06,2172,12,1235957852,1235958151,2,22,299
26874770@N06,2172,14,1235958151,1235958271,4,22,120
26874770@N06,2172,1,1235961178,1235961546,2,22,368
26874770@N06,2172,4,1235961546,1235962274,2,22,728
26874770@N06,2172,27,1235962274,1235963474,5,22,1200
26874770@N06,2172,8,1235963746,1235963866,7,22,120
26874770@N06,2172,12,1235964626,1235964918,2,22,292
26874770@N06,2172,15,1235964918,1235965098,6,22,180
26874770@N06,2172,13,1235965539,1235966139,2,22,600
26874770@N06,2172,23,1235971134,1235971224,3,22,90
26874770@N06,2172,24,1235972150,1235972630,2,22,480
26874770@N06,2172,16,1235978204,1235978924,2,22,720
26874770@N06,2172,12,1235980862,1235981583,2,22,721
26874770@N06,2172,24,1235981583,1235982063,1,22,480
26874770@N06,2173,9,1245499897,1245500137,1,1,240
26874770@N06,2174,27,1251500792,1251501215,2,14,423
26874770@N06,2174,16,1251501215,1251501935,2,14,720
26874770@N06,2174,14,1251503347,1251503467,3,14,120
26874770@N06,2174,9,1251520557,1251520797,2,14,240
26874770@N06,2174,17,1251526808,1251528188,4,14,1380
26874770@N06,2174,16,1251530415,1251531135,2,14,720
26874770@N06,2174,24,1251531538,1251531848,2,14,310
26874770@N06,2174,23,1251531848,1251531938,4,14,90
26874770@N06,2174,26,1251533364,1251533536,2,14,172
26874770@N06,2174,25,1251533536,1251534286,6,14,750
26874770@N06,2174,24,1251534306,1251534786,3,14,480
26874770@N06,2174,22,1251540380,1251540640,2,14,260
26874770@N06,2174,15,1251540640,1251540820,2,14,180
26874770@N06,2174,27,1251550371,1251551571,1,14,1200
26874770@N06,2175,2,1281267502,1281267592,1,1,90
26874770@N06,2176,16,1281395713,1281395979,2,6,266
26874770@N06,2176,9,1281395979,1281396144,2,6,165
26874770@N06,2176,14,1281396144,1281396264,2,6,120
26874770@N06,2176,9,1281396374,1281396614,4,6,240
26874770@N06,2176,14,1281397175,1281397295,2,6,120
26874770@N06,2176,2,1281415811,1281415901,1,6,90
26874770@N06,2177,1,1281445446,1281446046,1,1,600
26874770@N06,2178,27,1281705510,1281706710,3,2,1200
26874770@N06,2178,1,1281715263,1281715863,1,2,600
26874770@N06,2179,14,1281839384,1281839442,3,9,58
26874770@N06,2179,16,1281839442,1281839474,2,9,32
26874770@N06,2179,14,1281839474,1281839594,3,9,120
26874770@N06,2179,12,1281839953,1281840516,4,9,563
26874770@N06,2179,9,1281840516,1281840734,4,9,218
26874770@N06,2179,1,1281840734,1281840991,2,9,257
26874770@N06,2179,2,1281840991,1281841081,4,9,90
26874770@N06,2179,1,1281841461,1281841696,2,9,235
26874770@N06,2179,2,1281841696,1281841786,1,9,90
26888485@N08,2180,23,1371431215,1371431305,1,1,90
26893451@N02,2181,8,1360465762,1360465882,3,2,120
26893451@N02,2181,17,1360469561,1360470941,1,2,1380
26897917@N02,2182,1,1422667407,1422667411,2,2,4
26897917@N02,2182,27,1422667411,1422668611,1,2,1200
26913230@N03,2183,16,1248231794,1248232514,12,1,720
27027561@N03,2184,27,1298604945,1298606145,1,1,1200
27027561@N03,2185,27,1382537645,1382538845,2,3,1200
27027561@N03,2185,2,1382541437,1382541527,2,3,90
27027561@N03,2185,16,1382549589,1382550309,1,3,720
27027561@N03,2186,13,1382848336,1382848936,2,3,600
27027561@N03,2186,16,1382853968,1382854336,2,3,368
27027561@N03,2186,2,1382854336,1382854426,1,3,90
27064297@N04,2187,21,1360408889,1360409339,1,1,450
27064629@N00,2188,16,1403216576,1403217296,3,4,720
27064629@N00,2188,14,1403217384,1403217504,8,4,120
27064629@N00,2188,15,1403222575,1403222755,3,4,180
27064629@N00,2188,10,1403224477,1403224897,3,4,420
27064629@N00,2189,14,1403259087,1403259207,4,2,120
27064629@N00,2189,9,1403259840,1403260080,3,2,240
27178638@N00,2190,16,1359065621,1359066341,2,4,720
27178638@N00,2190,1,1359077951,1359078551,2,4,600
27178638@N00,2190,16,1359081901,1359082621,2,4,720
27178638@N00,2190,27,1359098983,1359100183,1,4,1200
27178638@N00,2191,20,1368609358,1368610438,2,2,1080
27178638@N00,2191,16,1368614217,1368614937,1,2,720
27182886@N02,2192,25,1451423038,1451423578,2,3,540
27182886@N02,2192,7,1451423578,1451423668,2,3,90
27182886@N02,2192,3,1451425100,1451425370,1,3,270
27233089@N04,2193,19,1251768267,1251768687,1,1,420
27233089@N04,2194,4,1256611062,1256611962,1,1,900
27233089@N04,2195,27,1298608235,1298609435,2,4,1200
27233089@N04,2195,11,1298622138,1298622318,2,4,180
27233089@N04,2195,17,1298629308,1298630688,3,4,1380
27233089@N04,2195,16,1298631254,1298631974,2,4,720
27249103@N05,2196,16,1227005796,1227006516,1,1,720
27270108@N05,2197,27,1306543330,1306544530,22,1,1200
27270108@N05,2198,27,1307000504,1307001704,23,1,1200
27270108@N05,2199,27,1307072873,1307074073,14,1,1200
27270108@N05,2200,27,1307158320,1307159520,12,1,1200
27270108@N05,2201,22,1339407570,1339408170,3,1,600
27270108@N05,2202,17,1339478177,1339479557,2,1,1380
27270108@N05,2203,19,1339553145,1339553565,3,2,420
27270108@N05,2203,17,1339564867,1339566247,4,2,1380
27270108@N05,2204,22,1339808967,1339809567,2,2,600
27270108@N05,2204,17,1339823840,1339825220,14,2,1380
27270108@N05,2205,17,1357013873,1357015253,19,1,1380
27270108@N05,2206,9,1403265949,1403266189,4,1,240
27312248@N04,2207,2,1216123302,1216123392,4,4,90
27312248@N04,2207,27,1216133081,1216133088,3,4,7
27312248@N04,2207,17,1216133088,1216133246,3,4,158
27312248@N04,2207,20,1216133246,1216134326,1,4,1080
27312709@N00,2208,15,1280643763,1280643943,1,1,180
27316914@N02,2209,23,1194348854,1194348944,1,1,90
27338137@N06,2210,27,1253835640,1253836840,1,1,1200
27338137@N06,2211,27,1319065187,1319066387,2,2,1200
27338137@N06,2211,14,1319068168,1319068288,1,2,120
27372897@N00,2212,27,1353025357,1353026557,2,1,1200
27372897@N00,2213,27,1353265766,1353266966,1,1,1200
27373375@N03,2214,27,1443958440,1443959640,2,1,1200
27373375@N03,2215,27,1444139716,1444140916,1,1,1200
27383466@N02,2216,16,1230654688,1230655408,3,1,720
27383466@N02,2217,16,1248161930,1248162650,1,1,720
27429042@N08,2218,17,1192534496,1192535876,1,1,1380
27429042@N08,2219,23,1231277963,1231278053,3,9,90
27429042@N08,2219,20,1231280563,1231281643,3,9,1080
27429042@N08,2219,17,1231282011,1231282192,2,9,181
27429042@N08,2219,19,1231282192,1231282612,2,9,420
27429042@N08,2219,9,1231287750,1231287990,2,9,240
27429042@N08,2219,14,1231290805,1231290893,4,9,88
27429042@N08,2219,16,1231290893,1231291613,3,9,720
27429042@N08,2219,14,1231291695,1231291815,2,9,120
27429042@N08,2219,8,1231292481,1231292601,2,9,120
27429042@N08,2220,27,1231651461,1231652661,2,2,1200
27429042@N08,2220,4,1231662302,1231663202,1,2,900
27429042@N08,2221,22,1264308549,1264309149,2,6,600
27429042@N08,2221,13,1264312046,1264312415,2,6,369
27429042@N08,2221,17,1264312415,1264313718,2,6,1303
27429042@N08,2221,15,1264313718,1264313882,2,6,164
27429042@N08,2221,16,1264313882,1264314602,2,6,720
27429042@N08,2221,14,1264315226,1264315346,1,6,120
27429042@N08,2222,20,1267499751,1267500287,2,5,536
27429042@N08,2222,18,1267500287,1267501092,2,5,805
27429042@N08,2222,19,1267501092,1267501512,2,5,420
27429042@N08,2222,17,1267501751,1267502273,2,5,522
27429042@N08,2222,16,1267502273,1267502993,2,5,720
27429042@N08,2223,27,1268352509,1268353709,2,3,1200
27429042@N08,2223,26,1268353941,1268354121,2,3,180
27429042@N08,2223,18,1268358817,1268360617,1,3,1800
27429042@N08,2224,19,1272948638,1272949058,2,2,420
27429042@N08,2224,20,1272953691,1272954771,1,2,1080
27429042@N08,2225,27,1273632029,1273633229,4,3,1200
27429042@N08,2225,21,1273635611,1273636061,2,3,450
27429042@N08,2225,1,1273643835,1273644435,1,3,600
27429042@N08,2226,16,1274396542,1274396866,2,3,324
27429042@N08,2226,14,1274396866,1274396986,3,3,120
27429042@N08,2226,27,1274399854,1274401054,1,3,1200
27429042@N08,2227,16,1292291107,1292291827,4,6,720
27429042@N08,2227,14,1292292439,1292292559,3,6,120
27429042@N08,2227,9,1292292629,1292292869,2,6,240
27429042@N08,2227,2,1292294413,1292294503,2,6,90
27429042@N08,2227,1,1292294594,1292295194,2,6,600
27429042@N08,2227,11,1292301952,1292302132,1,6,180
27429042@N08,2228,21,1300760892,1300761342,2,4,450
27429042@N08,2228,19,1300769093,1300769164,2,4,71
27429042@N08,2228,13,1300769164,1300769764,4,4,600
27429042@N08,2228,9,1300795805,1300796045,1,4,240
27429042@N08,2229,14,1322092211,1322092331,1,1,120
27429042@N08,2230,26,1331075362,1331075403,2,7,41
27429042@N08,2230,23,1331075403,1331075493,2,7,90
27429042@N08,2230,18,1331077567,1331079367,2,7,1800
27429042@N08,2230,2,1331085056,1331085146,2,7,90
27429042@N08,2230,1,1331095060,1331095660,2,7,600
27429042@N08,2230,27,1331103792,1331104992,2,7,1200
27429042@N08,2230,21,1331105676,1331106126,1,7,450
27429042@N08,2231,8,1349321611,1349321731,1,1,120
27432207@N05,2232,25,1212800580,1212801330,1,1,750
27457334@N02,2233,16,1333631424,1333632144,2,2,720
27457334@N02,2233,27,1333634737,1333635937,1,2,1200
27527078@N05,2234,27,1360454240,1360455440,15,10,1200
27527078@N05,2234,14,1360457142,1360457262,14,10,120
27527078@N05,2234,6,1360465424,1360465679,2,10,255
27527078@N05,2234,14,1360468369,1360468489,2,10,120
27527078@N05,2234,16,1360469704,1360470424,9,10,720
27527078@N05,2234,9,1360471281,1360471521,17,10,240
27527078@N05,2234,6,1360479310,1360479565,5,10,255
27527078@N05,2234,1,1360479763,1360480363,2,10,600
27527078@N05,2234,3,1360481431,1360481701,6,10,270
27527078@N05,2234,4,1360484217,1360485117,2,10,900
27527078@N05,2235,27,1360622268,1360623468,7,9,1200
27527078@N05,2235,7,1360627474,1360627564,4,9,90
27527078@N05,2235,1,1360628473,1360629073,2,9,600
27527078@N05,2235,23,1360636007,1360636097,11,9,90
27527078@N05,2235,19,1360640974,1360641394,8,9,420
27527078@N05,2235,22,1360642967,1360643567,3,9,600
27527078@N05,2235,15,1360644724,1360644904,8,9,180
27527078@N05,2235,12,1360646191,1360647031,3,9,840
27527078@N05,2235,20,1360653389,1360654469,4,9,1080
27527078@N05,2236,1,1360893418,1360893441,4,7,23
27527078@N05,2236,6,1360893441,1360893458,2,7,17
27527078@N05,2236,9,1360893458,1360893581,2,7,123
27527078@N05,2236,6,1360893581,1360893836,2,7,255
27527078@N05,2236,17,1360903264,1360904644,3,7,1380
27527078@N05,2236,20,1360908267,1360909347,2,7,1080
27527078@N05,2236,14,1360917333,1360917453,1,7,120
27528021@N06,2237,16,1413751530,1413752250,138,1,720
27528021@N06,2238,16,1414011118,1414011838,130,1,720
27539218@N06,2239,16,1210399888,1210400608,1,1,720
27539218@N06,2240,19,1216371889,1216372309,3,2,420
27539218@N06,2240,13,1216372475,1216373075,1,2,600
27539218@N06,2241,21,1216470112,1216470562,1,1,450
27539218@N06,2242,27,1221800707,1221801907,4,1,1200
27539218@N06,2243,27,1222061249,1222062449,2,1,1200
27539218@N06,2244,16,1224749728,1224750448,1,1,720
27539218@N06,2245,9,1228633352,1228633592,1,1,240
27539218@N06,2246,16,1230036938,1230037658,1,1,720
27539218@N06,2247,27,1230444299,1230445499,2,2,1200
27539218@N06,2247,3,1230452748,1230453018,1,2,270
27539218@N06,2248,24,1231996943,1231997423,2,4,480
27539218@N06,2248,20,1231998110,1231999190,6,4,1080
27539218@N06,2248,22,1232000639,1232001239,5,4,600
27539218@N06,2248,12,1232002111,1232002951,3,4,840
27539218@N06,2249,27,1234655186,1234656386,5,3,1200
27539218@N06,2249,21,1234666007,1234666457,2,3,450
27539218@N06,2249,12,1234668045,1234668885,2,3,840
27539218@N06,2250,3,1244090674,1244090944,1,1,270
27539218@N06,2251,27,1245838743,1245839943,1,1,1200
27539218@N06,2252,14,1248176612,1248176616,2,2,4
27539218@N06,2252,6,1248176616,1248176871,1,2,255
27539218@N06,2253,27,1260667111,1260668311,2,7,1200
27539218@N06,2253,24,1260670525,1260671005,2,7,480
27539218@N06,2253,21,1260671545,1260671995,5,7,450
27539218@N06,2253,14,1260681447,1260681567,2,7,120
27539218@N06,2253,9,1260688014,1260688254,2,7,240
27539218@N06,2253,4,1260689267,1260690167,4,7,900
27539218@N06,2253,27,1260709142,1260710342,1,7,1200
27539218@N06,2254,1,1261291483,1261292083,6,1,600
27557422@N08,2255,1,1212775123,1212775723,2,2,600
27557422@N08,2255,3,1212778010,1212778280,2,2,270
27618178@N08,2256,16,1351926991,1351927711,2,1,720
27624680@N02,2257,16,1303636611,1303637331,1,1,720
27719489@N06,2258,12,1325388380,1325389220,2,1,840
27724919@N02,2259,27,1212727127,1212728327,1,1,1200
27724919@N02,2260,27,1212886913,1212888113,3,1,1200
27724919@N02,2261,27,1213059639,1213060839,6,1,1200
27794725@N03,2262,16,1441875828,1441876548,1,1,720
27794725@N03,2263,13,1442543733,1442544333,1,1,600
27813472@N00,2264,16,1422229414,1422230134,2,4,720
27813472@N00,2264,27,1422232280,1422233480,6,4,1200
27813472@N00,2264,19,1422241323,1422241743,2,4,420
27813472@N00,2264,22,1422241749,1422242349,2,4,600
27813472@N00,2265,23,1422314176,1422314266,2,4,90
27813472@N00,2265,16,1422320877,1422321597,2,4,720
27813472@N00,2265,24,1422327490,1422327970,2,4,480
27813472@N00,2265,27,1422329679,1422330879,1,4,1200
27813472@N00,2266,17,1422570779,1422570811,2,2,32
27813472@N00,2266,26,1422570811,1422570991,1,2,180
27830299@N06,2267,8,1197007407,1197007527,2,2,120
27830299@N06,2267,19,1197012440,1197012860,1,2,420
27835170@N07,2268,16,1381017629,1381018349,1,1,720
27835170@N07,2269,10,1411804352,1411804772,1,1,420
27853624@N00,2270,2,1230190163,1230190253,1,1,90
27865886@N08,2271,11,1219488466,1219488646,4,1,180
27874898@N00,2272,27,1349571243,1349572443,6,13,1200
27874898@N00,2272,13,1349577106,1349577706,10,13,600
27874898@N00,2272,19,1349579103,1349579523,4,13,420
27874898@N00,2272,20,1349582045,1349582692,3,13,647
27874898@N00,2272,21,1349582692,1349583142,13,13,450
27874898@N00,2272,20,1349584272,1349584542,8,13,270
27874898@N00,2272,19,1349584542,1349584962,2,13,420
27874898@N00,2272,15,1349586346,1349586526,5,13,180
27874898@N00,2272,5,1349590996,1349591716,2,13,720
27874898@N00,2272,4,1349592637,1349592643,2,13,6
27874898@N00,2272,2,1349592643,1349592669,2,13,26
27874898@N00,2272,1,1349592669,1349593269,2,13,600
27874898@N00,2272,27,1349594836,1349596036,1,13,1200
27874898@N00,2273,19,1350088987,1350089407,4,9,420
27874898@N00,2273,11,1350093344,1350093524,7,9,180
27874898@N00,2273,1,1350096464,1350096530,4,9,66
27874898@N00,2273,4,1350096530,1350096565,3,9,35
27874898@N00,2273,5,1350096565,1350096627,2,9,62
27874898@N00,2273,6,1350096627,1350096882,2,9,255
27874898@N00,2273,5,1350097379,1350098099,2,9,720
27874898@N00,2273,3,1350099108,1350099378,2,9,270
27874898@N00,2273,20,1350124620,1350125700,1,9,1080
27874898@N00,2274,20,1367900108,1367901188,2,5,1080
27874898@N00,2274,6,1367903895,1367904150,2,5,255
27874898@N00,2274,27,1367908887,1367910087,4,5,1200
27874898@N00,2274,2,1367913601,1367913691,2,5,90
27874898@N00,2274,1,1367913841,1367914441,2,5,600
27874898@N00,2275,16,1368087780,1368088500,2,7,720
27874898@N00,2275,10,1368090324,1368090744,29,7,420
27874898@N00,2275,9,1368092431,1368092518,3,7,87
27874898@N00,2275,6,1368092518,1368092773,2,7,255
27874898@N00,2275,2,1368093481,1368093571,12,7,90
27874898@N00,2275,3,1368094058,1368094328,2,7,270
27874898@N00,2275,21,1368100263,1368100713,1,7,450
27874898@N00,2276,27,1378605253,1378606453,23,3,1200
27874898@N00,2276,2,1378635081,1378635171,7,3,90
27874898@N00,2276,27,1378638704,1378639904,1,3,1200
27874898@N00,2277,27,1378973893,1378975093,2,7,1200
27874898@N00,2277,20,1378975823,1378976903,6,7,1080
27874898@N00,2277,18,1378978338,1378978488,3,7,150
27874898@N00,2277,20,1378978488,1378979568,3,7,1080
27874898@N00,2277,5,1378980910,1378981070,2,7,160
27874898@N00,2277,6,1378981070,1378981143,2,7,73
27874898@N00,2277,1,1378981143,1378981743,4,7,600
27874898@N00,2278,21,1379132627,1379133077,2,3,450
27874898@N00,2278,20,1379136290,1379137370,3,3,1080
27874898@N00,2278,27,1379139309,1379140509,2,3,1200
27902479@N02,2279,4,1394666476,1394667376,2,3,900
27902479@N02,2279,18,1394672840,1394674640,2,3,1800
27902479@N02,2279,21,1394677826,1394678276,1,3,450
27907946@N04,2280,16,1215842379,1215843099,11,1,720
27914975@N06,2281,27,1379029381,1379030581,2,4,1200
27914975@N06,2281,19,1379032554,1379032974,2,4,420
27914975@N06,2281,18,1379033213,1379035013,2,4,1800
27914975@N06,2281,6,1379043280,1379043535,2,4,255
27934342@N00,2282,14,1326929372,1326929492,3,1,120
27967379@N08,2283,13,1410314037,1410314440,3,12,403
27967379@N08,2283,22,1410314440,1410314686,2,12,246
27967379@N08,2283,20,1410314686,1410315766,3,12,1080
27967379@N08,2283,21,1410316270,1410316720,3,12,450
27967379@N08,2283,20,1410321360,1410322440,5,12,1080
27967379@N08,2283,9,1410325890,1410326130,3,12,240
27967379@N08,2283,3,1410329820,1410330090,6,12,270
27967379@N08,2283,1,1410333378,1410333978,3,12,600
27967379@N08,2283,25,1410341451,1410342201,3,12,750
27967379@N08,2283,21,1410343517,1410343967,5,12,450
27967379@N08,2283,17,1410345036,1410346416,4,12,1380
27967379@N08,2283,27,1410352764,1410353964,3,12,1200
27976717@N05,2284,27,1220759838,1220761038,3,2,1200
27976717@N05,2284,17,1220767188,1220768568,1,2,1380
28004076@N04,2285,13,1399697288,1399697888,2,1,600
28019195@N07,2286,20,1418927668,1418928748,1,1,1080
28031728@N02,2287,3,1267490049,1267490319,1,1,270
28031728@N02,2288,14,1267638494,1267638614,1,1,120
28031728@N02,2289,22,1267781903,1267782503,1,1,600
28031728@N02,2290,17,1268111903,1268113283,1,1,1380
28031728@N02,2291,15,1268190551,1268190731,1,1,180
28031728@N02,2292,27,1268245989,1268247189,1,1,1200
28031728@N02,2293,21,1268727988,1268728438,1,1,450
28031728@N02,2294,21,1268935332,1268935782,1,1,450
28031728@N02,2295,27,1269022832,1269024032,1,1,1200
28031728@N02,2296,4,1270276547,1270277447,1,1,900
28031728@N02,2297,3,1270328053,1270328323,1,1,270
28057734@N03,2298,16,1313922312,1313923032,1,1,720
28057734@N03,2299,18,1316220220,1316220227,4,2,7
28057734@N03,2299,19,1316220227,1316220647,1,2,420
28065533@N00,2300,14,1356053221,1356053341,1,1,120
28069677@N00,2301,16,1223765002,1223765722,3,1,720
28069677@N00,2302,12,1223797978,1223798818,1,1,840
28069677@N00,2303,13,1224023935,1224024535,2,3,600
28069677@N00,2303,11,1224030999,1224031179,2,3,180
28069677@N00,2303,27,1224045293,1224046493,7,3,1200
28069677@N00,2304,27,1224127455,1224128655,3,1,1200
28083255@N00,2305,14,1416521208,1416521328,3,2,120
28083255@N00,2305,19,1416533064,1416533484,1,2,420
28083255@N00,2306,19,1443484723,1443485143,1,1,420
28083255@N00,2307,1,1443662428,1443663028,2,1,600
28113539@N07,2308,27,1222130042,1222130447,2,18,405
28113539@N07,2308,16,1222130447,1222130481,2,18,34
28113539@N07,2308,27,1222130481,1222131608,2,18,1127
28113539@N07,2308,16,1222131608,1222132049,2,18,441
28113539@N07,2308,24,1222132049,1222132218,2,18,169
28113539@N07,2308,21,1222132218,1222132668,4,18,450
28113539@N07,2308,22,1222133653,1222134253,4,18,600
28113539@N07,2308,26,1222135163,1222135343,2,18,180
28113539@N07,2308,23,1222137063,1222137153,2,18,90
28113539@N07,2308,21,1222138056,1222138425,2,18,369
28113539@N07,2308,18,1222138425,1222138603,3,18,178
28113539@N07,2308,13,1222138603,1222138764,4,18,161
28113539@N07,2308,17,1222138764,1222139011,2,18,247
28113539@N07,2308,13,1222139011,1222139611,2,18,600
28113539@N07,2308,16,1222139921,1222140641,2,18,720
28113539@N07,2308,3,1222140940,1222141210,2,18,270
28113539@N07,2308,16,1222143329,1222144049,2,18,720
28113539@N07,2308,27,1222146162,1222147362,6,18,1200
28132447@N00,2309,17,1292585656,1292587036,2,1,1380
28163344@N08,2310,15,1446763413,1446763593,2,3,180
28163344@N08,2310,27,1446769088,1446770288,2,3,1200
28163344@N08,2310,6,1446777698,1446777953,1,3,255
28203925@N08,2311,27,1344990673,1344991873,1,1,1200
28215341@N07,2312,10,1424299536,1424299956,1,1,420
28223347@N00,2313,17,1298626882,1298627022,4,10,140
28223347@N00,2313,16,1298627022,1298627351,2,10,329
28223347@N00,2313,14,1298627351,1298627471,4,10,120
28223347@N00,2313,17,1298628037,1298628453,2,10,416
28223347@N00,2313,26,1298628453,1298628633,2,10,180
28223347@N00,2313,20,1298628645,1298628975,3,10,330
28223347@N00,2313,19,1298628975,1298629395,4,10,420
28223347@N00,2313,22,1298630203,1298630518,2,10,315
28223347@N00,2313,17,1298630518,1298630886,2,10,368
28223347@N00,2313,4,1298630886,1298631786,1,10,900
28245557@N00,2314,15,1416951902,1416952082,2,3,180
28245557@N00,2314,27,1416961046,1416962246,2,3,1200
28245557@N00,2314,21,1416971032,1416971482,1,3,450
28267103@N07,2315,9,1193272898,1193273138,1,1,240
28289318@N07,2316,27,1433193187,1433194387,70,1,1200
28289318@N07,2317,27,1433336164,1433337364,13,1,1200
28289318@N07,2318,27,1433457412,1433458612,70,1,1200
28305413@N07,2319,27,1390893442,1390894642,1,1,1200
28311054@N03,2320,16,1197064660,1197065380,1,1,720
28311054@N03,2321,16,1197920570,1197921290,2,1,720
28311054@N03,2322,16,1214853509,1214854229,7,1,720
28312366@N08,2323,14,1387867997,1387868117,1,1,120
28416483@N03,2324,17,1342576495,1342576718,2,2,223
28416483@N03,2324,16,1342576718,1342577438,2,2,720
28416483@N03,2325,16,1342821758,1342822478,1,1,720
28416483@N03,2326,16,1342852889,1342853609,3,2,720
28416483@N03,2326,27,1342857873,1342859073,2,2,1200
28416483@N03,2327,15,1343113755,1343113935,2,2,180
28416483@N03,2327,16,1343117884,1343118604,1,2,720
28450912@N02,2328,27,1220160485,1220160832,3,12,347
28450912@N02,2328,4,1220160832,1220161732,5,12,900
28450912@N02,2328,16,1220162759,1220162894,3,12,135
28450912@N02,2328,17,1220162894,1220164274,5,12,1380
28450912@N02,2328,19,1220165579,1220165891,5,12,312
28450912@N02,2328,22,1220165891,1220166341,5,12,450
28450912@N02,2328,17,1220166341,1220166417,3,12,76
28450912@N02,2328,13,1220166417,1220166554,3,12,137
28450912@N02,2328,15,1220166554,1220166734,3,12,180
28450912@N02,2328,17,1220167108,1220167436,3,12,328
28450912@N02,2328,27,1220167436,1220168636,5,12,1200
28450912@N02,2328,25,1220187004,1220187754,1,12,750
28450912@N02,2329,27,1235789097,1235789372,2,11,275
28450912@N02,2329,17,1235789372,1235790752,2,11,1380
28450912@N02,2329,26,1235791955,1235792135,2,11,180
28450912@N02,2329,24,1235792196,1235792676,2,11,480
28450912@N02,2329,26,1235794300,1235794480,2,11,180
28450912@N02,2329,25,1235794506,1235795256,5,11,750
28450912@N02,2329,22,1235798765,1235799365,2,11,600
28450912@N02,2329,24,1235799561,1235800041,3,11,480
28450912@N02,2329,22,1235804073,1235804673,3,11,600
28450912@N02,2329,16,1235822128,1235822848,2,11,720
28450912@N02,2329,27,1235824342,1235825542,1,11,1200
28450912@N02,2330,27,1238830453,1238831021,4,8,568
28450912@N02,2330,25,1238831021,1238831265,2,8,244
28450912@N02,2330,24,1238831265,1238831745,2,8,480
28450912@N02,2330,18,1238832121,1238832693,2,8,572
28450912@N02,2330,19,1238832693,1238833113,2,8,420
28450912@N02,2330,25,1238838453,1238839203,4,8,750
28450912@N02,2330,23,1238848949,1238849039,2,8,90
28450912@N02,2330,21,1238849197,1238849647,2,8,450
28450912@N02,2331,22,1246788701,1246789301,1,1,600
28450912@N02,2332,27,1249892925,1249892929,3,32,4
28450912@N02,2332,15,1249892929,1249892930,2,32,1
28450912@N02,2332,22,1249892930,1249892931,2,32,1
28450912@N02,2332,21,1249892931,1249892931,2,32,0
28450912@N02,2332,26,1249892931,1249892932,2,32,1
28450912@N02,2332,25,1249892932,1249892934,4,32,2
28450912@N02,2332,20,1249892934,1249892937,3,32,3
28450912@N02,2332,24,1249892937,1249892938,2,32,1
28450912@N02,2332,21,1249892938,1249892939,2,32,1
28450912@N02,2332,24,1249892939,1249892939,2,32,0
28450912@N02,2332,25,1249892939,1249892940,2,32,1
28450912@N02,2332,13,1249892940,1249892940,2,32,0
28450912@N02,2332,18,1249892940,1249892941,2,32,1
28450912@N02,2332,26,1249892941,1249892942,3,32,1
28450912@N02,2332,22,1249892942,1249892945,3,32,3
28450912@N02,2332,1,1249892945,1249892946,2,32,1
28450912@N02,2332,9,1249892946,1249892948,2,32,2
28450912@N02,2332,16,1249892948,1249892950,2,32,2
28450912@N02,2332,27,1249892950,1249893073,5,32,123
28450912@N02,2332,25,1249893073,1249893075,2,32,2
28450912@N02,2332,21,1249893075,1249893076,3,32,1
28450912@N02,2332,18,1249893076,1249893076,2,32,0
28450912@N02,2332,21,1249893076,1249893077,2,32,1
28450912@N02,2332,18,1249893077,1249893078,3,32,1
28450912@N02,2332,26,1249893078,1249893080,2,32,2
28450912@N02,2332,18,1249893080,1249893081,3,32,1
28450912@N02,2332,19,1249893081,1249893084,2,32,3
28450912@N02,2332,13,1249893084,1249893086,2,32,2
28450912@N02,2332,21,1249893086,1249893089,3,32,3
28450912@N02,2332,25,1249893089,1249893093,3,32,4
28450912@N02,2332,21,1249893093,1249893217,3,32,124
28450912@N02,2332,22,1249893217,1249893817,3,32,600
28450912@N02,2333,27,1252041306,1252042506,1,1,1200
28450912@N02,2334,27,1252243350,1252244550,3,1,1200
28450912@N02,2335,27,1260479650,1260480850,1,1,1200
28450912@N02,2336,17,1260620477,1260620889,2,2,412
28450912@N02,2336,16,1260620889,1260621609,3,2,720
28450912@N02,2337,27,1263728346,1263729546,20,7,1200
28450912@N02,2337,2,1263732386,1263732476,2,7,90
28450912@N02,2337,6,1263732648,1263732903,5,7,255
28450912@N02,2337,9,1263734581,1263734821,7,7,240
28450912@N02,2337,15,1263736147,1263736327,5,7,180
28450912@N02,2337,13,1263737952,1263738552,2,7,600
28450912@N02,2337,17,1263738781,1263740161,1,7,1380
28450912@N02,2338,16,1274514872,1274515036,2,5,164
28450912@N02,2338,17,1274515036,1274515310,3,5,274
28450912@N02,2338,16,1274515310,1274516030,11,5,720
28450912@N02,2338,14,1274516199,1274516319,5,5,120
28450912@N02,2338,18,1274517406,1274519206,1,5,1800
28450912@N02,2339,27,1275132344,1275133544,3,3,1200
28450912@N02,2339,26,1275135500,1275135680,3,3,180
28450912@N02,2339,17,1275136035,1275137415,1,3,1380
28450912@N02,2340,27,1275223872,1275224894,4,12,1022
28450912@N02,2340,5,1275224894,1275225011,2,12,117
28450912@N02,2340,3,1275225011,1275225179,2,12,168
28450912@N02,2340,2,1275225179,1275225269,3,12,90
28450912@N02,2340,9,1275225893,1275226133,2,12,240
28450912@N02,2340,14,1275226862,1275226982,2,12,120
28450912@N02,2340,13,1275227887,1275228371,2,12,484
28450912@N02,2340,17,1275228371,1275229577,2,12,1206
28450912@N02,2340,27,1275229577,1275230777,8,12,1200
28450912@N02,2340,25,1275237303,1275238053,3,12,750
28450912@N02,2340,24,1275238331,1275238541,2,12,210
28450912@N02,2340,21,1275238541,1275238991,1,12,450
28450912@N02,2341,27,1323997657,1323998857,12,1,1200
28450912@N02,2342,12,1324125163,1324126003,2,3,840
28450912@N02,2342,16,1324126286,1324127006,3,3,720
28450912@N02,2342,17,1324128009,1324129389,8,3,1380
28450912@N02,2343,27,1388373256,1388374222,2,4,966
28450912@N02,2343,25,1388374222,1388374396,4,4,174
28450912@N02,2343,26,1388374396,1388374532,2,4,136
28450912@N02,2343,23,1388374532,1388374622,1,4,90
28450912@N02,2344,16,1400148102,1400148822,3,2,720
28450912@N02,2344,20,1400153974,1400155054,1,2,1080
28450912@N02,2345,8,1400456518,1400456638,1,1,120
28450912@N02,2346,27,1416119490,1416120120,2,7,630
28450912@N02,2346,17,1416120120,1416120350,2,7,230
28450912@N02,2346,18,1416120350,1416120462,2,7,112
28450912@N02,2346,26,1416120462,1416120566,2,7,104
28450912@N02,2346,17,1416120566,1416121946,2,7,1380
28450912@N02,2346,10,1416122234,1416122654,3,7,420
28450912@N02,2346,27,1416144668,1416145868,1,7,1200
28450912@N02,2347,17,1416184940,1416185082,2,2,142
28450912@N02,2347,18,1416185082,1416186882,1,2,1800
28464553@N03,2348,16,1231637433,1231637665,2,7,232
28464553@N03,2348,27,1231637665,1231638865,4,7,1200
28464553@N03,2348,25,1231644973,1231645723,4,7,750
28464553@N03,2348,24,1231646710,1231647190,6,7,480
28464553@N03,2348,18,1231650253,1231651915,3,7,1662
28464553@N03,2348,13,1231651915,1231652515,2,7,600
28464553@N03,2348,14,1231657666,1231657786,1,7,120
28466131@N07,2349,16,1295062350,1295063070,1,1,720
28469514@N05,2350,16,1380883326,1380884046,2,1,720
28474359@N03,2351,27,1217364938,1217366138,3,1,1200
28474359@N03,2352,16,1217565727,1217566447,2,1,720
28483202@N02,2353,14,1367728765,1367728885,2,1,120
28495380@N05,2354,17,1431391776,1431393156,25,1,1380
28495936@N03,2355,18,1292385120,1292386920,1,1,1800
28495936@N03,2356,16,1294707713,1294707921,2,7,208
28495936@N03,2356,17,1294707921,1294708924,2,7,1003
28495936@N03,2356,20,1294708924,1294710004,3,7,1080
28495936@N03,2356,17,1294710021,1294710429,2,7,408
28495936@N03,2356,15,1294710429,1294710609,2,7,180
28495936@N03,2356,9,1294710649,1294710889,2,7,240
28495936@N03,2356,3,1294713368,1294713638,1,7,270
28495936@N03,2357,19,1295743581,1295743753,2,2,172
28495936@N03,2357,10,1295743753,1295744173,1,2,420
28495936@N03,2358,10,1300061740,1300061851,4,3,111
28495936@N03,2358,8,1300061851,1300061879,2,3,28
28495936@N03,2358,10,1300061879,1300062299,1,3,420
28495936@N03,2359,11,1300750259,1300750396,2,4,137
28495936@N03,2359,25,1300750396,1300750516,2,4,120
28495936@N03,2359,23,1300750516,1300750546,2,4,30
28495936@N03,2359,6,1300750546,1300750801,1,4,255
28495936@N03,2360,10,1303087005,1303087425,1,1,420
28495936@N03,2361,10,1306274787,1306275207,1,1,420
28495936@N03,2362,10,1310595973,1310596393,2,1,420
28495936@N03,2363,14,1317509721,1317509841,2,2,120
28495936@N03,2363,7,1317509859,1317509949,1,2,90
28495936@N03,2364,6,1319339850,1319340105,1,1,255
28495936@N03,2365,26,1320831621,1320831801,2,4,180
28495936@N03,2365,14,1320834919,1320835039,2,4,120
28495936@N03,2365,26,1320837431,1320837611,2,4,180
28495936@N03,2365,27,1320840852,1320842052,1,4,1200
28495936@N03,2366,13,1322950429,1322951029,1,1,600
28495936@N03,2367,10,1323217047,1323217167,2,2,120
28495936@N03,2367,27,1323217167,1323218367,1,2,1200
28495936@N03,2368,10,1328388792,1328388853,2,3,61
28495936@N03,2368,14,1328388853,1328388900,2,3,47
28495936@N03,2368,10,1328388900,1328389320,1,3,420
28495936@N03,2369,10,1329021000,1329021000,3,2,0
28495936@N03,2369,19,1329021000,1329021420,1,2,420
28495936@N03,2370,25,1330474703,1330475264,2,6,561
28495936@N03,2370,21,1330475264,1330475714,2,6,450
28495936@N03,2370,18,1330477415,1330479064,2,6,1649
28495936@N03,2370,14,1330479064,1330479184,2,6,120
28495936@N03,2370,6,1330479292,1330479547,2,6,255
28495936@N03,2370,27,1330481653,1330482853,1,6,1200
28495936@N03,2371,10,1331768451,1331768669,3,4,218
28495936@N03,2371,11,1331768669,1331768819,3,4,150
28495936@N03,2371,19,1331768819,1331768824,2,4,5
28495936@N03,2371,14,1331768824,1331768944,1,4,120
28495936@N03,2372,10,1333058600,1333058729,2,6,129
28495936@N03,2372,2,1333058729,1333058769,2,6,40
28495936@N03,2372,14,1333058769,1333058889,2,6,120
28495936@N03,2372,27,1333059060,1333059078,2,6,18
28495936@N03,2372,14,1333059078,1333059083,2,6,5
28495936@N03,2372,7,1333059083,1333059173,1,6,90
28495936@N03,2373,10,1341443002,1341443074,2,6,72
28495936@N03,2373,27,1341443074,1341443296,3,6,222
28495936@N03,2373,10,1341443296,1341443306,2,6,10
28495936@N03,2373,11,1341443306,1341443486,2,6,180
28495936@N03,2373,2,1341443559,1341443649,2,6,90
28495936@N03,2373,27,1341443688,1341444888,1,6,1200
28495936@N03,2374,17,1343884960,1343886340,2,2,1380
28495936@N03,2374,8,1343886665,1343886785,1,2,120
28495936@N03,2375,14,1344390192,1344390312,1,1,120
28495936@N03,2376,17,1348800718,1348802098,1,1,1380
28495936@N03,2377,16,1348875700,1348876420,1,1,720
28495936@N03,2378,14,1349481410,1349481530,1,1,120
28495936@N03,2379,27,1354851686,1354852886,1,1,1200
28495936@N03,2380,27,1355965539,1355966739,1,1,1200
28519626@N07,2381,27,1325736185,1325737385,6,1,1200
28527853@N00,2382,8,1335685424,1335685544,2,2,120
28527853@N00,2382,16,1335700125,1335700845,1,2,720
28527853@N00,2383,8,1354684084,1354684204,3,2,120
28527853@N00,2383,14,1354686656,1354686776,3,2,120
28527853@N00,2384,10,1354732651,1354732655,2,4,4
28527853@N00,2384,14,1354732655,1354732775,2,4,120
28527853@N00,2384,16,1354743788,1354744508,2,4,720
28527853@N00,2384,3,1354745351,1354745621,1,4,270
28527853@N00,2385,10,1354867216,1354867636,1,1,420
28527853@N00,2386,16,1368215944,1368216664,2,2,720
28527853@N00,2386,27,1368230393,1368231593,1,2,1200
28530387@N06,2387,1,1443249534,1443250134,1,1,600
28530387@N06,2388,3,1469849492,1469849762,2,2,270
28530387@N06,2388,2,1469852385,1469852475,1,2,90
28530387@N06,2389,27,1470310013,1470311213,2,1,1200
28555778@N00,2390,7,1363127517,1363127607,9,3,90
28555778@N00,2390,1,1363130245,1363130845,2,3,600
28555778@N00,2390,2,1363135498,1363135588,5,3,90
28558260@N04,2391,27,1295720283,1295721483,1,1,1200
28572085@N03,2392,17,1216517058,1216518091,5,2,1033
28572085@N03,2392,3,1216518091,1216518361,4,2,270
28572085@N03,2393,24,1216639067,1216639547,2,7,480
28572085@N03,2393,27,1216651935,1216653135,2,7,1200
28572085@N03,2393,21,1216662365,1216662815,2,7,450
28572085@N03,2393,20,1216664817,1216665897,3,7,1080
28572085@N03,2393,14,1216672483,1216672603,7,7,120
28572085@N03,2393,4,1216676977,1216677877,2,7,900
28572085@N03,2393,16,1216682398,1216683118,6,7,720
28572085@N03,2394,27,1219069288,1219069289,2,8,1
28572085@N03,2394,3,1219069289,1219069296,5,8,7
28572085@N03,2394,11,1219069296,1219069296,2,8,0
28572085@N03,2394,14,1219069296,1219069307,13,8,11
28572085@N03,2394,13,1219069307,1219069309,3,8,2
28572085@N03,2394,27,1219069309,1219069316,6,8,7
28572085@N03,2394,23,1219069316,1219069317,2,8,1
28572085@N03,2394,14,1219069317,1219069437,8,8,120
28581468@N00,2395,27,1263945800,1263947000,101,1,1200
28582871@N04,2396,21,1253335916,1253336366,1,1,450
28598412@N04,2397,27,1251629831,1251630192,2,2,361
28598412@N04,2397,13,1251630192,1251630792,2,2,600
28598412@N04,2398,13,1251675881,1251676481,1,1,600
28598412@N04,2399,13,1251846088,1251846688,1,1,600
28600633@N04,2400,25,1212715260,1212716010,1,1,750
28636569@N06,2401,14,1354280400,1354280400,2,3,0
28636569@N06,2401,18,1354280400,1354280400,3,3,0
28636569@N06,2401,27,1354280400,1354281600,2,3,1200
28636569@N06,2402,4,1355531873,1355532773,2,5,900
28636569@N06,2402,9,1355534945,1355535038,2,5,93
28636569@N06,2402,6,1355535038,1355535100,2,5,62
28636569@N06,2402,9,1355535100,1355535340,2,5,240
28636569@N06,2402,16,1355536088,1355536808,2,5,720
28636569@N06,2403,9,1355637722,1355637962,2,2,240
28636569@N06,2403,27,1355638326,1355639526,1,2,1200
28636569@N06,2404,27,1379285771,1379286971,4,1,1200
28640739@N08,2405,16,1357868449,1357869169,1,1,720
28681548@N04,2406,15,1227991849,1227991855,2,4,6
28681548@N04,2406,14,1227991855,1227991860,2,4,5
28681548@N04,2406,6,1227991860,1227991866,2,4,6
28681548@N04,2406,14,1227991866,1227991986,6,4,120
28704523@N03,2407,12,1312360049,1312360889,1,1,840
28704523@N03,2408,9,1312935703,1312935943,1,1,240
28705786@N05,2409,27,1291795989,1291797189,1,1,1200
28712708@N06,2410,27,1282777716,1282778916,3,3,1200
28712708@N06,2410,22,1282781470,1282782031,2,3,561
28712708@N06,2410,19,1282782031,1282782451,3,3,420
28712708@N06,2411,27,1314513163,1314514363,2,3,1200
28712708@N06,2411,9,1314533410,1314533650,2,3,240
28712708@N06,2411,21,1314536281,1314536731,1,3,450
28712708@N06,2412,27,1314755863,1314757063,1,1,1200
28713051@N05,2413,27,1294774364,1294775564,1,1,1200
28717442@N00,2414,9,1406454530,1406454770,1,1,240
28724781@N04,2415,27,1228940238,1228941438,10,14,1200
28724781@N04,2415,3,1228944889,1228945159,2,14,270
28724781@N04,2415,14,1228954768,1228954888,2,14,120
28724781@N04,2415,25,1228963960,1228964710,3,14,750
28724781@N04,2415,27,1228966165,1228967365,4,14,1200
28724781@N04,2415,24,1228967479,1228967760,2,14,281
28724781@N04,2415,25,1228967760,1228968510,4,14,750
28724781@N04,2415,27,1228969577,1228970777,7,14,1200
28724781@N04,2415,26,1228980000,1228980180,2,14,180
28724781@N04,2415,1,1228985229,1228985829,2,14,600
28724781@N04,2415,2,1228987228,1228987318,3,14,90
28724781@N04,2415,9,1228988206,1228988446,3,14,240
28724781@N04,2415,12,1228988804,1228989644,2,14,840
28724781@N04,2415,17,1228990287,1228991667,2,14,1380
28724781@N04,2416,27,1229205275,1229206475,2,5,1200
28724781@N04,2416,14,1229206626,1229206746,2,5,120
28724781@N04,2416,15,1229207888,1229208068,3,5,180
28724781@N04,2416,9,1229215618,1229215646,2,5,28
28724781@N04,2416,15,1229215646,1229215826,1,5,180
28724781@N04,2417,6,1231539309,1231539564,2,19,255
28724781@N04,2417,1,1231543384,1231543715,2,19,331
28724781@N04,2417,6,1231543715,1231543970,5,19,255
28724781@N04,2417,1,1231546002,1231546137,3,19,135
28724781@N04,2417,6,1231546137,1231546392,7,19,255
28724781@N04,2417,2,1231548469,1231548559,4,19,90
28724781@N04,2417,5,1231548612,1231548856,2,19,244
28724781@N04,2417,1,1231548856,1231549456,2,19,600
28724781@N04,2417,6,1231551796,1231552051,4,19,255
28724781@N04,2417,16,1231553323,1231554043,3,19,720
28724781@N04,2417,6,1231558191,1231558446,5,19,255
28724781@N04,2417,27,1231570296,1231571496,2,19,1200
28724781@N04,2417,6,1231572703,1231572768,3,19,65
28724781@N04,2417,22,1231572768,1231573368,7,19,600
28724781@N04,2417,6,1231578013,1231578145,2,19,132
28724781@N04,2417,21,1231578145,1231578245,2,19,100
28724781@N04,2417,23,1231578245,1231578297,2,19,52
28724781@N04,2417,24,1231578297,1231578777,2,19,480
28724781@N04,2417,17,1231581302,1231582682,2,19,1380
28732514@N00,2418,26,1304807047,1304807227,1,1,180
28782167@N03,2419,17,1336909466,1336910846,1,1,1380
28827568@N05,2420,27,1222492732,1222493932,2,1,1200
28827568@N05,2421,26,1222742668,1222742848,2,2,180
28827568@N05,2421,14,1222749307,1222749427,2,2,120
28827568@N05,2422,27,1222858363,1222859563,5,1,1200
28827568@N05,2423,19,1289176959,1289177379,1,1,420
28835512@N07,2424,27,1302684332,1302685532,2,5,1200
28835512@N07,2424,16,1302685635,1302686355,2,5,720
28835512@N07,2424,14,1302686407,1302686527,2,5,120
28835512@N07,2424,9,1302691743,1302691983,8,5,240
28835512@N07,2424,27,1302698910,1302700110,1,5,1200
28836018@N02,2425,19,1305588774,1305589194,8,1,420
28836018@N02,2426,27,1337259402,1337260602,5,1,1200
28836018@N02,2427,27,1358037866,1358038017,4,10,151
28836018@N02,2427,4,1358038017,1358038054,2,10,37
28836018@N02,2427,5,1358038054,1358038085,2,10,31
28836018@N02,2427,2,1358038085,1358038149,2,10,64
28836018@N02,2427,6,1358038149,1358038240,2,10,91
28836018@N02,2427,14,1358038240,1358038354,3,10,114
28836018@N02,2427,17,1358038354,1358038423,4,10,69
28836018@N02,2427,26,1358038423,1358038603,8,10,180
28836018@N02,2427,22,1358038616,1358038714,3,10,98
28836018@N02,2427,20,1358038714,1358039794,3,10,1080
28869340@N00,2428,6,1310439112,1310439367,3,1,255
28869340@N00,2429,16,1310470127,1310470847,1,1,720
28900333@N08,2430,21,1381419159,1381419609,1,1,450
28900333@N08,2431,27,1381529829,1381531029,2,1,1200
28941821@N02,2432,27,1197077342,1197078542,1,1,1200
28941821@N02,2433,23,1197249678,1197249768,3,2,90
28941821@N02,2433,25,1197274666,1197275416,1,2,750
28946471@N00,2434,27,1373931628,1373932828,2,3,1200
28946471@N00,2434,23,1373932929,1373933019,2,3,90
28946471@N00,2434,14,1373944065,1373944185,1,3,120
28946471@N00,2435,13,1379311729,1379312329,2,2,600
28946471@N00,2435,16,1379315923,1379316643,1,2,720
28959709@N05,2436,2,1291940579,1291940669,7,1,90
28959709@N05,2437,14,1370045882,1370046002,3,1,120
28971971@N00,2438,4,1195003103,1195004003,2,8,900
28971971@N00,2438,9,1195007189,1195007429,2,8,240
28971971@N00,2438,11,1195008189,1195008369,6,8,180
28971971@N00,2438,9,1195009946,1195010186,6,8,240
28971971@N00,2438,14,1195015230,1195015350,8,8,120
28971971@N00,2438,27,1195034008,1195035208,2,8,1200
28971971@N00,2438,17,1195035332,1195036712,7,8,1380
28971971@N00,2438,15,1195038903,1195039083,1,8,180
28971971@N00,2439,15,1195175810,1195175990,3,3,180
28971971@N00,2439,8,1195179792,1195179912,5,3,120
28971971@N00,2439,1,1195182505,1195183105,3,3,600
28971971@N00,2440,25,1195264803,1195265553,2,4,750
28971971@N00,2440,16,1195267060,1195267780,3,4,720
28971971@N00,2440,9,1195269507,1195269747,2,4,240
28971971@N00,2440,27,1195270910,1195272110,2,4,1200
28971971@N00,2441,2,1264728785,1264728875,2,4,90
28971971@N00,2441,8,1264729664,1264729784,20,4,120
28971971@N00,2441,9,1264732323,1264732563,4,4,240
28971971@N00,2441,25,1264745546,1264746296,2,4,750
28971971@N00,2442,20,1297413713,1297414793,2,2,1080
28971971@N00,2442,14,1297418280,1297418400,4,2,120
28976420@N03,2443,27,1298360283,1298361483,6,5,1200
28976420@N03,2443,14,1298361988,1298362108,4,5,120
28976420@N03,2443,16,1298365339,1298366059,3,5,720
28976420@N03,2443,15,1298366416,1298366596,2,5,180
28976420@N03,2443,2,1298375029,1298375119,6,5,90
28977782@N00,2444,27,1191652660,1191653860,3,1,1200
28977782@N00,2445,27,1191708029,1191709229,5,1,1200
28977782@N00,2446,12,1191745001,1191745841,1,1,840
28977782@N00,2447,27,1191968817,1191970017,3,7,1200
28977782@N00,2447,23,1191975070,1191975160,2,7,90
28977782@N00,2447,24,1191982687,1191982852,2,7,165
28977782@N00,2447,23,1191982852,1191982936,2,7,84
28977782@N00,2447,22,1191982936,1191983300,3,7,364
28977782@N00,2447,24,1191983300,1191983780,5,7,480
28977782@N00,2447,27,1191989149,1191990349,2,7,1200
28977782@N00,2448,27,1192143440,1192144640,1,1,1200
28977782@N00,2449,27,1324057052,1324058252,3,4,1200
28977782@N00,2449,5,1324062073,1324062793,2,4,720
28977782@N00,2449,9,1324069454,1324069593,2,4,139
28977782@N00,2449,14,1324069593,1324069713,1,4,120
28977782@N00,2450,2,1324133030,1324133120,2,2,90
28977782@N00,2450,1,1324133607,1324134207,1,2,600
28977782@N00,2451,17,1324169912,1324171292,1,1,1380
28977782@N00,2452,27,1324482804,1324484004,2,3,1200
28977782@N00,2452,7,1324486916,1324487006,2,3,90
28977782@N00,2452,14,1324488803,1324488923,1,3,120
28977782@N00,2453,21,1334261060,1334261510,2,6,450
28977782@N00,2453,25,1334262626,1334263376,2,6,750
28977782@N00,2453,24,1334264631,1334264799,2,6,168
28977782@N00,2453,25,1334264799,1334265549,2,6,750
28977782@N00,2453,13,1334283742,1334284342,2,6,600
28977782@N00,2453,8,1334285402,1334285522,2,6,120
28980024@N04,2454,18,1303092264,1303094064,1,1,1800
29000027@N05,2455,16,1430309382,1430310102,2,1,720
29000027@N05,2456,27,1442744520,1442745720,5,1,1200
29000027@N05,2457,27,1451999974,1452001174,1,1,1200
29000027@N05,2458,13,1455194944,1455195544,1,1,600
29000027@N05,2459,16,1459476853,1459477573,29,1,720
29020490@N04,2460,17,1228197479,1228198859,1,1,1380
29020490@N04,2461,18,1231488804,1231490604,2,1,1800
29020490@N04,2462,16,1231539364,1231539971,3,2,607
29020490@N04,2462,17,1231539971,1231541351,1,2,1380
29057323@N07,2463,16,1207809134,1207809854,1,1,720
29075130@N00,2464,16,1307752639,1307753359,2,2,720
29075130@N00,2464,6,1307763352,1307763607,1,2,255
29108089@N04,2465,27,1385884676,1385885876,2,6,1200
29108089@N04,2465,15,1385894101,1385894281,2,6,180
29108089@N04,2465,10,1385896882,1385897302,5,6,420
29108089@N04,2465,2,1385899577,1385899667,2,6,90
29108089@N04,2465,5,1385899871,1385900076,2,6,205
29108089@N04,2465,4,1385900076,1385900976,3,6,900
29108089@N04,2466,27,1386025755,1386026955,3,4,1200
29108089@N04,2466,24,1386030577,1386031057,4,4,480
29108089@N04,2466,22,1386034704,1386035304,5,4,600
29108089@N04,2466,2,1386042509,1386042599,1,4,90
29108089@N04,2467,27,1386341640,1386342840,2,1,1200
29108089@N04,2468,27,1386395656,1386396856,1,1,1200
29129621@N05,2469,13,1246623229,1246623829,1,1,600
29129621@N05,2470,13,1269052835,1269053435,1,1,600
29129621@N05,2471,1,1291638738,1291639338,3,1,600
29129621@N05,2472,18,1317637061,1317638861,2,7,1800
29129621@N05,2472,2,1317642734,1317642824,2,7,90
29129621@N05,2472,1,1317644041,1317644641,2,7,600
29129621@N05,2472,3,1317644906,1317645176,2,7,270
29129621@N05,2472,13,1317646499,1317647099,2,7,600
29129621@N05,2472,17,1317647626,1317648206,2,7,580
29129621@N05,2472,27,1317648206,1317649406,2,7,1200
29129621@N05,2473,26,1327134956,1327135136,1,1,180
29129621@N05,2474,16,1348736186,1348736906,2,3,720
29129621@N05,2474,7,1348737482,1348737572,2,3,90
29129621@N05,2474,4,1348742528,1348743428,1,3,900
29129621@N05,2475,19,1348812696,1348813116,2,3,420
29129621@N05,2475,18,1348813828,1348815628,3,3,1800
29129621@N05,2475,9,1348818047,1348818287,1,3,240
29129621@N05,2476,12,1348885655,1348886495,1,1,840
29129621@N05,2477,1,1352508944,1352509544,2,6,600
29129621@N05,2477,10,1352510097,1352510283,2,6,186
29129621@N05,2477,14,1352510283,1352510403,2,6,120
29129621@N05,2477,9,1352510604,1352510844,2,6,240
29129621@N05,2477,10,1352511298,1352511573,2,6,275
29129621@N05,2477,14,1352511573,1352511693,1,6,120
29129621@N05,2478,7,1358585193,1358585283,1,1,90
29129621@N05,2479,16,1365207381,1365208101,2,5,720
29129621@N05,2479,20,1365227897,1365228977,2,5,1080
29129621@N05,2479,19,1365229422,1365229842,4,5,420
29129621@N05,2479,7,1365245627,1365245717,2,5,90
29129621@N05,2479,2,1365246756,1365246846,1,5,90
29129621@N05,2480,1,1379764414,1379765014,2,2,600
29129621@N05,2480,19,1379767733,1379768153,1,2,420
29129621@N05,2481,10,1382361817,1382362237,2,2,420
29129621@N05,2481,20,1382365526,1382366606,1,2,1080
29129621@N05,2482,19,1410414576,1410414996,1,1,420
29129621@N05,2483,19,1423738403,1423738823,1,1,420
29129621@N05,2484,2,1439036882,1439036972,1,1,90
29158990@N02,2485,14,1310945032,1310945152,1,1,120
29168905@N00,2486,12,1313374835,1313374921,3,5,86
29168905@N00,2486,13,1313374921,1313375521,9,5,600
29168905@N00,2486,21,1313380249,1313380699,2,5,450
29168905@N00,2486,13,1313401023,1313401623,2,5,600
29168905@N00,2486,18,1313402389,1313404189,5,5,1800
29168905@N00,2487,27,1313640187,1313641387,3,3,1200
29168905@N00,2487,14,1313649443,1313649563,15,3,120
29168905@N00,2487,17,1313663675,1313665055,2,3,1380
29196274@N02,2488,16,1201721423,1201722143,1,1,720
29196480@N02,2489,18,1216155493,1216157293,9,1,1800
29196480@N02,2490,18,1216326063,1216327863,9,1,1800
29196480@N02,2491,18,1216757322,1216759122,9,1,1800
29196480@N02,2492,27,1244249251,1244250451,2,1,1200
29196480@N02,2493,27,1272685865,1272687065,10,1,1200
29198183@N00,2494,14,1303805367,1303805487,2,1,120
29225947@N00,2495,20,1380070949,1380072029,29,18,1080
29225947@N00,2495,19,1380074502,1380074922,5,18,420
29225947@N00,2495,18,1380074974,1380074990,3,18,16
29225947@N00,2495,19,1380074990,1380075410,7,18,420
29225947@N00,2495,22,1380076021,1380076621,11,18,600
29225947@N00,2495,25,1380077359,1380077377,3,18,18
29225947@N00,2495,24,1380077377,1380077576,10,18,199
29225947@N00,2495,21,1380077576,1380077833,15,18,257
29225947@N00,2495,20,1380077833,1380077985,5,18,152
29225947@N00,2495,22,1380077985,1380078095,4,18,110
29225947@N00,2495,26,1380078095,1380078193,3,18,98
29225947@N00,2495,17,1380078193,1380078611,3,18,418
29225947@N00,2495,15,1380078611,1380078791,82,18,180
29225947@N00,2495,10,1380081711,1380081854,3,18,143
29225947@N00,2495,11,1380081854,1380082034,5,18,180
29225947@N00,2495,7,1380082370,1380082460,5,18,90
29225947@N00,2495,2,1380082693,1380082783,14,18,90
29225947@N00,2495,27,1380096351,1380097551,2,18,1200
29225947@N00,2496,17,1380362878,1380364258,1,1,1380
29225947@N00,2497,17,1380506677,1380507713,5,3,1036
29225947@N00,2497,10,1380507713,1380508133,15,3,420
29225947@N00,2497,14,1380511444,1380511564,6,3,120
29225947@N00,2498,14,1380577000,1380577120,5,7,120
29225947@N00,2498,15,1380579461,1380579641,11,7,180
29225947@N00,2498,17,1380580823,1380580984,3,7,161
29225947@N00,2498,22,1380580984,1380581584,3,7,600
29225947@N00,2498,7,1380588877,1380588967,27,7,90
29225947@N00,2498,9,1380615032,1380615272,6,7,240
29225947@N00,2498,5,1380615531,1380616251,1,7,720
29225947@N00,2499,24,1380781404,1380781884,2,4,480
29225947@N00,2499,26,1380782384,1380782564,3,4,180
29225947@N00,2499,19,1380785971,1380786391,2,4,420
29225947@N00,2499,14,1380791257,1380791377,1,4,120
29232178@N03,2500,4,1268596361,1268597261,1,1,900
29232178@N03,2501,18,1410549667,1410551467,1,1,1800
29232178@N03,2502,16,1412110373,1412111093,1,1,720
29232178@N03,2503,16,1436978382,1436979102,1,1,720
29259314@N04,2504,27,1285836681,1285837881,3,1,1200
29259314@N04,2505,27,1286064383,1286065583,3,5,1200
29259314@N04,2505,19,1286067099,1286067519,3,5,420
29259314@N04,2505,18,1286067582,1286069382,8,5,1800
29259314@N04,2505,19,1286069398,1286069818,3,5,420
29259314@N04,2505,27,1286074790,1286075990,1,5,1200
29259314@N04,2506,16,1412029027,1412029747,5,1,720
29259314@N04,2507,27,1412143825,1412145025,2,2,1200
29259314@N04,2507,14,1412157780,1412157900,1,2,120
29259314@N04,2508,14,1412649290,1412649298,2,3,8
29259314@N04,2508,5,1412649298,1412649298,2,3,0
29259314@N04,2508,9,1412649298,1412649538,1,3,240
29337846@N02,2509,3,1299852421,1299852691,2,2,270
29337846@N02,2509,4,1299856717,1299857617,1,2,900
29352917@N00,2510,27,1255576064,1255577264,2,3,1200
29352917@N00,2510,18,1255578519,1255580319,2,3,1800
29352917@N00,2510,27,1255582979,1255584179,2,3,1200
29358051@N07,2511,24,1216943130,1216943610,4,6,480
29358051@N07,2511,21,1216944860,1216945310,2,6,450
29358051@N07,2511,22,1216946629,1216947229,2,6,600
29358051@N07,2511,26,1216948425,1216948605,3,6,180
29358051@N07,2511,15,1216965455,1216965607,2,6,152
29358051@N07,2511,14,1216965607,1216965727,1,6,120
29384095@N00,2512,16,1253718739,1253719459,3,1,720
29392290@N03,2513,27,1396729452,1396730652,1,1,1200
29426902@N02,2514,16,1286926314,1286927034,1,1,720
29426902@N02,2515,5,1286959295,1286960015,1,1,720
29459675@N06,2516,27,1396220338,1396221538,1,1,1200
29507514@N03,2517,16,1365309741,1365310461,1,1,720
29542859@N05,2518,16,1247091881,1247092601,1,1,720
29542859@N05,2519,14,1266373612,1266373732,2,2,120
29542859@N05,2519,27,1266377403,1266378603,1,2,1200
29568026@N07,2520,27,1397180370,1397181570,5,5,1200
29568026@N07,2520,16,1397181878,1397182598,5,5,720
29568026@N07,2520,9,1397190813,1397191053,4,5,240
29568026@N07,2520,27,1397206614,1397207814,6,5,1200
29568026@N07,2520,17,1397209731,1397211111,1,5,1380
29568026@N07,2521,18,1397538812,1397540612,3,1,1800
29568026@N07,2522,27,1397640171,1397641371,2,1,1200
29583624@N04,2523,27,1223102222,1223103422,7,3,1200
29583624@N04,2523,18,1223113869,1223115067,2,3,1198
29583624@N04,2523,13,1223115067,1223115667,1,3,600
29583624@N04,2524,12,1226664403,1226665243,1,1,840
29583624@N04,2525,14,1252735516,1252735636,1,1,120
29583624@N04,2526,27,1329536176,1329537376,2,2,1200
29583624@N04,2526,16,1329538922,1329539642,1,2,720
29618911@N04,2527,13,1330063972,1330064206,2,2,234
29618911@N04,2527,25,1330064206,1330064956,1,2,750
29619840@N00,2528,27,1210030292,1210031492,12,41,1200
29619840@N00,2528,20,1210031660,1210032273,4,41,613
29619840@N00,2528,19,1210032273,1210032689,10,41,416
29619840@N00,2528,20,1210032689,1210032805,3,41,116
29619840@N00,2528,21,1210032805,1210033255,5,41,450
29619840@N00,2528,23,1210034053,1210034143,3,41,90
29619840@N00,2528,21,1210034165,1210034207,2,41,42
29619840@N00,2528,20,1210034207,1210035287,5,41,1080
29619840@N00,2528,24,1210036887,1210037367,6,41,480
29619840@N00,2528,23,1210037649,1210037739,2,41,90
29619840@N00,2528,25,1210038276,1210038602,2,41,326
29619840@N00,2528,4,1210038602,1210038784,5,41,182
29619840@N00,2528,5,1210038784,1210038942,2,41,158
29619840@N00,2528,1,1210038942,1210039045,2,41,103
29619840@N00,2528,2,1210039045,1210039115,2,41,70
29619840@N00,2528,4,1210039115,1210039117,2,41,2
29619840@N00,2528,5,1210039117,1210039837,4,41,720
29619840@N00,2528,3,1210040861,1210041131,4,41,270
29619840@N00,2528,1,1210045977,1210046577,3,41,600
29619840@N00,2528,3,1210047816,1210048086,5,41,270
29619840@N00,2528,2,1210048243,1210048333,2,41,90
29619840@N00,2528,16,1210051837,1210052557,8,41,720
29619840@N00,2528,9,1210052890,1210053130,3,41,240
29619840@N00,2528,8,1210055073,1210055193,16,41,120
29619840@N00,2528,11,1210055866,1210056046,3,41,180
29619840@N00,2528,8,1210056688,1210056808,3,41,120
29619840@N00,2528,11,1210057090,1210057270,15,41,180
29619840@N00,2528,8,1210057440,1210057560,3,41,120
29619840@N00,2528,9,1210058224,1210058464,3,41,240
29619840@N00,2528,14,1210058892,1210059012,3,41,120
29619840@N00,2528,15,1210059331,1210059511,2,41,180
29619840@N00,2528,14,1210059630,1210059736,4,41,106
29619840@N00,2528,16,1210059736,1210060456,3,41,720
29619840@N00,2528,12,1210062145,1210062985,19,41,840
29619840@N00,2528,13,1210063274,1210063874,8,41,600
29619840@N00,2528,17,1210064698,1210066078,18,41,1380
29619840@N00,2528,4,1210066808,1210067318,2,41,510
29619840@N00,2528,2,1210067318,1210067408,5,41,90
29619840@N00,2528,4,1210067685,1210068585,4,41,900
29619840@N00,2528,15,1210068816,1210068996,2,41,180
29619840@N00,2528,27,1210075000,1210076200,3,41,1200
29648523@N05,2529,27,1258513975,1258514650,5,4,675
29648523@N05,2529,17,1258514650,1258516030,3,4,1380
29648523@N05,2529,13,1258518261,1258518861,2,4,600
29648523@N05,2529,4,1258527438,1258528338,1,4,900
29648523@N05,2530,27,1448944178,1448945378,6,5,1200
29648523@N05,2530,22,1448946705,1448947305,2,5,600
29648523@N05,2530,13,1448949133,1448949733,2,5,600
29648523@N05,2530,17,1448950387,1448951767,4,5,1380
29648523@N05,2530,14,1448961466,1448961586,1,5,120
29651901@N00,2531,14,1374392171,1374392291,1,1,120
29651901@N00,2532,23,1374900957,1374901047,1,1,90
29664314@N02,2533,14,1219398121,1219398241,1,1,120
29664314@N02,2534,14,1219569946,1219570066,1,1,120
29675024@N05,2535,27,1276036329,1276037529,3,13,1200
29675024@N05,2535,1,1276039042,1276039642,2,13,600
29675024@N05,2535,4,1276040588,1276040728,2,13,140
29675024@N05,2535,9,1276040728,1276040968,3,13,240
29675024@N05,2535,12,1276041394,1276042234,6,13,840
29675024@N05,2535,13,1276042666,1276043266,2,13,600
29675024@N05,2535,20,1276043741,1276044072,2,13,331
29675024@N05,2535,22,1276044072,1276044301,2,13,229
29675024@N05,2535,19,1276044301,1276044721,2,13,420
29675024@N05,2535,21,1276045971,1276046421,2,13,450
29675024@N05,2535,4,1276073752,1276074652,2,13,900
29675024@N05,2535,2,1276080999,1276081089,2,13,90
29675024@N05,2535,24,1276081514,1276081994,1,13,480
29734611@N06,2536,25,1198498084,1198498834,1,1,750
29756928@N03,2537,19,1398901292,1398901712,2,2,420
29756928@N03,2537,23,1398907298,1398907388,1,2,90
29756928@N03,2538,9,1398943418,1398943658,1,1,240
29758442@N00,2539,16,1216882612,1216883332,4,1,720
29775332@N00,2540,27,1383690402,1383691602,2,12,1200
29775332@N00,2540,24,1383692739,1383693219,2,12,480
29775332@N00,2540,17,1383696364,1383697744,2,12,1380
29775332@N00,2540,15,1383697846,1383697955,3,12,109
29775332@N00,2540,12,1383697955,1383698408,2,12,453
29775332@N00,2540,15,1383698408,1383698588,2,12,180
29775332@N00,2540,9,1383699195,1383699435,2,12,240
29775332@N00,2540,8,1383700039,1383700159,4,12,120
29775332@N00,2540,3,1383706497,1383706767,3,12,270
29775332@N00,2540,8,1383714538,1383714658,2,12,120
29775332@N00,2540,19,1383717800,1383718220,3,12,420
29775332@N00,2540,17,1383727612,1383728992,1,12,1380
29775332@N00,2541,12,1383882222,1383883062,4,2,840
29775332@N00,2541,26,1383888944,1383889124,1,2,180
29807137@N03,2542,27,1221278169,1221279369,1,1,1200
29807137@N03,2543,4,1221361077,1221361977,1,1,900
29833862@N00,2544,4,1441671791,1441672691,2,12,900
29833862@N00,2544,6,1441672810,1441673065,8,12,255
29833862@N00,2544,1,1441674837,1441675437,2,12,600
29833862@N00,2544,9,1441676709,1441676949,4,12,240
29833862@N00,2544,15,1441680217,1441680218,2,12,1
29833862@N00,2544,13,1441680218,1441680818,4,12,600
29833862@N00,2544,9,1441681251,1441681491,5,12,240
29833862@N00,2544,16,1441684487,1441685207,3,12,720
29833862@N00,2544,23,1441690782,1441690872,6,12,90
29833862@N00,2544,26,1441691253,1441691433,3,12,180
29833862@N00,2544,11,1441697330,1441697331,2,12,1
29833862@N00,2544,8,1441697331,1441697451,1,12,120
29838859@N08,2545,19,1433606594,1433607014,1,1,420
29845947@N00,2546,5,1278549105,1278549315,3,11,210
29845947@N00,2546,4,1278549315,1278550215,14,11,900
29845947@N00,2546,1,1278552290,1278552299,2,11,9
29845947@N00,2546,2,1278552299,1278552389,32,11,90
29845947@N00,2546,1,1278573906,1278573930,3,11,24
29845947@N00,2546,2,1278573930,1278574020,27,11,90
29845947@N00,2546,7,1278578319,1278578409,2,11,90
29845947@N00,2546,11,1278578432,1278578612,29,11,180
29845947@N00,2546,9,1278585932,1278586013,3,11,81
29845947@N00,2546,14,1278586013,1278586026,2,11,13
29845947@N00,2546,9,1278586026,1278586266,2,11,240
29845947@N00,2547,8,1278816496,1278816616,5,5,120
29845947@N00,2547,11,1278817250,1278817430,36,5,180
29845947@N00,2547,23,1278834485,1278834575,13,5,90
29845947@N00,2547,25,1278836586,1278837336,18,5,750
29845947@N00,2547,14,1278839584,1278839704,18,5,120
29845947@N00,2548,14,1278894228,1278894348,3,1,120
29865634@N04,2549,4,1191660266,1191661166,1,1,900
29865634@N04,2550,22,1209791070,1209791670,2,2,600
29865634@N04,2550,13,1209794431,1209795031,1,2,600
29865634@N04,2551,1,1214561575,1214562175,3,2,600
29865634@N04,2551,26,1214564426,1214564606,1,2,180
29865634@N04,2552,14,1218847268,1218847388,2,2,120
29865634@N04,2552,9,1218849918,1218850158,2,2,240
29865634@N04,2553,27,1218941193,1218942393,1,1,1200
29865634@N04,2554,21,1220002423,1220002873,3,4,450
29865634@N04,2554,26,1220003859,1220004039,2,4,180
29865634@N04,2554,13,1220004853,1220005453,3,4,600
29865634@N04,2554,26,1220011841,1220012021,1,4,180
29865634@N04,2555,3,1221898716,1221898986,2,2,270
29865634@N04,2555,2,1221899272,1221899362,1,2,90
29865634@N04,2556,13,1222507149,1222507749,2,1,600
29865634@N04,2557,21,1223694213,1223694663,1,1,450
29865634@N04,2558,11,1226117133,1226117313,3,5,180
29865634@N04,2558,9,1226119687,1226119927,2,5,240
29865634@N04,2558,15,1226120667,1226120847,2,5,180
29865634@N04,2558,1,1226124172,1226124772,4,5,600
29865634@N04,2558,27,1226128775,1226129975,2,5,1200
29865634@N04,2559,4,1227450305,1227451205,2,2,900
29865634@N04,2559,13,1227451301,1227451901,1,2,600
29865634@N04,2560,13,1233377433,1233378033,2,10,600
29865634@N04,2560,14,1233382755,1233382875,3,10,120
29865634@N04,2560,9,1233383140,1233383380,2,10,240
29865634@N04,2560,8,1233385646,1233385766,2,10,120
29865634@N04,2560,9,1233385999,1233386239,2,10,240
29865634@N04,2560,6,1233386725,1233386980,2,10,255
29865634@N04,2560,13,1233395432,1233396032,2,10,600
29865634@N04,2560,21,1233396618,1233397068,2,10,450
29865634@N04,2560,14,1233398738,1233398858,2,10,120
29865634@N04,2560,9,1233399654,1233399894,1,10,240
29865634@N04,2561,27,1235355963,1235357163,2,5,1200
29865634@N04,2561,14,1235362465,1235362585,2,5,120
29865634@N04,2561,13,1235365197,1235365728,2,5,531
29865634@N04,2561,22,1235365728,1235366328,4,5,600
29865634@N04,2561,25,1235368412,1235369162,2,5,750
29865634@N04,2562,27,1237509038,1237510238,2,10,1200
29865634@N04,2562,8,1237510414,1237510534,5,10,120
29865634@N04,2562,3,1237516686,1237516956,4,10,270
29865634@N04,2562,9,1237519722,1237519962,2,10,240
29865634@N04,2562,14,1237521697,1237521817,6,10,120
29865634@N04,2562,15,1237524319,1237524499,2,10,180
29865634@N04,2562,13,1237524862,1237525462,3,10,600
29865634@N04,2562,22,1237526413,1237527013,2,10,600
29865634@N04,2562,21,1237527735,1237528185,6,10,450
29865634@N04,2562,27,1237531086,1237532286,1,10,1200
29865634@N04,2563,14,1242455906,1242456026,8,7,120
29865634@N04,2563,13,1242458502,1242459102,3,7,600
29865634@N04,2563,21,1242459982,1242460432,2,7,450
29865634@N04,2563,2,1242462676,1242462766,5,7,90
29865634@N04,2563,9,1242468885,1242469125,3,7,240
29865634@N04,2563,6,1242469840,1242470095,3,7,255
29865634@N04,2563,9,1242471492,1242471732,1,7,240
29865634@N04,2564,9,1243167993,1243168233,2,1,240
29865634@N04,2565,9,1243797635,1243797875,2,1,240
29865634@N04,2566,15,1243842689,1243842869,15,3,180
29865634@N04,2566,9,1243843354,1243843594,16,3,240
29865634@N04,2566,27,1243848567,1243849767,1,3,1200
29865634@N04,2567,22,1245393677,1245394277,4,13,600
29865634@N04,2567,13,1245394560,1245395160,3,13,600
29865634@N04,2567,21,1245396367,1245396817,6,13,450
29865634@N04,2567,17,1245402801,1245403275,3,13,474
29865634@N04,2567,16,1245403275,1245403995,3,13,720
29865634@N04,2567,13,1245404100,1245404700,9,13,600
29865634@N04,2567,9,1245406779,1245407019,2,13,240
29865634@N04,2567,1,1245416128,1245416728,4,13,600
29865634@N04,2567,2,1245417462,1245417552,2,13,90
29865634@N04,2567,4,1245417998,1245418898,2,13,900
29865634@N04,2567,16,1245419106,1245419826,2,13,720
29865634@N04,2567,17,1245420520,1245421794,2,13,1274
29865634@N04,2567,27,1245421794,1245422994,2,13,1200
29865634@N04,2568,27,1247804103,1247805303,2,4,1200
29865634@N04,2568,2,1247825732,1247825822,4,4,90
29865634@N04,2568,23,1247829470,1247829560,2,4,90
29865634@N04,2568,27,1247831018,1247832218,1,4,1200
29865634@N04,2569,14,1249475813,1249475933,4,2,120
29865634@N04,2569,27,1249477557,1249478757,1,2,1200
29865634@N04,2570,24,1250305712,1250306192,1,1,480
29865634@N04,2571,27,1250375735,1250376935,3,1,1200
29865634@N04,2572,14,1250431830,1250431950,1,1,120
29865634@N04,2573,15,1250506770,1250506950,2,2,180
29865634@N04,2573,13,1250507384,1250507984,2,2,600
29865634@N04,2574,14,1252151965,1252152085,1,1,120
29865634@N04,2575,27,1253953597,1253954195,3,3,598
29865634@N04,2575,9,1253954195,1253954435,3,3,240
29865634@N04,2575,13,1253955847,1253956447,4,3,600
29865634@N04,2576,1,1254568107,1254568707,2,7,600
29865634@N04,2576,8,1254570177,1254570297,2,7,120
29865634@N04,2576,9,1254571478,1254571718,3,7,240
29865634@N04,2576,17,1254573674,1254575054,2,7,1380
29865634@N04,2576,13,1254575266,1254575866,2,7,600
29865634@N04,2576,14,1254576346,1254576466,2,7,120
29865634@N04,2576,16,1254576642,1254577362,2,7,720
29865634@N04,2577,27,1255259474,1255260674,2,4,1200
29865634@N04,2577,22,1255265623,1255266223,2,4,600
29865634@N04,2577,15,1255270362,1255270542,2,4,180
29865634@N04,2577,6,1255271827,1255272082,1,4,255
29865634@N04,2578,27,1260004214,1260005414,1,1,1200
29865634@N04,2579,26,1264302619,1264302799,2,10,180
29865634@N04,2579,21,1264303200,1264303650,3,10,450
29865634@N04,2579,23,1264303905,1264303995,2,10,90
29865634@N04,2579,14,1264304629,1264304749,3,10,120
29865634@N04,2579,15,1264305307,1264305456,2,10,149
29865634@N04,2579,14,1264305456,1264305576,4,10,120
29865634@N04,2579,13,1264309855,1264310455,5,10,600
29865634@N04,2579,14,1264312719,1264312839,5,10,120
29865634@N04,2579,15,1264316641,1264316821,2,10,180
29865634@N04,2579,27,1264317345,1264318545,1,10,1200
29865634@N04,2580,5,1264921134,1264921854,1,1,720
29865634@N04,2581,14,1274341098,1274341218,2,3,120
29865634@N04,2581,4,1274342235,1274343135,2,3,900
29865634@N04,2581,21,1274347632,1274348082,1,3,450
29865634@N04,2582,9,1280484375,1280484615,2,3,240
29865634@N04,2582,13,1280488048,1280488648,2,3,600
29865634@N04,2582,27,1280498669,1280499869,1,3,1200
29865634@N04,2583,4,1288917553,1288918453,1,1,900
29865634@N04,2584,21,1289039071,1289039521,4,8,450
29865634@N04,2584,16,1289049787,1289050465,2,8,678
29865634@N04,2584,4,1289050465,1289051365,3,8,900
29865634@N04,2584,1,1289051468,1289051596,2,8,128
29865634@N04,2584,2,1289051596,1289051686,2,8,90
29865634@N04,2584,4,1289051787,1289052687,2,8,900
29865634@N04,2584,20,1289052997,1289054077,3,8,1080
29865634@N04,2584,27,1289055330,1289056530,1,8,1200
29865634@N04,2585,26,1290240197,1290240377,1,1,180
29865634@N04,2586,13,1300024545,1300025145,1,1,600
29865634@N04,2587,13,1304141097,1304141697,5,1,600
29865634@N04,2588,4,1305961333,1305962233,2,8,900
29865634@N04,2588,27,1305963272,1305964448,2,8,1176
29865634@N04,2588,14,1305964448,1305964568,2,8,120
29865634@N04,2588,13,1305968036,1305968636,3,8,600
29865634@N04,2588,9,1305970050,1305970290,3,8,240
29865634@N04,2588,4,1305970772,1305971446,2,8,674
29865634@N04,2588,9,1305971446,1305971686,4,8,240
29865634@N04,2588,13,1305975087,1305975687,2,8,600
29865634@N04,2589,25,1308319423,1308320173,2,5,750
29865634@N04,2589,23,1308320216,1308320306,3,5,90
29865634@N04,2589,20,1308320865,1308321945,2,5,1080
29865634@N04,2589,9,1308323913,1308324153,2,5,240
29865634@N04,2589,14,1308324925,1308325045,1,5,120
29865634@N04,2590,21,1319181271,1319181721,2,4,450
29865634@N04,2590,26,1319182396,1319182576,2,4,180
29865634@N04,2590,13,1319183030,1319183630,2,4,600
29865634@N04,2590,16,1319190985,1319191705,1,4,720
29869245@N07,2591,24,1258860987,1258861467,1,1,480
29870124@N02,2592,27,1336193913,1336195113,22,1,1200
29875277@N02,2593,27,1389247832,1389249032,4,1,1200
29882217@N06,2594,13,1353896455,1353897055,1,1,600
29896241@N06,2595,1,1220058222,1220058822,3,1,600
29896241@N06,2596,4,1220089334,1220090234,1,1,900
29913634@N06,2597,21,1368751020,1368751470,3,1,450
29914374@N05,2598,16,1240969633,1240970353,1,1,720
29924665@N05,2599,16,1454612400,1454613120,2,9,720
29924665@N05,2599,14,1454620931,1454621051,11,9,120
29924665@N05,2599,11,1454622347,1454622527,2,9,180
29924665@N05,2599,8,1454623047,1454623167,6,9,120
29924665@N05,2599,10,1454625156,1454625576,4,9,420
29924665@N05,2599,9,1454627030,1454627270,3,9,240
29924665@N05,2599,16,1454652693,1454653413,11,9,720
29924665@N05,2599,17,1454666035,1454667415,2,9,1380
29924665@N05,2599,16,1454670678,1454671398,1,9,720
29929764@N05,2600,16,1245773340,1245774060,1,1,720
29980560@N06,2601,19,1282092848,1282093268,3,2,420
29980560@N06,2601,27,1282096881,1282098081,1,2,1200
29980560@N06,2602,20,1283054259,1283055339,1,1,1080
30022156@N00,2603,14,1267317627,1267317747,28,1,120
30022156@N00,2604,27,1315012529,1315013729,38,1,1200
30022156@N00,2605,27,1322182762,1322183962,14,1,1200
30030726@N05,2606,27,1437382660,1437383860,2,4,1200
30030726@N05,2606,14,1437388187,1437388307,2,4,120
30030726@N05,2606,17,1437388332,1437388645,2,4,313
30030726@N05,2606,27,1437388645,1437389845,2,4,1200
30042168@N03,2607,27,1328412166,1328413366,2,4,1200
30042168@N03,2607,7,1328425760,1328425813,3,4,53
30042168@N03,2607,6,1328425813,1328426068,3,4,255
30042168@N03,2607,4,1328430555,1328431455,2,4,900
30042168@N03,2608,27,1328474405,1328475605,3,6,1200
30042168@N03,2608,14,1328477807,1328477814,2,6,7
30042168@N03,2608,16,1328477814,1328477823,2,6,9
30042168@N03,2608,14,1328477823,1328477943,5,6,120
30042168@N03,2608,16,1328479772,1328479780,2,6,8
30042168@N03,2608,14,1328479780,1328479900,1,6,120
30042168@N03,2609,4,1328597374,1328597380,2,2,6
30042168@N03,2609,3,1328597380,1328597650,1,2,270
30042168@N03,2610,3,1328674228,1328674498,2,1,270
30042168@N03,2611,26,1328829274,1328829454,2,11,180
30042168@N03,2611,23,1328831627,1328831717,5,11,90
30042168@N03,2611,15,1328833454,1328833634,7,11,180
30042168@N03,2611,3,1328835309,1328835317,2,11,8
30042168@N03,2611,2,1328835317,1328835407,2,11,90
30042168@N03,2611,3,1328836101,1328836371,2,11,270
30042168@N03,2611,27,1328853407,1328854607,7,11,1200
30042168@N03,2611,2,1328855854,1328855944,8,11,90
30042168@N03,2611,4,1328857193,1328858093,2,11,900
30042168@N03,2611,16,1328871220,1328871940,2,11,720
30042168@N03,2611,2,1328873175,1328873265,1,11,90
30042168@N03,2612,27,1328913350,1328914550,3,2,1200
30042168@N03,2612,25,1328941392,1328942142,1,2,750
30042168@N03,2613,27,1328998469,1328999669,5,4,1200
30042168@N03,2613,2,1329000052,1329000142,8,4,90
30042168@N03,2613,1,1329000190,1329000617,5,4,427
30042168@N03,2613,9,1329000617,1329000857,2,4,240
30052360@N08,2614,27,1341308980,1341310180,39,1,1200
30061875@N03,2615,9,1302696233,1302696473,4,2,240
30061875@N03,2615,16,1302696560,1302697280,1,2,720
30104263@N00,2616,3,1194253361,1194253631,1,1,270
30145793@N07,2617,14,1214129317,1214129437,1,1,120
30145793@N07,2618,18,1214448245,1214450045,1,1,1800
30196619@N08,2619,17,1225371992,1225373372,1,1,1380
30197109@N03,2620,26,1343638963,1343639143,1,1,180
30197109@N03,2621,25,1343782959,1343783709,1,1,750
30256684@N02,2622,2,1190168811,1190168811,2,7,0
30256684@N02,2622,3,1190168811,1190168811,2,7,0
30256684@N02,2622,17,1190168811,1190168811,2,7,0
30256684@N02,2622,19,1190168811,1190168811,2,7,0
30256684@N02,2622,20,1190168811,1190168811,2,7,0
30256684@N02,2622,21,1190168811,1190168811,2,7,0
30256684@N02,2622,27,1190168811,1190170011,2,7,1200
30269754@N05,2623,21,1283675614,1283676064,3,2,450
30269754@N05,2623,20,1283679121,1283680201,1,2,1080
30269754@N05,2624,27,1292574032,1292575232,2,2,1200
30269754@N05,2624,17,1292581371,1292582751,1,2,1380
30269754@N05,2625,27,1327730706,1327731502,3,10,796
30269754@N05,2625,25,1327731502,1327732073,4,10,571
30269754@N05,2625,23,1327732073,1327732163,3,10,90
30269754@N05,2625,24,1327732298,1327732483,2,10,185
30269754@N05,2625,21,1327732483,1327732554,2,10,71
30269754@N05,2625,20,1327732554,1327732638,2,10,84
30269754@N05,2625,22,1327732638,1327733238,3,10,600
30269754@N05,2625,26,1327734129,1327734309,5,10,180
30269754@N05,2625,15,1327734937,1327735117,2,10,180
30269754@N05,2625,27,1327736826,1327738026,2,10,1200
30269754@N05,2626,20,1408067500,1408068580,18,11,1080
30269754@N05,2626,10,1408076603,1408077023,8,11,420
30269754@N05,2626,15,1408077268,1408077448,7,11,180
30269754@N05,2626,25,1408077923,1408078427,12,11,504
30269754@N05,2626,26,1408078427,1408078499,2,11,72
30269754@N05,2626,24,1408078499,1408078979,4,11,480
30269754@N05,2626,22,1408079567,1408079619,2,11,52
30269754@N05,2626,23,1408079619,1408079709,3,11,90
30269754@N05,2626,22,1408079951,1408080551,2,11,600
30269754@N05,2626,9,1408083142,1408083382,3,11,240
30269754@N05,2626,19,1408083746,1408084166,28,11,420
30302460@N03,2627,27,1379504585,1379505785,1,1,1200
30302460@N03,2628,27,1393159205,1393160405,1,1,1200
30302460@N03,2629,27,1400853603,1400854803,1,1,1200
30446909@N07,2630,1,1345697651,1345698251,1,1,600
30457574@N00,2631,4,1216062691,1216063591,1,1,900
30468514@N08,2632,27,1397435613,1397436813,2,8,1200
30468514@N08,2632,10,1397437344,1397437764,2,8,420
30468514@N08,2632,4,1397438547,1397438861,2,8,314
30468514@N08,2632,23,1397438861,1397438951,2,8,90
30468514@N08,2632,22,1397439563,1397440163,2,8,600
30468514@N08,2632,6,1397456175,1397456430,2,8,255
30468514@N08,2632,17,1397469173,1397469549,2,8,376
30468514@N08,2632,27,1397469549,1397470749,2,8,1200
30468601@N00,2633,18,1324270374,1324272174,7,1,1800
30468601@N00,2634,21,1324438164,1324438614,5,1,450
30485540@N03,2635,17,1244330603,1244331983,1,1,1380
30485540@N03,2636,16,1244914852,1244914946,2,3,94
30485540@N03,2636,18,1244914946,1244915094,2,3,148
30485540@N03,2636,16,1244915094,1244915814,2,3,720
30485540@N03,2637,16,1247881249,1247881969,1,1,720
30493847@N04,2638,19,1317604691,1317605111,1,1,420
30498826@N00,2639,16,1291330744,1291331464,3,2,720
30498826@N00,2639,14,1291332826,1291332946,2,2,120
30498826@N00,2640,26,1303030044,1303030224,28,1,180
30498826@N00,2641,27,1303085942,1303087142,55,1,1200
30514233@N05,2642,16,1313831393,1313832113,1,1,720
30517481@N08,2643,7,1215152020,1215152110,1,1,90
30520769@N06,2644,2,1224391070,1224391160,7,1,90
30535117@N06,2645,27,1449918682,1449919882,3,1,1200
30573133@N00,2646,9,1368610727,1368610967,2,3,240
30573133@N00,2646,13,1368611584,1368612184,2,3,600
30573133@N00,2646,19,1368612888,1368613308,1,3,420
30622023@N08,2647,27,1314855894,1314857094,2,2,1200
30622023@N08,2647,21,1314876253,1314876703,1,2,450
30629351@N00,2648,27,1218165107,1218166307,5,10,1200
30629351@N00,2648,9,1218167423,1218167663,7,10,240
30629351@N00,2648,8,1218168656,1218168776,5,10,120
30629351@N00,2648,17,1218172198,1218173578,24,10,1380
30629351@N00,2648,14,1218177955,1218178075,7,10,120
30629351@N00,2648,27,1218196764,1218197964,6,10,1200
30629351@N00,2648,4,1218198253,1218199153,4,10,900
30629351@N00,2648,2,1218202902,1218202992,2,10,90
30629351@N00,2648,4,1218203780,1218204680,3,10,900
30629351@N00,2648,12,1218209923,1218210763,8,10,840
30629351@N00,2649,26,1218508029,1218508209,2,12,180
30629351@N00,2649,21,1218509725,1218510175,5,12,450
30629351@N00,2649,19,1218511456,1218511876,3,12,420
30629351@N00,2649,25,1218516032,1218516782,5,12,750
30629351@N00,2649,18,1218517736,1218518691,3,12,955
30629351@N00,2649,19,1218518691,1218519111,4,12,420
30629351@N00,2649,18,1218519324,1218521124,4,12,1800
30629351@N00,2649,24,1218521427,1218521907,13,12,480
30629351@N00,2649,20,1218522258,1218523338,2,12,1080
30629351@N00,2649,23,1218527244,1218527334,2,12,90
30629351@N00,2649,19,1218528015,1218528435,3,12,420
30629351@N00,2649,27,1218530352,1218531552,2,12,1200
30631138@N00,2650,27,1289194301,1289195501,1,1,1200
30650680@N02,2651,16,1276518756,1276519476,1,1,720
30650680@N02,2652,9,1434021355,1434021595,1,1,240
30651729@N05,2653,19,1389158750,1389159170,3,2,420
30651729@N05,2653,4,1389164797,1389165697,1,2,900
30701202@N03,2654,27,1434103301,1434104501,1,1,1200
30707075@N08,2655,27,1444174946,1444176146,1,1,1200
30708841@N05,2656,14,1328923776,1328923896,1,1,120
30738244@N07,2657,27,1201661042,1201662242,2,4,1200
30738244@N07,2657,16,1201662584,1201663304,2,4,720
30738244@N07,2657,21,1201663616,1201664066,2,4,450
30738244@N07,2657,13,1201667001,1201667601,1,4,600
30738244@N07,2658,16,1202968001,1202968721,1,1,720
30738244@N07,2659,25,1203813963,1203814206,2,4,243
30738244@N07,2659,24,1203814206,1203814686,3,4,480
30738244@N07,2659,20,1203820811,1203821891,2,4,1080
30738244@N07,2659,2,1203836805,1203836895,1,4,90
30738244@N07,2660,24,1206781292,1206781772,2,2,480
30738244@N07,2660,13,1206787535,1206788135,1,2,600
30738244@N07,2661,20,1209449668,1209450748,1,1,1080
30738244@N07,2662,12,1216349926,1216350766,3,3,840
30738244@N07,2662,7,1216358667,1216358757,2,3,90
30738244@N07,2662,4,1216366841,1216367741,1,3,900
30738244@N07,2663,19,1218081333,1218081753,1,1,420
30738244@N07,2664,16,1218711837,1218712557,10,1,720
30743089@N05,2665,4,1293066724,1293067624,2,4,900
30743089@N05,2665,24,1293070609,1293071089,4,4,480
30743089@N05,2665,14,1293086116,1293086236,2,4,120
30743089@N05,2665,16,1293086448,1293087168,1,4,720
30768270@N04,2666,17,1312028160,1312029540,1,1,1380
30793917@N07,2667,22,1274261188,1274261788,3,1,600
30793917@N07,2668,24,1274578520,1274579000,1,1,480
30793917@N07,2669,22,1275115749,1275116349,1,1,600
30831872@N08,2670,21,1241235430,1241235880,7,2,450
30831872@N08,2670,27,1241255582,1241256782,4,2,1200
30831872@N08,2671,13,1241351790,1241352390,1,1,600
30831872@N08,2672,13,1241403706,1241404306,2,2,600
30831872@N08,2672,20,1241408848,1241409928,1,2,1080
30831872@N08,2673,17,1241487091,1241488471,2,5,1380
30831872@N08,2673,22,1241492286,1241492886,2,5,600
30831872@N08,2673,14,1241496858,1241496978,2,5,120
30831872@N08,2673,16,1241501399,1241502119,2,5,720
30831872@N08,2673,3,1241507286,1241507556,2,5,270
30831872@N08,2674,21,1241659507,1241659957,3,2,450
30831872@N08,2674,13,1241663792,1241664392,5,2,600
30831872@N08,2675,20,1241844166,1241845246,2,7,1080
30831872@N08,2675,19,1241845908,1241846328,3,7,420
30831872@N08,2675,13,1241849955,1241850555,2,7,600
30831872@N08,2675,20,1241853893,1241854973,3,7,1080
30831872@N08,2675,3,1241863948,1241864215,2,7,267
30831872@N08,2675,5,1241864215,1241864935,2,7,720
30831872@N08,2675,13,1241866837,1241867437,2,7,600
30845032@N04,2676,23,1384384320,1384384410,1,1,90
30868771@N03,2677,27,1412849508,1412850708,5,1,1200
30891516@N08,2678,9,1305002360,1305002600,2,2,240
30891516@N08,2678,26,1305023248,1305023428,2,2,180
30891516@N08,2679,25,1305244830,1305245580,2,5,750
30891516@N08,2679,17,1305250366,1305250592,3,5,226
30891516@N08,2679,19,1305250592,1305251012,2,5,420
30891516@N08,2679,27,1305256095,1305257295,8,5,1200
30891516@N08,2679,14,1305277378,1305277498,10,5,120
30954521@N08,2680,27,1229703290,1229704490,2,2,1200
30954521@N08,2680,3,1229708224,1229708494,1,2,270
30954521@N08,2681,27,1230656727,1230657850,2,2,1123
30954521@N08,2681,17,1230657850,1230659230,1,2,1380
30960094@N04,2682,27,1262733679,1262734879,8,7,1200
30960094@N04,2682,17,1262742713,1262742727,2,7,14
30960094@N04,2682,26,1262742727,1262742907,3,7,180
30960094@N04,2682,24,1262744331,1262744811,2,7,480
30960094@N04,2682,27,1262750152,1262751352,2,7,1200
30960094@N04,2682,4,1262751820,1262752720,2,7,900
30960094@N04,2682,16,1262755703,1262756423,2,7,720
31001191@N05,2683,27,1194681340,1194682540,4,1,1200
31006502@N04,2684,20,1370002377,1370003457,1,1,1080
31006502@N04,2685,19,1406102668,1406103088,1,1,420
31006502@N04,2686,18,1420262315,1420264115,1,1,1800
31028157@N07,2687,14,1241777266,1241777386,2,1,120
31115319@N00,2688,8,1394149042,1394149162,1,1,120
31120227@N02,2689,27,1305020950,1305022150,1,1,1200
31149014@N00,2690,22,1329007654,1329008254,1,1,600
31181649@N00,2691,14,1294216136,1294216256,1,1,120
31188169@N04,2692,16,1332255447,1332256167,1,1,720
31188169@N04,2693,27,1336632865,1336634065,2,5,1200
31188169@N04,2693,16,1336636764,1336637484,4,5,720
31188169@N04,2693,20,1336639688,1336640768,3,5,1080
31188169@N04,2693,17,1336643080,1336644460,2,5,1380
31188169@N04,2693,16,1336648130,1336648850,1,5,720
31188169@N04,2694,17,1336722639,1336724019,2,2,1380
31188169@N04,2694,16,1336733160,1336733880,1,2,720
31223689@N00,2695,22,1222403499,1222404099,5,2,600
31223689@N00,2695,19,1222405387,1222405807,1,2,420
31281767@N04,2696,27,1348963749,1348964799,2,5,1050
31281767@N04,2696,21,1348964799,1348965017,2,5,218
31281767@N04,2696,20,1348965017,1348966097,2,5,1080
31281767@N04,2696,1,1348968682,1348969282,2,5,600
31281767@N04,2696,27,1348977832,1348979032,1,5,1200
31288648@N08,2697,16,1254046270,1254046990,9,1,720
31291728@N05,2698,9,1414997500,1414997740,2,1,240
31291728@N05,2699,27,1415240212,1415241412,2,9,1200
31291728@N05,2699,9,1415246236,1415246476,3,9,240
31291728@N05,2699,6,1415247314,1415247569,3,9,255
31291728@N05,2699,9,1415247596,1415247607,2,9,11
31291728@N05,2699,6,1415247607,1415247862,2,9,255
31291728@N05,2699,17,1415262537,1415263917,4,9,1380
31291728@N05,2699,9,1415271648,1415271888,4,9,240
31291728@N05,2699,14,1415276033,1415276153,2,9,120
31291728@N05,2699,27,1415277120,1415278320,1,9,1200
31291728@N05,2700,10,1430984801,1430985221,2,5,420
31291728@N05,2700,7,1430987661,1430987682,2,5,21
31291728@N05,2700,6,1430987682,1430987937,2,5,255
31291728@N05,2700,4,1430990921,1430991821,2,5,900
31291728@N05,2700,19,1430992892,1430993312,1,5,420
31291728@N05,2701,9,1431175681,1431175921,2,1,240
31291728@N05,2702,23,1431224096,1431224186,5,3,90
31291728@N05,2702,14,1431228069,1431228189,3,3,120
31291728@N05,2702,7,1431231837,1431231927,1,3,90
31291728@N05,2703,27,1431302634,1431302927,2,6,293
31291728@N05,2703,17,1431302927,1431304307,2,6,1380
31291728@N05,2703,3,1431308982,1431309252,2,6,270
31291728@N05,2703,9,1431311738,1431311978,2,6,240
31291728@N05,2703,10,1431312524,1431312801,2,6,277
31291728@N05,2703,15,1431312801,1431312981,2,6,180
31291728@N05,2704,26,1461551926,1461552106,1,1,180
31291728@N05,2705,10,1461763523,1461763943,5,2,420
31291728@N05,2705,14,1461765834,1461765954,1,2,120
31291728@N05,2706,23,1461806700,1461806790,5,1,90
31291728@N05,2707,14,1461896556,1461896676,4,2,120
31291728@N05,2707,27,1461912610,1461913810,1,2,1200
31291728@N05,2708,27,1461983952,1461985152,2,3,1200
31291728@N05,2708,14,1461993001,1461993088,2,3,87
31291728@N05,2708,12,1461993088,1461993928,7,3,840
31295546@N04,2709,14,1307354760,1307354880,3,1,120
31331814@N04,2710,3,1376623240,1376623510,2,3,270
31331814@N04,2710,11,1376627600,1376627780,6,3,180
31331814@N04,2710,27,1376633074,1376634274,1,3,1200
31348155@N03,2711,9,1325927096,1325927336,1,1,240
31348155@N03,2712,9,1326388290,1326388530,1,1,240
31360405@N06,2713,27,1284760152,1284760579,6,4,427
31360405@N06,2713,16,1284760579,1284760631,2,4,52
31360405@N06,2713,27,1284760631,1284760855,2,4,224
31360405@N06,2713,16,1284760855,1284761575,4,4,720
31360405@N06,2714,16,1285036752,1285037472,19,1,720
31360405@N06,2715,16,1285153048,1285153768,1,1,720
31369133@N04,2716,16,1292061538,1292062258,1,1,720
31385681@N02,2717,8,1195600182,1195600302,1,1,120
31409566@N00,2718,27,1258083024,1258083057,2,3,33
31409566@N00,2718,3,1258083057,1258083327,3,3,270
31409566@N00,2718,27,1258084673,1258085873,37,3,1200
31429098@N03,2719,3,1375605296,1375605566,1,1,270
31449648@N05,2720,10,1351908817,1351909237,1,1,420
31449648@N05,2721,27,1361772114,1361773314,1,1,1200
31449648@N05,2722,6,1362268222,1362268477,1,1,255
31449648@N05,2723,6,1366193068,1366193323,1,1,255
31449648@N05,2724,17,1377592211,1377593591,1,1,1380
31449648@N05,2725,3,1377656488,1377656758,1,1,270
31449648@N05,2726,6,1378685946,1378686201,1,1,255
31457177@N08,2727,6,1353509121,1353509376,1,1,255
31491939@N05,2728,21,1191843508,1191843958,46,1,450
31491939@N05,2729,21,1220483361,1220483811,32,1,450
31491939@N05,2730,21,1256978074,1256978524,98,1,450
31491939@N05,2731,21,1262246576,1262247026,18,1,450
31499593@N03,2732,16,1321956736,1321957456,1,1,720
31535569@N00,2733,16,1255387398,1255388118,2,3,720
31535569@N00,2733,9,1255389187,1255389427,4,3,240
31535569@N00,2733,27,1255406541,1255407741,11,3,1200
31535569@N00,2734,6,1255481913,1255482168,4,2,255
31535569@N00,2734,1,1255485074,1255485674,3,2,600
31535569@N00,2735,3,1255562093,1255562151,2,3,58
31535569@N00,2735,2,1255562151,1255562241,4,3,90
31535569@N00,2735,9,1255570609,1255570849,3,3,240
31545574@N02,2736,19,1313898811,1313899231,1,1,420
31559075@N00,2737,27,1257716007,1257717207,7,4,1200
31559075@N00,2737,16,1257719155,1257719875,3,4,720
31559075@N00,2737,27,1257724269,1257725469,2,4,1200
31559075@N00,2737,26,1257733378,1257733558,1,4,180
31559075@N00,2738,27,1280040875,1280042075,1,1,1200
31565537@N00,2739,16,1280965427,1280966147,19,1,720
31565537@N00,2740,16,1281057470,1281058190,18,1,720
31572810@N04,2741,2,1353823106,1353823196,1,1,90
31608675@N00,2742,16,1253273084,1253273804,4,1,720
31616435@N04,2743,27,1311303434,1311304634,3,1,1200
31616435@N04,2744,27,1315633833,1315635033,9,1,1200
31646024@N00,2745,13,1192201922,1192202522,6,4,600
31646024@N00,2745,1,1192222645,1192223245,2,4,600
31646024@N00,2745,16,1192225551,1192226271,5,4,720
31646024@N00,2745,27,1192233610,1192234810,2,4,1200
31646024@N00,2746,27,1208486583,1208487783,18,8,1200
31646024@N00,2746,16,1208490011,1208490341,10,8,330
31646024@N00,2746,14,1208490341,1208490461,2,8,120
31646024@N00,2746,16,1208494325,1208494847,2,8,522
31646024@N00,2746,13,1208494847,1208495447,10,8,600
31646024@N00,2746,21,1208501299,1208501749,5,8,450
31646024@N00,2746,24,1208504213,1208504693,11,8,480
31646024@N00,2746,27,1208506024,1208507224,2,8,1200
31692641@N00,2747,16,1223463022,1223463041,4,7,19
31692641@N00,2747,27,1223463041,1223463051,2,7,10
31692641@N00,2747,2,1223463051,1223463059,2,7,8
31692641@N00,2747,9,1223463059,1223463063,2,7,4
31692641@N00,2747,14,1223463063,1223463069,2,7,6
31692641@N00,2747,9,1223463069,1223463076,2,7,7
31692641@N00,2747,14,1223463076,1223463196,1,7,120
31692641@N00,2748,2,1223698086,1223698176,1,1,90
31692641@N00,2749,15,1228426298,1228426478,2,13,180
31692641@N00,2749,1,1228440479,1228441079,2,13,600
31692641@N00,2749,20,1228446926,1228448006,2,13,1080
31692641@N00,2749,27,1228451920,1228453120,2,13,1200
31692641@N00,2749,14,1228455001,1228455003,3,13,2
31692641@N00,2749,3,1228455003,1228455005,3,13,2
31692641@N00,2749,2,1228455005,1228455006,2,13,1
31692641@N00,2749,27,1228455006,1228456206,3,13,1200
31692641@N00,2749,14,1228456800,1228456803,4,13,3
31692641@N00,2749,9,1228456803,1228456804,2,13,1
31692641@N00,2749,4,1228456804,1228456805,2,13,1
31692641@N00,2749,3,1228456805,1228456807,3,13,2
31692641@N00,2749,1,1228456807,1228457407,1,13,600
31692641@N00,2750,27,1228741201,1228741211,11,2,10
31692641@N00,2750,11,1228741211,1228741391,5,2,180
31692641@N00,2751,27,1228771432,1228772632,6,17,1200
31692641@N00,2751,14,1228773372,1228773492,2,17,120
31692641@N00,2751,9,1228773990,1228774230,3,17,240
31692641@N00,2751,11,1228774853,1228775033,3,17,180
31692641@N00,2751,14,1228775335,1228775455,3,17,120
31692641@N00,2751,6,1228778337,1228778592,2,17,255
31692641@N00,2751,2,1228779637,1228779727,6,17,90
31692641@N00,2751,4,1228779795,1228779999,2,17,204
31692641@N00,2751,2,1228779999,1228780089,4,17,90
31692641@N00,2751,6,1228785714,1228785969,2,17,255
31692641@N00,2751,17,1228802058,1228803438,12,17,1380
31692641@N00,2751,12,1228810564,1228811404,4,17,840
31692641@N00,2751,8,1228815000,1228815001,2,17,1
31692641@N00,2751,2,1228815001,1228815003,3,17,2
31692641@N00,2751,5,1228815003,1228815006,4,17,3
31692641@N00,2751,12,1228815006,1228815008,3,17,2
31692641@N00,2751,3,1228815008,1228815278,1,17,270
31692641@N00,2752,23,1228881605,1228881695,3,6,90
31692641@N00,2752,9,1228889162,1228889402,3,6,240
31692641@N00,2752,17,1228890129,1228891509,2,6,1380
31692641@N00,2752,21,1228899600,1228899601,2,6,1
31692641@N00,2752,26,1228899601,1228899602,2,6,1
31692641@N00,2752,17,1228899602,1228900982,1,6,1380
31692641@N00,2753,24,1228947736,1228948216,3,8,480
31692641@N00,2753,18,1228951271,1228953071,7,8,1800
31692641@N00,2753,3,1228953604,1228953605,2,8,1
31692641@N00,2753,21,1228953605,1228953607,3,8,2
31692641@N00,2753,13,1228953607,1228953608,2,8,1
31692641@N00,2753,18,1228953608,1228953609,2,8,1
31692641@N00,2753,22,1228953609,1228953611,2,8,2
31692641@N00,2753,27,1228953611,1228954811,2,8,1200
31692641@N00,2754,27,1317477600,1317477601,3,12,1
31692641@N00,2754,9,1317477601,1317477601,2,12,0
31692641@N00,2754,27,1317477601,1317477602,2,12,1
31692641@N00,2754,13,1317477602,1317477602,2,12,0
31692641@N00,2754,27,1317477602,1317477614,12,12,12
31692641@N00,2754,14,1317477614,1317477620,7,12,6
31692641@N00,2754,9,1317477620,1317477624,5,12,4
31692641@N00,2754,6,1317477624,1317477628,5,12,4
31692641@N00,2754,1,1317477628,1317477629,2,12,1
31692641@N00,2754,6,1317477629,1317477631,3,12,2
31692641@N00,2754,21,1317477631,1317477632,2,12,1
31692641@N00,2754,25,1317477632,1317478382,17,12,750
31692641@N00,2755,26,1317906007,1317906008,2,4,1
31692641@N00,2755,22,1317906008,1317906016,7,4,8
31692641@N00,2755,17,1317906016,1317906018,3,4,2
31692641@N00,2755,27,1317906018,1317907218,1,4,1200
31692641@N00,2756,27,1317964191,1317965391,5,3,1200
31692641@N00,2756,9,1317991800,1317992040,3,3,240
31692641@N00,2756,27,1317992402,1317993602,1,3,1200
31692641@N00,2757,25,1399780800,1399780800,2,11,0
31692641@N00,2757,27,1399780800,1399780801,2,11,1
31692641@N00,2757,15,1399780801,1399780801,2,11,0
31692641@N00,2757,27,1399780801,1399780806,5,11,5
31692641@N00,2757,3,1399780806,1399780815,9,11,9
31692641@N00,2757,6,1399780815,1399780820,6,11,5
31692641@N00,2757,11,1399780820,1399780823,4,11,3
31692641@N00,2757,8,1399780823,1399780826,4,11,3
31692641@N00,2757,21,1399780826,1399780827,2,11,1
31692641@N00,2757,23,1399780827,1399780828,2,11,1
31692641@N00,2757,25,1399780828,1399781578,1,11,750
31751836@N04,2758,13,1338113542,1338114142,2,3,600
31751836@N04,2758,8,1338119165,1338119285,2,3,120
31751836@N04,2758,14,1338119883,1338120003,1,3,120
31751836@N04,2759,19,1338151706,1338152126,1,1,420
31758040@N04,2760,16,1233632563,1233633283,5,1,720
31758040@N04,2761,26,1233995473,1233995653,3,2,180
31758040@N04,2761,17,1233998144,1233999524,1,2,1380
31772181@N00,2762,25,1394599849,1394600599,1,1,750
31846143@N08,2763,16,1238901515,1238902235,63,1,720
31856542@N04,2764,17,1247626674,1247628054,1,1,1380
31864937@N00,2765,27,1344737882,1344739082,2,1,1200
31911001@N00,2766,17,1414191329,1414192709,2,3,1380
31911001@N00,2766,27,1414202022,1414203222,2,3,1200
31911001@N00,2766,9,1414213395,1414213635,1,3,240
31911575@N00,2767,2,1266636763,1266636853,1,1,90
31912731@N08,2768,27,1225580763,1225581963,1,1,1200
31924266@N02,2769,11,1272744899,1272745079,1,1,180
31924266@N02,2770,21,1272837145,1272837595,1,1,450
31924266@N02,2771,21,1282956242,1282956692,1,1,450
31924266@N02,2772,12,1304558556,1304559396,1,1,840
31937081@N07,2773,9,1422071445,1422071685,3,2,240
31937081@N07,2773,1,1422073951,1422074551,1,2,600
31953929@N08,2774,12,1292027970,1292028810,1,1,840
31953929@N08,2775,22,1297404618,1297405218,2,2,600
31953929@N08,2775,14,1297406010,1297406130,1,2,120
31953929@N08,2776,9,1304934654,1304934894,2,2,240
31953929@N08,2776,4,1304935188,1304936088,1,2,900
31953929@N08,2777,14,1321061851,1321061971,1,1,120
31957707@N08,2778,14,1388292422,1388292542,1,1,120
31957707@N08,2779,7,1419481320,1419481410,2,3,90
31957707@N08,2779,26,1419489384,1419489564,4,3,180
31957707@N08,2779,27,1419491769,1419492969,3,3,1200
31957707@N08,2780,11,1419803589,1419803769,2,2,180
31957707@N08,2780,9,1419803803,1419804043,3,2,240
31962189@N04,2781,27,1400968125,1400969325,1,1,1200
31962189@N04,2782,17,1401000902,1401002282,1,1,1380
31964360@N00,2783,7,1420238791,1420238881,3,6,90
31964360@N00,2783,6,1420238954,1420239209,2,6,255
31964360@N00,2783,16,1420241154,1420241874,2,6,720
31964360@N00,2783,7,1420243550,1420243640,3,6,90
31964360@N00,2783,15,1420250303,1420250483,2,6,180
31964360@N00,2783,14,1420277384,1420277504,1,6,120
31964360@N00,2784,24,1420410769,1420411249,3,6,480
31964360@N00,2784,17,1420414483,1420415863,2,6,1380
31964360@N00,2784,22,1420418297,1420418897,2,6,600
31964360@N00,2784,27,1420437553,1420438753,2,6,1200
31964360@N00,2784,5,1420442803,1420443523,2,6,720
31964360@N00,2784,27,1420451766,1420452966,1,6,1200
31979367@N00,2785,14,1270117258,1270117378,1,1,120
32018680@N06,2786,27,1217226629,1217227829,1,1,1200
32018985@N00,2787,27,1455241323,1455242477,2,8,1154
32018985@N00,2787,17,1455242477,1455243857,2,8,1380
32018985@N00,2787,14,1455246947,1455247067,2,8,120
32018985@N00,2787,21,1455251717,1455252167,16,8,450
32018985@N00,2787,20,1455255268,1455255294,2,8,26
32018985@N00,2787,21,1455255294,1455255744,6,8,450
32018985@N00,2787,13,1455258604,1455259204,3,8,600
32018985@N00,2787,9,1455260613,1455260853,2,8,240
32018985@N00,2788,27,1455416236,1455417436,8,7,1200
32018985@N00,2788,23,1455421923,1455422013,2,7,90
32018985@N00,2788,22,1455422762,1455423362,2,7,600
32018985@N00,2788,6,1455425234,1455425489,2,7,255
32018985@N00,2788,14,1455430960,1455431080,12,7,120
32018985@N00,2788,16,1455433702,1455434422,5,7,720
32018985@N00,2788,27,1455434520,1455435720,2,7,1200
32028508@N05,2789,21,1418462029,1418462479,1,1,450
32046983@N08,2790,14,1447009403,1447009523,1,1,120
32077113@N00,2791,1,1269239192,1269239792,1,1,600
32077113@N00,2792,21,1269402532,1269402982,4,1,450
32173292@N05,2793,16,1200191104,1200191824,1,1,720
32173292@N05,2794,16,1200358897,1200359617,1,1,720
32263245@N00,2795,9,1253271520,1253271760,14,1,240
32263245@N00,2796,9,1283595767,1283596007,7,1,240
32263245@N00,2797,27,1287735333,1287736533,2,3,1200
32263245@N00,2797,5,1287738716,1287739436,2,3,720
32263245@N00,2797,17,1287744023,1287745403,1,3,1380
32263245@N00,2798,1,1295749107,1295749707,1,1,600
32263245@N00,2799,5,1430452489,1430453209,7,1,720
32274991@N03,2800,21,1371278612,1371279062,1,1,450
32279598@N02,2801,14,1407413522,1407413642,2,2,120
32279598@N02,2801,16,1407417610,1407418330,1,2,720
32284286@N00,2802,25,1338816135,1338816219,2,3,84
32284286@N00,2802,6,1338816219,1338816446,3,3,227
32284286@N00,2802,27,1338816446,1338817646,2,3,1200
32288431@N08,2803,1,1317513946,1317514546,1,1,600
32288431@N08,2804,18,1409206424,1409206446,2,6,22
32288431@N08,2804,19,1409206446,1409206559,2,6,113
32288431@N08,2804,13,1409206559,1409206635,2,6,76
32288431@N08,2804,19,1409206635,1409206760,7,6,125
32288431@N08,2804,18,1409206760,1409208560,4,6,1800
32288431@N08,2804,27,1409214602,1409215802,2,6,1200
32288431@N08,2805,27,1409528725,1409529925,3,13,1200
32288431@N08,2805,25,1409531284,1409531487,7,13,203
32288431@N08,2805,26,1409531487,1409531609,4,13,122
32288431@N08,2805,23,1409531609,1409531699,2,13,90
32288431@N08,2805,21,1409531884,1409532334,4,13,450
32288431@N08,2805,24,1409532427,1409532433,2,13,6
32288431@N08,2805,23,1409532433,1409532523,5,13,90
32288431@N08,2805,25,1409532565,1409532576,2,13,11
32288431@N08,2805,23,1409532576,1409532666,3,13,90
32288431@N08,2805,10,1409539411,1409539831,7,13,420
32288431@N08,2805,7,1409541101,1409541191,4,13,90
32288431@N08,2805,8,1409541423,1409541543,5,13,120
32288431@N08,2805,1,1409541561,1409542161,1,13,600
32306742@N04,2806,16,1468887126,1468887753,2,4,627
32306742@N04,2806,2,1468887753,1468887843,3,4,90
32306742@N04,2806,1,1468889857,1468890457,2,4,600
32306742@N04,2806,3,1468890591,1468890861,2,4,270
32306742@N04,2807,14,1468997817,1468997937,1,1,120
32359947@N00,2808,17,1244024273,1244024505,2,2,232
32359947@N00,2808,13,1244024505,1244025105,8,2,600
32363335@N00,2809,27,1400281334,1400282534,2,2,1200
32363335@N00,2809,19,1400283940,1400284360,1,2,420
32370701@N02,2810,20,1292192826,1292193906,1,1,1080
32392791@N00,2811,27,1270077094,1270078294,68,1,1200
32401942@N04,2812,4,1335176318,1335177218,2,1,900
32485654@N03,2813,5,1299851769,1299852489,1,1,720
32509269@N08,2814,27,1303183845,1303183854,2,4,9
32509269@N08,2814,14,1303183854,1303183869,2,4,15
32509269@N08,2814,18,1303183869,1303183871,2,4,2
32509269@N08,2814,16,1303183871,1303184591,1,4,720
32544079@N08,2815,21,1457662245,1457662695,2,2,450
32544079@N08,2815,22,1457669758,1457670358,1,2,600
32558000@N00,2816,12,1361691729,1361692569,1,1,840
32617425@N00,2817,27,1346984286,1346985486,6,1,1200
32617425@N00,2818,27,1350117946,1350119146,137,1,1200
32617425@N00,2819,27,1352537847,1352539047,11,1,1200
32617425@N00,2820,27,1379384641,1379385841,4,4,1200
32617425@N00,2820,17,1379387751,1379387791,6,4,40
32617425@N00,2820,15,1379387791,1379387971,5,4,180
32617425@N00,2820,27,1379389052,1379390252,7,4,1200
32617425@N00,2821,27,1404384073,1404385273,30,1,1200
32617425@N00,2822,27,1436572959,1436574159,16,1,1200
32644191@N07,2823,17,1254971849,1254972118,2,4,269
32644191@N07,2823,13,1254972118,1254972718,2,4,600
32644191@N07,2823,19,1254991731,1254992151,2,4,420
32644191@N07,2823,16,1255002591,1255003311,1,4,720
32730020@N08,2824,16,1294045720,1294046440,3,1,720
32735714@N07,2825,13,1280808628,1280809228,56,1,600
32740711@N06,2826,14,1432903269,1432903389,2,2,120
32740711@N06,2826,16,1432903406,1432904126,1,2,720
32744581@N05,2827,16,1277285396,1277286116,2,1,720
32752574@N07,2828,22,1262264400,1262265000,1,1,600
32813984@N08,2829,4,1393099302,1393100202,1,1,900
32884264@N05,2830,26,1272091640,1272091820,1,1,180
32904352@N00,2831,21,1220443423,1220443873,1,1,450
32904352@N00,2832,7,1347185884,1347185974,3,1,90
32904352@N00,2833,20,1347354288,1347355368,7,3,1080
32904352@N00,2833,21,1347359539,1347359989,3,3,450
32904352@N00,2833,19,1347362368,1347362788,1,3,420
32904352@N00,2834,3,1347501680,1347501950,4,8,270
32904352@N00,2834,17,1347509840,1347511220,3,8,1380
32904352@N00,2834,25,1347511989,1347512069,3,8,80
32904352@N00,2834,17,1347512069,1347513449,2,8,1380
32904352@N00,2834,19,1347514647,1347515067,5,8,420
32904352@N00,2834,20,1347515560,1347516640,3,8,1080
32904352@N00,2834,19,1347517878,1347518298,2,8,420
32904352@N00,2834,17,1347520740,1347522120,13,8,1380
32904352@N00,2835,7,1347591434,1347591524,2,1,90
32939273@N02,2836,25,1369372422,1369372706,2,2,284
32939273@N02,2836,16,1369372706,1369373426,37,2,720
32996060@N05,2837,27,1393098209,1393099409,69,1,1200
33029321@N00,2838,16,1331482241,1331482961,14,2,720
33029321@N00,2838,9,1331492257,1331492497,5,2,240
33029321@N00,2839,27,1331552024,1331553224,14,4,1200
33029321@N00,2839,22,1331554436,1331555036,18,4,600
33029321@N00,2839,21,1331555325,1331555775,9,4,450
33029321@N00,2839,25,1331558043,1331558793,23,4,750
33063488@N02,2840,27,1224625197,1224626397,1,1,1200
33063488@N02,2841,27,1286440371,1286441571,2,3,1200
33063488@N02,2841,17,1286448864,1286450244,2,3,1380
33063488@N02,2841,27,1286454203,1286455403,1,3,1200
33063488@N02,2842,25,1301139486,1301140236,2,3,750
33063488@N02,2842,17,1301141332,1301142370,2,3,1038
33063488@N02,2842,13,1301142370,1301142970,1,3,600
33063488@N02,2843,25,1301223882,1301224632,1,1,750
33121758@N04,2844,27,1317418315,1317419515,2,2,1200
33121758@N04,2844,16,1317423600,1317424320,1,2,720
33121758@N04,2845,16,1321082763,1321083483,1,1,720
33121758@N04,2846,21,1325913303,1325913753,1,1,450
33121758@N04,2847,14,1328354498,1328354618,2,2,120
33121758@N04,2847,9,1328354872,1328355112,1,2,240
33121758@N04,2848,17,1329006628,1329008008,1,1,1380
33121758@N04,2849,27,1334988976,1334990061,4,2,1085
33121758@N04,2849,14,1334990061,1334990181,5,2,120
33121758@N04,2850,10,1350433235,1350433655,1,1,420
33121758@N04,2851,16,1352363349,1352364069,2,3,720
33121758@N04,2851,14,1352376015,1352376135,2,3,120
33121758@N04,2851,16,1352377486,1352378206,1,3,720
33121758@N04,2852,24,1359769891,1359770371,2,2,480
33121758@N04,2852,14,1359795548,1359795668,1,2,120
33121758@N04,2853,27,1378513507,1378514707,1,1,1200
33121758@N04,2854,24,1384502874,1384503354,1,1,480
33197996@N07,2855,14,1271459770,1271459890,7,1,120
33197996@N07,2856,14,1271498776,1271498896,3,4,120
33197996@N07,2856,9,1271508179,1271508419,2,4,240
33197996@N07,2856,14,1271508539,1271508659,2,4,120
33197996@N07,2856,16,1271510454,1271511174,1,4,720
33197996@N07,2857,14,1399665311,1399665431,1,1,120
33197996@N07,2858,14,1400783534,1400783654,1,1,120
33197996@N07,2859,21,1402482688,1402483138,1,1,450
33197996@N07,2860,19,1404855722,1404856142,1,1,420
33197996@N07,2861,16,1408052570,1408053290,1,1,720
33197996@N07,2862,27,1408101907,1408103107,1,1,1200
33197996@N07,2863,14,1409036382,1409036502,1,1,120
33197996@N07,2864,25,1410377664,1410378414,1,1,750
33197996@N07,2865,27,1411681779,1411682979,1,1,1200
33197996@N07,2866,4,1414616909,1414617809,1,1,900
33197996@N07,2867,8,1422912596,1422912716,1,1,120
33197996@N07,2868,16,1430118857,1430119577,1,1,720
33197996@N07,2869,14,1431646712,1431646832,1,1,120
33237989@N06,2870,2,1205451929,1205452019,1,1,90
33237989@N06,2871,9,1205483565,1205483805,2,3,240
33237989@N06,2871,20,1205486566,1205487646,2,3,1080
33237989@N06,2871,4,1205492119,1205493019,1,3,900
33237989@N06,2872,27,1238020669,1238021740,3,13,1071
33237989@N06,2872,16,1238021740,1238021945,3,13,205
33237989@N06,2872,4,1238021945,1238022845,2,13,900
33237989@N06,2872,3,1238023456,1238023726,2,13,270
33237989@N06,2872,2,1238025820,1238025910,5,13,90
33237989@N06,2872,9,1238027550,1238027790,4,13,240
33237989@N06,2872,14,1238028255,1238028375,3,13,120
33237989@N06,2872,13,1238033068,1238033668,4,13,600
33237989@N06,2872,19,1238036864,1238037284,2,13,420
33237989@N06,2872,21,1238037975,1238038425,2,13,450
33237989@N06,2872,17,1238041017,1238041055,2,13,38
33237989@N06,2872,16,1238041055,1238041775,5,13,720
33237989@N06,2872,22,1238049665,1238050265,1,13,600
33244915@N00,2873,27,1329007848,1329009048,6,14,1200
33244915@N00,2873,12,1329014320,1329014376,2,14,56
33244915@N00,2873,15,1329014376,1329014556,3,14,180
33244915@N00,2873,9,1329018796,1329019036,2,14,240
33244915@N00,2873,2,1329023578,1329023668,3,14,90
33244915@N00,2873,4,1329033582,1329033804,3,14,222
33244915@N00,2873,5,1329033804,1329034524,2,14,720
33244915@N00,2873,27,1329039660,1329040860,80,14,1200
33244915@N00,2873,15,1329045768,1329045894,7,14,126
33244915@N00,2873,12,1329045894,1329045916,2,14,22
33244915@N00,2873,15,1329045916,1329046046,7,14,130
33244915@N00,2873,12,1329046046,1329046130,5,14,84
33244915@N00,2873,15,1329046130,1329046152,2,14,22
33244915@N00,2873,9,1329046152,1329046392,9,14,240
33244915@N00,2874,9,1329076602,1329076842,20,6,240
33244915@N00,2874,6,1329076976,1329077231,19,6,255
33244915@N00,2874,3,1329077332,1329077480,8,6,148
33244915@N00,2874,4,1329077480,1329077682,7,6,202
33244915@N00,2874,2,1329077682,1329077772,11,6,90
33244915@N00,2874,5,1329077856,1329078576,7,6,720
33244915@N00,2875,14,1329353258,1329353346,6,7,88
33244915@N00,2875,9,1329353346,1329353586,18,7,240
33244915@N00,2875,15,1329353670,1329353758,5,7,88
33244915@N00,2875,22,1329353758,1329353790,3,7,32
33244915@N00,2875,20,1329353790,1329353806,2,7,16
33244915@N00,2875,21,1329353806,1329354256,13,7,450
33244915@N00,2875,25,1329358794,1329359544,2,7,750
33244915@N00,2876,25,1329392812,1329392828,2,12,16
33244915@N00,2876,26,1329392828,1329392846,2,12,18
33244915@N00,2876,25,1329392846,1329393046,3,12,200
33244915@N00,2876,24,1329393046,1329393090,3,12,44
33244915@N00,2876,21,1329393090,1329393124,3,12,34
33244915@N00,2876,20,1329393124,1329393216,6,12,92
33244915@N00,2876,22,1329393216,1329393400,9,12,184
33244915@N00,2876,18,1329393400,1329393414,2,12,14
33244915@N00,2876,13,1329393414,1329393488,6,12,74
33244915@N00,2876,17,1329393488,1329393620,7,12,132
33244915@N00,2876,15,1329393620,1329393684,4,12,64
33244915@N00,2876,17,1329393684,1329395064,5,12,1380
33257765@N05,2877,26,1334033854,1334034034,2,3,180
33257765@N05,2877,16,1334037448,1334038168,2,3,720
33257765@N05,2877,27,1334050400,1334051600,1,3,1200
33257765@N05,2878,16,1373948054,1373948774,3,1,720
33272592@N00,2879,20,1380937186,1380938266,2,6,1080
33272592@N00,2879,23,1380940151,1380940241,2,6,90
33272592@N00,2879,13,1380941792,1380941949,2,6,157
33272592@N00,2879,16,1380941949,1380942669,2,6,720
33272592@N00,2879,6,1380946786,1380947041,2,6,255
33272592@N00,2879,23,1380971074,1380971164,2,6,90
33277678@N03,2880,4,1393172325,1393173225,4,5,900
33277678@N03,2880,10,1393173783,1393174203,6,5,420
33277678@N03,2880,9,1393174940,1393175180,2,5,240
33277678@N03,2880,15,1393175631,1393175811,13,5,180
33277678@N03,2880,8,1393180891,1393181011,3,5,120
33312419@N07,2881,22,1353909822,1353910422,1,1,600
33312419@N07,2882,22,1354120597,1354121197,1,1,600
33334548@N05,2883,14,1396166975,1396167095,1,1,120
33352249@N03,2884,1,1331765755,1331766355,2,9,600
33352249@N03,2884,3,1331767376,1331767646,2,9,270
33352249@N03,2884,6,1331772325,1331772580,2,9,255
33352249@N03,2884,9,1331774890,1331775130,3,9,240
33352249@N03,2884,20,1331786944,1331788024,2,9,1080
33352249@N03,2884,27,1331789442,1331790642,3,9,1200
33352249@N03,2884,14,1331793739,1331793859,3,9,120
33352249@N03,2884,9,1331801461,1331801701,2,9,240
33352249@N03,2884,12,1331812759,1331813599,1,9,840
33360568@N05,2885,20,1389245382,1389246462,1,1,1080
33404394@N00,2886,13,1462013299,1462013899,1,1,600
33433883@N02,2887,4,1355448005,1355448244,2,2,239
33433883@N02,2887,3,1355448244,1355448514,1,2,270
33441892@N00,2888,27,1381101129,1381102329,2,20,1200
33441892@N00,2888,9,1381102793,1381103033,13,20,240
33441892@N00,2888,14,1381104188,1381104308,16,20,120
33441892@N00,2888,15,1381106638,1381106818,4,20,180
33441892@N00,2888,12,1381107029,1381107261,7,20,232
33441892@N00,2888,13,1381107261,1381107504,2,20,243
33441892@N00,2888,12,1381107504,1381108028,2,20,524
33441892@N00,2888,13,1381108028,1381108628,2,20,600
33441892@N00,2888,7,1381110073,1381110163,10,20,90
33441892@N00,2888,8,1381113538,1381113658,6,20,120
33441892@N00,2888,14,1381115227,1381115347,4,20,120
33441892@N00,2888,2,1381121737,1381121827,3,20,90
33441892@N00,2888,8,1381123073,1381123193,2,20,120
33441892@N00,2888,25,1381127837,1381128587,2,20,750
33441892@N00,2888,21,1381129554,1381129974,2,20,420
33441892@N00,2888,24,1381129974,1381130454,2,20,480
33441892@N00,2888,23,1381130715,1381130805,3,20,90
33441892@N00,2888,13,1381134887,1381135487,3,20,600
33441892@N00,2888,21,1381136546,1381136996,3,20,450
33441892@N00,2888,27,1381142310,1381143510,1,20,1200
33462708@N06,2889,2,1272077641,1272077731,1,1,90
33479020@N04,2890,14,1263579808,1263579928,1,1,120
33479020@N04,2891,26,1285658607,1285658787,1,1,180
33479020@N04,2892,2,1285749093,1285749183,1,1,90
33479020@N04,2893,18,1285829908,1285831708,1,1,1800
33479020@N04,2894,13,1288593238,1288593838,1,1,600
33479020@N04,2895,20,1294013826,1294014906,1,1,1080
33479020@N04,2896,22,1295415043,1295415643,1,1,600
33479020@N04,2897,17,1296019823,1296021203,1,1,1380
33479020@N04,2898,16,1297320118,1297320838,1,1,720
33479020@N04,2899,21,1298441651,1298442101,1,1,450
33479020@N04,2900,27,1299050139,1299051339,1,1,1200
33479020@N04,2901,1,1299478849,1299479449,1,1,600
33479020@N04,2902,19,1300080393,1300080813,1,1,420
33479020@N04,2903,1,1300682613,1300683213,1,1,600
33479020@N04,2904,27,1301462340,1301463540,1,1,1200
33479020@N04,2905,14,1301633601,1301633721,1,1,120
33479020@N04,2906,1,1302503003,1302503603,1,1,600
33479020@N04,2907,20,1303282983,1303284063,1,1,1080
33479020@N04,2908,4,1303886824,1303887724,1,1,900
33479020@N04,2909,15,1304316947,1304317127,1,1,180
33479020@N04,2910,2,1304914421,1304914511,1,1,90
33479020@N04,2911,13,1306308548,1306309148,1,1,600
33479020@N04,2912,27,1307413219,1307414419,1,1,1200
33479020@N04,2913,18,1312783658,1312785458,1,1,1800
33479020@N04,2914,13,1314171396,1314171996,1,1,600
33479020@N04,2915,27,1315378100,1315379300,1,1,1200
33479020@N04,2916,1,1315814288,1315814888,1,1,600
33494202@N04,2917,27,1252209936,1252211136,13,6,1200
33494202@N04,2917,21,1252211313,1252211763,7,6,450
33494202@N04,2917,23,1252213770,1252213860,3,6,90
33494202@N04,2917,27,1252214947,1252216147,4,6,1200
33494202@N04,2917,17,1252224759,1252225221,4,6,462
33494202@N04,2917,13,1252225221,1252225821,3,6,600
33494202@N04,2918,2,1252313749,1252313839,2,3,90
33494202@N04,2918,3,1252313936,1252314206,2,3,270
33494202@N04,2918,12,1252315116,1252315956,11,3,840
33494202@N04,2919,27,1252443408,1252444390,3,15,982
33494202@N04,2919,16,1252444390,1252445110,15,15,720
33494202@N04,2919,14,1252448423,1252448543,7,15,120
33494202@N04,2919,16,1252449973,1252450693,3,15,720
33494202@N04,2919,15,1252451591,1252451771,2,15,180
33494202@N04,2919,14,1252453594,1252453714,4,15,120
33494202@N04,2919,9,1252454504,1252454744,2,15,240
33494202@N04,2919,6,1252454995,1252455250,3,15,255
33494202@N04,2919,9,1252456319,1252456559,5,15,240
33494202@N04,2919,6,1252458303,1252458558,2,15,255
33494202@N04,2919,9,1252461620,1252461860,2,15,240
33494202@N04,2919,11,1252462809,1252462989,5,15,180
33494202@N04,2919,8,1252480664,1252480784,2,15,120
33494202@N04,2919,24,1252484655,1252485135,4,15,480
33494202@N04,2919,21,1252488653,1252489103,1,15,450
33494202@N04,2920,27,1252623947,1252625147,4,10,1200
33494202@N04,2920,23,1252628174,1252628264,3,10,90
33494202@N04,2920,17,1252629607,1252630156,3,10,549
33494202@N04,2920,16,1252630156,1252630876,3,10,720
33494202@N04,2920,9,1252634207,1252634447,2,10,240
33494202@N04,2920,8,1252635782,1252635902,2,10,120
33494202@N04,2920,6,1252637320,1252637575,2,10,255
33494202@N04,2920,3,1252638388,1252638658,2,10,270
33494202@N04,2920,1,1252639393,1252639964,2,10,571
33494202@N04,2920,2,1252639964,1252640054,1,10,90
33507016@N05,2921,19,1214319424,1214319844,2,2,420
33507016@N05,2921,18,1214321620,1214323420,1,2,1800
33507016@N05,2922,21,1385358929,1385359379,2,3,450
33507016@N05,2922,19,1385370726,1385371146,2,3,420
33507016@N05,2922,16,1385391644,1385392364,1,3,720
33507605@N03,2923,24,1249707593,1249708073,8,12,480
33507605@N03,2923,22,1249708326,1249708603,3,12,277
33507605@N03,2923,21,1249708603,1249709053,6,12,450
33507605@N03,2923,25,1249709308,1249709868,4,12,560
33507605@N03,2923,22,1249709868,1249710468,3,12,600
33507605@N03,2923,20,1249713623,1249714376,3,12,753
33507605@N03,2923,22,1249714376,1249714440,2,12,64
33507605@N03,2923,13,1249714440,1249715040,2,12,600
33507605@N03,2923,12,1249717315,1249718155,7,12,840
33507605@N03,2923,3,1249739321,1249739591,2,12,270
33507605@N03,2923,16,1249743624,1249744017,2,12,393
33507605@N03,2923,9,1249744017,1249744257,4,12,240
33507605@N03,2924,16,1249827593,1249828313,2,4,720
33507605@N03,2924,21,1249829438,1249829888,2,4,450
33507605@N03,2924,16,1249832204,1249832690,4,4,486
33507605@N03,2924,9,1249832690,1249832930,1,4,240
33507605@N03,2925,27,1250311420,1250312126,4,8,706
33507605@N03,2925,16,1250312126,1250312307,3,8,181
33507605@N03,2925,17,1250312307,1250313196,3,8,889
33507605@N03,2925,16,1250313196,1250313916,2,8,720
33507605@N03,2925,3,1250314077,1250314347,2,8,270
33507605@N03,2925,8,1250315303,1250315423,20,8,120
33507605@N03,2925,17,1250321064,1250321753,2,8,689
33507605@N03,2925,13,1250321753,1250322353,1,8,600
33507605@N03,2926,9,1250488853,1250489030,2,3,177
33507605@N03,2926,3,1250489030,1250489300,3,3,270
33507605@N03,2926,17,1250493010,1250494390,1,3,1380
33539876@N06,2927,16,1261547599,1261548319,1,1,720
33546659@N08,2928,20,1323579803,1323580883,2,6,1080
33546659@N08,2928,19,1323581697,1323582117,2,6,420
33546659@N08,2928,27,1323584091,1323585188,2,6,1097
33546659@N08,2928,13,1323585188,1323585788,2,6,600
33546659@N08,2928,14,1323606978,1323607098,2,6,120
33546659@N08,2928,25,1323612889,1323613639,1,6,750
33546659@N08,2929,22,1323917402,1323917728,2,4,326
33546659@N08,2929,23,1323917728,1323917818,2,4,90
33546659@N08,2929,22,1323921557,1323922157,2,4,600
33546659@N08,2929,25,1323925936,1323926686,1,4,750
33546659@N08,2930,14,1323957311,1323957431,3,4,120
33546659@N08,2930,16,1323958455,1323959175,3,4,720
33546659@N08,2930,19,1323965252,1323965672,2,4,420
33546659@N08,2930,14,1323967007,1323967127,4,4,120
33563310@N06,2931,16,1349395861,1349396581,2,9,720
33563310@N06,2931,15,1349397024,1349397204,4,9,180
33563310@N06,2931,12,1349397577,1349398417,2,9,840
33563310@N06,2931,8,1349398955,1349399075,2,9,120
33563310@N06,2931,27,1349401696,1349402896,5,9,1200
33563310@N06,2931,21,1349404279,1349404729,3,9,450
33563310@N06,2931,4,1349407483,1349407550,2,9,67
33563310@N06,2931,5,1349407550,1349407752,2,9,202
33563310@N06,2931,1,1349407752,1349408352,1,9,600
33563310@N06,2932,27,1357012734,1357013934,1,1,1200
33563310@N06,2933,7,1357106804,1357106894,1,1,90
33572008@N03,2934,27,1419911125,1419912325,11,6,1200
33572008@N03,2934,14,1419923873,1419923993,3,6,120
33572008@N03,2934,16,1419924345,1419924364,2,6,19
33572008@N03,2934,17,1419924364,1419925744,3,6,1380
33572008@N03,2934,16,1419926245,1419926965,7,6,720
33572008@N03,2934,27,1419931361,1419932561,7,6,1200
33572008@N03,2935,19,1420100165,1420100585,1,1,420
33598193@N03,2936,14,1358645043,1358645163,1,1,120
33598193@N03,2937,12,1358832826,1358832990,2,4,164
33598193@N03,2937,10,1358832990,1358833008,2,4,18
33598193@N03,2937,14,1358833008,1358833122,2,4,114
33598193@N03,2937,13,1358833122,1358833722,2,4,600
33598193@N03,2938,27,1367540997,1367542197,1,1,1200
33598193@N03,2939,16,1383796366,1383797086,1,1,720
33598193@N03,2940,27,1389498060,1389499260,4,1,1200
33598193@N03,2941,27,1389673294,1389673529,2,3,235
33598193@N03,2941,10,1389673529,1389673857,3,3,328
33598193@N03,2941,27,1389673857,1389675057,1,3,1200
33598193@N03,2942,27,1398679236,1398679888,2,2,652
33598193@N03,2942,23,1398679888,1398679978,1,2,90
33598193@N03,2943,6,1402201590,1402201845,1,1,255
33667899@N07,2944,17,1318403098,1318403221,3,2,123
33667899@N07,2944,26,1318403221,1318403401,2,2,180
33667899@N07,2945,27,1318576866,1318578066,2,1,1200
33667899@N07,2946,21,1318717902,1318718352,5,8,450
33667899@N07,2946,24,1318726674,1318726857,2,8,183
33667899@N07,2946,14,1318726857,1318726977,5,8,120
33667899@N07,2946,18,1318728241,1318730041,3,8,1800
33667899@N07,2946,16,1318730403,1318731123,12,8,720
33667899@N07,2946,27,1318755483,1318756683,2,8,1200
33667899@N07,2946,4,1318761485,1318762385,3,8,900
33667899@N07,2946,21,1318769171,1318769621,2,8,450
33667899@N07,2947,17,1349852555,1349853935,2,1,1380
33667899@N07,2948,6,1349991744,1349991999,2,5,255
33667899@N07,2948,9,1349992072,1349992312,7,5,240
33667899@N07,2948,14,1349993932,1349994052,4,5,120
33667899@N07,2948,24,1350000255,1350000735,2,5,480
33667899@N07,2948,21,1350015883,1350016333,9,5,450
33667899@N07,2949,18,1382177141,1382178941,1,1,1800
33700145@N05,2950,27,1278982055,1278983176,2,7,1121
33700145@N05,2950,18,1278983176,1278984976,5,7,1800
33700145@N05,2950,5,1278987041,1278987761,3,7,720
33700145@N05,2950,6,1278990672,1278990927,3,7,255
33700145@N05,2950,16,1279009163,1279009883,2,7,720
33700145@N05,2950,27,1279011235,1279012435,2,7,1200
33700145@N05,2950,16,1279021096,1279021816,1,7,720
33704098@N00,2951,27,1389150873,1389152073,4,7,1200
33704098@N00,2951,15,1389154684,1389154864,3,7,180
33704098@N00,2951,12,1389154864,1389155704,2,7,840
33704098@N00,2951,13,1389157987,1389158587,3,7,600
33704098@N00,2951,18,1389159073,1389160873,8,7,1800
33704098@N00,2951,19,1389161194,1389161614,2,7,420
33704098@N00,2951,21,1389167842,1389168292,1,7,450
33719077@N06,2952,14,1323580876,1323580996,4,1,120
33719077@N06,2953,23,1390798098,1390798188,2,6,90
33719077@N06,2953,19,1390799093,1390799513,2,6,420
33719077@N06,2953,12,1390800352,1390801192,2,6,840
33719077@N06,2953,14,1390802263,1390802383,3,6,120
33719077@N06,2953,16,1390802383,1390803103,5,6,720
33719077@N06,2953,20,1390804744,1390805824,1,6,1080
33725927@N00,2954,16,1299095771,1299096491,2,2,720
33725927@N00,2954,27,1299101924,1299103124,2,2,1200
33754377@N03,2955,14,1395542421,1395542436,2,4,15
33754377@N03,2955,16,1395542436,1395542463,2,4,27
33754377@N03,2955,27,1395542463,1395543358,2,4,895
33754377@N03,2955,17,1395543358,1395544738,1,4,1380
33786609@N02,2956,25,1437095381,1437096131,2,2,750
33786609@N02,2956,23,1437096590,1437096680,1,2,90
33786609@N02,2957,27,1437204999,1437206199,1,1,1200
33822743@N08,2958,27,1230184438,1230185638,6,1,1200
33822743@N08,2959,27,1230316725,1230317925,2,4,1200
33822743@N08,2959,17,1230318510,1230318761,2,4,251
33822743@N08,2959,16,1230318761,1230319481,7,4,720
33822743@N08,2959,27,1230321296,1230322496,1,4,1200
33822743@N08,2960,27,1244262362,1244263562,2,7,1200
33822743@N08,2960,21,1244263663,1244264113,2,7,450
33822743@N08,2960,2,1244265212,1244265302,3,7,90
33822743@N08,2960,21,1244272888,1244273016,2,7,128
33822743@N08,2960,18,1244273016,1244274816,41,7,1800
33822743@N08,2960,21,1244281653,1244282103,3,7,450
33822743@N08,2960,27,1244283235,1244284435,4,7,1200
33822743@N08,2961,24,1257745402,1257745882,5,2,480
33822743@N08,2961,27,1257748095,1257749295,3,2,1200
33822743@N08,2962,27,1259205704,1259206904,3,1,1200
33822743@N08,2963,16,1275008026,1275008746,1,1,720
33822883@N06,2964,19,1218159473,1218159893,1,1,420
33824882@N07,2965,13,1398514122,1398514722,4,1,600
33878587@N06,2966,2,1230799602,1230799692,1,1,90
33878587@N06,2967,16,1230965332,1230966052,1,1,720
33879159@N06,2968,2,1332138952,1332139042,2,2,90
33879159@N06,2968,14,1332139062,1332139182,1,2,120
33890513@N06,2969,27,1385006031,1385007231,5,1,1200
33912195@N05,2970,27,1305496338,1305497538,1,1,1200
33929547@N03,2971,27,1430790083,1430790862,2,5,779
33929547@N03,2971,16,1430790862,1430791582,2,5,720
33929547@N03,2971,6,1430797921,1430798176,2,5,255
33929547@N03,2971,9,1430799275,1430799515,2,5,240
33929547@N03,2971,16,1430821742,1430822462,1,5,720
33929547@N03,2972,14,1430988846,1430988966,2,2,120
33929547@N03,2972,27,1430995372,1430996572,1,2,1200
33931717@N03,2973,14,1230257195,1230257315,1,1,120
33931717@N03,2974,14,1230334927,1230335047,1,1,120
33934966@N00,2975,27,1290053836,1290055036,2,8,1200
33934966@N00,2975,12,1290059585,1290060425,2,8,840
33934966@N00,2975,14,1290060496,1290060616,4,8,120
33934966@N00,2975,13,1290066064,1290066664,2,8,600
33934966@N00,2975,23,1290068037,1290068127,2,8,90
33934966@N00,2975,27,1290069525,1290069778,2,8,253
33934966@N00,2975,25,1290069778,1290070041,2,8,263
33934966@N00,2975,27,1290070041,1290071241,2,8,1200
33934966@N00,2976,15,1290418220,1290418400,3,3,180
33934966@N00,2976,20,1290421766,1290422846,3,3,1080
33934966@N00,2976,2,1290424394,1290424484,2,3,90
33934966@N00,2977,21,1290605666,1290606116,3,4,450
33934966@N00,2977,23,1290607550,1290607640,4,4,90
33934966@N00,2977,4,1290615038,1290615938,2,4,900
33934966@N00,2977,27,1290617952,1290619152,3,4,1200
33934966@N00,2978,16,1290862466,1290863186,3,4,720
33934966@N00,2978,8,1290865504,1290865624,2,4,120
33934966@N00,2978,26,1290869571,1290869751,11,4,180
33934966@N00,2978,14,1290873350,1290873470,9,4,120
33934966@N00,2979,27,1291189801,1291191001,3,8,1200
33934966@N00,2979,12,1291191816,1291192656,2,8,840
33934966@N00,2979,26,1291194742,1291194922,2,8,180
33934966@N00,2979,22,1291195516,1291196116,2,8,600
33934966@N00,2979,20,1291197971,1291199051,5,8,1080
33934966@N00,2979,17,1291199539,1291200422,2,8,883
33934966@N00,2979,1,1291200422,1291201022,3,8,600
33934966@N00,2979,14,1291202577,1291202697,7,8,120
33934966@N00,2980,27,1320231321,1320231933,3,5,612
33934966@N00,2980,17,1320231933,1320233313,2,5,1380
33934966@N00,2980,19,1320236299,1320236719,8,5,420
33934966@N00,2980,3,1320238341,1320238611,4,5,270
33934966@N00,2980,4,1320241717,1320242617,4,5,900
33934966@N00,2981,14,1320556054,1320556174,3,5,120
33934966@N00,2981,15,1320557356,1320557502,2,5,146
33934966@N00,2981,12,1320557502,1320558342,2,5,840
33934966@N00,2981,20,1320558783,1320559863,2,5,1080
33934966@N00,2981,27,1320564070,1320565270,3,5,1200
33934966@N00,2982,27,1320722468,1320723668,2,5,1200
33934966@N00,2982,20,1320723683,1320724763,3,5,1080
33934966@N00,2982,21,1320728739,1320729189,7,5,450
33934966@N00,2982,9,1320745133,1320745373,2,5,240
33934966@N00,2982,16,1320747505,1320748225,1,5,720
33936522@N00,2983,27,1211779945,1211781145,1,1,1200
33938510@N00,2984,22,1199250607,1199251207,1,1,600
33971415@N07,2985,16,1248680264,1248680264,2,4,0
33971415@N07,2985,24,1248680264,1248680264,2,4,0
33971415@N07,2985,27,1248680264,1248681464,3,4,1200
33971415@N07,2985,14,1248683618,1248683738,1,4,120
34008756@N07,2986,16,1268657280,1268658000,1,1,720
34008756@N07,2987,18,1268797355,1268799155,1,1,1800
34009864@N00,2988,16,1362379282,1362380002,1,1,720
34017702@N00,2989,6,1305768270,1305768525,1,1,255
34038355@N06,2990,17,1353042815,1353044195,1,1,1380
34038355@N06,2991,17,1353094001,1353094015,2,3,14
34038355@N06,2991,25,1353094015,1353094027,2,3,12
34038355@N06,2991,17,1353094027,1353095407,1,3,1380
34091054@N00,2992,17,1286758006,1286759386,3,7,1380
34091054@N00,2992,14,1286764459,1286764579,2,7,120
34091054@N00,2992,8,1286768881,1286769001,3,7,120
34091054@N00,2992,11,1286769565,1286769707,4,7,142
34091054@N00,2992,8,1286769707,1286769749,2,7,42
34091054@N00,2992,11,1286769749,1286769929,3,7,180
34091054@N00,2992,8,1286770485,1286770605,1,7,120
34104198@N06,2993,27,1350706127,1350707327,1,1,1200
34104198@N06,2994,27,1391334018,1391335218,1,1,1200
34153311@N05,2995,27,1318649814,1318651014,3,2,1200
34153311@N05,2995,9,1318654177,1318654417,1,2,240
34153311@N05,2996,16,1318974834,1318975554,6,1,720
34153311@N05,2997,27,1319096555,1319097755,2,3,1200
34153311@N05,2997,9,1319102221,1319102461,3,3,240
34153311@N05,2997,21,1319103421,1319103871,2,3,450
34153311@N05,2998,27,1361229691,1361230891,2,4,1200
34153311@N05,2998,9,1361234490,1361234730,2,4,240
34153311@N05,2998,27,1361236783,1361237983,2,4,1200
34153311@N05,2998,9,1361244091,1361244331,2,4,240
34153311@N05,2999,14,1361398649,1361398769,3,3,120
34153311@N05,2999,9,1361403933,1361404173,2,3,240
34153311@N05,2999,14,1361405149,1361405269,1,3,120
34153311@N05,3000,16,1408229090,1408229810,10,2,720
34153311@N05,3000,9,1408234799,1408235039,6,2,240
34153311@N05,3001,9,1408325583,1408325823,1,1,240
34153311@N05,3002,15,1408578465,1408578645,4,3,180
34153311@N05,3002,17,1408580069,1408581449,6,3,1380
34153311@N05,3002,14,1408589234,1408589354,2,3,120
34155736@N07,3003,27,1381270854,1381272054,1,1,1200
34169073@N02,3004,16,1312486270,1312486990,1,1,720
34176066@N00,3005,27,1319444281,1319445481,51,1,1200
34176066@N00,3006,9,1319504884,1319505124,10,5,240
34176066@N00,3006,18,1319516940,1319516960,3,5,20
34176066@N00,3006,20,1319516960,1319517030,6,5,70
34176066@N00,3006,22,1319517030,1319517630,12,5,600
34176066@N00,3006,4,1319527420,1319528320,2,5,900
34176066@N00,3007,27,1319706638,1319707838,38,2,1200
34176066@N00,3007,4,1319711720,1319712620,13,2,900
34240084@N05,3008,19,1370600033,1370600453,1,1,420
34282503@N05,3009,26,1234839635,1234839815,2,1,180
34314282@N03,3010,27,1280274771,1280275265,2,3,494
34314282@N03,3010,19,1280275265,1280275685,3,3,420
34314282@N03,3010,9,1280285812,1280286052,1,3,240
34317816@N05,3011,27,1377987890,1377988398,2,2,508
34317816@N05,3011,16,1377988398,1377989118,2,2,720
34339642@N05,3012,27,1364432283,1364433483,3,1,1200
34361471@N02,3013,20,1283340009,1283341089,1,1,1080
34361916@N00,3014,13,1339494724,1339495324,1,1,600
34361916@N00,3015,9,1339636734,1339636974,2,2,240
34361916@N00,3015,27,1339647751,1339648951,1,2,1200
34390084@N07,3016,16,1205257206,1205257926,21,1,720
34390084@N07,3017,16,1238811404,1238812124,6,1,720
34390084@N07,3018,16,1240737419,1240738139,3,1,720
34390084@N07,3019,14,1260687814,1260687934,19,3,120
34390084@N07,3019,18,1260693073,1260694873,5,3,1800
34390084@N07,3019,16,1260709900,1260710620,7,3,720
34407909@N07,3020,16,1201929825,1201930545,1,1,720
34429030@N00,3021,9,1305623243,1305623483,1,1,240
34482114@N07,3022,17,1398849876,1398851256,1,1,1380
34538882@N00,3023,3,1307703058,1307703328,1,1,270
34544450@N05,3024,19,1359936406,1359936826,2,1,420
34544450@N05,3025,17,1360372269,1360373649,1,1,1380
34544916@N07,3026,14,1356076095,1356076215,1,1,120
34600882@N05,3027,27,1360629177,1360630377,2,9,1200
34600882@N05,3027,8,1360631140,1360631260,2,9,120
34600882@N05,3027,11,1360634922,1360635102,4,9,180
34600882@N05,3027,27,1360641962,1360643162,4,9,1200
34600882@N05,3027,3,1360644507,1360644777,2,9,270
34600882@N05,3027,17,1360648114,1360649494,3,9,1380
34600882@N05,3027,18,1360649711,1360651511,3,9,1800
34600882@N05,3027,13,1360651642,1360652242,2,9,600
34600882@N05,3027,14,1360652879,1360652999,2,9,120
34600882@N05,3028,25,1360802304,1360803054,2,2,750
34600882@N05,3028,4,1360815599,1360816499,1,2,900
34606214@N00,3029,20,1324173265,1324174345,2,1,1080
34612686@N08,3030,4,1427071703,1427072603,2,4,900
34612686@N08,3030,13,1427088100,1427088700,6,4,600
34612686@N08,3030,19,1427091976,1427092396,7,4,420
34612686@N08,3030,16,1427108247,1427108967,1,4,720
34695134@N00,3031,27,1198042542,1198043742,5,3,1200
34695134@N00,3031,3,1198046879,1198047149,3,3,270
34695134@N00,3031,25,1198051202,1198051952,8,3,750
34703628@N00,3032,18,1316313220,1316313465,2,7,245
34703628@N00,3032,19,1316313465,1316313794,2,7,329
34703628@N00,3032,18,1316313794,1316315594,3,7,1800
34703628@N00,3032,17,1316319815,1316321195,2,7,1380
34703628@N00,3032,19,1316322602,1316323022,2,7,420
34703628@N00,3032,25,1316330534,1316331284,2,7,750
34703628@N00,3032,16,1316332561,1316333281,1,7,720
34703628@N00,3033,27,1317428390,1317429105,3,6,715
34703628@N00,3033,16,1317429105,1317429825,2,6,720
34703628@N00,3033,27,1317442945,1317444145,2,6,1200
34703628@N00,3033,16,1317462625,1317463345,2,6,720
34703628@N00,3033,27,1317465274,1317466474,3,6,1200
34703628@N00,3033,16,1317467886,1317468606,6,6,720
34703628@N00,3034,27,1319262394,1319263594,1,1,1200
34703628@N00,3035,18,1331785627,1331787427,2,2,1800
34703628@N00,3035,17,1331790992,1331792372,1,2,1380
34727974@N05,3036,27,1291683572,1291683722,2,5,150
34727974@N05,3036,16,1291683722,1291684442,2,5,720
34727974@N05,3036,5,1291693217,1291693937,7,5,720
34727974@N05,3036,22,1291699923,1291700222,2,5,299
34727974@N05,3036,14,1291700222,1291700342,1,5,120
34737607@N00,3037,27,1234570453,1234571653,10,26,1200
34737607@N00,3037,16,1234572684,1234572777,3,26,93
34737607@N00,3037,17,1234572777,1234573229,3,26,452
34737607@N00,3037,26,1234573229,1234573409,5,26,180
34737607@N00,3037,22,1234573436,1234574036,2,26,600
34737607@N00,3037,13,1234574591,1234575191,2,26,600
34737607@N00,3037,18,1234582113,1234582780,2,26,667
34737607@N00,3037,13,1234582780,1234583380,5,26,600
34737607@N00,3037,15,1234583511,1234583691,7,26,180
34737607@N00,3037,9,1234587681,1234587921,3,26,240
34737607@N00,3037,27,1234589387,1234589827,4,26,440
34737607@N00,3037,19,1234589827,1234590247,2,26,420
34737607@N00,3037,2,1234590769,1234590859,9,26,90
34737607@N00,3037,5,1234591870,1234591945,3,26,75
34737607@N00,3037,2,1234591945,1234591958,2,26,13
34737607@N00,3037,6,1234591958,1234592028,2,26,70
34737607@N00,3037,1,1234592028,1234592296,2,26,268
34737607@N00,3037,4,1234592296,1234593196,3,26,900
34737607@N00,3037,16,1234593945,1234594168,4,26,223
34737607@N00,3037,14,1234594168,1234594288,3,26,120
34737607@N00,3037,16,1234596236,1234596831,3,26,595
34737607@N00,3037,4,1234596831,1234597171,6,26,340
34737607@N00,3037,5,1234597171,1234597415,2,26,244
34737607@N00,3037,6,1234597415,1234597670,3,26,255
34737607@N00,3037,9,1234598542,1234598782,2,26,240
34737607@N00,3037,27,1234609584,1234610784,10,26,1200
34756241@N05,3038,18,1204609393,1204611193,1,1,1800
34761987@N08,3039,17,1232327591,1232328971,1,1,1380
34772702@N08,3040,27,1192690207,1192691407,230,1,1200
34772702@N08,3041,27,1206921885,1206923085,11,1,1200
34772702@N08,3042,27,1224789673,1224790873,189,1,1200
34772702@N08,3043,27,1236842266,1236843466,50,1,1200
34772702@N08,3044,27,1241335722,1241336922,27,1,1200
34790448@N07,3045,27,1237644207,1237645407,2,1,1200
34790448@N07,3046,27,1249618242,1249619442,10,1,1200
34790448@N07,3047,27,1251896941,1251898141,1,1,1200
34790448@N07,3048,9,1253619297,1253619537,6,1,240
34790448@N07,3049,27,1254883771,1254884971,48,1,1200
34790448@N07,3050,27,1256438714,1256439914,13,1,1200
34790448@N07,3051,27,1257068790,1257069990,1,1,1200
34790448@N07,3052,12,1257829558,1257830398,1,1,840
34790448@N07,3053,16,1266429556,1266430276,5,2,720
34790448@N07,3053,14,1266431698,1266431818,1,2,120
34790448@N07,3054,27,1267417017,1267417693,4,2,676
34790448@N07,3054,4,1267417693,1267418593,1,2,900
34790448@N07,3055,12,1269060145,1269060985,9,1,840
34790448@N07,3056,12,1270285083,1270285923,5,1,840
34790448@N07,3057,17,1271046615,1271047995,4,2,1380
34790448@N07,3057,25,1271048450,1271049200,3,2,750
34790448@N07,3058,16,1271638252,1271638972,3,2,720
34790448@N07,3058,4,1271650007,1271650907,21,2,900
34790448@N07,3059,8,1272865146,1272865266,9,1,120
34790448@N07,3060,8,1272966039,1272966159,5,1,120
34790448@N07,3061,22,1273141756,1273142356,22,1,600
34790448@N07,3062,16,1273321668,1273322388,7,1,720
34790448@N07,3063,22,1275744191,1275744791,20,1,600
34795150@N07,3064,27,1352502140,1352503340,2,2,1200
34795150@N07,3064,9,1352507553,1352507793,1,2,240
34795150@N07,3065,16,1352539972,1352540692,1,1,720
34869921@N00,3066,6,1350111045,1350111300,1,1,255
34872729@N05,3067,17,1266549768,1266550713,3,3,945
34872729@N05,3067,19,1266550713,1266551133,14,3,420
34872729@N05,3067,17,1266552063,1266553443,3,3,1380
34898173@N05,3068,16,1255871933,1255872653,1,1,720
34898173@N05,3069,16,1256378965,1256379685,1,1,720
34932761@N06,3070,23,1244337543,1244337562,4,10,19
34932761@N06,3070,25,1244337562,1244338312,5,10,750
34932761@N06,3070,14,1244344077,1244344197,3,10,120
34932761@N06,3070,5,1244352871,1244353591,2,10,720
34932761@N06,3070,14,1244357832,1244357952,4,10,120
34932761@N06,3070,15,1244360189,1244360369,2,10,180
34932761@N06,3070,14,1244361258,1244361378,4,10,120
34932761@N06,3070,20,1244365460,1244366540,2,10,1080
34932761@N06,3070,14,1244372564,1244372684,6,10,120
34932761@N06,3070,27,1244377981,1244379181,1,10,1200
34958003@N02,3071,21,1391472330,1391472780,1,1,450
34959558@N03,3072,27,1356136271,1356137471,2,1,1200
34959558@N03,3073,22,1412474112,1412474712,1,1,600
34959558@N03,3074,2,1412571287,1412571377,1,1,90
35030525630@N01,3075,1,1468924214,1468924814,1,1,600
35032613@N03,3076,8,1343536235,1343536355,1,1,120
35034347371@N01,3077,9,1449738713,1449738953,5,1,240
35034348373@N01,3078,17,1364345039,1364346419,1,1,1380
35034363370@N01,3079,27,1414706611,1414707182,6,35,571
35034363370@N01,3079,16,1414707182,1414707565,3,35,383
35034363370@N01,3079,14,1414707565,1414707685,4,35,120
35034363370@N01,3079,6,1414707995,1414708250,2,35,255
35034363370@N01,3079,2,1414708521,1414708611,3,35,90
35034363370@N01,3079,4,1414708983,1414709883,2,35,900
35034363370@N01,3079,2,1414710673,1414710763,5,35,90
35034363370@N01,3079,1,1414712232,1414712832,2,35,600
35034363370@N01,3079,5,1414715922,1414715934,2,35,12
35034363370@N01,3079,4,1414715934,1414716834,2,35,900
35034363370@N01,3079,2,1414717424,1414717499,3,35,75
35034363370@N01,3079,7,1414717499,1414717589,3,35,90
35034363370@N01,3079,9,1414718216,1414718456,5,35,240
35034363370@N01,3079,25,1414719567,1414719762,2,35,195
35034363370@N01,3079,21,1414719762,1414720212,3,35,450
35034363370@N01,3079,20,1414723122,1414723696,2,35,574
35034363370@N01,3079,13,1414723696,1414724296,4,35,600
35034363370@N01,3079,12,1414725609,1414725767,6,35,158
35034363370@N01,3079,14,1414725767,1414725834,2,35,67
35034363370@N01,3079,12,1414725834,1414726354,4,35,520
35034363370@N01,3079,15,1414726354,1414726534,4,35,180
35034363370@N01,3079,21,1414727468,1414727741,3,35,273
35034363370@N01,3079,25,1414727741,1414727775,3,35,34
35034363370@N01,3079,24,1414727775,1414728255,3,35,480
35034363370@N01,3079,23,1414728309,1414728399,5,35,90
35034363370@N01,3079,25,1414729354,1414730104,7,35,750
35034363370@N01,3079,14,1414731299,1414731419,3,35,120
35034363370@N01,3079,16,1414731662,1414732382,2,35,720
35034363370@N01,3079,18,1414733398,1414733632,3,35,234
35034363370@N01,3079,22,1414733632,1414733791,2,35,159
35034363370@N01,3079,18,1414733791,1414733838,2,35,47
35034363370@N01,3079,19,1414733838,1414734258,2,35,420
35034363370@N01,3079,18,1414734648,1414735004,2,35,356
35034363370@N01,3079,16,1414735004,1414735724,2,35,720
35034363370@N01,3079,27,1414737977,1414739177,4,35,1200
35034364890@N01,3080,27,1194735299,1194736499,3,7,1200
35034364890@N01,3080,21,1194746018,1194746468,3,7,450
35034364890@N01,3080,26,1194754533,1194754713,2,7,180
35034364890@N01,3080,3,1194777858,1194778128,2,7,270
35034364890@N01,3080,6,1194779730,1194779985,5,7,255
35034364890@N01,3080,4,1194783034,1194783719,3,7,685
35034364890@N01,3080,27,1194783719,1194784919,1,7,1200
35034364890@N01,3081,27,1194824270,1194825317,2,3,1047
35034364890@N01,3081,1,1194825317,1194825917,2,3,600
35034364890@N01,3081,5,1194826723,1194827443,1,3,720
35041397@N00,3082,16,1193008982,1193009702,6,2,720
35041397@N00,3082,21,1193012741,1193013191,1,2,450
35067956@N08,3083,27,1436851568,1436852768,4,1,1200
35071666@N00,3084,15,1352198471,1352198651,1,1,180
35082889@N05,3085,15,1415316588,1415316768,3,2,180
35082889@N05,3085,17,1415320229,1415321609,1,2,1380
35144236@N07,3086,16,1271016246,1271016966,1,1,720
35155400@N03,3087,21,1396867708,1396868158,1,1,450
35209467@N02,3088,26,1295658781,1295658961,1,1,180
35209467@N02,3089,27,1295742148,1295743348,1,1,1200
35209467@N02,3090,16,1295771770,1295772490,1,1,720
35261894@N00,3091,27,1404266789,1404267989,19,8,1200
35261894@N00,3091,1,1404268030,1404268566,3,8,536
35261894@N00,3091,15,1404268566,1404268746,2,8,180
35261894@N00,3091,5,1404268948,1404269017,3,8,69
35261894@N00,3091,4,1404269017,1404269917,11,8,900
35261894@N00,3091,17,1404271417,1404272797,4,8,1380
35261894@N00,3091,18,1404276383,1404277345,7,8,962
35261894@N00,3091,21,1404277345,1404277795,15,8,450
35356940@N00,3092,27,1368742542,1368743742,3,13,1200
35356940@N00,3092,1,1368745801,1368746401,2,13,600
35356940@N00,3092,13,1368747505,1368748105,4,13,600
35356940@N00,3092,20,1368749311,1368749505,2,13,194
35356940@N00,3092,21,1368749505,1368749955,2,13,450
35356940@N00,3092,26,1368751330,1368751419,2,13,89
35356940@N00,3092,25,1368751419,1368752169,3,13,750
35356940@N00,3092,20,1368753724,1368754804,2,13,1080
35356940@N00,3092,27,1368773946,1368775146,2,13,1200
35356940@N00,3092,5,1368776873,1368777593,2,13,720
35356940@N00,3092,26,1368780924,1368781104,4,13,180
35356940@N00,3092,13,1368781544,1368782144,2,13,600
35356940@N00,3092,10,1368785811,1368786231,2,13,420
35356940@N00,3093,27,1393625632,1393626832,20,7,1200
35356940@N00,3093,17,1393630409,1393631789,2,7,1380
35356940@N00,3093,18,1393631931,1393631998,2,7,67
35356940@N00,3093,19,1393631998,1393632418,2,7,420
35356940@N00,3093,18,1393632718,1393634518,3,7,1800
35356940@N00,3093,22,1393634842,1393635442,2,7,600
35356940@N00,3093,9,1393639733,1393639973,1,7,240
35378947@N07,3094,27,1205232118,1205232482,2,3,364
35378947@N07,3094,16,1205232482,1205232490,2,3,8
35378947@N07,3094,5,1205232490,1205233210,1,3,720
35378947@N07,3095,20,1234411948,1234412773,3,5,825
35378947@N07,3095,21,1234412773,1234413223,3,5,450
35378947@N07,3095,2,1234414178,1234414268,7,5,90
35378947@N07,3095,1,1234418481,1234419008,2,5,527
35378947@N07,3095,3,1234419008,1234419278,28,5,270
35378947@N07,3096,1,1260152479,1260153079,2,8,600
35378947@N07,3096,25,1260153507,1260154257,2,8,750
35378947@N07,3096,27,1260158520,1260159309,2,8,789
35378947@N07,3096,14,1260159309,1260159429,3,8,120
35378947@N07,3096,1,1260162338,1260162938,3,8,600
35378947@N07,3096,3,1260164622,1260164892,9,8,270
35378947@N07,3096,17,1260166545,1260166818,2,8,273
35378947@N07,3096,20,1260166818,1260167898,2,8,1080
35378947@N07,3097,27,1260247598,1260248798,8,9,1200
35378947@N07,3097,16,1260249824,1260250149,4,9,325
35378947@N07,3097,9,1260250149,1260250389,2,9,240
35378947@N07,3097,12,1260250451,1260251291,12,9,840
35378947@N07,3097,20,1260252048,1260253128,3,9,1080
35378947@N07,3097,1,1260257031,1260257631,2,9,600
35378947@N07,3097,20,1260260787,1260261867,4,9,1080
35378947@N07,3097,17,1260271965,1260273345,5,9,1380
35378947@N07,3097,27,1260278150,1260279350,1,9,1200
35378947@N07,3098,2,1281500140,1281500230,3,5,90
35378947@N07,3098,1,1281500345,1281500843,2,5,498
35378947@N07,3098,2,1281500843,1281500933,2,5,90
35378947@N07,3098,20,1281508552,1281509632,2,5,1080
35378947@N07,3098,2,1281515445,1281515535,1,5,90
35378947@N07,3099,27,1281649199,1281650399,8,1,1200
35378947@N07,3100,22,1281706056,1281706656,10,4,600
35378947@N07,3100,17,1281707330,1281707625,3,4,295
35378947@N07,3100,4,1281707625,1281707880,4,4,255
35378947@N07,3100,27,1281707880,1281709080,7,4,1200
35378947@N07,3101,27,1284691761,1284692961,16,10,1200
35378947@N07,3101,16,1284692978,1284693130,2,10,152
35378947@N07,3101,17,1284693130,1284693253,2,10,123
35378947@N07,3101,19,1284693253,1284693673,7,10,420
35378947@N07,3101,8,1284695611,1284695731,11,10,120
35378947@N07,3101,2,1284697317,1284697407,3,10,90
35378947@N07,3101,3,1284698698,1284698968,2,10,270
35378947@N07,3101,9,1284703215,1284703455,2,10,240
35378947@N07,3101,26,1284708317,1284708497,2,10,180
35378947@N07,3101,27,1284717671,1284718871,2,10,1200
35378947@N07,3102,27,1285054515,1285055715,8,6,1200
35378947@N07,3102,17,1285056365,1285057745,6,6,1380
35378947@N07,3102,16,1285059570,1285060290,2,6,720
35378947@N07,3102,9,1285063184,1285063424,3,6,240
35378947@N07,3102,13,1285063997,1285064597,4,6,600
35378947@N07,3102,16,1285066034,1285066754,5,6,720
35378947@N07,3103,27,1304832877,1304834077,2,7,1200
35378947@N07,3103,17,1304836033,1304836250,2,7,217
35378947@N07,3103,26,1304836250,1304836430,5,7,180
35378947@N07,3103,15,1304841995,1304842175,2,7,180
35378947@N07,3103,14,1304844675,1304844752,2,7,77
35378947@N07,3103,15,1304844752,1304844932,2,7,180
35378947@N07,3103,2,1304854727,1304854817,1,7,90
35378947@N07,3104,6,1304940015,1304940270,3,3,255
35378947@N07,3104,18,1304944993,1304946793,2,3,1800
35378947@N07,3104,9,1304952715,1304952955,1,3,240
35378947@N07,3105,18,1305257146,1305257193,2,3,47
35378947@N07,3105,13,1305257193,1305257282,2,3,89
35378947@N07,3105,18,1305257282,1305259082,4,3,1800
35378947@N07,3106,13,1305336541,1305337141,3,5,600
35378947@N07,3106,27,1305337231,1305337623,2,5,392
35378947@N07,3106,22,1305337623,1305337667,2,5,44
35378947@N07,3106,19,1305337667,1305338087,2,5,420
35378947@N07,3106,1,1305338420,1305339020,1,5,600
35378947@N07,3107,17,1305612199,1305613579,2,2,1380
35378947@N07,3107,27,1305616911,1305618111,2,2,1200
35378947@N07,3108,14,1328353903,1328354023,1,1,120
35378947@N07,3109,16,1328433498,1328434218,2,4,720
35378947@N07,3109,13,1328435519,1328436119,5,4,600
35378947@N07,3109,16,1328441184,1328441904,2,4,720
35378947@N07,3109,27,1328442735,1328443935,4,4,1200
35378947@N07,3110,27,1328758328,1328758571,2,11,243
35378947@N07,3110,16,1328758571,1328759291,2,11,720
35378947@N07,3110,14,1328761791,1328761882,3,11,91
35378947@N07,3110,27,1328761882,1328762013,2,11,131
35378947@N07,3110,14,1328762013,1328762133,6,11,120
35378947@N07,3110,13,1328762595,1328763195,4,11,600
35378947@N07,3110,22,1328764665,1328765265,3,11,600
35378947@N07,3110,4,1328767753,1328768653,3,11,900
35378947@N07,3110,1,1328770369,1328770969,8,11,600
35378947@N07,3110,5,1328781051,1328781771,3,11,720
35378947@N07,3110,27,1328782162,1328783362,1,11,1200
35378947@N07,3111,2,1328842277,1328842367,2,2,90
35378947@N07,3111,1,1328846195,1328846795,1,2,600
35380796@N03,3112,2,1230728400,1230728400,2,5,0
35380796@N03,3112,16,1230728400,1230728400,2,5,0
35380796@N03,3112,17,1230728400,1230728400,3,5,0
35380796@N03,3112,21,1230728400,1230728400,2,5,0
35380796@N03,3112,22,1230728400,1230729000,2,5,600
35380796@N03,3113,24,1292303251,1292303731,3,12,480
35380796@N03,3113,21,1292304565,1292305015,4,12,450
35380796@N03,3113,19,1292305648,1292306068,4,12,420
35380796@N03,3113,12,1292311513,1292312353,3,12,840
35380796@N03,3113,15,1292312864,1292313044,2,12,180
35380796@N03,3113,14,1292316395,1292316515,3,12,120
35380796@N03,3113,2,1292321937,1292322027,3,12,90
35380796@N03,3113,16,1292322830,1292323550,4,12,720
35380796@N03,3113,22,1292325641,1292326241,6,12,600
35380796@N03,3113,20,1292327559,1292328639,2,12,1080
35380796@N03,3113,27,1292329432,1292330209,6,12,777
35380796@N03,3113,22,1292330209,1292330809,5,12,600
35380796@N03,3114,3,1292479949,1292480219,2,13,270
35380796@N03,3114,24,1292483197,1292483677,2,13,480
35380796@N03,3114,13,1292485097,1292485697,2,13,600
35380796@N03,3114,14,1292486276,1292486396,2,13,120
35380796@N03,3114,12,1292487916,1292488756,2,13,840
35380796@N03,3114,9,1292489586,1292489826,3,13,240
35380796@N03,3114,14,1292490171,1292490291,2,13,120
35380796@N03,3114,1,1292490389,1292490989,4,13,600
35380796@N03,3114,16,1292494815,1292495535,10,13,720
35380796@N03,3114,22,1292499852,1292500452,3,13,600
35380796@N03,3114,3,1292503274,1292503544,3,13,270
35380796@N03,3114,1,1292504448,1292505048,2,13,600
35380796@N03,3114,16,1292505343,1292506063,4,13,720
35380796@N03,3115,3,1318482782,1318483052,3,8,270
35380796@N03,3115,13,1318487254,1318487854,5,8,600
35380796@N03,3115,21,1318490128,1318490578,3,8,450
35380796@N03,3115,22,1318491260,1318491860,2,8,600
35380796@N03,3115,12,1318493393,1318494233,2,8,840
35380796@N03,3115,22,1318497032,1318497632,6,8,600
35380796@N03,3115,2,1318500067,1318500157,4,8,90
35380796@N03,3115,1,1318503426,1318504026,1,8,600
35380796@N03,3116,27,1318582804,1318584004,3,1,1200
35380796@N03,3117,3,1318718531,1318718801,3,14,270
35380796@N03,3117,20,1318720912,1318720964,3,14,52
35380796@N03,3117,21,1318720964,1318721414,4,14,450
35380796@N03,3117,23,1318722768,1318722858,2,14,90
35380796@N03,3117,24,1318723422,1318723902,5,14,480
35380796@N03,3117,26,1318725493,1318725673,2,14,180
35380796@N03,3117,1,1318726128,1318726728,3,14,600
35380796@N03,3117,3,1318727423,1318727693,2,14,270
35380796@N03,3117,15,1318731261,1318731441,2,14,180
35380796@N03,3117,9,1318738662,1318738902,2,14,240
35380796@N03,3117,12,1318739433,1318740273,5,14,840
35380796@N03,3117,19,1318742009,1318742429,2,14,420
35380796@N03,3117,3,1318743727,1318743997,3,14,270
35380796@N03,3117,1,1318744521,1318745121,2,14,600
35386099@N04,3118,27,1370098486,1370099686,1,1,1200
35404547@N02,3119,27,1375314799,1375315999,3,3,1200
35404547@N02,3119,16,1375317446,1375318166,2,3,720
35404547@N02,3119,13,1375323832,1375324432,1,3,600
35443533@N08,3120,16,1202941509,1202942229,1,1,720
35443533@N08,3121,16,1263205035,1263205755,1,1,720
35457947@N04,3122,17,1280037946,1280039326,1,1,1380
35457947@N04,3123,25,1280361209,1280361959,2,2,750
35457947@N04,3123,18,1280363062,1280364862,1,2,1800
35468140399@N01,3124,27,1332986832,1332988032,2,3,1200
35468140399@N01,3124,12,1332989565,1332990405,5,3,840
35468140399@N01,3124,10,1333001068,1333001488,1,3,420
35468141333@N01,3125,27,1313620903,1313621777,2,6,874
35468141333@N01,3125,14,1313621777,1313621897,2,6,120
35468141333@N01,3125,16,1313622412,1313623132,3,6,720
35468141333@N01,3125,14,1313635677,1313635797,3,6,120
35468141333@N01,3125,20,1313651144,1313652224,2,6,1080
35468141333@N01,3125,18,1313653972,1313655772,1,6,1800
35470197@N08,3126,14,1452910503,1452910623,2,1,120
35498711@N04,3127,13,1346037774,1346038374,2,2,600
35498711@N04,3127,1,1346041152,1346041752,1,2,600
35498711@N04,3128,27,1346731200,1346731201,2,5,1
35498711@N04,3128,21,1346731201,1346731202,2,5,1
35498711@N04,3128,20,1346731202,1346731203,2,5,1
35498711@N04,3128,16,1346731203,1346731923,2,5,720
35498711@N04,3128,19,1346752528,1346752948,1,5,420
35509457@N00,3129,10,1367545961,1367546381,2,3,420
35509457@N00,3129,2,1367551860,1367551950,3,3,90
35509457@N00,3129,4,1367553425,1367554325,1,3,900
35509457@N00,3130,9,1368327166,1368327406,1,1,240
35525807@N06,3131,17,1370673231,1370674611,1,1,1380
35536869@N06,3132,16,1312262223,1312262943,17,1,720
35536869@N06,3133,16,1312550009,1312550729,5,1,720
35536869@N06,3134,16,1312622478,1312623198,13,1,720
35547432@N07,3135,27,1364117897,1364119097,1,1,1200
35570988@N08,3136,21,1345028702,1345029152,1,1,450
35570988@N08,3137,21,1345186123,1345186573,1,1,450
35570988@N08,3138,21,1345726958,1345727408,1,1,450
35570988@N08,3139,22,1347059406,1347060006,1,1,600
35570988@N08,3140,4,1347794135,1347795035,1,1,900
35581623@N04,3141,21,1368921799,1368922249,1,1,450
35581623@N04,3142,18,1371507859,1371509659,1,1,1800
35602564@N00,3143,27,1439530041,1439531241,1,1,1200
35617346@N02,3144,27,1375610709,1375611909,2,1,1200
35617346@N02,3145,27,1375665031,1375666231,2,2,1200
35617346@N02,3145,20,1375668002,1375669082,1,2,1080
35617346@N02,3146,3,1404008895,1404009165,2,3,270
35617346@N02,3146,14,1404014243,1404014363,2,3,120
35617346@N02,3146,20,1404033480,1404034560,1,3,1080
35617346@N02,3147,8,1423799172,1423799292,1,1,120
35657441@N02,3148,27,1418600474,1418601674,2,5,1200
35657441@N02,3148,10,1418609078,1418609498,4,5,420
35657441@N02,3148,16,1418625069,1418625789,2,5,720
35657441@N02,3148,27,1418627779,1418628979,2,5,1200
35657441@N02,3148,17,1418643181,1418644561,1,5,1380
35665675@N04,3149,26,1197757200,1197757380,1,1,180
35721568@N00,3150,27,1221353344,1221354544,4,12,1200
35721568@N00,3150,8,1221355109,1221355229,3,12,120
35721568@N00,3150,9,1221356008,1221356248,2,12,240
35721568@N00,3150,18,1221359368,1221361085,5,12,1717
35721568@N00,3150,20,1221361085,1221361207,3,12,122
35721568@N00,3150,26,1221361207,1221361387,2,12,180
35721568@N00,3150,16,1221362414,1221363134,4,12,720
35721568@N00,3150,22,1221364983,1221365431,2,12,448
35721568@N00,3150,20,1221365431,1221366511,2,12,1080
35721568@N00,3150,19,1221366607,1221367027,2,12,420
35721568@N00,3150,1,1221369676,1221370276,3,12,600
35721568@N00,3150,23,1221373990,1221374080,4,12,90
35736481@N00,3151,27,1258321241,1258322441,4,15,1200
35736481@N00,3151,17,1258326654,1258326763,2,15,109
35736481@N00,3151,16,1258326763,1258327023,2,15,260
35736481@N00,3151,14,1258327023,1258327143,8,15,120
35736481@N00,3151,15,1258328381,1258328561,2,15,180
35736481@N00,3151,14,1258329874,1258329994,3,15,120
35736481@N00,3151,9,1258330551,1258330791,2,15,240
35736481@N00,3151,14,1258331548,1258331668,5,15,120
35736481@N00,3151,9,1258331994,1258332234,7,15,240
35736481@N00,3151,15,1258333599,1258333779,4,15,180
35736481@N00,3151,22,1258338679,1258339254,5,15,575
35736481@N00,3151,20,1258339254,1258340334,6,15,1080
35736481@N00,3151,27,1258346565,1258347765,2,15,1200
35736481@N00,3151,9,1258359569,1258359809,9,15,240
35736481@N00,3151,14,1258360614,1258360734,3,15,120
35736481@N00,3152,13,1258436975,1258437575,2,1,600
35736481@N00,3153,16,1258661832,1258662552,46,14,720
35736481@N00,3153,2,1258669303,1258669393,5,14,90
35736481@N00,3153,1,1258671064,1258671664,3,14,600
35736481@N00,3153,9,1258671846,1258672086,2,14,240
35736481@N00,3153,11,1258675499,1258675679,11,14,180
35736481@N00,3153,8,1258676435,1258676555,5,14,120
35736481@N00,3153,9,1258678818,1258679058,2,14,240
35736481@N00,3153,26,1258680148,1258680328,5,14,180
35736481@N00,3153,25,1258680747,1258681497,6,14,750
35736481@N00,3153,17,1258683018,1258684398,7,14,1380
35736481@N00,3153,20,1258687227,1258688307,2,14,1080
35736481@N00,3153,22,1258690447,1258691047,6,14,600
35736481@N00,3153,20,1258696611,1258697691,3,14,1080
35736481@N00,3153,14,1258699745,1258699865,8,14,120
35736481@N00,3154,27,1296079755,1296080886,3,10,1131
35736481@N00,3154,14,1296080886,1296081006,7,10,120
35736481@N00,3154,9,1296083559,1296083799,3,10,240
35736481@N00,3154,6,1296085217,1296085472,4,10,255
35736481@N00,3154,11,1296089141,1296089321,5,10,180
35736481@N00,3154,20,1296091571,1296092651,3,10,1080
35736481@N00,3154,22,1296096615,1296097215,4,10,600
35736481@N00,3154,26,1296097695,1296097875,2,10,180
35736481@N00,3154,25,1296099110,1296099860,6,10,750
35736481@N00,3154,26,1296100166,1296100346,3,10,180
35736481@N00,3155,9,1296429066,1296429306,12,13,240
35736481@N00,3155,17,1296434406,1296434567,3,13,161
35736481@N00,3155,16,1296434567,1296434901,2,13,334
35736481@N00,3155,14,1296434901,1296435021,3,13,120
35736481@N00,3155,9,1296436737,1296436977,4,13,240
35736481@N00,3155,2,1296445356,1296445446,2,13,90
35736481@N00,3155,1,1296446216,1296446816,6,13,600
35736481@N00,3155,22,1296450829,1296450913,2,13,84
35736481@N00,3155,26,1296450913,1296451093,2,13,180
35736481@N00,3155,20,1296453152,1296454232,6,13,1080
35736481@N00,3155,18,1296455297,1296457097,2,13,1800
35736481@N00,3155,19,1296458072,1296458492,2,13,420
35736481@N00,3155,17,1296458527,1296459907,1,13,1380
35736481@N00,3156,19,1296603300,1296603720,3,7,420
35736481@N00,3156,9,1296604776,1296605016,2,7,240
35736481@N00,3156,1,1296605044,1296605644,2,7,600
35736481@N00,3156,9,1296607817,1296608057,4,7,240
35736481@N00,3156,22,1296612846,1296613446,2,7,600
35736481@N00,3156,20,1296614342,1296615422,3,7,1080
35736481@N00,3156,25,1296618096,1296618846,1,7,750
35736481@N00,3157,25,1335775811,1335776561,2,1,750
35758162@N00,3158,16,1194768138,1194768143,2,5,5
35758162@N00,3158,6,1194768143,1194768147,3,5,4
35758162@N00,3158,2,1194768147,1194768152,2,5,5
35758162@N00,3158,13,1194768152,1194768167,2,5,15
35758162@N00,3158,18,1194768167,1194769967,1,5,1800
35816811@N04,3159,10,1379631788,1379632208,2,3,420
35816811@N04,3159,20,1379636244,1379637324,2,3,1080
35816811@N04,3159,8,1379639283,1379639403,1,3,120
35816811@N04,3160,27,1388947357,1388948557,1,1,1200
35816811@N04,3161,14,1389256006,1389256126,1,1,120
35825796@N00,3162,27,1194911845,1194913045,7,1,1200
35849644@N06,3163,17,1397177224,1397178604,32,1,1380
35849644@N06,3164,17,1397271049,1397272429,1,1,1380
35853462@N00,3165,9,1231122492,1231122732,2,1,240
35853462@N00,3166,6,1231471131,1231471174,2,2,43
35853462@N00,3166,27,1231471174,1231472374,1,2,1200
35853462@N00,3167,6,1283651155,1283651410,1,1,255
35853462@N00,3168,17,1283689429,1283690809,2,1,1380
35853462@N00,3169,13,1283996263,1283996331,2,5,68
35853462@N00,3169,12,1283996331,1283997171,2,5,840
35853462@N00,3169,14,1283997518,1283997638,2,5,120
35853462@N00,3169,2,1284001099,1284001189,2,5,90
35853462@N00,3169,26,1284014008,1284014188,1,5,180
35853462@N00,3170,20,1388915900,1388916980,1,1,1080
35853462@N00,3171,2,1389142023,1389142113,12,8,90
35853462@N00,3171,1,1389142975,1389143575,2,8,600
35853462@N00,3171,13,1389146621,1389147221,12,8,600
35853462@N00,3171,1,1389151115,1389151715,3,8,600
35853462@N00,3171,2,1389153595,1389153685,11,8,90
35853462@N00,3171,3,1389154401,1389154427,2,8,26
35853462@N00,3171,2,1389154427,1389154517,2,8,90
35853462@N00,3171,19,1389157171,1389157591,2,8,420
35853462@N00,3172,25,1389223569,1389224319,10,1,750
35853462@N00,3173,6,1389342972,1389343227,2,3,255
35853462@N00,3173,13,1389344442,1389344997,5,3,555
35853462@N00,3173,17,1389344997,1389346377,6,3,1380
35853462@N00,3174,4,1389393245,1389394131,2,9,886
35853462@N00,3174,2,1389394131,1389394221,5,9,90
35853462@N00,3174,6,1389394379,1389394634,2,9,255
35853462@N00,3174,10,1389396001,1389396421,2,9,420
35853462@N00,3174,13,1389398362,1389398962,2,9,600
35853462@N00,3174,21,1389399412,1389399862,2,9,450
35853462@N00,3174,25,1389400634,1389400646,2,9,12
35853462@N00,3174,26,1389400646,1389400826,3,9,180
35853462@N00,3174,25,1389400992,1389401742,3,9,750
35872939@N00,3175,27,1233451152,1233452352,9,11,1200
35872939@N00,3175,14,1233456532,1233456652,2,11,120
35872939@N00,3175,26,1233458068,1233458248,14,11,180
35872939@N00,3175,8,1233461392,1233461512,3,11,120
35872939@N00,3175,11,1233461758,1233461938,5,11,180
35872939@N00,3175,8,1233463026,1233463146,3,11,120
35872939@N00,3175,11,1233466044,1233466224,3,11,180
35872939@N00,3175,8,1233467360,1233467480,2,11,120
35872939@N00,3175,1,1233469259,1233469859,2,11,600
35872939@N00,3175,4,1233472567,1233473467,10,11,900
35872939@N00,3175,21,1233482144,1233482594,1,11,450
35872939@N00,3176,12,1233806926,1233807766,2,3,840
35872939@N00,3176,14,1233808428,1233808548,2,3,120
35872939@N00,3176,17,1233816242,1233817622,3,3,1380
35872939@N00,3177,27,1267400578,1267401573,3,5,995
35872939@N00,3177,8,1267401573,1267401693,2,5,120
35872939@N00,3177,9,1267401915,1267402155,2,5,240
35872939@N00,3177,12,1267402763,1267403603,7,5,840
35872939@N00,3177,11,1267404275,1267404455,18,5,180
35888901@N00,3178,14,1324986796,1324986916,2,2,120
35888901@N00,3178,16,1324987980,1324988700,1,2,720
35897523@N04,3179,4,1191281593,1191282493,1,1,900
35897523@N04,3180,27,1243381308,1243382134,2,5,826
35897523@N04,3180,4,1243382134,1243383034,2,5,900
35897523@N04,3180,14,1243387319,1243387439,2,5,120
35897523@N04,3180,17,1243387720,1243387891,2,5,171
35897523@N04,3180,23,1243387891,1243387981,1,5,90
35897523@N04,3181,21,1244941226,1244941676,5,2,450
35897523@N04,3181,4,1244954243,1244955143,1,2,900
35897523@N04,3182,27,1251091812,1251093012,3,4,1200
35897523@N04,3182,26,1251095418,1251095598,2,4,180
35897523@N04,3182,9,1251099881,1251100121,2,4,240
35897523@N04,3182,12,1251101074,1251101914,1,4,840
35897523@N04,3183,27,1251370977,1251372177,5,1,1200
35897523@N04,3184,27,1264625194,1264626394,1,1,1200
35897523@N04,3185,19,1283820168,1283820588,1,1,420
35897523@N04,3186,9,1314239261,1314239501,1,1,240
35897523@N04,3187,4,1347361719,1347362619,1,1,900
35897587@N08,3188,14,1401857291,1401857411,1,1,120
35908912@N07,3189,27,1294965590,1294966790,1,1,1200
35909485@N03,3190,2,1217494377,1217494441,2,3,64
35909485@N03,3190,16,1217494441,1217495161,2,3,720
35909485@N03,3190,1,1217502643,1217503243,1,3,600
35909485@N03,3191,16,1217813677,1217814397,1,1,720
35921741@N06,3192,2,1384132074,1384132164,1,1,90
35928519@N00,3193,27,1322943872,1322945072,1,1,1200
35928519@N00,3194,27,1323064571,1323065771,1,1,1200
35928519@N00,3195,16,1385939609,1385940329,3,1,720
36004850@N02,3196,22,1259551594,1259552194,1,1,600
36004850@N02,3197,27,1259622134,1259623334,5,1,1200
36041393@N06,3198,21,1415669810,1415670260,2,1,450
36041393@N06,3199,27,1416093612,1416094812,3,13,1200
36041393@N06,3199,9,1416095614,1416095854,4,13,240
36041393@N06,3199,19,1416099488,1416099908,2,13,420
36041393@N06,3199,22,1416100778,1416101378,4,13,600
36041393@N06,3199,26,1416101381,1416101561,2,13,180
36041393@N06,3199,13,1416109612,1416109852,2,13,240
36041393@N06,3199,26,1416109852,1416110032,2,13,180
36041393@N06,3199,25,1416110062,1416110812,3,13,750
36041393@N06,3199,19,1416111491,1416111911,2,13,420
36041393@N06,3199,13,1416112755,1416113115,2,13,360
36041393@N06,3199,14,1416113115,1416113235,2,13,120
36041393@N06,3199,8,1416114007,1416114127,3,13,120
36041393@N06,3199,6,1416116871,1416117126,1,13,255
36044387@N04,3200,27,1221531028,1221532228,1,1,1200
36048845@N06,3201,17,1392537316,1392538696,2,1,1380
36052779@N07,3202,27,1357082741,1357083941,4,2,1200
36052779@N07,3202,25,1357084644,1357085394,1,2,750
36052779@N07,3203,14,1357114072,1357114192,1,1,120
36072072@N06,3204,7,1271208920,1271209010,1,1,90
36101699447@N01,3205,24,1357162354,1357162834,2,2,480
36101699447@N01,3205,25,1357163633,1357164383,1,2,750
36101699901@N01,3206,4,1224902951,1224903851,2,1,900
36101699901@N01,3207,4,1262344642,1262345542,1,1,900
36101699901@N01,3208,18,1277347943,1277349743,1,1,1800
36101699901@N01,3209,22,1285390186,1285390786,1,1,600
36101699901@N01,3210,13,1340429842,1340430442,1,1,600
36112910@N02,3211,16,1380939831,1380940551,2,4,720
36112910@N02,3211,25,1380941265,1380942015,2,4,750
36112910@N02,3211,14,1380945170,1380945290,2,4,120
36112910@N02,3211,10,1380949810,1380950230,1,4,420
36168978@N00,3212,16,1292900484,1292901204,3,4,720
36168978@N00,3212,12,1292901801,1292902641,3,4,840
36168978@N00,3212,11,1292910302,1292910391,3,4,89
36168978@N00,3212,16,1292910391,1292911111,1,4,720
36179078@N03,3213,14,1384140617,1384140737,2,2,120
36179078@N03,3213,16,1384140786,1384141506,1,2,720
36191363@N00,3214,9,1214736695,1214736935,1,1,240
36196989@N02,3215,10,1297986447,1297986867,2,2,420
36196989@N02,3215,17,1298012603,1298013983,1,2,1380
36226805@N03,3216,27,1190599307,1190600507,2,2,1200
36226805@N03,3216,26,1190605538,1190605718,1,2,180
36226805@N03,3217,19,1222051171,1222051591,2,1,420
36226805@N03,3218,27,1222303857,1222305057,2,4,1200
36226805@N03,3218,16,1222305118,1222305838,2,4,720
36226805@N03,3218,18,1222318911,1222320711,2,4,1800
36226805@N03,3218,27,1222322759,1222323959,2,4,1200
36226805@N03,3219,25,1240317161,1240317911,1,1,750
36226805@N03,3220,13,1245417523,1245418123,1,1,600
36226805@N03,3221,26,1253506211,1253506230,2,2,19
36226805@N03,3221,18,1253506230,1253508030,1,2,1800
36226805@N03,3222,16,1253765845,1253766565,1,1,720
36226805@N03,3223,27,1284947673,1284947775,5,4,102
36226805@N03,3223,23,1284947775,1284947865,4,4,90
36226805@N03,3223,26,1284948023,1284948203,2,4,180
36226805@N03,3223,15,1284948760,1284948940,1,4,180
36226805@N03,3224,18,1285303995,1285304138,2,5,143
36226805@N03,3224,13,1285304138,1285304738,8,5,600
36226805@N03,3224,16,1285306074,1285306454,2,5,380
36226805@N03,3224,25,1285306454,1285306671,3,5,217
36226805@N03,3224,27,1285306671,1285307871,3,5,1200
36226805@N03,3225,16,1316401544,1316402264,2,15,720
36226805@N03,3225,2,1316406887,1316406977,3,15,90
36226805@N03,3225,3,1316409205,1316409226,2,15,21
36226805@N03,3225,4,1316409226,1316409811,2,15,585
36226805@N03,3225,1,1316409811,1316410411,3,15,600
36226805@N03,3225,19,1316414257,1316414665,2,15,408
36226805@N03,3225,22,1316414665,1316415265,6,15,600
36226805@N03,3225,18,1316416927,1316418727,8,15,1800
36226805@N03,3225,21,1316418752,1316419167,2,15,415
36226805@N03,3225,23,1316419167,1316419257,3,15,90
36226805@N03,3225,22,1316419699,1316420299,2,15,600
36226805@N03,3225,24,1316420481,1316420961,5,15,480
36226805@N03,3225,17,1316421430,1316421469,2,15,39
36226805@N03,3225,25,1316421469,1316421601,2,15,132
36226805@N03,3225,27,1316421601,1316422801,2,15,1200
36226805@N03,3226,27,1316742968,1316743303,5,21,335
36226805@N03,3226,12,1316743303,1316743392,5,21,89
36226805@N03,3226,27,1316743392,1316743614,7,21,222
36226805@N03,3226,25,1316743614,1316743644,2,21,30
36226805@N03,3226,27,1316743644,1316743906,4,21,262
36226805@N03,3226,4,1316743906,1316744176,5,21,270
36226805@N03,3226,5,1316744176,1316744232,3,21,56
36226805@N03,3226,2,1316744232,1316744322,3,21,90
36226805@N03,3226,6,1316745600,1316745679,2,21,79
36226805@N03,3226,2,1316745679,1316745769,2,21,90
36226805@N03,3226,9,1316747923,1316748163,6,21,240
36226805@N03,3226,15,1316748250,1316748430,3,21,180
36226805@N03,3226,12,1316749080,1316749920,13,21,840
36226805@N03,3226,18,1316750176,1316750986,3,21,810
36226805@N03,3226,13,1316750986,1316751586,14,21,600
36226805@N03,3226,26,1316752832,1316753012,2,21,180
36226805@N03,3226,24,1316753137,1316753617,2,21,480
36226805@N03,3226,25,1316754985,1316755083,2,21,98
36226805@N03,3226,27,1316755083,1316755112,2,21,29
36226805@N03,3226,16,1316755112,1316755305,2,21,193
36226805@N03,3226,27,1316755305,1316756505,1,21,1200
36226805@N03,3227,27,1347247414,1347247769,2,17,355
36226805@N03,3227,16,1347247769,1347247776,2,17,7
36226805@N03,3227,17,1347247776,1347248287,3,17,511
36226805@N03,3227,22,1347248287,1347248887,2,17,600
36226805@N03,3227,19,1347251160,1347251453,5,17,293
36226805@N03,3227,18,1347251453,1347251754,4,17,301
36226805@N03,3227,17,1347251754,1347251758,2,17,4
36226805@N03,3227,18,1347251758,1347253558,3,17,1800
36226805@N03,3227,9,1347255116,1347255356,4,17,240
36226805@N03,3227,2,1347257589,1347257679,3,17,90
36226805@N03,3227,3,1347258350,1347258620,6,17,270
36226805@N03,3227,4,1347259777,1347259937,3,17,160
36226805@N03,3227,5,1347259937,1347260096,2,17,159
36226805@N03,3227,4,1347260096,1347260187,2,17,91
36226805@N03,3227,5,1347260187,1347260907,3,17,720
36226805@N03,3227,19,1347262494,1347262914,2,17,420
36226805@N03,3227,27,1347263278,1347264478,4,17,1200
36226805@N03,3228,22,1347363543,1347364143,4,4,600
36226805@N03,3228,13,1347366647,1347367247,2,4,600
36226805@N03,3228,18,1347367879,1347368082,2,4,203
36226805@N03,3228,19,1347368082,1347368502,1,4,420
36226805@N03,3229,10,1378641219,1378641639,2,1,420
36226805@N03,3230,27,1378694671,1378695561,3,21,890
36226805@N03,3230,10,1378695561,1378695981,14,21,420
36226805@N03,3230,9,1378699283,1378699422,2,21,139
36226805@N03,3230,10,1378699422,1378699842,6,21,420
36226805@N03,3230,17,1378702507,1378702951,2,21,444
36226805@N03,3230,18,1378702951,1378703937,2,21,986
36226805@N03,3230,19,1378703937,1378704127,4,21,190
36226805@N03,3230,18,1378704127,1378704898,2,21,771
36226805@N03,3230,22,1378704898,1378705498,6,21,600
36226805@N03,3230,9,1378705660,1378705900,3,21,240
36226805@N03,3230,23,1378706496,1378706586,2,21,90
36226805@N03,3230,9,1378707106,1378707182,2,21,76
36226805@N03,3230,16,1378707182,1378707272,3,21,90
36226805@N03,3230,4,1378707272,1378708172,2,21,900
36226805@N03,3230,3,1378708535,1378708805,2,21,270
36226805@N03,3230,2,1378708920,1378708929,2,21,9
36226805@N03,3230,6,1378708929,1378709141,2,21,212
36226805@N03,3230,1,1378709141,1378709741,3,21,600
36226805@N03,3230,14,1378709825,1378709844,2,21,19
36226805@N03,3230,16,1378709844,1378710079,2,21,235
36226805@N03,3230,27,1378710079,1378711279,1,21,1200
36226805@N03,3231,16,1378807760,1378808480,8,9,720
36226805@N03,3231,22,1378813246,1378813456,3,9,210
36226805@N03,3231,18,1378813456,1378813615,2,9,159
36226805@N03,3231,22,1378813615,1378813662,3,9,47
36226805@N03,3231,18,1378813662,1378813779,4,9,117
36226805@N03,3231,22,1378813779,1378813923,8,9,144
36226805@N03,3231,13,1378813923,1378814523,9,9,600
36226805@N03,3231,19,1378815758,1378816178,2,9,420
36226805@N03,3231,27,1378818850,1378820050,2,9,1200
36226805@N03,3232,4,1378984063,1378984963,3,1,900
36231632@N00,3233,27,1432162653,1432163853,1,1,1200
36283124@N05,3234,27,1292028590,1292029790,2,7,1200
36283124@N05,3234,17,1292036949,1292038329,2,7,1380
36283124@N05,3234,27,1292040430,1292041630,3,7,1200
36283124@N05,3234,17,1292044828,1292045502,2,7,674
36283124@N05,3234,5,1292045502,1292046222,2,7,720
36283124@N05,3234,27,1292049719,1292050882,2,7,1163
36283124@N05,3234,4,1292050882,1292051782,1,7,900
36330825967@N01,3235,14,1259295597,1259295717,2,2,120
36330825967@N01,3235,27,1259311574,1259312774,1,2,1200
36330825967@N01,3236,4,1427664368,1427665268,7,1,900
36372149@N00,3237,23,1330061828,1330061918,2,2,90
36372149@N00,3237,17,1330063692,1330065072,1,2,1380
36450627@N08,3238,14,1279433945,1279434065,2,2,120
36450627@N08,3238,9,1279434068,1279434308,1,2,240
36476564@N05,3239,27,1338250312,1338251512,1,1,1200
36476564@N05,3240,27,1379479948,1379481148,1,1,1200
36476564@N05,3241,14,1402446992,1402447112,2,2,120
36476564@N05,3241,23,1402469789,1402469879,1,2,90
36488332@N07,3242,11,1296970207,1296970387,3,3,180
36488332@N07,3242,3,1296971829,1296972099,2,3,270
36488332@N07,3242,4,1296973641,1296974541,3,3,900
36488502@N03,3243,12,1355100806,1355101646,2,1,840
36488502@N03,3244,17,1355382813,1355384193,1,1,1380
36521965978@N01,3245,1,1288651127,1288651727,2,4,600
36521965978@N01,3245,2,1288656443,1288656533,2,4,90
36521965978@N01,3245,16,1288669539,1288670259,2,4,720
36521965978@N01,3245,23,1288691937,1288692027,1,4,90
36606366@N00,3246,20,1380266864,1380267944,2,3,1080
36606366@N00,3246,27,1380268816,1380270016,2,3,1200
36606366@N00,3246,16,1380273133,1380273853,1,3,720
36607954@N05,3247,21,1246946221,1246946671,3,2,450
36607954@N05,3247,17,1246946673,1246948053,2,2,1380
36675073@N02,3248,16,1249886626,1249887346,2,2,720
36675073@N02,3248,9,1249888406,1249888646,1,2,240
36675073@N02,3249,8,1250226167,1250226287,1,1,120
36675073@N02,3250,4,1250739485,1250740385,3,2,900
36675073@N02,3250,17,1250753524,1250754904,1,2,1380
36679705@N05,3251,14,1322049148,1322049268,1,1,120
36694655@N08,3252,15,1402309683,1402309863,1,1,180
36694655@N08,3253,14,1402354180,1402354200,2,2,20
36694655@N08,3253,27,1402354200,1402355400,1,2,1200
36694655@N08,3254,2,1402631753,1402631816,2,8,63
36694655@N08,3254,27,1402631816,1402633016,2,8,1200
36694655@N08,3254,14,1402638503,1402638525,2,8,22
36694655@N08,3254,20,1402638525,1402639605,2,8,1080
36694655@N08,3254,23,1402647085,1402647100,2,8,15
36694655@N08,3254,11,1402647100,1402647114,2,8,14
36694655@N08,3254,14,1402647114,1402647234,2,8,120
36694655@N08,3254,15,1402648640,1402648820,1,8,180
36702908@N05,3255,27,1421617562,1421618762,2,13,1200
36702908@N05,3255,3,1421622775,1421623045,3,13,270
36702908@N05,3255,27,1421623928,1421625128,2,13,1200
36702908@N05,3255,17,1421626252,1421626846,2,13,594
36702908@N05,3255,27,1421626846,1421628046,6,13,1200
36702908@N05,3255,8,1421630193,1421630313,2,13,120
36702908@N05,3255,11,1421631972,1421632152,2,13,180
36702908@N05,3255,14,1421633956,1421634076,3,13,120
36702908@N05,3255,18,1421636464,1421638264,5,13,1800
36702908@N05,3255,27,1421657793,1421658993,3,13,1200
36702908@N05,3255,25,1421660507,1421661257,2,13,750
36702908@N05,3255,4,1421661436,1421662220,2,13,784
36702908@N05,3255,9,1421662220,1421662460,3,13,240
36702908@N05,3256,18,1421882757,1421883646,5,10,889
36702908@N05,3256,19,1421883646,1421883772,2,10,126
36702908@N05,3256,18,1421883772,1421885572,2,10,1800
36702908@N05,3256,15,1421893124,1421893151,2,10,27
36702908@N05,3256,12,1421893151,1421893991,8,10,840
36702908@N05,3256,9,1421906764,1421906770,2,10,6
36702908@N05,3256,7,1421906770,1421906860,2,10,90
36702908@N05,3256,9,1421908825,1421909065,3,10,240
36702908@N05,3256,14,1421910063,1421910183,3,10,120
36702908@N05,3256,27,1421914240,1421915440,9,10,1200
36702908@N05,3257,14,1422489399,1422489519,3,3,120
36702908@N05,3257,8,1422501338,1422501458,2,3,120
36702908@N05,3257,17,1422515374,1422516754,1,3,1380
36735086@N07,3258,27,1252020721,1252021921,6,4,1200
36735086@N07,3258,2,1252022188,1252022278,3,4,90
36735086@N07,3258,6,1252024008,1252024263,3,4,255
36735086@N07,3258,11,1252024379,1252024559,2,4,180
36735086@N07,3259,27,1252236664,1252237358,3,4,694
36735086@N07,3259,24,1252237358,1252237838,3,4,480
36735086@N07,3259,26,1252239522,1252239702,4,4,180
36735086@N07,3259,27,1252242397,1252243597,5,4,1200
36753534@N02,3260,4,1307142354,1307143254,2,2,900
36753534@N02,3260,1,1307143923,1307144523,1,2,600
36771701@N00,3261,16,1200791645,1200792365,2,4,720
36771701@N00,3261,4,1200794029,1200794929,2,4,900
36771701@N00,3261,1,1200804582,1200805182,2,4,600
36771701@N00,3261,4,1200809053,1200809953,2,4,900
36776510@N03,3262,15,1293501261,1293501441,2,3,180
36776510@N03,3262,19,1293507252,1293507522,2,3,270
36776510@N03,3262,18,1293507522,1293509322,1,3,1800
36801190@N00,3263,16,1357257271,1357257313,2,3,42
36801190@N00,3263,11,1357257313,1357257392,2,3,79
36801190@N00,3263,13,1357257392,1357257992,1,3,600
36819642@N00,3264,27,1200001379,1200002579,4,3,1200
36819642@N00,3264,14,1200002696,1200002816,2,3,120
36819642@N00,3264,26,1200005767,1200005947,2,3,180
36819642@N00,3265,4,1200084927,1200084993,2,8,66
36819642@N00,3265,6,1200084993,1200085149,2,8,156
36819642@N00,3265,14,1200085149,1200085269,4,8,120
36819642@N00,3265,17,1200085290,1200085385,2,8,95
36819642@N00,3265,26,1200085385,1200085461,2,8,76
36819642@N00,3265,22,1200085461,1200085535,3,8,74
36819642@N00,3265,20,1200085535,1200086615,2,8,1080
36819642@N00,3265,21,1200112381,1200112831,1,8,450
36864630@N00,3266,16,1370301302,1370302022,1,1,720
36895960@N00,3267,3,1422674863,1422675133,1,1,270
36895960@N00,3268,27,1423191070,1423192270,1,1,1200
36911028@N00,3269,22,1332371971,1332372571,2,2,600
36911028@N00,3269,16,1332395422,1332396142,1,2,720
36911028@N00,3270,9,1410511919,1410512159,2,2,240
36911028@N00,3270,26,1410515415,1410515595,1,2,180
36916766@N08,3271,27,1261297432,1261298632,4,2,1200
36916766@N08,3271,9,1261303765,1261304005,1,2,240
36916766@N08,3272,6,1274824238,1274824493,1,1,255
36916766@N08,3273,25,1276329446,1276329455,2,6,9
36916766@N08,3273,20,1276329455,1276329477,2,6,22
36916766@N08,3273,13,1276329477,1276329485,2,6,8
36916766@N08,3273,19,1276329485,1276329506,3,6,21
36916766@N08,3273,20,1276329506,1276329531,2,6,25
36916766@N08,3273,27,1276329531,1276330731,3,6,1200
36916766@N08,3274,27,1279381244,1279381469,2,5,225
36916766@N08,3274,14,1279381469,1279381473,2,5,4
36916766@N08,3274,6,1279381473,1279381476,2,5,3
36916766@N08,3274,9,1279381476,1279381480,2,5,4
36916766@N08,3274,14,1279381480,1279381600,3,5,120
36916766@N08,3275,9,1361649691,1361649931,1,1,240
37046031@N00,3276,20,1225839915,1225840995,4,2,1080
37046031@N00,3276,19,1225841823,1225842243,2,2,420
37063827@N02,3277,27,1355702186,1355703213,2,40,1027
37063827@N02,3277,19,1355703213,1355703393,3,40,180
37063827@N02,3277,20,1355703393,1355703644,2,40,251
37063827@N02,3277,22,1355703644,1355704015,4,40,371
37063827@N02,3277,17,1355704015,1355705395,11,40,1380
37063827@N02,3277,27,1355706780,1355707980,6,40,1200
37063827@N02,3277,4,1355709675,1355709832,3,40,157
37063827@N02,3277,2,1355709832,1355709922,3,40,90
37063827@N02,3277,1,1355711500,1355711956,2,40,456
37063827@N02,3277,8,1355711956,1355712076,3,40,120
37063827@N02,3277,7,1355712345,1355712435,2,40,90
37063827@N02,3277,14,1355712629,1355712749,2,40,120
37063827@N02,3277,10,1355712904,1355713324,3,40,420
37063827@N02,3277,11,1355713439,1355713619,2,40,180
37063827@N02,3277,10,1355713851,1355714271,4,40,420
37063827@N02,3277,12,1355714305,1355714673,2,40,368
37063827@N02,3277,25,1355714673,1355715325,6,40,652
37063827@N02,3277,23,1355715325,1355715415,4,40,90
37063827@N02,3277,21,1355715628,1355716078,3,40,450
37063827@N02,3277,22,1355718432,1355719032,15,40,600
37063827@N02,3277,5,1355720451,1355721171,2,40,720
37063827@N02,3277,14,1355721218,1355721338,2,40,120
37063827@N02,3277,10,1355723045,1355723465,7,40,420
37063827@N02,3277,9,1355724682,1355724922,3,40,240
37063827@N02,3277,16,1355726854,1355727196,2,40,342
37063827@N02,3277,10,1355727196,1355727433,2,40,237
37063827@N02,3277,11,1355727433,1355727613,2,40,180
37063827@N02,3277,14,1355728537,1355728657,3,40,120
37063827@N02,3277,17,1355730667,1355731029,5,40,362
37063827@N02,3277,16,1355731029,1355731328,4,40,299
37063827@N02,3277,4,1355731328,1355731487,2,40,159
37063827@N02,3277,2,1355731487,1355731577,2,40,90
37063827@N02,3277,1,1355731654,1355732254,4,40,600
37063827@N02,3277,8,1355732516,1355732636,2,40,120
37063827@N02,3277,9,1355732905,1355733060,2,40,155
37063827@N02,3277,16,1355733060,1355733780,10,40,720
37063827@N02,3277,23,1355734403,1355734493,2,40,90
37063827@N02,3277,21,1355734573,1355734750,3,40,177
37063827@N02,3277,20,1355734750,1355735830,2,40,1080
37063827@N02,3277,27,1355735952,1355737152,4,40,1200
37084963@N08,3278,14,1393481191,1393481311,1,1,120
37088822@N00,3279,16,1236986365,1236986491,6,13,126
37088822@N00,3279,14,1236986491,1236986611,3,13,120
37088822@N00,3279,13,1236986895,1236987495,13,13,600
37088822@N00,3279,18,1236994152,1236994490,13,13,338
37088822@N00,3279,22,1236994490,1236994525,2,13,35
37088822@N00,3279,18,1236994525,1236994658,4,13,133
37088822@N00,3279,19,1236994658,1236995013,14,13,355
37088822@N00,3279,13,1236995013,1236995235,6,13,222
37088822@N00,3279,18,1236995235,1236995524,10,13,289
37088822@N00,3279,17,1236995524,1236996904,95,13,1380
37088822@N00,3279,25,1237007408,1237007954,2,13,546
37088822@N00,3279,27,1237007954,1237009154,9,13,1200
37088822@N00,3279,1,1237021276,1237021876,7,13,600
37095876@N02,3280,20,1366423835,1366424915,2,3,1080
37095876@N02,3280,1,1366425641,1366426241,2,3,600
37095876@N02,3280,20,1366427973,1366429053,1,3,1080
37097738@N02,3281,6,1444353567,1444353822,2,4,255
37097738@N02,3281,9,1444354290,1444354530,6,4,240
37097738@N02,3281,7,1444355979,1444356069,5,4,90
37097738@N02,3281,20,1444358885,1444359965,3,4,1080
37097738@N02,3282,27,1450066775,1450067975,10,5,1200
37097738@N02,3282,9,1450076557,1450076797,2,5,240
37097738@N02,3282,17,1450076917,1450078297,3,5,1380
37097738@N02,3282,14,1450079835,1450079955,2,5,120
37097738@N02,3282,27,1450080343,1450081543,1,5,1200
37159320@N00,3283,16,1188729307,1188730027,5,1,720
37159320@N00,3284,22,1274686403,1274687003,1,1,600
37159320@N00,3285,27,1345766213,1345767413,2,4,1200
37159320@N00,3285,14,1345780476,1345780596,2,4,120
37159320@N00,3285,2,1345781468,1345781558,2,4,90
37159320@N00,3285,4,1345795025,1345795925,1,4,900
37159320@N00,3286,27,1359866587,1359867787,2,2,1200
37159320@N00,3286,10,1359868946,1359869366,1,2,420
37159320@N00,3287,1,1360124429,1360125029,2,3,600
37159320@N00,3287,9,1360129238,1360129478,2,3,240
37159320@N00,3287,14,1360129841,1360129961,1,3,120
37159320@N00,3288,20,1360195369,1360196195,2,2,826
37159320@N00,3288,22,1360196195,1360196795,3,2,600
37159320@N00,3289,22,1360496470,1360497070,1,1,600
37159320@N00,3290,27,1379147949,1379149149,2,3,1200
37159320@N00,3290,17,1379150797,1379152177,2,3,1380
37159320@N00,3290,27,1379161928,1379163128,1,3,1200
37159320@N00,3291,27,1379402318,1379403518,4,10,1200
37159320@N00,3291,13,1379408281,1379408702,3,10,421
37159320@N00,3291,12,1379408702,1379409542,2,10,840
37159320@N00,3291,17,1379412893,1379414273,9,10,1380
37159320@N00,3291,13,1379414500,1379415100,2,10,600
37159320@N00,3291,19,1379418821,1379419241,2,10,420
37159320@N00,3291,1,1379422340,1379422604,2,10,264
37159320@N00,3291,8,1379422604,1379422724,2,10,120
37159320@N00,3291,16,1379423398,1379424118,4,10,720
37159320@N00,3291,13,1379424221,1379424821,2,10,600
37182874@N04,3292,27,1259109535,1259110735,1,1,1200
37186095@N08,3293,27,1305954927,1305956127,2,5,1200
37186095@N08,3293,23,1305958009,1305958030,2,5,21
37186095@N08,3293,24,1305958030,1305958510,2,5,480
37186095@N08,3293,1,1305983475,1305983667,2,5,192
37186095@N08,3293,2,1305983667,1305983757,1,5,90
37186095@N08,3294,27,1306366022,1306366359,3,9,337
37186095@N08,3294,16,1306366359,1306366767,2,9,408
37186095@N08,3294,14,1306366767,1306366887,2,9,120
37186095@N08,3294,12,1306368265,1306369031,2,9,766
37186095@N08,3294,9,1306369031,1306369271,2,9,240
37186095@N08,3294,14,1306369955,1306370075,2,9,120
37186095@N08,3294,9,1306371916,1306372046,2,9,130
37186095@N08,3294,14,1306372046,1306372125,2,9,79
37186095@N08,3294,9,1306372125,1306372365,2,9,240
37186095@N08,3295,4,1317375208,1317376108,2,2,900
37186095@N08,3295,21,1317386217,1317386667,3,2,450
37186095@N08,3296,27,1317422597,1317423797,3,2,1200
37186095@N08,3296,16,1317427041,1317427761,3,2,720
37186095@N08,3297,27,1317593851,1317595051,3,11,1200
37186095@N08,3297,14,1317597198,1317597318,2,11,120
37186095@N08,3297,13,1317599939,1317600539,3,11,600
37186095@N08,3297,17,1317601211,1317601910,2,11,699
37186095@N08,3297,15,1317601910,1317602090,2,11,180
37186095@N08,3297,17,1317603139,1317604519,2,11,1380
37186095@N08,3297,19,1317606805,1317607225,2,11,420
37186095@N08,3297,11,1317612038,1317612218,2,11,180
37186095@N08,3297,16,1317633504,1317634224,2,11,720
37186095@N08,3297,3,1317637669,1317637939,6,11,270
37186095@N08,3297,16,1317646472,1317647192,1,11,720
37186095@N08,3298,27,1330455048,1330456248,2,12,1200
37186095@N08,3298,16,1330456349,1330456379,2,12,30
37186095@N08,3298,14,1330456379,1330456499,2,12,120
37186095@N08,3298,27,1330460281,1330461481,2,12,1200
37186095@N08,3298,16,1330465071,1330465444,2,12,373
37186095@N08,3298,13,1330465444,1330465453,2,12,9
37186095@N08,3298,17,1330465453,1330465570,2,12,117
37186095@N08,3298,13,1330465570,1330466170,3,12,600
37186095@N08,3298,17,1330466783,1330468163,3,12,1380
37186095@N08,3298,20,1330469158,1330469404,2,12,246
37186095@N08,3298,26,1330469404,1330469584,2,12,180
37186095@N08,3298,27,1330473097,1330474297,1,12,1200
37186095@N08,3299,4,1330511175,1330511322,2,3,147
37186095@N08,3299,16,1330511322,1330512042,2,3,720
37186095@N08,3299,21,1330514707,1330515157,1,3,450
37196072@N07,3300,16,1239195282,1239196002,1,1,720
37216383@N05,3301,19,1336198106,1336198526,1,1,420
37216383@N05,3302,20,1338032931,1338034011,1,1,1080
37216383@N05,3303,10,1351027918,1351028338,3,1,420
37216383@N05,3304,17,1354742959,1354744339,1,1,1380
37216383@N05,3305,10,1358388688,1358389108,1,1,420
37216383@N05,3306,16,1362962519,1362963239,2,1,720
37216383@N05,3307,20,1385344740,1385345820,1,1,1080
37233792@N08,3308,21,1305424015,1305424465,1,1,450
37242378@N02,3309,4,1245397861,1245398761,1,1,900
37274056@N05,3310,27,1295310755,1295311955,2,10,1200
37274056@N05,3310,14,1295313391,1295313511,12,10,120
37274056@N05,3310,6,1295315287,1295315304,3,10,17
37274056@N05,3310,9,1295315304,1295315544,5,10,240
37274056@N05,3310,2,1295316609,1295316699,2,10,90
37274056@N05,3310,3,1295317242,1295317512,2,10,270
37274056@N05,3310,25,1295321514,1295322264,5,10,750
37274056@N05,3310,8,1295325334,1295325454,3,10,120
37274056@N05,3310,6,1295326097,1295326352,4,10,255
37274056@N05,3310,11,1295326701,1295326881,8,10,180
37274056@N05,3311,27,1371172446,1371173646,3,12,1200
37274056@N05,3311,6,1371178695,1371178950,2,12,255
37274056@N05,3311,1,1371179252,1371179429,3,12,177
37274056@N05,3311,6,1371179429,1371179684,2,12,255
37274056@N05,3311,20,1371196586,1371197666,3,12,1080
37274056@N05,3311,15,1371202420,1371202600,4,12,180
37274056@N05,3311,16,1371203549,1371203558,2,12,9
37274056@N05,3311,14,1371203558,1371203678,2,12,120
37274056@N05,3311,10,1371206494,1371206914,11,12,420
37274056@N05,3311,9,1371206933,1371207173,3,12,240
37274056@N05,3311,6,1371207234,1371207251,2,12,17
37274056@N05,3311,9,1371207251,1371207491,7,12,240
37274056@N05,3312,27,1403135337,1403136537,87,1,1200
37276158@N05,3313,20,1407648485,1407649565,1,1,1080
37276158@N05,3314,20,1408797086,1408798166,1,1,1080
37276158@N05,3315,17,1408862732,1408864112,1,1,1380
37287420@N08,3316,14,1357285089,1357285209,2,3,120
37287420@N08,3316,20,1357291586,1357292666,16,3,1080
37287420@N08,3316,4,1357297127,1357298027,2,3,900
37318322@N05,3317,14,1413440323,1413440443,1,1,120
37324769@N06,3318,27,1255651520,1255652720,10,25,1200
37324769@N06,3318,16,1255653027,1255653747,2,25,720
37324769@N06,3318,14,1255653866,1255653986,18,25,120
37324769@N06,3318,22,1255657168,1255657768,6,25,600
37324769@N06,3318,26,1255660052,1255660232,2,25,180
37324769@N06,3318,17,1255660362,1255660876,2,25,514
37324769@N06,3318,13,1255660876,1255661476,3,25,600
37324769@N06,3318,4,1255662280,1255663180,5,25,900
37324769@N06,3318,2,1255664280,1255664370,14,25,90
37324769@N06,3318,27,1255668016,1255669216,18,25,1200
37324769@N06,3318,14,1255674949,1255675069,3,25,120
37324769@N06,3318,16,1255678078,1255678422,4,25,344
37324769@N06,3318,27,1255678422,1255678428,2,25,6
37324769@N06,3318,16,1255678428,1255678428,2,25,0
37324769@N06,3318,27,1255678428,1255678431,2,25,3
37324769@N06,3318,16,1255678431,1255678431,2,25,0
37324769@N06,3318,27,1255678431,1255678434,3,25,3
37324769@N06,3318,16,1255678434,1255678434,3,25,0
37324769@N06,3318,27,1255678434,1255678437,2,25,3
37324769@N06,3318,16,1255678437,1255678437,2,25,0
37324769@N06,3318,27,1255678437,1255678440,2,25,3
37324769@N06,3318,16,1255678440,1255678440,2,25,0
37324769@N06,3318,27,1255678440,1255678452,2,25,12
37324769@N06,3318,16,1255678452,1255679172,4,25,720
37324769@N06,3318,27,1255679414,1255680614,30,25,1200
37387065@N05,3319,15,1445302841,1445303021,1,1,180
37457246@N07,3320,27,1292760697,1292761897,1,1,1200
37504803@N00,3321,20,1198808614,1198809694,3,4,1080
37504803@N00,3321,22,1198819879,1198820010,2,4,131
37504803@N00,3321,26,1198820010,1198820190,2,4,180
37504803@N00,3321,17,1198820492,1198821872,1,4,1380
37515566@N00,3322,27,1443605377,1443606577,3,1,1200
37541950@N08,3323,14,1285715899,1285716019,1,1,120
37541950@N08,3324,9,1286098254,1286098494,3,3,240
37541950@N08,3324,14,1286108024,1286108144,5,3,120
37541950@N08,3324,17,1286111396,1286112776,2,3,1380
37553034@N03,3325,19,1254357701,1254358121,1,1,420
37553034@N03,3326,16,1254396744,1254397082,2,4,338
37553034@N03,3326,3,1254397082,1254397120,3,4,38
37553034@N03,3326,16,1254397120,1254397840,4,4,720
37553034@N03,3326,4,1254401582,1254402482,1,4,900
37553034@N03,3327,19,1254446707,1254447127,1,1,420
37553034@N03,3328,4,1255737290,1255738190,1,1,900
37553034@N03,3329,4,1280140114,1280141014,1,1,900
37553034@N03,3330,1,1286398732,1286399332,2,6,600
37553034@N03,3330,16,1286403861,1286404581,2,6,720
37553034@N03,3330,17,1286408135,1286409515,2,6,1380
37553034@N03,3330,20,1286411307,1286412387,2,6,1080
37553034@N03,3330,18,1286428815,1286430615,2,6,1800
37553034@N03,3330,16,1286434995,1286435715,2,6,720
37553034@N03,3331,14,1286674660,1286674780,1,1,120
37553034@N03,3332,23,1294282213,1294282303,2,5,90
37553034@N03,3332,25,1294282559,1294283309,2,5,750
37553034@N03,3332,27,1294290624,1294290717,3,5,93
37553034@N03,3332,16,1294290717,1294291261,2,5,544
37553034@N03,3332,27,1294291261,1294292461,1,5,1200
37553034@N03,3333,20,1305749997,1305751077,1,1,1080
37553034@N03,3334,20,1307053749,1307054829,1,1,1080
37553034@N03,3335,18,1307094230,1307096030,1,1,1800
37553034@N03,3336,16,1313887615,1313888124,2,6,509
37553034@N03,3336,21,1313888124,1313888574,2,6,450
37553034@N03,3336,19,1313889462,1313889882,2,6,420
37553034@N03,3336,18,1313891894,1313892156,2,6,262
37553034@N03,3336,17,1313892156,1313892878,2,6,722
37553034@N03,3336,19,1313892878,1313893298,1,6,420
37553034@N03,3337,25,1314064095,1314064845,1,1,750
37553034@N03,3338,16,1315564707,1315565427,1,1,720
37553034@N03,3339,21,1317245851,1317246301,1,1,450
37553034@N03,3340,13,1317361965,1317362565,2,3,600
37553034@N03,3340,17,1317366735,1317367956,3,3,1221
37553034@N03,3340,26,1317367956,1317368136,1,3,180
37553034@N03,3341,2,1322282531,1322282621,1,1,90
37553034@N03,3342,21,1322609808,1322610258,1,1,450
37553034@N03,3343,26,1322640599,1322640779,2,2,180
37553034@N03,3343,16,1322649228,1322649948,1,2,720
37553034@N03,3344,10,1352332824,1352333244,1,1,420
37585370@N00,3345,27,1263440132,1263441332,1,1,1200
37585370@N00,3346,1,1263477478,1263478078,2,2,600
37585370@N00,3346,26,1263479826,1263480006,1,2,180
37595844@N08,3347,16,1286932411,1286933131,3,7,720
37595844@N08,3347,14,1286935167,1286935272,2,7,105
37595844@N08,3347,16,1286935272,1286935992,2,7,720
37595844@N08,3347,22,1286946836,1286947436,3,7,600
37595844@N08,3347,17,1286958269,1286958749,2,7,480
37595844@N08,3347,26,1286958749,1286958929,2,7,180
37595844@N08,3347,14,1286964748,1286964868,1,7,120
37599879@N06,3348,22,1420159975,1420160575,2,1,600
37599879@N06,3349,27,1452640571,1452641771,1,1,1200
37606273@N07,3350,9,1360828598,1360828838,2,2,240
37606273@N07,3350,6,1360833779,1360834034,1,2,255
37620552@N06,3351,10,1367893718,1367894079,2,2,361
37620552@N06,3351,14,1367894079,1367894199,1,2,120
37642540@N04,3352,10,1240455276,1240455696,1,1,420
37642540@N04,3353,3,1380280988,1380281258,1,1,270
37657436@N04,3354,16,1262297259,1262297979,2,2,720
37657436@N04,3354,20,1262303763,1262304843,1,2,1080
37657436@N04,3355,18,1310173515,1310173713,3,3,198
37657436@N04,3355,19,1310173713,1310174133,2,3,420
37657436@N04,3355,16,1310194000,1310194720,4,3,720
37657436@N04,3356,3,1450565476,1450565746,3,4,270
37657436@N04,3356,20,1450567042,1450568122,3,4,1080
37657436@N04,3356,15,1450570318,1450570498,2,4,180
37657436@N04,3356,27,1450573831,1450575031,1,4,1200
37657436@N04,3357,16,1461792719,1461793439,2,1,720
37657436@N04,3358,16,1461829239,1461829959,1,1,720
37663070@N03,3359,17,1216540439,1216541819,2,2,1380
37663070@N03,3359,9,1216544958,1216545198,1,2,240
37668708@N05,3360,21,1240456527,1240456977,1,1,450
37668708@N05,3361,17,1243579223,1243580603,1,1,1380
37681283@N00,3362,16,1298274320,1298275040,1,1,720
37709784@N00,3363,27,1239239937,1239241137,3,2,1200
37709784@N00,3363,17,1239244283,1239245663,2,2,1380
37728727@N06,3364,14,1270079296,1270079416,8,1,120
37728727@N06,3365,14,1270293687,1270293807,2,1,120
37729827@N05,3366,22,1337744567,1337745167,4,1,600
37747991@N02,3367,27,1240792825,1240794025,8,4,1200
37747991@N02,3367,8,1240806964,1240807084,2,4,120
37747991@N02,3367,16,1240826133,1240826140,2,4,7
37747991@N02,3367,14,1240826140,1240826260,1,4,120
37747991@N02,3368,20,1240880813,1240881893,8,2,1080
37747991@N02,3368,18,1240885051,1240886851,6,2,1800
37775700@N02,3369,16,1265466358,1265467078,2,3,720
37775700@N02,3369,17,1265478134,1265479514,2,3,1380
37775700@N02,3369,27,1265480730,1265481930,1,3,1200
37775700@N02,3370,1,1274460551,1274461151,2,3,600
37775700@N02,3370,27,1274464908,1274466108,3,3,1200
37775700@N02,3370,16,1274469179,1274469899,1,3,720
37775700@N02,3371,13,1304093915,1304094515,2,2,600
37775700@N02,3371,25,1304099215,1304099965,1,2,750
37869753@N06,3372,27,1312755015,1312756215,3,7,1200
37869753@N06,3372,2,1312756786,1312756876,3,7,90
37869753@N06,3372,23,1312772630,1312772720,2,7,90
37869753@N06,3372,26,1312772792,1312772972,2,7,180
37869753@N06,3372,17,1312775745,1312777125,2,7,1380
37869753@N06,3372,14,1312781589,1312781709,2,7,120
37869753@N06,3372,16,1312781724,1312782444,1,7,720
37869753@N06,3373,27,1376767451,1376768651,2,3,1200
37869753@N06,3373,16,1376782026,1376782746,19,3,720
37869753@N06,3373,27,1376787997,1376789197,5,3,1200
37908196@N07,3374,15,1329517949,1329518129,1,1,180
37908196@N07,3375,23,1355270162,1355270252,1,1,90
37925025@N08,3376,27,1287207965,1287209165,3,7,1200
37925025@N08,3376,17,1287209434,1287210814,2,7,1380
37925025@N08,3376,12,1287217022,1287217862,2,7,840
37925025@N08,3376,2,1287219152,1287219242,2,7,90
37925025@N08,3376,1,1287219285,1287219885,2,7,600
37925025@N08,3376,4,1287224383,1287225283,2,7,900
37925025@N08,3376,27,1287228587,1287229787,1,7,1200
37996583874@N01,3377,14,1377745392,1377745512,2,2,120
37996583874@N01,3377,6,1377765330,1377765585,2,2,255
37996583874@N01,3378,11,1378038927,1378039107,1,1,180
37996603748@N01,3379,27,1418165172,1418166129,2,6,957
37996603748@N01,3379,9,1418166129,1418166329,2,6,200
37996603748@N01,3379,10,1418166329,1418166749,2,6,420
37996603748@N01,3379,6,1418169556,1418169811,2,6,255
37996603748@N01,3379,20,1418174733,1418175813,2,6,1080
37996603748@N01,3379,17,1418185456,1418186836,1,6,1380
37996654902@N01,3380,27,1355633383,1355634583,2,3,1200
37996654902@N01,3380,10,1355635819,1355636239,2,3,420
37996654902@N01,3380,4,1355640054,1355640954,4,3,900
37996654902@N01,3381,25,1355825312,1355826062,2,1,750
37998051@N00,3382,27,1278392325,1278393525,3,2,1200
37998051@N00,3382,23,1278399135,1278399225,1,2,90
37998051@N00,3383,26,1278654709,1278654889,1,1,180
37998051@N00,3384,25,1309943495,1309944245,2,5,750
37998051@N00,3384,19,1309947485,1309947905,3,5,420
37998051@N00,3384,20,1309952131,1309953211,2,5,1080
37998051@N00,3384,21,1309961217,1309961667,2,5,450
37998051@N00,3384,16,1309965324,1309966044,1,5,720
37998051@N00,3385,27,1334483424,1334484624,1,1,1200
37998051@N00,3386,16,1387770243,1387770963,2,4,720
37998051@N00,3386,14,1387774107,1387774227,2,4,120
37998051@N00,3386,8,1387775446,1387775566,2,4,120
37998051@N00,3386,20,1387784642,1387785722,2,4,1080
38012205@N05,3387,22,1305626087,1305626687,1,1,600
38022350@N04,3388,16,1241643374,1241643916,3,2,542
38022350@N04,3388,14,1241643916,1241644036,1,2,120
38025203@N00,3389,14,1355474765,1355474885,1,1,120
38025203@N00,3390,27,1355533186,1355534386,1,1,1200
38067879@N08,3391,3,1323550656,1323550926,2,3,270
38067879@N08,3391,17,1323561786,1323563166,2,3,1380
38067879@N08,3391,19,1323567175,1323567595,1,3,420
38067879@N08,3392,21,1348300028,1348300478,3,2,450
38067879@N08,3392,8,1348310325,1348310445,1,2,120
38067879@N08,3393,18,1348368113,1348369913,2,4,1800
38067879@N08,3393,13,1348371099,1348371699,2,4,600
38067879@N08,3393,16,1348398059,1348398429,2,4,370
38067879@N08,3393,14,1348398429,1348398549,1,4,120
38067879@N08,3394,13,1348443967,1348444567,1,1,600
38067879@N08,3395,15,1348567263,1348567443,1,1,180
38067879@N08,3396,16,1348899640,1348900360,1,1,720
38067879@N08,3397,27,1348983078,1348984278,2,3,1200
38067879@N08,3397,24,1348985083,1348985563,2,3,480
38067879@N08,3397,19,1348989126,1348989546,1,3,420
38067879@N08,3398,13,1349266819,1349267419,1,1,600
38067879@N08,3399,8,1349324924,1349325044,1,1,120
38067879@N08,3400,15,1349413894,1349414074,1,1,180
38067879@N08,3401,21,1349486441,1349486891,1,1,450
38067879@N08,3402,16,1349639166,1349639886,1,1,720
38067879@N08,3403,15,1349898650,1349898830,1,1,180
38067879@N08,3404,14,1368354429,1368354549,2,2,120
38067879@N08,3404,9,1368360986,1368361226,1,2,240
38067879@N08,3405,20,1368431376,1368432456,1,1,1080
38067879@N08,3406,13,1386911630,1386912230,1,1,600
38067879@N08,3407,14,1411722213,1411722333,2,2,120
38067879@N08,3407,27,1411724611,1411725811,1,2,1200
38067879@N08,3408,3,1449717002,1449717272,1,1,270
38084526@N06,3409,22,1229486819,1229487419,1,1,600
38084526@N06,3410,4,1230191959,1230192859,2,3,900
38084526@N06,3410,17,1230196833,1230197339,2,3,506
38084526@N06,3410,13,1230197339,1230197939,1,3,600
38084526@N06,3411,16,1230274765,1230275485,2,5,720
38084526@N06,3411,14,1230275607,1230275727,3,5,120
38084526@N06,3411,9,1230275763,1230276003,2,5,240
38084526@N06,3411,5,1230276469,1230277189,2,5,720
38084526@N06,3411,27,1230280602,1230281802,1,5,1200
38084526@N06,3412,26,1240268877,1240269057,2,2,180
38084526@N06,3412,15,1240279528,1240279708,1,2,180
38084526@N06,3413,14,1240309158,1240309278,1,1,120
38084526@N06,3414,5,1241243744,1241244464,1,1,720
38084526@N06,3415,1,1315263345,1315263945,1,1,600
38088964@N00,3416,13,1330375478,1330376078,1,1,600
38088964@N00,3417,2,1330425479,1330425569,1,1,90
38102706@N05,3418,6,1240046818,1240047073,4,1,255
38102706@N05,3419,5,1253944202,1253944264,2,23,62
38102706@N05,3419,2,1253944264,1253944354,24,23,90
38102706@N05,3419,1,1253944963,1253945279,13,23,316
38102706@N05,3419,5,1253945279,1253945326,2,23,47
38102706@N05,3419,2,1253945326,1253945416,3,23,90
38102706@N05,3419,1,1253945520,1253945746,3,23,226
38102706@N05,3419,2,1253945746,1253945824,3,23,78
38102706@N05,3419,6,1253945824,1253945850,2,23,26
38102706@N05,3419,9,1253945850,1253946090,4,23,240
38102706@N05,3419,14,1253946206,1253946326,5,23,120
38102706@N05,3419,17,1253946461,1253946509,2,23,48
38102706@N05,3419,18,1253946509,1253946915,4,23,406
38102706@N05,3419,23,1253946915,1253947005,2,23,90
38102706@N05,3419,21,1253947692,1253948142,8,23,450
38102706@N05,3419,26,1253948310,1253948490,2,23,180
38102706@N05,3419,18,1253951859,1253952965,4,23,1106
38102706@N05,3419,7,1253952965,1253953055,6,23,90
38102706@N05,3419,8,1253954042,1253954162,4,23,120
38102706@N05,3419,14,1253956164,1253956284,4,23,120
38102706@N05,3419,17,1253956521,1253957901,2,23,1380
38102706@N05,3419,27,1253963416,1253964616,6,23,1200
38102706@N05,3419,18,1253967815,1253969450,6,23,1635
38102706@N05,3419,14,1253969450,1253969570,23,23,120
38102706@N05,3420,2,1254631739,1254631742,2,6,3
38102706@N05,3420,9,1254631742,1254631982,6,6,240
38102706@N05,3420,14,1254632030,1254632150,3,6,120
38102706@N05,3420,9,1254632323,1254632563,4,6,240
38102706@N05,3420,23,1254633101,1254633191,4,6,90
38102706@N05,3420,27,1254646403,1254647603,13,6,1200
38102706@N05,3421,15,1255503145,1255503325,2,10,180
38102706@N05,3421,9,1255504255,1255504291,2,10,36
38102706@N05,3421,6,1255504291,1255504546,2,10,255
38102706@N05,3421,5,1255504665,1255505385,22,10,720
38102706@N05,3421,2,1255506115,1255506205,2,10,90
38102706@N05,3421,6,1255506223,1255506299,2,10,76
38102706@N05,3421,1,1255506299,1255506437,5,10,138
38102706@N05,3421,7,1255506437,1255506520,6,10,83
38102706@N05,3421,2,1255506520,1255506610,5,10,90
38102706@N05,3421,5,1255506782,1255507502,2,10,720
38102706@N05,3422,11,1255933787,1255933967,4,4,180
38102706@N05,3422,2,1255936997,1255937087,7,4,90
38102706@N05,3422,1,1255938857,1255938870,3,4,13
38102706@N05,3422,2,1255938870,1255938960,1,4,90
38102706@N05,3423,27,1256963943,1256965025,7,11,1082
38102706@N05,3423,18,1256965025,1256966825,7,11,1800
38102706@N05,3423,26,1256968860,1256969003,4,11,143
38102706@N05,3423,18,1256969003,1256970803,5,11,1800
38102706@N05,3423,2,1256973099,1256973189,4,11,90
38102706@N05,3423,1,1256973276,1256973387,3,11,111
38102706@N05,3423,27,1256973387,1256973451,3,11,64
38102706@N05,3423,2,1256973451,1256973541,2,11,90
38102706@N05,3423,4,1256973558,1256973726,4,11,168
38102706@N05,3423,2,1256973726,1256973816,2,11,90
38102706@N05,3423,27,1256974949,1256976149,6,11,1200
38102706@N05,3424,27,1257485947,1257487147,8,11,1200
38102706@N05,3424,2,1257492288,1257492378,4,11,90
38102706@N05,3424,9,1257492669,1257492909,6,11,240
38102706@N05,3424,6,1257493224,1257493329,2,11,105
38102706@N05,3424,14,1257493329,1257493449,3,11,120
38102706@N05,3424,18,1257494686,1257494820,2,11,134
38102706@N05,3424,17,1257494820,1257495000,2,11,180
38102706@N05,3424,18,1257495000,1257495067,2,11,67
38102706@N05,3424,25,1257495067,1257495082,2,11,15
38102706@N05,3424,24,1257495082,1257495562,3,11,480
38102706@N05,3424,27,1257501954,1257503154,3,11,1200
38102706@N05,3425,27,1257748111,1257748965,4,5,854
38102706@N05,3425,2,1257748965,1257749055,4,5,90
38102706@N05,3425,3,1257749299,1257749449,2,5,150
38102706@N05,3425,1,1257749449,1257750049,3,5,600
38102706@N05,3425,5,1257752608,1257753328,1,5,720
38102706@N05,3426,27,1258179012,1258179610,8,13,598
38102706@N05,3426,2,1258179610,1258179697,2,13,87
38102706@N05,3426,1,1258179697,1258180062,8,13,365
38102706@N05,3426,27,1258180062,1258181262,16,13,1200
38102706@N05,3426,3,1258182010,1258182108,2,13,98
38102706@N05,3426,1,1258182108,1258182708,9,13,600
38102706@N05,3426,5,1258187574,1258188294,7,13,720
38102706@N05,3426,7,1258189907,1258189997,2,13,90
38102706@N05,3426,2,1258190412,1258190502,2,13,90
38102706@N05,3426,9,1258190598,1258190838,2,13,240
38102706@N05,3426,25,1258197192,1258197457,2,13,265
38102706@N05,3426,24,1258197457,1258197495,2,13,38
38102706@N05,3426,21,1258197495,1258197945,2,13,450
38102706@N05,3427,2,1258702740,1258702830,1,1,90
38102706@N05,3428,27,1260072924,1260074124,8,9,1200
38102706@N05,3428,22,1260075286,1260075886,13,9,600
38102706@N05,3428,18,1260076234,1260076386,2,9,152
38102706@N05,3428,22,1260076386,1260076602,4,9,216
38102706@N05,3428,26,1260076602,1260076634,2,9,32
38102706@N05,3428,18,1260076634,1260076798,4,9,164
38102706@N05,3428,17,1260076798,1260077503,6,9,705
38102706@N05,3428,18,1260077503,1260079303,8,9,1800
38102706@N05,3428,24,1260082271,1260082751,5,9,480
38102706@N05,3429,27,1260936064,1260937264,17,13,1200
38102706@N05,3429,3,1260941047,1260941109,3,13,62
38102706@N05,3429,2,1260941109,1260941199,3,13,90
38102706@N05,3429,3,1260941533,1260941637,3,13,104
38102706@N05,3429,2,1260941637,1260941727,2,13,90
38102706@N05,3429,17,1260944232,1260944685,6,13,453
38102706@N05,3429,26,1260944685,1260944792,3,13,107
38102706@N05,3429,25,1260944792,1260944912,6,13,120
38102706@N05,3429,23,1260944912,1260944984,2,13,72
38102706@N05,3429,24,1260944984,1260945464,2,13,480
38102706@N05,3429,1,1260947348,1260947948,3,13,600
38102706@N05,3429,3,1260948178,1260948448,4,13,270
38102706@N05,3429,5,1260948514,1260949234,1,13,720
38102706@N05,3430,27,1261099356,1261100367,41,14,1011
38102706@N05,3430,5,1261100367,1261100501,9,14,134
38102706@N05,3430,2,1261100501,1261100509,2,14,8
38102706@N05,3430,5,1261100509,1261100555,3,14,46
38102706@N05,3430,2,1261100555,1261100639,2,14,84
38102706@N05,3430,6,1261100639,1261100755,3,14,116
38102706@N05,3430,9,1261100755,1261100940,7,14,185
38102706@N05,3430,14,1261100940,1261101060,14,14,120
38102706@N05,3430,17,1261102773,1261103143,3,14,370
38102706@N05,3430,18,1261103143,1261104362,9,14,1219
38102706@N05,3430,17,1261104362,1261105742,7,14,1380
38102706@N05,3430,25,1261106708,1261106799,2,14,91
38102706@N05,3430,24,1261106799,1261107279,4,14,480
38102706@N05,3430,27,1261108394,1261109594,1,14,1200
38102706@N05,3431,27,1262323620,1262324483,8,5,863
38102706@N05,3431,7,1262324483,1262324573,7,5,90
38102706@N05,3431,2,1262328724,1262328814,2,5,90
38102706@N05,3431,3,1262330938,1262331208,2,5,270
38102706@N05,3431,16,1262331759,1262332479,3,5,720
38102706@N05,3432,17,1262429509,1262430889,3,3,1380
38102706@N05,3432,21,1262433901,1262434351,5,3,450
38102706@N05,3432,27,1262437593,1262438793,5,3,1200
38102706@N05,3433,27,1263009962,1263011162,29,7,1200
38102706@N05,3433,25,1263013230,1263013341,4,7,111
38102706@N05,3433,26,1263013341,1263013467,7,7,126
38102706@N05,3433,17,1263013467,1263013503,2,7,36
38102706@N05,3433,26,1263013503,1263013683,8,7,180
38102706@N05,3433,17,1263013691,1263015071,2,7,1380
38102706@N05,3433,14,1263016373,1263016493,10,7,120
38102706@N05,3434,27,1263639362,1263640562,1,1,1200
38102706@N05,3435,27,1263693101,1263694041,4,26,940
38102706@N05,3435,17,1263694041,1263695421,5,26,1380
38102706@N05,3435,2,1263696067,1263696157,17,26,90
38102706@N05,3435,5,1263699697,1263700417,2,26,720
38102706@N05,3435,27,1263702718,1263703918,4,26,1200
38102706@N05,3435,16,1263729971,1263730290,2,26,319
38102706@N05,3435,6,1263730290,1263730341,3,26,51
38102706@N05,3435,9,1263730341,1263730581,2,26,240
38102706@N05,3435,2,1263730709,1263730799,2,26,90
38102706@N05,3435,5,1263730914,1263731634,2,26,720
38102706@N05,3435,14,1263731996,1263732116,2,26,120
38102706@N05,3435,17,1263733433,1263734813,2,26,1380
38102706@N05,3435,14,1263735044,1263735164,6,26,120
38102706@N05,3435,16,1263736596,1263736741,3,26,145
38102706@N05,3435,14,1263736741,1263736861,3,26,120
38102706@N05,3435,17,1263737029,1263737228,3,26,199
38102706@N05,3435,18,1263737228,1263737310,2,26,82
38102706@N05,3435,17,1263737310,1263737686,2,26,376
38102706@N05,3435,24,1263737686,1263738166,22,26,480
38102706@N05,3435,21,1263738461,1263738639,3,26,178
38102706@N05,3435,18,1263738639,1263739238,3,26,599
38102706@N05,3435,22,1263739238,1263739838,10,26,600
38102706@N05,3435,26,1263740582,1263740615,3,26,33
38102706@N05,3435,18,1263740615,1263741166,15,26,551
38102706@N05,3435,17,1263741166,1263741456,3,26,290
38102706@N05,3435,27,1263741456,1263742656,1,26,1200
38102706@N05,3436,27,1263950768,1263951968,6,7,1200
38102706@N05,3436,17,1263969529,1263969973,5,7,444
38102706@N05,3436,6,1263969973,1263970228,3,7,255
38102706@N05,3436,22,1263974005,1263974605,2,7,600
38102706@N05,3436,25,1263976776,1263977526,2,7,750
38102706@N05,3436,9,1263978848,1263979088,6,7,240
38102706@N05,3436,27,1263981111,1263982311,6,7,1200
38102706@N05,3437,27,1264198443,1264199643,2,31,1200
38102706@N05,3437,4,1264200778,1264200969,2,31,191
38102706@N05,3437,1,1264200969,1264201097,2,31,128
38102706@N05,3437,2,1264201097,1264201187,4,31,90
38102706@N05,3437,3,1264201621,1264201891,2,31,270
38102706@N05,3437,2,1264202022,1264202112,18,31,90
38102706@N05,3437,4,1264207167,1264207371,2,31,204
38102706@N05,3437,1,1264207371,1264207580,2,31,209
38102706@N05,3437,2,1264207580,1264207670,2,31,90
38102706@N05,3437,17,1264208315,1264208351,2,31,36
38102706@N05,3437,18,1264208351,1264208632,3,31,281
38102706@N05,3437,26,1264208632,1264208745,2,31,113
38102706@N05,3437,18,1264208745,1264209810,15,31,1065
38102706@N05,3437,17,1264209810,1264211190,2,31,1380
38102706@N05,3437,26,1264212145,1264212309,2,31,164
38102706@N05,3437,17,1264212309,1264213689,2,31,1380
38102706@N05,3437,18,1264214591,1264214654,2,31,63
38102706@N05,3437,17,1264214654,1264214809,2,31,155
38102706@N05,3437,18,1264214809,1264216609,7,31,1800
38102706@N05,3437,14,1264217202,1264217322,3,31,120
38102706@N05,3437,2,1264222674,1264222764,3,31,90
38102706@N05,3437,1,1264224183,1264224459,2,31,276
38102706@N05,3437,7,1264224459,1264224549,3,31,90
38102706@N05,3437,8,1264224580,1264224700,5,31,120
38102706@N05,3437,11,1264225184,1264225273,3,31,89
38102706@N05,3437,8,1264225273,1264225393,6,31,120
38102706@N05,3437,6,1264225607,1264225862,2,31,255
38102706@N05,3437,14,1264226111,1264226231,4,31,120
38102706@N05,3437,27,1264226927,1264228127,14,31,1200
38102706@N05,3437,24,1264241566,1264242046,14,31,480
38102706@N05,3437,27,1264246889,1264248089,5,31,1200
38102706@N05,3438,27,1264909401,1264910601,20,27,1200
38102706@N05,3438,4,1264915592,1264915657,2,27,65
38102706@N05,3438,1,1264915657,1264915763,3,27,106
38102706@N05,3438,2,1264915763,1264915853,3,27,90
38102706@N05,3438,6,1264915859,1264916059,4,27,200
38102706@N05,3438,9,1264916059,1264916196,3,27,137
38102706@N05,3438,14,1264916196,1264916316,4,27,120
38102706@N05,3438,17,1264916353,1264916447,2,27,94
38102706@N05,3438,18,1264916447,1264918159,3,27,1712
38102706@N05,3438,26,1264918159,1264918239,2,27,80
38102706@N05,3438,23,1264918239,1264918329,3,27,90
38102706@N05,3438,22,1264918631,1264919231,13,27,600
38102706@N05,3438,23,1264919633,1264919723,4,27,90
38102706@N05,3438,26,1264919815,1264919851,2,27,36
38102706@N05,3438,25,1264919851,1264920153,2,27,302
38102706@N05,3438,18,1264920153,1264920397,2,27,244
38102706@N05,3438,22,1264920397,1264920479,2,27,82
38102706@N05,3438,24,1264920479,1264920851,2,27,372
38102706@N05,3438,17,1264920851,1264921339,2,27,488
38102706@N05,3438,2,1264921339,1264921429,5,27,90
38102706@N05,3438,7,1264922991,1264923081,2,27,90
38102706@N05,3438,6,1264923706,1264923767,2,27,61
38102706@N05,3438,2,1264923767,1264923857,3,27,90
38102706@N05,3438,1,1264923934,1264924534,7,27,600
38102706@N05,3438,2,1264925143,1264925233,3,27,90
38102706@N05,3438,18,1264925331,1264927131,2,27,1800
38102706@N05,3438,27,1264931835,1264933035,2,27,1200
38102706@N05,3439,27,1266011327,1266012527,12,7,1200
38102706@N05,3439,24,1266014399,1266014879,2,7,480
38102706@N05,3439,21,1266015254,1266015704,2,7,450
38102706@N05,3439,26,1266015743,1266015923,3,7,180
38102706@N05,3439,18,1266016869,1266017215,2,7,346
38102706@N05,3439,17,1266017215,1266018266,12,7,1051
38102706@N05,3439,14,1266018266,1266018386,2,7,120
38102706@N05,3440,2,1266065237,1266065327,1,1,90
38102706@N05,3441,25,1266648022,1266648772,1,1,750
38102706@N05,3442,27,1266730022,1266731222,4,1,1200
38102706@N05,3443,27,1267242066,1267242949,4,6,883
38102706@N05,3443,25,1267242949,1267243105,2,6,156
38102706@N05,3443,23,1267243105,1267243195,2,6,90
38102706@N05,3443,26,1267260157,1267260337,2,6,180
38102706@N05,3443,3,1267263967,1267264237,2,6,270
38102706@N05,3443,2,1267265123,1267265213,1,6,90
38102706@N05,3444,7,1267331703,1267331793,2,7,90
38102706@N05,3444,2,1267332392,1267332482,5,7,90
38102706@N05,3444,20,1267334185,1267334682,2,7,497
38102706@N05,3444,22,1267334682,1267335282,2,7,600
38102706@N05,3444,8,1267337349,1267337469,3,7,120
38102706@N05,3444,18,1267341580,1267343380,6,7,1800
38102706@N05,3444,27,1267343774,1267344974,1,7,1200
38102706@N05,3445,27,1268192233,1268193433,5,8,1200
38102706@N05,3445,5,1268196384,1268197104,2,8,720
38102706@N05,3445,17,1268198450,1268198597,2,8,147
38102706@N05,3445,26,1268198597,1268198777,2,8,180
38102706@N05,3445,18,1268198805,1268199263,2,8,458
38102706@N05,3445,26,1268199263,1268199443,2,8,180
38102706@N05,3445,18,1268199902,1268201702,7,8,1800
38102706@N05,3445,2,1268204528,1268204618,1,8,90
38102706@N05,3446,14,1271071711,1271071831,4,1,120
38102706@N05,3447,27,1274759852,1274761052,3,5,1200
38102706@N05,3447,17,1274763640,1274765020,2,5,1380
38102706@N05,3447,18,1274765786,1274767586,2,5,1800
38102706@N05,3447,14,1274771718,1274771838,5,5,120
38102706@N05,3447,27,1274773183,1274774383,1,5,1200
38102706@N05,3448,17,1275573600,1275574980,2,1,1380
38102706@N05,3449,17,1275632851,1275634231,5,7,1380
38102706@N05,3449,18,1275637424,1275639224,2,7,1800
38102706@N05,3449,5,1275639716,1275640436,2,7,720
38102706@N05,3449,26,1275641971,1275642151,2,7,180
38102706@N05,3449,27,1275643210,1275644410,2,7,1200
38102706@N05,3449,17,1275650519,1275651899,4,7,1380
38102706@N05,3449,18,1275660000,1275661800,1,7,1800
38102706@N05,3450,24,1275712742,1275712747,2,5,5
38102706@N05,3450,18,1275712747,1275714547,28,5,1800
38102706@N05,3450,16,1275718001,1275718721,3,5,720
38102706@N05,3450,27,1275720272,1275721472,2,5,1200
38102706@N05,3450,17,1275736265,1275737645,33,5,1380
38102706@N05,3451,27,1277557537,1277558737,6,1,1200
38102706@N05,3452,21,1277709937,1277710387,6,5,450
38102706@N05,3452,18,1277713684,1277713832,4,5,148
38102706@N05,3452,14,1277713832,1277713841,2,5,9
38102706@N05,3452,16,1277713841,1277714561,2,5,720
38102706@N05,3452,17,1277719259,1277720639,1,5,1380
38102706@N05,3453,18,1286430393,1286432120,9,2,1727
38102706@N05,3453,2,1286432120,1286432210,1,2,90
38102706@N05,3454,7,1286948104,1286948194,2,2,90
38102706@N05,3454,27,1286950301,1286951501,2,2,1200
38102706@N05,3455,27,1291085815,1291087015,4,4,1200
38102706@N05,3455,17,1291089137,1291089728,2,4,591
38102706@N05,3455,18,1291089728,1291091138,2,4,1410
38102706@N05,3455,27,1291091138,1291092338,2,4,1200
38102706@N05,3456,16,1298457804,1298458524,2,1,720
38102706@N05,3457,17,1299320184,1299321564,1,1,1380
38102706@N05,3458,9,1299482273,1299482513,2,4,240
38102706@N05,3458,17,1299482931,1299483519,2,4,588
38102706@N05,3458,22,1299483519,1299484119,3,4,600
38102706@N05,3458,27,1299484131,1299485331,2,4,1200
38102706@N05,3459,27,1299726189,1299727256,2,4,1067
38102706@N05,3459,14,1299727256,1299727376,3,4,120
38102706@N05,3459,9,1299727674,1299727914,2,4,240
38102706@N05,3459,14,1299728189,1299728309,3,4,120
38102706@N05,3460,16,1306664728,1306665448,1,1,720
38102706@N05,3461,2,1309698846,1309698936,1,1,90
38102706@N05,3462,1,1320912066,1320912666,3,2,600
38102706@N05,3462,13,1320914463,1320915063,1,2,600
38102706@N05,3463,14,1325367677,1325367797,1,1,120
38102706@N05,3464,4,1326264373,1326265273,1,1,900
38102706@N05,3465,1,1328361447,1328362047,1,1,600
38102706@N05,3466,21,1331731320,1331731770,3,3,450
38102706@N05,3466,1,1331731908,1331732178,2,3,270
38102706@N05,3466,14,1331732178,1331732298,1,3,120
38102706@N05,3467,8,1332681475,1332681595,1,1,120
38102706@N05,3468,27,1335345293,1335345459,3,11,166
38102706@N05,3468,25,1335345459,1335345828,2,11,369
38102706@N05,3468,26,1335345828,1335345837,2,11,9
38102706@N05,3468,21,1335345837,1335346221,2,11,384
38102706@N05,3468,15,1335346221,1335346401,2,11,180
38102706@N05,3468,18,1335346506,1335346870,5,11,364
38102706@N05,3468,25,1335346870,1335347620,2,11,750
38102706@N05,3468,15,1335347661,1335347684,2,11,23
38102706@N05,3468,9,1335347684,1335347924,4,11,240
38102706@N05,3468,25,1335351160,1335351910,2,11,750
38102706@N05,3468,27,1335358134,1335359334,1,11,1200
38102706@N05,3469,4,1335692851,1335693751,2,3,900
38102706@N05,3469,26,1335696601,1335696781,2,3,180
38102706@N05,3469,23,1335697202,1335697292,2,3,90
38102706@N05,3470,27,1338619401,1338619815,2,6,414
38102706@N05,3470,9,1338619815,1338619934,2,6,119
38102706@N05,3470,14,1338619934,1338620054,5,6,120
38102706@N05,3470,22,1338621881,1338622481,3,6,600
38102706@N05,3470,14,1338627264,1338627384,4,6,120
38102706@N05,3470,27,1338629243,1338630443,2,6,1200
38102706@N05,3471,15,1343284816,1343284881,2,10,65
38102706@N05,3471,14,1343284881,1343284987,4,10,106
38102706@N05,3471,9,1343284987,1343285117,4,10,130
38102706@N05,3471,7,1343285117,1343285207,3,10,90
38102706@N05,3471,8,1343285210,1343285294,7,10,84
38102706@N05,3471,11,1343285294,1343285344,6,10,50
38102706@N05,3471,8,1343285344,1343285464,4,10,120
38102706@N05,3471,9,1343285547,1343285597,2,10,50
38102706@N05,3471,6,1343285597,1343285742,2,10,145
38102706@N05,3471,5,1343285742,1343286462,1,10,720
38102706@N05,3472,9,1344854629,1344854869,2,2,240
38102706@N05,3472,13,1344855232,1344855832,1,2,600
38102706@N05,3473,26,1345014197,1345014280,2,9,83
38102706@N05,3473,17,1345014280,1345014742,5,9,462
38102706@N05,3473,9,1345014742,1345014950,2,9,208
38102706@N05,3473,2,1345014950,1345014973,2,9,23
38102706@N05,3473,1,1345014973,1345015219,2,9,246
38102706@N05,3473,2,1345015219,1345015309,4,9,90
38102706@N05,3473,3,1345015690,1345015960,3,9,270
38102706@N05,3473,4,1345015988,1345016888,2,9,900
38102706@N05,3473,27,1345016930,1345018130,1,9,1200
38102706@N05,3474,2,1345894240,1345894330,1,1,90
38102706@N05,3475,1,1346215647,1346216247,1,1,600
38102706@N05,3476,27,1352272907,1352274107,2,3,1200
38102706@N05,3476,22,1352276430,1352277030,2,3,600
38102706@N05,3476,16,1352277867,1352278587,1,3,720
38102706@N05,3477,10,1352886160,1352886580,1,1,420
38102706@N05,3478,27,1358580617,1358581817,1,1,1200
38102706@N05,3479,3,1362381460,1362381730,2,3,270
38102706@N05,3479,2,1362382026,1362382116,2,3,90
38102706@N05,3479,13,1362389485,1362390085,1,3,600
38102706@N05,3480,24,1367805831,1367806170,2,5,339
38102706@N05,3480,22,1367806170,1367806418,2,5,248
38102706@N05,3480,17,1367806418,1367807798,2,5,1380
38102706@N05,3480,1,1367808156,1367808756,2,5,600
38102706@N05,3480,27,1367810035,1367811235,1,5,1200
38102706@N05,3481,27,1372043255,1372044455,1,1,1200
38102706@N05,3482,27,1383087106,1383088306,2,2,1200
38102706@N05,3482,11,1383089017,1383089197,4,2,180
38102706@N05,3483,1,1391068549,1391069149,1,1,600
38102706@N05,3484,16,1393591050,1393591770,1,1,720
38102706@N05,3485,27,1395716192,1395717392,37,1,1200
38102706@N05,3486,13,1396949213,1396949813,1,1,600
38102706@N05,3487,14,1402143119,1402143239,1,1,120
38102706@N05,3488,3,1402379507,1402379777,1,1,270
38102706@N05,3489,27,1424763298,1424764498,1,1,1200
38102706@N05,3490,14,1426415265,1426415385,1,1,120
38102706@N05,3491,25,1426559525,1426560275,1,1,750
38102706@N05,3492,2,1429439661,1429439751,2,2,90
38102706@N05,3492,13,1429441527,1429442127,1,2,600
38189211@N05,3493,27,1400109681,1400110881,2,1,1200
38189211@N05,3494,19,1400210124,1400210544,2,2,420
38189211@N05,3494,4,1400238851,1400239751,1,2,900
38189526@N02,3495,27,1241013600,1241013602,2,2,2
38189526@N02,3495,23,1241013602,1241013692,1,2,90
38194020@N00,3496,20,1219724148,1219725228,4,1,1080
38235069@N00,3497,27,1450600690,1450601890,2,1,1200
38235069@N00,3498,8,1450664378,1450664498,4,7,120
38235069@N00,3498,20,1450668583,1450669663,3,7,1080
38235069@N00,3498,22,1450669815,1450670415,19,7,600
38235069@N00,3498,19,1450671720,1450672140,15,7,420
38235069@N00,3498,23,1450679227,1450679317,9,7,90
38235069@N00,3498,26,1450679858,1450679865,2,7,7
38235069@N00,3498,25,1450679865,1450680615,20,7,750
38235069@N00,3499,14,1450774867,1450774987,7,1,120
38235069@N00,3500,17,1451888717,1451889058,4,2,341
38235069@N00,3500,16,1451889058,1451889778,1,2,720
38251487@N03,3501,10,1388033092,1388033512,2,2,420
38251487@N03,3501,14,1388037262,1388037382,1,2,120
38255616@N06,3502,16,1349108630,1349109350,1,1,720
38257984@N04,3503,13,1337045442,1337046042,1,1,600
38278420@N00,3504,14,1342708383,1342708503,1,1,120
38332815@N00,3505,27,1263253951,1263255151,2,2,1200
38332815@N00,3505,19,1263272517,1263272937,2,2,420
38376245@N00,3506,3,1338424228,1338424498,2,2,270
38376245@N00,3506,27,1338436428,1338437628,1,2,1200
38376245@N04,3507,17,1356990732,1356992112,1,1,1380
38376245@N04,3508,15,1357532373,1357532553,1,1,180
38376245@N04,3509,4,1369557759,1369558659,1,1,900
38421387@N04,3510,14,1397186946,1397187066,2,3,120
38421387@N04,3510,16,1397198031,1397198751,3,3,720
38421387@N04,3510,9,1397202152,1397202392,1,3,240
38443862@N04,3511,16,1236502914,1236503634,1,1,720
38484710@N00,3512,27,1204781421,1204781600,2,3,179
38484710@N00,3512,17,1204781600,1204782980,2,3,1380
38484710@N00,3512,20,1204783798,1204784878,1,3,1080
38484710@N00,3513,16,1204859970,1204860690,2,7,720
38484710@N00,3513,18,1204866182,1204867982,4,7,1800
38484710@N00,3513,20,1204868019,1204869099,2,7,1080
38484710@N00,3513,1,1204870961,1204871561,2,7,600
38484710@N00,3513,3,1204871797,1204872067,2,7,270
38484710@N00,3513,4,1204872390,1204872625,4,7,235
38484710@N00,3513,5,1204872625,1204873345,1,7,720
38492497@N02,3514,21,1395442289,1395442739,1,1,450
38505413@N06,3515,27,1322372156,1322373356,1,1,1200
38505413@N06,3516,14,1322570356,1322570476,1,1,120
38505413@N06,3517,4,1323844497,1323845397,1,1,900
38564190@N00,3518,27,1427272250,1427273450,1,1,1200
38604142@N08,3519,4,1317866468,1317867368,1,1,900
38604142@N08,3520,4,1339644865,1339645765,1,1,900
38705054@N07,3521,27,1251356414,1251357614,1,1,1200
38719482@N03,3522,17,1417644341,1417645721,1,1,1380
38773853@N06,3523,22,1342961676,1342962276,1,1,600
38789043@N02,3524,7,1347071421,1347071511,2,5,90
38789043@N02,3524,8,1347071831,1347071834,2,5,3
38789043@N02,3524,7,1347071834,1347071924,2,5,90
38789043@N02,3524,24,1347083235,1347083248,2,5,13
38789043@N02,3524,19,1347083248,1347083668,2,5,420
38789043@N02,3525,17,1354420702,1354422082,1,1,1380
38789043@N02,3526,20,1368918996,1368919422,19,11,426
38789043@N02,3526,18,1368919422,1368919428,6,11,6
38789043@N02,3526,20,1368919428,1368920245,2,11,817
38789043@N02,3526,19,1368920245,1368920665,32,11,420
38789043@N02,3526,20,1368922509,1368923589,7,11,1080
38789043@N02,3526,21,1368930543,1368930993,5,11,450
38789043@N02,3526,17,1368932205,1368933585,3,11,1380
38789043@N02,3526,26,1368936779,1368936810,2,11,31
38789043@N02,3526,17,1368936810,1368938190,3,11,1380
38789043@N02,3526,3,1368941281,1368941551,3,11,270
38789043@N02,3526,6,1368943239,1368943494,5,11,255
38794272@N04,3527,27,1321263222,1321264422,24,1,1200
38848642@N00,3528,17,1218192164,1218193544,8,1,1380
38848642@N00,3529,27,1255742722,1255742985,5,5,263
38848642@N00,3529,14,1255742985,1255743105,7,5,120
38848642@N00,3529,27,1255749175,1255750375,10,5,1200
38848642@N00,3529,4,1255761983,1255762883,2,5,900
38848642@N00,3529,27,1255763353,1255764553,2,5,1200
38848642@N00,3530,14,1256442279,1256442399,8,1,120
38848642@N00,3531,26,1275464213,1275464393,2,2,180
38848642@N00,3531,22,1275469409,1275470009,1,2,600
38848642@N00,3532,20,1281339136,1281340216,1,1,1080
38848642@N00,3533,27,1408409969,1408411169,1,1,1200
38879474@N04,3534,19,1259359179,1259359599,1,1,420
38879474@N04,3535,13,1318064280,1318064880,2,2,600
38879474@N04,3535,24,1318067953,1318068433,1,2,480
38879474@N04,3536,4,1351215096,1351215996,1,1,900
39015228@N04,3537,19,1432735200,1432735620,1,1,420
39024895@N00,3538,20,1309416775,1309416897,6,7,122
39024895@N00,3538,22,1309416897,1309417497,9,7,600
39024895@N00,3538,15,1309419212,1309419342,13,7,130
39024895@N00,3538,16,1309419342,1309419526,5,7,184
39024895@N00,3538,14,1309419526,1309419646,4,7,120
39024895@N00,3538,5,1309420019,1309420077,4,7,58
39024895@N00,3538,4,1309420077,1309420977,11,7,900
39024895@N00,3539,16,1309503136,1309503363,6,3,227
39024895@N00,3539,17,1309503363,1309503457,3,3,94
39024895@N00,3539,18,1309503457,1309505257,4,3,1800
39024895@N00,3540,25,1309555459,1309556209,16,1,750
39052554@N00,3541,26,1396749784,1396749964,1,1,180
39073297@N04,3542,18,1426278618,1426280418,1,1,1800
39078602@N04,3543,14,1464566891,1464567011,1,1,120
39078602@N04,3544,14,1464596760,1464596880,2,2,120
39078602@N04,3544,25,1464599371,1464600121,6,2,750
39104390@N07,3545,22,1285308949,1285309549,2,1,600
39134511@N06,3546,27,1302231780,1302232980,2,2,1200
39134511@N06,3546,4,1302236493,1302237393,1,2,900
39146060@N00,3547,27,1188080542,1188081742,2,10,1200
39146060@N00,3547,16,1188082524,1188083244,5,10,720
39146060@N00,3547,13,1188086044,1188086644,2,10,600
39146060@N00,3547,19,1188087666,1188088086,7,10,420
39146060@N00,3547,22,1188090762,1188091362,2,10,600
39146060@N00,3547,17,1188092678,1188094058,3,10,1380
39146060@N00,3547,1,1188098694,1188099294,2,10,600
39146060@N00,3547,2,1188100267,1188100357,3,10,90
39146060@N00,3547,23,1188101772,1188101862,3,10,90
39146060@N00,3547,21,1188101952,1188102402,2,10,450
39146060@N00,3548,27,1190325530,1190326678,8,10,1148
39146060@N00,3548,13,1190326678,1190327278,3,10,600
39146060@N00,3548,18,1190328696,1190329282,3,10,586
39146060@N00,3548,19,1190329282,1190329702,3,10,420
39146060@N00,3548,20,1190330706,1190331786,2,10,1080
39146060@N00,3548,23,1190333420,1190333510,3,10,90
39146060@N00,3548,26,1190335062,1190335242,4,10,180
39146060@N00,3548,15,1190335414,1190335594,2,10,180
39146060@N00,3548,4,1190342114,1190342844,4,10,730
39146060@N00,3548,27,1190342844,1190344044,1,10,1200
39146060@N00,3549,1,1190540474,1190540500,2,2,26
39146060@N00,3549,3,1190540500,1190540770,1,2,270
39146060@N00,3550,27,1190684076,1190685140,4,10,1064
39146060@N00,3550,16,1190685140,1190685860,4,10,720
39146060@N00,3550,18,1190686794,1190688594,2,10,1800
39146060@N00,3550,19,1190688938,1190689358,4,10,420
39146060@N00,3550,22,1190691082,1190691682,2,10,600
39146060@N00,3550,18,1190693284,1190695084,2,10,1800
39146060@N00,3550,15,1190695104,1190695200,3,10,96
39146060@N00,3550,14,1190695200,1190695320,2,10,120
39146060@N00,3550,16,1190698838,1190698990,2,10,152
39146060@N00,3550,27,1190698990,1190700190,1,10,1200
39146060@N00,3551,27,1190939118,1190939910,2,7,792
39146060@N00,3551,17,1190939910,1190941290,3,7,1380
39146060@N00,3551,13,1190942008,1190942398,2,7,390
39146060@N00,3551,17,1190942398,1190942514,2,7,116
39146060@N00,3551,18,1190942514,1190942532,2,7,18
39146060@N00,3551,19,1190942532,1190942952,4,7,420
39146060@N00,3551,27,1190951498,1190952698,3,7,1200
39146060@N00,3552,27,1191133998,1191134588,3,10,590
39146060@N00,3552,17,1191134588,1191135832,2,10,1244
39146060@N00,3552,13,1191135832,1191136432,4,10,600
39146060@N00,3552,18,1191136554,1191136716,2,10,162
39146060@N00,3552,13,1191136716,1191136814,2,10,98
39146060@N00,3552,18,1191136814,1191136946,2,10,132
39146060@N00,3552,13,1191136946,1191137546,4,10,600
39146060@N00,3552,16,1191141958,1191142678,3,10,720
39146060@N00,3552,17,1191146524,1191147904,2,10,1380
39146060@N00,3552,27,1191150498,1191151698,1,10,1200
39146060@N00,3553,27,1192266366,1192266389,2,7,23
39146060@N00,3553,26,1192266389,1192266418,2,7,29
39146060@N00,3553,13,1192266418,1192266429,2,7,11
39146060@N00,3553,27,1192266429,1192266486,4,7,57
39146060@N00,3553,13,1192266486,1192266499,4,7,13
39146060@N00,3553,2,1192266499,1192266505,3,7,6
39146060@N00,3553,1,1192266505,1192267105,6,7,600
39146060@N00,3554,27,1223111957,1223111964,2,13,7
39146060@N00,3554,9,1223111964,1223111966,2,13,2
39146060@N00,3554,20,1223111966,1223111968,2,13,2
39146060@N00,3554,26,1223111968,1223111970,2,13,2
39146060@N00,3554,18,1223111970,1223111972,2,13,2
39146060@N00,3554,13,1223111972,1223111974,2,13,2
39146060@N00,3554,4,1223111974,1223111975,2,13,1
39146060@N00,3554,3,1223111975,1223111978,3,13,3
39146060@N00,3554,2,1223111978,1223111981,3,13,3
39146060@N00,3554,1,1223111981,1223112581,5,13,600
39146060@N00,3554,27,1223126810,1223126816,2,13,6
39146060@N00,3554,14,1223126816,1223126820,2,13,4
39146060@N00,3554,4,1223126820,1223127720,1,13,900
39146060@N00,3555,27,1228809515,1228810715,6,5,1200
39146060@N00,3555,1,1228812342,1228812942,2,5,600
39146060@N00,3555,12,1228816621,1228816783,2,5,162
39146060@N00,3555,13,1228816783,1228817383,13,5,600
39146060@N00,3555,19,1228819271,1228819691,4,5,420
39146060@N00,3556,27,1229158330,1229159247,2,6,917
39146060@N00,3556,19,1229159247,1229159667,8,6,420
39146060@N00,3556,20,1229161078,1229162158,2,6,1080
39146060@N00,3556,24,1229164053,1229164533,5,6,480
39146060@N00,3556,23,1229164724,1229164814,2,6,90
39146060@N00,3556,3,1229174044,1229174314,6,6,270
39146060@N00,3557,5,1229287805,1229288525,2,3,720
39146060@N00,3557,1,1229289430,1229290030,3,3,600
39146060@N00,3557,16,1229290144,1229290864,1,3,720
39146060@N00,3558,17,1255520142,1255521522,4,1,1380
39146060@N00,3559,17,1255565368,1255566748,6,1,1380
39146060@N00,3560,27,1262092390,1262092398,2,8,8
39146060@N00,3560,19,1262092398,1262092404,2,8,6
39146060@N00,3560,20,1262092404,1262092422,2,8,18
39146060@N00,3560,26,1262092422,1262092424,2,8,2
39146060@N00,3560,4,1262092424,1262092449,2,8,25
39146060@N00,3560,16,1262092449,1262092455,2,8,6
39146060@N00,3560,13,1262092455,1262092460,2,8,5
39146060@N00,3560,17,1262092460,1262093840,1,8,1380
39146060@N00,3561,13,1311248884,1311249484,1,1,600
39146060@N00,3562,18,1311552475,1311554275,2,3,1800
39146060@N00,3562,13,1311562808,1311563288,2,3,480
39146060@N00,3562,17,1311563288,1311564668,1,3,1380
39156069@N03,3563,6,1451356340,1451356595,2,5,255
39156069@N03,3563,7,1451358383,1451358473,5,5,90
39156069@N03,3563,8,1451361199,1451361319,2,5,120
39156069@N03,3563,15,1451364039,1451364219,5,5,180
39156069@N03,3563,9,1451375738,1451375978,1,5,240
39156069@N03,3564,27,1451467302,1451468031,2,2,729
39156069@N03,3564,17,1451468031,1451469411,1,2,1380
39179826@N04,3565,4,1255433153,1255434053,2,3,900
39179826@N04,3565,15,1255434468,1255434648,2,3,180
39179826@N04,3565,27,1255436329,1255437529,1,3,1200
39179826@N04,3566,18,1255472004,1255473804,3,2,1800
39179826@N04,3566,17,1255481336,1255482716,1,2,1380
39179826@N04,3567,16,1258343042,1258343762,1,1,720
39179826@N04,3568,14,1259707893,1259708013,1,1,120
39179826@N04,3569,13,1265155757,1265156357,1,1,600
39179826@N04,3570,21,1302588747,1302589197,1,1,450
39179826@N04,3571,14,1350757236,1350757356,1,1,120
39179826@N04,3572,13,1413839661,1413840261,1,1,600
39179826@N04,3573,16,1413951490,1413952210,1,1,720
39179826@N04,3574,2,1416986406,1416986496,1,1,90
39179826@N04,3575,13,1419408235,1419408835,1,1,600
39188842@N06,3576,11,1244276300,1244276315,2,2,15
39188842@N06,3576,16,1244276315,1244277035,1,2,720
39198272@N04,3577,3,1400370350,1400370620,2,2,270
39198272@N04,3577,8,1400384094,1400384214,1,2,120
39285097@N02,3578,27,1414711535,1414712735,2,3,1200
39285097@N02,3578,22,1414714100,1414714700,2,3,600
39285097@N02,3578,27,1414727022,1414728222,8,3,1200
39312075@N06,3579,15,1279892257,1279892437,1,1,180
39312075@N06,3580,27,1319193139,1319194339,1,1,1200
39333522@N03,3581,25,1355002557,1355003307,1,1,750
39360988@N05,3582,14,1274088517,1274088637,1,1,120
39360988@N05,3583,27,1300274199,1300275399,1,1,1200
39360988@N05,3584,16,1300307928,1300308648,2,3,720
39360988@N05,3584,27,1300309188,1300310028,2,3,840
39360988@N05,3584,16,1300310028,1300310748,1,3,720
39360988@N05,3585,21,1300435755,1300436205,1,1,450
39360988@N05,3586,27,1322772356,1322773556,1,1,1200
39360988@N05,3587,15,1354401242,1354401422,1,1,180
39364877@N05,3588,1,1264982338,1264982938,1,1,600
39364877@N05,3589,27,1391064559,1391065759,1,1,1200
39403274@N00,3590,4,1255471880,1255472780,2,1,900
39403274@N00,3591,27,1255780018,1255781218,1,1,1200
39404976@N03,3592,23,1320533604,1320533694,1,1,90
39414936@N05,3593,27,1267157371,1267158571,1,1,1200
39444366@N06,3594,27,1262134787,1262134800,2,2,13
39444366@N06,3594,9,1262134800,1262135040,1,2,240
39444366@N06,3595,27,1316864142,1316865342,1,1,1200
39444366@N06,3596,13,1329132068,1329132668,1,1,600
39444366@N06,3597,27,1330500918,1330502118,1,1,1200
39444366@N06,3598,9,1334374049,1334374054,2,2,5
39444366@N06,3598,15,1334374054,1334374234,1,2,180
39444366@N06,3599,10,1358037820,1358038240,1,1,420
39454436@N00,3600,16,1330888686,1330888804,2,3,118
39454436@N00,3600,15,1330888804,1330888947,2,3,143
39454436@N00,3600,6,1330888947,1330889202,1,3,255
39478938@N03,3601,5,1231379245,1231379275,2,2,30
39478938@N03,3601,2,1231379275,1231379365,1,2,90
39487324@N08,3602,18,1335222664,1335224464,1,1,1800
39487324@N08,3603,16,1335260796,1335261516,1,1,720
39490385@N08,3604,24,1371507250,1371507730,2,2,480
39490385@N08,3604,1,1371530069,1371530669,1,2,600
39491066@N02,3605,27,1396836162,1396837362,1,1,1200
39527581@N07,3606,21,1194555823,1194556273,2,1,450
39530849@N02,3607,10,1246640784,1246641204,1,1,420
39607403@N04,3608,16,1195782738,1195783458,1,1,720
39648663@N07,3609,16,1326238520,1326239240,1,1,720
39707801@N00,3610,14,1195272369,1195272489,8,4,120
39707801@N00,3610,16,1195278421,1195278988,2,4,567
39707801@N00,3610,14,1195278988,1195279108,4,4,120
39707801@N00,3610,13,1195285008,1195285608,2,4,600
39707801@N00,3611,22,1195341023,1195341623,5,1,600
39707801@N00,3612,27,1195438194,1195439394,9,1,1200
39707801@N00,3613,14,1196299249,1196299369,2,3,120
39707801@N00,3613,13,1196305574,1196306174,2,3,600
39707801@N00,3613,27,1196306961,1196308161,1,3,1200
39769363@N06,3614,12,1296699908,1296700748,1,1,840
39864275@N02,3615,4,1417517040,1417517940,5,2,900
39864275@N02,3615,27,1417519330,1417520530,1,2,1200
39893757@N00,3616,16,1314957158,1314957878,1,1,720
39893757@N00,3617,3,1409720302,1409720437,2,3,135
39893757@N00,3617,27,1409720437,1409720446,2,3,9
39893757@N00,3617,14,1409720446,1409720566,1,3,120
39894601@N00,3618,25,1198889310,1198890060,4,1,750
39894601@N00,3619,27,1199152540,1199153541,2,2,1001
39894601@N00,3619,21,1199153541,1199153991,5,2,450
39909510@N07,3620,9,1232935672,1232935677,3,2,5
39909510@N07,3620,2,1232935677,1232935767,2,2,90
39909510@N07,3621,9,1233282101,1233282138,7,2,37
39909510@N07,3621,14,1233282138,1233282258,2,2,120
39925495@N00,3622,22,1260841543,1260842143,1,1,600
39925495@N00,3623,23,1260916640,1260916730,1,1,90
39925495@N00,3624,3,1356958800,1356959070,1,1,270
39953677@N06,3625,24,1348397506,1348397986,2,3,480
39953677@N06,3625,2,1348399876,1348399966,2,3,90
39953677@N06,3625,6,1348404790,1348405045,1,3,255
40021579@N00,3626,3,1375510887,1375511157,1,1,270
40041746@N00,3627,18,1382055637,1382057437,11,1,1800
40048950@N04,3628,19,1338106832,1338107252,1,1,420
40048950@N04,3629,27,1367894630,1367895830,1,1,1200
40065817@N02,3630,27,1412311858,1412313058,1,1,1200
40067478@N00,3631,7,1376638278,1376638368,1,1,90
40072693@N04,3632,27,1293227191,1293228391,2,4,1200
40072693@N04,3632,4,1293228417,1293228436,2,4,19
40072693@N04,3632,5,1293228436,1293229156,2,4,720
40072693@N04,3632,1,1293231763,1293232363,1,4,600
40081977@N06,3633,27,1373503385,1373504585,15,3,1200
40081977@N06,3633,11,1373553308,1373553487,2,3,179
40081977@N06,3633,15,1373553487,1373553667,1,3,180
40081977@N06,3634,10,1373642889,1373643309,1,1,420
40089707@N00,3635,27,1219801673,1219802873,5,2,1200
40089707@N00,3635,26,1219817403,1219817583,2,2,180
40165694@N03,3636,22,1360159311,1360159911,1,1,600
40170821@N06,3637,16,1188442313,1188443033,1,1,720
40170821@N06,3638,9,1249513134,1249513374,1,1,240
40170821@N06,3639,27,1345799420,1345800620,2,3,1200
40170821@N06,3639,21,1345802580,1345803030,2,3,450
40170821@N06,3639,27,1345814397,1345815597,1,3,1200
40170821@N06,3640,20,1408698000,1408698803,2,2,803
40170821@N06,3640,22,1408698803,1408699403,1,2,600
40172365@N00,3641,26,1337820910,1337821090,1,1,180
40209760@N07,3642,16,1190806946,1190807666,1,1,720
40262057@N06,3643,27,1236725265,1236726378,3,17,1113
40262057@N06,3643,1,1236726378,1236726978,4,17,600
40262057@N06,3643,16,1236727073,1236727338,3,17,265
40262057@N06,3643,13,1236727338,1236727938,10,17,600
40262057@N06,3643,22,1236728609,1236728849,2,17,240
40262057@N06,3643,21,1236728849,1236729299,5,17,450
40262057@N06,3643,22,1236732872,1236733472,15,17,600
40262057@N06,3643,2,1236736455,1236736545,6,17,90
40262057@N06,3643,6,1236738585,1236738603,2,17,18
40262057@N06,3643,2,1236738603,1236738693,4,17,90
40262057@N06,3643,1,1236738926,1236739107,2,17,181
40262057@N06,3643,3,1236739107,1236739366,2,17,259
40262057@N06,3643,1,1236739366,1236739966,2,17,600
40262057@N06,3643,16,1236743000,1236743007,2,17,7
40262057@N06,3643,9,1236743007,1236743247,2,17,240
40262057@N06,3643,12,1236743788,1236744628,2,17,840
40262057@N06,3643,16,1236745090,1236745810,2,17,720
40262057@N06,3644,25,1236808398,1236809148,2,6,750
40262057@N06,3644,14,1236812697,1236812751,2,6,54
40262057@N06,3644,16,1236812751,1236813471,2,6,720
40262057@N06,3644,6,1236814286,1236814541,3,6,255
40262057@N06,3644,1,1236814627,1236815227,2,6,600
40262057@N06,3644,20,1236815616,1236816696,1,6,1080
40262057@N06,3645,20,1236901764,1236902844,4,5,1080
40262057@N06,3645,13,1236905477,1236906077,4,5,600
40262057@N06,3645,16,1236913449,1236914048,15,5,599
40262057@N06,3645,14,1236914048,1236914113,2,5,65
40262057@N06,3645,16,1236914113,1236914833,2,5,720
40262057@N06,3646,16,1354955893,1354956613,9,1,720
40262057@N06,3647,16,1355049601,1355050321,13,1,720
40262057@N06,3648,17,1355097900,1355099280,3,2,1380
40262057@N06,3648,13,1355101587,1355102187,2,2,600
40279984@N00,3649,2,1395782231,1395782275,2,21,44
40279984@N00,3649,4,1395782275,1395782341,2,21,66
40279984@N00,3649,6,1395782341,1395782596,2,21,255
40279984@N00,3649,1,1395782709,1395782764,2,21,55
40279984@N00,3649,2,1395782764,1395782828,2,21,64
40279984@N00,3649,3,1395782828,1395783098,2,21,270
40279984@N00,3649,2,1395784742,1395784832,3,21,90
40279984@N00,3649,4,1395784848,1395785748,2,21,900
40279984@N00,3649,17,1395789869,1395791249,6,21,1380
40279984@N00,3649,14,1395792064,1395792184,3,21,120
40279984@N00,3649,4,1395800577,1395801477,2,21,900
40279984@N00,3649,15,1395802190,1395802370,3,21,180
40279984@N00,3649,14,1395802709,1395802829,2,21,120
40279984@N00,3649,15,1395804525,1395804705,2,21,180
40279984@N00,3649,18,1395804722,1395806056,2,21,1334
40279984@N00,3649,26,1395806056,1395806236,2,21,180
40279984@N00,3649,17,1395806411,1395807791,4,21,1380
40279984@N00,3649,16,1395807965,1395808117,2,21,152
40279984@N00,3649,14,1395808117,1395808237,2,21,120
40279984@N00,3649,17,1395814428,1395815808,2,21,1380
40279984@N00,3649,9,1395818389,1395818629,1,21,240
40282793@N05,3650,27,1296175170,1296176370,1,1,1200
40291653@N08,3651,16,1292495751,1292496471,1,1,720
40291653@N08,3652,27,1298767420,1298768620,1,1,1200
40291653@N08,3653,1,1331510590,1331511190,1,1,600
40303166@N06,3654,22,1288071983,1288072583,2,3,600
40303166@N06,3654,13,1288074934,1288075534,2,3,600
40303166@N06,3654,4,1288092357,1288093257,1,3,900
40303166@N06,3655,27,1288591999,1288593199,7,14,1200
40303166@N06,3655,16,1288600291,1288601011,11,14,720
40303166@N06,3655,4,1288601559,1288602459,2,14,900
40303166@N06,3655,1,1288602764,1288603364,2,14,600
40303166@N06,3655,9,1288604082,1288604275,2,14,193
40303166@N06,3655,14,1288604275,1288604395,3,14,120
40303166@N06,3655,15,1288604847,1288605027,3,14,180
40303166@N06,3655,13,1288605145,1288605450,3,14,305
40303166@N06,3655,17,1288605450,1288606404,2,14,954
40303166@N06,3655,20,1288606404,1288607484,2,14,1080
40303166@N06,3655,21,1288608718,1288609168,2,14,450
40303166@N06,3655,25,1288609192,1288609691,2,14,499
40303166@N06,3655,17,1288609691,1288611040,2,14,1349
40303166@N06,3655,27,1288611040,1288612240,5,14,1200
40303166@N06,3656,27,1289207235,1289208135,2,6,900
40303166@N06,3656,16,1289208135,1289208855,13,6,720
40303166@N06,3656,17,1289210103,1289211483,6,6,1380
40303166@N06,3656,15,1289215333,1289215513,2,6,180
40303166@N06,3656,17,1289217504,1289218884,2,6,1380
40303166@N06,3656,27,1289219393,1289220593,4,6,1200
40303166@N06,3657,27,1289372721,1289373921,11,1,1200
40362134@N07,3658,27,1317424527,1317425727,4,9,1200
40362134@N07,3658,17,1317428680,1317430060,2,9,1380
40362134@N07,3658,18,1317430123,1317431333,2,9,1210
40362134@N07,3658,24,1317431333,1317431813,2,9,480
40362134@N07,3658,25,1317432641,1317432701,2,9,60
40362134@N07,3658,24,1317432701,1317433181,2,9,480
40362134@N07,3658,15,1317436988,1317437163,3,9,175
40362134@N07,3658,16,1317437163,1317437240,3,9,77
40362134@N07,3658,9,1317437240,1317437480,1,9,240
40362134@N07,3659,27,1403246305,1403247505,13,1,1200
40416743@N00,3660,16,1293448238,1293448958,1,1,720
40437944@N00,3661,27,1389383697,1389384897,2,1,1200
40437944@N00,3662,10,1389523415,1389523835,1,1,420
40472186@N08,3663,1,1261278329,1261278929,1,1,600
40472186@N08,3664,1,1261382471,1261383071,1,1,600
40472186@N08,3665,1,1261429635,1261430235,4,1,600
40482053@N07,3666,14,1269632556,1269632676,1,1,120
40482053@N07,3667,27,1363218545,1363219745,1,1,1200
40482053@N07,3668,27,1363248699,1363249899,1,1,1200
40531740@N08,3669,17,1371178207,1371179587,1,1,1380
40531740@N08,3670,5,1371297798,1371298306,2,2,508
40531740@N08,3670,4,1371298306,1371299206,1,2,900
40549771@N07,3671,16,1432565310,1432566030,1,1,720
40563308@N02,3672,15,1312577051,1312577231,1,1,180
40571088@N00,3673,27,1463705652,1463706852,11,18,1200
40571088@N00,3673,15,1463707318,1463707498,6,18,180
40571088@N00,3673,12,1463708272,1463709112,24,18,840
40571088@N00,3673,17,1463709756,1463711136,14,18,1380
40571088@N00,3673,13,1463712881,1463713481,9,18,600
40571088@N00,3673,1,1463717864,1463718245,3,18,381
40571088@N00,3673,17,1463718245,1463719625,5,18,1380
40571088@N00,3673,27,1463720921,1463722121,50,18,1200
40571088@N00,3673,23,1463738804,1463738894,4,18,90
40571088@N00,3673,26,1463739117,1463739185,2,18,68
40571088@N00,3673,20,1463739185,1463739221,2,18,36
40571088@N00,3673,26,1463739221,1463739253,2,18,32
40571088@N00,3673,20,1463739253,1463739356,2,18,103
40571088@N00,3673,26,1463739356,1463739456,2,18,100
40571088@N00,3673,20,1463739456,1463739515,2,18,59
40571088@N00,3673,26,1463739515,1463739695,3,18,180
40571088@N00,3673,20,1463739696,1463740776,4,18,1080
40571088@N00,3673,27,1463746963,1463748163,1,18,1200
40584328@N00,3674,19,1423359289,1423359709,1,1,420
40598203@N08,3675,1,1210697697,1210698297,2,1,600
40598203@N08,3676,15,1279931197,1279931377,1,1,180
40610681@N06,3677,1,1387166584,1387166781,2,7,197
40610681@N06,3677,8,1387166781,1387166832,2,7,51
40610681@N06,3677,4,1387166832,1387167732,2,7,900
40610681@N06,3677,14,1387169396,1387169516,2,7,120
40610681@N06,3677,20,1387171887,1387172967,2,7,1080
40610681@N06,3677,2,1387176984,1387177074,2,7,90
40610681@N06,3677,9,1387177941,1387178181,1,7,240
40616636@N08,3678,17,1340873533,1340874913,27,3,1380
40616636@N08,3678,27,1340881697,1340882897,10,3,1200
40616636@N08,3678,6,1340885008,1340885263,40,3,255
40646519@N00,3679,27,1227658887,1227659228,3,22,341
40646519@N00,3679,4,1227659228,1227660128,2,22,900
40646519@N00,3679,6,1227662270,1227662525,7,22,255
40646519@N00,3679,7,1227662851,1227662941,5,22,90
40646519@N00,3679,8,1227663027,1227663147,4,22,120
40646519@N00,3679,11,1227663279,1227663459,12,22,180
40646519@N00,3679,8,1227663549,1227663602,2,22,53
40646519@N00,3679,7,1227663602,1227663692,4,22,90
40646519@N00,3679,6,1227663959,1227664214,2,22,255
40646519@N00,3679,14,1227666276,1227666396,8,22,120
40646519@N00,3679,12,1227667606,1227668446,4,22,840
40646519@N00,3679,14,1227669349,1227669469,4,22,120
40646519@N00,3679,16,1227671003,1227671206,2,22,203
40646519@N00,3679,14,1227671206,1227671326,2,22,120
40646519@N00,3679,18,1227671971,1227672513,6,22,542
40646519@N00,3679,13,1227672513,1227673113,2,22,600
40646519@N00,3679,15,1227677426,1227677606,4,22,180
40646519@N00,3679,12,1227679130,1227679970,2,22,840
40646519@N00,3679,1,1227680364,1227680964,5,22,600
40646519@N00,3679,12,1227691076,1227691916,16,22,840
40646519@N00,3679,4,1227693487,1227694387,3,22,900
40646519@N00,3679,27,1227696167,1227697367,1,22,1200
40646519@N00,3680,27,1259450862,1259452018,9,9,1156
40646519@N00,3680,25,1259452018,1259452768,13,9,750
40646519@N00,3680,23,1259453178,1259453268,9,9,90
40646519@N00,3680,24,1259453663,1259454143,3,9,480
40646519@N00,3680,21,1259454554,1259455004,7,9,450
40646519@N00,3680,12,1259457375,1259458215,21,9,840
40646519@N00,3680,17,1259470209,1259470487,2,9,278
40646519@N00,3680,15,1259470487,1259470667,6,9,180
40646519@N00,3680,14,1259470797,1259470917,9,9,120
40646519@N00,3681,27,1320963113,1320963341,2,19,228
40646519@N00,3681,16,1320963341,1320963854,6,19,513
40646519@N00,3681,14,1320963854,1320963974,5,19,120
40646519@N00,3681,12,1320965539,1320966379,16,19,840
40646519@N00,3681,14,1320966615,1320966735,5,19,120
40646519@N00,3681,9,1320966968,1320967122,9,19,154
40646519@N00,3681,14,1320967122,1320967183,2,19,61
40646519@N00,3681,15,1320967183,1320967357,3,19,174
40646519@N00,3681,18,1320967357,1320967410,2,19,53
40646519@N00,3681,13,1320967410,1320968010,7,19,600
40646519@N00,3681,17,1320968655,1320968725,2,19,70
40646519@N00,3681,26,1320968725,1320968905,6,19,180
40646519@N00,3681,20,1320969349,1320969567,3,19,218
40646519@N00,3681,21,1320969567,1320970017,4,19,450
40646519@N00,3681,24,1320970860,1320971340,4,19,480
40646519@N00,3681,4,1320973546,1320973662,2,19,116
40646519@N00,3681,3,1320973662,1320973932,2,19,270
40646519@N00,3681,4,1320974178,1320974815,2,19,637
40646519@N00,3681,27,1320974815,1320976015,6,19,1200
40646519@N00,3682,27,1353014674,1353015289,4,50,615
40646519@N00,3682,16,1353015289,1353016009,37,50,720
40646519@N00,3682,14,1353019360,1353019360,2,50,0
40646519@N00,3682,16,1353019360,1353019483,3,50,123
40646519@N00,3682,14,1353019483,1353019595,2,50,112
40646519@N00,3682,15,1353019595,1353019741,3,50,146
40646519@N00,3682,12,1353019741,1353020581,15,50,840
40646519@N00,3682,16,1353020954,1353021674,2,50,720
40646519@N00,3682,9,1353022048,1353022171,6,50,123
40646519@N00,3682,14,1353022171,1353022291,3,50,120
40646519@N00,3682,9,1353022310,1353022314,2,50,4
40646519@N00,3682,14,1353022314,1353022409,2,50,95
40646519@N00,3682,10,1353022409,1353022829,27,50,420
40646519@N00,3682,14,1353023936,1353024056,3,50,120
40646519@N00,3682,15,1353024512,1353024692,3,50,180
40646519@N00,3682,17,1353024924,1353025121,4,50,197
40646519@N00,3682,13,1353025121,1353025721,2,50,600
40646519@N00,3682,14,1353026697,1353026817,6,50,120
40646519@N00,3682,26,1353027418,1353027598,2,50,180
40646519@N00,3682,22,1353028503,1353029103,2,50,600
40646519@N00,3682,21,1353033494,1353033944,7,50,450
40646519@N00,3682,4,1353035997,1353036368,4,50,371
40646519@N00,3682,2,1353036368,1353036458,5,50,90
40646519@N00,3682,17,1353036783,1353037383,2,50,600
40646519@N00,3682,16,1353037383,1353038103,3,50,720
40646519@N00,3682,3,1353040592,1353040862,6,50,270
40646519@N00,3682,6,1353040888,1353041143,7,50,255
40646519@N00,3682,1,1353041743,1353041874,4,50,131
40646519@N00,3682,6,1353041874,1353042129,8,50,255
40646519@N00,3682,2,1353042456,1353042546,10,50,90
40646519@N00,3682,5,1353043329,1353043391,2,50,62
40646519@N00,3682,6,1353043391,1353043607,2,50,216
40646519@N00,3682,1,1353043607,1353043661,2,50,54
40646519@N00,3682,3,1353043661,1353043879,2,50,218
40646519@N00,3682,2,1353043879,1353043969,10,50,90
40646519@N00,3682,5,1353045821,1353046070,2,50,249
40646519@N00,3682,7,1353046070,1353046160,7,50,90
40646519@N00,3682,11,1353046251,1353046391,4,50,140
40646519@N00,3682,8,1353046391,1353046511,6,50,120
40646519@N00,3682,11,1353046836,1353047016,7,50,180
40646519@N00,3682,7,1353047419,1353047419,2,50,0
40646519@N00,3682,8,1353047419,1353047539,2,50,120
40646519@N00,3682,9,1353047614,1353047854,6,50,240
40646519@N00,3682,10,1353047932,1353048241,3,50,309
40646519@N00,3682,9,1353048241,1353048481,3,50,240
40646519@N00,3682,14,1353049432,1353049552,2,50,120
40646519@N00,3682,10,1353056089,1353056509,2,50,420
40646519@N00,3682,14,1353056660,1353056780,9,50,120
40646519@N00,3682,9,1353057025,1353057265,5,50,240
40646519@N00,3682,27,1353057570,1353058770,8,50,1200
40646519@N00,3683,27,1416781537,1416782289,9,27,752
40646519@N00,3683,4,1416782289,1416783189,3,27,900
40646519@N00,3683,1,1416784824,1416785424,2,27,600
40646519@N00,3683,9,1416789562,1416789778,5,27,216
40646519@N00,3683,14,1416789778,1416789873,3,27,95
40646519@N00,3683,15,1416789873,1416790053,3,27,180
40646519@N00,3683,17,1416790205,1416790214,2,27,9
40646519@N00,3683,26,1416790214,1416790394,2,27,180
40646519@N00,3683,22,1416790421,1416791021,2,27,600
40646519@N00,3683,19,1416791570,1416791990,9,27,420
40646519@N00,3683,22,1416794590,1416795190,5,27,600
40646519@N00,3683,15,1416799792,1416799972,4,27,180
40646519@N00,3683,13,1416800175,1416800775,8,27,600
40646519@N00,3683,14,1416802496,1416802616,23,27,120
40646519@N00,3683,20,1416806500,1416807580,6,27,1080
40646519@N00,3683,17,1416809020,1416809452,3,27,432
40646519@N00,3683,16,1416809452,1416809546,4,27,94
40646519@N00,3683,14,1416809546,1416809666,5,27,120
40646519@N00,3683,9,1416810509,1416810749,2,27,240
40646519@N00,3683,7,1416814005,1416814095,6,27,90
40646519@N00,3683,9,1416814285,1416814525,2,27,240
40646519@N00,3683,3,1416815602,1416815869,2,27,267
40646519@N00,3683,1,1416815869,1416816469,5,27,600
40646519@N00,3683,7,1416819770,1416819860,3,27,90
40646519@N00,3683,14,1416823311,1416823431,7,27,120
40646519@N00,3683,9,1416824181,1416824421,2,27,240
40646519@N00,3683,27,1416825183,1416826383,3,27,1200
40696376@N03,3684,6,1293800400,1293800655,1,1,255
40709591@N07,3685,27,1257871559,1257872759,2,2,1200
40709591@N07,3685,20,1257875415,1257876495,1,2,1080
40709591@N07,3686,1,1258163939,1258164539,2,2,600
40709591@N07,3686,16,1258192421,1258193141,1,2,720
40718771@N00,3687,20,1446079582,1446080662,1,1,1080
40722759@N02,3688,27,1383001088,1383002288,2,2,1200
40722759@N02,3688,18,1383023141,1383024941,1,2,1800
40732565660@N01,3689,17,1188808674,1188810054,2,3,1380
40732565660@N01,3689,9,1188814128,1188814368,3,3,240
40732565660@N01,3689,11,1188818932,1188819112,1,3,180
40732565660@N01,3690,27,1201849477,1201850677,3,2,1200
40732565660@N01,3690,4,1201853439,1201854339,1,2,900
40732565660@N01,3691,27,1202001023,1202002223,2,4,1200
40732565660@N01,3691,22,1202002921,1202003521,2,4,600
40732565660@N01,3691,21,1202003781,1202004231,3,4,450
40732565660@N01,3691,27,1202005805,1202007005,2,4,1200
40745887@N05,3692,26,1284339003,1284339183,2,2,180
40745887@N05,3692,3,1284354617,1284354887,3,2,270
40802704@N05,3693,27,1274320778,1274321978,4,2,1200
40802704@N05,3693,16,1274322304,1274323024,16,2,720
40827705@N04,3694,9,1207635198,1207635438,1,1,240
40833298@N02,3695,27,1255554031,1255555231,4,5,1200
40833298@N02,3695,8,1255571168,1255571288,2,5,120
40833298@N02,3695,14,1255575919,1255576039,2,5,120
40833298@N02,3695,12,1255578307,1255579147,3,5,840
40833298@N02,3695,18,1255591652,1255593452,1,5,1800
40835857@N00,3696,16,1386855215,1386855935,1,1,720
40899173@N05,3697,16,1262023702,1262024422,1,1,720
40901879@N07,3698,17,1315486055,1315487435,1,1,1380
40908775@N04,3699,3,1248789602,1248789616,2,2,14
40908775@N04,3699,16,1248789616,1248790336,1,2,720
40937461@N02,3700,27,1329524551,1329525751,5,10,1200
40937461@N02,3700,11,1329526784,1329526964,2,10,180
40937461@N02,3700,1,1329527099,1329527240,2,10,141
40937461@N02,3700,27,1329527240,1329528440,3,10,1200
40937461@N02,3700,14,1329535182,1329535302,3,10,120
40937461@N02,3700,9,1329541699,1329541939,2,10,240
40937461@N02,3700,22,1329544884,1329545484,3,10,600
40937461@N02,3700,18,1329547053,1329547218,2,10,165
40937461@N02,3700,17,1329547218,1329548598,2,10,1380
40937461@N02,3700,16,1329550892,1329551612,2,10,720
40937461@N02,3701,18,1329721038,1329722698,2,6,1660
40937461@N02,3701,26,1329722698,1329722878,2,6,180
40937461@N02,3701,22,1329722994,1329723594,3,6,600
40937461@N02,3701,21,1329726108,1329726558,2,6,450
40937461@N02,3701,16,1329728322,1329728518,2,6,196
40937461@N02,3701,4,1329728518,1329729418,1,6,900
40979501@N04,3702,25,1307324086,1307324836,2,1,750
41013533@N04,3703,14,1428298725,1428298845,2,2,120
41013533@N04,3703,12,1428299877,1428300717,3,2,840
41013533@N04,3704,21,1428391927,1428392377,2,2,450
41013533@N04,3704,27,1428418006,1428419206,1,2,1200
41101678@N00,3705,14,1397616853,1397616973,1,1,120
41117712@N05,3706,27,1361820359,1361821559,2,8,1200
41117712@N05,3706,8,1361826970,1361827090,3,8,120
41117712@N05,3706,22,1361841649,1361842249,2,8,600
41117712@N05,3706,13,1361842410,1361843010,2,8,600
41117712@N05,3706,27,1361859817,1361861017,2,8,1200
41117712@N05,3706,4,1361871224,1361871379,2,8,155
41117712@N05,3706,2,1361871379,1361871469,2,8,90
41117712@N05,3706,6,1361871577,1361871832,1,8,255
41126359@N00,3707,1,1277945859,1277946459,2,2,600
41126359@N00,3707,18,1277949733,1277951533,1,2,1800
41126359@N00,3708,16,1278061932,1278062652,2,2,720
41126359@N00,3708,2,1278077489,1278077579,1,2,90
41126359@N00,3709,16,1278155663,1278156383,2,2,720
41126359@N00,3709,17,1278159696,1278161076,1,2,1380
41126359@N00,3710,3,1278749279,1278749549,2,2,270
41126359@N00,3710,19,1278754666,1278755086,1,2,420
41126359@N00,3711,14,1279363865,1279363985,1,1,120
41126359@N00,3712,14,1280923370,1280923490,1,1,120
41126359@N00,3713,9,1281005166,1281005406,1,1,240
41126359@N00,3714,16,1281101055,1281101775,1,1,720
41126359@N00,3715,14,1283853105,1283853225,1,1,120
41126359@N00,3716,12,1295827483,1295827713,2,2,230
41126359@N00,3716,9,1295827713,1295827953,1,2,240
41126359@N00,3717,14,1295860835,1295860955,2,2,120
41126359@N00,3717,13,1295874866,1295875466,1,2,600
41126359@N00,3718,16,1312448736,1312449456,1,1,720
41126359@N00,3719,27,1322904625,1322905825,2,2,1200
41126359@N00,3719,25,1322915908,1322916658,1,2,750
41126359@N00,3720,17,1329377270,1329378650,1,1,1380
41126359@N00,3721,18,1329805326,1329807126,2,2,1800
41126359@N00,3721,27,1329808503,1329809703,1,2,1200
41126359@N00,3722,8,1339840950,1339841070,1,1,120
41126359@N00,3723,16,1341318971,1341319691,1,1,720
41126359@N00,3724,14,1346546615,1346546700,2,2,85
41126359@N00,3724,9,1346546700,1346546940,1,2,240
41126359@N00,3725,10,1350103326,1350103746,1,1,420
41126359@N00,3726,2,1363945729,1363945819,1,1,90
41134616@N00,3727,27,1225059198,1225060398,3,13,1200
41134616@N00,3727,13,1225060623,1225061223,3,13,600
41134616@N00,3727,12,1225062609,1225063449,2,13,840
41134616@N00,3727,19,1225064181,1225064601,2,13,420
41134616@N00,3727,20,1225065012,1225066092,3,13,1080
41134616@N00,3727,19,1225067381,1225067801,2,13,420
41134616@N00,3727,21,1225068470,1225068920,2,13,450
41134616@N00,3727,25,1225074019,1225074769,2,13,750
41134616@N00,3727,24,1225075606,1225076086,2,13,480
41134616@N00,3727,16,1225076765,1225077485,4,13,720
41134616@N00,3727,14,1225081691,1225081811,3,13,120
41134616@N00,3727,16,1225093586,1225094306,7,13,720
41134616@N00,3727,27,1225108628,1225109828,1,13,1200
41134616@N00,3728,27,1225437226,1225438426,6,3,1200
41134616@N00,3728,11,1225442670,1225442850,2,3,180
41134616@N00,3728,9,1225443866,1225444106,1,3,240
41138825@N00,3729,27,1452840114,1452840467,2,9,353
41138825@N00,3729,4,1452840467,1452841367,2,9,900
41138825@N00,3729,2,1452841633,1452841723,2,9,90
41138825@N00,3729,3,1452842462,1452842714,2,9,252
41138825@N00,3729,5,1452842714,1452842717,2,9,3
41138825@N00,3729,14,1452842717,1452842837,2,9,120
41138825@N00,3729,15,1452846724,1452846904,2,9,180
41138825@N00,3729,19,1452849769,1452850189,2,9,420
41138825@N00,3729,17,1452854849,1452856229,1,9,1380
41164738@N00,3730,15,1373785899,1373786079,1,1,180
41164738@N00,3731,15,1373883396,1373883576,2,1,180
41164738@N00,3732,15,1374262828,1374263008,1,1,180
41164738@N00,3733,15,1374324422,1374324602,9,1,180
41164738@N00,3734,15,1374399519,1374399699,2,1,180
41164738@N00,3735,15,1374811401,1374811581,12,1,180
41180631@N06,3736,27,1227839252,1227840452,3,2,1200
41180631@N06,3736,16,1227842991,1227843711,1,2,720
41185854@N07,3737,16,1325302720,1325303440,1,1,720
41197583@N00,3738,27,1250228165,1250229365,2,3,1200
41197583@N00,3738,22,1250232610,1250233210,4,3,600
41197583@N00,3738,6,1250237292,1250237547,3,3,255
41197583@N00,3739,18,1250545276,1250546140,2,6,864
41197583@N00,3739,22,1250546140,1250546396,2,6,256
41197583@N00,3739,18,1250546396,1250548196,4,6,1800
41197583@N00,3739,17,1250559640,1250559896,2,6,256
41197583@N00,3739,22,1250559896,1250560496,2,6,600
41197583@N00,3739,23,1250582192,1250582282,1,6,90
41211080@N02,3740,4,1336602847,1336603747,1,1,900
41236077@N02,3741,16,1291034204,1291034924,1,1,720
41236077@N02,3742,14,1326513557,1326513677,6,2,120
41236077@N02,3742,2,1326536132,1326536222,1,2,90
41277655@N07,3743,14,1399170586,1399170706,9,2,120
41277655@N07,3743,7,1399200916,1399201006,1,2,90
41287315@N06,3744,27,1335660522,1335661722,1,1,1200
41294893@N05,3745,16,1252884006,1252884726,15,1,720
41294893@N05,3746,16,1252966785,1252967505,47,1,720
41294893@N05,3747,16,1253057017,1253057737,9,1,720
41294893@N05,3748,16,1253147727,1253148447,27,1,720
41294893@N05,3749,16,1253233693,1253234413,54,1,720
41299606@N00,3750,14,1425100465,1425100585,1,1,120
41330913@N04,3751,27,1351473201,1351474401,3,1,1200
41362237@N00,3752,16,1232743728,1232744448,7,4,720
41362237@N00,3752,18,1232756313,1232756518,7,4,205
41362237@N00,3752,19,1232756518,1232756938,23,4,420
41362237@N00,3752,18,1232757200,1232759000,15,4,1800
41396402@N03,3753,14,1396318027,1396318147,2,5,120
41396402@N03,3753,26,1396325089,1396325118,2,5,29
41396402@N03,3753,22,1396325118,1396325718,6,5,600
41396402@N03,3753,3,1396338745,1396339015,2,5,270
41396402@N03,3753,2,1396339075,1396339165,2,5,90
41407408@N00,3754,14,1281475497,1281475617,1,1,120
41407408@N00,3755,1,1306462973,1306463177,2,5,204
41407408@N00,3755,19,1306463177,1306463597,2,5,420
41407408@N00,3755,27,1306463705,1306463837,2,5,132
41407408@N00,3755,17,1306463837,1306464180,2,5,343
41407408@N00,3755,19,1306464180,1306464600,1,5,420
41407408@N00,3756,5,1420189115,1420189835,1,1,720
41407408@N00,3757,27,1421826185,1421826982,2,2,797
41407408@N00,3757,17,1421826982,1421828362,3,2,1380
41407408@N00,3758,15,1422309948,1422310128,1,1,180
41427544@N00,3759,16,1297756707,1297757427,1,1,720
41518442@N02,3760,16,1250746067,1250746787,2,1,720
41545932@N02,3761,9,1357104943,1357105183,2,2,240
41545932@N02,3761,12,1357108927,1357109767,1,2,840
41545932@N02,3762,16,1357164560,1357165280,1,1,720
41545932@N02,3763,1,1357264969,1357265569,2,2,600
41545932@N02,3763,16,1357277230,1357277950,1,2,720
41545932@N02,3764,14,1357453903,1357454023,1,1,120
41566089@N04,3765,14,1433297351,1433297471,1,1,120
41597043@N00,3766,27,1385327617,1385328817,2,2,1200
41597043@N00,3766,14,1385329197,1385329317,3,2,120
41610763@N04,3767,17,1315388794,1315390174,2,3,1380
41610763@N04,3767,9,1315408412,1315408652,2,3,240
41610763@N04,3767,27,1315411237,1315412437,1,3,1200
41610763@N04,3768,18,1326941401,1326943201,2,2,1800
41610763@N04,3768,17,1326949940,1326951320,1,2,1380
41624223@N08,3769,27,1338343544,1338344744,4,6,1200
41624223@N08,3769,25,1338355718,1338356468,4,6,750
41624223@N08,3769,20,1338357764,1338358844,3,6,1080
41624223@N08,3769,14,1338363670,1338363790,4,6,120
41624223@N08,3769,27,1338370908,1338372108,6,6,1200
41624223@N08,3769,4,1338373700,1338374600,2,6,900
41644332@N07,3770,16,1263339033,1263339753,4,1,720
41644332@N07,3771,16,1263539541,1263540261,3,1,720
41661621@N00,3772,9,1215127512,1215127752,4,17,240
41661621@N00,3772,15,1215131392,1215131572,6,17,180
41661621@N00,3772,9,1215133582,1215133822,2,17,240
41661621@N00,3772,8,1215136481,1215136601,2,17,120
41661621@N00,3772,11,1215136940,1215137120,2,17,180
41661621@N00,3772,4,1215138641,1215139541,4,17,900
41661621@N00,3772,27,1215139623,1215140823,5,17,1200
41661621@N00,3772,4,1215159286,1215159622,2,17,336
41661621@N00,3772,3,1215159622,1215159780,4,17,158
41661621@N00,3772,4,1215159780,1215160460,2,17,680
41661621@N00,3772,6,1215160460,1215160588,2,17,128
41661621@N00,3772,9,1215160588,1215160828,2,17,240
41661621@N00,3772,22,1215161817,1215162417,11,17,600
41661621@N00,3772,18,1215163160,1215163444,2,17,284
41661621@N00,3772,20,1215163444,1215163549,2,17,105
41661621@N00,3772,18,1215163549,1215165349,8,17,1800
41661621@N00,3772,9,1215169392,1215169632,16,17,240
41661621@N00,3773,27,1240613575,1240614775,12,13,1200
41661621@N00,3773,24,1240616006,1240616486,4,13,480
41661621@N00,3773,23,1240616490,1240616580,2,13,90
41661621@N00,3773,17,1240617147,1240618057,9,13,910
41661621@N00,3773,16,1240618057,1240618777,8,13,720
41661621@N00,3773,14,1240622834,1240622954,2,13,120
41661621@N00,3773,15,1240623062,1240623242,8,13,180
41661621@N00,3773,14,1240624395,1240624515,3,13,120
41661621@N00,3773,22,1240625548,1240626148,5,13,600
41661621@N00,3773,21,1240627323,1240627773,6,13,450
41661621@N00,3773,9,1240630083,1240630323,2,13,240
41661621@N00,3773,14,1240656830,1240656950,5,13,120
41661621@N00,3773,27,1240663616,1240664816,4,13,1200
41661621@N00,3774,27,1240718230,1240719430,1,1,1200
41661621@N00,3775,14,1392158678,1392158798,8,22,120
41661621@N00,3775,15,1392160328,1392160508,20,22,180
41661621@N00,3775,19,1392162919,1392163339,6,22,420
41661621@N00,3775,22,1392164927,1392165527,17,22,600
41661621@N00,3775,23,1392166695,1392166785,5,22,90
41661621@N00,3775,25,1392167217,1392167691,6,22,474
41661621@N00,3775,22,1392167691,1392168043,2,22,352
41661621@N00,3775,20,1392168043,1392168471,2,22,428
41661621@N00,3775,18,1392168471,1392169944,3,22,1473
41661621@N00,3775,19,1392169944,1392170239,3,22,295
41661621@N00,3775,18,1392170239,1392171428,7,22,1189
41661621@N00,3775,20,1392171428,1392172508,3,22,1080
41661621@N00,3775,9,1392173415,1392173655,2,22,240
41661621@N00,3775,10,1392174332,1392174570,4,22,238
41661621@N00,3775,14,1392174570,1392174690,3,22,120
41661621@N00,3775,2,1392177489,1392177579,4,22,90
41661621@N00,3775,4,1392178320,1392179220,3,22,900
41661621@N00,3775,3,1392180704,1392180974,6,22,270
41661621@N00,3775,2,1392181612,1392181702,5,22,90
41661621@N00,3775,3,1392182501,1392182771,2,22,270
41661621@N00,3775,6,1392184235,1392184490,2,22,255
41661621@N00,3775,16,1392186602,1392187322,1,22,720
41662207@N05,3776,2,1393582198,1393582288,3,2,90
41662207@N05,3776,8,1393584250,1393584370,1,2,120
41662207@N05,3777,14,1400851851,1400851971,2,1,120
41662207@N05,3778,16,1428744526,1428745246,1,1,720
41663556@N00,3779,27,1354842538,1354843665,2,5,1127
41663556@N00,3779,4,1354843665,1354844565,2,5,900
41663556@N00,3779,6,1354844692,1354844947,2,5,255
41663556@N00,3779,7,1354845091,1354845181,2,5,90
41663556@N00,3779,14,1354856359,1354856479,9,5,120
41689886@N02,3780,27,1347500749,1347501949,2,3,1200
41689886@N02,3780,14,1347510031,1347510151,2,3,120
41689886@N02,3780,9,1347511919,1347512159,1,3,240
41693381@N00,3781,16,1212919014,1212919734,1,1,720
41693381@N00,3782,1,1292106178,1292106778,1,1,600
41693381@N00,3783,16,1292241242,1292241962,1,1,720
41693381@N00,3784,13,1337478212,1337478812,2,2,600
41693381@N00,3784,27,1337485744,1337486944,1,2,1200
41693381@N00,3785,13,1337523661,1337524261,1,1,600
41693381@N00,3786,2,1337845355,1337845445,3,3,90
41693381@N00,3786,4,1337847722,1337848622,2,3,900
41693381@N00,3786,17,1337852392,1337853772,1,3,1380
41693381@N00,3787,27,1365752042,1365753242,1,1,1200
41693381@N00,3788,27,1365846910,1365848110,2,1,1200
41693381@N00,3789,14,1404265277,1404265397,1,1,120
41693381@N00,3790,14,1406286701,1406286821,1,1,120
41693381@N00,3791,27,1415009210,1415010410,1,1,1200
41693381@N00,3792,13,1424503426,1424504026,1,1,600
41693381@N00,3793,27,1430554683,1430555883,2,2,1200
41693381@N00,3793,9,1430556631,1430556871,2,2,240
41693381@N00,3794,20,1432459339,1432460419,1,1,1080
41693381@N00,3795,19,1434529220,1434529640,1,1,420
41693381@N00,3796,17,1442133447,1442133806,2,3,359
41693381@N00,3796,10,1442133806,1442134179,3,3,373
41693381@N00,3796,17,1442134179,1442135559,1,3,1380
41695711@N00,3797,16,1191289076,1191289796,1,1,720
41709523@N07,3798,14,1415087771,1415087891,1,1,120
41781975@N00,3799,9,1229211380,1229211620,3,1,240
41781975@N00,3800,10,1253353867,1253354100,2,2,233
41781975@N00,3800,17,1253354100,1253355480,1,2,1380
41864324@N02,3801,4,1225955151,1225956051,1,1,900
41872770@N05,3802,7,1255671273,1255671363,1,1,90
41872770@N05,3803,21,1260499739,1260500189,2,2,450
41872770@N05,3803,24,1260504371,1260504851,1,2,480
41872770@N05,3804,22,1260622345,1260622945,1,1,600
41872770@N05,3805,22,1266115876,1266116476,2,4,600
41872770@N05,3805,5,1266143363,1266144083,2,4,720
41872770@N05,3805,1,1266153329,1266153929,2,4,600
41872770@N05,3805,27,1266163305,1266164505,1,4,1200
41872770@N05,3806,26,1268970340,1268970520,1,1,180
41878212@N00,3807,13,1394840433,1394841033,1,1,600
41881070@N08,3808,27,1284653000,1284654200,2,4,1200
41881070@N08,3808,16,1284654483,1284655203,9,4,720
41881070@N08,3808,21,1284662489,1284662939,3,4,450
41881070@N08,3808,16,1284673357,1284674077,6,4,720
41881070@N08,3809,27,1284859130,1284860330,2,2,1200
41881070@N08,3809,16,1284862107,1284862827,1,2,720
41881070@N08,3810,16,1284929236,1284929956,1,1,720
41881070@N08,3811,16,1285026069,1285026789,5,1,720
41894164051@N01,3812,16,1366700839,1366701559,1,1,720
41894165897@N01,3813,13,1356558590,1356559190,3,4,600
41894165897@N01,3813,27,1356584426,1356585626,2,4,1200
41894165897@N01,3813,4,1356591573,1356591882,2,4,309
41894165897@N01,3813,17,1356591882,1356593262,1,4,1380
41894166078@N01,3814,9,1292449759,1292449999,1,1,240
41894185936@N01,3815,17,1381890104,1381891484,1,1,1380
41894194820@N01,3816,17,1370872803,1370874183,1,1,1380
41894194820@N01,3817,17,1371011210,1371012590,1,1,1380
41903519@N07,3818,16,1379573907,1379574627,2,3,720
41903519@N07,3818,8,1379580608,1379580728,2,3,120
41903519@N07,3818,22,1379585821,1379586421,1,3,600
41919930@N03,3819,22,1258345521,1258346121,4,1,600
41919930@N03,3820,22,1269229299,1269229899,2,1,600
41934700@N05,3821,16,1360384464,1360385184,2,3,720
41934700@N05,3821,13,1360385416,1360386016,3,3,600
41934700@N05,3821,21,1360388098,1360388548,1,3,450
41967511@N00,3822,27,1244036708,1244037908,1,1,1200
41967511@N00,3823,27,1244191010,1244192210,2,1,1200
41976006@N02,3824,16,1306323555,1306324275,1,1,720
42085328@N07,3825,16,1268031600,1268032320,1,1,720
42118699@N08,3826,20,1210189156,1210190236,1,1,1080
42118699@N08,3827,25,1210294783,1210295533,1,1,750
42118699@N08,3828,26,1254594324,1254594504,3,6,180
42118699@N08,3828,20,1254594590,1254595670,2,6,1080
42118699@N08,3828,3,1254597725,1254597995,2,6,270
42118699@N08,3828,18,1254600830,1254602630,2,6,1800
42118699@N08,3828,24,1254611068,1254611548,2,6,480
42118699@N08,3828,16,1254615403,1254616123,1,6,720
42118699@N08,3829,20,1257880934,1257882014,2,3,1080
42118699@N08,3829,19,1257883047,1257883467,3,3,420
42118699@N08,3829,24,1257885544,1257886024,1,3,480
42118699@N08,3830,27,1286387988,1286388451,2,6,463
42118699@N08,3830,16,1286388451,1286389107,2,6,656
42118699@N08,3830,15,1286389107,1286389287,2,6,180
42118699@N08,3830,9,1286390152,1286390392,2,6,240
42118699@N08,3830,20,1286392741,1286393821,2,6,1080
42118699@N08,3830,21,1286394360,1286394810,1,6,450
42118699@N08,3831,1,1286700233,1286700833,1,1,600
42118699@N08,3832,15,1286995816,1286995996,1,1,180
42118699@N08,3833,15,1351102701,1351102881,2,2,180
42118699@N08,3833,19,1351113798,1351114218,1,2,420
42118699@N08,3834,10,1367458898,1367459318,6,1,420
42118699@N08,3835,14,1368513065,1368513185,2,5,120
42118699@N08,3835,9,1368513433,1368513673,2,5,240
42118699@N08,3835,14,1368514631,1368514751,2,5,120
42118699@N08,3835,10,1368516535,1368516955,2,5,420
42118699@N08,3835,9,1368520625,1368520865,1,5,240
42118699@N08,3836,15,1368645877,1368646057,3,3,180
42118699@N08,3836,10,1368648787,1368649207,2,3,420
42118699@N08,3836,14,1368650412,1368650532,1,3,120
42118699@N08,3837,1,1368771032,1368771632,3,2,600
42118699@N08,3837,15,1368776278,1368776458,2,2,180
42118699@N08,3838,9,1429860790,1429861030,2,1,240
42118699@N08,3839,10,1430030573,1430030993,1,1,420
42118699@N08,3840,9,1430094783,1430095023,2,2,240
42118699@N08,3840,8,1430097489,1430097609,1,2,120
42118699@N08,3841,16,1460357673,1460358393,1,1,720
42118699@N08,3842,14,1460638703,1460638823,2,1,120
42151752@N05,3843,15,1417052564,1417052744,2,3,180
42151752@N05,3843,9,1417052754,1417052994,2,3,240
42151752@N05,3843,4,1417053573,1417054473,1,3,900
42151752@N05,3844,2,1417140424,1417140514,2,4,90
42151752@N05,3844,7,1417146095,1417146185,2,4,90
42151752@N05,3844,8,1417149485,1417149605,3,4,120
42151752@N05,3844,19,1417153121,1417153541,1,4,420
42201001@N07,3845,2,1287008454,1287008544,1,1,90
42218330@N03,3846,4,1343645412,1343646312,2,1,900
42299049@N06,3847,14,1453813200,1453813320,1,1,120
42320709@N06,3848,16,1454033287,1454034007,2,1,720
42327762@N03,3849,16,1257995941,1257996661,3,2,720
42327762@N03,3849,27,1258013762,1258014962,2,2,1200
42327762@N03,3850,27,1286332934,1286334134,33,1,1200
42344249@N02,3851,25,1217132879,1217133629,3,2,750
42344249@N02,3851,9,1217160338,1217160578,1,2,240
42398872@N03,3852,19,1325898434,1325898854,2,6,420
42398872@N03,3852,23,1325900888,1325900978,2,6,90
42398872@N03,3852,4,1325903522,1325904422,2,6,900
42398872@N03,3852,1,1325908780,1325908954,2,6,174
42398872@N03,3852,6,1325908954,1325909209,2,6,255
42398872@N03,3852,14,1325913765,1325913885,1,6,120
42399173@N05,3853,27,1345430885,1345432085,4,5,1200
42399173@N05,3853,9,1345443753,1345443993,5,5,240
42399173@N05,3853,8,1345444177,1345444297,3,5,120
42399173@N05,3853,14,1345452159,1345452279,2,5,120
42399173@N05,3853,22,1345458525,1345459125,9,5,600
42399173@N05,3854,9,1345609169,1345609409,1,1,240
42399173@N05,3855,27,1386642347,1386643547,2,8,1200
42399173@N05,3855,23,1386646403,1386646493,2,8,90
42399173@N05,3855,24,1386647088,1386647568,2,8,480
42399173@N05,3855,23,1386651001,1386651091,2,8,90
42399173@N05,3855,9,1386658223,1386658463,3,8,240
42399173@N05,3855,6,1386661758,1386662013,3,8,255
42399173@N05,3855,4,1386662309,1386663209,2,8,900
42399173@N05,3855,27,1386676698,1386677898,10,8,1200
42399173@N05,3856,27,1386983862,1386985062,2,4,1200
42399173@N05,3856,16,1386985240,1386985726,2,4,486
42399173@N05,3856,7,1386985726,1386985816,3,4,90
42399173@N05,3856,27,1387008568,1387009768,1,4,1200
42416044@N04,3857,27,1291759363,1291760563,2,10,1200
42416044@N04,3857,21,1291760751,1291761201,4,10,450
42416044@N04,3857,23,1291763592,1291763682,3,10,90
42416044@N04,3857,21,1291764738,1291765188,2,10,450
42416044@N04,3857,18,1291765993,1291767793,5,10,1800
42416044@N04,3857,20,1291768513,1291769084,2,10,571
42416044@N04,3857,17,1291769084,1291770334,2,10,1250
42416044@N04,3857,13,1291770334,1291770934,2,10,600
42416044@N04,3857,16,1291776401,1291777121,2,10,720
42416044@N04,3857,13,1291783466,1291784066,2,10,600
42419824@N03,3858,20,1383524014,1383525094,123,1,1080
42431443@N08,3859,15,1313219822,1313220002,1,1,180
42438292@N07,3860,21,1290847206,1290847656,1,1,450
42438292@N07,3861,16,1290929617,1290930337,1,1,720
42440817@N02,3862,16,1335694313,1335695033,1,1,720
42486569@N00,3863,4,1300008095,1300008425,3,4,330
42486569@N00,3863,5,1300008425,1300009145,4,4,720
42486569@N00,3863,4,1300011203,1300012103,2,4,900
42486569@N00,3863,18,1300019759,1300021559,1,4,1800
42486569@N00,3864,27,1300132435,1300133635,14,7,1200
42486569@N00,3864,24,1300138413,1300138893,4,7,480
42486569@N00,3864,20,1300148345,1300149425,2,7,1080
42486569@N00,3864,15,1300150972,1300151152,2,7,180
42486569@N00,3864,14,1300151953,1300152073,2,7,120
42486569@N00,3864,6,1300154638,1300154893,3,7,255
42486569@N00,3864,5,1300183211,1300183931,1,7,720
42486569@N00,3865,20,1300404885,1300404969,3,7,84
42486569@N00,3865,22,1300404969,1300405560,3,7,591
42486569@N00,3865,17,1300405560,1300405756,12,7,196
42486569@N00,3865,13,1300405756,1300406356,33,7,600
42486569@N00,3865,18,1300409170,1300409229,3,7,59
42486569@N00,3865,13,1300409229,1300409829,16,7,600
42486569@N00,3865,12,1300414689,1300415529,6,7,840
42491939@N00,3866,9,1228960913,1228961153,3,2,240
42491939@N00,3866,25,1228970967,1228971717,1,2,750
42491939@N00,3867,27,1347832611,1347833811,9,1,1200
42491939@N00,3868,27,1348266384,1348267584,7,4,1200
42491939@N00,3868,22,1348270588,1348271188,7,4,600
42491939@N00,3868,24,1348271977,1348272130,4,4,153
42491939@N00,3868,21,1348272130,1348272580,22,4,450
42504117@N06,3869,27,1356651503,1356652703,2,2,1200
42504117@N06,3869,25,1356668139,1356668889,1,2,750
42508926@N03,3870,27,1328825205,1328826405,3,1,1200
42508926@N03,3871,27,1329262271,1329263471,4,4,1200
42508926@N03,3871,21,1329265871,1329266321,3,4,450
42508926@N03,3871,22,1329266826,1329267426,4,4,600
42508926@N03,3871,1,1329277808,1329278408,8,4,600
42508926@N03,3872,21,1329364527,1329364977,3,2,450
42508926@N03,3872,27,1329378001,1329379201,23,2,1200
42508926@N03,3873,27,1330601988,1330603188,1,1,1200
42533701@N00,3874,27,1215403889,1215405089,3,1,1200
42539010@N02,3875,27,1428280873,1428282073,5,13,1200
42539010@N02,3875,25,1428282121,1428282871,9,13,750
42539010@N02,3875,23,1428283376,1428283466,10,13,90
42539010@N02,3875,21,1428285336,1428285340,2,13,4
42539010@N02,3875,23,1428285340,1428285430,2,13,90
42539010@N02,3875,21,1428285613,1428286063,2,13,450
42539010@N02,3875,20,1428287323,1428287680,5,13,357
42539010@N02,3875,18,1428287680,1428288235,3,13,555
42539010@N02,3875,19,1428288235,1428288416,2,13,181
42539010@N02,3875,18,1428288416,1428289010,2,13,594
42539010@N02,3875,19,1428289010,1428289430,2,13,420
42539010@N02,3875,21,1428290503,1428290953,2,13,450
42539010@N02,3875,17,1428296873,1428298253,17,13,1380
42580834@N08,3876,27,1256372401,1256373601,2,2,1200
42580834@N08,3876,17,1256381001,1256382381,1,2,1380
42580834@N08,3877,27,1256547211,1256548411,2,6,1200
42580834@N08,3877,9,1256548458,1256548698,2,6,240
42580834@N08,3877,16,1256550664,1256551384,4,6,720
42580834@N08,3877,9,1256553443,1256553683,2,6,240
42580834@N08,3877,2,1256553693,1256553783,2,6,90
42580834@N08,3877,3,1256553904,1256554174,2,6,270
42580834@N08,3878,27,1256616448,1256617648,7,8,1200
42580834@N08,3878,24,1256619795,1256620275,2,8,480
42580834@N08,3878,25,1256620323,1256620842,2,8,519
42580834@N08,3878,23,1256620842,1256620932,2,8,90
42580834@N08,3878,22,1256621778,1256622378,7,8,600
42580834@N08,3878,8,1256641646,1256641766,2,8,120
42580834@N08,3878,13,1256643115,1256643715,4,8,600
42580834@N08,3878,21,1256646097,1256646547,1,8,450
42580834@N08,3879,7,1256857696,1256857786,2,8,90
42580834@N08,3879,11,1256858402,1256858582,5,8,180
42580834@N08,3879,9,1256859823,1256860063,2,8,240
42580834@N08,3879,3,1256861587,1256861827,2,8,240
42580834@N08,3879,4,1256861827,1256862727,2,8,900
42580834@N08,3879,19,1256864737,1256864737,2,8,0
42580834@N08,3879,20,1256864737,1256865817,4,8,1080
42580834@N08,3879,16,1256892159,1256892879,1,8,720
42580834@N08,3880,27,1256938901,1256940101,2,1,1200
42580834@N08,3881,27,1350015244,1350016444,3,3,1200
42580834@N08,3881,10,1350017119,1350017539,4,3,420
42580834@N08,3881,14,1350021163,1350021283,1,3,120
42580834@N08,3882,21,1350339820,1350340270,2,8,450
42580834@N08,3882,13,1350345318,1350345554,2,8,236
42580834@N08,3882,12,1350345554,1350346394,2,8,840
42580834@N08,3882,11,1350347502,1350347682,3,8,180
42580834@N08,3882,4,1350357554,1350358454,3,8,900
42580834@N08,3882,27,1350359497,1350360376,3,8,879
42580834@N08,3882,19,1350360376,1350360796,2,8,420
42580834@N08,3882,17,1350373679,1350375059,1,8,1380
42580834@N08,3883,22,1350607689,1350608289,2,5,600
42580834@N08,3883,21,1350615321,1350615614,2,5,293
42580834@N08,3883,25,1350615614,1350616364,2,5,750
42580834@N08,3883,12,1350617023,1350617863,2,5,840
42580834@N08,3883,16,1350618080,1350618800,1,5,720
42614577@N03,3884,27,1335651872,1335653072,4,8,1200
42614577@N03,3884,4,1335656059,1335656959,4,8,900
42614577@N03,3884,9,1335659498,1335659738,4,8,240
42614577@N03,3884,6,1335659936,1335659942,3,8,6
42614577@N03,3884,9,1335659942,1335660167,9,8,225
42614577@N03,3884,14,1335660167,1335660287,3,8,120
42614577@N03,3884,26,1335661629,1335661809,2,8,180
42614577@N03,3884,24,1335666751,1335667231,1,8,480
42614577@N03,3885,27,1366110957,1366112157,32,1,1200
42688661@N06,3886,27,1442122454,1442123654,2,3,1200
42688661@N06,3886,3,1442124854,1442125124,2,3,270
42688661@N06,3886,27,1442132927,1442134127,1,3,1200
42688661@N06,3887,27,1442307471,1442308671,4,1,1200
42688661@N06,3888,2,1442455407,1442455463,3,6,56
42688661@N06,3888,4,1442455463,1442455565,2,6,102
42688661@N06,3888,6,1442455565,1442455598,2,6,33
42688661@N06,3888,1,1442455598,1442455909,3,6,311
42688661@N06,3888,4,1442455909,1442455988,2,6,79
42688661@N06,3888,2,1442455988,1442456078,1,6,90
42688661@N06,3889,27,1442613567,1442614767,3,2,1200
42688661@N06,3889,14,1442616015,1442616135,1,2,120
42695644@N04,3890,4,1262053616,1262054516,1,1,900
42728140@N00,3891,6,1229678269,1229678524,1,1,255
42755016@N02,3892,4,1404776447,1404776978,2,2,531
42755016@N02,3892,10,1404776978,1404777398,1,2,420
42786185@N06,3893,17,1336968040,1336969420,2,1,1380
42786185@N06,3894,16,1367151008,1367151728,5,2,720
42786185@N06,3894,27,1367155236,1367156436,1,2,1200
42786185@N06,3895,18,1399021490,1399023290,1,1,1800
42787199@N08,3896,16,1386147196,1386147916,3,1,720
42815122@N02,3897,27,1347147079,1347148279,2,3,1200
42815122@N02,3897,19,1347165484,1347165904,2,3,420
42815122@N02,3897,4,1347183011,1347183911,1,3,900
42832231@N00,3898,14,1309664885,1309665005,1,1,120
42848911@N05,3899,24,1298627586,1298628066,2,2,480
42848911@N05,3899,19,1298629211,1298629631,1,2,420
42852007@N07,3900,21,1303032377,1303032827,1,1,450
42852007@N07,3901,27,1323079090,1323080290,1,1,1200
42895575@N00,3902,17,1283253117,1283254497,1,1,1380
42912996@N00,3903,27,1379626746,1379627946,2,8,1200
42912996@N00,3903,16,1379633552,1379634272,2,8,720
42912996@N00,3903,10,1379634757,1379635176,2,8,419
42912996@N00,3903,13,1379635176,1379635776,2,8,600
42912996@N00,3903,11,1379636025,1379636205,2,8,180
42912996@N00,3903,27,1379637256,1379638456,3,8,1200
42912996@N00,3903,2,1379655359,1379655449,2,8,90
42912996@N00,3903,27,1379671476,1379672676,2,8,1200
42912996@N00,3904,27,1380145686,1380146886,2,3,1200
42912996@N00,3904,10,1380171915,1380172335,2,3,420
42912996@N00,3904,27,1380173742,1380174942,1,3,1200
42925588@N00,3905,27,1333404811,1333406011,2,2,1200
42925588@N00,3905,8,1333406777,1333406897,1,2,120
42930817@N06,3906,21,1252722201,1252722651,1,1,450
42930817@N06,3907,4,1253237329,1253238229,2,1,900
42930817@N06,3908,27,1253404317,1253405517,4,2,1200
42930817@N06,3908,2,1253408736,1253408826,1,2,90
42960193@N04,3909,27,1309791821,1309793021,6,1,1200
42995562@N00,3910,14,1230945532,1230945652,1,1,120
43038803@N00,3911,26,1192430589,1192430617,3,3,28
43038803@N00,3911,12,1192430617,1192430628,2,3,11
43038803@N00,3911,2,1192430628,1192430718,1,3,90
43038803@N00,3912,27,1192506925,1192507534,6,5,609
43038803@N00,3912,9,1192507534,1192507774,2,5,240
43038803@N00,3912,20,1192507918,1192508082,2,5,164
43038803@N00,3912,4,1192508082,1192508251,2,5,169
43038803@N00,3912,27,1192508251,1192509451,1,5,1200
43074401@N07,3913,26,1386814356,1386814536,1,1,180
43082306@N00,3914,4,1195291327,1195292227,1,1,900
43082306@N00,3915,27,1211693563,1211694763,4,1,1200
43082306@N00,3916,27,1213421433,1213422633,2,1,1200
43082306@N00,3917,27,1215235963,1215237163,1,1,1200
43082306@N00,3918,27,1216445777,1216446977,3,1,1200
43082306@N00,3919,16,1217132301,1217133021,3,2,720
43082306@N00,3919,27,1217136992,1217138192,1,2,1200
43082306@N00,3920,13,1222433619,1222433648,2,2,29
43082306@N00,3920,22,1222433648,1222434248,1,2,600
43082306@N00,3921,27,1223098617,1223099817,1,1,1200
43082306@N00,3922,27,1223785726,1223786926,2,1,1200
43082306@N00,3923,21,1224914077,1224914527,1,1,450
43082306@N00,3924,22,1225518090,1225518690,1,1,600
43082306@N00,3925,27,1226122952,1226124152,2,2,1200
43082306@N00,3925,16,1226136552,1226137272,1,2,720
43082306@N00,3926,1,1227350888,1227351488,2,2,600
43082306@N00,3926,27,1227358032,1227359232,1,2,1200
43082306@N00,3927,27,1227840179,1227841379,2,3,1200
43082306@N00,3927,9,1227864500,1227864740,2,3,240
43082306@N00,3927,27,1227874706,1227875906,1,3,1200
43082306@N00,3928,16,1229756286,1229757006,2,2,720
43082306@N00,3928,3,1229758603,1229758873,1,2,270
43082306@N00,3929,5,1231584559,1231585279,1,1,720
43082306@N00,3930,4,1232785943,1232786843,2,1,900
43082306@N00,3931,5,1233373308,1233374028,2,2,720
43082306@N00,3931,27,1233376804,1233378004,4,2,1200
43082306@N00,3932,17,1234745675,1234746403,2,5,728
43082306@N00,3932,19,1234746403,1234746823,2,5,420
43082306@N00,3932,13,1234746977,1234747577,2,5,600
43082306@N00,3932,15,1234749345,1234749525,2,5,180
43082306@N00,3932,25,1234759647,1234760397,1,5,750
43082306@N00,3933,5,1235181131,1235181755,2,5,624
43082306@N00,3933,2,1235181755,1235181845,2,5,90
43082306@N00,3933,14,1235182189,1235182309,2,5,120
43082306@N00,3933,12,1235183875,1235184715,3,5,840
43082306@N00,3933,27,1235192442,1235193642,1,5,1200
43082306@N00,3934,27,1235795557,1235796757,7,2,1200
43082306@N00,3934,23,1235798550,1235798640,1,2,90
43082306@N00,3935,27,1241928388,1241929588,5,1,1200
43082306@N00,3936,21,1243140069,1243140519,1,1,450
43082306@N00,3937,21,1243191213,1243191663,1,1,450
43082306@N00,3938,21,1243223398,1243223848,2,1,450
43082306@N00,3939,4,1246008456,1246009319,2,8,863
43082306@N00,3939,13,1246009319,1246009346,2,8,27
43082306@N00,3939,17,1246009346,1246010044,2,8,698
43082306@N00,3939,23,1246010044,1246010134,2,8,90
43082306@N00,3939,21,1246011136,1246011586,3,8,450
43082306@N00,3939,26,1246011767,1246011905,2,8,138
43082306@N00,3939,25,1246011905,1246012214,2,8,309
43082306@N00,3939,27,1246012214,1246013414,3,8,1200
43082306@N00,3940,12,1246157560,1246158400,2,2,840
43082306@N00,3940,17,1246171950,1246173330,2,2,1380
43082306@N00,3941,21,1248331526,1248331967,2,2,441
43082306@N00,3941,23,1248331967,1248332057,1,2,90
43082306@N00,3942,12,1250138560,1250139400,1,1,840
43082306@N00,3943,27,1251082692,1251083892,1,1,1200
43082306@N00,3944,21,1252032616,1252033066,1,1,450
43082306@N00,3945,27,1254608866,1254610066,2,3,1200
43082306@N00,3945,19,1254610507,1254610927,3,3,420
43082306@N00,3945,21,1254618221,1254618671,1,3,450
43082306@N00,3946,27,1255746978,1255748178,2,2,1200
43082306@N00,3946,4,1255753267,1255754167,1,2,900
43082306@N00,3947,17,1256948690,1256949079,2,2,389
43082306@N00,3947,19,1256949079,1256949499,1,2,420
43082306@N00,3948,12,1257574868,1257575656,2,2,788
43082306@N00,3948,21,1257575656,1257576106,1,2,450
43082306@N00,3949,27,1261803424,1261804624,2,1,1200
43082306@N00,3950,20,1263683331,1263683902,2,3,571
43082306@N00,3950,22,1263683902,1263684502,2,3,600
43082306@N00,3950,27,1263700605,1263701805,1,3,1200
43082306@N00,3951,4,1265430436,1265431336,1,1,900
43082306@N00,3952,27,1266639351,1266640551,1,1,1200
43082306@N00,3953,27,1267325019,1267326219,1,1,1200
43082306@N00,3954,2,1267873589,1267873679,2,1,90
43082306@N00,3955,27,1270357051,1270358251,1,1,1200
43082306@N00,3956,21,1270878061,1270878511,1,1,450
43082306@N00,3957,27,1273320314,1273321514,2,1,1200
43082306@N00,3958,4,1273895621,1273896521,1,1,900
43082306@N00,3959,27,1275221398,1275222598,1,1,1200
43082306@N00,3960,27,1275743291,1275744491,2,1,1200
43082306@N00,3961,27,1278736705,1278737905,1,1,1200
43082306@N00,3962,17,1280480751,1280482131,1,1,1380
43082306@N00,3963,4,1282369110,1282370010,3,2,900
43082306@N00,3963,18,1282372899,1282374699,1,2,1800
43082306@N00,3964,1,1284787108,1284787708,2,2,600
43082306@N00,3964,27,1284789061,1284790261,3,2,1200
43082306@N00,3965,22,1286106248,1286106848,1,1,600
43082306@N00,3966,4,1287816523,1287817423,1,1,900
43082306@N00,3967,5,1291446222,1291446942,2,2,720
43082306@N00,3967,27,1291457988,1291459188,2,2,1200
43082306@N00,3968,27,1291896605,1291897805,1,1,1200
43082306@N00,3969,13,1295753499,1295754099,3,1,600
43082306@N00,3970,27,1296902969,1296904169,1,1,1200
43082306@N00,3971,16,1300438210,1300438930,1,1,720
43082306@N00,3972,27,1302412825,1302414025,2,1,1200
43082306@N00,3973,13,1303547391,1303547991,2,3,600
43082306@N00,3973,16,1303554245,1303554965,2,3,720
43082306@N00,3973,3,1303557655,1303557925,1,3,270
43082306@N00,3974,21,1306567905,1306568355,1,1,450
43082306@N00,3975,21,1307109815,1307110265,2,3,450
43082306@N00,3975,20,1307111754,1307112766,2,3,1012
43082306@N00,3975,26,1307112766,1307112946,1,3,180
43082306@N00,3976,22,1308445835,1308446042,2,6,207
43082306@N00,3976,17,1308446042,1308447422,2,6,1380
43082306@N00,3976,9,1308449766,1308450006,2,6,240
43082306@N00,3976,4,1308455342,1308456086,2,6,744
43082306@N00,3976,27,1308456086,1308456877,2,6,791
43082306@N00,3976,19,1308456877,1308457297,1,6,420
43082306@N00,3977,20,1309663484,1309664258,2,3,774
43082306@N00,3977,19,1309664258,1309664678,3,3,420
43082306@N00,3977,18,1309665461,1309667261,1,3,1800
43082306@N00,3978,4,1310879231,1310880131,1,1,900
43082306@N00,3979,3,1313208682,1313208952,1,1,270
43082306@N00,3980,16,1313768921,1313769641,1,1,720
43082306@N00,3981,27,1315051736,1315052936,1,1,1200
43082306@N00,3982,3,1317179247,1317179517,1,1,270
43082306@N00,3983,27,1319190183,1319191383,2,2,1200
43082306@N00,3983,22,1319197251,1319197851,1,2,600
43082306@N00,3984,26,1320501247,1320501427,2,3,180
43082306@N00,3984,21,1320504532,1320504982,3,3,450
43082306@N00,3984,27,1320508393,1320509593,1,3,1200
43082306@N00,3985,16,1323642498,1323643218,6,1,720
43082306@N00,3986,22,1325227613,1325228213,11,1,600
43082306@N00,3987,17,1330456781,1330458161,1,1,1380
43082306@N00,3988,8,1331544438,1331544558,1,1,120
43082306@N00,3989,13,1333536576,1333537176,1,1,600
43082306@N00,3990,8,1333864856,1333864976,2,3,120
43082306@N00,3990,17,1333869395,1333870775,2,3,1380
43082306@N00,3990,9,1333876570,1333876810,1,3,240
43082306@N00,3991,12,1336209194,1336210034,3,2,840
43082306@N00,3991,27,1336215883,1336217083,2,2,1200
43082306@N00,3992,18,1340789788,1340791588,1,1,1800
43082306@N00,3993,17,1344047467,1344047691,2,2,224
43082306@N00,3993,26,1344047691,1344047871,1,2,180
43082306@N00,3994,8,1345211372,1345211492,1,1,120
43082306@N00,3995,26,1347626682,1347626862,2,1,180
43082306@N00,3996,27,1348375109,1348376309,1,1,1200
43082306@N00,3997,10,1350088294,1350088714,2,1,420
43082306@N00,3998,10,1350294710,1350295130,2,2,420
43082306@N00,3998,2,1350302498,1350302588,1,2,90
43082306@N00,3999,10,1353218610,1353219030,1,1,420
43082306@N00,4000,27,1354014148,1354015348,2,1,1200
43082306@N00,4001,10,1354329807,1354330227,1,1,420
43082306@N00,4002,27,1365854637,1365855837,1,1,1200
43082306@N00,4003,20,1381579747,1381580827,1,1,1080
43082306@N00,4004,27,1384508440,1384509640,2,2,1200
43082306@N00,4004,15,1384515571,1384515751,1,2,180
43082306@N00,4005,15,1391856655,1391856835,1,1,180
43082306@N00,4006,10,1399104668,1399105088,1,1,420
43082306@N00,4007,10,1400996851,1400997271,2,1,420
43082306@N00,4008,27,1413538973,1413540173,2,1,1200
43082306@N00,4009,16,1415009081,1415009801,1,1,720
43082306@N00,4010,27,1417694459,1417695659,2,1,1200
43082306@N00,4011,13,1420952569,1420953169,1,1,600
43082306@N00,4012,13,1435904532,1435905132,2,1,600
43082306@N00,4013,27,1445186709,1445187909,1,1,1200
43082306@N00,4014,27,1449312283,1449313483,1,1,1200
43082306@N00,4015,27,1449571642,1449572842,3,1,1200
43108539@N03,4016,17,1278671709,1278673089,2,2,1380
43108539@N03,4016,27,1278694366,1278695566,1,2,1200
43108539@N03,4017,20,1279032703,1279033783,4,2,1080
43108539@N03,4017,18,1279038769,1279040569,3,2,1800
43108539@N03,4018,19,1279096394,1279096814,1,1,420
43122711@N02,4019,17,1272167075,1272168455,4,2,1380
43122711@N02,4019,27,1272186636,1272187836,6,2,1200
43122711@N02,4020,9,1272253534,1272253774,3,6,240
43122711@N02,4020,18,1272259758,1272261558,14,6,1800
43122711@N02,4020,17,1272266584,1272267964,2,6,1380
43122711@N02,4020,6,1272288344,1272288465,2,6,121
43122711@N02,4020,7,1272288465,1272288555,5,6,90
43122711@N02,4020,8,1272289034,1272289154,3,6,120
43122711@N02,4021,18,1272692656,1272694456,1,1,1800
43122711@N02,4022,14,1307139410,1307139530,2,5,120
43122711@N02,4022,6,1307147845,1307148100,4,5,255
43122711@N02,4022,2,1307152016,1307152106,2,5,90
43122711@N02,4022,1,1307152280,1307152880,2,5,600
43122711@N02,4022,25,1307165664,1307166414,1,5,750
43122711@N02,4023,27,1307353322,1307354166,2,3,844
43122711@N02,4023,4,1307354166,1307355066,2,3,900
43122711@N02,4023,6,1307357732,1307357987,1,3,255
43186161@N04,4024,27,1254443406,1254444606,7,6,1200
43186161@N04,4024,17,1254445319,1254446699,2,6,1380
43186161@N04,4024,7,1254453396,1254453486,3,6,90
43186161@N04,4024,8,1254453521,1254453641,15,6,120
43186161@N04,4024,11,1254454348,1254454528,25,6,180
43186161@N04,4024,27,1254458399,1254459599,35,6,1200
43244835@N00,4025,6,1354358780,1354359035,1,1,255
43244835@N00,4026,17,1354496315,1354497695,4,3,1380
43244835@N00,4026,16,1354518173,1354518893,2,3,720
43244835@N00,4026,15,1354520151,1354520331,1,3,180
43245053@N00,4027,16,1331362220,1331362940,1,1,720
43245053@N00,4028,13,1331442578,1331443178,2,1,600
43245053@N00,4029,16,1331898281,1331899001,1,1,720
43245053@N00,4030,1,1332756641,1332756683,2,4,42
43245053@N00,4030,16,1332756683,1332757403,3,4,720
43245053@N00,4030,27,1332758210,1332758247,2,4,37
43245053@N00,4030,13,1332758247,1332758847,1,4,600
43245053@N00,4031,13,1346851475,1346851526,2,3,51
43245053@N00,4031,16,1346851526,1346851763,2,3,237
43245053@N00,4031,22,1346851763,1346852363,1,3,600
43245053@N00,4032,27,1355009573,1355010773,2,2,1200
43245053@N00,4032,14,1355015688,1355015808,1,2,120
43245053@N00,4033,26,1356530333,1356530513,1,1,180
43245053@N00,4034,13,1381107559,1381108159,2,1,600
43245053@N00,4035,9,1414881582,1414881822,2,1,240
43245053@N00,4036,16,1414913556,1414914276,2,1,720
43266053@N00,4037,2,1278218965,1278219055,1,1,90
43266097@N03,4038,27,1456609211,1456610411,4,1,1200
43266097@N03,4039,27,1459308429,1459309629,18,1,1200
43297700@N00,4040,17,1321953036,1321954416,1,1,1380
43358741@N00,4041,19,1400985550,1400985970,2,2,420
43358741@N00,4041,14,1400992236,1400992356,2,2,120
43391619@N06,4042,9,1195697083,1195697323,1,1,240
43391619@N06,4043,3,1252180894,1252181164,3,1,270
43391619@N06,4044,3,1258795834,1258796104,2,3,270
43391619@N06,4044,9,1258801435,1258801675,2,3,240
43391619@N06,4044,18,1258802140,1258803940,1,3,1800
43391619@N06,4045,17,1266123396,1266124776,2,2,1380
43391619@N06,4045,3,1266125755,1266126025,1,2,270
43391619@N06,4046,6,1269684165,1269684420,1,1,255
43391619@N06,4047,17,1275276936,1275277427,3,2,491
43391619@N06,4047,5,1275277427,1275278147,1,2,720
43391619@N06,4048,27,1278470802,1278472002,1,1,1200
43391619@N06,4049,2,1283633390,1283633480,1,1,90
43391619@N06,4050,17,1283666773,1283668153,2,2,1380
43391619@N06,4050,2,1283682649,1283682739,1,2,90
43391619@N06,4051,27,1293183554,1293184754,1,1,1200
43391619@N06,4052,26,1293243739,1293243919,1,1,180
43391619@N06,4053,17,1296768940,1296770320,1,1,1380
43441796@N06,4054,4,1325814018,1325814918,1,1,900
43511960@N08,4055,27,1334539705,1334540905,1,1,1200
43535605@N00,4056,11,1360639272,1360639452,2,2,180
43535605@N00,4056,22,1360646343,1360646943,1,2,600
43545301@N03,4057,18,1331802652,1331804452,1,1,1800
43549138@N00,4058,18,1229322641,1229324441,1,1,1800
43549138@N00,4059,17,1231464809,1231466189,1,1,1380
43549138@N00,4060,16,1254694615,1254695335,1,1,720
43608757@N08,4061,4,1455935056,1455935956,2,3,900
43608757@N08,4061,16,1455941502,1455942222,4,3,720
43608757@N08,4061,17,1455944945,1455946325,7,3,1380
43612819@N03,4062,15,1188606476,1188606656,1,1,180
43612819@N03,4063,17,1268363840,1268365220,1,1,1380
43612819@N03,4064,27,1337411422,1337412622,1,1,1200
43612819@N03,4065,27,1337935627,1337936827,3,2,1200
43612819@N03,4065,17,1337942570,1337943950,1,2,1380
43612819@N03,4066,25,1345258409,1345259159,1,1,750
43612819@N03,4067,22,1353319053,1353319653,1,1,600
43612819@N03,4068,26,1380331717,1380331897,1,1,180
43612819@N03,4069,25,1408227118,1408227868,1,1,750
43636216@N00,4070,27,1228775269,1228776469,2,3,1200
43636216@N00,4070,4,1228777066,1228777966,2,3,900
43636216@N00,4070,9,1228782472,1228782712,1,3,240
43642153@N04,4071,27,1412206043,1412207243,5,8,1200
43642153@N04,4071,16,1412208323,1412208976,2,8,653
43642153@N04,4071,8,1412208976,1412209096,2,8,120
43642153@N04,4071,10,1412210983,1412211403,2,8,420
43642153@N04,4071,13,1412214495,1412215095,2,8,600
43642153@N04,4071,2,1412225354,1412225444,2,8,90
43642153@N04,4071,1,1412229548,1412230148,3,8,600
43642153@N04,4071,22,1412236503,1412237103,1,8,600
43642153@N04,4072,7,1412548740,1412548830,2,9,90
43642153@N04,4072,14,1412555486,1412555606,2,9,120
43642153@N04,4072,9,1412559324,1412559564,2,9,240
43642153@N04,4072,25,1412566901,1412567651,2,9,750
43642153@N04,4072,17,1412568678,1412569948,2,9,1270
43642153@N04,4072,20,1412569948,1412571028,2,9,1080
43642153@N04,4072,9,1412574917,1412575157,3,9,240
43642153@N04,4072,7,1412581161,1412581251,2,9,90
43642153@N04,4072,14,1412581309,1412581429,3,9,120
43643415@N07,4073,27,1293714128,1293715328,1,1,1200
43649575@N03,4074,14,1398937663,1398937783,1,1,120
43652558@N00,4075,16,1462420319,1462421039,2,3,720
43652558@N00,4075,15,1462425156,1462425336,2,3,180
43652558@N00,4075,12,1462426221,1462427061,1,3,840
43652558@N00,4076,27,1462683337,1462684537,3,3,1200
43652558@N00,4076,5,1462685151,1462685710,2,3,559
43652558@N00,4076,2,1462685710,1462685800,1,3,90
43652558@N00,4077,27,1463662617,1463663817,1,1,1200
43652558@N00,4078,16,1463910056,1463910375,3,5,319
43652558@N00,4078,14,1463910375,1463910495,2,5,120
43652558@N00,4078,10,1463911308,1463911728,3,5,420
43652558@N00,4078,14,1463913266,1463913386,2,5,120
43652558@N00,4078,12,1463913604,1463914444,2,5,840
43667163@N00,4079,5,1256357786,1256358506,3,14,720
43667163@N00,4079,6,1256362299,1256362554,2,14,255
43667163@N00,4079,2,1256365529,1256365619,3,14,90
43667163@N00,4079,12,1256367502,1256368342,5,14,840
43667163@N00,4079,13,1256371522,1256372122,2,14,600
43667163@N00,4079,25,1256374534,1256375284,2,14,750
43667163@N00,4079,23,1256375406,1256375496,3,14,90
43667163@N00,4079,25,1256376377,1256377127,3,14,750
43667163@N00,4079,26,1256382407,1256382587,4,14,180
43667163@N00,4079,11,1256383993,1256384132,2,14,139
43667163@N00,4079,17,1256384132,1256384943,3,14,811
43667163@N00,4079,20,1256384943,1256386023,3,14,1080
43667163@N00,4079,22,1256386257,1256386857,7,14,600
43667163@N00,4079,17,1256388860,1256390240,1,14,1380
43676934@N06,4080,27,1253682300,1253683500,1,1,1200
43679955@N05,4081,6,1261797310,1261797565,1,1,255
43681824@N00,4082,27,1212796566,1212796995,8,14,429
43681824@N00,4082,4,1212796995,1212797646,4,14,651
43681824@N00,4082,5,1212797646,1212798366,4,14,720
43681824@N00,4082,6,1212799664,1212799919,6,14,255
43681824@N00,4082,2,1212801705,1212801795,4,14,90
43681824@N00,4082,1,1212803205,1212803764,3,14,559
43681824@N00,4082,9,1212803764,1212804004,3,14,240
43681824@N00,4082,20,1212804720,1212805800,7,14,1080
43681824@N00,4082,19,1212811198,1212811618,11,14,420
43681824@N00,4082,22,1212812629,1212813229,3,14,600
43681824@N00,4082,15,1212813421,1212813601,4,14,180
43681824@N00,4082,12,1212815386,1212816226,7,14,840
43681824@N00,4082,25,1212817761,1212818511,3,14,750
43681824@N00,4082,27,1212819843,1212821043,3,14,1200
43681824@N00,4083,20,1232709875,1232710955,1,1,1080
43700437@N06,4084,19,1362996361,1362996781,1,1,420
43700437@N06,4085,23,1364327926,1364328016,2,2,90
43700437@N06,4085,13,1364328258,1364328858,1,2,600
43700437@N06,4086,27,1368339865,1368341065,1,1,1200
43700437@N06,4087,13,1371328213,1371328813,1,1,600
43700437@N06,4088,27,1373076455,1373076643,2,2,188
43700437@N06,4088,22,1373076643,1373077243,1,2,600
43700437@N06,4089,26,1376090724,1376090904,2,4,180
43700437@N06,4089,25,1376093827,1376094577,3,4,750
43700437@N06,4089,15,1376098643,1376098823,2,4,180
43700437@N06,4089,14,1376107389,1376107509,1,4,120
43700437@N06,4090,27,1392501337,1392502537,1,1,1200
43700437@N06,4091,22,1393023428,1393024028,2,3,600
43700437@N06,4091,13,1393024571,1393024886,2,3,315
43700437@N06,4091,10,1393024886,1393025306,1,3,420
43700437@N06,4092,13,1394277109,1394277145,3,2,36
43700437@N06,4092,15,1394277145,1394277325,1,2,180
43700437@N06,4093,16,1401436442,1401437162,4,3,720
43700437@N06,4093,10,1401446748,1401447168,2,3,420
43700437@N06,4093,9,1401449585,1401449825,1,3,240
43700437@N06,4094,17,1402100259,1402101639,2,2,1380
43700437@N06,4094,22,1402112460,1402113060,1,2,600
43700437@N06,4095,13,1405669509,1405670109,1,1,600
43700437@N06,4096,17,1420957179,1420958559,1,1,1380
43700437@N06,4097,18,1440814605,1440816405,1,1,1800
43808803@N00,4098,27,1462232401,1462232927,2,7,526
43808803@N00,4098,9,1462232927,1462233167,2,7,240
43808803@N00,4098,20,1462237859,1462238939,3,7,1080
43808803@N00,4098,15,1462240840,1462241020,3,7,180
43808803@N00,4098,26,1462253733,1462253913,2,7,180
43808803@N00,4098,25,1462262600,1462263350,2,7,750
43808803@N00,4098,14,1462265964,1462266084,1,7,120
43808803@N00,4099,22,1462421748,1462422348,2,2,600
43808803@N00,4099,27,1462429883,1462431083,3,2,1200
43808803@N00,4100,27,1462757237,1462758437,1,1,1200
43808803@N00,4101,15,1463012039,1463012219,1,1,180
43882213@N00,4102,27,1261438445,1261439645,7,22,1200
43882213@N00,4102,17,1261440181,1261440786,2,22,605
43882213@N00,4102,26,1261440786,1261440925,4,22,139
43882213@N00,4102,18,1261440925,1261441097,2,22,172
43882213@N00,4102,22,1261441097,1261441697,3,22,600
43882213@N00,4102,26,1261442619,1261442799,3,22,180
43882213@N00,4102,22,1261443048,1261443578,7,22,530
43882213@N00,4102,24,1261443578,1261444058,8,22,480
43882213@N00,4102,21,1261448523,1261448973,2,22,450
43882213@N00,4102,26,1261450817,1261450997,2,22,180
43882213@N00,4102,17,1261451906,1261452853,2,22,947
43882213@N00,4102,18,1261452853,1261454653,4,22,1800
43882213@N00,4102,14,1261456913,1261457033,6,22,120
43882213@N00,4102,7,1261462110,1261462200,9,22,90
43882213@N00,4102,8,1261463369,1261463489,4,22,120
43882213@N00,4102,7,1261469058,1261469148,2,22,90
43882213@N00,4102,2,1261469229,1261469235,2,22,6
43882213@N00,4102,7,1261469235,1261469325,6,22,90
43882213@N00,4102,2,1261470410,1261470500,5,22,90
43882213@N00,4102,1,1261476788,1261477388,3,22,600
43882213@N00,4102,2,1261478879,1261478969,2,22,90
43882213@N00,4102,27,1261481721,1261482921,1,22,1200
43906182@N04,4103,27,1269587332,1269587369,2,2,37
43906182@N04,4103,18,1269587369,1269589169,2,2,1800
43906182@N04,4104,18,1269814551,1269816351,1,1,1800
43906182@N04,4105,18,1270074448,1270076248,1,1,1800
43928881@N00,4106,27,1275301972,1275303172,2,1,1200
43998338@N07,4107,16,1262323208,1262323928,2,1,720
44022769@N00,4108,1,1344732579,1344732642,2,2,63
44022769@N00,4108,9,1344732642,1344732882,1,2,240
44023757@N04,4109,27,1321957228,1321957597,2,3,369
44023757@N04,4109,16,1321957597,1321958317,70,3,720
44023757@N04,4109,27,1321968246,1321969446,7,3,1200
44023757@N04,4110,16,1352083216,1352083936,14,3,720
44023757@N04,4110,27,1352089188,1352090388,2,3,1200
44023757@N04,4110,16,1352097454,1352098174,3,3,720
44023757@N04,4111,11,1365306192,1365306372,10,2,180
44023757@N04,4111,9,1365306956,1365307196,43,2,240
44033839@N05,4112,26,1288994414,1288994415,2,3,1
44033839@N05,4112,17,1288994415,1288994416,2,3,1
44033839@N05,4112,27,1288994416,1288995616,6,3,1200
44082489@N00,4113,27,1230588994,1230589210,3,4,216
44082489@N00,4113,16,1230589210,1230589930,2,4,720
44082489@N00,4113,13,1230597266,1230597866,3,4,600
44082489@N00,4113,27,1230603817,1230605017,19,4,1200
44082489@N00,4114,16,1230638366,1230639086,7,4,720
44082489@N00,4114,12,1230642516,1230643356,5,4,840
44082489@N00,4114,20,1230645494,1230646574,3,4,1080
44082489@N00,4114,22,1230647028,1230647628,1,4,600
44082489@N00,4115,27,1261181012,1261182212,2,2,1200
44082489@N00,4115,20,1261186558,1261187638,1,2,1080
44082489@N00,4116,27,1395673334,1395674534,9,5,1200
44082489@N00,4116,8,1395681214,1395681334,2,5,120
44082489@N00,4116,27,1395682047,1395683247,6,5,1200
44082489@N00,4116,20,1395688079,1395689159,2,5,1080
44082489@N00,4116,27,1395691171,1395692371,27,5,1200
44082489@N00,4117,23,1395928556,1395928646,2,2,90
44082489@N00,4117,27,1395929165,1395930365,1,2,1200
44085687@N06,4118,22,1292689921,1292690521,1,1,600
44124305550@N01,4119,27,1189377125,1189378325,3,8,1200
44124305550@N01,4119,4,1189378428,1189379328,4,8,900
44124305550@N01,4119,3,1189380177,1189380447,2,8,270
44124305550@N01,4119,17,1189380497,1189381877,2,8,1380
44124305550@N01,4119,21,1189383939,1189384389,3,8,450
44124305550@N01,4119,1,1189387714,1189387925,2,8,211
44124305550@N01,4119,2,1189387925,1189388015,2,8,90
44124305550@N01,4119,4,1189388159,1189389059,1,8,900
44124305550@N01,4120,14,1189417733,1189417853,1,1,120
44124305550@N01,4121,21,1189770019,1189770469,1,1,450
44124305550@N01,4122,13,1189846981,1189847581,3,3,600
44124305550@N01,4122,2,1189851083,1189851173,2,3,90
44124305550@N01,4122,4,1189853044,1189853944,1,3,900
44124341154@N01,4123,4,1353192047,1353192947,3,11,900
44124341154@N01,4123,6,1353195099,1353195354,4,11,255
44124341154@N01,4123,2,1353195458,1353195496,2,11,38
44124341154@N01,4123,1,1353195496,1353195509,2,11,13
44124341154@N01,4123,6,1353195509,1353195529,2,11,20
44124341154@N01,4123,7,1353195529,1353195576,3,11,47
44124341154@N01,4123,6,1353195576,1353195831,3,11,255
44124341154@N01,4123,15,1353200476,1353200513,2,11,37
44124341154@N01,4123,12,1353200513,1353201353,2,11,840
44124341154@N01,4123,20,1353208944,1353210024,4,11,1080
44124341154@N01,4123,27,1353213634,1353214834,1,11,1200
44124341154@N01,4124,12,1353583113,1353583690,2,2,577
44124341154@N01,4124,14,1353583690,1353583810,2,2,120
44124341154@N01,4125,27,1353663475,1353664675,2,3,1200
44124341154@N01,4125,4,1353666278,1353667178,2,3,900
44124341154@N01,4125,3,1353670095,1353670365,3,3,270
44124364198@N01,4126,25,1420493831,1420494581,2,2,750
44124364198@N01,4126,14,1420514025,1420514145,1,2,120
44124367235@N01,4127,27,1364761722,1364762922,2,2,1200
44124367235@N01,4127,6,1364764581,1364764836,1,2,255
44124372331@N01,4128,27,1217192103,1217193146,2,2,1043
44124372331@N01,4128,13,1217193146,1217193746,1,2,600
44124372331@N01,4129,14,1217330107,1217330227,5,4,120
44124372331@N01,4129,16,1217330448,1217330638,2,4,190
44124372331@N01,4129,14,1217330638,1217330758,5,4,120
44124372331@N01,4129,15,1217331335,1217331515,1,4,180
44124372331@N01,4130,14,1217375167,1217375287,14,4,120
44124372331@N01,4130,12,1217387810,1217388650,3,4,840
44124372331@N01,4130,16,1217393383,1217394103,3,4,720
44124372331@N01,4130,17,1217396183,1217397563,1,4,1380
44124377471@N01,4131,23,1306357833,1306357923,1,1,90
44124395373@N01,4132,27,1353542146,1353543277,2,5,1131
44124395373@N01,4132,22,1353543277,1353543560,2,5,283
44124395373@N01,4132,26,1353543560,1353543740,5,5,180
44124395373@N01,4132,25,1353555970,1353556720,2,5,750
44124395373@N01,4132,19,1353558593,1353559013,1,5,420
44124395373@N01,4133,9,1353662592,1353662832,1,1,240
44124401501@N01,4134,27,1336809581,1336810781,8,1,1200
44124401501@N01,4135,17,1349004690,1349006070,22,2,1380
44124401501@N01,4135,1,1349009627,1349010227,1,2,600
44124401501@N01,4136,5,1359873665,1359874385,1,1,720
44124401501@N01,4137,14,1360830341,1360830461,3,1,120
44124401501@N01,4138,3,1384177951,1384178221,2,2,270
44124401501@N01,4138,2,1384178768,1384178858,2,2,90
44124401501@N01,4139,27,1385806970,1385808170,7,14,1200
44124401501@N01,4139,22,1385810079,1385810190,2,14,111
44124401501@N01,4139,26,1385810190,1385810370,6,14,180
44124401501@N01,4139,23,1385810684,1385810774,7,14,90
44124401501@N01,4139,22,1385812419,1385813019,19,14,600
44124401501@N01,4139,17,1385813753,1385814049,9,14,296
44124401501@N01,4139,18,1385814049,1385814788,6,14,739
44124401501@N01,4139,13,1385814788,1385815388,5,14,600
44124401501@N01,4139,15,1385815971,1385816151,5,14,180
44124401501@N01,4139,14,1385816917,1385817037,5,14,120
44124401501@N01,4139,9,1385817138,1385817378,5,14,240
44124401501@N01,4139,14,1385817422,1385817542,2,14,120
44124401501@N01,4139,9,1385817625,1385817795,5,14,170
44124401501@N01,4139,6,1385817795,1385818050,2,14,255
44124426205@N01,4140,27,1271738598,1271739798,1,1,1200
44124426205@N01,4141,13,1352763539,1352764139,2,2,600
44124426205@N01,4141,14,1352770120,1352770240,1,2,120
44124426205@N01,4142,27,1352894621,1352895821,1,1,1200
44124426205@N01,4143,13,1352957511,1352958111,1,1,600
44124426205@N01,4144,24,1385851126,1385851606,2,9,480
44124426205@N01,4144,13,1385858685,1385859285,2,9,600
44124426205@N01,4144,6,1385861491,1385861746,2,9,255
44124426205@N01,4144,17,1385866247,1385867627,2,9,1380
44124426205@N01,4144,21,1385870793,1385871243,2,9,450
44124426205@N01,4144,8,1385874461,1385874581,2,9,120
44124426205@N01,4144,19,1385876414,1385876834,2,9,420
44124426205@N01,4144,16,1385887143,1385887863,2,9,720
44124426205@N01,4144,14,1385893126,1385893246,1,9,120
44124426205@N01,4145,16,1386153595,1386154315,1,1,720
44124426205@N01,4146,19,1386222515,1386222935,1,1,420
44124426205@N01,4147,27,1386287137,1386288194,2,4,1057
44124426205@N01,4147,16,1386288194,1386288914,2,4,720
44124426205@N01,4147,13,1386292073,1386292673,3,4,600
44124426205@N01,4147,26,1386294869,1386295049,1,4,180
44124426205@N01,4148,13,1386385469,1386386069,2,2,600
44124426205@N01,4148,18,1386388016,1386389816,1,2,1800
44124426205@N01,4149,10,1411350928,1411351348,2,1,420
44124426205@N01,4150,27,1411719116,1411720316,2,2,1200
44124426205@N01,4150,18,1411721210,1411723010,1,2,1800
44124427374@N01,4151,4,1201923543,1201924443,1,1,900
44124427374@N01,4152,27,1202024487,1202025687,1,1,1200
44124427374@N01,4153,6,1202443249,1202443504,2,3,255
44124427374@N01,4153,18,1202446772,1202448572,7,3,1800
44124427374@N01,4153,2,1202454816,1202454906,1,3,90
44124427374@N01,4154,12,1202509680,1202510520,6,3,840
44124427374@N01,4154,2,1202522195,1202522285,2,3,90
44124427374@N01,4154,18,1202525670,1202527470,3,3,1800
44124427374@N01,4155,15,1349137367,1349137434,2,5,67
44124427374@N01,4155,12,1349137434,1349137459,2,5,25
44124427374@N01,4155,15,1349137459,1349137502,3,5,43
44124427374@N01,4155,12,1349137502,1349137759,4,5,257
44124427374@N01,4155,13,1349137759,1349138359,1,5,600
44124427374@N01,4156,2,1415237009,1415237099,2,3,90
44124427374@N01,4156,5,1415237137,1415237857,2,3,720
44124427374@N01,4156,2,1415238450,1415238540,1,3,90
44124427374@N01,4157,2,1415576717,1415576807,2,2,90
44124427374@N01,4157,17,1415588565,1415589945,1,2,1380
44124427374@N01,4158,21,1415667604,1415668054,2,2,450
44124427374@N01,4158,23,1415669408,1415669498,1,2,90
44124461706@N01,4159,27,1413447140,1413448340,2,2,1200
44124461706@N01,4159,12,1413454128,1413454968,1,2,840
44124461706@N01,4160,10,1413684480,1413684900,3,3,420
44124461706@N01,4160,24,1413686331,1413686811,4,3,480
44124461706@N01,4160,3,1413692452,1413692722,3,3,270
44124473586@N01,4161,14,1412296329,1412296449,1,1,120
44124478562@N01,4162,14,1317173815,1317173935,4,1,120
44124478562@N01,4163,27,1317203467,1317204667,4,1,1200
44125563@N00,4164,27,1301862175,1301863375,1,1,1200
44125563@N00,4165,12,1301912012,1301912852,1,1,840
44164246@N00,4166,7,1250375554,1250375644,1,1,90
44164246@N00,4167,14,1267661492,1267661612,1,1,120
44164246@N00,4168,23,1293065992,1293066082,4,3,90
44164246@N00,4168,21,1293067107,1293067557,4,3,450
44164246@N00,4168,14,1293069160,1293069280,2,3,120
44164246@N00,4169,22,1327044463,1327045063,9,2,600
44164246@N00,4169,14,1327061813,1327061933,5,2,120
44178635@N08,4170,4,1256772407,1256773307,1,1,900
44225280@N00,4171,27,1192254929,1192256129,2,1,1200
44275181@N00,4172,21,1425718042,1425718492,2,3,450
44275181@N00,4172,22,1425726338,1425726938,2,3,600
44275181@N00,4172,15,1425737389,1425737569,1,3,180
44275181@N00,4173,19,1442642759,1442643179,1,1,420
44275181@N00,4174,21,1450948471,1450948921,1,1,450
44307313@N04,4175,14,1310271173,1310271293,37,1,120
44318907@N08,4176,4,1286101743,1286102643,2,3,900
44318907@N08,4176,20,1286102968,1286104048,2,3,1080
44318907@N08,4176,14,1286110307,1286110427,1,3,120
44318907@N08,4177,4,1286389564,1286390464,2,5,900
44318907@N08,4177,26,1286408557,1286408737,2,5,180
44318907@N08,4177,17,1286408893,1286409377,3,5,484
44318907@N08,4177,27,1286409377,1286409753,2,5,376
44318907@N08,4177,17,1286409753,1286411133,1,5,1380
44318907@N08,4178,19,1286546806,1286547226,1,1,420
44318907@N08,4179,13,1286706905,1286707283,2,2,378
44318907@N08,4179,20,1286707283,1286708363,1,2,1080
44318907@N08,4180,16,1296630055,1296630775,5,1,720
44318907@N08,4181,13,1296946937,1296947537,2,2,600
44318907@N08,4181,16,1296960118,1296960838,2,2,720
44318907@N08,4182,17,1305498152,1305499532,2,1,1380
44318907@N08,4183,27,1305756950,1305758150,1,1,1200
44318907@N08,4184,16,1305844574,1305845294,1,1,720
44318907@N08,4185,4,1306794271,1306795171,1,1,900
44318907@N08,4186,22,1307396799,1307396806,2,2,7
44318907@N08,4186,4,1307396806,1307397706,1,2,900
44318907@N08,4187,18,1309905156,1309906956,1,1,1800
44318907@N08,4188,18,1317437248,1317437432,2,4,184
44318907@N08,4188,13,1317437432,1317438032,2,4,600
44318907@N08,4188,18,1317459948,1317461205,2,4,1257
44318907@N08,4188,27,1317461205,1317462405,1,4,1200
44318907@N08,4189,13,1317671257,1317671857,3,4,600
44318907@N08,4189,1,1317677786,1317678386,2,4,600
44318907@N08,4189,21,1317682903,1317683353,2,4,450
44318907@N08,4189,20,1317685161,1317686241,1,4,1080
44318907@N08,4190,21,1317871150,1317871600,2,5,450
44318907@N08,4190,17,1317887473,1317888853,2,5,1380
44318907@N08,4190,23,1317891516,1317891606,2,5,90
44318907@N08,4190,21,1317892095,1317892545,2,5,450
44318907@N08,4190,13,1317894449,1317895049,2,5,600
44318907@N08,4191,23,1329047921,1329048011,2,7,90
44318907@N08,4191,21,1329048205,1329048655,4,7,450
44318907@N08,4191,20,1329049775,1329050855,2,7,1080
44318907@N08,4191,18,1329050882,1329052083,2,7,1201
44318907@N08,4191,16,1329052083,1329052234,2,7,151
44318907@N08,4191,14,1329052234,1329052354,3,7,120
44318907@N08,4191,4,1329052926,1329053826,1,7,900
44318907@N08,4192,9,1329211555,1329211795,2,6,240
44318907@N08,4192,16,1329211884,1329212604,5,6,720
44318907@N08,4192,2,1329215309,1329215367,2,6,58
44318907@N08,4192,5,1329215367,1329215623,2,6,256
44318907@N08,4192,4,1329215623,1329216523,2,6,900
44318907@N08,4192,27,1329218028,1329219228,2,6,1200
44318907@N08,4193,21,1329387099,1329387549,3,3,450
44318907@N08,4193,18,1329388873,1329390673,2,3,1800
44318907@N08,4193,4,1329392508,1329393408,1,3,900
44318907@N08,4194,9,1347491646,1347491886,1,1,240
44318907@N08,4195,26,1361590074,1361590254,2,5,180
44318907@N08,4195,16,1361616845,1361617565,2,5,720
44318907@N08,4195,10,1361620681,1361621101,2,5,420
44318907@N08,4195,12,1361621506,1361621875,2,5,369
44318907@N08,4195,14,1361621875,1361621995,2,5,120
44318907@N08,4196,12,1361849496,1361850336,2,6,840
44318907@N08,4196,13,1361870808,1361871408,2,6,600
44318907@N08,4196,14,1361872508,1361872628,2,6,120
44318907@N08,4196,10,1361872986,1361873406,2,6,420
44318907@N08,4196,14,1361874001,1361874121,3,6,120
44318907@N08,4196,27,1361877153,1361878353,1,6,1200
44318907@N08,4197,22,1361958161,1361958761,2,3,600
44318907@N08,4197,9,1361962169,1361962409,2,3,240
44318907@N08,4197,14,1361963836,1361963956,1,3,120
44318907@N08,4198,17,1362027126,1362028506,2,4,1380
44318907@N08,4198,14,1362029525,1362029645,2,4,120
44318907@N08,4198,12,1362030460,1362031027,2,4,567
44318907@N08,4198,16,1362031027,1362031747,2,4,720
44318907@N08,4199,20,1371901258,1371902119,2,5,861
44318907@N08,4199,21,1371902119,1371902569,2,5,450
44318907@N08,4199,23,1371902868,1371902958,2,5,90
44318907@N08,4199,15,1371903735,1371903915,2,5,180
44318907@N08,4199,4,1371904721,1371905621,1,5,900
44318907@N08,4200,21,1371964939,1371965389,1,1,450
44337661@N07,4201,17,1337921698,1337921711,2,6,13
44337661@N07,4201,12,1337921711,1337922551,2,6,840
44337661@N07,4201,13,1337922884,1337922904,2,6,20
44337661@N07,4201,15,1337922904,1337923084,3,6,180
44337661@N07,4201,9,1337925730,1337925970,2,6,240
44337661@N07,4201,27,1337943895,1337945095,10,6,1200
44375167@N00,4202,9,1324939188,1324939428,1,1,240
44437814@N00,4203,16,1319341395,1319342115,1,1,720
44437814@N00,4204,27,1440897760,1440898960,1,1,1200
44458225@N00,4205,4,1325349615,1325350515,2,2,900
44458225@N00,4205,9,1325351366,1325351606,1,2,240
44458225@N00,4206,27,1338694553,1338695753,1,1,1200
44458225@N00,4207,4,1343738183,1343739083,1,1,900
44490358@N04,4208,13,1192425996,1192426596,3,3,600
44490358@N04,4208,3,1192434340,1192434610,2,3,270
44490358@N04,4208,5,1192434816,1192435536,1,3,720
44490358@N04,4209,21,1308243329,1308243779,1,1,450
44490358@N04,4210,12,1312888234,1312888664,2,2,430
44490358@N04,4210,13,1312888664,1312889264,1,2,600
44490358@N04,4211,27,1315033777,1315034977,1,1,1200
44490358@N04,4212,27,1315628130,1315629143,9,3,1013
44490358@N04,4212,17,1315629143,1315629284,3,3,141
44490358@N04,4212,26,1315629284,1315629464,4,3,180
44490358@N04,4213,25,1322133300,1322133645,2,4,345
44490358@N04,4213,26,1322133645,1322133825,3,4,180
44490358@N04,4213,25,1322134002,1322134752,6,4,750
44490358@N04,4213,17,1322135317,1322136697,3,4,1380
44490358@N04,4214,23,1329340438,1329340528,2,9,90
44490358@N04,4214,22,1329340751,1329341235,2,9,484
44490358@N04,4214,23,1329341235,1329341307,2,9,72
44490358@N04,4214,24,1329341307,1329341787,2,9,480
44490358@N04,4214,14,1329343067,1329343187,5,9,120
44490358@N04,4214,9,1329346090,1329346330,3,9,240
44490358@N04,4214,3,1329348456,1329348726,3,9,270
44490358@N04,4214,2,1329349669,1329349759,3,9,90
44490358@N04,4214,4,1329351376,1329352276,1,9,900
44510773@N08,4215,16,1314514325,1314515045,1,1,720
44510773@N08,4216,18,1355263579,1355264153,2,6,574
44510773@N08,4216,24,1355264153,1355264443,2,6,290
44510773@N08,4216,14,1355264443,1355264563,2,6,120
44510773@N08,4216,2,1355264787,1355264877,2,6,90
44510773@N08,4216,9,1355265157,1355265397,2,6,240
44510773@N08,4216,14,1355265809,1355265929,1,6,120
44510773@N08,4217,14,1355424274,1355424394,2,3,120
44510773@N08,4217,6,1355425899,1355426154,3,3,255
44510773@N08,4217,16,1355433497,1355434217,1,3,720
44510773@N08,4218,27,1441111697,1441112897,1,1,1200
44510773@N08,4219,17,1441333891,1441335271,1,1,1380
44603553@N03,4220,16,1352623124,1352623844,5,1,720
44633742@N02,4221,27,1278745871,1278747071,2,4,1200
44633742@N02,4221,11,1278753970,1278754150,2,4,180
44633742@N02,4221,10,1278755236,1278755656,2,4,420
44633742@N02,4221,3,1278767258,1278767528,1,4,270
44649244@N00,4222,27,1193403837,1193405037,4,1,1200
44679044@N07,4223,27,1368227568,1368228768,1,1,1200
44684173@N00,4224,14,1311126133,1311126253,5,14,120
44684173@N00,4224,19,1311133432,1311133852,2,14,420
44684173@N00,4224,15,1311135608,1311135788,2,14,180
44684173@N00,4224,14,1311136901,1311137021,2,14,120
44684173@N00,4224,3,1311141725,1311141995,4,14,270
44684173@N00,4224,2,1311145004,1311145094,5,14,90
44684173@N00,4224,9,1311146564,1311146804,5,14,240
44684173@N00,4224,3,1311148565,1311148835,7,14,270
44684173@N00,4224,20,1311154148,1311155228,2,14,1080
44684173@N00,4224,25,1311155846,1311156596,2,14,750
44684173@N00,4224,26,1311157260,1311157440,7,14,180
44684173@N00,4224,17,1311163908,1311165288,2,14,1380
44684173@N00,4224,9,1311167000,1311167240,2,14,240
44684173@N00,4224,20,1311177402,1311178482,1,14,1080
44718928@N00,4225,4,1427796253,1427797153,1,1,900
44813763@N07,4226,6,1425255483,1425255738,2,2,255
44813763@N07,4226,2,1425277106,1425277196,2,2,90
44813763@N07,4227,14,1425523733,1425523853,3,3,120
44813763@N07,4227,27,1425535627,1425536014,2,3,387
44813763@N07,4227,14,1425536014,1425536134,4,3,120
44816688@N00,4228,12,1410768383,1410769223,2,1,840
44816688@N00,4229,9,1430980201,1430980398,5,3,197
44816688@N00,4229,11,1430980398,1430980548,4,3,150
44816688@N00,4229,15,1430980548,1430980728,1,3,180
44816688@N00,4230,9,1432078204,1432078289,2,2,85
44816688@N00,4230,8,1432078289,1432078409,1,2,120
44816688@N00,4231,14,1439381757,1439381877,4,1,120
44816688@N00,4232,27,1454918751,1454919951,1,1,1200
44861310@N03,4233,27,1349581750,1349582950,2,1,1200
44867875@N00,4234,14,1353663176,1353663203,3,6,27
44867875@N00,4234,6,1353663203,1353663230,2,6,27
44867875@N00,4234,18,1353663230,1353663295,4,6,65
44867875@N00,4234,14,1353663295,1353663310,2,6,15
44867875@N00,4234,6,1353663310,1353663326,2,6,16
44867875@N00,4234,27,1353663326,1353664526,1,6,1200
44867875@N00,4235,11,1353924972,1353925152,1,1,180
44867875@N00,4236,14,1385431531,1385431651,2,3,120
44867875@N00,4236,16,1385431950,1385432670,2,3,720
44867875@N00,4236,22,1385432672,1385433272,2,3,600
44888545@N00,4237,27,1356466004,1356467204,2,4,1200
44888545@N00,4237,10,1356467756,1356467842,2,4,86
44888545@N00,4237,25,1356467842,1356467909,2,4,67
44888545@N00,4237,9,1356467909,1356468149,1,4,240
44888545@N00,4238,23,1419571668,1419571758,1,1,90
44914784@N04,4239,27,1260149892,1260151092,1,1,1200
44948268@N02,4240,16,1327970722,1327971442,10,1,720
44948268@N02,4241,16,1328869871,1328870591,1,1,720
44948268@N02,4242,10,1399344552,1399344972,2,2,420
44948268@N02,4242,16,1399345570,1399346290,1,2,720
44948268@N02,4243,21,1399858331,1399858781,2,2,450
44948268@N02,4243,17,1399868671,1399870051,1,2,1380
44948268@N02,4244,9,1399977446,1399977686,2,3,240
44948268@N02,4244,10,1399981025,1399981445,2,3,420
44948268@N02,4244,20,1399984536,1399985616,1,3,1080
44948268@N02,4245,14,1400203988,1400204108,2,2,120
44948268@N02,4245,9,1400206756,1400206996,1,2,240
44948268@N02,4246,2,1422706715,1422706805,1,1,90
44948268@N02,4247,19,1423025858,1423026278,1,1,420
44957651@N00,4248,27,1320214686,1320215886,1,1,1200
44978333@N06,4249,14,1293686077,1293686197,2,4,120
44978333@N06,4249,16,1293696352,1293697072,2,4,720
44978333@N06,4249,14,1293698807,1293698927,2,4,120
44978333@N06,4249,16,1293699152,1293699872,1,4,720
45023772@N03,4250,27,1361235802,1361237002,1,1,1200
45032460@N06,4251,3,1380669296,1380669566,3,13,270
45032460@N06,4251,6,1380672847,1380673102,2,13,255
45032460@N06,4251,9,1380673615,1380673855,7,13,240
45032460@N06,4251,10,1380674641,1380675061,3,13,420
45032460@N06,4251,7,1380675957,1380676047,3,13,90
45032460@N06,4251,8,1380676144,1380676161,2,13,17
45032460@N06,4251,7,1380676161,1380676251,2,13,90
45032460@N06,4251,4,1380685968,1380686868,2,13,900
45032460@N06,4251,27,1380688287,1380689487,7,13,1200
45032460@N06,4251,17,1380703654,1380703974,2,13,320
45032460@N06,4251,20,1380703974,1380705054,2,13,1080
45032460@N06,4251,23,1380707745,1380707835,2,13,90
45032460@N06,4251,22,1380709168,1380709768,7,13,600
45032460@N06,4252,22,1380848469,1380849069,5,15,600
45032460@N06,4252,26,1380849245,1380849425,3,15,180
45032460@N06,4252,17,1380849516,1380850896,4,15,1380
45032460@N06,4252,18,1380850986,1380851113,4,15,127
45032460@N06,4252,17,1380851113,1380852097,3,15,984
45032460@N06,4252,18,1380852097,1380853897,2,15,1800
45032460@N06,4252,26,1380854715,1380854730,2,15,15
45032460@N06,4252,17,1380854730,1380856110,4,15,1380
45032460@N06,4252,4,1380859038,1380859938,7,15,900
45032460@N06,4252,16,1380862581,1380863301,2,15,720
45032460@N06,4252,12,1380865418,1380865432,2,15,14
45032460@N06,4252,15,1380865432,1380865612,2,15,180
45032460@N06,4252,13,1380866222,1380866822,2,15,600
45032460@N06,4252,23,1380868383,1380868473,3,15,90
45032460@N06,4252,16,1380868999,1380869719,10,15,720
45032460@N06,4253,27,1380965075,1380966275,2,5,1200
45032460@N06,4253,9,1380969692,1380969932,3,5,240
45032460@N06,4253,10,1380970451,1380970871,7,5,420
45032460@N06,4253,14,1380975903,1380976023,2,5,120
45032460@N06,4253,24,1380996816,1380997296,1,5,480
45033503@N06,4254,13,1285628988,1285629588,2,1,600
45033503@N06,4255,23,1285662138,1285662228,1,1,90
45033503@N06,4256,14,1290059720,1290059840,2,2,120
45033503@N06,4256,27,1290088007,1290089207,1,2,1200
45033503@N06,4257,21,1290208980,1290209430,2,3,450
45033503@N06,4257,19,1290210834,1290211254,2,3,420
45033503@N06,4257,27,1290219571,1290220771,1,3,1200
45033503@N06,4258,21,1305761804,1305762254,1,1,450
45033503@N06,4259,22,1307102637,1307103237,1,1,600
45033503@N06,4260,17,1307264144,1307265524,2,3,1380
45033503@N06,4260,2,1307275727,1307275817,2,3,90
45033503@N06,4260,4,1307286302,1307287202,1,3,900
45033503@N06,4261,17,1315989007,1315990387,1,1,1380
45067258@N00,4262,2,1318769621,1318769711,2,2,90
45067258@N00,4262,27,1318770770,1318771970,3,2,1200
45067258@N00,4263,27,1339459293,1339460493,4,1,1200
45067258@N00,4264,27,1339645785,1339646985,3,3,1200
45067258@N00,4264,21,1339647189,1339647639,2,3,450
45067258@N00,4264,27,1339652049,1339653249,1,3,1200
45067258@N00,4265,27,1339823031,1339824231,3,6,1200
45067258@N00,4265,11,1339824972,1339825152,2,6,180
45067258@N00,4265,8,1339825189,1339825219,2,6,30
45067258@N00,4265,11,1339825219,1339825341,10,6,122
45067258@N00,4265,8,1339825341,1339825364,3,6,23
45067258@N00,4265,11,1339825364,1339825544,2,6,180
45067258@N00,4266,17,1339891732,1339893112,2,1,1380
45067258@N00,4267,27,1354748468,1354749668,1,1,1200
45067258@N00,4268,27,1354791206,1354792406,1,1,1200
45067258@N00,4269,27,1370235482,1370236682,37,1,1200
45067258@N00,4270,7,1383991909,1383991999,3,7,90
45067258@N00,4270,17,1383993277,1383994657,5,7,1380
45067258@N00,4270,23,1383997534,1383997624,2,7,90
45067258@N00,4270,24,1383997811,1383998291,4,7,480
45067258@N00,4270,18,1384001124,1384001135,2,7,11
45067258@N00,4270,19,1384001135,1384001555,4,7,420
45067258@N00,4270,26,1384002671,1384002851,1,7,180
45067258@N00,4271,27,1432237875,1432239075,9,2,1200
45067258@N00,4271,6,1432239703,1432239958,3,2,255
45067258@N00,4272,15,1432290239,1432290419,4,3,180
45067258@N00,4272,17,1432291698,1432293078,24,3,1380
45067258@N00,4272,27,1432298223,1432299423,1,3,1200
45067258@N00,4273,9,1432381890,1432382130,2,6,240
45067258@N00,4273,7,1432388973,1432389063,8,6,90
45067258@N00,4273,8,1432390376,1432390496,3,6,120
45067258@N00,4273,9,1432391839,1432392079,3,6,240
45067258@N00,4273,15,1432394238,1432394418,2,6,180
45067258@N00,4273,14,1432397476,1432397596,2,6,120
45067258@N00,4274,26,1432791592,1432791772,2,7,180
45067258@N00,4274,21,1432792322,1432792772,2,7,450
45067258@N00,4274,20,1432793015,1432794095,5,7,1080
45067258@N00,4274,18,1432807287,1432808590,2,7,1303
45067258@N00,4274,15,1432808590,1432808770,2,7,180
45067258@N00,4274,11,1432809751,1432809810,2,7,59
45067258@N00,4274,10,1432809810,1432810230,4,7,420
45072542@N00,4275,27,1317269967,1317271167,3,4,1200
45072542@N00,4275,22,1317271665,1317272265,14,4,600
45072542@N00,4275,21,1317274156,1317274573,3,4,417
45072542@N00,4275,27,1317274573,1317275773,5,4,1200
45072542@N00,4276,27,1317424667,1317425867,4,9,1200
45072542@N00,4276,17,1317426176,1317427556,25,9,1380
45072542@N00,4276,13,1317428190,1317428790,38,9,600
45072542@N00,4276,14,1317430995,1317431115,8,9,120
45072542@N00,4276,5,1317432396,1317433048,17,9,652
45072542@N00,4276,2,1317433048,1317433138,4,9,90
45072542@N00,4276,4,1317433331,1317433762,2,9,431
45072542@N00,4276,6,1317433762,1317433813,2,9,51
45072542@N00,4276,2,1317433813,1317433903,5,9,90
45072542@N00,4277,27,1317889137,1317889871,8,17,734
45072542@N00,4277,21,1317889871,1317890321,11,17,450
45072542@N00,4277,22,1317890919,1317891084,2,17,165
45072542@N00,4277,18,1317891084,1317892474,26,17,1390
45072542@N00,4277,17,1317892474,1317892719,3,17,245
45072542@N00,4277,18,1317892719,1317893088,14,17,369
45072542@N00,4277,17,1317893088,1317893193,12,17,105
45072542@N00,4277,18,1317893193,1317893270,7,17,77
45072542@N00,4277,17,1317893270,1317893660,34,17,390
45072542@N00,4277,18,1317893660,1317893902,6,17,242
45072542@N00,4277,14,1317893902,1317894022,7,17,120
45072542@N00,4277,16,1317894439,1317894514,3,17,75
45072542@N00,4277,14,1317894514,1317894634,20,17,120
45072542@N00,4277,4,1317898130,1317899030,4,17,900
45072542@N00,4277,5,1317899040,1317899740,4,17,700
45072542@N00,4277,14,1317899740,1317899860,6,17,120
45072542@N00,4277,27,1317904191,1317905391,2,17,1200
45083310@N06,4278,27,1353822723,1353822773,2,2,50
45083310@N06,4278,14,1353822773,1353822893,1,2,120
45083310@N06,4279,27,1357932665,1357933865,1,1,1200
45083310@N06,4280,7,1358037552,1358037642,3,6,90
45083310@N06,4280,15,1358044461,1358044641,5,6,180
45083310@N06,4280,12,1358044680,1358045520,7,6,840
45083310@N06,4280,10,1358047223,1358047643,2,6,420
45083310@N06,4280,17,1358050802,1358052182,3,6,1380
45083310@N06,4280,16,1358060711,1358061431,1,6,720
45088079@N00,4281,19,1315129745,1315130165,1,1,420
45088079@N00,4282,21,1315461069,1315461519,1,1,450
45130440@N03,4283,16,1368269016,1368269736,1,1,720
45130440@N03,4284,16,1368303038,1368303758,1,1,720
45130440@N03,4285,16,1368423536,1368424256,1,1,720
45151724@N00,4286,2,1443146538,1443146628,1,1,90
45182247@N06,4287,27,1384856928,1384858128,2,2,1200
45182247@N06,4287,16,1384864667,1384865387,1,2,720
45188796@N06,4288,25,1281019046,1281019796,1,1,750
45194801@N03,4289,27,1300706998,1300708198,1,1,1200
45212148@N07,4290,27,1326844059,1326845259,22,3,1200
45212148@N07,4290,4,1326849955,1326850265,8,3,310
45212148@N07,4290,3,1326850265,1326850535,9,3,270
45264491@N00,4291,14,1347707452,1347707572,3,3,120
45264491@N00,4291,12,1347708478,1347709318,2,3,840
45264491@N00,4291,17,1347709422,1347710802,1,3,1380
45264491@N00,4292,10,1351912608,1351913028,1,1,420
45265244@N07,4293,13,1305795480,1305796080,1,1,600
45297761@N02,4294,22,1229137733,1229138333,3,1,600
45297761@N02,4295,22,1229201817,1229202417,10,1,600
45297761@N02,4296,22,1229291340,1229291940,6,1,600
45297761@N02,4297,22,1229376310,1229376910,1,1,600
45297761@N02,4298,22,1229458225,1229458825,4,1,600
45313042@N08,4299,27,1286247424,1286248624,6,2,1200
45313042@N08,4299,7,1286249614,1286249704,1,2,90
45313042@N08,4300,27,1323239737,1323240662,5,5,925
45313042@N08,4300,16,1323240662,1323240750,2,5,88
45313042@N08,4300,14,1323240750,1323240870,2,5,120
45313042@N08,4300,1,1323242368,1323242968,2,5,600
45313042@N08,4300,17,1323245748,1323247128,1,5,1380
45409135@N00,4301,16,1431316041,1431316761,1,1,720
45504464@N00,4302,12,1207102635,1207103475,25,1,840
45504464@N00,4303,12,1207174501,1207175341,40,1,840
45504464@N00,4304,12,1207271624,1207272464,30,1,840
45504464@N00,4305,12,1207436371,1207437211,30,1,840
45514084@N03,4306,26,1275355467,1275355647,1,1,180
45537774@N02,4307,16,1312174747,1312175467,1,1,720
45561435@N00,4308,19,1295084400,1295084820,2,2,420
45561435@N00,4308,14,1295089240,1295089360,2,2,120
45561435@N00,4309,27,1295186108,1295187308,2,1,1200
45561435@N00,4310,19,1295231708,1295232128,2,7,420
45561435@N00,4310,1,1295236108,1295236708,7,7,600
45561435@N00,4310,9,1295243104,1295243114,2,7,10
45561435@N00,4310,14,1295243114,1295243234,6,7,120
45561435@N00,4310,16,1295243237,1295243319,2,7,82
45561435@N00,4310,17,1295243319,1295244041,5,7,722
45561435@N00,4310,27,1295244041,1295245241,4,7,1200
45561435@N00,4311,20,1426498566,1426499646,2,2,1080
45561435@N00,4311,27,1426507907,1426509107,2,2,1200
45561435@N00,4312,2,1426757048,1426757138,2,8,90
45561435@N00,4312,3,1426758807,1426759077,3,8,270
45561435@N00,4312,2,1426759261,1426759311,2,8,50
45561435@N00,4312,1,1426759311,1426759899,2,8,588
45561435@N00,4312,9,1426759899,1426760073,3,8,174
45561435@N00,4312,14,1426760073,1426760193,4,8,120
45561435@N00,4312,4,1426762786,1426763686,2,8,900
45561435@N00,4312,27,1426766370,1426767570,1,8,1200
45571875@N06,4313,3,1266643669,1266643939,1,1,270
45571875@N06,4314,4,1326795022,1326795922,3,1,900
45571875@N06,4315,27,1349751374,1349752574,2,5,1200
45571875@N06,4315,14,1349752801,1349752921,2,5,120
45571875@N06,4315,9,1349752954,1349753194,2,5,240
45571875@N06,4315,14,1349753372,1349753492,6,5,120
45571875@N06,4315,11,1349755013,1349755193,1,5,180
45571875@N06,4316,9,1350002602,1350002708,2,2,106
45571875@N06,4316,10,1350002708,1350003128,2,2,420
45571875@N06,4317,9,1351137329,1351137418,2,2,89
45571875@N06,4317,14,1351137418,1351137538,1,2,120
45571875@N06,4318,26,1353499669,1353499849,2,6,180
45571875@N06,4318,22,1353499852,1353499954,2,6,102
45571875@N06,4318,26,1353499954,1353500134,3,6,180
45571875@N06,4318,7,1353503680,1353503770,2,6,90
45571875@N06,4318,16,1353504385,1353505105,2,6,720
45571875@N06,4318,27,1353507085,1353508285,2,6,1200
45571875@N06,4319,20,1359522693,1359522796,2,4,103
45571875@N06,4319,19,1359522796,1359523216,2,4,420
45571875@N06,4319,9,1359526002,1359526242,2,4,240
45571875@N06,4319,10,1359531758,1359532178,1,4,420
45571875@N06,4320,9,1360145200,1360145440,2,2,240
45571875@N06,4320,14,1360145474,1360145594,1,2,120
45571875@N06,4321,7,1369420068,1369420158,1,1,90
45571875@N06,4322,10,1386599797,1386600217,1,1,420
45571875@N06,4323,27,1387853036,1387854236,1,1,1200
45571875@N06,4324,3,1401199330,1401199600,1,1,270
45571875@N06,4325,27,1401255190,1401256390,1,1,1200
45571875@N06,4326,22,1407301757,1407302357,3,2,600
45571875@N06,4326,14,1407305975,1407306095,1,2,120
45577837@N02,4327,4,1279730773,1279731673,2,2,900
45577837@N02,4327,16,1279735895,1279736615,1,2,720
45577837@N02,4328,24,1310397300,1310397780,1,1,480
45577837@N02,4329,23,1347364879,1347364969,1,1,90
45583433@N00,4330,18,1287201581,1287203247,2,5,1666
45583433@N00,4330,22,1287203247,1287203847,2,5,600
45583433@N00,4330,23,1287205281,1287205371,2,5,90
45583433@N00,4330,21,1287210466,1287210916,2,5,450
45583433@N00,4330,14,1287216861,1287216981,1,5,120
45596886@N00,4331,16,1255901269,1255901989,2,2,720
45596886@N00,4331,14,1255904500,1255904620,1,2,120
45614589@N02,4332,27,1225503308,1225504508,7,1,1200
45614589@N02,4333,27,1226277219,1226278419,2,1,1200
45614589@N02,4334,27,1289086874,1289088074,3,1,1200
45614589@N02,4335,27,1290037913,1290039113,3,1,1200
45614589@N02,4336,27,1320531344,1320532544,4,1,1200
45614589@N02,4337,27,1320825778,1320826978,6,1,1200
45614589@N02,4338,27,1321569573,1321570773,2,1,1200
45614589@N02,4339,27,1351997705,1351998905,1,1,1200
45614589@N02,4340,27,1352896496,1352897696,1,1,1200
45618467@N03,4341,18,1260927258,1260929058,3,1,1800
45621944@N00,4342,16,1260963653,1260964373,1,1,720
45632083@N00,4343,14,1411285720,1411285840,1,1,120
45632083@N00,4344,14,1412588351,1412588471,5,2,120
45632083@N00,4344,9,1412588960,1412589200,2,2,240
45653662@N06,4345,27,1271899798,1271900998,2,1,1200
45676151@N08,4346,16,1226302624,1226303344,1,1,720
45681479@N04,4347,27,1298679185,1298679809,5,3,624
45681479@N04,4347,4,1298679809,1298680709,5,3,900
45681479@N04,4347,2,1298680763,1298680853,3,3,90
45681479@N04,4348,27,1298722611,1298723044,2,22,433
45681479@N04,4348,18,1298723044,1298723275,3,22,231
45681479@N04,4348,26,1298723275,1298723455,6,22,180
45681479@N04,4348,20,1298724451,1298724866,3,22,415
45681479@N04,4348,2,1298724866,1298724956,5,22,90
45681479@N04,4348,9,1298726317,1298726557,8,22,240
45681479@N04,4348,17,1298730294,1298731674,2,22,1380
45681479@N04,4348,9,1298731723,1298731963,2,22,240
45681479@N04,4348,26,1298733923,1298734103,2,22,180
45681479@N04,4348,24,1298735565,1298736045,3,22,480
45681479@N04,4348,21,1298738833,1298739186,3,22,353
45681479@N04,4348,24,1298739186,1298739666,3,22,480
45681479@N04,4348,17,1298744420,1298744825,11,22,405
45681479@N04,4348,22,1298744825,1298745425,2,22,600
45681479@N04,4348,27,1298746260,1298747460,4,22,1200
45681479@N04,4348,3,1298749055,1298749325,3,22,270
45681479@N04,4348,25,1298750169,1298750919,3,22,750
45681479@N04,4348,18,1298751418,1298753218,2,22,1800
45681479@N04,4348,19,1298754098,1298754518,7,22,420
45681479@N04,4348,17,1298761852,1298763232,14,22,1380
45681479@N04,4348,9,1298763348,1298763588,3,22,240
45681479@N04,4348,4,1298766970,1298767870,1,22,900
45716980@N00,4349,27,1327441421,1327442621,13,24,1200
45716980@N00,4349,25,1327443103,1327443853,3,24,750
45716980@N00,4349,26,1327444349,1327444480,3,24,131
45716980@N00,4349,17,1327444480,1327444780,5,24,300
45716980@N00,4349,24,1327444780,1327445025,3,24,245
45716980@N00,4349,25,1327445025,1327445775,7,24,750
45716980@N00,4349,9,1327446456,1327446696,5,24,240
45716980@N00,4349,6,1327448356,1327448611,2,24,255
45716980@N00,4349,1,1327448899,1327449138,2,24,239
45716980@N00,4349,6,1327449138,1327449393,2,24,255
45716980@N00,4349,3,1327449641,1327449911,2,24,270
45716980@N00,4349,27,1327450049,1327451249,2,24,1200
45716980@N00,4349,4,1327452178,1327453078,2,24,900
45716980@N00,4349,16,1327453151,1327453480,2,24,329
45716980@N00,4349,17,1327453480,1327454362,2,24,882
45716980@N00,4349,25,1327454362,1327454814,4,24,452
45716980@N00,4349,24,1327454814,1327454865,2,24,51
45716980@N00,4349,25,1327454865,1327455615,17,24,750
45716980@N00,4349,22,1327463751,1327464160,3,24,409
45716980@N00,4349,20,1327464160,1327464713,4,24,553
45716980@N00,4349,18,1327464713,1327466513,4,24,1800
45716980@N00,4349,25,1327468117,1327468867,12,24,750
45716980@N00,4349,4,1327479437,1327479668,2,24,231
45716980@N00,4349,25,1327479668,1327480418,1,24,750
45716980@N00,4350,16,1362027008,1362027728,2,12,720
45716980@N00,4350,27,1362028163,1362028771,2,12,608
45716980@N00,4350,26,1362028771,1362028784,2,12,13
45716980@N00,4350,25,1362028784,1362029534,7,12,750
45716980@N00,4350,18,1362030864,1362031356,14,12,492
45716980@N00,4350,22,1362031356,1362031537,2,12,181
45716980@N00,4350,18,1362031537,1362031553,3,12,16
45716980@N00,4350,19,1362031553,1362031973,9,12,420
45716980@N00,4350,18,1362032138,1362032866,4,12,728
45716980@N00,4350,14,1362032866,1362032986,2,12,120
45716980@N00,4350,10,1362033048,1362033468,4,12,420
45716980@N00,4350,9,1362033935,1362034175,3,12,240
45716980@N00,4351,16,1362091320,1362092040,1,1,720
45716980@N00,4352,14,1362176679,1362176799,2,2,120
45716980@N00,4352,16,1362179629,1362180349,1,2,720
45718773@N00,4353,16,1234704617,1234705337,1,1,720
45730150@N02,4354,16,1307955630,1307956350,1,1,720
45749280@N00,4355,27,1303942114,1303942892,2,13,778
45749280@N00,4355,4,1303942892,1303943016,2,13,124
45749280@N00,4355,2,1303943016,1303943106,2,13,90
45749280@N00,4355,1,1303943167,1303943767,3,13,600
45749280@N00,4355,24,1303945753,1303946233,3,13,480
45749280@N00,4355,19,1303949654,1303950074,3,13,420
45749280@N00,4355,13,1303950910,1303951510,6,13,600
45749280@N00,4355,12,1303952985,1303953825,4,13,840
45749280@N00,4355,18,1303958215,1303958468,3,13,253
45749280@N00,4355,19,1303958468,1303958888,2,13,420
45749280@N00,4355,18,1303958950,1303960750,2,13,1800
45749280@N00,4355,3,1303965078,1303965348,2,13,270
45749280@N00,4355,17,1303967112,1303968492,2,13,1380
45749280@N00,4356,27,1304299033,1304300233,4,1,1200
45749280@N00,4357,18,1304340351,1304340479,2,2,128
45749280@N00,4357,13,1304340479,1304341079,2,2,600
45749280@N00,4358,3,1412998596,1412998866,3,12,270
45749280@N00,4358,13,1413003251,1413003851,2,12,600
45749280@N00,4358,22,1413006797,1413007397,2,12,600
45749280@N00,4358,19,1413020911,1413021331,2,12,420
45749280@N00,4358,18,1413023310,1413024495,4,12,1185
45749280@N00,4358,19,1413024495,1413024651,3,12,156
45749280@N00,4358,18,1413024651,1413026451,2,12,1800
45749280@N00,4358,17,1413027629,1413029009,2,12,1380
45749280@N00,4358,14,1413030155,1413030275,2,12,120
45749280@N00,4358,16,1413045446,1413045855,2,12,409
45749280@N00,4358,14,1413045855,1413045975,2,12,120
45749280@N00,4358,16,1413046018,1413046738,1,12,720
45749280@N00,4359,13,1413727035,1413727635,6,2,600
45749280@N00,4359,27,1413731104,1413732304,3,2,1200
45756179@N03,4360,14,1315979564,1315979649,2,12,85
45756179@N03,4360,16,1315979649,1315980124,2,12,475
45756179@N03,4360,26,1315980124,1315980304,2,12,180
45756179@N03,4360,21,1315981088,1315981538,2,12,450
45756179@N03,4360,19,1315983302,1315983722,2,12,420
45756179@N03,4360,23,1315988620,1315988710,2,12,90
45756179@N03,4360,19,1315991113,1315991533,2,12,420
45756179@N03,4360,13,1315993737,1315994337,4,12,600
45756179@N03,4360,16,1315995003,1315995723,2,12,720
45756179@N03,4360,24,1316003430,1316003910,2,12,480
45756179@N03,4360,23,1316004824,1316004914,2,12,90
45756179@N03,4360,27,1316012837,1316014037,5,12,1200
45769608@N00,4361,9,1219805471,1219805711,2,1,240
45771081@N02,4362,16,1390343006,1390343726,1,1,720
45777165@N00,4363,14,1248175520,1248175640,2,2,120
45777165@N00,4363,27,1248181151,1248182351,1,2,1200
45842774@N00,4364,16,1221959569,1221960289,2,2,720
45842774@N00,4364,8,1221961857,1221961977,2,2,120
45842774@N00,4365,20,1223347368,1223348448,1,1,1080
45842774@N00,4366,27,1237943580,1237944780,1,1,1200
45842774@N00,4367,14,1249216951,1249217071,2,2,120
45842774@N00,4367,16,1249217517,1249218237,1,2,720
45842774@N00,4368,18,1249359146,1249359904,2,4,758
45842774@N00,4368,17,1249359904,1249360091,3,4,187
45842774@N00,4368,15,1249360091,1249360271,3,4,180
45842774@N00,4368,14,1249380139,1249380259,2,4,120
45842803@N00,4369,25,1254524627,1254525377,6,5,750
45842803@N00,4369,19,1254525512,1254525932,2,5,420
45842803@N00,4369,17,1254528846,1254529068,2,5,222
45842803@N00,4369,16,1254529068,1254529788,2,5,720
45842803@N00,4369,24,1254530988,1254531468,2,5,480
45848087@N03,4370,15,1455517449,1455517629,1,1,180
45886439@N06,4371,16,1301723062,1301723782,1,1,720
45906008@N00,4372,27,1340578975,1340580175,16,1,1200
45913899@N02,4373,7,1354343263,1354343353,1,1,90
45936897@N07,4374,27,1292557413,1292558613,4,11,1200
45936897@N07,4374,14,1292558671,1292558791,6,11,120
45936897@N07,4374,17,1292563717,1292563926,3,11,209
45936897@N07,4374,22,1292563926,1292564526,2,11,600
45936897@N07,4374,21,1292566199,1292566649,2,11,450
45936897@N07,4374,18,1292570335,1292572135,2,11,1800
45936897@N07,4374,1,1292575932,1292575974,2,11,42
45936897@N07,4374,7,1292575974,1292576017,5,11,43
45936897@N07,4374,1,1292576017,1292576617,3,11,600
45936897@N07,4374,3,1292577643,1292577913,3,11,270
45936897@N07,4374,27,1292590039,1292591239,2,11,1200
45959609@N00,4375,20,1343899311,1343900391,2,2,1080
45959609@N00,4375,6,1343910500,1343910755,1,2,255
45959609@N00,4376,3,1368222339,1368222609,3,2,270
45959609@N00,4376,1,1368224538,1368225138,2,2,600
45959609@N00,4377,10,1368323359,1368323543,2,2,184
45959609@N00,4377,27,1368323543,1368324743,1,2,1200
45959609@N00,4378,10,1374205421,1374205841,2,2,420
45959609@N00,4378,27,1374222323,1374223523,1,2,1200
45959609@N00,4379,27,1393668054,1393669254,1,1,1200
45959609@N00,4380,20,1407557109,1407558189,1,1,1080
45959609@N00,4381,10,1429309651,1429310071,2,2,420
45959609@N00,4381,20,1429315303,1429316383,1,2,1080
45968077@N02,4382,27,1350172997,1350174197,2,6,1200
45968077@N02,4382,14,1350174329,1350174449,2,6,120
45968077@N02,4382,12,1350177323,1350178163,2,6,840
45968077@N02,4382,10,1350178184,1350178604,9,6,420
45968077@N02,4382,8,1350183134,1350183149,2,6,15
45968077@N02,4382,11,1350183149,1350183329,3,6,180
46023761@N08,4383,27,1307785931,1307787131,9,5,1200
46023761@N08,4383,16,1307787742,1307787945,3,5,203
46023761@N08,4383,4,1307787945,1307788845,7,5,900
46023761@N08,4383,16,1307792393,1307793113,24,5,720
46023761@N08,4383,27,1307796652,1307797852,4,5,1200
46023761@N08,4384,12,1308215152,1308215992,22,2,840
46023761@N08,4384,16,1308224973,1308225693,17,2,720
46027550@N00,4385,21,1236651278,1236651728,2,2,450
46027550@N00,4385,3,1236669810,1236670080,1,2,270
46027550@N00,4386,1,1236903769,1236904369,1,1,600
46050386@N03,4387,27,1242686608,1242687257,2,15,649
46050386@N03,4387,20,1242687257,1242687325,2,15,68
46050386@N03,4387,19,1242687325,1242687346,2,15,21
46050386@N03,4387,20,1242687346,1242687809,2,15,463
46050386@N03,4387,19,1242687809,1242688130,2,15,321
46050386@N03,4387,20,1242688130,1242689210,19,15,1080
46050386@N03,4387,21,1242689382,1242689832,4,15,450
46050386@N03,4387,24,1242690856,1242691336,3,15,480
46050386@N03,4387,22,1242692867,1242693467,2,15,600
46050386@N03,4387,13,1242693624,1242694224,7,15,600
46050386@N03,4387,18,1242697565,1242697907,2,15,342
46050386@N03,4387,13,1242697907,1242698507,2,15,600
46050386@N03,4387,16,1242699855,1242700501,2,15,646
46050386@N03,4387,12,1242700501,1242701341,12,15,840
46050386@N03,4387,17,1242703181,1242704561,1,15,1380
46050386@N03,4388,27,1242876446,1242877054,2,2,608
46050386@N03,4388,2,1242877054,1242877144,1,2,90
46050386@N03,4389,16,1242974625,1242975345,2,8,720
46050386@N03,4389,12,1242976255,1242977095,2,8,840
46050386@N03,4389,13,1242977174,1242977555,2,8,381
46050386@N03,4389,22,1242977555,1242977566,2,8,11
46050386@N03,4389,26,1242977566,1242977746,6,8,180
46050386@N03,4389,22,1242978721,1242979321,4,8,600
46050386@N03,4389,20,1242979493,1242980573,8,8,1080
46050386@N03,4389,21,1242980829,1242981279,1,8,450
46050386@N03,4390,8,1262864767,1262864791,3,2,24
46050386@N03,4390,20,1262864791,1262865871,1,2,1080
46050386@N03,4391,1,1280800791,1280801391,3,1,600
46083863@N06,4392,22,1319332213,1319332813,1,1,600
46108419@N00,4393,16,1257027424,1257028144,9,17,720
46108419@N00,4393,17,1257028762,1257028942,5,17,180
46108419@N00,4393,18,1257028942,1257028951,2,17,9
46108419@N00,4393,20,1257028951,1257029059,2,17,108
46108419@N00,4393,26,1257029059,1257029223,2,17,164
46108419@N00,4393,22,1257029223,1257029823,9,17,600
46108419@N00,4393,24,1257030031,1257030511,9,17,480
46108419@N00,4393,17,1257031485,1257031911,2,17,426
46108419@N00,4393,26,1257031911,1257032091,14,17,180
46108419@N00,4393,18,1257033577,1257035377,11,17,1800
46108419@N00,4393,13,1257035581,1257036181,4,17,600
46108419@N00,4393,12,1257036687,1257036888,2,17,201
46108419@N00,4393,14,1257036888,1257037008,6,17,120
46108419@N00,4393,8,1257038435,1257038555,29,17,120
46108419@N00,4393,2,1257041098,1257041188,2,17,90
46108419@N00,4393,8,1257044857,1257044977,2,17,120
46108419@N00,4393,16,1257047232,1257047952,2,17,720
46108419@N00,4394,16,1452400924,1452401644,1,1,720
46229761@N02,4395,6,1307303373,1307303628,1,1,255
46229761@N02,4396,16,1307648494,1307649214,1,1,720
46272979@N08,4397,3,1293016472,1293016742,2,2,270
46272979@N08,4397,12,1293017969,1293018809,1,2,840
46328592@N00,4398,27,1267921794,1267922994,2,5,1200
46328592@N00,4398,21,1267924215,1267924665,3,5,450
46328592@N00,4398,19,1267928664,1267929084,7,5,420
46328592@N00,4398,26,1267930298,1267930478,5,5,180
46328592@N00,4398,15,1267936455,1267936635,6,5,180
46328592@N00,4399,21,1268960268,1268960718,1,1,450
46334439@N04,4400,16,1262939727,1262940447,2,1,720
46360199@N06,4401,27,1408231401,1408232601,1,1,1200
46364076@N02,4402,16,1258746114,1258746834,3,1,720
46364076@N02,4403,16,1284879829,1284880549,32,1,720
46401409@N00,4404,27,1467176766,1467177966,4,1,1200
46401409@N00,4405,14,1467206117,1467206237,2,1,120
46419214@N06,4406,8,1212398481,1212398601,1,1,120
46419214@N06,4407,16,1293444079,1293444799,1,1,720
46453719@N00,4408,20,1205698309,1205699389,2,6,1080
46453719@N00,4408,2,1205706990,1205707080,2,6,90
46453719@N00,4408,11,1205709139,1205709319,2,6,180
46453719@N00,4408,15,1205709762,1205709942,3,6,180
46453719@N00,4408,21,1205713549,1205713999,2,6,450
46453719@N00,4408,1,1205730163,1205730763,1,6,600
46453719@N00,4409,18,1205922008,1205923808,1,1,1800
46453719@N00,4410,25,1206053966,1206054716,1,1,750
46453719@N00,4411,13,1230615884,1230616484,2,1,600
46514221@N03,4412,18,1392939817,1392941617,1,1,1800
46592338@N04,4413,26,1274096921,1274097101,1,1,180
46602694@N00,4414,15,1294787375,1294787555,1,1,180
46602694@N00,4415,21,1317541505,1317541955,1,1,450
46602694@N00,4416,27,1317677077,1317678277,1,1,1200
46602694@N00,4417,14,1355178010,1355178130,2,3,120
46602694@N00,4417,9,1355181081,1355181321,2,3,240
46602694@N00,4417,27,1355190823,1355192023,1,3,1200
46602694@N00,4418,14,1355621437,1355621557,2,2,120
46602694@N00,4418,13,1355629571,1355630171,1,2,600
46602694@N00,4419,14,1357852282,1357852402,3,7,120
46602694@N00,4419,15,1357853709,1357853805,2,7,96
46602694@N00,4419,17,1357853805,1357855185,2,7,1380
46602694@N00,4419,18,1357857678,1357859478,3,7,1800
46602694@N00,4419,2,1357874981,1357875071,2,7,90
46602694@N00,4419,1,1357876020,1357876620,2,7,600
46602694@N00,4419,27,1357894375,1357895575,1,7,1200
46602694@N00,4420,21,1372307269,1372307719,1,1,450
46602694@N00,4421,8,1372486552,1372486672,1,1,120
46602694@N00,4422,16,1372554449,1372555169,1,1,720
46602694@N00,4423,16,1389502007,1389502727,2,2,720
46602694@N00,4423,21,1389505449,1389505899,1,2,450
46602694@N00,4424,14,1394411122,1394411242,1,1,120
46602694@N00,4425,17,1414812476,1414813856,1,1,1380
46602694@N00,4426,20,1415361057,1415362137,2,2,1080
46602694@N00,4426,27,1415362783,1415363983,1,2,1200
46623443@N00,4427,24,1392439934,1392440414,2,2,480
46623443@N00,4427,27,1392468400,1392469600,1,2,1200
46649528@N04,4428,27,1285328675,1285329875,2,1,1200
46649528@N04,4429,27,1348565279,1348566479,1,1,1200
46659210@N07,4430,13,1305770620,1305771220,1,1,600
46671006@N00,4431,27,1253404464,1253405664,7,2,1200
46671006@N00,4431,1,1253407771,1253408371,1,2,600
46724048@N00,4432,19,1294543366,1294543786,2,4,420
46724048@N00,4432,14,1294552477,1294552597,2,4,120
46724048@N00,4432,12,1294554976,1294555816,3,4,840
46724048@N00,4432,22,1294561266,1294561866,1,4,600
46724048@N00,4433,27,1295326253,1295326661,2,4,408
46724048@N00,4433,16,1295326661,1295326873,2,4,212
46724048@N00,4433,13,1295326873,1295327473,2,4,600
46724048@N00,4433,27,1295335771,1295336971,1,4,1200
46724048@N00,4434,4,1325988188,1325989088,1,1,900
46738052@N00,4435,23,1429576130,1429576220,2,2,90
46738052@N00,4435,21,1429576349,1429576799,1,2,450
46772713@N04,4436,16,1388056996,1388057716,1,1,720
46814333@N00,4437,4,1190960597,1190961497,1,1,900
46818794@N00,4438,5,1282530656,1282531376,17,1,720
46818794@N00,4439,5,1287726326,1287727046,1,1,720
46818794@N00,4440,21,1289979334,1289979784,2,1,450
46866350@N00,4441,27,1293836033,1293837233,3,11,1200
46866350@N00,4441,3,1293837656,1293837926,4,11,270
46866350@N00,4441,12,1293840126,1293840332,2,11,206
46866350@N00,4441,9,1293840332,1293840531,3,11,199
46866350@N00,4441,12,1293840531,1293841371,4,11,840
46866350@N00,4441,20,1293844999,1293846079,2,11,1080
46866350@N00,4441,26,1293848372,1293848482,2,11,110
46866350@N00,4441,25,1293848482,1293849232,2,11,750
46866350@N00,4441,2,1293854827,1293854917,2,11,90
46866350@N00,4441,14,1293858755,1293858875,2,11,120
46866350@N00,4441,27,1293859758,1293860958,1,11,1200
46879553@N00,4442,16,1210993073,1210993793,2,1,720
46993544@N00,4443,2,1419367477,1419367567,2,2,90
46993544@N00,4443,21,1419372557,1419373007,1,2,450
47003653@N00,4444,27,1396912822,1396914022,2,12,1200
47003653@N00,4444,12,1396916854,1396917103,2,12,249
47003653@N00,4444,15,1396917103,1396917283,2,12,180
47003653@N00,4444,27,1396930237,1396931437,15,12,1200
47003653@N00,4444,8,1396942992,1396943112,2,12,120
47003653@N00,4444,17,1396950641,1396951126,3,12,485
47003653@N00,4444,13,1396951126,1396951726,3,12,600
47003653@N00,4444,15,1396952551,1396952666,2,12,115
47003653@N00,4444,12,1396952666,1396952900,2,12,234
47003653@N00,4444,15,1396952900,1396953080,3,12,180
47003653@N00,4444,14,1396953395,1396953515,2,12,120
47003653@N00,4444,27,1396955615,1396956815,9,12,1200
47064447@N00,4445,27,1351332213,1351332755,3,3,542
47064447@N00,4445,6,1351332755,1351333010,2,3,255
47064447@N00,4445,27,1351340032,1351341232,2,3,1200
47087576@N00,4446,12,1212889240,1212890080,2,2,840
47087576@N00,4446,26,1212903620,1212903800,3,2,180
47087576@N00,4447,4,1213152010,1213152910,2,3,900
47087576@N00,4447,26,1213153554,1213153734,3,3,180
47087576@N00,4447,14,1213181900,1213182020,1,3,120
47125846@N08,4448,27,1268463888,1268465088,3,3,1200
47125846@N08,4448,22,1268467902,1268468502,2,3,600
47125846@N08,4448,21,1268469052,1268469502,1,3,450
47125846@N08,4449,12,1273143717,1273144300,5,3,583
47125846@N08,4449,14,1273144300,1273144420,2,3,120
47125846@N08,4449,3,1273145859,1273146129,1,3,270
47125846@N08,4450,17,1280035116,1280036496,1,1,1380
47125846@N08,4451,27,1282978258,1282979458,4,5,1200
47125846@N08,4451,13,1282986037,1282986637,2,5,600
47125846@N08,4451,16,1282987483,1282987626,2,5,143
47125846@N08,4451,5,1282987626,1282988346,2,5,720
47125846@N08,4451,4,1282998419,1282999319,1,5,900
47125846@N08,4452,12,1291867056,1291867896,4,7,840
47125846@N08,4452,13,1291870074,1291870674,4,7,600
47125846@N08,4452,18,1291872294,1291872769,2,7,475
47125846@N08,4452,22,1291872769,1291873369,2,7,600
47125846@N08,4452,18,1291874200,1291875620,2,7,1420
47125846@N08,4452,21,1291875620,1291876070,3,7,450
47125846@N08,4452,24,1291876758,1291877238,2,7,480
47125846@N08,4453,9,1293714912,1293715152,2,3,240
47125846@N08,4453,14,1293715660,1293715780,3,3,120
47125846@N08,4453,9,1293717518,1293717758,1,3,240
47125846@N08,4454,14,1294477410,1294477530,2,2,120
47125846@N08,4454,26,1294482449,1294482629,1,2,180
47125846@N08,4455,25,1295670237,1295670987,2,4,750
47125846@N08,4455,21,1295672487,1295672937,2,4,450
47125846@N08,4455,18,1295673059,1295674859,4,4,1800
47125846@N08,4455,19,1295675480,1295675900,1,4,420
47125846@N08,4456,17,1299192353,1299193733,2,5,1380
47125846@N08,4456,20,1299194021,1299195101,2,5,1080
47125846@N08,4456,21,1299196088,1299196538,3,5,450
47125846@N08,4456,19,1299198241,1299198661,2,5,420
47125846@N08,4456,15,1299203726,1299203906,1,5,180
47125846@N08,4457,3,1301217520,1301217790,2,2,270
47125846@N08,4457,23,1301223847,1301223937,1,2,90
47125846@N08,4458,13,1302167079,1302167679,5,6,600
47125846@N08,4458,14,1302171030,1302171150,2,6,120
47125846@N08,4458,15,1302171773,1302171953,2,6,180
47125846@N08,4458,13,1302172795,1302173395,2,6,600
47125846@N08,4458,18,1302173692,1302175492,2,6,1800
47125846@N08,4458,13,1302176121,1302176721,1,6,600
47125846@N08,4459,27,1304130680,1304131880,2,6,1200
47125846@N08,4459,24,1304139400,1304139880,3,6,480
47125846@N08,4459,23,1304141345,1304141435,2,6,90
47125846@N08,4459,13,1304144428,1304145028,6,6,600
47125846@N08,4459,12,1304146832,1304147672,2,6,840
47125846@N08,4459,9,1304149233,1304149473,3,6,240
47125846@N08,4460,4,1305712167,1305713067,4,3,900
47125846@N08,4460,5,1305714696,1305714895,2,3,199
47125846@N08,4460,4,1305714895,1305715795,1,3,900
47125846@N08,4461,4,1306573165,1306574065,3,4,900
47125846@N08,4461,13,1306575619,1306576199,3,4,580
47125846@N08,4461,26,1306576199,1306576379,2,4,180
47125846@N08,4461,15,1306585095,1306585275,1,4,180
47125846@N08,4462,26,1307099149,1307099329,3,3,180
47125846@N08,4462,20,1307107269,1307108349,2,3,1080
47125846@N08,4462,26,1307108975,1307109155,1,3,180
47125846@N08,4463,22,1309696537,1309697137,2,1,600
47125846@N08,4464,16,1313229930,1313230650,1,1,720
47125846@N08,4465,17,1315992205,1315993585,2,1,1380
47125846@N08,4466,19,1317455657,1317456077,4,4,420
47125846@N08,4466,26,1317474334,1317474514,2,4,180
47125846@N08,4466,15,1317475509,1317475689,2,4,180
47125846@N08,4466,2,1317478488,1317478578,1,4,90
47125846@N08,4467,17,1317544320,1317545700,2,3,1380
47125846@N08,4467,26,1317546677,1317546857,2,3,180
47125846@N08,4467,13,1317557917,1317558517,5,3,600
47125846@N08,4468,23,1317640781,1317640871,3,2,90
47125846@N08,4468,27,1317644204,1317645404,1,2,1200
47125846@N08,4469,17,1317803525,1317804602,2,2,1077
47125846@N08,4469,6,1317804602,1317804857,1,2,255
47125846@N08,4470,17,1319287427,1319288807,1,1,1380
47125846@N08,4471,21,1324633279,1324633729,1,1,450
47125846@N08,4472,4,1327820874,1327821774,1,1,900
47125846@N08,4473,4,1328353934,1328354834,2,2,900
47125846@N08,4473,3,1328355984,1328356254,1,2,270
47125846@N08,4474,6,1328518192,1328518447,1,1,255
47125846@N08,4475,16,1330456862,1330457582,2,4,720
47125846@N08,4475,17,1330460482,1330461687,3,4,1205
47125846@N08,4475,24,1330461687,1330462045,2,4,358
47125846@N08,4475,26,1330462045,1330462225,1,4,180
47125846@N08,4476,21,1330773348,1330773798,1,1,450
47125846@N08,4477,8,1331538060,1331538180,6,1,120
47125846@N08,4478,24,1333243460,1333243940,2,3,480
47125846@N08,4478,13,1333245666,1333246266,2,3,600
47125846@N08,4478,24,1333249478,1333249958,1,3,480
47125846@N08,4479,22,1333863057,1333863657,1,1,600
47125846@N08,4480,27,1336212654,1336213854,1,1,1200
47125846@N08,4481,2,1337253103,1337253193,1,1,90
47125846@N08,4482,4,1338197633,1338198533,1,1,900
47125846@N08,4483,2,1339845394,1339845484,1,1,90
47125846@N08,4484,3,1341296929,1341297199,1,1,270
47125846@N08,4485,27,1348968660,1348969860,5,5,1200
47125846@N08,4485,20,1348996078,1348997158,2,5,1080
47125846@N08,4485,22,1349007758,1349008358,2,5,600
47125846@N08,4485,13,1349009988,1349010588,4,5,600
47125846@N08,4485,27,1349012015,1349013215,3,5,1200
47125846@N08,4486,10,1350184720,1350185140,1,1,420
47125846@N08,4487,10,1351980021,1351980441,4,2,420
47125846@N08,4487,12,1351989377,1351990217,1,2,840
47125846@N08,4488,10,1354368192,1354368612,1,1,420
47125846@N08,4489,27,1354786686,1354787886,4,1,1200
47125846@N08,4490,27,1356843832,1356845032,1,1,1200
47125846@N08,4491,4,1359807819,1359808719,1,1,900
47125846@N08,4492,13,1363506878,1363507478,1,1,600
47125846@N08,4493,4,1373190414,1373191314,1,1,900
47125846@N08,4494,10,1373711310,1373711730,4,1,420
47125846@N08,4495,27,1378615201,1378616401,2,2,1200
47125846@N08,4495,3,1378622403,1378622673,3,2,270
47125846@N08,4496,14,1379589142,1379589262,1,1,120
47125846@N08,4497,9,1381566321,1381566561,2,3,240
47125846@N08,4497,21,1381569698,1381570148,2,3,450
47125846@N08,4497,3,1381574302,1381574572,1,3,270
47125846@N08,4498,27,1383376970,1383378170,2,2,1200
47125846@N08,4498,4,1383399046,1383399946,1,2,900
47125846@N08,4499,27,1386237571,1386238771,3,1,1200
47125846@N08,4500,13,1387627216,1387627816,1,1,600
47125846@N08,4501,10,1391861976,1391862396,1,1,420
47125846@N08,4502,22,1392620570,1392621170,2,5,600
47125846@N08,4502,17,1392627104,1392627504,2,5,400
47125846@N08,4502,16,1392627504,1392628224,2,5,720
47125846@N08,4502,10,1392630115,1392630535,3,5,420
47125846@N08,4502,14,1392635468,1392635588,1,5,120
47136771@N03,4503,17,1346499151,1346500531,3,2,1380
47136771@N03,4503,27,1346502275,1346503475,16,2,1200
47136771@N03,4504,4,1347094656,1347095556,2,1,900
47136771@N03,4505,20,1347417646,1347418726,2,3,1080
47136771@N03,4505,27,1347421760,1347422960,3,3,1200
47136771@N03,4505,4,1347429226,1347430126,2,3,900
47136771@N03,4506,27,1347536843,1347538043,1,1,1200
47136771@N03,4507,9,1347581404,1347581644,2,2,240
47136771@N03,4507,8,1347582244,1347582364,1,2,120
47189760@N05,4508,9,1359215548,1359215632,2,2,84
47189760@N05,4508,16,1359215632,1359216352,3,2,720
47189760@N05,4509,1,1359529260,1359529860,2,5,600
47189760@N05,4509,27,1359536921,1359536997,2,5,76
47189760@N05,4509,10,1359536997,1359537417,7,5,420
47189760@N05,4509,9,1359539102,1359539308,4,5,206
47189760@N05,4509,8,1359539308,1359539428,3,5,120
47223527@N05,4510,27,1412312075,1412313275,1,1,1200
47340152@N06,4511,23,1352714658,1352714748,1,1,90
47343648@N04,4512,5,1271141627,1271142347,2,2,720
47343648@N04,4512,27,1271152501,1271153701,1,2,1200
47363316@N08,4513,27,1330046891,1330048091,2,2,1200
47363316@N08,4513,9,1330058225,1330058465,1,2,240
47365658@N00,4514,6,1278682590,1278682845,1,1,255
47373126@N03,4515,16,1292740236,1292740956,1,1,720
47391741@N04,4516,27,1310097121,1310098321,2,1,1200
47423151@N06,4517,3,1318295723,1318295993,2,4,270
47423151@N06,4517,14,1318319344,1318319464,2,4,120
47423151@N06,4517,16,1318324484,1318324532,2,4,48
47423151@N06,4517,13,1318324532,1318325132,2,4,600
47423151@N06,4518,27,1318370238,1318371438,1,1,1200
47423151@N06,4519,14,1321347747,1321347867,1,1,120
47423151@N06,4520,27,1368864895,1368866095,1,1,1200
47423151@N06,4521,19,1380778224,1380778644,1,1,420
47423151@N06,4522,16,1381155408,1381156128,1,1,720
47423151@N06,4523,15,1399618074,1399618254,2,2,180
47423151@N06,4523,25,1399632843,1399633593,1,2,750
47423151@N06,4524,14,1415507052,1415507172,1,1,120
47473683@N06,4525,4,1265792943,1265793843,1,1,900
47522010@N03,4526,16,1302086516,1302087236,1,1,720
47522010@N03,4527,25,1316769260,1316770010,1,1,750
47567986@N00,4528,17,1303348054,1303349434,5,1,1380
47580197@N07,4529,4,1279309891,1279310791,177,2,900
47580197@N07,4529,22,1279361985,1279362585,58,2,600
47580197@N07,4530,22,1279401403,1279402003,100,1,600
47580197@N07,4531,22,1279489673,1279490273,10,2,600
47580197@N07,4531,21,1279497263,1279497713,1,2,450
47597914@N00,4532,25,1298492902,1298493652,2,7,750
47597914@N00,4532,18,1298503228,1298505028,2,7,1800
47597914@N00,4532,25,1298511001,1298511751,3,7,750
47597914@N00,4532,2,1298515124,1298515214,3,7,90
47597914@N00,4532,1,1298516127,1298516727,2,7,600
47597914@N00,4532,4,1298517675,1298518575,4,7,900
47597914@N00,4532,9,1298521929,1298522169,3,7,240
47606840@N00,4533,15,1379890290,1379890470,2,4,180
47606840@N00,4533,18,1379893049,1379894231,3,4,1182
47606840@N00,4533,16,1379894231,1379894716,3,4,485
47606840@N00,4533,3,1379894716,1379894986,1,4,270
47615165@N04,4534,16,1357870096,1357870816,5,10,720
47615165@N04,4534,14,1357872430,1357872465,3,10,35
47615165@N04,4534,16,1357872465,1357872812,3,10,347
47615165@N04,4534,10,1357872812,1357873016,6,10,204
47615165@N04,4534,14,1357873016,1357873136,3,10,120
47615165@N04,4534,10,1357874646,1357875066,9,10,420
47615165@N04,4534,7,1357878251,1357878332,2,10,81
47615165@N04,4534,8,1357878332,1357878452,2,10,120
47615165@N04,4534,16,1357883420,1357884140,6,10,720
47615165@N04,4534,10,1357893828,1357894248,2,10,420
47615165@N04,4535,16,1358015942,1358016091,2,3,149
47615165@N04,4535,17,1358016091,1358016100,2,3,9
47615165@N04,4535,16,1358016100,1358016820,25,3,720
47615165@N04,4536,27,1358066845,1358068045,5,1,1200
47615165@N04,4537,27,1358200467,1358201667,4,4,1200
47615165@N04,4537,17,1358212327,1358212366,2,4,39
47615165@N04,4537,10,1358212366,1358212786,2,4,420
47615165@N04,4537,16,1358215706,1358216426,12,4,720
47705525@N06,4538,16,1304670178,1304670208,2,4,30
47705525@N06,4538,4,1304670208,1304670241,2,4,33
47705525@N06,4538,3,1304670241,1304670295,2,4,54
47705525@N06,4538,4,1304670295,1304671195,1,4,900
47705525@N06,4539,16,1306240136,1306240194,2,2,58
47705525@N06,4539,4,1306240194,1306241094,1,2,900
47705525@N06,4540,16,1306315910,1306316630,3,1,720
47705525@N06,4541,16,1307073952,1307074672,2,3,720
47705525@N06,4541,27,1307077002,1307077094,3,3,92
47705525@N06,4541,16,1307077094,1307077814,2,3,720
47705525@N06,4542,27,1308285043,1308285056,3,3,13
47705525@N06,4542,14,1308285056,1308285068,3,3,12
47705525@N06,4542,27,1308285068,1308286268,2,3,1200
47705525@N06,4543,27,1308375224,1308376424,34,1,1200
47705525@N06,4544,27,1313044046,1313045246,4,1,1200
47705525@N06,4545,14,1440839652,1440839772,1,1,120
47722545@N00,4546,23,1355654410,1355654500,1,1,90
47743387@N07,4547,14,1416284005,1416284125,1,1,120
47762796@N03,4548,16,1274686970,1274687060,2,2,90
47762796@N03,4548,2,1274687060,1274687150,1,2,90
47785122@N06,4549,16,1346632447,1346633167,1,1,720
47785122@N06,4550,16,1354400160,1354400880,1,1,720
47785122@N06,4551,3,1363909370,1363909640,2,2,270
47785122@N06,4551,27,1363910006,1363911206,1,2,1200
47785122@N06,4552,1,1367716178,1367716778,1,1,600
47785122@N06,4553,27,1372765252,1372766452,3,1,1200
47785122@N06,4554,19,1378890616,1378891036,1,1,420
47785122@N06,4555,27,1381569024,1381570224,2,2,1200
47785122@N06,4555,3,1381570706,1381570976,1,2,270
47785122@N06,4556,27,1393131762,1393132962,1,1,1200
47845995@N00,4557,17,1338776806,1338778186,2,3,1380
47845995@N00,4557,15,1338787654,1338787834,2,3,180
47845995@N00,4557,27,1338807066,1338808266,2,3,1200
47861479@N02,4558,10,1355607433,1355607853,2,2,420
47861479@N02,4558,14,1355632984,1355633104,1,2,120
47861479@N02,4559,27,1355949456,1355950656,1,1,1200
47861479@N02,4560,20,1381445421,1381446501,3,1,1080
47861479@N02,4561,27,1381478397,1381479597,3,1,1200
47861479@N02,4562,13,1381710326,1381710926,4,2,600
47861479@N02,4562,20,1381719677,1381720757,1,2,1080
47861479@N02,4563,14,1403513114,1403513234,1,1,120
47861479@N02,4564,27,1403697490,1403698690,1,1,1200
47861479@N02,4565,27,1409281553,1409282753,3,3,1200
47861479@N02,4565,14,1409284332,1409284452,2,3,120
47861479@N02,4565,20,1409288449,1409289529,1,3,1080
47861479@N02,4566,1,1418527871,1418528471,2,4,600
47861479@N02,4566,10,1418529795,1418530215,2,4,420
47861479@N02,4566,16,1418534247,1418534967,6,4,720
47861479@N02,4566,27,1418549360,1418550560,1,4,1200
47861479@N02,4567,27,1418802318,1418803518,1,1,1200
47861479@N02,4568,27,1419031191,1419032391,5,1,1200
47861479@N02,4569,8,1432459499,1432459619,1,1,120
47861479@N02,4570,19,1432890470,1432890890,1,1,420
47918842@N00,4571,16,1332888720,1332889440,1,1,720
47918842@N00,4572,14,1332919065,1332919185,1,1,120
47918842@N00,4573,4,1332977644,1332978544,1,1,900
47943464@N06,4574,27,1318326737,1318327937,1,1,1200
47953780@N07,4575,27,1400030866,1400032066,2,2,1200
47953780@N07,4575,2,1400044458,1400044548,1,2,90
48075944@N06,4576,17,1274584568,1274585948,1,1,1380
48105777@N00,4577,27,1275442628,1275443828,2,2,1200
48105777@N00,4577,18,1275456621,1275458421,1,2,1800
48105777@N00,4578,10,1370051455,1370051875,5,1,420
48105777@N00,4579,27,1370168293,1370168521,2,3,228
48105777@N00,4579,17,1370168521,1370169132,3,3,611
48105777@N00,4579,19,1370169132,1370169552,1,3,420
48105777@N00,4580,20,1370250043,1370251123,1,1,1080
48144132@N06,4581,16,1268962982,1268963702,1,1,720
48152295@N00,4582,27,1377957600,1377958800,1,1,1200
48257423@N02,4583,23,1300529050,1300529140,1,1,90
48271781@N00,4584,1,1275696668,1275697268,2,11,600
48271781@N00,4584,3,1275699639,1275699909,2,11,270
48271781@N00,4584,9,1275700673,1275700913,4,11,240
48271781@N00,4584,2,1275701504,1275701532,2,11,28
48271781@N00,4584,5,1275701532,1275702252,2,11,720
48271781@N00,4584,7,1275703845,1275703892,2,11,47
48271781@N00,4584,9,1275703892,1275704132,3,11,240
48271781@N00,4584,14,1275704865,1275704985,2,11,120
48271781@N00,4584,19,1275710434,1275710854,5,11,420
48271781@N00,4584,16,1275734630,1275734705,2,11,75
48271781@N00,4584,17,1275734705,1275736085,12,11,1380
48271781@N00,4585,27,1345344535,1345345735,2,1,1200
48275668@N02,4586,21,1340314524,1340314974,1,1,450
48275668@N02,4587,14,1340493291,1340493411,1,1,120
48275668@N02,4588,27,1347100839,1347102039,2,6,1200
48275668@N02,4588,15,1347116672,1347116852,2,6,180
48275668@N02,4588,10,1347120825,1347121245,2,6,420
48275668@N02,4588,27,1347126476,1347127676,2,6,1200
48275668@N02,4588,14,1347154174,1347154294,3,6,120
48275668@N02,4588,9,1347162443,1347162683,1,6,240
48275668@N02,4589,23,1347285611,1347285701,2,4,90
48275668@N02,4589,26,1347286434,1347286614,2,4,180
48275668@N02,4589,12,1347293324,1347294164,4,4,840
48275668@N02,4589,17,1347303284,1347304664,1,4,1380
48275668@N02,4590,16,1350310734,1350310871,2,4,137
48275668@N02,4590,9,1350310871,1350310986,2,4,115
48275668@N02,4590,14,1350310986,1350311106,2,4,120
48275668@N02,4590,16,1350311528,1350312248,1,4,720
48275668@N02,4591,20,1350392563,1350392935,2,6,372
48275668@N02,4591,17,1350392935,1350393138,2,6,203
48275668@N02,4591,18,1350393138,1350393241,2,6,103
48275668@N02,4591,20,1350393241,1350394279,2,6,1038
48275668@N02,4591,27,1350394279,1350394504,2,6,225
48275668@N02,4591,12,1350394504,1350395344,1,6,840
48275668@N02,4592,6,1350532619,1350532874,2,5,255
48275668@N02,4592,7,1350533125,1350533215,2,5,90
48275668@N02,4592,27,1350533654,1350534854,7,5,1200
48275668@N02,4592,3,1350535689,1350535871,2,5,182
48275668@N02,4592,16,1350535871,1350536591,1,5,720
48275668@N02,4593,27,1350632362,1350633562,3,1,1200
48275668@N02,4594,23,1359360557,1359360647,1,1,90
48275668@N02,4595,27,1363510087,1363511287,1,1,1200
48275668@N02,4596,5,1363669475,1363670195,1,1,720
48275668@N02,4597,16,1374307081,1374307801,1,1,720
48275668@N02,4598,26,1410341994,1410342174,2,2,180
48275668@N02,4598,20,1410344705,1410345785,1,2,1080
48275668@N02,4599,17,1418789532,1418790912,1,1,1380
48275668@N02,4600,17,1425762896,1425764276,1,1,1380
48275668@N02,4601,25,1450234748,1450235498,1,1,750
48275668@N02,4602,19,1457394277,1457394697,1,1,420
48275668@N02,4603,13,1457520739,1457521339,1,1,600
48275668@N02,4604,25,1468971546,1468972296,1,1,750
48275668@N02,4605,4,1469156307,1469157207,1,1,900
48279300@N00,4606,21,1444968497,1444968947,1,1,450
48279300@N00,4607,3,1445119292,1445119562,1,1,270
48311919@N00,4608,18,1367108711,1367110511,1,1,1800
48311919@N00,4609,13,1415668918,1415669119,8,20,201
48311919@N00,4609,17,1415669119,1415669221,3,20,102
48311919@N00,4609,26,1415669221,1415669281,5,20,60
48311919@N00,4609,18,1415669281,1415669314,3,20,33
48311919@N00,4609,26,1415669314,1415669494,2,20,180
48311919@N00,4609,24,1415669911,1415670132,3,20,221
48311919@N00,4609,17,1415670132,1415671512,2,20,1380
48311919@N00,4609,16,1415672181,1415672313,4,20,132
48311919@N00,4609,17,1415672313,1415672654,5,20,341
48311919@N00,4609,20,1415672654,1415672883,5,20,229
48311919@N00,4609,21,1415672883,1415673333,7,20,450
48311919@N00,4609,24,1415673378,1415673858,16,20,480
48311919@N00,4609,14,1415675082,1415675202,22,20,120
48311919@N00,4609,1,1415677628,1415678228,2,20,600
48311919@N00,4609,13,1415678449,1415678475,3,20,26
48311919@N00,4609,18,1415678475,1415678532,2,20,57
48311919@N00,4609,17,1415678532,1415678902,4,20,370
48311919@N00,4609,18,1415678902,1415678936,2,20,34
48311919@N00,4609,19,1415678936,1415679356,14,20,420
48311919@N00,4609,27,1415681085,1415682285,11,20,1200
48311919@N00,4610,14,1418453608,1418453728,15,3,120
48311919@N00,4610,16,1418458723,1418459443,13,3,720
48311919@N00,4610,27,1418461123,1418462323,9,3,1200
48311919@N00,4611,27,1423368622,1423369072,3,5,450
48311919@N00,4611,21,1423369072,1423369522,9,5,450
48311919@N00,4611,1,1423371004,1423371604,6,5,600
48311919@N00,4611,14,1423375483,1423375603,41,5,120
48311919@N00,4611,27,1423385205,1423386405,4,5,1200
48311919@N00,4612,27,1423713811,1423715011,1,1,1200
48311919@N00,4613,16,1426290378,1426291098,33,14,720
48311919@N00,4613,17,1426293073,1426293407,12,14,334
48311919@N00,4613,16,1426293407,1426293491,5,14,84
48311919@N00,4613,17,1426293491,1426293561,6,14,70
48311919@N00,4613,16,1426293561,1426294281,53,14,720
48311919@N00,4613,17,1426294519,1426294566,4,14,47
48311919@N00,4613,16,1426294566,1426294659,6,14,93
48311919@N00,4613,17,1426294659,1426294702,4,14,43
48311919@N00,4613,16,1426294702,1426295422,52,14,720
48311919@N00,4613,17,1426296961,1426297436,4,14,475
48311919@N00,4613,16,1426297436,1426298156,45,14,720
48311919@N00,4613,27,1426300931,1426300933,2,14,2
48311919@N00,4613,16,1426300933,1426300942,4,14,9
48311919@N00,4613,27,1426300942,1426302142,1,14,1200
48311919@N00,4614,27,1430803848,1430805048,84,2,1200
48311919@N00,4614,17,1430806862,1430808242,40,2,1380
48311919@N00,4615,14,1440807422,1440807542,12,4,120
48311919@N00,4615,9,1440808391,1440808631,2,4,240
48311919@N00,4615,14,1440811868,1440811988,21,4,120
48311919@N00,4615,20,1440818305,1440819385,7,4,1080
48427787@N00,4616,4,1320359155,1320360055,3,4,900
48427787@N00,4616,14,1320361677,1320361684,2,4,7
48427787@N00,4616,12,1320361684,1320362524,5,4,840
48427787@N00,4616,21,1320365146,1320365596,2,4,450
48427787@N00,4617,27,1320480961,1320481993,13,9,1032
48427787@N00,4617,17,1320481993,1320483373,2,9,1380
48427787@N00,4617,21,1320484681,1320485131,3,9,450
48427787@N00,4617,18,1320486127,1320486354,3,9,227
48427787@N00,4617,13,1320486354,1320486607,2,9,253
48427787@N00,4617,12,1320486607,1320487447,2,9,840
48427787@N00,4617,13,1320487505,1320487796,2,9,291
48427787@N00,4617,14,1320487796,1320487916,3,9,120
48427787@N00,4617,16,1320487979,1320488699,1,9,720
48427787@N00,4618,27,1320618187,1320619387,4,4,1200
48427787@N00,4618,4,1320620141,1320621041,3,4,900
48427787@N00,4618,25,1320624091,1320624841,4,4,750
48427787@N00,4618,27,1320627991,1320629191,4,4,1200
48481127@N08,4619,1,1356905962,1356906562,2,4,600
48481127@N08,4619,16,1356924051,1356924771,2,4,720
48481127@N08,4619,14,1356933994,1356934114,2,4,120
48481127@N08,4619,16,1356936606,1356937326,2,4,720
48481127@N08,4620,15,1372546023,1372546203,2,2,180
48481127@N08,4620,20,1372553473,1372554553,1,2,1080
48494440@N04,4621,16,1253489092,1253489812,1,1,720
48494440@N04,4622,27,1322974987,1322976187,1,1,1200
48513718@N02,4623,2,1221954900,1221954990,1,1,90
48513718@N02,4624,6,1253403430,1253403685,1,1,255
48513718@N02,4625,27,1253834829,1253836029,2,1,1200
48513718@N02,4626,6,1269082371,1269082626,1,1,255
48600084713@N01,4627,14,1314234765,1314234768,2,2,3
48600084713@N01,4627,16,1314234768,1314235488,1,2,720
48600084713@N01,4628,4,1314360770,1314361670,1,1,900
48600084713@N01,4629,9,1314601278,1314601518,3,1,240
48600084713@N01,4630,6,1314761980,1314762235,1,1,255
48600084713@N01,4631,14,1351851193,1351851313,1,1,120
48600085633@N01,4632,22,1204320187,1204320787,25,1,600
48603464@N05,4633,27,1458160825,1458162025,2,3,1200
48603464@N05,4633,8,1458172481,1458172601,2,3,120
48603464@N05,4633,27,1458174574,1458175774,3,3,1200
48624550@N00,4634,27,1328307674,1328308874,2,7,1200
48624550@N00,4634,3,1328310387,1328310657,11,7,270
48624550@N00,4634,2,1328312888,1328312978,2,7,90
48624550@N00,4634,1,1328317831,1328317862,12,7,31
48624550@N00,4634,7,1328317862,1328317952,2,7,90
48624550@N00,4634,6,1328319462,1328319717,9,7,255
48624550@N00,4634,27,1328334449,1328335649,5,7,1200
48658532@N06,4635,7,1352509653,1352509743,2,4,90
48658532@N06,4635,8,1352510244,1352510364,2,4,120
48658532@N06,4635,7,1352511662,1352511752,3,4,90
48658532@N06,4635,8,1352518555,1352518675,1,4,120
48699368@N08,4636,27,1304317472,1304318672,3,1,1200
48763139@N00,4637,26,1199925378,1199925558,1,1,180
48763139@N00,4638,1,1262927197,1262927797,1,1,600
48763139@N00,4639,4,1294717019,1294717919,1,1,900
48826873@N08,4640,27,1321821663,1321822863,2,1,1200
48826873@N08,4641,8,1328450053,1328450173,1,1,120
48826873@N08,4642,1,1329688108,1329688708,3,4,600
48826873@N08,4642,13,1329693945,1329694545,2,4,600
48826873@N08,4642,18,1329697996,1329699063,2,4,1067
48826873@N08,4642,19,1329699063,1329699483,1,4,420
48826873@N08,4643,4,1335511151,1335512051,2,4,900
48826873@N08,4643,3,1335512399,1335512669,2,4,270
48826873@N08,4643,7,1335515715,1335515805,3,4,90
48826873@N08,4643,13,1335519057,1335519657,1,4,600
48826873@N08,4644,18,1335575918,1335577718,1,1,1800
48826873@N08,4645,27,1344715600,1344716800,1,1,1200
48826873@N08,4646,2,1350521949,1350522039,1,1,90
48826873@N08,4647,2,1411776088,1411776178,1,1,90
48826873@N08,4648,26,1414035879,1414036059,2,1,180
48826873@N08,4649,5,1421810279,1421810999,2,2,720
48826873@N08,4649,4,1421825146,1421826046,1,2,900
48826873@N08,4650,27,1438298901,1438300101,1,1,1200
48826873@N08,4651,13,1456384432,1456385032,1,1,600
48826873@N08,4652,15,1457420837,1457421017,1,1,180
48826873@N08,4653,17,1465376151,1465377531,1,1,1380
48842746@N04,4654,27,1277409932,1277411132,1,1,1200
48861861@N08,4655,4,1403748202,1403749102,2,8,900
48861861@N08,4655,18,1403757011,1403758811,2,8,1800
48861861@N08,4655,15,1403759970,1403760150,2,8,180
48861861@N08,4655,2,1403761528,1403761618,2,8,90
48861861@N08,4655,17,1403764503,1403765883,2,8,1380
48861861@N08,4655,26,1403767426,1403767606,2,8,180
48861861@N08,4655,22,1403770011,1403770159,2,8,148
48861861@N08,4655,1,1403770159,1403770759,1,8,600
48861861@N08,4656,16,1426213309,1426214029,1,1,720
48861861@N08,4657,25,1427103760,1427104510,1,1,750
48861861@N08,4658,16,1427686148,1427686868,1,1,720
48861861@N08,4659,21,1428143694,1428144144,1,1,450
48861861@N08,4660,6,1429086592,1429086847,1,1,255
48861861@N08,4661,1,1430015734,1430016334,1,1,600
48861861@N08,4662,17,1432219525,1432220905,1,1,1380
48861861@N08,4663,7,1434677228,1434677318,1,1,90
48861861@N08,4664,19,1434875967,1434876387,1,1,420
48861861@N08,4665,20,1437088317,1437089397,1,1,1080
48861861@N08,4666,13,1437205236,1437205836,1,1,600
48861861@N08,4667,14,1438375442,1438375562,1,1,120
48861861@N08,4668,4,1438736779,1438737679,1,1,900
48861861@N08,4669,2,1438921534,1438921624,1,1,90
48861861@N08,4670,24,1440560035,1440560515,1,1,480
48861861@N08,4671,7,1441006807,1441006897,1,1,90
48861861@N08,4672,27,1441532566,1441533766,1,1,1200
48861861@N08,4673,3,1441622675,1441622945,1,1,270
48861861@N08,4674,27,1441688209,1441689409,1,1,1200
48861861@N08,4675,14,1441857100,1441857220,1,1,120
48861861@N08,4676,9,1441960665,1441960905,1,1,240
48861861@N08,4677,3,1442205496,1442205766,1,1,270
48861861@N08,4678,20,1443409152,1443410232,1,1,1080
48861861@N08,4679,16,1444525799,1444526519,1,1,720
48861861@N08,4680,25,1445140342,1445141092,1,1,750
48861861@N08,4681,4,1445299406,1445300306,1,1,900
48861861@N08,4682,23,1449026567,1449026657,1,1,90
48861861@N08,4683,12,1449456673,1449457513,1,1,840
48861861@N08,4684,6,1450417774,1450418029,1,1,255
48861861@N08,4685,10,1453334626,1453335046,1,1,420
48861861@N08,4686,21,1453961575,1453962025,1,1,450
48861861@N08,4687,27,1454728609,1454729809,1,1,1200
48861861@N08,4688,26,1454812423,1454812603,1,1,180
48861861@N08,4689,6,1454896604,1454896859,1,1,255
48861861@N08,4690,9,1455665997,1455666237,1,1,240
48861861@N08,4691,9,1456710562,1456710802,1,1,240
48861861@N08,4692,8,1457069781,1457069901,1,1,120
48861861@N08,4693,20,1457227926,1457229006,1,1,1080
48861861@N08,4694,27,1457314497,1457315697,1,1,1200
48861861@N08,4695,6,1460250439,1460250694,1,1,255
48861861@N08,4696,5,1461544548,1461545268,1,1,720
48861861@N08,4697,19,1462155129,1462155549,1,1,420
48861861@N08,4698,6,1464581701,1464581956,1,1,255
48861861@N08,4699,5,1464784456,1464785176,1,1,720
48889050018@N01,4700,11,1296712081,1296712261,2,5,180
48889050018@N01,4700,14,1296713150,1296713270,2,5,120
48889050018@N01,4700,9,1296713667,1296713907,2,5,240
48889050018@N01,4700,2,1296714468,1296714558,2,5,90
48889050018@N01,4700,9,1296715993,1296716233,1,5,240
48889050018@N01,4701,27,1296861544,1296862744,2,3,1200
48889050018@N01,4701,25,1296871185,1296871935,2,3,750
48889050018@N01,4701,2,1296888237,1296888327,1,3,90
48889052497@N01,4702,4,1311584719,1311585619,3,1,900
48889052497@N01,4703,27,1311633038,1311634238,2,2,1200
48889052497@N01,4703,14,1311634837,1311634957,5,2,120
48889052497@N01,4704,27,1311762923,1311764123,6,9,1200
48889052497@N01,4704,14,1311764188,1311764308,2,9,120
48889052497@N01,4704,15,1311764723,1311764903,2,9,180
48889052497@N01,4704,12,1311765018,1311765180,4,9,162
48889052497@N01,4704,13,1311765180,1311765291,3,9,111
48889052497@N01,4704,12,1311765291,1311765537,6,9,246
48889052497@N01,4704,15,1311765537,1311765641,2,9,104
48889052497@N01,4704,13,1311765641,1311765995,4,9,354
48889052497@N01,4704,9,1311765995,1311766235,1,9,240
48889052497@N01,4705,25,1344730660,1344731338,2,5,678
48889052497@N01,4705,23,1344731338,1344731428,5,5,90
48889052497@N01,4705,22,1344733442,1344734042,7,5,600
48889052497@N01,4705,15,1344739146,1344739326,2,5,180
48889052497@N01,4705,13,1344739468,1344740068,1,5,600
48889052497@N01,4706,15,1344770832,1344771012,1,1,180
48889052497@N01,4707,17,1344910600,1344911980,2,4,1380
48889052497@N01,4707,18,1344914922,1344916722,2,4,1800
48889052497@N01,4707,8,1344918231,1344918351,4,4,120
48889052497@N01,4707,4,1344920664,1344921564,1,4,900
48889052497@N01,4708,9,1344990268,1344990508,7,11,240
48889052497@N01,4708,14,1344990840,1344990960,2,11,120
48889052497@N01,4708,15,1344991264,1344991444,5,11,180
48889052497@N01,4708,16,1344992382,1344993102,3,11,720
48889052497@N01,4708,21,1344994263,1344994713,4,11,450
48889052497@N01,4708,23,1344995304,1344995394,2,11,90
48889052497@N01,4708,21,1344995457,1344995627,2,11,170
48889052497@N01,4708,23,1344995627,1344995717,2,11,90
48889052497@N01,4708,22,1344997007,1344997607,2,11,600
48889052497@N01,4708,24,1344998914,1344998918,2,11,4
48889052497@N01,4708,23,1344998918,1344999008,6,11,90
48889052497@N01,4709,27,1345072382,1345073424,4,3,1042
48889052497@N01,4709,16,1345073424,1345074144,2,3,720
48889052497@N01,4709,12,1345080412,1345081252,2,3,840
48889052497@N01,4710,16,1376891302,1376892022,5,3,720
48889052497@N01,4710,27,1376892650,1376893850,2,3,1200
48889052497@N01,4710,22,1376901170,1376901770,2,3,600
48889052497@N01,4711,22,1377149042,1377149642,22,1,600
48889052497@N01,4712,9,1377224514,1377224754,1,1,240
48889119686@N01,4713,27,1352363693,1352364893,1,1,1200
48889119704@N01,4714,17,1273397827,1273399207,4,2,1380
48889119704@N01,4714,22,1273403431,1273404031,5,2,600
48890186@N05,4715,16,1278072758,1278073478,1,1,720
48891180@N00,4716,26,1229889130,1229889310,1,1,180
48891180@N00,4717,27,1230236361,1230237561,2,3,1200
48891180@N00,4717,9,1230244430,1230244663,2,3,233
48891180@N00,4717,16,1230244663,1230245383,3,3,720
48891180@N00,4718,27,1230312703,1230313903,2,1,1200
48900696@N04,4719,27,1404378363,1404379563,1,1,1200
48904826@N06,4720,22,1257818672,1257819272,1,1,600
48922012@N08,4721,27,1283263200,1283264400,4,1,1200
48922012@N08,4722,27,1283509148,1283510348,2,1,1200
48922012@N08,4723,27,1283555729,1283556929,23,1,1200
48938973@N07,4724,4,1379304831,1379305731,1,1,900
48938973@N07,4725,16,1379644223,1379644943,1,1,720
48954567@N02,4726,14,1324459202,1324459322,32,1,120
48980448@N05,4727,4,1263972176,1263973076,1,1,900
48989603@N06,4728,23,1297562753,1297562843,2,4,90
48989603@N06,4728,26,1297591364,1297591544,2,4,180
48989603@N06,4728,25,1297591671,1297591951,2,4,280
48989603@N06,4728,23,1297591951,1297592041,1,4,90
49014295@N06,4729,17,1397090518,1397090899,2,13,381
49014295@N06,4729,16,1397090899,1397091619,2,13,720
49014295@N06,4729,14,1397095920,1397096040,2,13,120
49014295@N06,4729,10,1397096787,1397097207,2,13,420
49014295@N06,4729,5,1397097624,1397098344,2,13,720
49014295@N06,4729,1,1397101222,1397101421,2,13,199
49014295@N06,4729,4,1397101421,1397102321,2,13,900
49014295@N06,4729,21,1397104340,1397104790,2,13,450
49014295@N06,4729,17,1397109064,1397109592,2,13,528
49014295@N06,4729,13,1397109592,1397110192,2,13,600
49014295@N06,4729,4,1397126425,1397127325,11,13,900
49014295@N06,4729,10,1397130250,1397130670,2,13,420
49014295@N06,4729,27,1397133241,1397134441,1,13,1200
49027661@N03,4730,27,1400026177,1400027377,5,8,1200
49027661@N03,4730,23,1400028474,1400028564,2,8,90
49027661@N03,4730,17,1400030414,1400031794,3,8,1380
49027661@N03,4730,4,1400040340,1400041240,2,8,900
49027661@N03,4730,2,1400044652,1400044742,4,8,90
49027661@N03,4730,5,1400044743,1400044981,2,8,238
49027661@N03,4730,6,1400044981,1400045236,2,8,255
49027661@N03,4730,20,1400052534,1400053614,1,8,1080
49027661@N03,4731,22,1400869401,1400869404,2,6,3
49027661@N03,4731,3,1400869404,1400869407,2,6,3
49027661@N03,4731,19,1400869407,1400869702,5,6,295
49027661@N03,4731,22,1400869702,1400869702,2,6,0
49027661@N03,4731,26,1400869702,1400869882,2,6,180
49027661@N03,4731,27,1400869910,1400871110,1,6,1200
49032331@N05,4732,25,1339982514,1339983264,3,3,750
49032331@N05,4732,17,1339986649,1339988029,3,3,1380
49032331@N05,4732,22,1339997110,1339997710,10,3,600
49032331@N05,4733,13,1347637762,1347638362,2,2,600
49032331@N05,4733,20,1347648018,1347649098,1,2,1080
49032331@N05,4734,16,1348145985,1348146705,2,4,720
49032331@N05,4734,2,1348148883,1348148973,2,4,90
49032331@N05,4734,3,1348150173,1348150443,2,4,270
49032331@N05,4734,1,1348178772,1348179372,1,4,600
49032331@N05,4735,27,1348552252,1348553452,2,4,1200
49032331@N05,4735,18,1348555835,1348557635,2,4,1800
49032331@N05,4735,21,1348564516,1348564966,2,4,450
49032331@N05,4735,25,1348567126,1348567876,1,4,750
49032331@N05,4736,24,1353972311,1353972382,6,5,71
49032331@N05,4736,25,1353972382,1353972433,16,5,51
49032331@N05,4736,24,1353972433,1353972533,5,5,100
49032331@N05,4736,25,1353972533,1353972697,8,5,164
49032331@N05,4736,24,1353972697,1353973177,2,5,480
49032331@N05,4737,17,1354444109,1354444382,5,2,273
49032331@N05,4737,22,1354444382,1354444982,1,2,600
49039096@N04,4738,27,1388696602,1388697802,19,1,1200
49052221@N00,4739,27,1366937511,1366938711,1,1,1200
49052221@N00,4740,20,1367023934,1367025014,2,2,1080
49052221@N00,4740,16,1367033398,1367034118,1,2,720
49052221@N00,4741,6,1367119056,1367119311,1,1,255
49075539@N06,4742,16,1298159733,1298160092,2,11,359
49075539@N06,4742,17,1298160092,1298160675,2,11,583
49075539@N06,4742,19,1298160675,1298161095,3,11,420
49075539@N06,4742,17,1298162548,1298163928,2,11,1380
49075539@N06,4742,15,1298167485,1298167665,2,11,180
49075539@N06,4742,26,1298167900,1298168080,4,11,180
49075539@N06,4742,20,1298168652,1298169732,5,11,1080
49075539@N06,4742,16,1298178262,1298178982,2,11,720
49075539@N06,4742,1,1298182021,1298182621,2,11,600
49075539@N06,4742,17,1298184842,1298185705,3,11,863
49075539@N06,4742,16,1298185705,1298186425,11,11,720
49103297@N04,4743,27,1407976185,1407977385,4,15,1200
49103297@N04,4743,13,1407982589,1407983189,2,15,600
49103297@N04,4743,3,1407984428,1407984698,2,15,270
49103297@N04,4743,4,1407984702,1407984751,3,15,49
49103297@N04,4743,3,1407984751,1407985021,8,15,270
49103297@N04,4743,9,1407985674,1407985914,2,15,240
49103297@N04,4743,4,1407992825,1407992901,4,15,76
49103297@N04,4743,5,1407992901,1407992911,2,15,10
49103297@N04,4743,4,1407992911,1407993811,2,15,900
49103297@N04,4743,3,1407997864,1407998134,4,15,270
49103297@N04,4743,6,1408001290,1408001409,7,15,119
49103297@N04,4743,5,1408001409,1408001443,2,15,34
49103297@N04,4743,6,1408001443,1408001698,2,15,255
49103297@N04,4743,4,1408009471,1408010371,4,15,900
49103297@N04,4743,27,1408016126,1408017326,7,15,1200
49109678@N04,4744,4,1251441130,1251442030,2,3,900
49109678@N04,4744,21,1251445280,1251445730,2,3,450
49109678@N04,4744,27,1251457885,1251459085,1,3,1200
49109678@N04,4745,5,1277603813,1277604533,2,16,720
49109678@N04,4745,3,1277607553,1277607553,2,16,0
49109678@N04,4745,4,1277607553,1277608434,2,16,881
49109678@N04,4745,5,1277608434,1277608451,2,16,17
49109678@N04,4745,6,1277608451,1277608512,2,16,61
49109678@N04,4745,1,1277608512,1277609112,2,16,600
49109678@N04,4745,17,1277609361,1277609608,2,16,247
49109678@N04,4745,13,1277609608,1277609693,2,16,85
49109678@N04,4745,15,1277609693,1277609873,2,16,180
49109678@N04,4745,12,1277610232,1277611072,4,16,840
49109678@N04,4745,16,1277611485,1277612205,2,16,720
49109678@N04,4745,22,1277613116,1277613716,2,16,600
49109678@N04,4745,21,1277616097,1277616289,2,16,192
49109678@N04,4745,20,1277616289,1277616584,2,16,295
49109678@N04,4745,24,1277616584,1277617064,2,16,480
49109678@N04,4745,27,1277620569,1277621769,1,16,1200
49109678@N04,4746,27,1278039269,1278040270,3,10,1001
49109678@N04,4746,17,1278040270,1278041650,5,10,1380
49109678@N04,4746,3,1278046781,1278047051,3,10,270
49109678@N04,4746,2,1278048810,1278048900,2,10,90
49109678@N04,4746,5,1278049126,1278049846,2,10,720
49109678@N04,4746,23,1278052356,1278052446,4,10,90
49109678@N04,4746,26,1278052891,1278053071,2,10,180
49109678@N04,4746,20,1278053099,1278053647,4,10,548
49109678@N04,4746,19,1278053647,1278054067,2,10,420
49109678@N04,4746,27,1278054846,1278056046,1,10,1200
49109678@N04,4747,27,1303170990,1303172190,1,1,1200
49109678@N04,4748,4,1344042966,1344043866,1,1,900
49109678@N04,4749,15,1365118909,1365119089,2,2,180
49109678@N04,4749,10,1365121525,1365121945,1,2,420
49109678@N04,4750,14,1405468971,1405469091,1,1,120
49165041@N00,4751,27,1281445187,1281446387,2,16,1200
49165041@N00,4751,2,1281450028,1281450118,2,16,90
49165041@N00,4751,13,1281463380,1281463980,3,16,600
49165041@N00,4751,21,1281468988,1281469438,2,16,450
49165041@N00,4751,27,1281484453,1281485653,9,16,1200
49165041@N00,4751,4,1281486398,1281486548,4,16,150
49165041@N00,4751,5,1281486548,1281487268,5,16,720
49165041@N00,4751,16,1281491280,1281492000,3,16,720
49165041@N00,4751,14,1281492857,1281492977,3,16,120
49165041@N00,4751,16,1281492994,1281493054,2,16,60
49165041@N00,4751,14,1281493054,1281493174,2,16,120
49165041@N00,4751,4,1281493523,1281494423,2,16,900
49165041@N00,4751,1,1281500477,1281501077,4,16,600
49165041@N00,4751,13,1281501980,1281502580,2,16,600
49165041@N00,4751,26,1281505344,1281505524,2,16,180
49165041@N00,4751,23,1281507787,1281507877,2,16,90
49169223@N00,4752,27,1230872656,1230872889,5,21,233
49169223@N00,4752,16,1230872889,1230873026,2,21,137
49169223@N00,4752,4,1230873026,1230873926,2,21,900
49169223@N00,4752,16,1230885853,1230886573,15,21,720
49169223@N00,4752,23,1230901205,1230901206,2,21,1
49169223@N00,4752,21,1230901206,1230901207,2,21,1
49169223@N00,4752,20,1230901207,1230901210,4,21,3
49169223@N00,4752,22,1230901210,1230901212,2,21,2
49169223@N00,4752,19,1230901212,1230901217,6,21,5
49169223@N00,4752,18,1230901217,1230901223,4,21,6
49169223@N00,4752,26,1230901223,1230901224,2,21,1
49169223@N00,4752,17,1230901224,1230901225,2,21,1
49169223@N00,4752,18,1230901225,1230901226,2,21,1
49169223@N00,4752,13,1230901226,1230901228,2,21,2
49169223@N00,4752,16,1230901228,1230901229,2,21,1
49169223@N00,4752,25,1230901229,1230901237,9,21,8
49169223@N00,4752,22,1230901237,1230901242,6,21,5
49169223@N00,4752,2,1230901242,1230901246,5,21,4
49169223@N00,4752,3,1230901246,1230901249,2,21,3
49169223@N00,4752,12,1230901249,1230901256,8,21,7
49169223@N00,4752,16,1230901256,1230901976,1,21,720
49169223@N00,4753,27,1230962589,1230963789,1,1,1200
49169223@N00,4754,21,1231333227,1231333677,1,1,450
49217725@N08,4755,16,1237695562,1237696282,1,1,720
49223458@N00,4756,11,1395982176,1395982356,1,1,180
49275237@N00,4757,27,1206730434,1206730817,3,7,383
49275237@N00,4757,16,1206730817,1206731537,2,7,720
49275237@N00,4757,14,1206732718,1206732838,2,7,120
49275237@N00,4757,15,1206733812,1206733844,3,7,32
49275237@N00,4757,12,1206733844,1206734031,2,7,187
49275237@N00,4757,16,1206734031,1206734751,2,7,720
49275237@N00,4757,13,1206738391,1206738991,4,7,600
49275237@N00,4758,12,1206776844,1206777684,3,3,840
49275237@N00,4758,14,1206779086,1206779206,5,3,120
49275237@N00,4758,12,1206780122,1206780962,3,3,840
49275237@N00,4759,22,1206829918,1206830518,5,4,600
49275237@N00,4759,8,1206834522,1206834642,3,4,120
49275237@N00,4759,27,1206837808,1206837912,3,4,104
49275237@N00,4759,22,1206837912,1206838512,1,4,600
49275237@N00,4760,27,1329434467,1329435667,3,12,1200
49275237@N00,4760,22,1329438477,1329438722,3,12,245
49275237@N00,4760,21,1329438722,1329439172,2,12,450
49275237@N00,4760,22,1329441788,1329442388,5,12,600
49275237@N00,4760,21,1329443614,1329444064,8,12,450
49275237@N00,4760,17,1329471320,1329472700,13,12,1380
49275237@N00,4760,12,1329476288,1329477128,9,12,840
49275237@N00,4760,9,1329477265,1329477505,8,12,240
49275237@N00,4760,2,1329478280,1329478370,5,12,90
49275237@N00,4760,5,1329479316,1329480036,5,12,720
49275237@N00,4760,4,1329480903,1329481080,3,12,177
49275237@N00,4760,27,1329481080,1329482280,4,12,1200
49275237@N00,4761,13,1329731676,1329732276,2,1,600
49276854@N08,4762,15,1382209881,1382210061,2,4,180
49276854@N08,4762,18,1382210468,1382212268,2,4,1800
49276854@N08,4762,27,1382214894,1382216094,2,4,1200
49276854@N08,4762,4,1382228744,1382229644,1,4,900
49280743@N03,4763,27,1380699542,1380700742,18,3,1200
49280743@N03,4763,20,1380702588,1380703668,3,3,1080
49280743@N03,4763,4,1380710722,1380711622,116,3,900
49305593@N05,4764,19,1389697989,1389698409,1,1,420
49305593@N05,4765,9,1425895794,1425896034,6,1,240
49395260@N00,4766,6,1333503315,1333503570,1,1,255
49395260@N00,4767,6,1333961921,1333962176,2,1,255
49472870@N04,4768,24,1385814681,1385815161,1,1,480
49502978053@N01,4769,22,1315897005,1315897605,1,1,600
49502978053@N01,4770,27,1317466925,1317468125,6,8,1200
49502978053@N01,4770,22,1317468987,1317469027,3,8,40
49502978053@N01,4770,18,1317469027,1317469131,6,8,104
49502978053@N01,4770,22,1317469131,1317469170,3,8,39
49502978053@N01,4770,13,1317469170,1317469770,2,8,600
49502978053@N01,4770,19,1317470070,1317470123,4,8,53
49502978053@N01,4770,20,1317470123,1317470150,2,8,27
49502978053@N01,4770,4,1317470150,1317471050,1,8,900
49502987176@N01,4771,27,1275284878,1275286078,1,1,1200
49502987176@N01,4772,20,1275348996,1275350076,2,4,1080
49502987176@N01,4772,16,1275350929,1275351649,10,4,720
49502987176@N01,4772,11,1275364792,1275364972,5,4,180
49502987176@N01,4772,12,1275368921,1275369761,2,4,840
49502987176@N01,4773,21,1314060147,1314060597,2,4,450
49502987176@N01,4773,19,1314062455,1314062875,2,4,420
49502987176@N01,4773,17,1314063127,1314064507,2,4,1380
49502987176@N01,4773,25,1314066026,1314066776,3,4,750
49502987176@N01,4774,4,1314097715,1314098615,1,1,900
49502987176@N01,4775,6,1314495289,1314495544,2,2,255
49502987176@N01,4775,14,1314517065,1314517185,1,2,120
49503068447@N01,4776,22,1203989213,1203989813,2,4,600
49503068447@N01,4776,15,1203996887,1203997067,2,4,180
49503068447@N01,4776,14,1203998886,1203999006,4,4,120
49503068447@N01,4776,16,1204004656,1204005376,1,4,720
49503068447@N01,4777,14,1267416948,1267417068,1,1,120
49503068447@N01,4778,14,1267516268,1267516388,2,1,120
49503114584@N01,4779,20,1217676288,1217677368,2,2,1080
49503114584@N01,4779,4,1217680241,1217681141,1,2,900
49503114584@N01,4780,3,1218283889,1218284159,1,1,270
49503114584@N01,4781,27,1249188817,1249190017,2,3,1200
49503114584@N01,4781,4,1249199510,1249200410,2,3,900
49503114584@N01,4781,27,1249207402,1249208602,1,3,1200
49503114584@N01,4782,19,1249288449,1249288869,2,3,420
49503114584@N01,4782,17,1249292581,1249293961,2,3,1380
49503114584@N01,4782,27,1249296845,1249298045,1,3,1200
49503114584@N01,4783,19,1344064867,1344065287,2,2,420
49503114584@N01,4783,27,1344068480,1344069680,1,2,1200
49503114584@N01,4784,19,1405568986,1405569406,2,1,420
49503128117@N01,4785,10,1391149173,1391149593,1,1,420
49503128117@N01,4786,16,1391366876,1391367596,1,1,720
49503128117@N01,4787,16,1391456693,1391457413,1,1,720
49503181455@N01,4788,23,1246857279,1246857369,15,2,90
49503181455@N01,4788,18,1246867691,1246869491,5,2,1800
49503181455@N01,4789,18,1246919239,1246919949,20,3,710
49503181455@N01,4789,17,1246919949,1246921329,5,3,1380
49503181455@N01,4789,8,1246933864,1246933984,25,3,120
49645702@N00,4790,27,1363424911,1363425765,3,11,854
49645702@N00,4790,5,1363425765,1363426075,4,11,310
49645702@N00,4790,2,1363426075,1363426165,7,11,90
49645702@N00,4790,6,1363426602,1363426857,20,11,255
49645702@N00,4790,7,1363428105,1363428195,2,11,90
49645702@N00,4790,9,1363428283,1363428472,3,11,189
49645702@N00,4790,14,1363428472,1363428592,2,11,120
49645702@N00,4790,18,1363428870,1363429149,2,11,279
49645702@N00,4790,26,1363429149,1363429329,6,11,180
49645702@N00,4790,18,1363429503,1363430516,4,11,1013
49645702@N00,4790,14,1363430516,1363430636,9,11,120
49675952@N07,4791,4,1273925381,1273926281,1,1,900
49675952@N07,4792,18,1305332606,1305334406,1,1,1800
49675952@N07,4793,27,1305388053,1305389253,1,1,1200
49675952@N07,4794,27,1305638234,1305639434,1,1,1200
49677598@N00,4795,1,1220757900,1220758500,3,5,600
49677598@N00,4795,2,1220759640,1220759730,2,5,90
49677598@N00,4795,14,1220779800,1220779920,2,5,120
49677598@N00,4795,23,1220785860,1220785950,2,5,90
49677598@N00,4795,26,1220788620,1220788800,1,5,180
49677598@N00,4796,16,1220854320,1220855040,7,1,720
49677598@N00,4797,27,1221016648,1221017848,3,4,1200
49677598@N00,4797,26,1221020391,1221020571,2,4,180
49677598@N00,4797,17,1221029820,1221030120,2,4,300
49677598@N00,4797,16,1221030120,1221030840,1,4,720
49686361@N00,4798,16,1284098886,1284099606,1,1,720
49727271@N00,4799,2,1386308099,1386308189,1,1,90
49727271@N00,4800,16,1386475330,1386476050,2,7,720
49727271@N00,4800,9,1386484757,1386484997,2,7,240
49727271@N00,4800,3,1386485648,1386485918,2,7,270
49727271@N00,4800,16,1386489797,1386490517,2,7,720
49727271@N00,4800,11,1386494745,1386494925,2,7,180
49727271@N00,4800,20,1386502948,1386503421,2,7,473
49727271@N00,4800,19,1386503421,1386503841,1,7,420
49727271@N00,4801,8,1386552447,1386552567,1,1,120
49727271@N00,4802,19,1418033235,1418033655,1,1,420
49731541@N02,4803,27,1400541023,1400542223,1,1,1200
49738389@N00,4804,27,1287371076,1287372276,6,3,1200
49738389@N00,4804,11,1287373666,1287373846,7,3,180
49738389@N00,4804,3,1287384237,1287384507,1,3,270
49768774@N02,4805,22,1446092141,1446092741,1,1,600
49786625@N07,4806,10,1416188296,1416188716,1,1,420
49855440@N00,4807,16,1229649588,1229650308,2,10,720
49855440@N00,4807,15,1229657792,1229657972,4,10,180
49855440@N00,4807,18,1229661226,1229663026,2,10,1800
49855440@N00,4807,22,1229663525,1229664125,5,10,600
49855440@N00,4807,21,1229668847,1229669297,3,10,450
49855440@N00,4807,16,1229672203,1229672923,7,10,720
49855440@N00,4807,9,1229677625,1229677865,3,10,240
49855440@N00,4807,14,1229678944,1229679064,2,10,120
49855440@N00,4807,16,1229682939,1229683659,4,10,720
49855440@N00,4807,27,1229690365,1229691565,1,10,1200
49858381@N04,4808,16,1358016151,1358016871,2,1,720
49858381@N04,4809,14,1358202959,1358203079,2,1,120
49887039@N04,4810,27,1283233128,1283233560,2,7,432
49887039@N04,4810,4,1283233560,1283234460,2,7,900
49887039@N04,4810,17,1283235876,1283236457,4,7,581
49887039@N04,4810,20,1283236457,1283237537,3,7,1080
49887039@N04,4810,9,1283243290,1283243530,3,7,240
49887039@N04,4810,26,1283253990,1283254170,3,7,180
49887039@N04,4810,4,1283271082,1283271982,1,7,900
49887039@N04,4811,27,1283651386,1283652586,2,1,1200
49887039@N04,4812,17,1283685108,1283686488,2,1,1380
49887039@N04,4813,27,1346614736,1346615936,1,1,1200
49887039@N04,4814,27,1346817531,1346818731,7,16,1200
49887039@N04,4814,1,1346824283,1346824883,2,16,600
49887039@N04,4814,3,1346825142,1346825412,2,16,270
49887039@N04,4814,19,1346825762,1346826182,2,16,420
49887039@N04,4814,17,1346828763,1346828795,3,16,32
49887039@N04,4814,19,1346828795,1346829215,2,16,420
49887039@N04,4814,11,1346831213,1346831337,2,16,124
49887039@N04,4814,8,1346831337,1346831457,2,16,120
49887039@N04,4814,5,1346836688,1346837408,2,16,720
49887039@N04,4814,27,1346839772,1346840972,3,16,1200
49887039@N04,4814,25,1346843815,1346844565,2,16,750
49887039@N04,4814,16,1346848619,1346848659,2,16,40
49887039@N04,4814,25,1346848659,1346848752,2,16,93
49887039@N04,4814,24,1346848752,1346849232,2,16,480
49887039@N04,4814,16,1346855470,1346856190,2,16,720
49887039@N04,4814,17,1346859457,1346860837,1,16,1380
49887039@N04,4815,27,1347342796,1347343996,2,5,1200
49887039@N04,4815,1,1347345003,1347345603,2,5,600
49887039@N04,4815,13,1347347196,1347347796,3,5,600
49887039@N04,4815,26,1347360136,1347360316,2,5,180
49887039@N04,4815,1,1347387030,1347387630,1,5,600
49887039@N04,4816,14,1360566680,1360566800,2,2,120
49887039@N04,4816,17,1360572362,1360573742,1,2,1380
49934509@N00,4817,16,1291532401,1291533121,1,1,720
49934509@N00,4818,16,1291718677,1291719397,1,1,720
49934509@N00,4819,9,1291853331,1291853571,2,4,240
49934509@N00,4819,4,1291879362,1291880262,2,4,900
49934509@N00,4819,14,1291886874,1291886994,2,4,120
49934509@N00,4819,16,1291891484,1291892204,1,4,720
49934509@N00,4820,16,1291940207,1291940927,5,1,720
49934509@N00,4821,14,1292125943,1292126063,1,1,120
49934509@N00,4822,27,1292189842,1292191042,2,4,1200
49934509@N00,4822,14,1292191807,1292191927,2,4,120
49934509@N00,4822,3,1292194442,1292194712,2,4,270
49934509@N00,4822,16,1292200163,1292200883,1,4,720
49934509@N00,4823,4,1292235980,1292236880,1,1,900
49934509@N00,4824,21,1326586314,1326586764,2,4,450
49934509@N00,4824,19,1326587321,1326587741,2,4,420
49934509@N00,4824,13,1326591933,1326592533,2,4,600
49934509@N00,4824,16,1326597103,1326597823,1,4,720
49934509@N00,4825,27,1326758772,1326759972,2,6,1200
49934509@N00,4825,17,1326763506,1326764886,2,6,1380
49934509@N00,4825,20,1326770582,1326771662,2,6,1080
49934509@N00,4825,25,1326774512,1326775262,2,6,750
49934509@N00,4825,2,1326782117,1326782207,2,6,90
49934509@N00,4825,5,1326783169,1326783889,1,6,720
49934509@N00,4826,25,1326840171,1326840921,2,4,750
49934509@N00,4826,27,1326842140,1326842727,2,4,587
49934509@N00,4826,21,1326842727,1326843177,2,4,450
49934509@N00,4826,16,1326846859,1326847579,1,4,720
49934509@N00,4827,27,1327106380,1327107580,2,2,1200
49934509@N00,4827,21,1327108448,1327108898,1,2,450
49934509@N00,4828,15,1351426758,1351426760,2,3,2
49934509@N00,4828,14,1351426760,1351426880,2,3,120
49934509@N00,4828,27,1351428387,1351429587,1,3,1200
49934509@N00,4829,27,1351553944,1351555144,7,12,1200
49934509@N00,4829,22,1351557851,1351558451,2,12,600
49934509@N00,4829,10,1351559040,1351559044,2,12,4
49934509@N00,4829,19,1351559044,1351559464,4,12,420
49934509@N00,4829,20,1351559757,1351560837,2,12,1080
49934509@N00,4829,9,1351563643,1351563883,4,12,240
49934509@N00,4829,11,1351564800,1351564980,2,12,180
49934509@N00,4829,6,1351565112,1351565367,2,12,255
49934509@N00,4829,7,1351565753,1351565843,3,12,90
49934509@N00,4829,8,1351566490,1351566610,2,12,120
49934509@N00,4829,11,1351569648,1351569828,3,12,180
49934509@N00,4829,27,1351571408,1351572608,10,12,1200
49934509@N00,4830,24,1351840573,1351841053,4,1,480
49934509@N00,4831,17,1351908844,1351910224,3,9,1380
49934509@N00,4831,16,1351911414,1351912134,2,9,720
49934509@N00,4831,2,1351916084,1351916174,4,9,90
49934509@N00,4831,3,1351916810,1351917080,3,9,270
49934509@N00,4831,21,1351918647,1351918648,2,9,1
49934509@N00,4831,2,1351918648,1351918738,2,9,90
49934509@N00,4831,9,1351920404,1351920644,4,9,240
49934509@N00,4831,22,1351921657,1351922257,2,9,600
49934509@N00,4831,25,1351923481,1351924231,1,9,750
49934509@N00,4832,17,1351978745,1351978948,4,13,203
49934509@N00,4832,14,1351978948,1351979068,5,13,120
49934509@N00,4832,10,1351979859,1351980279,2,13,420
49934509@N00,4832,14,1351980363,1351980483,2,13,120
49934509@N00,4832,10,1351980687,1351981107,13,13,420
49934509@N00,4832,14,1351984014,1351984134,4,13,120
49934509@N00,4832,12,1351984463,1351985294,2,13,831
49934509@N00,4832,10,1351985294,1351985714,7,13,420
49934509@N00,4832,14,1351986550,1351986670,2,13,120
49934509@N00,4832,15,1351986791,1351986971,2,13,180
49934509@N00,4832,14,1351986980,1351987100,7,13,120
49934509@N00,4832,25,1351991900,1351992650,2,13,750
49934509@N00,4832,14,1351994599,1351994719,1,13,120
49942639@N04,4833,17,1379394334,1379395714,2,2,1380
49942639@N04,4833,18,1379398422,1379400222,1,2,1800
49952306@N00,4834,27,1303014882,1303015308,3,2,426
49952306@N00,4834,14,1303015308,1303015428,1,2,120
49952306@N00,4835,27,1307159950,1307160728,2,3,778
49952306@N00,4835,26,1307160728,1307160908,2,3,180
49952306@N00,4835,9,1307174293,1307174533,3,3,240
50023219@N05,4836,26,1272250045,1272250225,4,1,180
50073458@N00,4837,17,1339459103,1339460483,2,6,1380
50073458@N00,4837,6,1339469995,1339470250,2,6,255
50073458@N00,4837,17,1339472491,1339473465,2,6,974
50073458@N00,4837,21,1339473465,1339473915,2,6,450
50073458@N00,4837,27,1339483919,1339485119,3,6,1200
50073458@N00,4837,14,1339492604,1339492724,3,6,120
50073458@N00,4838,8,1340462272,1340462392,1,1,120
50102917@N08,4839,27,1439816586,1439817786,1,1,1200
50109110@N00,4840,17,1207108234,1207109614,2,2,1380
50109110@N00,4840,3,1207122368,1207122638,2,2,270
50158065@N00,4841,16,1390227881,1390228601,1,1,720
50207065@N00,4842,6,1291452574,1291452829,1,1,255
50216293@N04,4843,15,1192915403,1192915583,1,1,180
50249220@N00,4844,3,1363421328,1363421598,1,1,270
50276147@N05,4845,17,1304842123,1304843503,1,1,1380
50403713@N03,4846,2,1391257688,1391257778,2,2,90
50403713@N03,4846,8,1391258307,1391258427,1,2,120
50403713@N03,4847,16,1391299281,1391299538,6,6,257
50403713@N03,4847,8,1391299538,1391299658,3,6,120
50403713@N03,4847,17,1391301288,1391302668,4,6,1380
50403713@N03,4847,27,1391304033,1391304903,2,6,870
50403713@N03,4847,17,1391304903,1391306283,5,6,1380
50403713@N03,4847,27,1391310225,1391311425,8,6,1200
50428026@N00,4848,27,1431823339,1431824539,7,1,1200
50480909@N04,4849,6,1251970223,1251970478,1,1,255
50514133@N00,4850,16,1267312998,1267313718,2,3,720
50514133@N00,4850,22,1267331317,1267331917,2,3,600
50514133@N00,4850,14,1267338466,1267338586,3,3,120
50514859@N00,4851,16,1248811402,1248812122,9,1,720
50578763@N07,4852,27,1268189170,1268190370,1,1,1200
50591494@N07,4853,17,1348890013,1348891393,1,1,1380
50731912@N04,4854,27,1296643714,1296644914,2,1,1200
50731912@N04,4855,27,1296829883,1296831083,1,1,1200
50731912@N04,4856,27,1296990138,1296991338,1,1,1200
50753203@N02,4857,22,1278134454,1278135054,3,1,600
50753203@N02,4858,22,1300060219,1300060819,7,1,600
50753203@N02,4859,22,1300426139,1300426739,1,1,600
50753203@N02,4860,16,1451571845,1451572565,1,1,720
50811165@N06,4861,12,1275209978,1275210818,1,1,840
50848173@N00,4862,14,1356014115,1356014235,1,1,120
50853888@N00,4863,4,1278725923,1278726823,1,1,900
50881303@N05,4864,27,1374541547,1374542747,1,1,1200
50968580@N00,4865,13,1330469951,1330470551,1,1,600
50968580@N00,4866,27,1330543339,1330544539,1,1,1200
50968580@N00,4867,23,1330604845,1330604935,1,1,90
50968580@N00,4868,16,1356871682,1356872402,3,3,720
50968580@N00,4868,14,1356874161,1356874281,2,3,120
50968580@N00,4868,10,1356875109,1356875529,3,3,420
50968580@N00,4869,27,1387157516,1387158716,2,9,1200
50968580@N00,4869,3,1387166545,1387166815,2,9,270
50968580@N00,4869,16,1387166885,1387167273,2,9,388
50968580@N00,4869,17,1387167273,1387168653,6,9,1380
50968580@N00,4869,16,1387179267,1387179987,2,9,720
50968580@N00,4869,14,1387182131,1387182251,2,9,120
50968580@N00,4869,10,1387183379,1387183799,2,9,420
50968580@N00,4869,16,1387190183,1387190903,2,9,720
50968580@N00,4869,27,1387193988,1387195188,2,9,1200
51011933@N00,4870,1,1366245176,1366245776,2,5,600
51011933@N00,4870,18,1366251583,1366253005,2,5,1422
51011933@N00,4870,17,1366253005,1366254385,2,5,1380
51011933@N00,4870,9,1366254754,1366254994,2,5,240
51011933@N00,4870,20,1366259946,1366261026,1,5,1080
51035587259@N01,4871,27,1354083569,1354084769,1,1,1200
51035647214@N01,4872,4,1273959617,1273960517,2,4,900
51035647214@N01,4872,14,1273961094,1273961214,2,4,120
51035647214@N01,4872,20,1273964254,1273965334,3,4,1080
51035647214@N01,4872,27,1273969948,1273971148,2,4,1200
51035650382@N01,4873,23,1350196338,1350196428,1,1,90
51035693821@N01,4874,9,1249099468,1249099708,6,3,240
51035693821@N01,4874,14,1249108491,1249108611,13,3,120
51035693821@N01,4874,2,1249115359,1249115449,3,3,90
51035730365@N01,4875,1,1226891625,1226892225,1,1,600
51037533@N00,4876,27,1359281033,1359282233,2,3,1200
51037533@N00,4876,26,1359292306,1359292486,2,3,180
51037533@N00,4876,16,1359295985,1359296705,1,3,720
51038094@N04,4877,16,1360980565,1360981285,1,1,720
51052219@N00,4878,27,1361007001,1361008201,1,1,1200
51052219@N00,4879,26,1367997232,1367997412,1,1,180
51065161@N00,4880,23,1386563753,1386563843,2,4,90
51065161@N00,4880,16,1386567998,1386568718,2,4,720
51065161@N00,4880,3,1386589253,1386589523,2,4,270
51065161@N00,4880,16,1386595899,1386596619,2,4,720
51082690@N03,4881,26,1313648192,1313648372,1,1,180
51082690@N03,4882,19,1419633317,1419633737,3,3,420
51082690@N03,4882,26,1419636682,1419636862,2,3,180
51082690@N03,4882,10,1419641327,1419641747,1,3,420
51087604@N07,4883,25,1269658012,1269658762,13,1,750
51087604@N07,4884,25,1284468203,1284468953,1,1,750
51141147@N02,4885,22,1335228513,1335229113,2,4,600
51141147@N02,4885,16,1335235298,1335236018,2,4,720
51141147@N02,4885,27,1335244269,1335245469,2,4,1200
51141147@N02,4885,17,1335250104,1335251484,2,4,1380
51159953@N00,4886,16,1304293638,1304294224,4,14,586
51159953@N00,4886,14,1304294224,1304294344,2,14,120
51159953@N00,4886,12,1304294442,1304295282,10,14,840
51159953@N00,4886,9,1304296169,1304296409,2,14,240
51159953@N00,4886,16,1304305402,1304305457,2,14,55
51159953@N00,4886,5,1304305457,1304305590,2,14,133
51159953@N00,4886,16,1304305590,1304305942,2,14,352
51159953@N00,4886,27,1304305942,1304307142,3,14,1200
51159953@N00,4886,20,1304308614,1304309108,2,14,494
51159953@N00,4886,26,1304309108,1304309204,2,14,96
51159953@N00,4886,13,1304309204,1304309804,2,14,600
51159953@N00,4886,18,1304309863,1304311074,3,14,1211
51159953@N00,4886,19,1304311074,1304311494,2,14,420
51159953@N00,4886,17,1304312321,1304313701,2,14,1380
51159953@N00,4887,16,1304550945,1304551665,3,3,720
51159953@N00,4887,7,1304553691,1304553781,2,3,90
51159953@N00,4887,27,1304569251,1304570451,1,3,1200
51159953@N00,4888,1,1304673859,1304674459,1,1,600
51166785@N06,4889,27,1352156967,1352158167,2,14,1200
51166785@N06,4889,21,1352159497,1352159947,2,14,450
51166785@N06,4889,20,1352161072,1352162152,4,14,1080
51166785@N06,4889,12,1352165478,1352166318,2,14,840
51166785@N06,4889,9,1352176116,1352176356,2,14,240
51166785@N06,4889,6,1352179108,1352179363,2,14,255
51166785@N06,4889,10,1352179610,1352180030,6,14,420
51166785@N06,4889,9,1352182400,1352182640,2,14,240
51166785@N06,4889,8,1352183846,1352183966,3,14,120
51166785@N06,4889,6,1352185134,1352185389,2,14,255
51166785@N06,4889,5,1352186018,1352186738,2,14,720
51166785@N06,4889,2,1352188436,1352188526,2,14,90
51166785@N06,4889,4,1352193714,1352194614,3,14,900
51166785@N06,4889,27,1352200144,1352201344,2,14,1200
51166785@N06,4890,27,1444769164,1444770364,15,12,1200
51166785@N06,4890,26,1444777183,1444777363,22,12,180
51166785@N06,4890,21,1444777944,1444778178,6,12,234
51166785@N06,4890,26,1444778178,1444778358,2,12,180
51166785@N06,4890,19,1444778827,1444779247,2,12,420
51166785@N06,4890,2,1444787897,1444787987,2,12,90
51166785@N06,4890,10,1444789925,1444790345,2,12,420
51166785@N06,4890,9,1444791147,1444791387,7,12,240
51166785@N06,4890,24,1444810790,1444811270,2,12,480
51166785@N06,4890,20,1444814708,1444815788,2,12,1080
51166785@N06,4890,9,1444820349,1444820589,2,12,240
51166785@N06,4890,6,1444821380,1444821635,1,12,255
51179707@N00,4891,15,1327643173,1327643353,1,1,180
51267780@N00,4892,27,1224196999,1224198199,35,10,1200
51267780@N00,4892,17,1224199784,1224201164,3,10,1380
51267780@N00,4892,15,1224205905,1224206085,7,10,180
51267780@N00,4892,4,1224208829,1224209729,4,10,900
51267780@N00,4892,2,1224210954,1224211044,4,10,90
51267780@N00,4892,5,1224211456,1224211550,2,10,94
51267780@N00,4892,4,1224211550,1224212450,4,10,900
51267780@N00,4892,21,1224212868,1224213197,5,10,329
51267780@N00,4892,22,1224213197,1224213437,4,10,240
51267780@N00,4892,26,1224213437,1224213617,3,10,180
51298319@N07,4893,22,1282149097,1282149697,1,1,600
51313971@N08,4894,26,1443310578,1443310758,2,5,180
51313971@N08,4894,25,1443317917,1443318202,2,5,285
51313971@N08,4894,26,1443318202,1443318382,2,5,180
51313971@N08,4894,17,1443329415,1443330795,2,5,1380
51313971@N08,4894,19,1443335104,1443335524,1,5,420
51355647@N00,4895,16,1278888052,1278888772,2,2,720
51355647@N00,4895,4,1278890106,1278891006,1,2,900
51422514@N00,4896,5,1228300114,1228300834,2,1,720
51446559@N06,4897,21,1322495648,1322496098,1,1,450
51460585@N03,4898,3,1375088566,1375088836,2,2,270
51460585@N03,4898,16,1375092094,1375092814,2,2,720
51501947@N05,4899,17,1319764063,1319765443,1,1,1380
51501947@N05,4900,22,1320361520,1320362120,1,1,600
51512337@N00,4901,9,1364162493,1364162733,3,6,240
51512337@N00,4901,7,1364164268,1364164358,2,6,90
51512337@N00,4901,20,1364183022,1364184102,2,6,1080
51512337@N00,4901,18,1364184561,1364186361,2,6,1800
51512337@N00,4901,3,1364200025,1364200295,2,6,270
51512337@N00,4901,25,1364203887,1364204637,1,6,750
51547237@N00,4902,23,1253529957,1253530047,1,1,90
51547237@N00,4903,2,1253661905,1253661995,1,1,90
51547237@N00,4904,16,1291978171,1291978891,4,1,720
51547237@N00,4905,27,1292070879,1292072079,2,2,1200
51547237@N00,4905,14,1292074254,1292074374,1,2,120
51547237@N00,4906,2,1412389401,1412389491,8,3,90
51547237@N00,4906,8,1412398769,1412398889,5,3,120
51547237@N00,4906,14,1412425417,1412425537,6,3,120
51547237@N00,4907,24,1412916280,1412916760,1,1,480
51547237@N00,4908,27,1431168350,1431169550,2,2,1200
51547237@N00,4908,2,1431175411,1431175501,1,2,90
51547237@N00,4909,9,1449095289,1449095529,1,1,240
51571496@N00,4910,27,1337505759,1337506959,1,1,1200
51587558@N08,4911,6,1357698113,1357698368,2,4,255
51587558@N08,4911,14,1357709913,1357710033,2,4,120
51587558@N08,4911,9,1357710165,1357710405,2,4,240
51587558@N08,4911,10,1357710415,1357710835,1,4,420
51636307@N00,4912,27,1323294703,1323295592,5,32,889
51636307@N00,4912,16,1323295592,1323295925,4,32,333
51636307@N00,4912,6,1323295925,1323296180,3,32,255
51636307@N00,4912,9,1323297475,1323297715,5,32,240
51636307@N00,4912,14,1323298393,1323298513,6,32,120
51636307@N00,4912,9,1323300530,1323300770,2,32,240
51636307@N00,4912,6,1323300955,1323301210,2,32,255
51636307@N00,4912,14,1323302646,1323302766,6,32,120
51636307@N00,4912,15,1323304072,1323304252,6,32,180
51636307@N00,4912,12,1323306836,1323307676,11,32,840
51636307@N00,4912,13,1323308308,1323308822,2,32,514
51636307@N00,4912,18,1323308822,1323310622,4,32,1800
51636307@N00,4912,17,1323310903,1323311216,2,32,313
51636307@N00,4912,18,1323311216,1323311768,4,32,552
51636307@N00,4912,19,1323311768,1323312188,3,32,420
51636307@N00,4912,20,1323312323,1323313403,2,32,1080
51636307@N00,4912,15,1323313716,1323313896,2,32,180
51636307@N00,4912,26,1323315028,1323315162,2,32,134
51636307@N00,4912,20,1323315162,1323315254,2,32,92
51636307@N00,4912,21,1323315254,1323315704,3,32,450
51636307@N00,4912,24,1323317928,1323318408,3,32,480
51636307@N00,4912,21,1323319290,1323319566,2,32,276
51636307@N00,4912,25,1323319566,1323319659,2,32,93
51636307@N00,4912,16,1323319659,1323320062,2,32,403
51636307@N00,4912,26,1323320062,1323320189,3,32,127
51636307@N00,4912,22,1323320189,1323320514,2,32,325
51636307@N00,4912,25,1323320514,1323321264,2,32,750
51636307@N00,4912,4,1323321375,1323321488,2,32,113
51636307@N00,4912,16,1323321488,1323322174,2,32,686
51636307@N00,4912,2,1323322174,1323322264,3,32,90
51636307@N00,4912,5,1323322541,1323323261,2,32,720
51636307@N00,4912,3,1323323667,1323323937,1,32,270
51692964@N05,4913,5,1236892792,1236893512,2,6,720
51692964@N05,4913,6,1236894063,1236894318,2,6,255
51692964@N05,4913,14,1236897540,1236897660,2,6,120
51692964@N05,4913,19,1236902872,1236903292,2,6,420
51692964@N05,4913,21,1236904026,1236904476,2,6,450
51692964@N05,4913,16,1236905265,1236905985,1,6,720
51737371@N00,4914,2,1284901879,1284901969,1,1,90
51746064@N07,4915,16,1362695927,1362696543,4,3,616
51746064@N07,4915,14,1362696543,1362696663,2,3,120
51746064@N07,4915,25,1362712172,1362712922,5,3,750
51746586@N06,4916,17,1281284405,1281285785,2,1,1380
51746586@N06,4917,13,1281684604,1281685204,4,4,600
51746586@N06,4917,20,1281686233,1281687313,2,4,1080
51746586@N06,4917,19,1281691128,1281691548,2,4,420
51746586@N06,4917,27,1281694186,1281695386,5,4,1200
51746586@N06,4918,16,1282351963,1282352683,15,8,720
51746586@N06,4918,5,1282356393,1282356397,2,8,4
51746586@N06,4918,4,1282356397,1282357297,2,8,900
51746586@N06,4918,16,1282357652,1282358372,4,8,720
51746586@N06,4918,17,1282363062,1282364442,2,8,1380
51746586@N06,4918,20,1282366777,1282367857,23,8,1080
51746586@N06,4918,17,1282388287,1282389667,15,8,1380
51746586@N06,4918,16,1282392791,1282393511,1,8,720
51746586@N06,4919,16,1312332426,1312333146,1,1,720
51746586@N06,4920,27,1312768430,1312769630,2,4,1200
51746586@N06,4920,13,1312770242,1312770842,6,4,600
51746586@N06,4920,20,1312787370,1312788450,2,4,1080
51746586@N06,4920,16,1312790014,1312790734,1,4,720
51746586@N06,4921,16,1313302670,1313303390,32,6,720
51746586@N06,4921,4,1313303688,1313303691,2,6,3
51746586@N06,4921,16,1313303691,1313304411,8,6,720
51746586@N06,4921,21,1313307938,1313308388,2,6,450
51746586@N06,4921,20,1313309917,1313310997,2,6,1080
51746586@N06,4921,17,1313320699,1313322079,22,6,1380
51746586@N06,4922,16,1343955225,1343955945,13,11,720
51746586@N06,4922,17,1343957208,1343958588,3,11,1380
51746586@N06,4922,20,1343961452,1343962532,4,11,1080
51746586@N06,4922,17,1343965030,1343966410,4,11,1380
51746586@N06,4922,16,1343966614,1343967334,30,11,720
51746586@N06,4922,14,1343974102,1343974222,2,11,120
51746586@N06,4922,16,1343975356,1343975774,2,11,418
51746586@N06,4922,17,1343975774,1343977107,2,11,1333
51746586@N06,4922,22,1343977107,1343977707,2,11,600
51746586@N06,4922,16,1343988170,1343988890,2,11,720
51746586@N06,4922,17,1343992918,1343994298,9,11,1380
51746586@N06,4923,27,1344903702,1344904902,30,17,1200
51746586@N06,4923,16,1344906369,1344906457,3,17,88
51746586@N06,4923,17,1344906457,1344907837,5,17,1380
51746586@N06,4923,15,1344907923,1344907925,2,17,2
51746586@N06,4923,17,1344907925,1344908087,5,17,162
51746586@N06,4923,15,1344908087,1344908138,2,17,51
51746586@N06,4923,17,1344908138,1344909518,5,17,1380
51746586@N06,4923,21,1344917986,1344918436,2,17,450
51746586@N06,4923,4,1344920299,1344921199,3,17,900
51746586@N06,4923,16,1344921431,1344921449,3,17,18
51746586@N06,4923,14,1344921449,1344921461,2,17,12
51746586@N06,4923,16,1344921461,1344922181,2,17,720
51746586@N06,4923,17,1344943305,1344943406,5,17,101
51746586@N06,4923,4,1344943406,1344943497,3,17,91
51746586@N06,4923,17,1344943497,1344943659,8,17,162
51746586@N06,4923,4,1344943659,1344943681,2,17,22
51746586@N06,4923,17,1344943681,1344945061,2,17,1380
51773303@N00,4924,14,1301727071,1301727191,1,1,120
51791370@N03,4925,14,1299885965,1299886085,1,1,120
51791370@N03,4926,17,1300226388,1300226791,2,3,403
51791370@N03,4926,15,1300226791,1300226971,2,3,180
51791370@N03,4926,19,1300236797,1300237217,1,3,420
51791370@N03,4927,19,1300402161,1300402581,2,3,420
51791370@N03,4927,3,1300413346,1300413616,2,3,270
51791370@N03,4927,27,1300417357,1300418557,1,3,1200
51791370@N03,4928,16,1415358481,1415359201,1,1,720
51965232@N06,4929,16,1408071576,1408072296,2,5,720
51965232@N06,4929,12,1408077403,1408078243,2,5,840
51965232@N06,4929,6,1408087996,1408088251,2,5,255
51965232@N06,4929,2,1408091604,1408091694,2,5,90
51965232@N06,4929,16,1408094041,1408094761,1,5,720
51973523@N07,4930,14,1420158832,1420158952,1,1,120
51981360@N07,4931,27,1349677395,1349678595,1,1,1200
52034253@N02,4932,17,1319278540,1319279920,1,1,1380
52066610@N03,4933,3,1394748504,1394748774,1,1,270
52082189@N03,4934,16,1328014800,1328014800,5,2,0
52082189@N03,4934,27,1328014800,1328016000,2,2,1200
52110522@N04,4935,22,1300354755,1300355355,1,1,600
52111934@N00,4936,4,1214981653,1214982553,40,1,900
52168854@N00,4937,27,1348398583,1348399783,3,3,1200
52168854@N00,4937,9,1348399936,1348400176,3,3,240
52168854@N00,4937,26,1348402774,1348402954,4,3,180
52168854@N00,4938,21,1348553026,1348553476,2,2,450
52168854@N00,4938,9,1348554458,1348554698,1,2,240
52192784@N08,4939,10,1389742309,1389742729,2,5,420
52192784@N08,4939,9,1389742761,1389743001,3,5,240
52192784@N08,4939,2,1389744158,1389744248,2,5,90
52192784@N08,4939,20,1389749033,1389750113,2,5,1080
52192784@N08,4939,15,1389753725,1389753905,1,5,180
52195956@N03,4940,16,1314223885,1314224605,2,2,720
52195956@N03,4940,27,1314242250,1314243450,1,2,1200
52195956@N03,4941,27,1383037789,1383038989,6,1,1200
52195956@N03,4942,27,1383372154,1383373354,2,4,1200
52195956@N03,4942,16,1383381933,1383382653,2,4,720
52195956@N03,4942,17,1383391151,1383392119,4,4,968
52195956@N03,4942,16,1383392119,1383392839,2,4,720
52195956@N03,4943,6,1383446035,1383446290,3,3,255
52195956@N03,4943,17,1383454006,1383454276,2,3,270
52195956@N03,4943,18,1383454276,1383456076,1,3,1800
52195956@N03,4944,16,1383704872,1383705592,3,5,720
52195956@N03,4944,6,1383708570,1383708825,6,5,255
52195956@N03,4944,27,1383712753,1383712801,2,5,48
52195956@N03,4944,16,1383712801,1383712812,2,5,11
52195956@N03,4944,27,1383712812,1383714012,8,5,1200
52195956@N03,4945,8,1408417332,1408417452,2,1,120
52195956@N03,4946,27,1408926253,1408927453,1,1,1200
52195956@N03,4947,11,1426122912,1426123092,3,3,180
52195956@N03,4947,16,1426128658,1426129378,3,3,720
52195956@N03,4947,17,1426133641,1426135021,3,3,1380
52219207@N03,4948,12,1366438179,1366439019,5,3,840
52219207@N03,4948,21,1366451199,1366451649,2,3,450
52219207@N03,4948,12,1366466705,1366467545,1,3,840
52226961@N04,4949,27,1391837040,1391838240,1,1,1200
52254014@N00,4950,17,1278063209,1278064589,3,1,1380
52254014@N00,4951,8,1290653950,1290654070,2,2,120
52254014@N00,4951,26,1290655481,1290655661,1,2,180
52254014@N00,4952,1,1320465309,1320465909,1,1,600
52254014@N00,4953,27,1322462085,1322463285,2,3,1200
52254014@N00,4953,4,1322466201,1322467101,3,3,900
52254014@N00,4953,14,1322467673,1322467793,1,3,120
52254014@N00,4954,17,1322637942,1322639200,2,2,1258
52254014@N00,4954,4,1322639200,1322640100,1,2,900
52254014@N00,4955,27,1322982948,1322984148,1,1,1200
52254014@N00,4956,21,1324363647,1324364097,2,4,450
52254014@N00,4956,17,1324368358,1324368767,2,4,409
52254014@N00,4956,26,1324368767,1324368947,2,4,180
52254014@N00,4956,21,1324370794,1324371244,1,4,450
52254014@N00,4957,19,1324689058,1324689478,1,1,420
52254014@N00,4958,17,1330460423,1330461551,2,2,1128
52254014@N00,4958,16,1330461551,1330462271,1,2,720
52254014@N00,4959,15,1333105668,1333105848,1,1,180
52254014@N00,4960,10,1351929064,1351929484,2,1,420
52254014@N00,4961,23,1359236085,1359236175,1,1,90
52254014@N00,4962,9,1373710658,1373710898,2,2,240
52254014@N00,4962,7,1373711318,1373711408,1,2,90
52254014@N00,4963,10,1385798247,1385798667,1,1,420
52273551@N00,4964,16,1412947215,1412947935,1,1,720
52275225@N07,4965,16,1385290547,1385291267,3,2,720
52275225@N07,4965,9,1385299934,1385300174,1,2,240
52349877@N08,4966,27,1325490375,1325491575,2,2,1200
52349877@N08,4966,14,1325495769,1325495889,2,2,120
52349877@N08,4967,22,1325638146,1325638746,2,1,600
52378595@N06,4968,24,1342418939,1342419419,1,1,480
52378595@N06,4969,4,1342775278,1342776178,1,1,900
52399740@N05,4970,19,1395985499,1395985919,2,3,420
52399740@N05,4970,8,1395985930,1395986050,3,3,120
52399740@N05,4970,27,1395986171,1395987371,5,3,1200
52407821@N00,4971,21,1354936418,1354936868,1,1,450
52423581@N00,4972,2,1306822571,1306822661,1,1,90
52446667@N08,4973,27,1373307075,1373308275,3,1,1200
52458519@N07,4974,17,1251154773,1251156153,2,2,1380
52458519@N07,4974,26,1251157004,1251157184,1,2,180
52465495@N06,4975,16,1378540397,1378540397,2,8,0
52465495@N06,4975,17,1378540397,1378541777,2,8,1380
52465495@N06,4975,27,1378543008,1378543010,3,8,2
52465495@N06,4975,11,1378543010,1378543012,3,8,2
52465495@N06,4975,27,1378543012,1378543014,2,8,2
52465495@N06,4975,26,1378543014,1378543015,2,8,1
52465495@N06,4975,17,1378543015,1378543017,2,8,2
52465495@N06,4975,27,1378543017,1378544217,1,8,1200
52504278@N00,4976,16,1253984345,1253985065,2,1,720
52504278@N00,4977,22,1333565193,1333565793,2,2,600
52504278@N00,4977,16,1333565954,1333566674,1,2,720
52536373@N02,4978,27,1305252893,1305254093,1,1,1200
52574631@N00,4979,27,1269907657,1269908857,2,12,1200
52574631@N00,4979,8,1269909373,1269909493,12,12,120
52574631@N00,4979,19,1269911801,1269912020,3,12,219
52574631@N00,4979,8,1269912020,1269912140,3,12,120
52574631@N00,4979,2,1269912963,1269913053,6,12,90
52574631@N00,4979,9,1269917924,1269918062,3,12,138
52574631@N00,4979,2,1269918062,1269918102,2,12,40
52574631@N00,4979,9,1269918102,1269918342,6,12,240
52574631@N00,4979,14,1269919407,1269919527,19,12,120
52574631@N00,4979,19,1269925531,1269925951,9,12,420
52574631@N00,4979,1,1269931787,1269932387,2,12,600
52574631@N00,4979,11,1269934291,1269934471,13,12,180
52574631@N00,4980,27,1323212798,1323213998,2,5,1200
52574631@N00,4980,17,1323216332,1323216871,2,5,539
52574631@N00,4980,14,1323216871,1323216991,3,5,120
52574631@N00,4980,15,1323223413,1323223593,2,5,180
52574631@N00,4980,22,1323251812,1323252412,2,5,600
52574631@N00,4981,2,1323857845,1323857935,1,1,90
52574631@N00,4982,3,1363824612,1363824882,2,7,270
52574631@N00,4982,14,1363826501,1363826621,5,7,120
52574631@N00,4982,8,1363838487,1363838607,2,7,120
52574631@N00,4982,14,1363847568,1363847688,2,7,120
52574631@N00,4982,10,1363849637,1363850057,2,7,420
52574631@N00,4982,8,1363852378,1363852498,2,7,120
52574631@N00,4982,27,1363854580,1363855780,1,7,1200
52574631@N00,4983,14,1363910033,1363910153,3,6,120
52574631@N00,4983,27,1363915706,1363916906,3,6,1200
52574631@N00,4983,20,1363919999,1363921079,2,6,1080
52574631@N00,4983,17,1363922717,1363924097,2,6,1380
52574631@N00,4983,13,1363937159,1363937759,4,6,600
52574631@N00,4983,12,1363937999,1363938839,2,6,840
52574631@N00,4984,16,1424862100,1424862820,1,1,720
52574631@N00,4985,16,1455578405,1455578644,2,14,239
52574631@N00,4985,14,1455578644,1455578764,4,14,120
52574631@N00,4985,15,1455581554,1455581734,3,14,180
52574631@N00,4985,16,1455582093,1455582813,3,14,720
52574631@N00,4985,9,1455587410,1455587650,3,14,240
52574631@N00,4985,6,1455588274,1455588280,2,14,6
52574631@N00,4985,9,1455588280,1455588333,2,14,53
52574631@N00,4985,6,1455588333,1455588588,2,14,255
52574631@N00,4985,9,1455592053,1455592293,2,14,240
52574631@N00,4985,16,1455601572,1455601977,2,14,405
52574631@N00,4985,15,1455601977,1455602157,2,14,180
52574631@N00,4985,14,1455602703,1455602823,3,14,120
52574631@N00,4985,6,1455603820,1455604075,5,14,255
52574631@N00,4985,2,1455610172,1455610262,1,14,90
52574631@N00,4986,10,1455669582,1455669746,2,10,164
52574631@N00,4986,14,1455669746,1455669866,2,10,120
52574631@N00,4986,10,1455670477,1455670897,6,10,420
52574631@N00,4986,14,1455673835,1455673955,2,10,120
52574631@N00,4986,15,1455676847,1455677027,3,10,180
52574631@N00,4986,27,1455692974,1455694174,2,10,1200
52574631@N00,4986,8,1455702862,1455702982,3,10,120
52574631@N00,4986,19,1455706063,1455706483,3,10,420
52574631@N00,4986,15,1455709857,1455710037,3,10,180
52574631@N00,4986,16,1455710876,1455711596,1,10,720
52574631@N00,4987,27,1456013554,1456014754,4,11,1200
52574631@N00,4987,14,1456015735,1456015855,6,11,120
52574631@N00,4987,1,1456021716,1456022316,2,11,600
52574631@N00,4987,2,1456025230,1456025320,4,11,90
52574631@N00,4987,3,1456025658,1456025928,3,11,270
52574631@N00,4987,2,1456029037,1456029121,2,11,84
52574631@N00,4987,4,1456029121,1456030021,2,11,900
52574631@N00,4987,2,1456031330,1456031420,2,11,90
52574631@N00,4987,4,1456032558,1456033179,2,11,621
52574631@N00,4987,1,1456033179,1456033779,2,11,600
52574631@N00,4987,27,1456036507,1456037707,4,11,1200
52576475@N00,4988,15,1384653512,1384653692,5,2,180
52576475@N00,4988,2,1384665613,1384665703,3,2,90
52627430@N00,4989,16,1222581951,1222582671,5,1,720
52636686@N07,4990,27,1390248541,1390249741,14,37,1200
52636686@N07,4990,20,1390255766,1390256089,6,37,323
52636686@N07,4990,19,1390256089,1390256089,2,37,0
52636686@N07,4990,20,1390256089,1390256160,2,37,71
52636686@N07,4990,19,1390256160,1390256580,3,37,420
52636686@N07,4990,27,1390256726,1390257380,4,37,654
52636686@N07,4990,19,1390257380,1390257800,6,37,420
52636686@N07,4990,26,1390258527,1390258699,4,37,172
52636686@N07,4990,13,1390258699,1390259299,18,37,600
52636686@N07,4990,17,1390259882,1390260147,3,37,265
52636686@N07,4990,13,1390260147,1390260547,2,37,400
52636686@N07,4990,22,1390260547,1390261147,6,37,600
52636686@N07,4990,18,1390261221,1390261493,7,37,272
52636686@N07,4990,13,1390261493,1390261651,2,37,158
52636686@N07,4990,18,1390261651,1390262019,7,37,368
52636686@N07,4990,19,1390262019,1390262439,7,37,420
52636686@N07,4990,21,1390264033,1390264483,24,37,450
52636686@N07,4990,23,1390266171,1390266261,7,37,90
52636686@N07,4990,17,1390266632,1390268012,11,37,1380
52636686@N07,4990,16,1390269221,1390269941,9,37,720
52636686@N07,4990,9,1390270149,1390270389,2,37,240
52636686@N07,4990,14,1390270426,1390270546,4,37,120
52636686@N07,4990,7,1390271915,1390272005,6,37,90
52636686@N07,4990,10,1390273461,1390273858,5,37,397
52636686@N07,4990,8,1390273858,1390273978,8,37,120
52636686@N07,4990,1,1390274461,1390275061,2,37,600
52636686@N07,4990,2,1390275113,1390275203,7,37,90
52636686@N07,4990,1,1390276532,1390276733,3,37,201
52636686@N07,4990,6,1390276733,1390276988,13,37,255
52636686@N07,4990,10,1390279410,1390279830,14,37,420
52636686@N07,4990,14,1390281206,1390281326,6,37,120
52636686@N07,4990,15,1390282029,1390282209,5,37,180
52636686@N07,4990,12,1390282264,1390283104,22,37,840
52636686@N07,4990,15,1390283529,1390283709,3,37,180
52636686@N07,4990,27,1390286695,1390287895,56,37,1200
52636686@N07,4990,1,1390289420,1390290020,10,37,600
52636686@N07,4990,7,1390290531,1390290621,1,37,90
52666614@N06,4991,27,1407885687,1407886887,2,5,1200
52666614@N06,4991,20,1407886896,1407887976,4,5,1080
52666614@N06,4991,19,1407890342,1407890762,3,5,420
52666614@N06,4991,14,1407891377,1407891457,2,5,80
52666614@N06,4991,10,1407891457,1407891877,3,5,420
52666614@N06,4992,27,1408077408,1408078608,2,10,1200
52666614@N06,4992,21,1408079129,1408079579,9,10,450
52666614@N06,4992,14,1408082497,1408082615,3,10,118
52666614@N06,4992,16,1408082615,1408082863,2,10,248
52666614@N06,4992,10,1408082863,1408083283,10,10,420
52666614@N06,4992,26,1408091459,1408091639,2,10,180
52666614@N06,4992,20,1408092260,1408092724,3,10,464
52666614@N06,4992,22,1408092724,1408093324,2,10,600
52666614@N06,4992,3,1408095713,1408095983,3,10,270
52666614@N06,4992,4,1408100646,1408101546,2,10,900
52666614@N06,4993,6,1408190658,1408190788,2,11,130
52666614@N06,4993,7,1408190788,1408190878,3,11,90
52666614@N06,4993,14,1408191596,1408191716,4,11,120
52666614@N06,4993,15,1408194086,1408194209,2,11,123
52666614@N06,4993,14,1408194209,1408194329,4,11,120
52666614@N06,4993,10,1408194902,1408195322,6,11,420
52666614@N06,4993,9,1408196038,1408196278,6,11,240
52666614@N06,4993,10,1408197188,1408197608,3,11,420
52666614@N06,4993,12,1408197800,1408198640,4,11,840
52666614@N06,4993,10,1408198919,1408199336,2,11,417
52666614@N06,4993,9,1408199336,1408199576,1,11,240
52666614@N06,4994,13,1408443401,1408444001,3,3,600
52666614@N06,4994,9,1408445413,1408445653,3,3,240
52666614@N06,4994,4,1408448973,1408449873,2,3,900
52683535@N00,4995,16,1322821942,1322822662,1,1,720
52758053@N07,4996,16,1309600251,1309600971,1,1,720
52758053@N07,4997,1,1309649628,1309650228,2,2,600
52758053@N07,4997,13,1309655225,1309655825,1,2,600
52758053@N07,4998,16,1335341713,1335342433,1,1,720
52758053@N07,4999,9,1375571265,1375571418,2,12,153
52758053@N07,4999,10,1375571418,1375571838,2,12,420
52758053@N07,4999,14,1375572160,1375572280,2,12,120
52758053@N07,4999,11,1375573470,1375573650,2,12,180
52758053@N07,4999,14,1375574802,1375574922,3,12,120
52758053@N07,4999,12,1375583533,1375583713,2,12,180
52758053@N07,4999,9,1375583713,1375583755,2,12,42
52758053@N07,4999,12,1375583755,1375584595,2,12,840
52758053@N07,4999,27,1375604317,1375605182,2,12,865
52758053@N07,4999,24,1375605182,1375605662,2,12,480
52758053@N07,4999,13,1375606651,1375607251,2,12,600
52758053@N07,4999,16,1375616113,1375616833,1,12,720
52758053@N07,5000,15,1375842460,1375842640,1,1,180
52758053@N07,5001,13,1376005467,1376005523,2,6,56
52758053@N07,5001,17,1376005523,1376005725,2,6,202
52758053@N07,5001,22,1376005725,1376006325,2,6,600
52758053@N07,5001,20,1376006728,1376006751,2,6,23
52758053@N07,5001,19,1376006751,1376007171,3,6,420
52758053@N07,5001,18,1376011659,1376013459,1,6,1800
52758053@N07,5002,27,1376207713,1376208913,1,1,1200
52758053@N07,5003,16,1400790946,1400791666,2,2,720
52758053@N07,5003,17,1400811815,1400813195,1,2,1380
52758053@N07,5004,3,1431166079,1431166349,1,1,270
52786697@N00,5005,27,1239511866,1239513066,2,3,1200
52786697@N00,5005,6,1239520634,1239520889,2,3,255
52786697@N00,5005,8,1239524717,1239524837,3,3,120
52793155@N07,5006,2,1295151475,1295151565,1,1,90
52793155@N07,5007,9,1297430739,1297430979,1,1,240
52793155@N07,5008,14,1297672706,1297672826,1,1,120
52793155@N07,5009,2,1334356357,1334356447,1,1,90
52793155@N07,5010,24,1336815122,1336815602,2,2,480
52793155@N07,5010,23,1336815920,1336816010,1,2,90
52793155@N07,5011,27,1352780391,1352781591,2,6,1200
52793155@N07,5011,9,1352783573,1352783813,2,6,240
52793155@N07,5011,16,1352788227,1352788403,2,6,176
52793155@N07,5011,14,1352788403,1352788523,4,6,120
52793155@N07,5011,2,1352794540,1352794630,2,6,90
52793155@N07,5011,4,1352794883,1352795783,1,6,900
52793155@N07,5012,17,1363219991,1363221371,1,1,1380
52793155@N07,5013,27,1366504107,1366505307,1,1,1200
52793155@N07,5014,23,1383171271,1383171361,1,1,90
52793155@N07,5015,27,1395288712,1395289275,2,3,563
52793155@N07,5015,1,1395289275,1395289875,3,3,600
52793155@N07,5015,3,1395295766,1395296036,1,3,270
52793155@N07,5016,14,1396685350,1396685470,1,1,120
52793155@N07,5017,23,1396919838,1396919928,1,1,90
52793155@N07,5018,12,1420262456,1420263296,1,1,840
52800207@N06,5019,21,1409289614,1409290064,4,1,450
52800207@N06,5020,21,1409461241,1409461691,1,1,450
52800207@N06,5021,21,1409636217,1409636667,2,1,450
52842822@N04,5022,17,1372075890,1372077270,1,1,1380
52855156@N00,5023,27,1216852438,1216853638,1,1,1200
52871849@N04,5024,10,1420345538,1420345958,1,1,420
52872213@N04,5025,16,1301681530,1301682250,1,1,720
52884050@N08,5026,16,1322465837,1322466557,1,1,720
52892088@N02,5027,17,1346558772,1346558968,2,3,196
52892088@N02,5027,18,1346558968,1346560768,2,3,1800
52892088@N02,5027,10,1346582375,1346582795,1,3,420
52892088@N02,5028,9,1367702536,1367702776,1,1,240
52906672@N00,5029,27,1407714109,1407715309,2,2,1200
52906672@N00,5029,17,1407726241,1407727621,1,2,1380
52906672@N00,5030,4,1407923944,1407924844,4,1,900
52906672@N00,5031,6,1408010209,1408010464,2,3,255
52906672@N00,5031,10,1408020569,1408020989,2,3,420
52906672@N00,5031,9,1408023979,1408024219,1,3,240
52976240@N00,5032,27,1354947179,1354948379,6,1,1200
52976240@N00,5033,8,1355040228,1355040348,2,4,120
52976240@N00,5033,19,1355040906,1355041326,2,4,420
52976240@N00,5033,10,1355045870,1355046290,2,4,420
52976240@N00,5033,27,1355055995,1355057195,1,4,1200
52976240@N00,5034,26,1424481455,1424481635,1,1,180
52982457@N00,5035,16,1278454717,1278455437,291,1,720
52999052@N08,5036,27,1278976031,1278977231,1,1,1200
53003768@N06,5037,27,1362410218,1362411418,1,1,1200
53024970@N07,5038,13,1329087537,1329088137,1,1,600
53024970@N07,5039,8,1334488586,1334488706,1,1,120
53025862@N00,5040,17,1420336583,1420336679,2,14,96
53025862@N00,5040,25,1420336679,1420337429,2,14,750
53025862@N00,5040,15,1420337749,1420337929,5,14,180
53025862@N00,5040,20,1420339416,1420340496,13,14,1080
53025862@N00,5040,15,1420345136,1420345316,8,14,180
53025862@N00,5040,2,1420350625,1420350715,3,14,90
53025862@N00,5040,9,1420352430,1420352670,10,14,240
53025862@N00,5040,6,1420356902,1420357157,6,14,255
53025862@N00,5040,26,1420360994,1420361174,5,14,180
53025862@N00,5040,16,1420362522,1420363242,5,14,720
53025862@N00,5040,11,1420364215,1420364395,2,14,180
53025862@N00,5040,12,1420366000,1420366840,13,14,840
53025862@N00,5040,14,1420369008,1420369128,37,14,120
53025862@N00,5040,10,1420370970,1420371390,8,14,420
53046881@N07,5041,27,1389598478,1389599678,1,1,1200
53052885@N08,5042,25,1372367209,1372367959,1,1,750
53055319@N00,5043,27,1188721058,1188722258,11,3,1200
53055319@N00,5043,2,1188722601,1188722691,3,3,90
53055319@N00,5043,19,1188722732,1188723152,1,3,420
53055319@N00,5044,27,1197883967,1197884269,2,4,302
53055319@N00,5044,3,1197884269,1197884323,2,4,54
53055319@N00,5044,2,1197884323,1197884376,2,4,53
53055319@N00,5044,9,1197884376,1197884616,1,4,240
53079182@N04,5045,16,1251948719,1251949439,1,1,720
53123154@N04,5046,27,1294426761,1294427961,2,1,1200
53127166@N04,5047,27,1391208275,1391209475,4,1,1200
53127166@N04,5048,27,1393058579,1393059779,1,1,1200
53129881@N00,5049,24,1366593439,1366593919,2,3,480
53129881@N00,5049,16,1366613994,1366614070,2,3,76
53129881@N00,5049,22,1366614070,1366614670,1,3,600
53199533@N07,5050,13,1268658014,1268658018,5,5,4
53199533@N07,5050,15,1268658018,1268658019,2,5,1
53199533@N07,5050,13,1268658019,1268658032,4,5,13
53199533@N07,5050,7,1268658032,1268658034,3,5,2
53199533@N07,5050,21,1268658034,1268658484,1,5,450
53199533@N07,5051,19,1269003611,1269003615,5,7,4
53199533@N07,5051,12,1269003615,1269003619,5,7,4
53199533@N07,5051,15,1269003619,1269003620,2,7,1
53199533@N07,5051,12,1269003620,1269003621,2,7,1
53199533@N07,5051,14,1269003621,1269003623,2,7,2
53199533@N07,5051,9,1269003623,1269003626,4,7,3
53199533@N07,5051,6,1269003626,1269003881,1,7,255
53199533@N07,5052,1,1269090001,1269090002,2,5,1
53199533@N07,5052,4,1269090002,1269090004,3,5,2
53199533@N07,5052,16,1269090004,1269090020,15,5,16
53199533@N07,5052,21,1269090020,1269090025,4,5,5
53199533@N07,5052,27,1269090025,1269091225,1,5,1200
53325263@N07,5053,19,1301186568,1301186988,2,4,420
53325263@N07,5053,6,1301193766,1301194021,5,4,255
53325263@N07,5053,11,1301201772,1301201952,2,4,180
53325263@N07,5053,27,1301210351,1301211551,2,4,1200
53342633@N00,5054,9,1224039450,1224039690,3,4,240
53342633@N00,5054,1,1224047256,1224047856,2,4,600
53342633@N00,5054,3,1224047944,1224048214,2,4,270
53342633@N00,5054,27,1224066264,1224067464,1,4,1200
53342633@N00,5055,15,1288596905,1288597085,2,3,180
53342633@N00,5055,14,1288597477,1288597597,2,3,120
53342633@N00,5055,17,1288597804,1288599184,1,3,1380
53353745@N00,5056,14,1399763144,1399763264,2,3,120
53353745@N00,5056,8,1399773167,1399773287,2,3,120
53353745@N00,5056,2,1399783721,1399783811,1,3,90
53407359@N00,5057,6,1417564934,1417565189,4,2,255
53407359@N00,5057,20,1417580323,1417581403,1,2,1080
53438674@N03,5058,22,1256762713,1256763313,23,1,600
53438674@N03,5059,22,1286834189,1286834789,16,1,600
53439923@N02,5060,16,1307720871,1307721591,2,2,720
53439923@N02,5060,2,1307722816,1307722906,1,2,90
53467158@N00,5061,3,1319545989,1319546259,1,1,270
53516741@N04,5062,27,1319190205,1319191405,9,3,1200
53516741@N04,5062,13,1319199613,1319200213,3,3,600
53516741@N04,5062,27,1319204216,1319205416,1,3,1200
53516741@N04,5063,18,1319408077,1319409877,3,8,1800
53516741@N04,5063,20,1319412532,1319413612,3,8,1080
53516741@N04,5063,14,1319438809,1319438929,2,8,120
53516741@N04,5063,16,1319439495,1319440215,2,8,720
53516741@N04,5063,15,1319443399,1319443579,2,8,180
53516741@N04,5063,26,1319450879,1319451059,2,8,180
53516741@N04,5063,23,1319456479,1319456569,2,8,90
53516741@N04,5063,27,1319458196,1319459396,2,8,1200
53516741@N04,5064,20,1386577221,1386578301,2,2,1080
53516741@N04,5064,26,1386592403,1386592583,1,2,180
53516741@N04,5065,26,1413538214,1413538394,2,2,180
53516741@N04,5065,13,1413549479,1413550079,1,2,600
53602988@N02,5066,5,1302826333,1302827053,13,3,720
53602988@N02,5066,16,1302827784,1302827884,2,3,100
53602988@N02,5066,5,1302827884,1302828604,4,3,720
53602988@N02,5067,16,1353118837,1353119449,2,3,612
53602988@N02,5067,8,1353119449,1353119569,2,3,120
53602988@N02,5067,16,1353123533,1353124253,1,3,720
53613159@N04,5068,27,1319326561,1319327761,3,4,1200
53613159@N04,5068,18,1319335600,1319337400,2,4,1800
53613159@N04,5068,17,1319339097,1319340477,2,4,1380
53613159@N04,5068,27,1319345346,1319346546,2,4,1200
53613159@N04,5069,25,1319770686,1319771436,1,1,750
53727855@N08,5070,16,1327984640,1327985360,7,1,720
53727855@N08,5071,16,1328051837,1328052557,12,1,720
53786716@N06,5072,10,1351309703,1351310123,1,1,420
53797701@N07,5073,18,1406462997,1406464797,1,1,1800
53798207@N02,5074,22,1303709210,1303709810,1,1,600
53821866@N05,5075,27,1470036084,1470037284,1,1,1200
53901034@N00,5076,27,1362701847,1362703047,6,13,1200
53901034@N00,5076,25,1362708965,1362709715,3,13,750
53901034@N00,5076,23,1362710812,1362710902,2,13,90
53901034@N00,5076,24,1362714121,1362714601,3,13,480
53901034@N00,5076,22,1362715221,1362715821,2,13,600
53901034@N00,5076,14,1362718456,1362718576,2,13,120
53901034@N00,5076,9,1362719484,1362719724,2,13,240
53901034@N00,5076,8,1362720222,1362720342,4,13,120
53901034@N00,5076,11,1362721043,1362721223,3,13,180
53901034@N00,5076,12,1362730042,1362730701,2,13,659
53901034@N00,5076,14,1362730701,1362730821,2,13,120
53901034@N00,5076,12,1362731245,1362731518,2,13,273
53901034@N00,5076,16,1362731518,1362732238,2,13,720
53901034@N00,5077,27,1362870667,1362871867,2,10,1200
53901034@N00,5077,3,1362876055,1362876325,2,10,270
53901034@N00,5077,8,1362880753,1362880873,2,10,120
53901034@N00,5077,14,1362885839,1362885959,4,10,120
53901034@N00,5077,17,1362892984,1362894364,2,10,1380
53901034@N00,5077,11,1362897350,1362897530,3,10,180
53901034@N00,5077,9,1362898288,1362898528,2,10,240
53901034@N00,5077,4,1362898595,1362899495,3,10,900
53901034@N00,5077,16,1362900396,1362901116,2,10,720
53901034@N00,5077,9,1362903512,1362903752,1,10,240
53937205@N06,5078,17,1278241340,1278242720,13,1,1380
53964849@N08,5079,16,1347016838,1347017558,2,1,720
53964849@N08,5080,16,1347065159,1347065879,2,1,720
53980976@N07,5081,14,1372720428,1372720548,1,1,120
54010592@N03,5082,21,1296156099,1296156549,31,1,450
54010592@N03,5083,21,1296247223,1296247673,60,1,450
54010592@N03,5084,21,1296346251,1296346701,8,1,450
54033452@N00,5085,10,1360205332,1360205752,1,1,420
54034604@N00,5086,15,1381358229,1381358409,4,5,180
54034604@N00,5086,9,1381359371,1381359611,4,5,240
54034604@N00,5086,10,1381361427,1381361847,14,5,420
54034604@N00,5086,3,1381364107,1381364377,2,5,270
54034604@N00,5086,1,1381366385,1381366985,1,5,600
54182124@N02,5087,26,1363923003,1363923183,1,1,180
54250081@N05,5088,25,1370034670,1370035136,2,20,466
54250081@N05,5088,21,1370035136,1370035586,12,20,450
54250081@N05,5088,23,1370039508,1370039598,7,20,90
54250081@N05,5088,24,1370040893,1370040986,5,20,93
54250081@N05,5088,21,1370040986,1370041158,4,20,172
54250081@N05,5088,24,1370041158,1370041191,2,20,33
54250081@N05,5088,25,1370041191,1370041294,2,20,103
54250081@N05,5088,24,1370041294,1370041734,13,20,440
54250081@N05,5088,21,1370041734,1370042184,11,20,450
54250081@N05,5088,20,1370043052,1370043358,4,20,306
54250081@N05,5088,18,1370043358,1370043482,3,20,124
54250081@N05,5088,19,1370043482,1370043520,2,20,38
54250081@N05,5088,18,1370043520,1370043595,2,20,75
54250081@N05,5088,19,1370043595,1370043789,5,20,194
54250081@N05,5088,18,1370043789,1370045589,12,20,1800
54250081@N05,5088,16,1370047609,1370048329,4,20,720
54250081@N05,5088,17,1370055587,1370055673,2,20,86
54250081@N05,5088,14,1370055673,1370055793,5,20,120
54250081@N05,5088,9,1370055841,1370055889,2,20,48
54250081@N05,5088,10,1370055889,1370056309,1,20,420
54354082@N00,5089,19,1283572444,1283572864,2,2,420
54354082@N00,5089,27,1283574539,1283575739,3,2,1200
54364530@N08,5090,27,1354569954,1354571154,3,1,1200
54364530@N08,5091,20,1386806668,1386807284,11,5,616
54364530@N08,5091,19,1386807284,1386807490,2,5,206
54364530@N08,5091,20,1386807490,1386807580,5,5,90
54364530@N08,5091,22,1386807580,1386807594,2,5,14
54364530@N08,5091,20,1386807594,1386808674,1,5,1080
54364530@N08,5092,27,1449026181,1449027381,1,1,1200
54364530@N08,5093,3,1449402319,1449402589,2,1,270
54417425@N08,5094,5,1329251542,1329252262,1,1,720
54432460@N08,5095,26,1295495305,1295495485,1,1,180
54497431@N05,5096,16,1258534006,1258534726,1,1,720
54502770@N04,5097,27,1288733950,1288735150,1,1,1200
54512387@N04,5098,14,1313218619,1313218739,2,2,120
54512387@N04,5098,2,1313222230,1313222320,2,2,90
54573009@N00,5099,11,1295764357,1295764537,1,1,180
54575648@N03,5100,24,1364432174,1364432654,1,1,480
54612194@N05,5101,16,1364518741,1364519461,2,1,720
54619082@N05,5102,14,1321745292,1321745412,1,1,120
54619082@N05,5103,21,1337765543,1337765993,1,1,450
54623999@N07,5104,16,1307656087,1307656807,3,4,720
54623999@N07,5104,27,1307683689,1307684889,2,4,1200
54623999@N07,5104,16,1307707648,1307708368,3,4,720
54623999@N07,5104,27,1307711353,1307712553,2,4,1200
54679799@N03,5105,16,1370231973,1370232693,3,1,720
54679799@N03,5106,8,1370658463,1370658583,1,1,120
54679799@N03,5107,27,1386229497,1386230697,1,1,1200
54679799@N03,5108,16,1463810506,1463811226,2,3,720
54679799@N03,5108,21,1463815393,1463815843,2,3,450
54679799@N03,5108,16,1463824120,1463824840,2,3,720
54679799@N03,5109,15,1464218272,1464218452,2,6,180
54679799@N03,5109,12,1464225881,1464226349,2,6,468
54679799@N03,5109,14,1464226349,1464226469,2,6,120
54679799@N03,5109,27,1464228052,1464228823,2,6,771
54679799@N03,5109,1,1464228823,1464229423,2,6,600
54679799@N03,5109,27,1464257053,1464258253,2,6,1200
54679799@N03,5110,21,1464300792,1464301242,2,3,450
54679799@N03,5110,4,1464307193,1464308093,2,3,900
54679799@N03,5110,27,1464308923,1464310123,2,3,1200
54748189@N05,5111,27,1333770372,1333771572,1,1,1200
54780044@N02,5112,3,1302409413,1302409683,6,1,270
54804105@N07,5113,20,1454740200,1454741280,1,1,1080
54821630@N00,5114,27,1190159838,1190161038,116,1,1200
54831087@N00,5115,25,1286927538,1286928288,4,8,750
54831087@N00,5115,10,1286934724,1286935144,2,8,420
54831087@N00,5115,13,1286941721,1286942321,2,8,600
54831087@N00,5115,2,1286946331,1286946421,2,8,90
54831087@N00,5115,20,1286951271,1286951938,2,8,667
54831087@N00,5115,13,1286951938,1286952538,2,8,600
54831087@N00,5115,27,1286958258,1286958784,3,8,526
54831087@N00,5115,10,1286958784,1286959204,1,8,420
54845704@N05,5116,27,1298412756,1298413956,3,10,1200
54845704@N05,5116,14,1298424393,1298424513,3,10,120
54845704@N05,5116,6,1298425773,1298426028,2,10,255
54845704@N05,5116,9,1298427196,1298427436,3,10,240
54845704@N05,5116,7,1298429144,1298429234,2,10,90
54845704@N05,5116,2,1298429777,1298429867,2,10,90
54845704@N05,5116,5,1298434623,1298434955,2,10,332
54845704@N05,5116,6,1298434955,1298435210,2,10,255
54845704@N05,5116,2,1298441841,1298441931,2,10,90
54845704@N05,5116,16,1298444986,1298445706,3,10,720
54845704@N05,5117,27,1298595390,1298596435,2,7,1045
54845704@N05,5117,21,1298596435,1298596885,2,7,450
54845704@N05,5117,22,1298606677,1298607277,2,7,600
54845704@N05,5117,23,1298608321,1298608411,3,7,90
54845704@N05,5117,20,1298609966,1298611046,2,7,1080
54845704@N05,5117,26,1298612002,1298612182,5,7,180
54845704@N05,5117,17,1298614287,1298615667,4,7,1380
54855264@N00,5118,27,1192952290,1192952945,2,12,655
54855264@N00,5118,16,1192952945,1192953070,2,12,125
54855264@N00,5118,17,1192953070,1192954450,2,12,1380
54855264@N00,5118,26,1192954684,1192954864,3,12,180
54855264@N00,5118,14,1192959372,1192959492,6,12,120
54855264@N00,5118,26,1192963135,1192963315,2,12,180
54855264@N00,5118,17,1192963626,1192964542,3,12,916
54855264@N00,5118,13,1192964542,1192965142,3,12,600
54855264@N00,5118,7,1192966893,1192966983,2,12,90
54855264@N00,5118,3,1192968525,1192968795,3,12,270
54855264@N00,5118,16,1192970085,1192970805,8,12,720
54855264@N00,5118,27,1192970879,1192972079,2,12,1200
54855264@N00,5119,27,1376218034,1376219234,1,1,1200
54886079@N07,5120,26,1282047082,1282047262,1,1,180
54902025@N00,5121,27,1227257139,1227258339,1,1,1200
54902025@N00,5122,27,1286521236,1286522436,2,8,1200
54902025@N00,5122,14,1286524592,1286524712,2,8,120
54902025@N00,5122,13,1286526597,1286527197,3,8,600
54902025@N00,5122,21,1286529135,1286529486,2,8,351
54902025@N00,5122,20,1286529486,1286530566,2,8,1080
54902025@N00,5122,9,1286531285,1286531525,2,8,240
54902025@N00,5122,3,1286535701,1286535971,5,8,270
54902025@N00,5122,27,1286543413,1286544613,1,8,1200
54902025@N00,5123,2,1286761420,1286761510,2,5,90
54902025@N00,5123,18,1286764464,1286766142,2,5,1678
54902025@N00,5123,23,1286766142,1286766232,3,5,90
54902025@N00,5123,1,1286770282,1286770882,2,5,600
54902025@N00,5123,27,1286771831,1286773031,1,5,1200
54902025@N00,5124,25,1329013853,1329014603,2,7,750
54902025@N00,5124,21,1329014810,1329015260,2,7,450
54902025@N00,5124,18,1329017534,1329019334,2,7,1800
54902025@N00,5124,13,1329021542,1329022142,2,7,600
54902025@N00,5124,12,1329025911,1329026751,2,7,840
54902025@N00,5124,3,1329032562,1329032832,2,7,270
54902025@N00,5124,4,1329037298,1329038198,1,7,900
54902025@N00,5125,21,1329110776,1329111226,3,2,450
54902025@N00,5125,13,1329117497,1329118097,1,2,600
54902025@N00,5126,21,1332309228,1332309678,3,5,450
54902025@N00,5126,18,1332323123,1332324923,4,5,1800
54902025@N00,5126,7,1332327655,1332327745,2,5,90
54902025@N00,5126,9,1332328230,1332328470,2,5,240
54902025@N00,5126,1,1332328971,1332329571,1,5,600
54902025@N00,5127,25,1332405745,1332406495,2,4,750
54902025@N00,5127,26,1332412146,1332412326,2,4,180
54902025@N00,5127,16,1332419730,1332420450,3,4,720
54902025@N00,5127,25,1332420800,1332421550,1,4,750
54902025@N00,5128,10,1354698498,1354698918,6,3,420
54902025@N00,5128,7,1354704699,1354704789,2,3,90
54902025@N00,5128,27,1354708686,1354709886,1,3,1200
54902025@N00,5129,16,1354752676,1354753396,1,1,720
54902025@N00,5130,27,1379325798,1379326998,2,4,1200
54902025@N00,5130,14,1379329941,1379330061,2,4,120
54902025@N00,5130,25,1379332710,1379333460,2,4,750
54902025@N00,5130,27,1379334704,1379335904,2,4,1200
54902025@N00,5131,27,1379417684,1379418884,4,4,1200
54902025@N00,5131,26,1379425881,1379426060,2,4,179
54902025@N00,5131,20,1379426060,1379427140,2,4,1080
54902025@N00,5131,13,1379427203,1379427803,1,4,600
54962605@N00,5132,16,1332046942,1332047662,1,1,720
55005522@N00,5133,27,1217809948,1217811148,1,1,1200
55005522@N00,5134,27,1249492420,1249493620,1,1,1200
55005522@N00,5135,27,1344339041,1344340241,8,1,1200
55041396@N00,5136,27,1367044482,1367045682,2,2,1200
55041396@N00,5136,8,1367049502,1367049622,1,2,120
55050519@N08,5137,2,1325841243,1325841333,1,1,90
55095306@N02,5138,10,1310668164,1310668584,1,1,420
55132698@N04,5139,16,1332127151,1332127871,1,1,720
55143107@N00,5140,5,1223943991,1223944711,6,3,720
55143107@N00,5140,15,1223948914,1223949094,4,3,180
55143107@N00,5140,27,1223959967,1223961167,2,3,1200
55171970@N00,5141,26,1439205768,1439205948,20,1,180
55191318@N04,5142,2,1287118809,1287118899,4,1,90
55193633@N05,5143,17,1352797872,1352799252,9,1,1380
55206790@N08,5144,14,1309776781,1309776901,9,1,120
55206790@N08,5145,6,1362733602,1362733857,1,1,255
55217458@N00,5146,25,1352620138,1352620296,2,2,158
55217458@N00,5146,1,1352620296,1352620896,1,2,600
55217458@N00,5147,3,1352836189,1352836288,2,5,99
55217458@N00,5147,16,1352836288,1352836337,2,5,49
55217458@N00,5147,14,1352836337,1352836457,2,5,120
55217458@N00,5147,10,1352836521,1352836941,3,5,420
55217458@N00,5147,24,1352864094,1352864574,1,5,480
55217458@N00,5148,14,1389139364,1389139484,2,6,120
55217458@N00,5148,19,1389139849,1389140269,2,6,420
55217458@N00,5148,22,1389142574,1389143174,2,6,600
55217458@N00,5148,21,1389143778,1389144228,2,6,450
55217458@N00,5148,16,1389145443,1389146163,2,6,720
55217458@N00,5148,1,1389148593,1389149193,1,6,600
55217458@N00,5149,16,1389384814,1389385534,1,1,720
55217458@N00,5150,1,1389482774,1389482862,2,2,88
55217458@N00,5150,16,1389482862,1389483582,1,2,720
55236153@N04,5151,27,1289913427,1289914627,1,1,1200
55332987@N00,5152,18,1257674360,1257676160,1,1,1800
55332987@N00,5153,3,1265498173,1265498443,1,1,270
55362088@N06,5154,1,1341975794,1341976394,1,1,600
55364225@N06,5155,27,1251727200,1251728400,10,1,1200
55404083@N08,5156,12,1303387376,1303388216,1,1,840
55404083@N08,5157,16,1303983393,1303984113,2,2,720
55404083@N08,5157,12,1303989646,1303990486,1,2,840
55405015@N08,5158,5,1375486199,1375486275,2,5,76
55405015@N08,5158,4,1375486275,1375487175,2,5,900
55405015@N08,5158,6,1375488660,1375488915,3,5,255
55405015@N08,5158,21,1375502277,1375502727,2,5,450
55405015@N08,5158,27,1375507800,1375509000,3,5,1200
55432889@N05,5159,21,1358305674,1358306124,10,1,450
55442189@N00,5160,27,1403995579,1403996779,1,1,1200
55455788@N00,5161,25,1198094305,1198095055,11,35,750
55455788@N00,5161,16,1198100480,1198100765,2,35,285
55455788@N00,5161,14,1198100765,1198100885,6,35,120
55455788@N00,5161,25,1198105187,1198105666,2,35,479
55455788@N00,5161,9,1198105666,1198105906,3,35,240
55455788@N00,5161,25,1198106143,1198106893,5,35,750
55455788@N00,5161,8,1198107352,1198107472,2,35,120
55455788@N00,5161,25,1198108504,1198108993,3,35,489
55455788@N00,5161,8,1198108993,1198109113,2,35,120
55455788@N00,5161,25,1198109305,1198110055,6,35,750
55455788@N00,5161,6,1198110420,1198110675,3,35,255
55455788@N00,5161,9,1198115804,1198116044,7,35,240
55455788@N00,5161,25,1198116876,1198117626,3,35,750
55455788@N00,5161,16,1198117761,1198117997,3,35,236
55455788@N00,5161,8,1198117997,1198118117,8,35,120
55455788@N00,5161,16,1198118510,1198119067,5,35,557
55455788@N00,5161,27,1198119067,1198119224,2,35,157
55455788@N00,5161,25,1198119224,1198119905,2,35,681
55455788@N00,5161,8,1198119905,1198120025,3,35,120
55455788@N00,5161,25,1198120031,1198120781,3,35,750
55455788@N00,5161,6,1198121324,1198121579,3,35,255
55455788@N00,5161,16,1198122043,1198122358,2,35,315
55455788@N00,5161,14,1198122358,1198122478,7,35,120
55455788@N00,5161,9,1198126523,1198126763,5,35,240
55455788@N00,5161,21,1198129113,1198129396,3,35,283
55455788@N00,5161,16,1198129396,1198129459,3,35,63
55455788@N00,5161,8,1198129459,1198129467,2,35,8
55455788@N00,5161,16,1198129467,1198129477,2,35,10
55455788@N00,5161,8,1198129477,1198129597,6,35,120
55455788@N00,5161,6,1198132034,1198132289,4,35,255
55455788@N00,5161,5,1198132974,1198133694,2,35,720
55455788@N00,5161,22,1198134983,1198135583,2,35,600
55455788@N00,5161,21,1198139129,1198139419,2,35,290
55455788@N00,5161,25,1198139419,1198139844,2,35,425
55455788@N00,5161,16,1198139844,1198140564,5,35,720
55455788@N00,5162,3,1222560575,1222560845,6,4,270
55455788@N00,5162,17,1222569648,1222571028,7,4,1380
55455788@N00,5162,21,1222580636,1222580849,3,4,213
55455788@N00,5162,19,1222580849,1222581269,1,4,420
55455788@N00,5163,16,1239523738,1239524458,15,1,720
55455788@N00,5164,22,1255776688,1255776724,2,3,36
55455788@N00,5164,16,1255776724,1255776753,2,3,29
55455788@N00,5164,9,1255776753,1255776993,1,3,240
55455788@N00,5165,14,1256680669,1256680789,1,1,120
55455788@N00,5166,27,1276232894,1276234094,2,11,1200
55455788@N00,5166,16,1276234484,1276235204,6,11,720
55455788@N00,5166,22,1276235754,1276236354,15,11,600
55455788@N00,5166,25,1276237453,1276238203,8,11,750
55455788@N00,5166,12,1276241039,1276241879,23,11,840
55455788@N00,5166,14,1276243079,1276243199,11,11,120
55455788@N00,5166,9,1276247278,1276247518,2,11,240
55455788@N00,5166,3,1276248557,1276248827,2,11,270
55455788@N00,5166,6,1276250277,1276250532,4,11,255
55455788@N00,5166,17,1276255383,1276256763,53,11,1380
55455788@N00,5166,16,1276257387,1276258107,94,11,720
55455788@N00,5167,26,1292070313,1292070493,1,1,180
55455788@N00,5168,14,1420067538,1420067580,2,7,42
55455788@N00,5168,9,1420067580,1420067820,4,7,240
55455788@N00,5168,10,1420068019,1420068439,4,7,420
55455788@N00,5168,13,1420074752,1420075352,3,7,600
55455788@N00,5168,22,1420082070,1420082670,2,7,600
55455788@N00,5168,1,1420092016,1420092616,2,7,600
55455788@N00,5168,15,1420108303,1420108483,1,7,180
55466956@N00,5169,16,1209338440,1209339160,1,1,720
55474499@N04,5170,27,1317116710,1317117910,1,1,1200
55558729@N03,5171,18,1331338471,1331340271,1,1,1800
55569174@N00,5172,13,1349326678,1349327278,2,2,600
55569174@N00,5172,9,1349328820,1349329060,1,2,240
55615740@N00,5173,27,1404471736,1404471948,3,4,212
55615740@N00,5173,2,1404471948,1404472038,10,4,90
55615740@N00,5173,26,1404478995,1404479175,2,4,180
55615740@N00,5173,21,1404480006,1404480456,2,4,450
55615740@N00,5174,15,1410049333,1410049499,5,4,166
55615740@N00,5174,12,1410049499,1410049534,4,4,35
55615740@N00,5174,13,1410049534,1410050132,11,4,598
55615740@N00,5174,14,1410050132,1410050252,1,4,120
55653833@N04,5175,27,1379983681,1379984881,1,1,1200
55723046@N04,5176,10,1320718270,1320718690,2,1,420
55762226@N00,5177,17,1423983710,1423985090,1,1,1380
55762226@N00,5178,2,1439490639,1439490729,1,1,90
55762226@N00,5179,6,1441530840,1441531095,1,1,255
55894487@N00,5180,9,1335005707,1335005947,2,2,240
55894487@N00,5180,17,1335007507,1335008887,1,2,1380
55986062@N03,5181,27,1371162034,1371163234,1,1,1200
55986062@N03,5182,27,1371255133,1371256333,1,1,1200
55991777@N00,5183,27,1433541024,1433542224,2,7,1200
55991777@N00,5183,9,1433543217,1433543457,5,7,240
55991777@N00,5183,4,1433546373,1433547273,2,7,900
55991777@N00,5183,19,1433551719,1433552139,3,7,420
55991777@N00,5183,26,1433561801,1433561910,4,7,109
55991777@N00,5183,22,1433561910,1433562510,4,7,600
55991777@N00,5183,15,1433586600,1433586780,1,7,180
55991777@N00,5184,15,1433935727,1433935907,1,1,180
56005337@N03,5185,1,1285215734,1285216334,2,4,600
56005337@N03,5185,9,1285216956,1285217196,2,4,240
56005337@N03,5185,16,1285218366,1285219086,2,4,720
56005337@N03,5185,20,1285219468,1285220548,2,4,1080
56027706@N00,5186,16,1264215646,1264216366,3,2,720
56027706@N00,5186,24,1264216911,1264217391,1,2,480
56040377@N07,5187,14,1412233196,1412233316,2,3,120
56040377@N07,5187,17,1412233654,1412235034,2,3,1380
56040377@N07,5187,20,1412235321,1412236401,1,3,1080
56068273@N06,5188,12,1359619965,1359620805,1,1,840
56072795@N00,5189,16,1358011272,1358011992,1,1,720
56129960@N03,5190,27,1347483120,1347484320,3,2,1200
56129960@N03,5190,18,1347496583,1347498383,2,2,1800
56176110@N04,5191,4,1307870836,1307870972,2,8,136
56176110@N04,5191,12,1307870972,1307871812,2,8,840
56176110@N04,5191,14,1307872359,1307872479,2,8,120
56176110@N04,5191,16,1307876846,1307876904,2,8,58
56176110@N04,5191,12,1307876904,1307877024,2,8,120
56176110@N04,5191,16,1307877024,1307877596,2,8,572
56176110@N04,5191,12,1307877596,1307877759,3,8,163
56176110@N04,5191,27,1307877759,1307878959,1,8,1200
56223610@N07,5192,20,1335160618,1335161698,1,1,1080
56223610@N07,5193,4,1335197251,1335198151,5,1,900
56279017@N03,5194,2,1383947126,1383947216,1,1,90
56293740@N06,5195,16,1245251747,1245252467,1,1,720
56414555@N03,5196,21,1311837725,1311838175,2,2,450
56414555@N03,5196,27,1311843682,1311844882,1,2,1200
56414555@N03,5197,27,1311902649,1311903849,2,5,1200
56414555@N03,5197,25,1311905239,1311905989,3,5,750
56414555@N03,5197,21,1311915267,1311915717,3,5,450
56414555@N03,5197,5,1311920267,1311920987,2,5,720
56414555@N03,5197,1,1311922872,1311923472,2,5,600
56416261@N00,5198,21,1304045130,1304045580,3,1,450
56507536@N04,5199,1,1351470211,1351470811,1,1,600
56515177@N02,5200,27,1317702760,1317703960,3,12,1200
56515177@N02,5200,23,1317704611,1317704701,3,12,90
56515177@N02,5200,16,1317709287,1317709856,2,12,569
56515177@N02,5200,13,1317709856,1317710220,4,12,364
56515177@N02,5200,18,1317710220,1317711083,2,12,863
56515177@N02,5200,13,1317711083,1317711112,2,12,29
56515177@N02,5200,18,1317711112,1317711366,4,12,254
56515177@N02,5200,17,1317711366,1317711423,2,12,57
56515177@N02,5200,12,1317711423,1317712263,5,12,840
56515177@N02,5200,4,1317716094,1317716225,3,12,131
56515177@N02,5200,9,1317716225,1317716465,3,12,240
56515177@N02,5200,27,1317718488,1317719688,1,12,1200
56572346@N02,5201,27,1345876294,1345877321,2,4,1027
56572346@N02,5201,13,1345877321,1345877921,7,4,600
56572346@N02,5201,21,1345887974,1345888424,4,4,450
56572346@N02,5201,16,1345890436,1345891156,1,4,720
56572346@N02,5202,16,1351544400,1351545120,3,6,720
56572346@N02,5202,10,1351546187,1351546607,12,6,420
56572346@N02,5202,21,1351552844,1351553294,6,6,450
56572346@N02,5202,10,1351555939,1351556359,6,6,420
56572346@N02,5202,13,1351564063,1351564663,4,6,600
56572346@N02,5202,27,1351574235,1351575435,3,6,1200
56609749@N02,5203,14,1299648463,1299648583,2,4,120
56609749@N02,5203,16,1299655988,1299656708,2,4,720
56609749@N02,5203,14,1299666127,1299666247,2,4,120
56609749@N02,5203,22,1299666631,1299667231,1,4,600
56615362@N05,5204,19,1288420359,1288420779,2,2,420
56615362@N05,5204,16,1288433487,1288434207,2,2,720
56642201@N00,5205,25,1308362253,1308363003,3,1,750
56695999@N08,5206,14,1440528290,1440528410,1,1,120
56701972@N00,5207,25,1440770400,1440770400,2,18,0
56701972@N00,5207,27,1440770400,1440770401,2,18,1
56701972@N00,5207,25,1440770401,1440770401,2,18,0
56701972@N00,5207,27,1440770401,1440770404,4,18,3
56701972@N00,5207,25,1440770404,1440770404,2,18,0
56701972@N00,5207,27,1440770404,1440770405,2,18,1
56701972@N00,5207,25,1440770405,1440770405,2,18,0
56701972@N00,5207,27,1440770405,1440770406,2,18,1
56701972@N00,5207,25,1440770406,1440770406,2,18,0
56701972@N00,5207,27,1440770406,1440770407,2,18,1
56701972@N00,5207,25,1440770407,1440770407,2,18,0
56701972@N00,5207,27,1440770407,1440770408,2,18,1
56701972@N00,5207,25,1440770408,1440770408,2,18,0
56701972@N00,5207,27,1440770408,1440770409,2,18,1
56701972@N00,5207,25,1440770409,1440770410,3,18,1
56701972@N00,5207,27,1440770410,1440770411,2,18,1
56701972@N00,5207,25,1440770411,1440770411,2,18,0
56701972@N00,5207,27,1440770411,1440771611,4,18,1200
56701972@N00,5208,27,1440810743,1440811118,2,2,375
56701972@N00,5208,25,1440811118,1440811868,2,2,750
56726532@N06,5209,16,1419678402,1419679122,1,1,720
56795655@N00,5210,8,1296478800,1296478800,2,4,0
56795655@N00,5210,15,1296478800,1296478800,2,4,0
56795655@N00,5210,17,1296478800,1296478800,4,4,0
56795655@N00,5210,26,1296478800,1296478980,1,4,180
56815302@N00,5211,14,1231061021,1231061141,1,1,120
56881130@N02,5212,18,1295485260,1295487060,1,1,1800
56909601@N00,5213,20,1271916320,1271917400,1,1,1080
56922122@N03,5214,16,1255216804,1255217524,1,1,720
56922122@N03,5215,16,1260690519,1260691239,1,1,720
56922122@N03,5216,16,1267865571,1267866291,2,1,720
56922122@N03,5217,16,1283505222,1283505942,3,1,720
56922122@N03,5218,16,1283700173,1283700893,2,1,720
56922122@N03,5219,16,1301218401,1301219121,1,1,720
56922122@N03,5220,16,1313310606,1313311326,2,1,720
56922122@N03,5221,16,1320393862,1320394582,7,1,720
56922122@N03,5222,27,1326621292,1326622492,2,2,1200
56922122@N03,5222,16,1326623136,1326623856,1,2,720
56972276@N06,5223,24,1309591426,1309591906,2,1,480
57060047@N04,5224,3,1452216783,1452217053,2,1,270
57072623@N00,5225,27,1352452668,1352453868,1,1,1200
57102255@N00,5226,12,1354313373,1354314213,1,1,840
57147777@N05,5227,16,1311904293,1311905013,1,1,720
57169261@N06,5228,27,1395456991,1395458191,2,2,1200
57169261@N06,5228,16,1395468647,1395469367,1,2,720
57169261@N06,5229,15,1399371285,1399371465,1,1,180
57169261@N06,5230,3,1400114187,1400114457,1,1,270
57169261@N06,5231,3,1400578310,1400578580,1,1,270
57169261@N06,5232,25,1413602817,1413603567,1,1,750
57169261@N06,5233,20,1433494973,1433496053,1,1,1080
57248474@N00,5234,27,1250207661,1250208861,1,1,1200
57268629@N00,5235,27,1388395658,1388396858,4,5,1200
57268629@N00,5235,15,1388401339,1388401405,3,5,66
57268629@N00,5235,13,1388401405,1388401426,2,5,21
57268629@N00,5235,12,1388401426,1388402266,3,5,840
57268629@N00,5235,17,1388408552,1388409932,1,5,1380
57268629@N00,5236,26,1388540044,1388540224,19,6,180
57268629@N00,5236,17,1388552292,1388553287,3,6,995
57268629@N00,5236,13,1388553287,1388553887,2,6,600
57268629@N00,5236,12,1388555348,1388556188,2,6,840
57268629@N00,5236,10,1388558234,1388558654,6,6,420
57268629@N00,5236,2,1388563086,1388563176,1,6,90
57268629@N00,5237,27,1388744962,1388746162,1,1,1200
57268629@N00,5238,23,1389319056,1389319146,2,2,90
57268629@N00,5238,17,1389326351,1389327731,1,2,1380
57268629@N00,5239,17,1389849939,1389851319,1,1,1380
57311596@N05,5240,17,1259406911,1259408291,3,1,1380
57311596@N05,5241,18,1322047575,1322049375,2,2,1800
57311596@N05,5241,16,1322054973,1322055693,1,2,720
57377423@N00,5242,27,1362202326,1362203526,1,1,1200
57377423@N00,5243,27,1445857597,1445858797,1,1,1200
57441548@N00,5244,16,1261623500,1261624220,2,1,720
57453992@N04,5245,19,1259545767,1259546187,2,2,420
57453992@N04,5245,25,1259555856,1259556606,1,2,750
57453992@N04,5246,27,1295048101,1295048859,3,3,758
57453992@N04,5246,11,1295048859,1295049039,2,3,180
57453992@N04,5246,27,1295053787,1295054987,7,3,1200
57507580@N00,5247,27,1336264329,1336265529,2,6,1200
57507580@N00,5247,21,1336269076,1336269526,2,6,450
57507580@N00,5247,23,1336272466,1336272556,3,6,90
57507580@N00,5247,6,1336276103,1336276358,2,6,255
57507580@N00,5247,2,1336285717,1336285807,2,6,90
57507580@N00,5247,17,1336286389,1336287769,1,6,1380
57510064@N06,5248,27,1403513760,1403514960,1,1,1200
57516324@N03,5249,9,1428326346,1428326586,1,1,240
57540523@N07,5250,9,1294894924,1294895164,3,2,240
57540523@N07,5250,5,1294909282,1294910002,1,2,720
57619740@N05,5251,27,1329130666,1329131866,1,1,1200
57657053@N00,5252,12,1189926120,1189926140,2,2,20
57657053@N00,5252,27,1189926140,1189927340,2,2,1200
57657053@N00,5253,27,1195363369,1195364569,1,1,1200
57657053@N00,5254,12,1207355193,1207356033,3,2,840
57657053@N00,5254,9,1207358626,1207358866,2,2,240
57657053@N00,5255,27,1222414558,1222415758,5,4,1200
57657053@N00,5255,14,1222419707,1222419827,5,4,120
57657053@N00,5255,16,1222423453,1222424173,2,4,720
57657053@N00,5255,17,1222429109,1222430489,3,4,1380
57669645@N03,5256,25,1408075762,1408076512,2,4,750
57669645@N03,5256,24,1408083081,1408083561,2,4,480
57669645@N03,5256,23,1408085880,1408085970,2,4,90
57669645@N03,5256,27,1408111451,1408112651,1,4,1200
57669645@N03,5257,14,1408854503,1408854623,1,1,120
57672494@N04,5258,14,1415166067,1415166187,1,1,120
57765281@N06,5259,27,1307702226,1307703426,1,1,1200
57765281@N06,5260,16,1307921065,1307921785,1,1,720
57799803@N02,5261,3,1393290363,1393290633,1,1,270
57799803@N02,5262,25,1424501926,1424502676,1,1,750
57812277@N05,5263,16,1298674193,1298674913,2,3,720
57812277@N05,5263,14,1298675662,1298675782,2,3,120
57812277@N05,5263,27,1298701237,1298702437,9,3,1200
57812277@N05,5264,19,1343266485,1343266905,1,1,420
57812277@N05,5265,17,1343382312,1343383692,1,1,1380
57812277@N05,5266,9,1343690680,1343690920,2,2,240
57812277@N05,5266,21,1343700190,1343700640,1,2,450
57812277@N05,5267,27,1343819088,1343820288,2,1,1200
57812277@N05,5268,10,1356820880,1356821300,1,1,420
57812277@N05,5269,27,1375842610,1375843810,1,1,1200
57812277@N05,5270,14,1409544696,1409544816,1,1,120
57812277@N05,5271,27,1426728859,1426730059,1,1,1200
57835821@N00,5272,27,1196427600,1196428800,1,1,1200
57835821@N00,5273,27,1305412309,1305413509,8,5,1200
57835821@N00,5273,17,1305416127,1305417507,6,5,1380
57835821@N00,5273,15,1305422922,1305423102,2,5,180
57835821@N00,5273,9,1305423167,1305423407,6,5,240
57835821@N00,5273,12,1305424693,1305425533,1,5,840
57835821@N00,5274,2,1315636367,1315636416,3,3,49
57835821@N00,5274,6,1315636416,1315636671,2,3,255
57835821@N00,5274,27,1315644850,1315646050,2,3,1200
57835821@N00,5275,27,1327701837,1327703037,7,14,1200
57835821@N00,5275,21,1327704142,1327704551,3,14,409
57835821@N00,5275,20,1327704551,1327705354,6,14,803
57835821@N00,5275,21,1327705354,1327705804,17,14,450
57835821@N00,5275,24,1327708955,1327709435,15,14,480
57835821@N00,5275,27,1327731361,1327732561,2,14,1200
57835821@N00,5275,6,1327734420,1327734435,2,14,15
57835821@N00,5275,1,1327734435,1327734441,2,14,6
57835821@N00,5275,6,1327734441,1327734460,2,14,19
57835821@N00,5275,3,1327734460,1327734730,2,14,270
57835821@N00,5275,14,1327736073,1327736193,2,14,120
57835821@N00,5275,12,1327737591,1327738431,6,14,840
57835821@N00,5275,17,1327740342,1327741722,7,14,1380
57835821@N00,5275,23,1327744518,1327744608,2,14,90
57835821@N00,5276,27,1362089278,1362090478,4,5,1200
57835821@N00,5276,9,1362091608,1362091848,8,5,240
57835821@N00,5276,14,1362112965,1362113085,8,5,120
57835821@N00,5276,16,1362115412,1362116132,2,5,720
57835821@N00,5276,17,1362117329,1362118709,1,5,1380
57835821@N00,5277,27,1368232330,1368233530,2,9,1200
57835821@N00,5277,25,1368234147,1368234897,2,9,750
57835821@N00,5277,24,1368237789,1368238269,2,9,480
57835821@N00,5277,22,1368242445,1368243045,5,9,600
57835821@N00,5277,11,1368251944,1368252124,10,9,180
57835821@N00,5277,27,1368255017,1368255952,2,9,935
57835821@N00,5277,8,1368255952,1368256072,4,9,120
57835821@N00,5277,4,1368256696,1368257596,3,9,900
57835821@N00,5277,27,1368257770,1368258970,3,9,1200
57835821@N00,5278,27,1381531527,1381532727,4,15,1200
57835821@N00,5278,11,1381536815,1381536995,17,15,180
57835821@N00,5278,8,1381541962,1381542082,2,15,120
57835821@N00,5278,14,1381544889,1381545009,2,15,120
57835821@N00,5278,17,1381553263,1381554643,6,15,1380
57835821@N00,5278,13,1381555283,1381555416,3,15,133
57835821@N00,5278,18,1381555416,1381555484,2,15,68
57835821@N00,5278,13,1381555484,1381556084,2,15,600
57835821@N00,5278,25,1381557211,1381557645,7,15,434
57835821@N00,5278,26,1381557645,1381557825,2,15,180
57835821@N00,5278,22,1381559423,1381560023,2,15,600
57835821@N00,5278,21,1381561504,1381561954,3,15,450
57835821@N00,5278,17,1381563748,1381565128,2,15,1380
57835821@N00,5278,2,1381566308,1381566398,3,15,90
57835821@N00,5278,4,1381571581,1381572481,2,15,900
57835821@N00,5279,27,1394236073,1394236250,3,3,177
57835821@N00,5279,20,1394236250,1394237330,2,3,1080
57835821@N00,5279,26,1394249356,1394249536,1,3,180
57835821@N00,5280,27,1411691834,1411693034,3,10,1200
57835821@N00,5280,3,1411694938,1411695208,9,10,270
57835821@N00,5280,5,1411699015,1411699735,3,10,720
57835821@N00,5280,22,1411702721,1411703321,2,10,600
57835821@N00,5280,21,1411706760,1411707210,3,10,450
57835821@N00,5280,25,1411708460,1411709210,7,10,750
57835821@N00,5280,24,1411711817,1411712297,8,10,480
57835821@N00,5280,25,1411712866,1411713616,4,10,750
57835821@N00,5280,18,1411716736,1411717622,8,10,886
57835821@N00,5280,19,1411717622,1411718042,3,10,420
57835821@N00,5281,27,1413325774,1413326974,2,6,1200
57835821@N00,5281,2,1413331512,1413331602,5,6,90
57835821@N00,5281,10,1413337535,1413337955,10,6,420
57835821@N00,5281,20,1413348012,1413349092,6,6,1080
57835821@N00,5281,24,1413359862,1413360342,5,6,480
57835821@N00,5281,27,1413363399,1413364599,2,6,1200
57908463@N00,5282,27,1435361447,1435362647,1,1,1200
57915028@N00,5283,5,1357590964,1357591684,2,5,720
57915028@N00,5283,3,1357597044,1357597314,2,5,270
57915028@N00,5283,13,1357602203,1357602803,2,5,600
57915028@N00,5283,18,1357609821,1357611356,2,5,1535
57915028@N00,5283,26,1357611356,1357611536,1,5,180
57915028@N00,5284,27,1357693129,1357694329,2,2,1200
57915028@N00,5284,4,1357717876,1357718776,3,2,900
57915028@N00,5285,12,1357777966,1357778806,2,2,840
57915028@N00,5285,9,1357778882,1357779122,1,2,240
57915028@N00,5286,27,1357976367,1357977567,5,3,1200
57915028@N00,5286,10,1357978154,1357978574,2,3,420
57915028@N00,5286,14,1357978942,1357979062,1,3,120
57937052@N06,5287,27,1394760003,1394761203,2,2,1200
57937052@N06,5287,10,1394764012,1394764432,1,2,420
57959349@N00,5288,9,1385006655,1385006895,1,1,240
58013444@N04,5289,26,1284790810,1284790990,1,1,180
58013444@N04,5290,27,1286000908,1286002108,1,1,1200
58013444@N04,5291,27,1288935426,1288936626,1,1,1200
58013444@N04,5292,23,1295319445,1295319535,2,2,90
58013444@N04,5292,26,1295324912,1295325092,2,2,180
58072194@N08,5293,16,1381362026,1381362746,8,3,720
58072194@N08,5293,11,1381369186,1381369366,2,3,180
58072194@N08,5293,24,1381385002,1381385482,1,3,480
58121556@N04,5294,16,1243778400,1243779120,1,1,720
58147831@N08,5295,27,1381202748,1381203948,1,1,1200
58228008@N00,5296,27,1385085117,1385086317,5,6,1200
58228008@N00,5296,21,1385088313,1385088763,4,6,450
58228008@N00,5296,17,1385090032,1385091412,2,6,1380
58228008@N00,5296,9,1385097799,1385098039,3,6,240
58228008@N00,5296,7,1385098710,1385098800,4,6,90
58228008@N00,5296,6,1385099379,1385099634,3,6,255
58228008@N00,5297,10,1385158134,1385158554,4,17,420
58228008@N00,5297,14,1385160185,1385160305,3,17,120
58228008@N00,5297,10,1385163068,1385163488,18,17,420
58228008@N00,5297,15,1385164523,1385164637,4,17,114
58228008@N00,5297,12,1385164637,1385164835,4,17,198
58228008@N00,5297,13,1385164835,1385165435,2,17,600
58228008@N00,5297,16,1385166565,1385167285,13,17,720
58228008@N00,5297,14,1385170328,1385170448,13,17,120
58228008@N00,5297,16,1385171844,1385171863,3,17,19
58228008@N00,5297,14,1385171863,1385171983,4,17,120
58228008@N00,5297,16,1385172215,1385172223,2,17,8
58228008@N00,5297,14,1385172223,1385172343,3,17,120
58228008@N00,5297,16,1385172591,1385172630,2,17,39
58228008@N00,5297,14,1385172630,1385172750,8,17,120
58228008@N00,5297,3,1385177601,1385177871,4,17,270
58228008@N00,5297,4,1385179530,1385180430,2,17,900
58228008@N00,5297,17,1385198903,1385200283,1,17,1380
58288136@N06,5298,21,1298971026,1298971476,1,1,450
58434175@N08,5299,2,1438737865,1438737955,1,1,90
58436993@N00,5300,5,1301788318,1301789038,2,6,720
58436993@N00,5300,14,1301811635,1301811755,2,6,120
58436993@N00,5300,6,1301816014,1301816269,3,6,255
58436993@N00,5300,14,1301819532,1301819652,3,6,120
58436993@N00,5300,24,1301821959,1301822439,2,6,480
58436993@N00,5300,17,1301825806,1301827186,1,6,1380
58479263@N00,5301,15,1350885769,1350885949,1,1,180
58505724@N00,5302,8,1188718190,1188718310,4,2,120
58505724@N00,5302,16,1188720739,1188721459,1,2,720
58512585@N00,5303,27,1415657167,1415658367,3,14,1200
58512585@N00,5303,14,1415659424,1415659544,2,14,120
58512585@N00,5303,10,1415662299,1415662719,2,14,420
58512585@N00,5303,15,1415663710,1415663890,3,14,180
58512585@N00,5303,13,1415664549,1415664737,2,14,188
58512585@N00,5303,12,1415664737,1415665281,2,14,544
58512585@N00,5303,15,1415665281,1415665461,2,14,180
58512585@N00,5303,14,1415665866,1415665986,2,14,120
58512585@N00,5303,19,1415670094,1415670514,7,14,420
58512585@N00,5303,8,1415673109,1415673229,2,14,120
58512585@N00,5303,22,1415680095,1415680695,2,14,600
58512585@N00,5303,9,1415685048,1415685288,2,14,240
58512585@N00,5303,7,1415687286,1415687376,3,14,90
58512585@N00,5303,8,1415687616,1415687736,1,14,120
58512585@N00,5304,3,1415829090,1415829360,2,9,270
58512585@N00,5304,10,1415829898,1415830318,4,9,420
58512585@N00,5304,23,1415835387,1415835477,2,9,90
58512585@N00,5304,21,1415838781,1415839231,2,9,450
58512585@N00,5304,20,1415839656,1415840736,2,9,1080
58512585@N00,5304,2,1415843721,1415843811,2,9,90
58512585@N00,5304,6,1415845705,1415845752,2,9,47
58512585@N00,5304,1,1415845752,1415846352,2,9,600
58512585@N00,5304,18,1415849106,1415850906,3,9,1800
58518845@N00,5305,8,1351591062,1351591182,1,1,120
58588822@N00,5306,13,1298599808,1298600408,1,1,600
58602712@N04,5307,14,1295573123,1295573124,2,3,1
58602712@N04,5307,3,1295573124,1295573126,2,3,2
58602712@N04,5307,1,1295573126,1295573726,1,3,600
58604743@N04,5308,27,1377747946,1377749146,3,1,1200
58638140@N08,5309,14,1319327629,1319327749,3,2,120
58638140@N08,5309,15,1319357363,1319357543,1,2,180
58755999@N05,5310,16,1400532507,1400533227,1,1,720
58769150@N04,5311,16,1322547323,1322548043,5,1,720
58783731@N05,5312,16,1292400276,1292400996,3,1,720
58853244@N07,5313,23,1295024950,1295025040,1,1,90
58887120@N00,5314,17,1330064152,1330065001,2,5,849
58887120@N00,5314,13,1330065001,1330065601,4,5,600
58887120@N00,5314,25,1330067524,1330068274,4,5,750
58887120@N00,5314,14,1330087309,1330087429,5,5,120
58887120@N00,5314,1,1330094841,1330095441,1,5,600
58923069@N02,5315,21,1326373208,1326373658,1,1,450
58953549@N05,5316,23,1332563842,1332563932,1,1,90
58953549@N05,5317,3,1333285003,1333285016,2,5,13
58953549@N05,5317,5,1333285016,1333285736,2,5,720
58953549@N05,5317,21,1333287919,1333288369,2,5,450
58953549@N05,5317,27,1333293779,1333294979,2,5,1200
58953549@N05,5317,16,1333300132,1333300852,4,5,720
58991728@N00,5318,27,1260592116,1260593316,1,1,1200
58991728@N00,5319,27,1261039449,1261040649,1,1,1200
59063529@N02,5320,16,1335176256,1335176976,1,1,720
59067283@N00,5321,27,1279385657,1279386857,24,1,1200
59067283@N00,5322,27,1279501613,1279502813,123,1,1200
59067283@N00,5323,27,1279678194,1279679394,34,1,1200
59067283@N00,5324,27,1279769989,1279771189,24,1,1200
59067283@N00,5325,27,1279840056,1279841256,61,1,1200
59067283@N00,5326,27,1279928309,1279929509,61,1,1200
59071486@N00,5327,10,1354783051,1354783471,2,2,420
59071486@N00,5327,16,1354785022,1354785742,2,2,720
59071486@N00,5328,14,1359267329,1359267449,3,1,120
59071486@N00,5329,14,1366711330,1366711450,1,1,120
59071486@N00,5330,3,1373703552,1373703822,2,2,270
59071486@N00,5330,16,1373706243,1373706963,1,2,720
59071486@N00,5331,13,1377414564,1377415164,1,1,600
59071486@N00,5332,16,1385812283,1385813003,1,1,720
59071486@N00,5333,27,1392364320,1392365520,2,2,1200
59071486@N00,5333,16,1392372524,1392373244,1,2,720
59106234@N00,5334,16,1299877681,1299878401,1,1,720
59162053@N00,5335,16,1347592739,1347593400,3,7,661
59162053@N00,5335,25,1347593400,1347594150,2,7,750
59162053@N00,5335,4,1347596920,1347597820,2,7,900
59162053@N00,5335,2,1347599408,1347599498,2,7,90
59162053@N00,5335,17,1347602450,1347603830,2,7,1380
59162053@N00,5335,9,1347604510,1347604750,3,7,240
59162053@N00,5335,7,1347604922,1347605012,2,7,90
59171457@N00,5336,27,1329730170,1329731370,1,1,1200
59187662@N05,5337,16,1375661688,1375662408,2,2,720
59187662@N05,5337,14,1375663539,1375663659,1,2,120
59288549@N02,5338,17,1347608031,1347608196,2,2,165
59288549@N02,5338,16,1347608196,1347608916,1,2,720
59288549@N02,5339,27,1347683700,1347684900,2,2,1200
59288549@N02,5339,17,1347685089,1347686469,2,2,1380
59288549@N02,5340,24,1347749748,1347750228,3,5,480
59288549@N02,5340,20,1347750713,1347751793,4,5,1080
59288549@N02,5340,22,1347751820,1347752122,2,5,302
59288549@N02,5340,18,1347752122,1347753922,2,5,1800
59288549@N02,5340,27,1347764379,1347765579,2,5,1200
59288549@N02,5341,17,1367626157,1367627537,2,4,1380
59288549@N02,5341,13,1367631525,1367631758,2,4,233
59288549@N02,5341,9,1367631758,1367631998,2,4,240
59288549@N02,5341,22,1367641028,1367641628,1,4,600
59288549@N02,5342,27,1367906213,1367907413,3,7,1200
59288549@N02,5342,20,1367917473,1367918237,3,7,764
59288549@N02,5342,19,1367918237,1367918436,2,7,199
59288549@N02,5342,20,1367918436,1367918661,2,7,225
59288549@N02,5342,21,1367918661,1367919111,2,7,450
59288549@N02,5342,14,1367924871,1367924991,3,7,120
59288549@N02,5342,16,1367925229,1367925949,3,7,720
59305396@N05,5343,21,1306470485,1306470935,1,1,450
59320616@N08,5344,21,1324165939,1324166389,1,1,450
59320616@N08,5345,26,1324351385,1324351565,1,1,180
59320616@N08,5346,26,1324691580,1324691760,2,3,180
59320616@N08,5346,17,1324692180,1324692206,2,3,26
59320616@N08,5346,25,1324692206,1324692956,1,3,750
59361155@N07,5347,17,1334121462,1334122842,3,2,1380
59361155@N07,5347,16,1334144228,1334144948,1,2,720
59364175@N00,5348,23,1330133420,1330133510,3,3,90
59364175@N00,5348,25,1330134004,1330134754,12,3,750
59364175@N00,5348,27,1330140648,1330141848,4,3,1200
59390981@N04,5349,27,1309683867,1309685067,5,10,1200
59390981@N04,5349,13,1309688334,1309688358,3,10,24
59390981@N04,5349,18,1309688358,1309688543,3,10,185
59390981@N04,5349,13,1309688543,1309689143,3,10,600
59390981@N04,5349,12,1309690144,1309690984,4,10,840
59390981@N04,5349,24,1309699367,1309699847,2,10,480
59390981@N04,5349,17,1309701109,1309702489,2,10,1380
59390981@N04,5349,3,1309705401,1309705671,2,10,270
59390981@N04,5349,2,1309706185,1309706275,2,10,90
59390981@N04,5349,27,1309707176,1309708376,3,10,1200
59390981@N04,5350,18,1309956492,1309958137,2,2,1645
59390981@N04,5350,14,1309958137,1309958257,1,2,120
59451747@N00,5351,16,1358463603,1358464323,4,5,720
59451747@N00,5351,10,1358469721,1358470141,2,5,420
59451747@N00,5351,4,1358483704,1358483709,2,5,5
59451747@N00,5351,16,1358483709,1358483714,3,5,5
59451747@N00,5351,17,1358483714,1358485094,1,5,1380
59471679@N04,5352,1,1407554961,1407555561,1,1,600
59471679@N04,5353,22,1408702178,1408702778,2,2,600
59471679@N04,5353,4,1408703317,1408704217,1,2,900
59471679@N04,5354,26,1414814883,1414815063,1,1,180
59471679@N04,5355,8,1417837903,1417838023,2,2,120
59471679@N04,5355,27,1417847391,1417848591,1,2,1200
59471679@N04,5356,15,1417924323,1417924503,2,2,180
59471679@N04,5356,27,1417934067,1417935267,1,2,1200
59471679@N04,5357,10,1425447899,1425448319,1,1,420
59471679@N04,5358,22,1425776874,1425777474,3,2,600
59471679@N04,5358,19,1425780004,1425780424,2,2,420
59471679@N04,5359,26,1428109768,1428109948,1,1,180
59471679@N04,5360,17,1428189076,1428190456,1,1,1380
59471679@N04,5361,8,1431582444,1431582564,2,2,120
59471679@N04,5361,27,1431584475,1431585675,1,2,1200
59471679@N04,5362,26,1431742345,1431742525,3,1,180
59471679@N04,5363,26,1432347000,1432347180,1,1,180
59471679@N04,5364,27,1432502611,1432503811,1,1,1200
59471679@N04,5365,26,1433555779,1433555959,1,1,180
59471679@N04,5366,27,1442608721,1442609921,1,1,1200
59471679@N04,5367,27,1442695055,1442696255,1,1,1200
59471679@N04,5368,26,1460867121,1460867301,1,1,180
59487241@N04,5369,27,1387263606,1387264806,2,3,1200
59487241@N04,5369,4,1387267067,1387267967,2,3,900
59487241@N04,5369,26,1387278799,1387278979,1,3,180
59513859@N00,5370,27,1316737114,1316738314,4,11,1200
59513859@N00,5370,16,1316739074,1316739794,2,11,720
59513859@N00,5370,20,1316743794,1316744874,2,11,1080
59513859@N00,5370,24,1316746810,1316747290,6,11,480
59513859@N00,5370,19,1316749662,1316750082,2,11,420
59513859@N00,5370,24,1316753126,1316753606,2,11,480
59513859@N00,5370,20,1316756780,1316757860,2,11,1080
59513859@N00,5370,27,1316760626,1316761826,3,11,1200
59513859@N00,5370,16,1316764457,1316765177,2,11,720
59513859@N00,5370,20,1316776091,1316777171,3,11,1080
59513859@N00,5370,24,1316778533,1316779013,1,11,480
59543838@N00,5371,27,1317543694,1317544894,1,1,1200
59615198@N00,5372,19,1272157502,1272157922,3,4,420
59615198@N00,5372,3,1272165033,1272165303,2,4,270
59615198@N00,5372,1,1272169886,1272170486,3,4,600
59615198@N00,5372,14,1272192195,1272192315,1,4,120
59622473@N06,5373,4,1347156175,1347157075,1,1,900
59643697@N00,5374,2,1390611505,1390611595,2,7,90
59643697@N00,5374,9,1390612052,1390612292,4,7,240
59643697@N00,5374,24,1390612596,1390612619,2,7,23
59643697@N00,5374,21,1390612619,1390613069,5,7,450
59643697@N00,5374,10,1390617145,1390617565,15,7,420
59643697@N00,5374,6,1390619431,1390619686,2,7,255
59643697@N00,5374,21,1390622989,1390623439,1,7,450
59669438@N05,5375,27,1311300029,1311301229,2,3,1200
59669438@N05,5375,6,1311304942,1311305197,2,3,255
59669438@N05,5375,24,1311310717,1311311197,1,3,480
59669438@N05,5376,27,1353316258,1353317458,1,1,1200
59682384@N03,5377,18,1378526958,1378528758,1,1,1800
59686711@N04,5378,27,1388897172,1388898372,2,1,1200
59774801@N07,5379,16,1376838276,1376838996,1,1,720
59794429@N07,5380,27,1338168255,1338169455,1,1,1200
59834105@N02,5381,14,1446632496,1446632616,1,1,120
59888795@N03,5382,15,1249533000,1249533180,1,1,180
59888795@N03,5383,16,1253074473,1253075193,2,2,720
59888795@N03,5383,17,1253077371,1253078751,1,2,1380
59888795@N03,5384,17,1379401363,1379401997,2,3,634
59888795@N03,5384,16,1379401997,1379402717,2,3,720
59888795@N03,5384,20,1379409848,1379410928,7,3,1080
59888795@N03,5385,17,1379549361,1379549382,2,6,21
59888795@N03,5385,13,1379549382,1379549466,2,6,84
59888795@N03,5385,18,1379549466,1379549494,2,6,28
59888795@N03,5385,17,1379549494,1379550866,2,6,1372
59888795@N03,5385,19,1379550866,1379551286,6,6,420
59888795@N03,5385,27,1379561869,1379563069,1,6,1200
59888795@N03,5386,17,1431905307,1431906687,2,3,1380
59888795@N03,5386,19,1431906824,1431907244,2,3,420
59888795@N03,5386,27,1431923556,1431924756,1,3,1200
59888866@N00,5387,27,1231809336,1231810536,15,1,1200
59888866@N00,5388,16,1286352592,1286353312,2,2,720
59888866@N00,5388,2,1286354312,1286354402,2,2,90
59888866@N00,5389,27,1317281582,1317282110,2,2,528
59888866@N00,5389,16,1317282110,1317282830,1,2,720
59888866@N00,5390,22,1358405396,1358405996,1,1,600
59888866@N00,5391,25,1358478110,1358478860,1,1,750
59888866@N00,5392,17,1363494461,1363494550,2,2,89
59888866@N00,5392,19,1363494550,1363494970,1,2,420
59888866@N00,5393,19,1370077521,1370077941,2,2,420
59888866@N00,5393,3,1370082689,1370082959,1,2,270
59888866@N00,5394,3,1377308088,1377308358,1,1,270
59888866@N00,5395,2,1379246506,1379246596,1,1,90
59888866@N00,5396,16,1394105527,1394106247,1,1,720
59888866@N00,5397,14,1394947436,1394947556,1,1,120
59918083@N03,5398,27,1246863444,1246864644,1,1,1200
59983818@N06,5399,9,1366449621,1366449861,1,1,240
59983818@N06,5400,13,1366546192,1366546651,2,7,459
59983818@N06,5400,17,1366546651,1366548031,3,7,1380
59983818@N06,5400,21,1366548752,1366549202,6,7,450
59983818@N06,5400,4,1366551208,1366551650,2,7,442
59983818@N06,5400,5,1366551650,1366552364,2,7,714
59983818@N06,5400,9,1366552364,1366552604,2,7,240
59983818@N06,5400,5,1366552942,1366553662,1,7,720
59983818@N06,5401,2,1366769117,1366769207,2,2,90
59983818@N06,5401,10,1366772449,1366772869,1,2,420
60007645@N06,5402,27,1316906778,1316907978,10,2,1200
60007645@N06,5402,15,1316911660,1316911840,8,2,180
60007645@N06,5403,14,1316986393,1316986513,56,3,120
60007645@N06,5403,9,1316989474,1316989555,2,3,81
60007645@N06,5403,14,1316989555,1316989675,13,3,120
60054626@N00,5404,27,1245833767,1245834967,6,2,1200
60054626@N00,5404,4,1245844560,1245845460,1,2,900
60054626@N00,5405,27,1246012388,1246013588,9,12,1200
60054626@N00,5405,17,1246015229,1246015489,4,12,260
60054626@N00,5405,14,1246015489,1246015609,11,12,120
60054626@N00,5405,15,1246016828,1246017008,12,12,180
60054626@N00,5405,26,1246020354,1246020534,4,12,180
60054626@N00,5405,15,1246020757,1246020937,3,12,180
60054626@N00,5405,26,1246020952,1246021132,7,12,180
60054626@N00,5405,16,1246022372,1246022621,3,12,249
60054626@N00,5405,26,1246022621,1246022801,3,12,180
60054626@N00,5405,14,1246022901,1246023021,6,12,120
60054626@N00,5405,16,1246024901,1246025621,2,12,720
60054626@N00,5405,27,1246026273,1246027473,2,12,1200
60054626@N00,5406,14,1246186003,1246186123,3,5,120
60054626@N00,5406,5,1246188280,1246189000,3,5,720
60054626@N00,5406,1,1246190000,1246190020,2,5,20
60054626@N00,5406,5,1246190020,1246190109,3,5,89
60054626@N00,5406,16,1246190109,1246190829,4,5,720
60054626@N00,5407,16,1431908226,1431908946,2,12,720
60054626@N00,5407,8,1431909087,1431909207,6,12,120
60054626@N00,5407,9,1431910686,1431910926,3,12,240
60054626@N00,5407,2,1431911734,1431911824,2,12,90
60054626@N00,5407,1,1431914125,1431914725,3,12,600
60054626@N00,5407,2,1431915358,1431915448,4,12,90
60054626@N00,5407,27,1431918890,1431920090,11,12,1200
60054626@N00,5407,20,1431922198,1431923173,2,12,975
60054626@N00,5407,27,1431923173,1431924373,5,12,1200
60054626@N00,5407,16,1431926996,1431927716,3,12,720
60054626@N00,5407,5,1431932419,1431933139,4,12,720
60054626@N00,5407,12,1431934484,1431935324,3,12,840
60054626@N00,5408,27,1432077536,1432078736,6,2,1200
60054626@N00,5408,9,1432078797,1432079037,10,2,240
60054626@N00,5409,27,1432118756,1432119956,1,1,1200
60062774@N02,5410,27,1298413378,1298414578,2,2,1200
60062774@N02,5410,24,1298435338,1298435818,1,2,480
60065271@N04,5411,16,1307247705,1307248425,2,3,720
60065271@N04,5411,3,1307250937,1307251207,2,3,270
60065271@N04,5411,4,1307275234,1307276134,3,3,900
60065710@N00,5412,16,1374115480,1374116200,1,1,720
60065710@N00,5413,8,1464261549,1464261669,1,1,120
60082453@N05,5414,16,1394401511,1394402231,13,1,720
60082453@N05,5415,16,1394679713,1394680433,22,1,720
60082453@N05,5416,9,1428970766,1428971006,2,8,240
60082453@N05,5416,19,1428972104,1428972524,2,8,420
60082453@N05,5416,20,1428973032,1428974112,2,8,1080
60082453@N05,5416,14,1428975489,1428975609,2,8,120
60082453@N05,5416,19,1428987965,1428988385,2,8,420
60082453@N05,5416,27,1428992979,1428994179,5,8,1200
60082453@N05,5416,6,1429011074,1429011329,2,8,255
60082453@N05,5416,17,1429019011,1429020391,1,8,1380
60082453@N05,5417,4,1429152585,1429153319,2,9,734
60082453@N05,5417,16,1429153319,1429153400,2,9,81
60082453@N05,5417,17,1429153400,1429154780,2,9,1380
60082453@N05,5417,20,1429155617,1429155785,2,9,168
60082453@N05,5417,19,1429155785,1429156205,2,9,420
60082453@N05,5417,22,1429156507,1429157107,2,9,600
60082453@N05,5417,20,1429157669,1429158749,2,9,1080
60082453@N05,5417,19,1429159124,1429159544,5,9,420
60082453@N05,5417,17,1429160527,1429161907,1,9,1380
60082453@N05,5418,27,1447275142,1447276342,2,2,1200
60082453@N05,5418,16,1447290378,1447291098,1,2,720
60082453@N05,5419,16,1447319914,1447320634,15,4,720
60082453@N05,5419,4,1447328308,1447329208,2,4,900
60082453@N05,5419,23,1447329462,1447329552,2,4,90
60082453@N05,5419,27,1447332644,1447333844,1,4,1200
60212022@N00,5420,16,1195202340,1195203060,3,1,720
60212022@N00,5421,16,1195894020,1195894740,1,1,720
60212022@N00,5422,16,1212016714,1212017434,2,1,720
60212022@N00,5423,16,1215051791,1215052511,9,1,720
60212022@N00,5424,16,1215162769,1215163489,1,1,720
60220094@N07,5425,8,1387940484,1387940604,2,2,120
60220094@N07,5425,18,1387947603,1387949403,1,2,1800
60272404@N06,5426,2,1400794544,1400794634,1,1,90
60272404@N06,5427,16,1409486924,1409487644,1,1,720
60272404@N06,5428,27,1431996686,1431997886,1,1,1200
60328269@N07,5429,27,1418676268,1418677468,1,1,1200
60385541@N00,5430,27,1380862266,1380863466,5,4,1200
60385541@N00,5430,3,1380866106,1380866376,5,4,270
60385541@N00,5430,10,1380866573,1380866993,7,4,420
60385541@N00,5430,27,1380879196,1380880396,4,4,1200
60385541@N00,5431,13,1412392274,1412392874,2,3,600
60385541@N00,5431,14,1412397434,1412397554,2,3,120
60385541@N00,5431,9,1412401183,1412401423,1,3,240
60388490@N00,5432,20,1407908518,1407909598,1,1,1080
60388490@N00,5433,16,1407971254,1407971974,2,1,720
60388490@N00,5434,3,1408163954,1408164224,1,1,270
60417400@N08,5435,16,1315889119,1315889839,1,1,720
60429294@N06,5436,16,1267948787,1267949507,1,1,720
60466267@N05,5437,27,1344037832,1344039032,1,1,1200
60481456@N00,5438,16,1387405926,1387406646,1,1,720
60481456@N00,5439,27,1387450948,1387452148,1,1,1200
60504322@N04,5440,27,1317391200,1317392400,29,1,1200
60504322@N04,5441,26,1372306652,1372306832,19,17,180
60504322@N04,5441,23,1372308915,1372309005,15,17,90
60504322@N04,5441,22,1372311842,1372312442,55,17,600
60504322@N04,5441,14,1372314356,1372314476,8,17,120
60504322@N04,5441,17,1372317945,1372319325,18,17,1380
60504322@N04,5441,14,1372321786,1372321822,2,17,36
60504322@N04,5441,16,1372321822,1372321852,2,17,30
60504322@N04,5441,14,1372321852,1372321866,2,17,14
60504322@N04,5441,16,1372321866,1372321968,2,17,102
60504322@N04,5441,14,1372321968,1372321976,2,17,8
60504322@N04,5441,16,1372321976,1372322467,6,17,491
60504322@N04,5441,1,1372322467,1372322500,2,17,33
60504322@N04,5441,14,1372322500,1372322620,31,17,120
60504322@N04,5441,11,1372323309,1372323489,16,17,180
60504322@N04,5441,16,1372338113,1372338833,46,17,720
60504322@N04,5441,3,1372340035,1372340305,9,17,270
60504322@N04,5441,4,1372341094,1372341994,4,17,900
60595282@N07,5442,16,1309647634,1309648354,43,1,720
60595282@N07,5443,16,1309736880,1309737600,26,1,720
60595282@N07,5444,16,1309824082,1309824802,18,1,720
60611201@N02,5445,19,1347946694,1347947114,1,1,420
60667261@N05,5446,9,1349013600,1349013600,2,3,0
60667261@N05,5446,10,1349013600,1349013600,5,3,0
60667261@N05,5446,14,1349013600,1349013720,3,3,120
60667261@N05,5447,10,1350078321,1350078741,3,1,420
60734465@N07,5448,27,1380701289,1380702489,2,1,1200
60822590@N07,5449,17,1447554647,1447556027,2,3,1380
60822590@N07,5449,14,1447567240,1447567360,3,3,120
60822590@N07,5449,27,1447569854,1447571054,2,3,1200
60881589@N00,5450,20,1392601852,1392602932,2,2,1080
60881589@N00,5450,14,1392607935,1392608055,1,2,120
60881589@N00,5451,13,1392771203,1392771803,2,3,600
60881589@N00,5451,8,1392774046,1392774166,2,3,120
60881589@N00,5451,27,1392784539,1392785739,1,3,1200
60883325@N03,5452,27,1354832619,1354833819,1,1,1200
60883325@N03,5453,27,1354867351,1354868551,1,1,1200
60887351@N02,5454,14,1301713527,1301713647,1,1,120
60897658@N00,5455,16,1210819206,1210819926,2,5,720
60897658@N00,5455,9,1210823510,1210823750,3,5,240
60897658@N00,5455,8,1210826033,1210826153,4,5,120
60897658@N00,5455,11,1210828622,1210828802,2,5,180
60897658@N00,5455,22,1210830980,1210831580,1,5,600
60897658@N00,5456,11,1210930048,1210930228,1,1,180
60897658@N00,5457,16,1210983743,1210984463,2,2,720
60897658@N00,5457,22,1210995319,1210995919,3,2,600
60897658@N00,5458,11,1211098040,1211098220,3,5,180
60897658@N00,5458,8,1211098942,1211099062,3,5,120
60897658@N00,5458,14,1211103811,1211103931,4,5,120
60897658@N00,5458,12,1211107340,1211108180,2,5,840
60897658@N00,5458,21,1211108516,1211108966,1,5,450
60981140@N03,5459,27,1386445011,1386446211,1,1,1200
61078591@N00,5460,9,1208818394,1208818634,2,5,240
61078591@N00,5460,17,1208826686,1208828066,3,5,1380
61078591@N00,5460,20,1208828686,1208829766,7,5,1080
61078591@N00,5460,22,1208830221,1208830821,2,5,600
61078591@N00,5460,14,1208830855,1208830975,1,5,120
61081531@N00,5461,9,1220575828,1220576068,4,18,240
61081531@N00,5461,15,1220576612,1220576792,6,18,180
61081531@N00,5461,20,1220579062,1220579246,2,18,184
61081531@N00,5461,19,1220579246,1220579666,4,18,420
61081531@N00,5461,26,1220580159,1220580339,2,18,180
61081531@N00,5461,23,1220580706,1220580796,2,18,90
61081531@N00,5461,13,1220582755,1220583355,2,18,600
61081531@N00,5461,27,1220585621,1220586266,2,18,645
61081531@N00,5461,24,1220586266,1220586596,2,18,330
61081531@N00,5461,25,1220586596,1220587346,5,18,750
61081531@N00,5461,22,1220590366,1220590966,4,18,600
61081531@N00,5461,17,1220591798,1220593178,18,18,1380
61081531@N00,5461,14,1220594760,1220594880,2,18,120
61081531@N00,5461,9,1220595142,1220595257,2,18,115
61081531@N00,5461,7,1220595257,1220595335,2,18,78
61081531@N00,5461,8,1220595335,1220595455,3,18,120
61081531@N00,5461,11,1220595507,1220595687,7,18,180
61081531@N00,5461,27,1220600727,1220601927,2,18,1200
61083754@N04,5462,3,1199574170,1199574440,2,4,270
61083754@N04,5462,20,1199588664,1199589744,2,4,1080
61083754@N04,5462,17,1199600548,1199601094,2,4,546
61083754@N04,5462,19,1199601094,1199601514,1,4,420
61083754@N04,5463,4,1199774036,1199774936,2,2,900
61083754@N04,5463,16,1199775853,1199776573,3,2,720
61083754@N04,5464,27,1252814284,1252815484,5,4,1200
61083754@N04,5464,14,1252822548,1252822668,5,4,120
61083754@N04,5464,20,1252827624,1252828704,7,4,1080
61083754@N04,5464,3,1252842740,1252843010,2,4,270
61083754@N04,5465,25,1253140687,1253141437,43,11,750
61083754@N04,5465,21,1253153184,1253153507,5,11,323
61083754@N04,5465,14,1253153507,1253153627,8,11,120
61083754@N04,5465,21,1253154938,1253155388,4,11,450
61083754@N04,5465,14,1253158515,1253158635,10,11,120
61083754@N04,5465,9,1253164318,1253164558,6,11,240
61083754@N04,5465,2,1253164683,1253164773,2,11,90
61083754@N04,5465,16,1253169314,1253169864,8,11,550
61083754@N04,5465,27,1253169864,1253171064,3,11,1200
61083754@N04,5465,14,1253175452,1253175536,3,11,84
61083754@N04,5465,16,1253175536,1253176256,2,11,720
61096082@N05,5466,27,1418861292,1418862492,2,6,1200
61096082@N05,5466,20,1418868724,1418869804,2,6,1080
61096082@N05,5466,19,1418869851,1418870271,2,6,420
61096082@N05,5466,20,1418870505,1418871585,3,6,1080
61096082@N05,5466,3,1418875583,1418875853,2,6,270
61096082@N05,5466,27,1418882716,1418883916,1,6,1200
61102903@N02,5467,12,1459046016,1459046663,2,3,647
61102903@N02,5467,15,1459046663,1459046843,2,3,180
61102903@N02,5467,23,1459051297,1459051387,1,3,90
61102903@N02,5468,16,1466325479,1466326199,1,1,720
61104413@N00,5469,25,1344384764,1344385514,1,1,750
61149901@N06,5470,27,1385975258,1385976458,2,2,1200
61149901@N06,5470,16,1385998018,1385998738,1,2,720
61172210@N08,5471,20,1293415157,1293416237,1,1,1080
61198674@N00,5472,1,1311462300,1311462900,2,16,600
61198674@N00,5472,9,1311463988,1311464228,4,16,240
61198674@N00,5472,15,1311465355,1311465373,2,16,18
61198674@N00,5472,12,1311465373,1311465414,2,16,41
61198674@N00,5472,15,1311465414,1311465458,2,16,44
61198674@N00,5472,13,1311465458,1311466058,7,16,600
61198674@N00,5472,21,1311468304,1311468350,2,16,46
61198674@N00,5472,23,1311468350,1311468404,2,16,54
61198674@N00,5472,26,1311468404,1311468475,3,16,71
61198674@N00,5472,25,1311468475,1311468628,2,16,153
61198674@N00,5472,4,1311468628,1311468692,2,16,64
61198674@N00,5472,5,1311468692,1311469412,4,16,720
61198674@N00,5472,22,1311477006,1311477606,2,16,600
61198674@N00,5472,2,1311479545,1311479635,2,16,90
61198674@N00,5472,3,1311481600,1311481870,2,16,270
61198674@N00,5472,27,1311491087,1311492287,2,16,1200
61198674@N00,5473,27,1311545400,1311546600,4,6,1200
61198674@N00,5473,14,1311548571,1311548577,2,6,6
61198674@N00,5473,16,1311548577,1311548581,2,6,4
61198674@N00,5473,14,1311548581,1311548701,7,6,120
61198674@N00,5473,13,1311550423,1311551023,3,6,600
61198674@N00,5473,20,1311551616,1311552696,2,6,1080
61202488@N00,5474,9,1447628075,1447628315,3,8,240
61202488@N00,5474,7,1447628898,1447628988,3,8,90
61202488@N00,5474,10,1447630327,1447630747,4,8,420
61202488@N00,5474,12,1447635128,1447635968,5,8,840
61202488@N00,5474,19,1447656376,1447656796,2,8,420
61202488@N00,5474,23,1447659575,1447659665,4,8,90
61202488@N00,5474,17,1447661345,1447662725,6,8,1380
61202488@N00,5474,14,1447667908,1447668028,4,8,120
61202488@N00,5475,9,1447801811,1447802051,2,6,240
61202488@N00,5475,6,1447803853,1447804108,2,6,255
61202488@N00,5475,14,1447806278,1447806398,8,6,120
61202488@N00,5475,22,1447811874,1447812474,2,6,600
61202488@N00,5475,27,1447831085,1447832285,7,6,1200
61202488@N00,5475,10,1447837202,1447837622,4,6,420
61207928@N04,5476,27,1340615418,1340616618,1,1,1200
61207928@N04,5477,19,1340665620,1340666040,2,2,420
61207928@N04,5477,25,1340689995,1340690745,1,2,750
61207928@N04,5478,3,1340881866,1340882136,1,1,270
61207928@N04,5479,13,1341130995,1341131595,2,2,600
61207928@N04,5479,2,1341139294,1341139384,1,2,90
61261095@N02,5480,22,1290772589,1290773189,1,1,600
61261095@N02,5481,9,1292073023,1292073263,1,1,240
61261095@N02,5482,16,1292293651,1292294371,2,2,720
61261095@N02,5482,26,1292300173,1292300353,2,2,180
61261095@N02,5483,16,1295328606,1295328963,3,4,357
61261095@N02,5483,4,1295328963,1295329264,2,4,301
61261095@N02,5483,1,1295329264,1295329864,2,4,600
61261095@N02,5483,4,1295330913,1295331813,1,4,900
61261095@N02,5484,23,1297576862,1297576952,2,1,90
61261095@N02,5485,21,1298113485,1298113935,1,1,450
61261095@N02,5486,16,1299545335,1299546055,2,5,720
61261095@N02,5486,17,1299558331,1299558364,2,5,33
61261095@N02,5486,26,1299558364,1299558401,2,5,37
61261095@N02,5486,17,1299558401,1299559781,2,5,1380
61261095@N02,5486,16,1299569365,1299570085,1,5,720
61261095@N02,5487,27,1299746594,1299747794,1,1,1200
61261095@N02,5488,21,1303102679,1303103129,2,1,450
61261095@N02,5489,11,1339840318,1339840478,2,5,160
61261095@N02,5489,8,1339840478,1339840598,5,5,120
61261095@N02,5489,14,1339842107,1339842227,2,5,120
61261095@N02,5489,21,1339844999,1339845348,2,5,349
61261095@N02,5489,24,1339845348,1339845828,1,5,480
61261095@N02,5490,16,1341317808,1341318528,2,1,720
61261095@N02,5491,27,1346540639,1346541839,2,3,1200
61261095@N02,5491,14,1346544250,1346544370,2,3,120
61261095@N02,5491,12,1346546562,1346547402,1,3,840
61261095@N02,5492,27,1347427431,1347428631,1,1,1200
61285500@N03,5493,14,1402391162,1402391282,1,1,120
61285553@N00,5494,2,1197112204,1197112294,15,2,90
61285553@N00,5494,27,1197115420,1197116620,25,2,1200
61308976@N04,5495,4,1320370289,1320371189,1,1,900
61343115@N06,5496,6,1255320402,1255320657,1,1,255
61343955@N00,5497,12,1242516987,1242517827,233,1,840
61388024@N08,5498,20,1376631067,1376632147,1,1,1080
61411564@N04,5499,9,1355132027,1355132035,2,3,8
61411564@N04,5499,21,1355132035,1355132485,3,3,450
61411564@N04,5499,9,1355133024,1355133264,1,3,240
61413472@N05,5500,27,1356926930,1356928130,1,1,1200
61415829@N08,5501,27,1430559909,1430561109,1,1,1200
61473396@N04,5502,17,1374475030,1374476410,1,1,1380
61525316@N06,5503,16,1356587917,1356588637,2,3,720
61525316@N06,5503,6,1356610254,1356610509,2,3,255
61525316@N06,5503,27,1356619445,1356620645,1,3,1200
61525316@N06,5504,14,1356757038,1356757158,2,3,120
61525316@N06,5504,10,1356771782,1356772202,2,3,420
61525316@N06,5504,9,1356775052,1356775292,1,3,240
61554297@N00,5505,14,1218172302,1218172422,1,1,120
61554297@N00,5506,27,1231211449,1231212649,2,2,1200
61554297@N00,5506,14,1231214713,1231214833,1,2,120
61581248@N04,5507,27,1388344070,1388344185,3,4,115
61581248@N04,5507,16,1388344185,1388344230,2,4,45
61581248@N04,5507,8,1388344230,1388344350,2,4,120
61581248@N04,5507,27,1388356364,1388357564,1,4,1200
61581248@N04,5508,14,1388429225,1388429345,4,3,120
61581248@N04,5508,9,1388437278,1388437518,3,3,240
61581248@N04,5508,27,1388439192,1388440392,1,3,1200
61581248@N04,5509,16,1388484142,1388484862,2,2,720
61581248@N04,5509,3,1388486050,1388486320,1,2,270
61581248@N04,5510,27,1388703552,1388704752,2,2,1200
61581248@N04,5510,10,1388711925,1388712345,3,2,420
61599636@N02,5511,19,1295486515,1295486935,1,1,420
61634238@N07,5512,14,1367228856,1367228976,1,1,120
61634238@N07,5513,27,1367315718,1367316918,1,1,1200
61638597@N05,5514,9,1327105240,1327105480,2,3,240
61638597@N05,5514,16,1327105503,1327106223,2,3,720
61638597@N05,5514,6,1327132936,1327133191,1,3,255
61644290@N00,5515,22,1294572420,1294573020,1,1,600
61644290@N00,5516,17,1326618998,1326620378,1,1,1380
61644290@N00,5517,22,1332767351,1332767951,2,1,600
61644290@N00,5518,9,1351765009,1351765249,1,1,240
61644290@N00,5519,23,1352067261,1352067351,1,1,90
61644290@N00,5520,13,1379065156,1379065756,1,1,600
61658419@N00,5521,21,1335055494,1335055944,8,1,450
61658419@N00,5522,21,1335167741,1335168191,14,1,450
61658419@N00,5523,21,1349655985,1349656435,3,1,450
61658419@N00,5524,21,1349822130,1349822580,2,1,450
61658419@N00,5525,21,1349865324,1349865774,2,1,450
61658419@N00,5526,21,1350010661,1350011111,196,1,450
61658419@N00,5527,21,1350392400,1350392850,18,1,450
61658419@N00,5528,21,1355588919,1355589369,1,1,450
61659566@N00,5529,23,1352069893,1352069983,2,9,90
61659566@N00,5529,17,1352073281,1352074661,3,9,1380
61659566@N00,5529,25,1352079509,1352080259,2,9,750
61659566@N00,5529,26,1352080582,1352080762,2,9,180
61659566@N00,5529,22,1352081322,1352081922,2,9,600
61659566@N00,5529,14,1352096155,1352096275,2,9,120
61659566@N00,5529,16,1352099084,1352099373,3,9,289
61659566@N00,5529,14,1352099373,1352099374,2,9,1
61659566@N00,5529,16,1352099374,1352100094,1,9,720
61666954@N06,5530,12,1286974667,1286975507,1,1,840
61756292@N00,5531,10,1358407442,1358407862,1,1,420
61761579@N00,5532,14,1335839474,1335839594,1,1,120
61761579@N00,5533,14,1335905072,1335905192,1,1,120
61806797@N03,5534,21,1393762301,1393762751,2,1,450
61817209@N05,5535,27,1392822190,1392823390,1,1,1200
61834460@N00,5536,27,1378534164,1378535364,2,2,1200
61834460@N00,5536,18,1378545218,1378547018,1,2,1800
61897832@N00,5537,12,1260625780,1260626620,23,1,840
61897832@N00,5538,12,1260672952,1260673792,3,1,840
61897832@N00,5539,12,1260788251,1260789091,20,1,840
61905010@N03,5540,17,1411122453,1411123833,1,1,1380
62065836@N00,5541,2,1301028456,1301028546,2,2,90
62065836@N00,5541,13,1301028613,1301029213,4,2,600
62065836@N00,5542,18,1456978400,1456980200,7,1,1800
62089667@N00,5543,22,1454631720,1454632320,1,1,600
62092290@N04,5544,27,1338282187,1338283387,1,1,1200
62102776@N02,5545,20,1375949218,1375950298,1,1,1080
62102776@N02,5546,1,1376181832,1376182432,1,1,600
62102776@N02,5547,8,1376466208,1376466328,1,1,120
62102776@N02,5548,2,1376642357,1376642447,1,1,90
62102776@N02,5549,16,1376723127,1376723847,1,1,720
62102776@N02,5550,2,1376812097,1376812187,1,1,90
62102776@N02,5551,27,1377302266,1377303466,2,2,1200
62102776@N02,5551,13,1377322006,1377322606,1,2,600
62121361@N03,5552,9,1307979016,1307979256,2,2,240
62121361@N03,5552,27,1307992647,1307993847,1,2,1200
62122462@N00,5553,11,1284427285,1284427465,7,5,180
62122462@N00,5553,2,1284434263,1284434353,6,5,90
62122462@N00,5553,14,1284437344,1284437464,5,5,120
62122462@N00,5553,20,1284440904,1284441984,32,5,1080
62122462@N00,5553,24,1284447730,1284448210,6,5,480
62122462@N00,5554,27,1347575512,1347576712,16,2,1200
62122462@N00,5554,14,1347598687,1347598807,3,2,120
62147041@N08,5555,2,1454124399,1454124489,1,1,90
62205900@N00,5556,27,1268852180,1268853380,2,1,1200
62205900@N00,5557,27,1268940792,1268941992,24,1,1200
62208823@N00,5558,3,1308381271,1308381541,1,1,270
62208823@N00,5559,16,1317425935,1317426655,2,1,720
62208823@N00,5560,3,1343450709,1343450979,1,1,270
62208823@N00,5561,10,1351404961,1351405381,1,1,420
62208823@N00,5562,27,1372570823,1372572023,1,1,1200
62213164@N00,5563,27,1188735590,1188736511,2,7,921
62213164@N00,5563,20,1188736511,1188736779,2,7,268
62213164@N00,5563,21,1188736779,1188737229,6,7,450
62213164@N00,5563,24,1188738358,1188738838,2,7,480
62213164@N00,5563,23,1188739978,1188740068,2,7,90
62213164@N00,5563,16,1188740525,1188741030,2,7,505
62213164@N00,5563,4,1188741030,1188741930,5,7,900
62213164@N00,5564,27,1188810348,1188811548,2,10,1200
62213164@N00,5564,20,1188812052,1188813132,6,10,1080
62213164@N00,5564,16,1188815018,1188815577,3,10,559
62213164@N00,5564,14,1188815577,1188815697,2,10,120
62213164@N00,5564,16,1188819186,1188819906,7,10,720
62213164@N00,5564,26,1188823235,1188823415,2,10,180
62213164@N00,5564,22,1188824666,1188825266,2,10,600
62213164@N00,5564,16,1188826269,1188826989,2,10,720
62213164@N00,5564,5,1188827470,1188827879,3,10,409
62213164@N00,5564,27,1188827879,1188829079,1,10,1200
62213164@N00,5565,4,1338542133,1338543033,1,1,900
62221880@N00,5566,25,1307619662,1307620412,2,2,750
62221880@N00,5566,21,1307628045,1307628495,2,2,450
62221880@N00,5567,5,1307662699,1307663419,2,6,720
62221880@N00,5567,2,1307666703,1307666793,2,6,90
62221880@N00,5567,26,1307668560,1307668740,2,6,180
62221880@N00,5567,14,1307671201,1307671321,2,6,120
62221880@N00,5567,19,1307672853,1307673273,2,6,420
62221880@N00,5567,21,1307674989,1307675439,4,6,450
62221880@N00,5568,17,1307707000,1307708380,3,4,1380
62221880@N00,5568,14,1307708989,1307709109,3,4,120
62221880@N00,5568,17,1307709987,1307711367,2,4,1380
62221880@N00,5568,22,1307712867,1307713467,1,4,600
62221880@N00,5569,17,1307756149,1307757529,2,4,1380
62221880@N00,5569,23,1307757676,1307757766,2,4,90
62221880@N00,5569,13,1307760273,1307760873,6,4,600
62221880@N00,5569,18,1307763369,1307765169,3,4,1800
62221880@N00,5570,27,1307841145,1307842345,3,4,1200
62221880@N00,5570,13,1307846619,1307847219,2,4,600
62221880@N00,5570,1,1307856776,1307857352,2,4,576
62221880@N00,5570,2,1307857352,1307857442,2,4,90
62236593@N04,5571,17,1316862495,1316863875,2,1,1380
62236593@N04,5572,17,1416876931,1416878311,1,1,1380
62256889@N05,5573,16,1305510367,1305511087,2,2,720
62256889@N05,5573,4,1305523578,1305524478,1,2,900
62256889@N05,5574,22,1328339183,1328339783,4,1,600
62256889@N05,5575,27,1328577269,1328578469,1,1,1200
62256889@N05,5576,27,1328606095,1328607295,3,1,1200
62256889@N05,5577,27,1328691401,1328692601,1,1,1200
62256889@N05,5578,27,1328832697,1328833897,3,3,1200
62256889@N05,5578,26,1328850555,1328850735,2,3,180
62256889@N05,5578,27,1328863389,1328864589,2,3,1200
62256889@N05,5579,10,1358559475,1358559895,2,2,420
62256889@N05,5579,8,1358568379,1358568499,1,2,120
62256889@N05,5580,17,1359009456,1359010836,1,1,1380
62256889@N05,5581,27,1387950422,1387951622,3,2,1200
62256889@N05,5581,23,1387963527,1387963617,1,2,90
62282437@N00,5582,27,1211352670,1211353870,4,7,1200
62282437@N00,5582,18,1211355661,1211357108,3,7,1447
62282437@N00,5582,19,1211357108,1211357528,2,7,420
62282437@N00,5582,18,1211357631,1211358113,2,7,482
62282437@N00,5582,22,1211358113,1211358713,2,7,600
62282437@N00,5582,17,1211360473,1211361853,2,7,1380
62282437@N00,5582,4,1211361931,1211362831,3,7,900
62328663@N02,5583,4,1255874681,1255875581,1,1,900
62372928@N03,5584,16,1256107520,1256108240,1,1,720
62372928@N03,5585,27,1369091789,1369092600,2,4,811
62372928@N03,5585,17,1369092600,1369093980,2,4,1380
62372928@N03,5585,14,1369103942,1369104062,2,4,120
62372928@N03,5585,2,1369105028,1369105118,1,4,90
62372928@N03,5586,19,1369141882,1369142151,2,2,269
62372928@N03,5586,20,1369142151,1369143231,1,2,1080
62372928@N03,5587,16,1369224745,1369225465,1,1,720
62382210@N02,5588,3,1400675956,1400676226,2,4,270
62382210@N02,5588,13,1400676971,1400676978,2,4,7
62382210@N02,5588,20,1400676978,1400678058,2,4,1080
62382210@N02,5588,14,1400679426,1400679546,2,4,120
62396405@N03,5589,5,1368362620,1368363340,2,2,720
62396405@N03,5589,17,1368365994,1368367374,1,2,1380
62482223@N07,5590,18,1304326979,1304328779,1,1,1800
62486370@N00,5591,9,1191541532,1191541772,2,1,240
62595633@N06,5592,27,1370469565,1370470181,4,33,616
62595633@N06,5592,14,1370470181,1370470301,3,33,120
62595633@N06,5592,9,1370470753,1370470993,2,33,240
62595633@N06,5592,10,1370471199,1370471619,5,33,420
62595633@N06,5592,2,1370477636,1370477726,2,33,90
62595633@N06,5592,5,1370477737,1370478295,2,33,558
62595633@N06,5592,14,1370478295,1370478415,2,33,120
62595633@N06,5592,26,1370478495,1370478621,2,33,126
62595633@N06,5592,20,1370478621,1370478947,2,33,326
62595633@N06,5592,19,1370478947,1370479367,3,33,420
62595633@N06,5592,22,1370479909,1370480509,3,33,600
62595633@N06,5592,13,1370482350,1370482379,2,33,29
62595633@N06,5592,17,1370482379,1370482655,2,33,276
62595633@N06,5592,13,1370482655,1370483255,4,33,600
62595633@N06,5592,15,1370483767,1370483947,3,33,180
62595633@N06,5592,12,1370484025,1370484865,4,33,840
62595633@N06,5592,14,1370486503,1370486623,2,33,120
62595633@N06,5592,25,1370487595,1370487651,2,33,56
62595633@N06,5592,26,1370487651,1370487799,2,33,148
62595633@N06,5592,25,1370487799,1370488549,2,33,750
62595633@N06,5592,21,1370493499,1370493949,3,33,450
62595633@N06,5592,17,1370495072,1370495260,2,33,188
62595633@N06,5592,13,1370495260,1370495296,2,33,36
62595633@N06,5592,12,1370495296,1370495451,3,33,155
62595633@N06,5592,15,1370495451,1370495631,2,33,180
62595633@N06,5592,13,1370497947,1370498547,2,33,600
62595633@N06,5592,20,1370498761,1370499349,2,33,588
62595633@N06,5592,22,1370499349,1370499496,2,33,147
62595633@N06,5592,13,1370499496,1370499841,2,33,345
62595633@N06,5592,14,1370499841,1370499961,4,33,120
62595633@N06,5592,27,1370500352,1370501552,9,33,1200
62595633@N06,5592,14,1370512020,1370512140,11,33,120
62595633@N06,5592,27,1370521100,1370522300,1,33,1200
62595633@N06,5593,14,1370730619,1370730739,10,1,120
62598671@N04,5594,1,1210846419,1210847019,1,1,600
62598671@N04,5595,16,1230804238,1230804958,1,1,720
62598671@N04,5596,16,1282037016,1282037736,2,2,720
62598671@N04,5596,3,1282041211,1282041481,1,2,270
62599993@N06,5597,14,1369345921,1369346041,2,2,120
62599993@N06,5597,18,1369352099,1369353899,4,2,1800
62599993@N06,5598,27,1400834530,1400835730,1,1,1200
62599993@N06,5599,27,1461376432,1461377632,1,1,1200
62624768@N02,5600,27,1361520775,1361521975,2,3,1200
62624768@N02,5600,12,1361523860,1361524215,2,3,355
62624768@N02,5600,14,1361524215,1361524335,1,3,120
62624768@N02,5601,17,1361648777,1361650157,1,1,1380
62665100@N00,5602,22,1347513113,1347513126,2,2,13
62665100@N00,5602,16,1347513126,1347513846,1,2,720
62667441@N00,5603,16,1224454719,1224455439,2,4,720
62667441@N00,5603,3,1224456771,1224457041,2,4,270
62667441@N00,5603,13,1224470401,1224471001,3,4,600
62667441@N00,5603,19,1224472153,1224472573,4,4,420
62704710@N03,5604,27,1350116442,1350117642,2,3,1200
62704710@N03,5604,3,1350120772,1350121042,2,3,270
62704710@N03,5604,2,1350122339,1350122429,1,3,90
62704710@N03,5605,19,1350429319,1350429688,2,5,369
62704710@N03,5605,18,1350429688,1350430943,3,5,1255
62704710@N03,5605,21,1350430943,1350431393,2,5,450
62704710@N03,5605,9,1350441132,1350441372,2,5,240
62704710@N03,5605,11,1350441877,1350442057,1,5,180
62704710@N03,5606,27,1362887128,1362888328,2,2,1200
62704710@N03,5606,2,1362905226,1362905316,1,2,90
62704710@N03,5607,4,1363428115,1363429015,1,1,900
62705831@N05,5608,20,1259281567,1259282647,2,2,1080
62705831@N05,5608,16,1259307643,1259308363,1,2,720
62772368@N00,5609,27,1441507311,1441507313,2,8,2
62772368@N00,5609,9,1441507313,1441507313,2,8,0
62772368@N00,5609,27,1441507313,1441508513,2,8,1200
62772368@N00,5609,9,1441518060,1441518300,3,8,240
62772368@N00,5609,6,1441520379,1441520634,2,8,255
62772368@N00,5609,9,1441537074,1441537314,2,8,240
62772368@N00,5609,27,1441542745,1441543012,3,8,267
62772368@N00,5609,6,1441543012,1441543267,1,8,255
62789043@N07,5610,22,1303201693,1303202293,1,1,600
62891726@N08,5611,16,1318763437,1318764157,1,1,720
62935145@N05,5612,27,1224568386,1224569586,1,1,1200
62935145@N05,5613,27,1224722374,1224723574,4,3,1200
62935145@N05,5613,4,1224724807,1224725707,4,3,900
62935145@N05,5613,25,1224727686,1224728436,4,3,750
62935145@N05,5614,27,1224913907,1224915107,1,1,1200
62935145@N05,5615,18,1225161554,1225163354,2,2,1800
62935145@N05,5615,27,1225170949,1225172149,1,2,1200
62935145@N05,5616,25,1249290396,1249291146,1,1,750
62950363@N05,5617,4,1349071033,1349071933,10,2,900
62950363@N05,5617,17,1349073563,1349074943,3,2,1380
62950363@N05,5618,27,1349243185,1349244385,3,1,1200
62950363@N05,5619,23,1349481255,1349481345,4,2,90
62950363@N05,5619,9,1349485809,1349486049,4,2,240
62975060@N07,5620,14,1382341915,1382342035,1,1,120
63014850@N00,5621,17,1434847622,1434849002,1,1,1380
63051331@N00,5622,14,1225513483,1225513603,1,1,120
63084736@N00,5623,9,1437614558,1437614798,2,3,240
63084736@N00,5623,2,1437618481,1437618571,3,3,90
63084736@N00,5623,1,1437619952,1437620552,1,3,600
63084736@N00,5624,22,1438161353,1438161953,3,2,600
63084736@N00,5624,27,1438166955,1438168155,5,2,1200
63084736@N00,5625,1,1438245560,1438246160,3,2,600
63084736@N00,5625,5,1438253546,1438254266,1,2,720
63084736@N00,5626,6,1438576589,1438576844,3,2,255
63084736@N00,5626,14,1438582491,1438582611,1,2,120
63098965@N00,5627,9,1465815268,1465815508,1,1,240
63186081@N00,5628,1,1365410931,1365411531,2,2,600
63186081@N00,5628,17,1365429350,1365430730,2,2,1380
63202442@N00,5629,16,1189632434,1189633154,1,1,720
63202442@N00,5630,19,1201224164,1201224584,1,1,420
63202442@N00,5631,13,1201428174,1201428774,1,1,600
63202442@N00,5632,9,1201604623,1201604863,2,2,240
63202442@N00,5632,13,1201606265,1201606865,1,2,600
63202442@N00,5633,21,1220578645,1220579095,1,1,450
63202442@N00,5634,14,1220656181,1220656301,3,4,120
63202442@N00,5634,9,1220657531,1220657771,2,4,240
63202442@N00,5634,5,1220669455,1220670175,2,4,720
63202442@N00,5634,4,1220672516,1220673416,1,4,900
63202442@N00,5635,4,1220783562,1220784462,2,4,900
63202442@N00,5635,24,1220786408,1220786888,2,4,480
63202442@N00,5635,6,1220788974,1220789229,2,4,255
63202442@N00,5635,27,1220791634,1220792834,1,4,1200
63202442@N00,5636,21,1220953330,1220953780,4,6,450
63202442@N00,5636,13,1220954339,1220954939,3,6,600
63202442@N00,5636,15,1220955648,1220955828,2,6,180
63202442@N00,5636,27,1220958001,1220959201,2,6,1200
63202442@N00,5636,4,1220961273,1220962173,2,6,900
63202442@N00,5636,13,1220966991,1220967591,1,6,600
63202442@N00,5637,27,1221304823,1221306023,5,1,1200
63202442@N00,5638,17,1221348108,1221348220,2,4,112
63202442@N00,5638,16,1221348220,1221348257,2,4,37
63202442@N00,5638,14,1221348257,1221348377,2,4,120
63202442@N00,5638,16,1221348593,1221349313,1,4,720
63202442@N00,5639,14,1264900108,1264900228,2,11,120
63202442@N00,5639,21,1264911306,1264911756,2,11,450
63202442@N00,5639,7,1264915530,1264915620,2,11,90
63202442@N00,5639,27,1264917623,1264918823,2,11,1200
63202442@N00,5639,3,1264919211,1264919481,2,11,270
63202442@N00,5639,13,1264927446,1264928046,2,11,600
63202442@N00,5639,14,1264930950,1264931070,2,11,120
63202442@N00,5639,2,1264933521,1264933611,2,11,90
63202442@N00,5639,5,1264933747,1264934467,2,11,720
63202442@N00,5639,4,1264936908,1264937808,2,11,900
63202442@N00,5639,27,1264937877,1264939077,1,11,1200
63202442@N00,5640,13,1265003291,1265003891,2,1,600
63202442@N00,5641,19,1265156229,1265156649,2,4,420
63202442@N00,5641,4,1265160939,1265161536,2,4,597
63202442@N00,5641,1,1265161536,1265162136,3,4,600
63202442@N00,5641,3,1265164112,1265164382,2,4,270
63202442@N00,5642,16,1265231011,1265231731,2,4,720
63202442@N00,5642,20,1265233850,1265234930,3,4,1080
63202442@N00,5642,19,1265235303,1265235723,2,4,420
63202442@N00,5642,27,1265237658,1265238858,1,4,1200
63202442@N00,5643,27,1291460280,1291461480,2,4,1200
63202442@N00,5643,2,1291467692,1291467782,2,4,90
63202442@N00,5643,5,1291467802,1291468113,2,4,311
63202442@N00,5643,4,1291468113,1291469013,1,4,900
63202442@N00,5644,14,1327845474,1327845594,1,1,120
63211078@N00,5645,27,1245644425,1245645625,1,1,1200
63211078@N00,5646,27,1245915902,1245917102,2,2,1200
63211078@N00,5646,14,1245921894,1245922014,1,2,120
63219576@N08,5647,22,1435632422,1435632722,2,2,300
63219576@N08,5647,26,1435632722,1435632902,1,2,180
63257911@N00,5648,4,1188008612,1188009512,2,4,900
63257911@N00,5648,6,1188013054,1188013309,2,4,255
63257911@N00,5648,14,1188013746,1188013866,2,4,120
63257911@N00,5648,15,1188029822,1188030002,2,4,180
63257911@N00,5649,6,1188086838,1188087093,2,5,255
63257911@N00,5649,8,1188090017,1188090137,3,5,120
63257911@N00,5649,5,1188093230,1188093950,3,5,720
63257911@N00,5649,20,1188095273,1188096031,2,5,758
63257911@N00,5649,21,1188096031,1188096481,1,5,450
63257911@N00,5650,13,1212895045,1212895645,6,18,600
63257911@N00,5650,19,1212898597,1212899017,3,18,420
63257911@N00,5650,20,1212900155,1212901235,2,18,1080
63257911@N00,5650,2,1212906381,1212906471,6,18,90
63257911@N00,5650,6,1212907069,1212907324,2,18,255
63257911@N00,5650,3,1212908061,1212908331,6,18,270
63257911@N00,5650,9,1212909198,1212909438,4,18,240
63257911@N00,5650,12,1212912414,1212913254,13,18,840
63257911@N00,5650,5,1212913711,1212914431,2,18,720
63257911@N00,5650,1,1212914696,1212915296,4,18,600
63257911@N00,5650,13,1212918806,1212919406,3,18,600
63257911@N00,5650,20,1212920119,1212920253,2,18,134
63257911@N00,5650,21,1212920253,1212920609,2,18,356
63257911@N00,5650,9,1212920609,1212920849,2,18,240
63257911@N00,5650,1,1212922046,1212922156,2,18,110
63257911@N00,5650,3,1212922156,1212922341,3,18,185
63257911@N00,5650,4,1212922341,1212923241,3,18,900
63257911@N00,5650,27,1212926542,1212927742,6,18,1200
63257911@N00,5651,13,1212963409,1212963476,2,3,67
63257911@N00,5651,12,1212963476,1212963582,2,3,106
63257911@N00,5651,15,1212963582,1212963762,1,3,180
63257911@N00,5652,16,1229140452,1229141172,3,15,720
63257911@N00,5652,12,1229147351,1229148191,17,15,840
63257911@N00,5652,1,1229151089,1229151246,2,15,157
63257911@N00,5652,2,1229151246,1229151336,4,15,90
63257911@N00,5652,9,1229151472,1229151712,3,15,240
63257911@N00,5652,6,1229152190,1229152445,3,15,255
63257911@N00,5652,17,1229152957,1229154337,4,15,1380
63257911@N00,5652,11,1229156179,1229156359,2,15,180
63257911@N00,5652,8,1229157361,1229157481,2,15,120
63257911@N00,5652,11,1229158705,1229158885,3,15,180
63257911@N00,5652,8,1229159953,1229160073,3,15,120
63257911@N00,5652,4,1229162550,1229163450,2,15,900
63257911@N00,5652,3,1229163792,1229164062,2,15,270
63257911@N00,5652,4,1229164876,1229165776,8,15,900
63257911@N00,5652,27,1229168169,1229169369,5,15,1200
63257911@N00,5653,9,1229214452,1229214692,3,7,240
63257911@N00,5653,14,1229217060,1229217180,2,7,120
63257911@N00,5653,13,1229220687,1229221287,2,7,600
63257911@N00,5653,16,1229225160,1229225880,4,7,720
63257911@N00,5653,1,1229226555,1229226794,4,7,239
63257911@N00,5653,3,1229226794,1229227064,3,7,270
63257911@N00,5653,1,1229231988,1229232588,7,7,600
63257911@N00,5654,15,1277450070,1277450250,4,7,180
63257911@N00,5654,12,1277459976,1277460816,6,7,840
63257911@N00,5654,9,1277461596,1277461836,3,7,240
63257911@N00,5654,22,1277462311,1277462480,3,7,169
63257911@N00,5654,2,1277462480,1277462570,3,7,90
63257911@N00,5654,22,1277464749,1277465349,14,7,600
63257911@N00,5654,3,1277469639,1277469909,3,7,270
63257911@N00,5655,21,1277509442,1277509762,3,9,320
63257911@N00,5655,20,1277509762,1277510842,2,9,1080
63257911@N00,5655,14,1277510853,1277510973,4,9,120
63257911@N00,5655,25,1277513223,1277513973,2,9,750
63257911@N00,5655,20,1277514464,1277515544,2,9,1080
63257911@N00,5655,21,1277516682,1277517132,5,9,450
63257911@N00,5655,26,1277517520,1277517700,2,9,180
63257911@N00,5655,17,1277517840,1277518828,3,9,988
63257911@N00,5655,15,1277518828,1277519008,1,9,180
63257911@N00,5656,26,1277595506,1277595686,2,21,180
63257911@N00,5656,24,1277595744,1277596224,5,21,480
63257911@N00,5656,21,1277596546,1277596996,3,21,450
63257911@N00,5656,19,1277597828,1277597979,2,21,151
63257911@N00,5656,18,1277597979,1277598739,4,21,760
63257911@N00,5656,19,1277598739,1277599159,6,21,420
63257911@N00,5656,15,1277599854,1277600034,2,21,180
63257911@N00,5656,22,1277605932,1277606532,2,21,600
63257911@N00,5656,23,1277606917,1277607007,4,21,90
63257911@N00,5656,26,1277607841,1277608005,2,21,164
63257911@N00,5656,23,1277608005,1277608095,2,21,90
63257911@N00,5656,26,1277608654,1277608834,4,21,180
63257911@N00,5656,3,1277614219,1277614489,2,21,270
63257911@N00,5656,2,1277616727,1277616817,5,21,90
63257911@N00,5656,6,1277618483,1277618738,11,21,255
63257911@N00,5656,1,1277621554,1277622154,7,21,600
63257911@N00,5656,14,1277622364,1277622484,3,21,120
63257911@N00,5656,1,1277622772,1277623372,3,21,600
63257911@N00,5656,2,1277623611,1277623701,2,21,90
63257911@N00,5656,11,1277625797,1277625977,8,21,180
63257911@N00,5656,27,1277629205,1277630405,5,21,1200
63257911@N00,5657,26,1308909756,1308909757,2,3,1
63257911@N00,5657,4,1308909757,1308909777,2,3,20
63257911@N00,5657,20,1308909777,1308910857,1,3,1080
63257911@N00,5658,27,1316836869,1316838069,2,9,1200
63257911@N00,5658,4,1316838131,1316839031,4,9,900
63257911@N00,5658,1,1316839046,1316839330,2,9,284
63257911@N00,5658,2,1316839330,1316839420,3,9,90
63257911@N00,5658,13,1316841190,1316841790,10,9,600
63257911@N00,5658,21,1316843840,1316844290,6,9,450
63257911@N00,5658,23,1316844448,1316844538,3,9,90
63257911@N00,5658,1,1316846898,1316847498,2,9,600
63257911@N00,5658,4,1316848086,1316848986,2,9,900
63265130@N03,5659,27,1416013876,1416015076,8,17,1200
63265130@N03,5659,16,1416015759,1416015852,2,17,93
63265130@N03,5659,14,1416015852,1416015972,2,17,120
63265130@N03,5659,10,1416016635,1416017055,3,17,420
63265130@N03,5659,11,1416017337,1416017471,2,17,134
63265130@N03,5659,10,1416017471,1416017891,3,17,420
63265130@N03,5659,11,1416019165,1416019345,3,17,180
63265130@N03,5659,27,1416021357,1416022557,9,17,1200
63265130@N03,5659,25,1416024177,1416024867,2,17,690
63265130@N03,5659,21,1416024867,1416025317,6,17,450
63265130@N03,5659,19,1416028198,1416028618,5,17,420
63265130@N03,5659,20,1416030198,1416031278,2,17,1080
63265130@N03,5659,27,1416031772,1416032972,4,17,1200
63265130@N03,5659,3,1416034780,1416035050,2,17,270
63265130@N03,5659,2,1416036091,1416036181,6,17,90
63265130@N03,5659,7,1416045044,1416045052,2,17,8
63265130@N03,5659,16,1416045052,1416045772,4,17,720
63287267@N00,5660,27,1332825716,1332826916,1,1,1200
63287402@N00,5661,27,1257569590,1257570790,3,2,1200
63287402@N00,5661,14,1257571592,1257571712,1,2,120
63287402@N00,5662,16,1272257074,1272257794,2,2,720
63287402@N00,5662,19,1272258453,1272258873,1,2,420
63287402@N00,5663,2,1272424528,1272424618,2,2,90
63287402@N00,5663,21,1272427611,1272428061,1,2,450
63287402@N00,5664,19,1289256681,1289257101,2,2,420
63287402@N00,5664,6,1289263835,1289264090,1,2,255
63287402@N00,5665,20,1291953957,1291955037,1,1,1080
63287402@N00,5666,15,1304213571,1304213751,1,1,180
63287402@N00,5667,1,1306976109,1306976109,2,2,0
63287402@N00,5667,3,1306976109,1306976379,2,2,270
63287402@N00,5668,22,1313450315,1313450915,1,1,600
63311968@N07,5669,14,1373506445,1373506565,1,1,120
63330642@N06,5670,1,1372849611,1372850211,1,1,600
63330642@N06,5671,1,1379828179,1379828779,1,1,600
63330642@N06,5672,27,1380261792,1380262992,2,4,1200
63330642@N06,5672,1,1380265574,1380266174,2,4,600
63330642@N06,5672,10,1380268213,1380268633,2,4,420
63330642@N06,5672,20,1380269624,1380270704,2,4,1080
63330642@N06,5673,27,1383450270,1383451470,3,2,1200
63330642@N06,5673,3,1383452851,1383453121,1,2,270
63330642@N06,5674,16,1385278407,1385279127,1,1,720
63330642@N06,5675,2,1385719045,1385719135,1,1,90
63330642@N06,5676,27,1387007369,1387008569,1,1,1200
63330642@N06,5677,1,1390718564,1390719164,1,1,600
63330642@N06,5678,4,1391242855,1391243755,1,1,900
63330642@N06,5679,16,1391843858,1391844578,2,2,720
63330642@N06,5679,21,1391845829,1391846279,1,2,450
63330642@N06,5680,5,1393742872,1393743592,2,2,720
63330642@N06,5680,3,1393746731,1393747001,3,2,270
63330642@N06,5681,9,1394262532,1394262772,1,1,240
63330642@N06,5682,13,1394868825,1394869425,1,1,600
63330642@N06,5683,14,1396072624,1396072744,2,6,120
63330642@N06,5683,20,1396074049,1396075129,5,6,1080
63330642@N06,5683,19,1396076739,1396077159,2,6,420
63330642@N06,5683,24,1396078810,1396079290,2,6,480
63330642@N06,5683,1,1396083918,1396084518,2,6,600
63330642@N06,5683,9,1396085031,1396085271,1,6,240
63330642@N06,5684,17,1396679118,1396679511,2,5,393
63330642@N06,5684,13,1396679511,1396680111,2,5,600
63330642@N06,5684,14,1396681778,1396681898,2,5,120
63330642@N06,5684,10,1396683259,1396683679,2,5,420
63330642@N06,5684,11,1396686906,1396687086,1,5,180
63330642@N06,5685,2,1440829135,1440829225,1,1,90
63338696@N00,5686,14,1221563024,1221563144,2,2,120
63338696@N00,5686,16,1221572170,1221572890,1,2,720
63365181@N00,5687,27,1326705763,1326706963,2,1,1200
63513545@N00,5688,27,1380271423,1380272623,8,6,1200
63513545@N00,5688,4,1380272773,1380273673,2,6,900
63513545@N00,5688,6,1380274292,1380274547,2,6,255
63513545@N00,5688,9,1380274931,1380275004,2,6,73
63513545@N00,5688,14,1380275004,1380275124,2,6,120
63513545@N00,5688,27,1380278722,1380279922,3,6,1200
63513545@N00,5689,25,1380332086,1380332836,4,10,750
63513545@N00,5689,13,1380332973,1380333048,2,10,75
63513545@N00,5689,18,1380333048,1380333056,2,10,8
63513545@N00,5689,13,1380333056,1380333656,3,10,600
63513545@N00,5689,19,1380337379,1380337447,4,10,68
63513545@N00,5689,18,1380337447,1380338209,2,10,762
63513545@N00,5689,19,1380338209,1380338629,2,10,420
63513545@N00,5689,14,1380341489,1380341609,2,10,120
63513545@N00,5689,16,1380341739,1380342459,2,10,720
63513545@N00,5689,19,1380343268,1380343688,1,10,420
63513545@N00,5690,1,1380612850,1380613450,2,1,600
63513545@N00,5691,27,1415236480,1415237680,2,7,1200
63513545@N00,5691,9,1415240809,1415241049,2,7,240
63513545@N00,5691,6,1415242514,1415242769,2,7,255
63513545@N00,5691,7,1415243907,1415243997,5,7,90
63513545@N00,5691,15,1415247833,1415248013,3,7,180
63513545@N00,5691,21,1415250979,1415251429,2,7,450
63513545@N00,5691,23,1415253710,1415253800,3,7,90
63513545@N00,5692,7,1415404808,1415404898,1,1,90
63559604@N00,5693,2,1252645800,1252645890,1,1,90
63631877@N00,5694,27,1220217854,1220219054,1,1,1200
63631877@N00,5695,27,1223369986,1223371186,1,1,1200
63631877@N00,5696,16,1231046861,1231046875,2,3,14
63631877@N00,5696,9,1231046875,1231046879,2,3,4
63631877@N00,5696,3,1231046879,1231047149,1,3,270
63631877@N00,5697,5,1234743329,1234743348,2,2,19
63631877@N00,5697,13,1234743348,1234743948,1,2,600
63631877@N00,5698,1,1239513205,1239513248,2,2,43
63631877@N00,5698,25,1239513248,1239513998,1,2,750
63631877@N00,5699,14,1249100957,1249101077,1,1,120
63631877@N00,5700,27,1271122031,1271122036,2,2,5
63631877@N00,5700,22,1271122036,1271122636,1,2,600
63631877@N00,5701,12,1400202932,1400203772,1,1,840
63637045@N07,5702,27,1400990947,1400992147,7,1,1200
63679518@N00,5703,17,1319497489,1319498869,1,1,1380
63691080@N00,5704,27,1311309998,1311311198,3,13,1200
63691080@N00,5704,22,1311313101,1311313701,3,13,600
63691080@N00,5704,23,1311315452,1311315542,3,13,90
63691080@N00,5704,16,1311317117,1311317837,2,13,720
63691080@N00,5704,6,1311318419,1311318674,3,13,255
63691080@N00,5704,14,1311319330,1311319450,2,13,120
63691080@N00,5704,15,1311320589,1311320769,2,13,180
63691080@N00,5704,13,1311321173,1311321773,2,13,600
63691080@N00,5704,14,1311322930,1311323050,2,13,120
63691080@N00,5704,2,1311323441,1311323531,2,13,90
63691080@N00,5704,4,1311328699,1311329599,2,13,900
63691080@N00,5704,1,1311332186,1311332786,2,13,600
63691080@N00,5704,16,1311336054,1311336774,2,13,720
63691080@N00,5705,14,1311595360,1311595480,1,1,120
63765222@N02,5706,13,1461030059,1461030659,2,2,600
63765222@N02,5706,9,1461040630,1461040870,1,2,240
63786834@N00,5707,1,1298800123,1298800723,2,6,600
63786834@N00,5707,13,1298803193,1298803793,2,6,600
63786834@N00,5707,19,1298804248,1298804668,2,6,420
63786834@N00,5707,21,1298805937,1298806387,2,6,450
63786834@N00,5707,20,1298807433,1298808283,2,6,850
63786834@N00,5707,14,1298808283,1298808403,1,6,120
63812709@N02,5708,27,1306448277,1306449477,11,8,1200
63812709@N02,5708,19,1306452732,1306452955,3,8,223
63812709@N02,5708,17,1306452955,1306454335,7,8,1380
63812709@N02,5708,27,1306454356,1306455556,47,8,1200
63812709@N02,5708,19,1306460114,1306460142,2,8,28
63812709@N02,5708,27,1306460142,1306461342,5,8,1200
63812709@N02,5708,9,1306463911,1306464151,2,8,240
63812709@N02,5708,27,1306465456,1306466656,11,8,1200
63812709@N02,5709,27,1306535016,1306536216,3,1,1200
63818228@N03,5710,15,1310641759,1310641939,1,1,180
63818228@N03,5711,26,1312927872,1312928052,1,1,180
63883907@N00,5712,20,1290717352,1290718432,2,5,1080
63883907@N00,5712,26,1290723856,1290723948,2,5,92
63883907@N00,5712,25,1290723948,1290724698,2,5,750
63883907@N00,5712,9,1290733274,1290733514,2,5,240
63883907@N00,5712,12,1290734626,1290735466,2,5,840
63958044@N03,5713,27,1347282474,1347283674,1,1,1200
64034745@N02,5714,21,1373071589,1373072039,2,1,450
64105048@N00,5715,9,1442974053,1442974293,1,1,240
64105875@N00,5716,27,1218060099,1218060704,5,20,605
64105875@N00,5716,16,1218060704,1218061424,2,20,720
64105875@N00,5716,12,1218062195,1218063035,9,20,840
64105875@N00,5716,9,1218063633,1218063873,6,20,240
64105875@N00,5716,20,1218065391,1218066471,5,20,1080
64105875@N00,5716,19,1218066628,1218067048,5,20,420
64105875@N00,5716,21,1218068123,1218068573,4,20,450
64105875@N00,5716,22,1218071121,1218071721,5,20,600
64105875@N00,5716,24,1218072206,1218072686,10,20,480
64105875@N00,5716,4,1218073856,1218074756,2,20,900
64105875@N00,5716,1,1218074951,1218075290,2,20,339
64105875@N00,5716,16,1218075290,1218076010,4,20,720
64105875@N00,5716,14,1218077295,1218077415,7,20,120
64105875@N00,5716,27,1218087593,1218088793,2,20,1200
64105875@N00,5716,1,1218090298,1218090898,3,20,600
64105875@N00,5716,17,1218091905,1218093285,3,20,1380
64105875@N00,5716,18,1218095393,1218097193,4,20,1800
64105875@N00,5716,17,1218097622,1218099002,2,20,1380
64105875@N00,5716,8,1218099397,1218099517,2,20,120
64105875@N00,5716,27,1218100506,1218101706,22,20,1200
64111638@N00,5717,16,1382021092,1382021812,1,1,720
64171510@N00,5718,25,1247212175,1247212659,2,7,484
64171510@N00,5718,21,1247212659,1247213109,2,7,450
64171510@N00,5718,26,1247215585,1247215765,7,7,180
64171510@N00,5718,17,1247227319,1247228699,2,7,1380
64171510@N00,5718,9,1247236586,1247236826,3,7,240
64171510@N00,5718,14,1247237135,1247237255,2,7,120
64171510@N00,5718,16,1247238772,1247239492,1,7,720
64220937@N02,5719,26,1322288036,1322288216,1,1,180
64285153@N00,5720,16,1291415629,1291416349,2,1,720
64298924@N04,5721,27,1409411102,1409412302,1,1,1200
64318110@N00,5722,27,1363902184,1363903384,2,2,1200
64318110@N00,5722,13,1363910560,1363911160,1,2,600
64355339@N02,5723,4,1197309858,1197310758,1,1,900
64406224@N07,5724,27,1372406941,1372408141,1,1,1200
64415341@N07,5725,27,1315699994,1315701194,1,1,1200
64440833@N05,5726,17,1302339536,1302339964,3,6,428
64440833@N05,5726,13,1302339964,1302340239,5,6,275
64440833@N05,5726,18,1302340239,1302341658,2,6,1419
64440833@N05,5726,22,1302341658,1302342258,3,6,600
64440833@N05,5726,20,1302344802,1302345882,3,6,1080
64440833@N05,5726,15,1302350272,1302350452,2,6,180
64440833@N05,5727,27,1303766782,1303767540,2,4,758
64440833@N05,5727,1,1303767540,1303768140,2,4,600
64440833@N05,5727,14,1303768861,1303768981,2,4,120
64440833@N05,5727,15,1303769439,1303769619,1,4,180
64440833@N05,5728,9,1312531204,1312531444,3,6,240
64440833@N05,5728,14,1312531565,1312531685,3,6,120
64440833@N05,5728,12,1312532534,1312533374,2,6,840
64440833@N05,5728,13,1312537658,1312538258,2,6,600
64440833@N05,5728,17,1312541729,1312543109,2,6,1380
64440833@N05,5728,21,1312543246,1312543696,3,6,450
64440833@N05,5729,27,1371771700,1371772900,10,1,1200
64440833@N05,5730,27,1371811549,1371812749,1,1,1200
64440833@N05,5731,27,1374801408,1374802608,22,1,1200
64440833@N05,5732,27,1387012553,1387013753,2,1,1200
64465885@N03,5733,24,1309399595,1309400075,2,2,480
64465885@N03,5733,25,1309403557,1309404307,1,2,750
64465885@N03,5734,25,1328066096,1328066846,1,1,750
64465885@N03,5735,25,1409204212,1409204962,2,1,750
64465885@N03,5736,14,1421013320,1421013440,2,15,120
64465885@N03,5736,16,1421013893,1421014075,18,15,182
64465885@N03,5736,14,1421014075,1421014195,3,15,120
64465885@N03,5736,16,1421014523,1421015243,12,15,720
64465885@N03,5736,10,1421017200,1421017620,2,15,420
64465885@N03,5736,14,1421017746,1421017866,2,15,120
64465885@N03,5736,9,1421020800,1421021040,12,15,240
64465885@N03,5736,10,1421025483,1421025903,2,15,420
64465885@N03,5736,15,1421030441,1421030621,2,15,180
64465885@N03,5736,24,1421033461,1421033551,3,15,90
64465885@N03,5736,21,1421033551,1421033631,2,15,80
64465885@N03,5736,24,1421033631,1421034111,6,15,480
64465885@N03,5736,23,1421034674,1421034764,3,15,90
64465885@N03,5736,3,1421037336,1421037606,2,15,270
64465885@N03,5736,16,1421047931,1421048651,5,15,720
64465885@N03,5737,14,1421274353,1421274473,12,16,120
64465885@N03,5737,16,1421275083,1421275803,5,16,720
64465885@N03,5737,27,1421277731,1421278931,13,16,1200
64465885@N03,5737,17,1421279663,1421280050,11,16,387
64465885@N03,5737,16,1421280050,1421280770,2,16,720
64465885@N03,5737,1,1421281028,1421281210,2,16,182
64465885@N03,5737,3,1421281210,1421281480,2,16,270
64465885@N03,5737,27,1421281713,1421282913,9,16,1200
64465885@N03,5737,10,1421285364,1421285413,7,16,49
64465885@N03,5737,9,1421285413,1421285653,7,16,240
64465885@N03,5737,10,1421286991,1421287411,2,16,420
64465885@N03,5737,14,1421290393,1421290513,2,16,120
64465885@N03,5737,13,1421291881,1421292481,5,16,600
64465885@N03,5737,23,1421300252,1421300342,7,16,90
64465885@N03,5737,3,1421301738,1421302008,2,16,270
64465885@N03,5737,16,1421316231,1421316951,3,16,720
64466278@N03,5738,21,1340014898,1340014961,2,6,63
64466278@N03,5738,24,1340014961,1340015018,3,6,57
64466278@N03,5738,16,1340015018,1340015118,2,6,100
64466278@N03,5738,14,1340015118,1340015156,2,6,38
64466278@N03,5738,9,1340015156,1340015222,3,6,66
64466278@N03,5738,16,1340015222,1340015942,1,6,720
64466278@N03,5739,13,1344504187,1344504348,2,3,161
64466278@N03,5739,27,1344504348,1344504476,2,3,128
64466278@N03,5739,21,1344504476,1344504926,2,3,450
64466278@N03,5740,11,1348977035,1348977215,1,1,180
64466278@N03,5741,10,1350164887,1350165307,11,1,420
64466278@N03,5742,9,1352462174,1352462414,2,2,240
64466278@N03,5742,27,1352467230,1352468430,1,2,1200
64478148@N07,5743,9,1333787777,1333788017,4,2,240
64478148@N07,5743,8,1333788234,1333788354,17,2,120
64478148@N07,5744,23,1333889434,1333889524,5,5,90
64478148@N07,5744,8,1333892375,1333892495,7,5,120
64478148@N07,5744,7,1333892558,1333892607,3,5,49
64478148@N07,5744,8,1333892607,1333892667,2,5,60
64478148@N07,5744,7,1333892667,1333892757,1,5,90
64478148@N07,5745,8,1335870598,1335870718,6,2,120
64478148@N07,5745,7,1335871025,1335871115,1,2,90
64478148@N07,5746,11,1339833125,1339833256,9,6,131
64478148@N07,5746,8,1339833256,1339833376,5,6,120
64478148@N07,5746,11,1339833441,1339833468,4,6,27
64478148@N07,5746,8,1339833468,1339833588,4,6,120
64478148@N07,5746,7,1339834217,1339834307,7,6,90
64478148@N07,5746,9,1339834440,1339834680,1,6,240
64478148@N07,5747,16,1347620435,1347621155,2,1,720
64478148@N07,5748,6,1350005356,1350005470,2,23,114
64478148@N07,5748,14,1350005470,1350005491,3,23,21
64478148@N07,5748,9,1350005491,1350005670,2,23,179
64478148@N07,5748,10,1350005670,1350005796,9,23,126
64478148@N07,5748,9,1350005796,1350005798,2,23,2
64478148@N07,5748,10,1350005798,1350005946,3,23,148
64478148@N07,5748,9,1350005946,1350005967,3,23,21
64478148@N07,5748,10,1350005967,1350006387,25,23,420
64478148@N07,5748,11,1350006528,1350006623,11,23,95
64478148@N07,5748,10,1350006623,1350006627,2,23,4
64478148@N07,5748,11,1350006627,1350006807,42,23,180
64478148@N07,5748,10,1350007222,1350007642,6,23,420
64478148@N07,5748,11,1350008301,1350008371,4,23,70
64478148@N07,5748,10,1350008371,1350008385,2,23,14
64478148@N07,5748,11,1350008385,1350008565,12,23,180
64478148@N07,5748,7,1350008900,1350008905,2,23,5
64478148@N07,5748,10,1350008905,1350009325,3,23,420
64478148@N07,5748,25,1350009355,1350009676,2,23,321
64478148@N07,5748,10,1350009676,1350009848,16,23,172
64478148@N07,5748,9,1350009848,1350010088,16,23,240
64478148@N07,5748,10,1350010321,1350010434,4,23,113
64478148@N07,5748,9,1350010434,1350010674,5,23,240
64478148@N07,5748,10,1350010694,1350011114,2,23,420
64478148@N07,5749,9,1350637735,1350637744,2,2,9
64478148@N07,5749,10,1350637744,1350638164,30,2,420
64478148@N07,5750,10,1351928798,1351929218,3,1,420
64478148@N07,5751,25,1352965144,1352965203,2,2,59
64478148@N07,5751,27,1352965203,1352966403,3,2,1200
64478148@N07,5752,27,1358736628,1358737828,15,1,1200
64478148@N07,5753,22,1359263087,1359263262,2,4,175
64478148@N07,5753,20,1359263262,1359263310,5,4,48
64478148@N07,5753,19,1359263310,1359263730,23,4,420
64478148@N07,5753,20,1359266375,1359267455,2,4,1080
64478148@N07,5754,27,1360904295,1360905495,4,2,1200
64478148@N07,5754,14,1360908164,1360908284,3,2,120
64478148@N07,5755,27,1362698994,1362699631,8,9,637
64478148@N07,5755,15,1362699631,1362699811,2,9,180
64478148@N07,5755,12,1362699962,1362700135,3,9,173
64478148@N07,5755,15,1362700135,1362700315,9,9,180
64478148@N07,5755,13,1362700445,1362700494,2,9,49
64478148@N07,5755,17,1362700494,1362700612,6,9,118
64478148@N07,5755,15,1362700612,1362700792,17,9,180
64478148@N07,5755,12,1362701283,1362701410,3,9,127
64478148@N07,5755,15,1362701410,1362701590,2,9,180
64478148@N07,5756,15,1362996207,1362996387,28,7,180
64478148@N07,5756,13,1362996669,1362996689,2,7,20
64478148@N07,5756,15,1362996689,1362996732,2,7,43
64478148@N07,5756,13,1362996732,1362997332,4,7,600
64478148@N07,5756,7,1363005409,1363005499,6,7,90
64478148@N07,5756,8,1363005545,1363005567,3,7,22
64478148@N07,5756,19,1363005567,1363005987,3,7,420
64478148@N07,5757,27,1363999126,1364000326,6,1,1200
64478148@N07,5758,27,1365978737,1365979937,3,9,1200
64478148@N07,5758,25,1365981111,1365981299,2,9,188
64478148@N07,5758,26,1365981299,1365981479,2,9,180
64478148@N07,5758,25,1365982216,1365982966,2,9,750
64478148@N07,5758,26,1365984926,1365985094,4,9,168
64478148@N07,5758,21,1365985094,1365985124,3,9,30
64478148@N07,5758,22,1365985124,1365985168,2,9,44
64478148@N07,5758,20,1365985168,1365985608,2,9,440
64478148@N07,5758,21,1365985608,1365986058,10,9,450
64478148@N07,5759,25,1366955391,1366955544,4,2,153
64478148@N07,5759,17,1366955544,1366956924,1,2,1380
64478148@N07,5760,21,1368228046,1368228283,10,6,237
64478148@N07,5760,23,1368228283,1368228373,2,6,90
64478148@N07,5760,21,1368228611,1368229061,4,6,450
64478148@N07,5760,17,1368230949,1368231670,2,6,721
64478148@N07,5760,21,1368231670,1368232120,3,6,450
64478148@N07,5760,10,1368254102,1368254522,5,6,420
64478148@N07,5761,27,1369398560,1369399760,4,1,1200
64478148@N07,5762,27,1374367771,1374368971,11,1,1200
64478148@N07,5763,27,1378082217,1378083417,17,1,1200
64478148@N07,5764,14,1379062096,1379062216,48,8,120
64478148@N07,5764,15,1379069236,1379069416,2,8,180
64478148@N07,5764,6,1379069679,1379069815,2,8,136
64478148@N07,5764,5,1379069815,1379070535,2,8,720
64478148@N07,5764,4,1379071834,1379072734,49,8,900
64478148@N07,5764,20,1379075452,1379076532,20,8,1080
64478148@N07,5764,26,1379077508,1379077688,2,8,180
64478148@N07,5764,13,1379077979,1379078579,1,8,600
64478148@N07,5765,14,1382932499,1382932583,5,3,84
64478148@N07,5765,9,1382932583,1382932672,2,3,89
64478148@N07,5765,7,1382932672,1382932762,4,3,90
64478148@N07,5766,16,1384154555,1384155275,2,7,720
64478148@N07,5766,21,1384156269,1384156719,2,7,450
64478148@N07,5766,26,1384166348,1384166506,2,7,158
64478148@N07,5766,17,1384166506,1384167886,4,7,1380
64478148@N07,5766,14,1384170760,1384170880,2,7,120
64478148@N07,5766,17,1384172178,1384173558,2,7,1380
64478148@N07,5766,27,1384175200,1384176400,14,7,1200
64478148@N07,5767,20,1384238555,1384238559,2,2,4
64478148@N07,5767,26,1384238559,1384238739,1,2,180
64478148@N07,5768,9,1392723253,1392723396,2,2,143
64478148@N07,5768,10,1392723396,1392723816,3,2,420
64478148@N07,5769,9,1394942706,1394942946,7,2,240
64478148@N07,5769,14,1394943024,1394943144,3,2,120
64478148@N07,5770,7,1397992716,1397992806,4,1,90
64478148@N07,5771,10,1400791671,1400792091,3,13,420
64478148@N07,5771,9,1400793273,1400793513,3,13,240
64478148@N07,5771,2,1400800356,1400800446,2,13,90
64478148@N07,5771,9,1400805361,1400805601,6,13,240
64478148@N07,5771,20,1400820028,1400821108,2,13,1080
64478148@N07,5771,17,1400831023,1400832403,5,13,1380
64478148@N07,5771,14,1400837508,1400837628,3,13,120
64478148@N07,5771,9,1400837770,1400838001,2,13,231
64478148@N07,5771,10,1400838001,1400838101,3,13,100
64478148@N07,5771,9,1400838101,1400838341,4,13,240
64478148@N07,5771,26,1400850217,1400850397,3,13,180
64478148@N07,5771,27,1400852977,1400854177,25,13,1200
64478148@N07,5771,10,1400858995,1400859415,1,13,420
64478148@N07,5772,16,1409346896,1409347616,4,4,720
64478148@N07,5772,25,1409348258,1409348753,2,4,495
64478148@N07,5772,26,1409348753,1409348933,3,4,180
64478148@N07,5772,14,1409349234,1409349354,4,4,120
64478148@N07,5773,27,1409554106,1409555306,26,3,1200
64478148@N07,5773,17,1409575166,1409576546,2,3,1380
64478148@N07,5773,4,1409577945,1409578845,1,3,900
64478148@N07,5774,26,1409677943,1409677944,2,3,1
64478148@N07,5774,27,1409677944,1409677962,8,3,18
64478148@N07,5774,17,1409677962,1409679342,1,3,1380
64478148@N07,5775,27,1420377192,1420378392,1,1,1200
64542402@N07,5776,27,1355527948,1355528875,3,21,927
64542402@N07,5776,14,1355528875,1355528995,2,21,120
64542402@N07,5776,6,1355529403,1355529658,2,21,255
64542402@N07,5776,9,1355529941,1355530165,2,21,224
64542402@N07,5776,10,1355530165,1355530577,2,21,412
64542402@N07,5776,14,1355530577,1355530697,2,21,120
64542402@N07,5776,24,1355535100,1355535580,2,21,480
64542402@N07,5776,14,1355536165,1355536285,3,21,120
64542402@N07,5776,25,1355538519,1355539269,3,21,750
64542402@N07,5776,21,1355541653,1355542103,2,21,450
64542402@N07,5776,5,1355542338,1355543058,2,21,720
64542402@N07,5776,25,1355543328,1355544078,2,21,750
64542402@N07,5776,10,1355544747,1355545167,2,21,420
64542402@N07,5776,14,1355545395,1355545515,3,21,120
64542402@N07,5776,27,1355547318,1355547522,2,21,204
64542402@N07,5776,25,1355547522,1355548272,2,21,750
64542402@N07,5776,9,1355551408,1355551648,2,21,240
64542402@N07,5776,25,1355553908,1355554658,2,21,750
64542402@N07,5776,19,1355558774,1355559194,2,21,420
64542402@N07,5776,8,1355559306,1355559426,2,21,120
64542402@N07,5776,27,1355575612,1355576812,1,21,1200
64552430@N08,5777,16,1290157354,1290158074,1,1,720
64574649@N00,5778,16,1308392814,1308393534,1,1,720
64574649@N00,5779,27,1341211965,1341213165,1,1,1200
64588066@N00,5780,27,1392471487,1392472687,1,1,1200
64592191@N00,5781,16,1197769467,1197770187,1,1,720
64623188@N00,5782,18,1428812884,1428814684,1,1,1800
64634237@N02,5783,12,1291703266,1291704106,1,1,840
64634237@N02,5784,12,1311041099,1311041939,31,1,840
64667804@N00,5785,17,1190934243,1190935623,2,1,1380
64667804@N00,5786,17,1191221657,1191223037,2,1,1380
64667804@N00,5787,17,1194125599,1194126979,1,1,1380
64667804@N00,5788,17,1194473183,1194474563,13,1,1380
64669762@N02,5789,27,1350985282,1350986482,2,4,1200
64669762@N02,5789,10,1350991510,1350991930,2,4,420
64669762@N02,5789,13,1350993107,1350993707,2,4,600
64669762@N02,5789,27,1350997050,1350998250,2,4,1200
64697193@N06,5790,16,1365035187,1365035907,3,1,720
64713954@N00,5791,3,1345513468,1345513738,1,1,270
64769958@N07,5792,13,1311999372,1311999972,1,1,600
64777759@N06,5793,19,1319337684,1319338104,1,1,420
64779594@N00,5794,27,1195249559,1195250597,6,8,1038
64779594@N00,5794,1,1195250597,1195251197,2,8,600
64779594@N00,5794,13,1195252936,1195253536,2,8,600
64779594@N00,5794,19,1195255072,1195255492,2,8,420
64779594@N00,5794,18,1195255904,1195257704,3,8,1800
64779594@N00,5794,9,1195259069,1195259309,2,8,240
64779594@N00,5794,4,1195271188,1195272088,2,8,900
64779594@N00,5794,27,1195275144,1195276344,1,8,1200
64779594@N00,5795,15,1201393993,1201394173,2,1,180
64779594@N00,5796,21,1205032392,1205032842,4,1,450
64779594@N00,5797,27,1377411157,1377412357,1,1,1200
64779594@N00,5798,18,1390697217,1390697567,3,2,350
64779594@N00,5798,13,1390697567,1390698167,2,2,600
64779594@N00,5799,16,1394800528,1394801248,1,1,720
64779594@N00,5800,9,1418332517,1418332757,4,1,240
64779594@N00,5801,27,1454038868,1454040068,2,8,1200
64779594@N00,5801,21,1454040201,1454040651,2,8,450
64779594@N00,5801,2,1454043419,1454043509,2,8,90
64779594@N00,5801,4,1454044403,1454045303,3,8,900
64779594@N00,5801,14,1454047294,1454047414,2,8,120
64779594@N00,5801,27,1454047605,1454048805,9,8,1200
64779594@N00,5801,20,1454049313,1454049840,2,8,527
64779594@N00,5801,11,1454049840,1454050020,3,8,180
64787247@N02,5802,10,1367899433,1367899853,1,1,420
64812054@N06,5803,4,1324646231,1324647131,31,1,900
64812054@N06,5804,4,1324729177,1324730077,52,1,900
64812054@N06,5805,4,1324920989,1324921889,18,1,900
64812054@N06,5806,4,1325029698,1325030598,12,1,900
64812054@N06,5807,4,1325545020,1325545920,4,1,900
64834051@N00,5808,27,1230151851,1230153051,8,3,1200
64834051@N00,5808,12,1230155167,1230156007,6,3,840
64834051@N00,5808,14,1230161313,1230161433,7,3,120
64834051@N00,5809,27,1230402465,1230403665,6,6,1200
64834051@N00,5809,16,1230403876,1230404113,6,6,237
64834051@N00,5809,14,1230404113,1230404233,29,6,120
64834051@N00,5809,12,1230410926,1230411766,5,6,840
64834051@N00,5809,11,1230423504,1230423684,11,6,180
64834051@N00,5809,23,1230429036,1230429126,3,6,90
64834051@N00,5810,14,1292894724,1292894844,1,1,120
64834051@N00,5811,21,1341637399,1341637849,4,1,450
64834051@N00,5812,27,1342231351,1342231567,2,2,216
64834051@N00,5812,16,1342231567,1342232287,4,2,720
64834051@N00,5813,27,1421533729,1421534929,4,10,1200
64834051@N00,5813,6,1421543178,1421543433,2,10,255
64834051@N00,5813,19,1421549871,1421550291,4,10,420
64834051@N00,5813,26,1421554670,1421554850,2,10,180
64834051@N00,5813,11,1421559161,1421559190,2,10,29
64834051@N00,5813,8,1421559190,1421559310,2,10,120
64834051@N00,5813,10,1421559439,1421559859,3,10,420
64834051@N00,5813,8,1421559876,1421559996,2,10,120
64834051@N00,5813,10,1421561500,1421561920,2,10,420
64834051@N00,5813,14,1421562675,1421562795,2,10,120
64834051@N00,5814,27,1421969435,1421970635,2,19,1200
64834051@N00,5814,5,1421972651,1421973371,2,19,720
64834051@N00,5814,6,1421974478,1421974733,3,19,255
64834051@N00,5814,7,1421976379,1421976469,2,19,90
64834051@N00,5814,8,1421976915,1421977035,3,19,120
64834051@N00,5814,19,1421978819,1421979239,2,19,420
64834051@N00,5814,17,1421982300,1421983680,2,19,1380
64834051@N00,5814,2,1421984034,1421984124,4,19,90
64834051@N00,5814,9,1421985184,1421985424,3,19,240
64834051@N00,5814,7,1421985578,1421985668,2,19,90
64834051@N00,5814,23,1421988031,1421988121,2,19,90
64834051@N00,5814,25,1421989512,1421990262,3,19,750
64834051@N00,5814,9,1421993784,1421994024,3,19,240
64834051@N00,5814,25,1421994225,1421994832,2,19,607
64834051@N00,5814,10,1421994832,1421995252,2,19,420
64834051@N00,5814,14,1421997170,1421997290,11,19,120
64834051@N00,5814,9,1422003757,1422003804,2,19,47
64834051@N00,5814,14,1422003804,1422003924,4,19,120
64834051@N00,5814,16,1422009411,1422010131,1,19,720
64834051@N00,5815,14,1439005380,1439005500,2,5,120
64834051@N00,5815,20,1439014020,1439015100,2,5,1080
64834051@N00,5815,10,1439017837,1439018129,2,5,292
64834051@N00,5815,16,1439018129,1439018139,2,5,10
64834051@N00,5815,14,1439018139,1439018259,1,5,120
64834051@N00,5816,19,1439429825,1439430245,2,1,420
64834051@N00,5817,9,1439475595,1439475835,1,1,240
64854604@N07,5818,2,1429193344,1429193434,2,2,90
64854604@N07,5818,23,1429196511,1429196601,1,2,90
64874983@N00,5819,24,1254286682,1254287162,2,2,480
64874983@N00,5819,20,1254290243,1254291323,1,2,1080
64874983@N00,5820,27,1254350694,1254351894,1,1,1200
64874983@N00,5821,20,1254618208,1254618317,2,2,109
64874983@N00,5821,27,1254618317,1254619517,2,2,1200
64876770@N08,5822,27,1309699637,1309700837,1,1,1200
64907932@N00,5823,14,1443491828,1443491948,1,1,120
64907932@N00,5824,14,1443764286,1443764406,1,1,120
64917984@N00,5825,26,1269228088,1269228268,2,2,180
64917984@N00,5825,25,1269228292,1269229042,1,2,750
64923481@N00,5826,18,1363223412,1363225212,1,1,1800
64975676@N03,5827,14,1310127927,1310128047,1,1,120
64999331@N04,5828,16,1311963935,1311964655,1,1,720
65067379@N08,5829,27,1384331834,1384333034,2,1,1200
65098523@N02,5830,4,1313119187,1313120087,1,1,900
65105672@N00,5831,16,1379219419,1379220139,1,1,720
65105672@N00,5832,16,1379251310,1379252030,1,1,720
65105672@N00,5833,16,1379458804,1379459524,2,4,720
65105672@N00,5833,15,1379461227,1379461407,3,4,180
65105672@N00,5833,22,1379462911,1379463511,4,4,600
65105672@N00,5833,16,1379468091,1379468811,3,4,720
65105672@N00,5834,9,1442966383,1442966623,2,8,240
65105672@N00,5834,12,1442968750,1442969590,3,8,840
65105672@N00,5834,10,1442969849,1442970269,2,8,420
65105672@N00,5834,13,1442974758,1442975358,4,8,600
65105672@N00,5834,16,1442977179,1442977899,3,8,720
65105672@N00,5834,2,1442979927,1442980017,2,8,90
65105672@N00,5834,10,1442982463,1442982883,7,8,420
65105672@N00,5834,16,1442997231,1442997951,1,8,720
65105672@N00,5835,13,1443177829,1443178429,4,4,600
65105672@N00,5835,17,1443181396,1443182776,7,4,1380
65105672@N00,5835,16,1443189045,1443189765,2,4,720
65105672@N00,5835,27,1443191616,1443192816,2,4,1200
65105672@N00,5836,27,1443307019,1443308219,3,2,1200
65105672@N00,5836,17,1443331046,1443332426,2,2,1380
65105672@N00,5837,27,1443602528,1443603728,3,12,1200
65105672@N00,5837,13,1443606822,1443607422,2,12,600
65105672@N00,5837,17,1443608351,1443609731,11,12,1380
65105672@N00,5837,21,1443610241,1443610691,8,12,450
65105672@N00,5837,17,1443611378,1443612426,3,12,1048
65105672@N00,5837,13,1443612426,1443612442,2,12,16
65105672@N00,5837,15,1443612442,1443612532,2,12,90
65105672@N00,5837,14,1443612532,1443612652,2,12,120
65105672@N00,5837,10,1443612799,1443613098,3,12,299
65105672@N00,5837,7,1443613098,1443613188,2,12,90
65105672@N00,5837,4,1443615415,1443616315,2,12,900
65105672@N00,5837,27,1443617502,1443618702,1,12,1200
65105672@N00,5838,17,1443671232,1443672612,7,2,1380
65105672@N00,5838,8,1443684317,1443684437,1,2,120
65105672@N00,5839,21,1443757489,1443757939,1,1,450
65105672@N00,5840,27,1460540788,1460541988,3,1,1200
65105672@N00,5841,27,1460844824,1460846024,1,1,1200
65105672@N00,5842,6,1460887077,1460887332,4,1,255
65145534@N06,5843,16,1310003087,1310003807,1,1,720
65164043@N02,5844,27,1414107984,1414109184,2,2,1200
65164043@N02,5844,16,1414125373,1414126093,1,2,720
65164043@N02,5845,19,1414632744,1414633164,1,1,420
65184867@N04,5846,27,1393718808,1393720008,1,1,1200
65184867@N04,5847,14,1393752610,1393752730,1,1,120
65223931@N00,5848,16,1387875691,1387876411,2,1,720
65228321@N00,5849,27,1448774376,1448775576,10,8,1200
65228321@N00,5849,16,1448775887,1448776607,3,8,720
65228321@N00,5849,6,1448777137,1448777392,6,8,255
65228321@N00,5849,9,1448777911,1448778151,2,8,240
65228321@N00,5849,17,1448782112,1448783492,2,8,1380
65228321@N00,5849,22,1448789479,1448790079,4,8,600
65228321@N00,5849,16,1448797146,1448797866,3,8,720
65228321@N00,5849,27,1448802875,1448804075,3,8,1200
65228321@N00,5850,27,1449298760,1449299960,1,1,1200
65315936@N00,5851,2,1371208894,1371208984,1,1,90
65350711@N08,5852,25,1253433366,1253434116,1,1,750
65353764@N06,5853,27,1402361879,1402363079,1,1,1200
65353764@N06,5854,3,1402640912,1402641182,2,2,270
65353764@N06,5854,10,1402647501,1402647921,1,2,420
65353764@N06,5855,20,1402813202,1402814282,2,4,1080
65353764@N06,5855,21,1402819281,1402819731,4,4,450
65353764@N06,5855,9,1402825955,1402826195,4,4,240
65353764@N06,5855,3,1402828654,1402828924,1,4,270
65367128@N00,5856,27,1198230169,1198231369,7,7,1200
65367128@N00,5856,22,1198232689,1198233289,5,7,600
65367128@N00,5856,17,1198235002,1198235054,3,7,52
65367128@N00,5856,21,1198235054,1198235504,4,7,450
65367128@N00,5856,27,1198241254,1198242256,2,7,1002
65367128@N00,5856,22,1198242256,1198242856,3,7,600
65367128@N00,5856,27,1198244022,1198245222,5,7,1200
65367128@N00,5857,4,1198317039,1198317939,7,2,900
65367128@N00,5857,27,1198324055,1198325255,1,2,1200
65367128@N00,5858,6,1229677682,1229677937,1,1,255
65367128@N00,5859,9,1261133495,1261133735,1,1,240
65367128@N00,5860,4,1278264725,1278265625,1,1,900
65367128@N00,5861,27,1292575408,1292576608,1,1,1200
65367128@N00,5862,12,1374120172,1374121012,2,2,840
65367128@N00,5862,15,1374122557,1374122737,1,2,180
65367128@N00,5863,3,1396095550,1396095820,2,1,270
65367128@N00,5864,27,1456020716,1456021916,2,2,1200
65367128@N00,5864,20,1456023016,1456024096,1,2,1080
65367128@N00,5865,27,1456093122,1456094322,3,7,1200
65367128@N00,5865,24,1456095041,1456095521,2,7,480
65367128@N00,5865,21,1456096523,1456096973,2,7,450
65367128@N00,5865,20,1456097227,1456098307,7,7,1080
65367128@N00,5865,26,1456109703,1456109883,3,7,180
65367128@N00,5865,10,1456118595,1456119015,5,7,420
65367128@N00,5865,14,1456127545,1456127665,1,7,120
65451028@N00,5866,14,1239369214,1239369334,1,1,120
65451028@N00,5867,9,1282708036,1282708276,4,3,240
65451028@N00,5867,23,1282711837,1282711927,2,3,90
65451028@N00,5867,9,1282713695,1282713935,16,3,240
65461349@N08,5868,16,1393573591,1393574311,1,1,720
65547015@N00,5869,27,1388882114,1388883314,32,24,1200
65547015@N00,5869,25,1388885230,1388885980,18,24,750
65547015@N00,5869,26,1388886261,1388886366,2,24,105
65547015@N00,5869,21,1388886366,1388886816,16,24,450
65547015@N00,5869,20,1388889162,1388889672,6,24,510
65547015@N00,5869,19,1388889672,1388889923,4,24,251
65547015@N00,5869,26,1388889923,1388890103,6,24,180
65547015@N00,5869,17,1388890336,1388890417,2,24,81
65547015@N00,5869,16,1388890417,1388890701,2,24,284
65547015@N00,5869,9,1388890701,1388890941,3,24,240
65547015@N00,5869,11,1388892704,1388892884,8,24,180
65547015@N00,5869,8,1388896176,1388896296,4,24,120
65547015@N00,5869,9,1388896580,1388896709,2,24,129
65547015@N00,5869,14,1388896709,1388896829,4,24,120
65547015@N00,5869,15,1388896964,1388897144,2,24,180
65547015@N00,5869,17,1388897707,1388898670,7,24,963
65547015@N00,5869,16,1388898670,1388899079,7,24,409
65547015@N00,5869,14,1388899079,1388899199,6,24,120
65547015@N00,5869,10,1388900071,1388900491,14,24,420
65547015@N00,5869,14,1388904969,1388905089,4,24,120
65547015@N00,5869,12,1388907076,1388907916,5,24,840
65547015@N00,5869,14,1388912094,1388912214,2,24,120
65547015@N00,5869,6,1388916432,1388916687,3,24,255
65547015@N00,5869,27,1388921319,1388922519,4,24,1200
65660258@N03,5870,16,1367369305,1367370025,1,1,720
65701179@N00,5871,16,1313147210,1313147930,1,1,720
65746045@N00,5872,18,1218161156,1218162956,2,2,1800
65746045@N00,5872,19,1218170257,1218170677,1,2,420
65746045@N00,5873,27,1218410807,1218412007,3,3,1200
65746045@N00,5873,22,1218432775,1218433375,3,3,600
65746045@N00,5873,18,1218439286,1218441086,1,3,1800
65746519@N00,5874,16,1227876266,1227876986,1,1,720
65784570@N00,5875,13,1382601093,1382601693,1,1,600
65785294@N07,5876,27,1359706309,1359707509,1,1,1200
65825924@N03,5877,16,1311333195,1311333224,2,2,29
65825924@N03,5877,14,1311333224,1311333344,1,2,120
65825924@N03,5878,26,1343969219,1343969399,2,2,180
65825924@N03,5878,16,1343997714,1343998434,1,2,720
65825924@N03,5879,22,1363227511,1363228111,1,1,600
65825924@N03,5880,16,1363259607,1363260327,1,1,720
65825924@N03,5881,22,1395296301,1395296901,3,3,600
65825924@N03,5881,11,1395308266,1395308446,2,3,180
65825924@N03,5881,9,1395308911,1395309151,1,3,240
65825924@N03,5882,27,1395455839,1395457039,1,1,1200
65825924@N03,5883,16,1395565691,1395566411,2,4,720
65825924@N03,5883,17,1395571638,1395573018,2,4,1380
65825924@N03,5883,4,1395573747,1395574609,2,4,862
65825924@N03,5883,27,1395574609,1395575809,1,4,1200
65825924@N03,5884,16,1418887626,1418888346,2,3,720
65825924@N03,5884,27,1418895731,1418896931,3,3,1200
65825924@N03,5884,16,1418902266,1418902986,1,3,720
65825924@N03,5885,16,1419070073,1419070793,2,5,720
65825924@N03,5885,18,1419077943,1419079005,2,5,1062
65825924@N03,5885,20,1419079005,1419080085,2,5,1080
65825924@N03,5885,16,1419080592,1419081312,4,5,720
65825924@N03,5885,27,1419084528,1419085728,1,5,1200
65825924@N03,5886,14,1440673745,1440673865,2,2,120
65825924@N03,5886,27,1440674077,1440675277,1,2,1200
65825924@N03,5887,16,1458098561,1458099281,4,3,720
65825924@N03,5887,10,1458124448,1458124868,3,3,420
65825924@N03,5887,16,1458128562,1458129282,2,3,720
65976254@N05,5888,10,1464057307,1464057727,1,1,420
65987396@N00,5889,2,1308043699,1308043789,2,2,90
65987396@N00,5889,27,1308044552,1308045752,1,2,1200
65988422@N07,5890,27,1373368075,1373369275,1,1,1200
65990642@N06,5891,27,1383603700,1383604900,2,4,1200
65990642@N06,5891,16,1383605547,1383606267,2,4,720
65990642@N06,5891,24,1383617020,1383617500,2,4,480
65990642@N06,5891,8,1383625631,1383625751,1,4,120
66139507@N05,5892,27,1316326167,1316327367,7,12,1200
66139507@N05,5892,4,1316328797,1316329152,7,12,355
66139507@N05,5892,3,1316329152,1316329422,4,12,270
66139507@N05,5892,5,1316332134,1316332854,2,12,720
66139507@N05,5892,3,1316334090,1316334295,2,12,205
66139507@N05,5892,1,1316334295,1316334445,2,12,150
66139507@N05,5892,6,1316334445,1316334700,3,12,255
66139507@N05,5892,9,1316334820,1316335060,3,12,240
66139507@N05,5892,15,1316335091,1316335271,4,12,180
66139507@N05,5892,13,1316335968,1316336568,11,12,600
66139507@N05,5892,22,1316341110,1316341710,3,12,600
66139507@N05,5892,16,1316348388,1316349108,3,12,720
66147934@N04,5893,24,1386384589,1386385069,1,1,480
66147934@N04,5894,27,1417170362,1417171562,1,1,1200
66186191@N00,5895,6,1235531270,1235531525,1,1,255
66222834@N05,5896,7,1370223521,1370223611,1,1,90
66222834@N05,5897,14,1370258694,1370258814,1,1,120
66231302@N00,5898,14,1280224686,1280224806,5,1,120
66231302@N00,5899,14,1280276327,1280276447,2,5,120
66231302@N00,5899,16,1280277199,1280277919,10,5,720
66231302@N00,5899,14,1280279672,1280279792,3,5,120
66231302@N00,5899,7,1280282521,1280282611,2,5,90
66231302@N00,5899,8,1280282613,1280282733,5,5,120
66231302@N00,5900,27,1280401136,1280402336,6,1,1200
66231302@N00,5901,7,1280487222,1280487312,4,1,90
66231596@N04,5902,4,1445825314,1445826214,2,2,900
66231596@N04,5902,2,1445832231,1445832321,1,2,90
66231596@N04,5903,3,1446089830,1446090100,1,1,270
66293290@N06,5904,14,1417676079,1417676199,1,1,120
66372986@N00,5905,27,1280881993,1280883193,7,14,1200
66372986@N00,5905,24,1280883684,1280883922,4,14,238
66372986@N00,5905,21,1280883922,1280884372,2,14,450
66372986@N00,5905,6,1280890861,1280891116,3,14,255
66372986@N00,5905,2,1280891811,1280891893,7,14,82
66372986@N00,5905,5,1280891893,1280892613,5,14,720
66372986@N00,5905,14,1280896025,1280896145,2,14,120
66372986@N00,5905,11,1280901555,1280901735,2,14,180
66372986@N00,5905,18,1280903969,1280905769,2,14,1800
66372986@N00,5905,15,1280906586,1280906766,5,14,180
66372986@N00,5905,3,1280909425,1280909695,3,14,270
66372986@N00,5905,9,1280910831,1280911071,2,14,240
66372986@N00,5905,17,1280914298,1280915678,47,14,1380
66372986@N00,5905,13,1280921955,1280922555,1,14,600
66372986@N00,5906,21,1343705648,1343706098,3,6,450
66372986@N00,5906,19,1343709208,1343709628,2,6,420
66372986@N00,5906,8,1343709795,1343709915,4,6,120
66372986@N00,5906,27,1343713161,1343714361,8,6,1200
66372986@N00,5906,13,1343728200,1343728800,2,6,600
66372986@N00,5906,21,1343732459,1343732909,1,6,450
66372986@N00,5907,17,1373949129,1373950509,2,3,1380
66372986@N00,5907,1,1373965855,1373966011,6,3,156
66372986@N00,5907,4,1373966011,1373966911,6,3,900
66406888@N08,5908,13,1345865866,1345866466,1,1,600
66408130@N07,5909,27,1304948337,1304949537,1,1,1200
66408130@N07,5910,10,1418431660,1418432080,2,2,420
66408130@N07,5910,27,1418443099,1418444299,1,2,1200
66408130@N07,5911,10,1418680548,1418680968,2,4,420
66408130@N07,5911,14,1418684785,1418684905,2,4,120
66408130@N07,5911,15,1418691558,1418691738,2,4,180
66408130@N07,5911,19,1418711425,1418711845,1,4,420
66408130@N07,5912,3,1419298850,1419299120,2,3,270
66408130@N07,5912,9,1419307468,1419307708,2,3,240
66408130@N07,5912,15,1419312667,1419312847,1,3,180
66408130@N07,5913,19,1419550222,1419550642,1,1,420
66543355@N00,5914,27,1215475927,1215477127,1,1,1200
66685507@N03,5915,16,1309259672,1309260392,1,1,720
66691654@N00,5916,27,1327465512,1327466712,88,1,1200
66718423@N03,5917,27,1230339471,1230340671,3,10,1200
66718423@N03,5917,6,1230342121,1230342376,6,10,255
66718423@N03,5917,27,1230342736,1230343936,4,10,1200
66718423@N03,5917,20,1230346156,1230346976,4,10,820
66718423@N03,5917,21,1230346976,1230347426,3,10,450
66718423@N03,5917,6,1230349125,1230349380,2,10,255
66718423@N03,5917,18,1230357371,1230359171,4,10,1800
66718423@N03,5917,14,1230377178,1230377298,4,10,120
66718423@N03,5917,5,1230378381,1230379101,2,10,720
66718423@N03,5917,14,1230381832,1230381952,10,10,120
66718423@N03,5918,27,1287388999,1287389877,6,9,878
66718423@N03,5918,20,1287389877,1287390957,2,9,1080
66718423@N03,5918,17,1287396110,1287397490,3,9,1380
66718423@N03,5918,19,1287401571,1287401820,5,9,249
66718423@N03,5918,18,1287401820,1287403216,6,9,1396
66718423@N03,5918,23,1287403216,1287403306,6,9,90
66718423@N03,5918,26,1287403485,1287403665,7,9,180
66718423@N03,5918,14,1287405119,1287405239,3,9,120
66718423@N03,5918,27,1287405617,1287406817,1,9,1200
66718423@N03,5919,2,1287627664,1287627754,4,6,90
66718423@N03,5919,6,1287628820,1287629075,7,6,255
66718423@N03,5919,21,1287632503,1287632953,2,6,450
66718423@N03,5919,23,1287633039,1287633129,5,6,90
66718423@N03,5919,14,1287637321,1287637441,2,6,120
66718423@N03,5919,27,1287640841,1287642041,5,6,1200
66718423@N03,5920,27,1288011313,1288012513,3,4,1200
66718423@N03,5920,21,1288017784,1288018234,3,4,450
66718423@N03,5920,5,1288019795,1288020515,2,4,720
66718423@N03,5920,27,1288027290,1288028490,2,4,1200
66718423@N03,5921,6,1288231705,1288231960,10,17,255
66718423@N03,5921,20,1288236398,1288236907,5,17,509
66718423@N03,5921,19,1288236907,1288237327,17,17,420
66718423@N03,5921,18,1288237795,1288238386,12,17,591
66718423@N03,5921,19,1288238386,1288238736,5,17,350
66718423@N03,5921,20,1288238736,1288239816,4,17,1080
66718423@N03,5921,23,1288240482,1288240572,3,17,90
66718423@N03,5921,26,1288241755,1288241935,7,17,180
66718423@N03,5921,6,1288244018,1288244273,2,17,255
66718423@N03,5921,14,1288248302,1288248422,7,17,120
66718423@N03,5921,13,1288250263,1288250863,2,17,600
66718423@N03,5921,20,1288252301,1288253381,6,17,1080
66718423@N03,5921,19,1288253869,1288254202,3,17,333
66718423@N03,5921,11,1288254202,1288254382,5,17,180
66718423@N03,5921,6,1288256944,1288257199,3,17,255
66718423@N03,5921,17,1288259342,1288259782,6,17,440
66718423@N03,5921,27,1288259782,1288260982,7,17,1200
66736603@N00,5922,19,1458884913,1458885333,1,1,420
66755680@N06,5923,27,1319890239,1319891439,1,1,1200
66755680@N06,5924,27,1319967670,1319968870,11,2,1200
66755680@N06,5924,14,1319972865,1319972985,1,2,120
66874291@N07,5925,16,1298586011,1298586731,1,1,720
66884161@N05,5926,13,1330491379,1330491979,1,1,600
66884161@N05,5927,27,1337340200,1337341400,1,1,1200
66943671@N05,5928,9,1279595184,1279595424,2,6,240
66943671@N05,5928,27,1279609898,1279611098,2,6,1200
66943671@N05,5928,24,1279617790,1279618270,2,6,480
66943671@N05,5928,18,1279632514,1279632895,2,6,381
66943671@N05,5928,20,1279632895,1279632907,2,6,12
66943671@N05,5928,14,1279632907,1279633027,1,6,120
66950820@N08,5929,4,1256629604,1256630504,1,1,900
66985846@N08,5930,9,1470898857,1470899097,1,1,240
66985846@N08,5931,27,1471391138,1471392338,1,1,1200
67037430@N06,5932,27,1385958542,1385959742,48,1,1200
67038581@N00,5933,9,1315714203,1315714443,2,2,240
67038581@N00,5933,27,1315715839,1315717039,2,2,1200
67038581@N00,5934,25,1315973813,1315974563,2,2,750
67038581@N00,5934,16,1315983809,1315984529,4,2,720
67065233@N02,5935,27,1339451610,1339451885,2,2,275
67065233@N02,5935,16,1339451885,1339452605,2,2,720
67093054@N00,5936,27,1377407402,1377407985,3,8,583
67093054@N00,5936,16,1377407985,1377407992,2,8,7
67093054@N00,5936,14,1377407992,1377408112,3,8,120
67093054@N00,5936,10,1377408188,1377408608,30,8,420
67093054@N00,5936,14,1377410665,1377410785,2,8,120
67093054@N00,5936,15,1377411071,1377411251,2,8,180
67093054@N00,5936,26,1377411414,1377411594,2,8,180
67093054@N00,5936,27,1377415957,1377417157,1,8,1200
67123974@N05,5937,19,1361315157,1361315577,1,1,420
67157140@N00,5938,8,1359522232,1359522352,1,1,120
67237167@N03,5939,27,1387941391,1387942591,2,6,1200
67237167@N03,5939,19,1387947932,1387948352,4,6,420
67237167@N03,5939,4,1387963728,1387964628,3,6,900
67237167@N03,5939,26,1387968235,1387968284,3,6,49
67237167@N03,5939,25,1387968284,1387969034,2,6,750
67237167@N03,5939,27,1387971409,1387972609,3,6,1200
67246822@N00,5940,27,1323639892,1323641092,3,8,1200
67246822@N00,5940,17,1323642128,1323643508,2,8,1380
67246822@N00,5940,13,1323648774,1323649374,3,8,600
67246822@N00,5940,12,1323656819,1323657659,2,8,840
67246822@N00,5940,4,1323663057,1323663957,3,8,900
67246822@N00,5940,2,1323670929,1323671019,2,8,90
67246822@N00,5940,13,1323677221,1323677821,2,8,600
67246822@N00,5940,16,1323678755,1323679475,1,8,720
67246822@N00,5941,17,1323928960,1323930340,1,1,1380
67298936@N05,5942,27,1333933433,1333934633,2,2,1200
67298936@N05,5942,9,1333940036,1333940276,1,2,240
67298936@N05,5943,27,1346750201,1346751401,1,1,1200
67298936@N05,5944,2,1429675386,1429675476,1,1,90
67299437@N06,5945,16,1433406542,1433407262,2,4,720
67299437@N06,5945,14,1433407555,1433407675,21,4,120
67299437@N06,5945,6,1433414209,1433414464,2,4,255
67299437@N06,5945,16,1433415577,1433416297,1,4,720
67299437@N06,5946,14,1433469313,1433469433,6,1,120
67302249@N08,5947,10,1309598752,1309599172,1,1,420
67336497@N05,5948,27,1413421227,1413422427,1,1,1200
67397176@N02,5949,27,1247114531,1247115731,2,2,1200
67397176@N02,5949,11,1247119057,1247119237,1,2,180
67407588@N00,5950,5,1203207661,1203207688,2,2,27
67407588@N00,5950,16,1203207688,1203208408,1,2,720
67407588@N00,5951,18,1203293009,1203293012,2,2,3
67407588@N00,5951,5,1203293012,1203293732,1,2,720
67485106@N05,5952,27,1379979870,1379981070,10,1,1200
67485106@N05,5953,27,1380095803,1380097003,1,1,1200
67485106@N05,5954,27,1380151179,1380152379,1,1,1200
67522962@N07,5955,14,1394929413,1394929533,4,1,120
67527549@N00,5956,27,1293946748,1293947948,3,1,1200
67527549@N00,5957,14,1294005091,1294005134,2,4,43
67527549@N00,5957,16,1294005134,1294005854,54,4,720
67527549@N00,5957,14,1294010889,1294011009,6,4,120
67527549@N00,5957,23,1294019273,1294019363,2,4,90
67527549@N00,5958,17,1294368859,1294370239,8,2,1380
67527549@N00,5958,11,1294377353,1294377533,5,2,180
67559929@N00,5959,19,1440922418,1440922838,1,1,420
67621043@N00,5960,16,1323885783,1323886503,1,1,720
67621043@N00,5961,11,1332030331,1332030511,2,1,180
67621043@N00,5962,8,1337637320,1337637440,4,1,120
67621043@N00,5963,14,1351812014,1351812134,1,1,120
67622575@N00,5964,9,1359329414,1359329654,1,1,240
67645990@N00,5965,9,1398603683,1398603923,3,1,240
67661617@N04,5966,27,1389603784,1389604984,1,1,1200
67678180@N04,5967,21,1242093028,1242093478,1,1,450
67678180@N04,5968,9,1257672551,1257672791,1,1,240
67700845@N07,5969,27,1349830568,1349831768,3,1,1200
67737010@N08,5970,22,1470901907,1470902507,1,1,600
67774977@N00,5971,1,1266056757,1266057357,2,9,600
67774977@N00,5971,9,1266059508,1266059748,3,9,240
67774977@N00,5971,16,1266060997,1266061717,3,9,720
67774977@N00,5971,12,1266063120,1266063960,7,9,840
67774977@N00,5971,9,1266067487,1266067605,2,9,118
67774977@N00,5971,4,1266067605,1266068505,2,9,900
67774977@N00,5971,17,1266070794,1266072174,2,9,1380
67774977@N00,5971,22,1266073285,1266073885,3,9,600
67774977@N00,5971,21,1266076139,1266076589,2,9,450
67839110@N02,5972,16,1436268606,1436269326,2,1,720
67875732@N05,5973,19,1389295565,1389295985,2,2,420
67875732@N05,5973,21,1389302258,1389302708,1,2,450
67949678@N00,5974,27,1419808073,1419809273,2,14,1200
67949678@N00,5974,3,1419810034,1419810304,2,14,270
67949678@N00,5974,2,1419811355,1419811445,2,14,90
67949678@N00,5974,11,1419814963,1419815143,3,14,180
67949678@N00,5974,8,1419815435,1419815454,2,14,19
67949678@N00,5974,11,1419815454,1419815634,2,14,180
67949678@N00,5974,17,1419820147,1419821527,3,14,1380
67949678@N00,5974,22,1419821877,1419822477,2,14,600
67949678@N00,5974,14,1419828354,1419828474,2,14,120
67949678@N00,5974,9,1419828703,1419828943,2,14,240
67949678@N00,5974,16,1419831464,1419832184,2,14,720
67949678@N00,5974,14,1419834756,1419834876,3,14,120
67949678@N00,5974,25,1419846054,1419846804,4,14,750
67949678@N00,5974,27,1419848975,1419850175,1,14,1200
68010648@N07,5975,27,1343287289,1343288489,2,3,1200
68010648@N07,5975,9,1343291125,1343291365,2,3,240
68010648@N07,5975,4,1343298858,1343299758,1,3,900
68010648@N07,5976,16,1343700163,1343700883,1,1,720
68026024@N00,5977,27,1389407758,1389408958,2,7,1200
68026024@N00,5977,25,1389409259,1389410009,2,7,750
68026024@N00,5977,15,1389415526,1389415539,2,7,13
68026024@N00,5977,14,1389415539,1389415659,3,7,120
68026024@N00,5977,7,1389420484,1389420574,4,7,90
68026024@N00,5977,8,1389424187,1389424307,3,7,120
68026024@N00,5977,27,1389429329,1389430529,1,7,1200
68194729@N00,5978,27,1422165639,1422166839,1,1,1200
68235353@N00,5979,13,1328728458,1328729045,2,2,587
68235353@N00,5979,19,1328729045,1328729465,1,2,420
68235353@N00,5980,14,1328809498,1328809618,1,1,120
68255606@N00,5981,18,1345635652,1345637452,1,1,1800
68559301@N00,5982,20,1335948225,1335949305,2,2,1080
68559301@N00,5982,16,1335964452,1335965172,1,2,720
68559301@N00,5983,27,1374496565,1374496787,2,3,222
68559301@N00,5983,1,1374496787,1374497387,2,3,600
68559301@N00,5983,27,1374500638,1374501838,2,3,1200
68574102@N00,5984,17,1376833440,1376834820,1,1,1380
68577094@N06,5985,10,1352288281,1352288701,2,2,420
68577094@N06,5985,24,1352289529,1352290009,1,2,480
68577094@N06,5986,17,1355229105,1355230485,1,1,1380
68655192@N08,5987,18,1468730515,1468732315,1,1,1800
68655192@N08,5988,10,1470376371,1470376791,1,1,420
68731864@N04,5989,13,1394856130,1394856205,2,3,75
68731864@N04,5989,17,1394856205,1394857585,2,3,1380
68731864@N04,5989,16,1394864409,1394865129,1,3,720
68743655@N00,5990,21,1240101913,1240102363,1,1,450
68743655@N00,5991,5,1240132366,1240133086,2,1,720
68821991@N03,5992,15,1438562730,1438562910,1,1,180
68821991@N03,5993,9,1438593757,1438593997,1,1,240
68846374@N00,5994,15,1235796791,1235796971,1,1,180
68903520@N04,5995,27,1329179497,1329180697,7,6,1200
68903520@N04,5995,13,1329186311,1329186911,9,6,600
68903520@N04,5995,15,1329189141,1329189321,10,6,180
68903520@N04,5995,20,1329193300,1329194380,35,6,1080
68903520@N04,5995,15,1329199741,1329199921,6,6,180
68903520@N04,5995,16,1329203312,1329204032,3,6,720
68997488@N00,5996,1,1363875460,1363876060,1,1,600
68997488@N00,5997,19,1389787268,1389787688,1,1,420
68997488@N00,5998,27,1390102506,1390103706,1,1,1200
68998347@N00,5999,27,1324600246,1324601446,2,3,1200
68998347@N00,5999,14,1324623159,1324623279,3,3,120
68998347@N00,5999,27,1324629681,1324630881,4,3,1200
68998347@N00,6000,24,1365120952,1365121432,2,2,480
68998347@N00,6000,14,1365128636,1365128756,1,2,120
68998347@N00,6001,7,1365298838,1365298928,2,2,90
68998347@N00,6001,16,1365312483,1365313203,1,2,720
68998347@N00,6002,16,1396833696,1396834416,6,6,720
68998347@N00,6002,14,1396843747,1396843867,2,6,120
68998347@N00,6002,10,1396844431,1396844851,2,6,420
68998347@N00,6002,14,1396846137,1396846257,2,6,120
68998347@N00,6002,15,1396846470,1396846650,2,6,180
68998347@N00,6002,20,1396847292,1396848372,1,6,1080
68998347@N00,6003,15,1397009921,1397010101,3,6,180
68998347@N00,6003,10,1397015316,1397015736,2,6,420
68998347@N00,6003,8,1397017169,1397017289,6,6,120
68998347@N00,6003,7,1397019759,1397019849,2,6,90
68998347@N00,6003,2,1397029424,1397029514,4,6,90
68998347@N00,6003,4,1397032404,1397033304,2,6,900
68998347@N00,6004,27,1414278108,1414279308,5,1,1200
68998347@N00,6005,27,1414487219,1414488419,3,2,1200
68998347@N00,6005,17,1414488431,1414489811,7,2,1380
69031754@N06,6006,4,1393113633,1393114533,1,1,900
69056984@N07,6007,9,1389409563,1389409803,1,1,240
69056984@N07,6008,19,1408237874,1408238294,2,4,420
69056984@N07,6008,18,1408239119,1408240919,2,4,1800
69056984@N07,6008,6,1408248220,1408248441,2,4,221
69056984@N07,6008,1,1408248441,1408249041,1,4,600
69066018@N00,6009,22,1421403822,1421404422,3,2,600
69066018@N00,6009,26,1421404574,1421404754,1,2,180
69108709@N07,6010,15,1319215030,1319215210,1,1,180
69108709@N07,6011,1,1321109615,1321110215,1,1,600
69108709@N07,6012,27,1323326754,1323327954,2,1,1200
69108709@N07,6013,4,1330551707,1330552607,2,8,900
69108709@N07,6013,17,1330554930,1330556310,3,8,1380
69108709@N07,6013,14,1330575198,1330575211,2,8,13
69108709@N07,6013,9,1330575211,1330575211,2,8,0
69108709@N07,6013,14,1330575211,1330575212,2,8,1
69108709@N07,6013,17,1330575212,1330575212,3,8,0
69108709@N07,6013,22,1330575212,1330575213,2,8,1
69108709@N07,6013,23,1330575213,1330575303,1,8,90
69108709@N07,6014,1,1333505365,1333505365,2,2,0
69108709@N07,6014,8,1333505365,1333505485,1,2,120
69121654@N00,6015,14,1264761193,1264761203,2,2,10
69121654@N00,6015,9,1264761203,1264761443,1,2,240
69161765@N08,6016,27,1352077609,1352078575,5,14,966
69161765@N08,6016,17,1352078575,1352078639,3,14,64
69161765@N08,6016,26,1352078639,1352078739,2,14,100
69161765@N08,6016,22,1352078739,1352078798,2,14,59
69161765@N08,6016,20,1352078798,1352079878,4,14,1080
69161765@N08,6016,23,1352086107,1352086133,4,14,26
69161765@N08,6016,24,1352086133,1352086613,2,14,480
69161765@N08,6016,18,1352090886,1352091431,13,14,545
69161765@N08,6016,13,1352091431,1352091451,3,14,20
69161765@N08,6016,18,1352091451,1352093251,4,14,1800
69161765@N08,6016,1,1352094541,1352095141,4,14,600
69161765@N08,6016,2,1352096056,1352096080,2,14,24
69161765@N08,6016,6,1352096080,1352096335,5,14,255
69161765@N08,6016,10,1352097704,1352098124,47,14,420
69219361@N05,6017,2,1371364365,1371364371,2,2,6
69219361@N05,6017,3,1371364371,1371364641,1,2,270
69219361@N05,6018,21,1433032900,1433033350,1,1,450
69219361@N05,6019,22,1433225488,1433226088,1,1,600
69256737@N00,6020,18,1311305601,1311307401,1,1,1800
69271250@N00,6021,27,1290756175,1290757375,3,1,1200
69271250@N00,6022,26,1290940815,1290940995,1,1,180
69271250@N00,6023,15,1448262142,1448262322,5,2,180
69271250@N00,6023,3,1448262414,1448262684,1,2,270
69271250@N00,6024,27,1448844197,1448845397,2,2,1200
69271250@N00,6024,1,1448848632,1448849232,6,2,600
69301930@N03,6025,18,1315612326,1315614126,2,2,1800
69301930@N03,6025,17,1315624286,1315625666,1,2,1380
69343619@N08,6026,14,1371099170,1371099290,2,2,120
69343619@N08,6026,7,1371121092,1371121182,1,2,90
69343619@N08,6027,7,1371349186,1371349276,1,1,90
69343619@N08,6028,2,1371383229,1371383319,2,3,90
69343619@N08,6028,10,1371384239,1371384659,4,3,420
69343619@N08,6028,14,1371385271,1371385391,1,3,120
69377536@N00,6029,1,1339047883,1339048483,1,1,600
69416229@N00,6030,27,1248040116,1248041316,2,2,1200
69416229@N00,6030,17,1248045310,1248046690,1,2,1380
69487366@N02,6031,27,1375001545,1375002745,1,1,1200
69548110@N08,6032,27,1320884275,1320885475,2,2,1200
69548110@N08,6032,14,1320885791,1320885911,2,2,120
69573456@N00,6033,23,1206729091,1206729181,2,4,90
69573456@N00,6033,9,1206743577,1206743817,4,4,240
69573456@N00,6033,4,1206744491,1206745040,2,4,549
69573456@N00,6033,5,1206745040,1206745760,1,4,720
69573456@N00,6034,6,1206876523,1206876778,4,3,255
69573456@N00,6034,20,1206882780,1206883860,4,3,1080
69573456@N00,6034,27,1206889592,1206890792,5,3,1200
69574134@N00,6035,19,1214834400,1214834820,1,1,420
69574134@N00,6036,27,1346122148,1346123348,3,19,1200
69574134@N00,6036,18,1346133625,1346135425,3,19,1800
69574134@N00,6036,16,1346138322,1346139042,2,19,720
69574134@N00,6036,21,1346139285,1346139735,5,19,450
69574134@N00,6036,24,1346141863,1346141992,3,19,129
69574134@N00,6036,21,1346141992,1346142111,2,19,119
69574134@N00,6036,24,1346142111,1346142591,3,19,480
69574134@N00,6036,21,1346142929,1346143379,3,19,450
69574134@N00,6036,17,1346146463,1346147843,2,19,1380
69574134@N00,6036,18,1346148645,1346148856,5,19,211
69574134@N00,6036,19,1346148856,1346149276,5,19,420
69574134@N00,6036,18,1346149281,1346151081,7,19,1800
69574134@N00,6036,17,1346152736,1346152976,2,19,240
69574134@N00,6036,12,1346152976,1346153816,3,19,840
69574134@N00,6036,10,1346158287,1346158707,2,19,420
69574134@N00,6036,12,1346159998,1346160027,2,19,29
69574134@N00,6036,3,1346160027,1346160081,2,19,54
69574134@N00,6036,1,1346160081,1346160681,2,19,600
69574134@N00,6036,4,1346166421,1346167321,22,19,900
69591415@N02,6037,4,1330133742,1330134447,2,5,705
69591415@N02,6037,17,1330134447,1330134669,2,5,222
69591415@N02,6037,13,1330134669,1330135269,3,5,600
69591415@N02,6037,20,1330135916,1330136996,2,5,1080
69591415@N02,6037,17,1330137597,1330138977,1,5,1380
69689125@N02,6038,27,1395633807,1395635007,1,1,1200
69720780@N05,6039,27,1340061111,1340062311,8,1,1200
69765102@N04,6040,14,1432252935,1432253055,1,1,120
69781071@N00,6041,27,1299626441,1299627641,24,1,1200
69811005@N00,6042,14,1433292360,1433292480,3,4,120
69811005@N00,6042,9,1433294454,1433294694,5,4,240
69811005@N00,6042,7,1433302441,1433302531,6,4,90
69811005@N00,6042,14,1433305973,1433306093,1,4,120
69811005@N00,6043,27,1433494825,1433496025,3,6,1200
69811005@N00,6043,10,1433496447,1433496867,4,6,420
69811005@N00,6043,15,1433498004,1433498142,3,6,138
69811005@N00,6043,12,1433498142,1433498982,4,6,840
69811005@N00,6043,14,1433499381,1433499501,5,6,120
69811005@N00,6043,27,1433504371,1433505571,27,6,1200
69811005@N00,6044,14,1433937714,1433937834,1,1,120
69872692@N07,6045,20,1322889347,1322890427,1,1,1080
69872692@N07,6046,21,1380433976,1380434426,1,1,450
69880349@N08,6047,14,1448917142,1448917262,1,1,120
69882141@N06,6048,14,1294889715,1294889835,3,1,120
69882141@N06,6049,16,1322618006,1322618726,1,1,720
69882141@N06,6050,14,1322656512,1322656632,2,1,120
69882141@N06,6051,14,1357801892,1357802012,4,1,120
69882141@N06,6052,14,1375877966,1375878086,38,1,120
69883003@N00,6053,13,1348880266,1348880391,2,2,125
69883003@N00,6053,21,1348880391,1348880841,1,2,450
69883003@N00,6054,10,1431737362,1431737782,3,6,420
69883003@N00,6054,17,1431739073,1431740453,2,6,1380
69883003@N00,6054,22,1431743244,1431743844,2,6,600
69883003@N00,6054,17,1431745980,1431747360,2,6,1380
69883003@N00,6054,2,1431747692,1431747782,2,6,90
69883003@N00,6054,14,1431758723,1431758843,1,6,120
69904569@N00,6055,27,1219268216,1219269416,1,1,1200
70084804@N00,6056,19,1349000359,1349000779,1,1,420
70084804@N00,6057,27,1349564354,1349565554,1,1,1200
70133294@N08,6058,13,1345453118,1345453718,1,1,600
70268120@N00,6059,14,1217449058,1217449178,3,1,120
70268120@N00,6060,14,1218267012,1218267132,12,1,120
70378830@N08,6061,21,1413882943,1413883393,1,1,450
70414449@N06,6062,2,1457919326,1457919416,4,3,90
70414449@N06,6062,4,1457923591,1457924491,2,3,900
70414449@N06,6062,26,1457930866,1457931046,9,3,180
70456885@N00,6063,27,1319365617,1319366817,1,1,1200
70626136@N00,6064,2,1348392271,1348392361,2,2,90
70626136@N00,6064,4,1348393100,1348394000,1,2,900
70824604@N00,6065,16,1217295585,1217296305,2,1,720
70862502@N00,6066,13,1330575588,1330576188,1,1,600
70862502@N00,6067,16,1330878482,1330879202,1,1,720
70862502@N00,6068,13,1331130609,1331131209,1,1,600
70862502@N00,6069,21,1331273936,1331274386,1,1,450
70862502@N00,6070,14,1358163862,1358163982,2,1,120
70862502@N00,6071,14,1358345994,1358346114,2,2,120
70862502@N00,6071,16,1358346157,1358346877,1,2,720
70862502@N00,6072,21,1383951792,1383952242,2,2,450
70862502@N00,6072,27,1383952854,1383954054,1,2,1200
70862502@N00,6073,21,1384071816,1384072266,3,3,450
70862502@N00,6073,13,1384077541,1384078141,2,3,600
70862502@N00,6073,16,1384078949,1384079669,1,3,720
70862502@N00,6074,27,1384289283,1384290483,1,1,1200
70862502@N00,6075,27,1384456704,1384457904,1,1,1200
70862502@N00,6076,16,1384587645,1384588365,3,2,720
70862502@N00,6076,13,1384592396,1384592996,1,2,600
70926999@N00,6077,27,1406263864,1406265064,3,1,1200
70926999@N00,6078,7,1406426060,1406426150,2,4,90
70926999@N00,6078,6,1406426155,1406426410,2,4,255
70926999@N00,6078,17,1406434801,1406436181,3,4,1380
70926999@N00,6078,13,1406437524,1406438124,1,4,600
70926999@N00,6079,15,1406628168,1406628208,2,7,40
70926999@N00,6079,17,1406628208,1406629588,4,7,1380
70926999@N00,6079,9,1406630247,1406630487,2,7,240
70926999@N00,6079,14,1406631213,1406631333,2,7,120
70926999@N00,6079,15,1406631676,1406631856,3,7,180
70926999@N00,6079,12,1406632260,1406632367,2,7,107
70926999@N00,6079,15,1406632367,1406632547,2,7,180
70926999@N00,6080,7,1406758519,1406758609,4,2,90
70926999@N00,6080,1,1406760420,1406761020,1,2,600
70926999@N00,6081,26,1406858704,1406858884,2,5,180
70926999@N00,6081,22,1406859260,1406859860,2,5,600
70926999@N00,6081,1,1406862740,1406863340,4,5,600
70926999@N00,6081,11,1406866031,1406866211,2,5,180
70926999@N00,6081,24,1406867720,1406868200,2,5,480
70928085@N00,6082,9,1214698303,1214698543,1,1,240
70928085@N00,6083,5,1224112238,1224112958,3,12,720
70928085@N00,6083,11,1224119509,1224119689,3,12,180
70928085@N00,6083,16,1224122006,1224122726,3,12,720
70928085@N00,6083,26,1224130738,1224130918,2,12,180
70928085@N00,6083,20,1224132945,1224134025,2,12,1080
70928085@N00,6083,1,1224134975,1224135575,2,12,600
70928085@N00,6083,27,1224136831,1224138031,8,12,1200
70928085@N00,6083,16,1224147909,1224148629,2,12,720
70928085@N00,6083,22,1224148771,1224149371,29,12,600
70928085@N00,6083,15,1224150188,1224150368,3,12,180
70928085@N00,6083,13,1224154537,1224155137,5,12,600
70928085@N00,6083,16,1224156847,1224157567,7,12,720
70928085@N00,6084,2,1461227377,1461227467,2,2,90
70928085@N00,6084,14,1461236404,1461236524,1,2,120
70944869@N00,6085,27,1425722195,1425723395,1,1,1200
70944869@N00,6086,4,1429313013,1429313913,7,2,900
70944869@N00,6086,5,1429343902,1429344622,1,2,720
71061535@N00,6087,27,1339995256,1339996456,2,1,1200
71079304@N04,6088,20,1335547724,1335547953,2,2,229
71079304@N04,6088,19,1335547953,1335548373,1,2,420
71121295@N00,6089,3,1363039102,1363039372,1,1,270
71128153@N00,6090,25,1369899798,1369899799,2,2,1
71128153@N00,6090,12,1369899799,1369900639,1,2,840
71214537@N00,6091,8,1382342203,1382342323,1,1,120
71214537@N00,6092,10,1455244480,1455244900,3,2,420
71214537@N00,6092,9,1455247889,1455248129,1,2,240
71214537@N00,6093,10,1455360858,1455361278,2,1,420
7128421@N05,6094,27,1447133195,1447134395,1,1,1200
7128421@N05,6095,14,1463313509,1463313629,1,1,120
7141509@N02,6096,6,1323324574,1323324829,1,1,255
7151738@N03,6097,18,1353289340,1353291140,1,1,1800
7151738@N03,6098,16,1390623432,1390624152,2,2,720
7151738@N03,6098,21,1390624919,1390625369,1,2,450
7151738@N03,6099,14,1393194512,1393194632,5,2,120
7151738@N03,6099,3,1393205950,1393206220,5,2,270
7151738@N03,6100,19,1396743908,1396744328,2,2,420
7151738@N03,6100,27,1396757355,1396758555,1,2,1200
7151738@N03,6101,27,1412975721,1412976921,1,1,1200
7151738@N03,6102,10,1415576039,1415576459,2,1,420
7151738@N03,6103,14,1421369521,1421369631,2,7,110
7151738@N03,6103,16,1421369631,1421370172,2,7,541
7151738@N03,6103,10,1421370172,1421370592,5,7,420
7151738@N03,6103,12,1421376429,1421377269,3,7,840
7151738@N03,6103,10,1421377754,1421378174,4,7,420
7151738@N03,6103,27,1421383542,1421384742,2,7,1200
7151738@N03,6103,9,1421385161,1421385401,1,7,240
7151738@N03,6104,27,1421444782,1421445982,3,8,1200
7151738@N03,6104,26,1421447793,1421447973,2,8,180
7151738@N03,6104,11,1421451594,1421451774,3,8,180
7151738@N03,6104,7,1421453945,1421454035,2,8,90
7151738@N03,6104,8,1421454639,1421454759,2,8,120
7151738@N03,6104,10,1421456033,1421456453,3,8,420
7151738@N03,6104,15,1421457567,1421457747,2,8,180
7151738@N03,6104,14,1421482313,1421482433,8,8,120
71577463@N02,6105,16,1363928629,1363929349,1,1,720
71665812@N00,6106,15,1365300728,1365300908,2,7,180
71665812@N00,6106,9,1365302524,1365302764,2,7,240
71665812@N00,6106,26,1365307822,1365308002,2,7,180
71665812@N00,6106,5,1365319005,1365319725,2,7,720
71665812@N00,6106,3,1365321891,1365322161,3,7,270
71665812@N00,6106,2,1365327224,1365327314,2,7,90
71665812@N00,6106,26,1365333542,1365333722,10,7,180
71665812@N00,6107,24,1365730247,1365730727,3,4,480
71665812@N00,6107,10,1365733267,1365733687,8,4,420
71665812@N00,6107,3,1365748907,1365749177,6,4,270
71665812@N00,6107,27,1365751461,1365752661,3,4,1200
71680505@N05,6108,16,1266311590,1266312310,1,1,720
7168480@N02,6109,17,1391931612,1391932992,1,1,1380
71722325@N00,6110,27,1426320628,1426321828,1,1,1200
71745361@N06,6111,14,1188129418,1188129538,2,1,120
71752988@N08,6112,19,1384027911,1384028331,1,1,420
71778096@N00,6113,14,1240220829,1240220949,4,3,120
71778096@N00,6113,20,1240231876,1240232956,2,3,1080
71778096@N00,6113,26,1240233090,1240233270,6,3,180
71814567@N02,6114,4,1297914988,1297915888,2,1,900
71922377@N00,6115,9,1350175418,1350175658,1,1,240
71922377@N00,6116,27,1391217572,1391218772,1,1,1200
71922377@N00,6117,9,1412461214,1412461454,2,1,240
71922377@N00,6118,7,1470464023,1470464113,1,1,90
71965292@N00,6119,14,1213189174,1213189294,183,1,120
7197250@N06,6120,27,1368381523,1368382723,1,1,1200
7197250@N06,6121,11,1368632344,1368632524,1,1,180
7197250@N06,6122,11,1368689187,1368689337,2,3,150
7197250@N06,6122,27,1368689337,1368690537,5,3,1200
7197250@N06,6122,14,1368733136,1368733256,1,3,120
7197250@N06,6123,24,1368814280,1368814760,2,2,480
7197250@N06,6123,27,1368823206,1368824406,1,2,1200
7197250@N06,6124,17,1368855795,1368856258,2,2,463
7197250@N06,6124,27,1368856258,1368857458,1,2,1200
7197250@N06,6125,16,1368903480,1368904200,2,3,720
7197250@N06,6125,27,1368911800,1368911929,2,3,129
7197250@N06,6125,14,1368911929,1368912049,1,3,120
7197250@N06,6126,27,1368950248,1368950578,2,2,330
7197250@N06,6126,14,1368950578,1368950698,1,2,120
7197250@N06,6127,27,1368985018,1368986218,1,1,1200
7197250@N06,6128,27,1369036770,1369037970,1,1,1200
7197250@N06,6129,22,1399038727,1399039327,1,1,600
7200488@N08,6130,8,1191420000,1191420120,1,1,120
72043907@N00,6131,6,1223892130,1223892385,3,1,255
72048386@N00,6132,27,1200875894,1200877092,2,6,1198
72048386@N00,6132,3,1200877092,1200877184,2,6,92
72048386@N00,6132,4,1200877184,1200878084,2,6,900
72048386@N00,6132,18,1200884177,1200885977,2,6,1800
72048386@N00,6132,20,1200892631,1200893711,2,6,1080
72048386@N00,6132,14,1200900574,1200900694,1,6,120
72048386@N00,6133,21,1204719358,1204719808,2,1,450
72048386@N00,6134,25,1204804669,1204805419,1,1,750
72069620@N00,6135,27,1273991291,1273992491,3,3,1200
72069620@N00,6135,20,1273995863,1273996943,2,3,1080
72069620@N00,6135,22,1273997187,1273997787,1,3,600
7206981@N03,6136,26,1244764447,1244764627,2,5,180
7206981@N03,6136,18,1244765161,1244766390,3,5,1229
7206981@N03,6136,14,1244766390,1244766510,4,5,120
7206981@N03,6136,16,1244770175,1244770895,2,5,720
7206981@N03,6136,26,1244771489,1244771669,1,5,180
7210398@N05,6137,2,1314372846,1314372936,1,1,90
72126458@N00,6138,14,1310956832,1310956952,3,8,120
72126458@N00,6138,25,1310969240,1310969990,18,8,750
72126458@N00,6138,24,1310971242,1310971722,10,8,480
72126458@N00,6138,14,1310982265,1310982385,4,8,120
72126458@N00,6138,16,1310982735,1310983455,2,8,720
72126458@N00,6138,14,1310985048,1310985168,16,8,120
72126458@N00,6138,17,1310987741,1310989121,42,8,1380
72126458@N00,6138,14,1310990404,1310990524,35,8,120
72126458@N00,6139,2,1311164903,1311164993,11,4,90
72126458@N00,6139,3,1311165282,1311165552,7,4,270
72126458@N00,6139,16,1311167632,1311168352,2,4,720
72126458@N00,6139,19,1311169505,1311169925,5,4,420
72173566@N04,6140,6,1340687947,1340688136,2,3,189
72173566@N04,6140,2,1340688136,1340688226,2,3,90
72173566@N04,6140,6,1340706726,1340706981,2,3,255
72173566@N04,6141,17,1341386397,1341387777,1,1,1380
72256065@N07,6142,27,1366238597,1366239797,2,3,1200
72256065@N07,6142,14,1366244974,1366245094,2,3,120
72256065@N07,6142,5,1366247636,1366248356,1,3,720
72256065@N07,6143,21,1366333205,1366333655,2,2,450
72256065@N07,6143,16,1366356972,1366357692,2,2,720
72312878@N00,6144,27,1334457215,1334458415,1,1,1200
72324747@N00,6145,16,1286934708,1286935428,2,3,720
72324747@N00,6145,21,1286943838,1286944288,2,3,450
72324747@N00,6145,27,1286950619,1286951819,1,3,1200
72324747@N00,6146,14,1287366569,1287366689,2,3,120
72324747@N00,6146,19,1287371174,1287371594,2,3,420
72324747@N00,6146,22,1287376999,1287377599,1,3,600
72324747@N00,6147,27,1288315296,1288316496,1,1,1200
72324747@N00,6148,5,1288478757,1288479477,1,1,720
72324747@N00,6149,27,1288690659,1288691859,1,1,1200
72408746@N08,6150,27,1384215600,1384216800,1,1,1200
7256184@N02,6151,27,1228786565,1228787475,5,6,910
7256184@N02,6151,16,1228787475,1228788195,11,6,720
7256184@N02,6151,14,1228790173,1228790293,8,6,120
7256184@N02,6151,16,1228796857,1228797577,3,6,720
7256184@N02,6151,21,1228806621,1228807071,2,6,450
7256184@N02,6151,16,1228814058,1228814778,3,6,720
7256184@N02,6152,16,1228890002,1228890722,2,1,720
7256184@N02,6153,11,1229049392,1229049572,13,1,180
7256454@N05,6154,21,1214266971,1214267421,20,1,450
7256454@N05,6155,16,1214607130,1214607850,2,1,720
7256454@N05,6156,27,1214786209,1214786936,7,12,727
7256454@N05,6156,20,1214786936,1214787203,5,12,267
7256454@N05,6156,22,1214787203,1214787803,9,12,600
7256454@N05,6156,23,1214788403,1214788493,9,12,90
7256454@N05,6156,22,1214789028,1214789628,2,12,600
7256454@N05,6156,25,1214791811,1214792561,5,12,750
7256454@N05,6156,22,1214795360,1214795960,3,12,600
7256454@N05,6156,17,1214799344,1214799867,6,12,523
7256454@N05,6156,18,1214799867,1214800595,8,12,728
7256454@N05,6156,19,1214800595,1214800764,14,12,169
7256454@N05,6156,18,1214800764,1214801929,8,12,1165
7256454@N05,6156,17,1214801929,1214803309,33,12,1380
7256454@N05,6157,21,1239719157,1239719607,10,1,450
7256454@N05,6158,16,1244972390,1244973110,8,1,720
7256454@N05,6159,16,1245411711,1245412431,1,1,720
7256454@N05,6160,6,1279707902,1279708157,7,1,255
7256454@N05,6161,14,1288346099,1288346219,2,2,120
7256454@N05,6161,12,1288348340,1288349180,2,2,840
7256454@N05,6162,27,1352504638,1352505838,8,2,1200
7256454@N05,6162,17,1352513564,1352514944,13,2,1380
72589879@N00,6163,4,1291460085,1291460336,2,2,251
72589879@N00,6163,5,1291460336,1291461056,1,2,720
72589879@N00,6164,18,1348901870,1348903670,3,2,1800
72589879@N00,6164,4,1348912650,1348913550,1,2,900
72640719@N07,6165,9,1431755006,1431755246,1,1,240
72655656@N00,6166,16,1409904400,1409905120,1,1,720
72670227@N06,6167,27,1429238186,1429239386,15,3,1200
72670227@N06,6167,9,1429241627,1429241867,41,3,240
72670227@N06,6167,8,1429253384,1429253504,1,3,120
72685908@N00,6168,27,1380427934,1380429134,2,4,1200
72685908@N00,6168,13,1380432641,1380432748,2,4,107
72685908@N00,6168,16,1380432748,1380433468,2,4,720
72685908@N00,6168,3,1380435079,1380435349,1,4,270
72685908@N00,6169,10,1380544778,1380545002,2,2,224
72685908@N00,6169,14,1380545002,1380545122,1,2,120
72776097@N00,6170,9,1205972966,1205973206,1,1,240
72844756@N00,6171,16,1249802486,1249803206,1,1,720
7287512@N02,6172,27,1270338745,1270339843,7,11,1098
7287512@N02,6172,4,1270339843,1270340743,2,11,900
7287512@N02,6172,25,1270344715,1270345465,5,11,750
7287512@N02,6172,24,1270346193,1270346673,2,11,480
7287512@N02,6172,23,1270348238,1270348328,2,11,90
7287512@N02,6172,25,1270348369,1270349119,2,11,750
7287512@N02,6172,7,1270354628,1270354718,2,11,90
7287512@N02,6172,8,1270354762,1270354882,2,11,120
7287512@N02,6172,11,1270358704,1270358884,5,11,180
7287512@N02,6172,12,1270362290,1270363130,2,11,840
7287512@N02,6172,18,1270369706,1270371506,1,11,1800
7293619@N07,6173,27,1329776764,1329777964,3,5,1200
7293619@N07,6173,6,1329785455,1329785710,2,5,255
7293619@N07,6173,14,1329796745,1329796865,2,5,120
7293619@N07,6173,20,1329802842,1329803922,2,5,1080
7293619@N07,6173,16,1329809384,1329810104,1,5,720
72949871@N00,6174,14,1301965145,1301965265,1,1,120
72949871@N00,6175,9,1302002827,1302002840,2,2,13
72949871@N00,6175,21,1302002840,1302003290,1,2,450
72949871@N00,6176,14,1302214764,1302214884,1,1,120
72977144@N00,6177,27,1380878365,1380879565,1,1,1200
73055057@N00,6178,2,1323490228,1323490318,1,1,90
7305851@N07,6179,27,1206938907,1206940069,2,4,1162
7305851@N07,6179,4,1206940069,1206940969,2,4,900
7305851@N07,6179,17,1206945158,1206946538,2,4,1380
7305851@N07,6179,18,1206946563,1206948363,1,4,1800
7305851@N07,6180,19,1207359039,1207359459,1,1,420
7305851@N07,6181,10,1353470409,1353470829,2,4,420
7305851@N07,6181,14,1353477379,1353477499,2,4,120
7305851@N07,6181,10,1353477516,1353477936,2,4,420
7305851@N07,6181,18,1353479930,1353481730,1,4,1800
73059826@N00,6182,10,1403943605,1403944025,1,1,420
73105116@N00,6183,20,1210860006,1210861086,1,1,1080
73105116@N00,6184,9,1210946400,1210946402,3,4,2
73105116@N00,6184,26,1210946402,1210946403,2,4,1
73105116@N00,6184,20,1210946403,1210946404,2,4,1
73105116@N00,6184,3,1210946404,1210946674,1,4,270
73105116@N00,6185,21,1211032800,1211033250,1,1,450
73105116@N00,6186,18,1242707760,1242709560,1,1,1800
73105116@N00,6187,18,1242767893,1242769693,2,2,1800
73105116@N00,6187,9,1242771896,1242772136,2,2,240
73105116@N00,6188,27,1242870832,1242872032,1,1,1200
73105116@N00,6189,17,1273884247,1273885627,1,1,1380
73105116@N00,6190,27,1273952762,1273953962,2,4,1200
73105116@N00,6190,22,1273955329,1273955453,2,4,124
73105116@N00,6190,20,1273955453,1273955734,2,4,281
73105116@N00,6190,22,1273955734,1273956334,1,4,600
73114641@N00,6191,21,1329645524,1329645974,1,1,450
73114641@N00,6192,14,1359263590,1359263710,9,1,120
73114641@N00,6193,27,1452399164,1452400364,11,1,1200
73114641@N00,6194,27,1452574589,1452575789,1,1,1200
73122205@N07,6195,17,1363507880,1363509260,1,1,1380
73122205@N07,6196,4,1363947529,1363948429,1,1,900
73181922@N00,6197,27,1227154792,1227155992,2,1,1200
73260031@N05,6198,4,1388124164,1388125064,1,1,900
73265016@N00,6199,12,1207612747,1207613587,2,9,840
73265016@N00,6199,6,1207615254,1207615509,3,9,255
73265016@N00,6199,2,1207616519,1207616609,2,9,90
73265016@N00,6199,14,1207619573,1207619693,2,9,120
73265016@N00,6199,3,1207621039,1207621309,3,9,270
73265016@N00,6199,24,1207623396,1207623876,2,9,480
73265016@N00,6199,8,1207631752,1207631872,2,9,120
73265016@N00,6199,6,1207633562,1207633817,2,9,255
73265016@N00,6199,16,1207653129,1207653849,1,9,720
7327560@N06,6200,27,1231726645,1231727845,2,2,1200
7327560@N06,6200,7,1231745643,1231745733,1,2,90
7327560@N06,6201,24,1231982330,1231982810,2,2,480
7327560@N06,6201,22,1231986763,1231987363,1,2,600
7327560@N06,6202,22,1232720595,1232721195,1,1,600
73281647@N03,6203,26,1421380280,1421380460,2,5,180
73281647@N03,6203,2,1421389586,1421389676,3,5,90
73281647@N03,6203,9,1421407960,1421408200,2,5,240
73281647@N03,6203,22,1421409639,1421410239,2,5,600
73281647@N03,6203,27,1421412998,1421414198,2,5,1200
73287343@N03,6204,27,1360195700,1360196900,5,4,1200
73287343@N03,6204,7,1360203900,1360203990,2,4,90
73287343@N03,6204,16,1360204709,1360205429,3,4,720
73287343@N03,6204,15,1360205643,1360205823,1,4,180
7334692@N04,6205,16,1329201072,1329201792,1,1,720
73366745@N02,6206,3,1321351800,1321352070,1,1,270
73376948@N00,6207,25,1423275072,1423275558,2,3,486
73376948@N00,6207,23,1423275558,1423275648,2,3,90
73376948@N00,6207,20,1423277442,1423278522,1,3,1080
73389359@N07,6208,27,1427625180,1427626380,1,1,1200
73427821@N00,6209,27,1257724838,1257726038,11,7,1200
73427821@N00,6209,17,1257727039,1257728419,6,7,1380
73427821@N00,6209,7,1257728431,1257728521,9,7,90
73427821@N00,6209,8,1257728931,1257729051,8,7,120
73427821@N00,6209,11,1257730171,1257730351,14,7,180
73427821@N00,6209,14,1257734816,1257734936,5,7,120
73427821@N00,6209,23,1257747237,1257747327,10,7,90
73427821@N00,6210,7,1257907580,1257907670,4,2,90
73427821@N00,6210,18,1257925176,1257926976,1,2,1800
73427821@N00,6211,16,1273618734,1273619454,3,9,720
73427821@N00,6211,7,1273622259,1273622349,2,9,90
73427821@N00,6211,9,1273622629,1273622869,6,9,240
73427821@N00,6211,7,1273622942,1273623032,7,9,90
73427821@N00,6211,9,1273623128,1273623368,3,9,240
73427821@N00,6211,16,1273623853,1273624573,13,9,720
73427821@N00,6211,14,1273626132,1273626252,5,9,120
73427821@N00,6211,17,1273630816,1273632196,25,9,1380
73427821@N00,6211,7,1273639568,1273639658,4,9,90
73427821@N00,6212,4,1317512393,1317513293,7,1,900
73427821@N00,6213,17,1345943238,1345944618,5,2,1380
73427821@N00,6213,20,1345959941,1345961021,3,2,1080
73427821@N00,6214,14,1346036664,1346036784,6,2,120
73427821@N00,6214,4,1346039252,1346040152,3,2,900
73427821@N00,6215,9,1352525653,1352525893,17,5,240
73427821@N00,6215,6,1352528657,1352528912,11,5,255
73427821@N00,6215,14,1352530638,1352530758,16,5,120
73427821@N00,6215,9,1352533403,1352533643,25,5,240
73427821@N00,6215,14,1352540829,1352540949,3,5,120
73427821@N00,6216,9,1352962398,1352962638,14,1,240
73451901@N00,6217,9,1244092220,1244092460,2,3,240
73451901@N00,6217,6,1244092575,1244092830,2,3,255
73451901@N00,6217,15,1244098010,1244098190,1,3,180
73451901@N00,6218,14,1300705353,1300705473,2,2,120
73451901@N00,6218,9,1300705505,1300705745,9,2,240
7349370@N04,6219,27,1241848014,1241849214,3,11,1200
7349370@N04,6219,24,1241852652,1241853132,2,11,480
7349370@N04,6219,21,1241854527,1241854977,2,11,450
7349370@N04,6219,19,1241855730,1241856150,3,11,420
7349370@N04,6219,20,1241856235,1241857116,3,11,881
7349370@N04,6219,13,1241857116,1241857716,4,11,600
7349370@N04,6219,7,1241860839,1241860929,2,11,90
7349370@N04,6219,11,1241861363,1241861543,2,11,180
7349370@N04,6219,4,1241865205,1241865290,2,11,85
7349370@N04,6219,16,1241865290,1241866010,3,11,720
7349370@N04,6219,3,1241867843,1241868113,9,11,270
7349370@N04,6220,27,1242257402,1242258602,8,7,1200
7349370@N04,6220,19,1242265901,1242266321,3,7,420
7349370@N04,6220,18,1242266389,1242268189,7,7,1800
7349370@N04,6220,19,1242269339,1242269759,4,7,420
7349370@N04,6220,22,1242269891,1242270491,3,7,600
7349370@N04,6220,17,1242270849,1242272229,9,7,1380
7349370@N04,6220,27,1242275902,1242277102,2,7,1200
7349370@N04,6221,27,1260565435,1260566635,2,6,1200
7349370@N04,6221,24,1260571456,1260571936,2,6,480
7349370@N04,6221,17,1260580094,1260581474,2,6,1380
7349370@N04,6221,16,1260581998,1260582188,2,6,190
7349370@N04,6221,9,1260582188,1260582428,2,6,240
7349370@N04,6221,4,1260586874,1260587774,2,6,900
7349370@N04,6222,27,1286506616,1286507816,1,1,1200
7349370@N04,6223,27,1289183594,1289184794,14,26,1200
7349370@N04,6223,16,1289185695,1289186415,8,26,720
7349370@N04,6223,14,1289186592,1289186649,2,26,57
7349370@N04,6223,16,1289186649,1289186702,4,26,53
7349370@N04,6223,14,1289186702,1289186822,2,26,120
7349370@N04,6223,16,1289186963,1289187102,2,26,139
7349370@N04,6223,14,1289187102,1289187198,2,26,96
7349370@N04,6223,23,1289187198,1289187253,3,26,55
7349370@N04,6223,14,1289187253,1289187293,3,26,40
7349370@N04,6223,24,1289187293,1289187301,2,26,8
7349370@N04,6223,23,1289187301,1289187319,2,26,18
7349370@N04,6223,24,1289187319,1289187348,3,26,29
7349370@N04,6223,23,1289187348,1289187393,2,26,45
7349370@N04,6223,24,1289187393,1289187414,2,26,21
7349370@N04,6223,21,1289187414,1289187686,6,26,272
7349370@N04,6223,13,1289187686,1289187707,2,26,21
7349370@N04,6223,14,1289187707,1289187797,6,26,90
7349370@N04,6223,22,1289187797,1289187815,2,26,18
7349370@N04,6223,9,1289187815,1289187862,2,26,47
7349370@N04,6223,14,1289187862,1289187885,2,26,23
7349370@N04,6223,17,1289187885,1289188036,4,26,151
7349370@N04,6223,12,1289188036,1289188075,2,26,39
7349370@N04,6223,16,1289188075,1289188095,2,26,20
7349370@N04,6223,14,1289188095,1289188134,2,26,39
7349370@N04,6223,16,1289188134,1289188854,17,26,720
7349370@N04,6223,27,1289193280,1289194480,10,26,1200
7356139@N05,6224,13,1361802530,1361803130,1,1,600
7356405@N05,6225,16,1213348901,1213349621,4,1,720
7356405@N05,6226,16,1213489377,1213490097,2,1,720
7356405@N05,6227,16,1213586990,1213587710,1,1,720
7356405@N05,6228,27,1213916746,1213916760,2,4,14
7356405@N05,6228,16,1213916760,1213916787,2,4,27
7356405@N05,6228,27,1213916787,1213917987,7,4,1200
7356405@N05,6228,16,1213920008,1213920728,1,4,720
7356405@N05,6229,16,1214132640,1214133360,7,1,720
7356405@N05,6230,9,1228538889,1228539129,1,1,240
7357708@N03,6231,27,1320215347,1320216547,1,1,1200
7357708@N03,6232,16,1320411600,1320412320,1,1,720
73626640@N00,6233,27,1200303387,1200304368,3,6,981
73626640@N00,6233,14,1200304368,1200304488,4,6,120
73626640@N00,6233,17,1200307063,1200308443,2,6,1380
73626640@N00,6233,14,1200312885,1200313005,2,6,120
73626640@N00,6233,17,1200316844,1200318224,2,6,1380
73626640@N00,6233,27,1200319755,1200320955,1,6,1200
7366969@N02,6234,27,1335912695,1335913895,8,3,1200
7366969@N02,6234,9,1335915659,1335915899,5,3,240
7366969@N02,6234,2,1335931705,1335931795,1,3,90
7366969@N02,6235,16,1336213996,1336214716,11,1,720
7366969@N02,6236,7,1391557261,1391557351,5,10,90
7366969@N02,6236,6,1391558283,1391558538,4,10,255
7366969@N02,6236,18,1391561130,1391561821,4,10,691
7366969@N02,6236,13,1391561821,1391562421,4,10,600
7366969@N02,6236,16,1391563097,1391563817,21,10,720
7366969@N02,6236,23,1391575549,1391575639,2,10,90
7366969@N02,6236,24,1391575736,1391575747,2,10,11
7366969@N02,6236,23,1391575747,1391575837,3,10,90
7366969@N02,6236,20,1391578267,1391579347,11,10,1080
7366969@N02,6236,27,1391580162,1391581362,2,10,1200
7366969@N02,6237,9,1391832257,1391832497,3,3,240
7366969@N02,6237,15,1391836561,1391836741,24,3,180
7366969@N02,6237,21,1391849271,1391849721,2,3,450
7366969@N02,6238,6,1392184440,1392184550,2,2,110
7366969@N02,6238,7,1392184550,1392184640,1,2,90
7366969@N02,6239,27,1392333606,1392334425,7,9,819
7366969@N02,6239,16,1392334425,1392334575,4,9,150
7366969@N02,6239,1,1392334575,1392335149,2,9,574
7366969@N02,6239,18,1392335149,1392335623,2,9,474
7366969@N02,6239,12,1392335623,1392336463,7,9,840
7366969@N02,6239,9,1392338256,1392338491,3,9,235
7366969@N02,6239,7,1392338491,1392338581,7,9,90
7366969@N02,6239,16,1392344242,1392344592,5,9,350
7366969@N02,6239,27,1392344592,1392345792,9,9,1200
7366969@N02,6240,27,1392376020,1392377220,3,1,1200
7366969@N02,6241,16,1392538385,1392539105,2,4,720
7366969@N02,6241,21,1392539469,1392539919,3,4,450
7366969@N02,6241,4,1392544218,1392544924,2,4,706
7366969@N02,6241,27,1392544924,1392546124,16,4,1200
7367216@N05,6242,20,1218844067,1218845147,3,1,1080
7367216@N05,6243,27,1239068244,1239069444,1,1,1200
7367216@N05,6244,27,1239159349,1239160549,6,1,1200
7367216@N05,6245,27,1341351301,1341352501,5,3,1200
7367216@N05,6245,22,1341357334,1341357934,6,3,600
7367216@N05,6245,18,1341361865,1341363665,15,3,1800
7367216@N05,6246,7,1341399716,1341399806,5,1,90
7367216@N05,6247,1,1341711025,1341711625,5,2,600
7367216@N05,6247,27,1341720935,1341722135,6,2,1200
7367216@N05,6248,17,1348556960,1348558340,2,5,1380
7367216@N05,6248,14,1348560685,1348560805,3,5,120
7367216@N05,6248,10,1348560955,1348561375,2,5,420
7367216@N05,6248,13,1348569616,1348570216,3,5,600
7367216@N05,6248,17,1348577029,1348578409,2,5,1380
7367216@N05,6249,27,1348613026,1348614226,3,6,1200
7367216@N05,6249,13,1348614488,1348614784,4,6,296
7367216@N05,6249,18,1348614784,1348616584,3,6,1800
7367216@N05,6249,11,1348618159,1348618339,2,6,180
7367216@N05,6249,22,1348621431,1348622031,2,6,600
7367216@N05,6249,14,1348624716,1348624836,29,6,120
7367216@N05,6250,13,1351203726,1351203797,2,3,71
7367216@N05,6250,27,1351203797,1351204175,3,3,378
7367216@N05,6250,14,1351204175,1351204295,2,3,120
73783753@N00,6251,17,1260593382,1260594762,5,2,1380
73783753@N00,6251,27,1260594990,1260596190,1,2,1200
73783753@N00,6252,27,1283663464,1283664664,36,1,1200
73783753@N00,6253,27,1292044984,1292046184,1,1,1200
73799444@N00,6254,20,1197829970,1197831050,1,1,1080
73802184@N00,6255,26,1297744544,1297744724,2,3,180
73802184@N00,6255,17,1297746847,1297746852,2,3,5
73802184@N00,6255,26,1297746852,1297747032,2,3,180
73813555@N00,6256,19,1236379058,1236379478,6,4,420
73813555@N00,6256,14,1236379728,1236379848,7,4,120
73813555@N00,6256,24,1236388845,1236389325,4,4,480
73813555@N00,6256,17,1236402806,1236404186,1,4,1380
73825591@N00,6257,23,1357280518,1357280608,1,1,90
7383636@N06,6258,27,1272843984,1272845184,4,4,1200
7383636@N06,6258,20,1272855017,1272856097,2,4,1080
7383636@N06,6258,12,1272862287,1272863127,2,4,840
7383636@N06,6258,5,1272876142,1272876862,1,4,720
7383636@N06,6259,9,1396045192,1396045432,5,2,240
7383636@N06,6259,27,1396050577,1396051777,4,2,1200
7383636@N06,6260,27,1416793923,1416795123,4,5,1200
7383636@N06,6260,7,1416797896,1416797986,2,5,90
7383636@N06,6260,15,1416799845,1416800025,2,5,180
7383636@N06,6260,13,1416800079,1416800679,3,5,600
7383636@N06,6260,17,1416802295,1416803675,10,5,1380
7383636@N06,6261,27,1420859561,1420860536,2,2,975
7383636@N06,6261,4,1420860536,1420861436,2,2,900
7383636@N06,6262,16,1420922031,1420922751,2,3,720
7383636@N06,6262,27,1420929084,1420930284,2,3,1200
7383636@N06,6262,2,1420935115,1420935205,1,3,90
7383636@N06,6263,22,1443067707,1443068307,2,1,600
7383636@N06,6264,27,1464304340,1464305540,4,13,1200
7383636@N06,6264,6,1464306586,1464306761,2,13,175
7383636@N06,6264,2,1464306761,1464306851,2,13,90
7383636@N06,6264,6,1464306870,1464307125,2,13,255
7383636@N06,6264,9,1464307401,1464307523,2,13,122
7383636@N06,6264,7,1464307523,1464307567,2,13,44
7383636@N06,6264,11,1464307567,1464307747,2,13,180
7383636@N06,6264,8,1464307778,1464307898,6,13,120
7383636@N06,6264,10,1464310294,1464310714,2,13,420
7383636@N06,6264,14,1464311655,1464311775,4,13,120
7383636@N06,6264,17,1464314281,1464315661,2,13,1380
7383636@N06,6264,20,1464319258,1464320338,2,13,1080
7383636@N06,6264,23,1464320434,1464320524,2,13,90
73850513@N02,6265,27,1378565133,1378566333,4,3,1200
73850513@N02,6265,17,1378579570,1378579732,3,3,162
73850513@N02,6265,27,1378579732,1378580932,4,3,1200
7387139@N03,6266,23,1306310507,1306310597,4,2,90
7387139@N03,6266,9,1306316537,1306316777,3,2,240
7397829@N06,6267,16,1228627490,1228628210,1,1,720
74051711@N00,6268,27,1193835600,1193836800,8,1,1200
74089168@N00,6269,2,1382508388,1382508478,2,5,90
74089168@N00,6269,17,1382517893,1382519273,2,5,1380
74089168@N00,6269,8,1382525970,1382526090,2,5,120
74089168@N00,6269,16,1382526865,1382527550,2,5,685
74089168@N00,6269,27,1382527550,1382528750,1,5,1200
74101007@N00,6270,27,1356155198,1356156398,3,12,1200
74101007@N00,6270,9,1356157849,1356157958,2,12,109
74101007@N00,6270,7,1356157958,1356158048,3,12,90
74101007@N00,6270,8,1356158137,1356158181,2,12,44
74101007@N00,6270,11,1356158181,1356158361,2,12,180
74101007@N00,6270,10,1356158757,1356159177,3,12,420
74101007@N00,6270,14,1356159462,1356159582,9,12,120
74101007@N00,6270,16,1356163921,1356164592,2,12,671
74101007@N00,6270,4,1356164592,1356165004,2,12,412
74101007@N00,6270,2,1356165004,1356165094,14,12,90
74101007@N00,6270,9,1356168445,1356168685,3,12,240
74101007@N00,6270,5,1356177249,1356177969,1,12,720
74111533@N00,6271,20,1286327058,1286328138,3,2,1080
74111533@N00,6271,27,1286336997,1286338197,1,2,1200
7416177@N04,6272,14,1293531279,1293531399,9,1,120
7416177@N04,6273,14,1293566779,1293566899,3,1,120
7416177@N04,6274,16,1293611671,1293612391,1,1,720
7416177@N04,6275,14,1293821715,1293821835,7,5,120
7416177@N04,6275,16,1293829033,1293829753,2,5,720
7416177@N04,6275,14,1293835907,1293836027,18,5,120
7416177@N04,6275,22,1293843841,1293844441,4,5,600
7416177@N04,6275,14,1293858126,1293858246,2,5,120
74221923@N02,6276,27,1397619382,1397620582,1,1,1200
74227781@N00,6277,8,1359861603,1359861723,2,4,120
74227781@N00,6277,6,1359862569,1359862824,3,4,255
74227781@N00,6277,3,1359867690,1359867910,2,4,220
74227781@N00,6277,4,1359867910,1359868810,1,4,900
74246558@N00,6278,15,1468035437,1468035617,1,1,180
74285955@N00,6279,9,1230168192,1230168432,1,1,240
74285955@N00,6280,18,1320363125,1320364925,2,1,1800
74289372@N00,6281,15,1318905105,1318905106,2,5,1
74289372@N00,6281,17,1318905106,1318906486,2,5,1380
74289372@N00,6281,16,1318906656,1318907376,2,5,720
74289372@N00,6281,1,1318908364,1318908964,2,5,600
74289372@N00,6281,3,1318910365,1318910635,4,5,270
74324897@N06,6282,20,1256116720,1256117800,1,1,1080
74366817@N06,6283,27,1386855518,1386856718,1,1,1200
74366817@N06,6284,26,1387599302,1387599482,2,2,180
74366817@N06,6284,13,1387627187,1387627787,1,2,600
74366817@N06,6285,13,1388810663,1388811263,2,1,600
74366817@N06,6286,21,1389394143,1389394593,2,2,450
74366817@N06,6286,13,1389415128,1389415728,1,2,600
74366817@N06,6287,2,1391300755,1391300845,1,1,90
74366817@N06,6288,20,1393050869,1393051439,3,2,570
74366817@N06,6288,19,1393051439,1393051859,2,2,420
74366817@N06,6289,13,1399191269,1399191869,1,1,600
74372164@N04,6290,21,1352152838,1352152992,2,17,154
74372164@N04,6290,17,1352152992,1352154372,2,17,1380
74372164@N04,6290,13,1352154835,1352155435,3,17,600
74372164@N04,6290,21,1352155884,1352156334,2,17,450
74372164@N04,6290,17,1352156907,1352156927,2,17,20
74372164@N04,6290,19,1352156927,1352157347,2,17,420
74372164@N04,6290,25,1352157981,1352158731,2,17,750
74372164@N04,6290,21,1352158985,1352159435,3,17,450
74372164@N04,6290,10,1352180712,1352180802,2,17,90
74372164@N04,6290,21,1352180802,1352181252,3,17,450
74372164@N04,6290,10,1352182179,1352182229,3,17,50
74372164@N04,6290,9,1352182229,1352182469,2,17,240
74372164@N04,6290,21,1352183413,1352183863,3,17,450
74372164@N04,6290,16,1352188509,1352189229,2,17,720
74372164@N04,6290,21,1352194843,1352194993,2,17,150
74372164@N04,6290,3,1352194993,1352195263,2,17,270
74372164@N04,6290,16,1352195848,1352196568,1,17,720
74372164@N04,6291,21,1363860409,1363860859,1,1,450
74382902@N00,6292,2,1334724867,1334724957,2,3,90
74382902@N00,6292,7,1334728448,1334728538,2,3,90
74382902@N00,6292,19,1334737450,1334737870,1,3,420
74417388@N08,6293,1,1361948136,1361948736,1,1,600
74417388@N08,6294,27,1380007896,1380009096,1,1,1200
74434146@N04,6295,9,1329611607,1329611847,3,2,240
74434146@N04,6295,14,1329616355,1329616475,1,2,120
74461555@N05,6296,23,1326682238,1326682328,1,1,90
74461555@N05,6297,14,1330653237,1330653314,2,4,77
74461555@N05,6297,12,1330653314,1330654154,3,4,840
74461555@N05,6297,14,1330658614,1330658734,2,4,120
74461555@N05,6297,20,1330660987,1330662067,1,4,1080
74461555@N05,6298,21,1330820762,1330821212,2,2,450
74461555@N05,6298,13,1330824256,1330824856,4,2,600
74461555@N05,6299,15,1336008782,1336008962,1,1,180
74461555@N05,6300,27,1352756413,1352757613,2,7,1200
74461555@N05,6300,17,1352757695,1352759075,21,7,1380
74461555@N05,6300,16,1352759758,1352760478,2,7,720
74461555@N05,6300,19,1352761771,1352762191,6,7,420
74461555@N05,6300,21,1352762954,1352763350,2,7,396
74461555@N05,6300,23,1352763350,1352763440,3,7,90
74461555@N05,6300,27,1352763836,1352765036,1,7,1200
74461555@N05,6301,27,1352798082,1352799282,4,11,1200
74461555@N05,6301,17,1352800049,1352801429,2,11,1380
74461555@N05,6301,4,1352802625,1352803480,4,11,855
74461555@N05,6301,8,1352803480,1352803600,3,11,120
74461555@N05,6301,7,1352803863,1352803953,2,11,90
74461555@N05,6301,16,1352803991,1352804136,3,11,145
74461555@N05,6301,17,1352804136,1352804757,2,11,621
74461555@N05,6301,18,1352804757,1352805143,3,11,386
74461555@N05,6301,22,1352805143,1352805682,3,11,539
74461555@N05,6301,20,1352805682,1352806637,3,11,955
74461555@N05,6301,27,1352806637,1352807837,6,11,1200
74461555@N05,6302,7,1360284404,1360284494,3,2,90
74461555@N05,6302,18,1360286835,1360288635,6,2,1800
74461555@N05,6303,7,1360320747,1360320837,2,2,90
74461555@N05,6303,2,1360321550,1360321640,2,2,90
74461555@N05,6304,13,1375490829,1375490977,2,3,148
74461555@N05,6304,12,1375490977,1375491753,2,3,776
74461555@N05,6304,22,1375491753,1375492353,3,3,600
74476774@N00,6305,27,1382364117,1382365317,2,1,1200
7450381@N05,6306,18,1414901752,1414903552,2,2,1800
7450381@N05,6306,27,1414920825,1414922025,1,2,1200
7450381@N05,6307,2,1415072317,1415072407,1,1,90
7451382@N03,6308,7,1393979599,1393979689,2,3,90
7451382@N03,6308,8,1393980749,1393980869,3,3,120
7451382@N03,6308,21,1394004390,1394004840,1,3,450
74571557@N07,6309,17,1333009456,1333010836,2,2,1380
74571557@N07,6309,16,1333015016,1333015736,2,2,720
74571557@N07,6310,16,1333863966,1333864686,1,1,720
74712199@N00,6311,1,1334814715,1334815315,2,2,600
74712199@N00,6311,16,1334831059,1334831779,1,2,720
74712199@N00,6312,23,1428627569,1428627659,2,4,90
74712199@N00,6312,20,1428632214,1428633294,2,4,1080
74712199@N00,6312,14,1428643686,1428643806,2,4,120
74712199@N00,6312,9,1428646337,1428646577,1,4,240
7472274@N05,6313,3,1245626216,1245626486,2,5,270
7472274@N05,6313,2,1245626639,1245626729,2,5,90
7472274@N05,6313,6,1245627647,1245627902,5,5,255
7472274@N05,6313,11,1245629891,1245630071,2,5,180
7472274@N05,6313,20,1245636580,1245637660,2,5,1080
74762807@N00,6314,14,1438225944,1438226064,5,7,120
74762807@N00,6314,7,1438232446,1438232536,2,7,90
74762807@N00,6314,2,1438235296,1438235386,3,7,90
74762807@N00,6314,14,1438247594,1438247714,2,7,120
74762807@N00,6314,22,1438249656,1438250256,3,7,600
74762807@N00,6314,17,1438255392,1438256772,5,7,1380
74762807@N00,6314,14,1438258658,1438258778,1,7,120
74865359@N00,6315,27,1386814631,1386815831,11,1,1200
74865359@N00,6316,12,1391651784,1391652624,3,1,840
74865359@N00,6317,27,1412033030,1412034230,2,2,1200
74865359@N00,6317,2,1412035755,1412035845,1,2,90
74865359@N00,6318,27,1425290730,1425291930,12,1,1200
74875454@N00,6319,6,1241074722,1241074977,1,1,255
74875454@N00,6320,6,1241224674,1241224929,1,1,255
7490466@N08,6321,16,1298713689,1298714409,2,2,720
7490466@N08,6321,22,1298715922,1298716522,3,2,600
74985978@N00,6322,27,1353402139,1353403339,1,1,1200
7503886@N06,6323,10,1399968831,1399968898,2,4,67
7503886@N06,6323,9,1399968898,1399969138,2,4,240
7503886@N06,6323,3,1399974728,1399974998,3,4,270
7503886@N06,6323,2,1399975890,1399975980,2,4,90
7504153@N07,6324,27,1371951919,1371953119,1,1,1200
7504153@N07,6325,27,1390444660,1390445860,1,1,1200
75070889@N07,6326,16,1372133322,1372134042,1,1,720
75113045@N07,6327,27,1380880241,1380881441,1,1,1200
75122326@N00,6328,16,1258687089,1258687809,1,1,720
75122326@N00,6329,5,1258856345,1258857065,2,4,720
75122326@N00,6329,9,1258866754,1258866994,2,4,240
75122326@N00,6329,16,1258867820,1258868104,2,4,284
75122326@N00,6329,6,1258868104,1258868359,1,4,255
75132636@N00,6330,4,1228279479,1228280379,10,1,900
75132636@N00,6331,27,1228354339,1228355539,3,1,1200
7527751@N05,6332,1,1290249744,1290250344,1,1,600
75296851@N06,6333,16,1326628114,1326628834,5,2,720
75296851@N06,6333,2,1326631435,1326631525,1,2,90
75316711@N00,6334,4,1365249517,1365250417,16,1,900
75316711@N00,6335,4,1365337805,1365338705,20,1,900
75316711@N00,6336,4,1365398294,1365399194,20,1,900
75316711@N00,6337,4,1365508662,1365509562,32,1,900
75316711@N00,6338,4,1365597391,1365598291,1,1,900
75316711@N00,6339,4,1365684770,1365685670,28,1,900
75316711@N00,6340,4,1365770901,1365771801,49,1,900
75316711@N00,6341,4,1365939507,1365940407,54,1,900
75316711@N00,6342,4,1366034027,1366034927,18,1,900
75316711@N00,6343,4,1367828644,1367829544,1,1,900
75321142@N00,6344,27,1247090226,1247091426,2,1,1200
75321142@N00,6345,16,1247233888,1247234608,2,1,720
75321142@N00,6346,20,1247409052,1247410132,3,2,1080
75321142@N00,6346,16,1247411328,1247412048,1,2,720
75321142@N00,6347,16,1247542503,1247543223,3,2,720
75321142@N00,6347,11,1247544019,1247544199,1,2,180
75338025@N07,6348,27,1383520404,1383520751,7,25,347
75338025@N07,6348,25,1383520751,1383520861,2,25,110
75338025@N07,6348,23,1383520861,1383520951,2,25,90
75338025@N07,6348,24,1383521297,1383521777,3,25,480
75338025@N07,6348,20,1383521803,1383522352,2,25,549
75338025@N07,6348,19,1383522352,1383522469,5,25,117
75338025@N07,6348,20,1383522469,1383523549,5,25,1080
75338025@N07,6348,22,1383523853,1383524130,3,25,277
75338025@N07,6348,17,1383524130,1383524166,3,25,36
75338025@N07,6348,13,1383524166,1383524189,2,25,23
75338025@N07,6348,18,1383524189,1383525045,3,25,856
75338025@N07,6348,15,1383525045,1383525225,9,25,180
75338025@N07,6348,12,1383526302,1383526416,10,25,114
75338025@N07,6348,13,1383526416,1383526422,2,25,6
75338025@N07,6348,12,1383526422,1383526455,2,25,33
75338025@N07,6348,13,1383526455,1383526544,3,25,89
75338025@N07,6348,12,1383526544,1383526552,2,25,8
75338025@N07,6348,13,1383526552,1383526754,2,25,202
75338025@N07,6348,12,1383526754,1383527227,2,25,473
75338025@N07,6348,17,1383527227,1383527366,3,25,139
75338025@N07,6348,15,1383527366,1383527546,2,25,180
75338025@N07,6348,10,1383528093,1383528513,5,25,420
75338025@N07,6348,2,1383533215,1383533305,2,25,90
75338025@N07,6348,4,1383533956,1383534856,2,25,900
75338025@N07,6348,27,1383561168,1383562368,2,25,1200
7548090@N03,6349,17,1352372566,1352373946,2,1,1380
75515006@N00,6350,11,1208442051,1208442231,5,1,180
75601845@N06,6351,22,1209986793,1209987393,29,1,600
75601845@N06,6352,22,1210139676,1210140276,8,1,600
75601845@N06,6353,22,1210183152,1210183752,6,1,600
75601845@N06,6354,22,1210345228,1210345828,63,1,600
75601845@N06,6355,22,1231978390,1231978990,1,1,600
75601845@N06,6356,22,1283417764,1283418364,89,1,600
75601845@N06,6357,22,1283615455,1283616055,79,1,600
75601845@N06,6358,22,1284007999,1284008599,284,1,600
75601845@N06,6359,22,1284047819,1284048419,163,1,600
75601845@N06,6360,22,1284097768,1284098368,545,1,600
75601845@N06,6361,22,1284377732,1284378332,72,1,600
75601845@N06,6362,22,1284468048,1284468648,577,1,600
75601845@N06,6363,22,1322730995,1322731595,282,1,600
75601845@N06,6364,22,1322826862,1322827462,194,1,600
75601845@N06,6365,22,1323267552,1323268152,209,1,600
75601845@N06,6366,22,1323521214,1323521814,131,1,600
75601845@N06,6367,22,1323662284,1323662884,80,1,600
75601845@N06,6368,22,1323793146,1323793746,25,1,600
75601845@N06,6369,22,1323835939,1323836539,141,1,600
75601845@N06,6370,22,1323929871,1323930471,53,1,600
75671401@N08,6371,16,1325298050,1325298770,1,1,720
75722661@N00,6372,16,1302266843,1302267563,1,1,720
75736915@N00,6373,27,1332712520,1332713282,2,6,762
75736915@N00,6373,21,1332713282,1332713732,2,6,450
75736915@N00,6373,14,1332719790,1332719886,2,6,96
75736915@N00,6373,9,1332719886,1332720126,2,6,240
75736915@N00,6373,21,1332737325,1332737775,3,6,450
75736915@N00,6373,27,1332743551,1332744751,1,6,1200
7573710@N02,6374,15,1233344078,1233344258,6,1,180
75742976@N05,6375,21,1289094831,1289095281,2,3,450
75742976@N05,6375,20,1289096348,1289097428,3,3,1080
75742976@N05,6375,15,1289101278,1289101458,1,3,180
75742976@N05,6376,16,1326000043,1326000763,1,1,720
75742976@N05,6377,27,1353711504,1353712704,2,2,1200
75742976@N05,6377,10,1353715511,1353715931,1,2,420
75742976@N05,6378,22,1362804741,1362805341,2,3,600
75742976@N05,6378,17,1362808340,1362809720,3,3,1380
75742976@N05,6378,13,1362810887,1362811487,1,3,600
75742976@N05,6379,27,1365860451,1365861651,1,1,1200
75742976@N05,6380,19,1367647312,1367647732,2,2,420
75742976@N05,6380,13,1367649091,1367649691,1,2,600
75742976@N05,6381,4,1368878404,1368879304,1,1,900
75742976@N05,6382,8,1369346463,1369346583,3,4,120
75742976@N05,6382,19,1369362887,1369363307,3,4,420
75742976@N05,6382,4,1369375468,1369376368,2,4,900
75742976@N05,6382,26,1369386961,1369387141,1,4,180
75825285@N05,6383,27,1428453682,1428454882,3,1,1200
75825285@N05,6384,27,1460522987,1460524187,2,4,1200
75825285@N05,6384,15,1460527126,1460527306,2,4,180
75825285@N05,6384,21,1460530526,1460530976,9,4,450
75825285@N05,6384,4,1460541699,1460542599,2,4,900
75871529@N02,6385,12,1330484504,1330485344,5,7,840
75871529@N02,6385,4,1330486119,1330487019,2,7,900
75871529@N02,6385,26,1330488735,1330488915,2,7,180
75871529@N02,6385,14,1330491330,1330491450,4,7,120
75871529@N02,6385,16,1330491873,1330491996,2,7,123
75871529@N02,6385,4,1330491996,1330492896,2,7,900
75871529@N02,6385,16,1330494034,1330494754,1,7,720
75871529@N02,6386,12,1330599588,1330600428,5,4,840
75871529@N02,6386,16,1330600648,1330600906,3,4,258
75871529@N02,6386,10,1330600906,1330601118,2,4,212
75871529@N02,6386,14,1330601118,1330601238,1,4,120
75990687@N05,6387,2,1437715118,1437715208,3,9,90
75990687@N05,6387,4,1437719156,1437719360,3,9,204
75990687@N05,6387,9,1437719360,1437719600,3,9,240
75990687@N05,6387,24,1437727060,1437727540,2,9,480
75990687@N05,6387,9,1437739212,1437739452,5,9,240
75990687@N05,6387,13,1437740661,1437741261,3,9,600
75990687@N05,6387,7,1437741956,1437742046,3,9,90
75990687@N05,6387,8,1437742119,1437742239,4,9,120
75990687@N05,6387,11,1437742263,1437742443,1,9,180
75990687@N05,6388,7,1454104951,1454104965,3,10,14
75990687@N05,6388,14,1454104965,1454105085,2,10,120
75990687@N05,6388,17,1454105494,1454105809,5,10,315
75990687@N05,6388,24,1454105809,1454106289,6,10,480
75990687@N05,6388,14,1454126726,1454126846,3,10,120
75990687@N05,6388,17,1454128983,1454130363,2,10,1380
75990687@N05,6388,25,1454131831,1454132356,3,10,525
75990687@N05,6388,26,1454132356,1454132365,2,10,9
75990687@N05,6388,25,1454132365,1454133115,22,10,750
75990687@N05,6388,3,1454141346,1454141616,3,10,270
76024515@N07,6389,25,1347572466,1347573216,3,3,750
76024515@N07,6389,19,1347575463,1347575883,2,3,420
76024515@N07,6389,17,1347589157,1347590537,1,3,1380
76024515@N07,6390,21,1348024590,1348024723,2,6,133
76024515@N07,6390,23,1348024723,1348024813,2,6,90
76024515@N07,6390,21,1348025018,1348025369,2,6,351
76024515@N07,6390,22,1348025369,1348025969,3,6,600
76024515@N07,6390,16,1348028965,1348029569,2,6,604
76024515@N07,6390,13,1348029569,1348030169,1,6,600
76101503@N00,6391,21,1415067485,1415067935,1,1,450
76151808@N00,6392,27,1234570527,1234571727,9,6,1200
76151808@N00,6392,14,1234583867,1234583987,2,6,120
76151808@N00,6392,16,1234586208,1234586928,2,6,720
76151808@N00,6392,22,1234588062,1234588662,6,6,600
76151808@N00,6392,12,1234595181,1234596021,2,6,840
76151808@N00,6392,27,1234612501,1234613701,1,6,1200
76151808@N00,6393,9,1234868800,1234869040,3,3,240
76151808@N00,6393,17,1234870930,1234871067,3,3,137
76151808@N00,6393,4,1234871067,1234871967,1,3,900
76151808@N00,6394,1,1265850653,1265851253,2,19,600
76151808@N00,6394,3,1265851596,1265851866,2,19,270
76151808@N00,6394,14,1265852833,1265852953,2,19,120
76151808@N00,6394,27,1265856092,1265857195,2,19,1103
76151808@N00,6394,20,1265857195,1265858119,2,19,924
76151808@N00,6394,27,1265858119,1265859319,2,19,1200
76151808@N00,6394,1,1265860066,1265860666,3,19,600
76151808@N00,6394,9,1265863689,1265863929,2,19,240
76151808@N00,6394,13,1265865745,1265865865,2,19,120
76151808@N00,6394,18,1265865865,1265866175,2,19,310
76151808@N00,6394,13,1265866175,1265866775,2,19,600
76151808@N00,6394,1,1265868971,1265869046,2,19,75
76151808@N00,6394,7,1265869046,1265869136,2,19,90
76151808@N00,6394,4,1265872520,1265873420,2,19,900
76151808@N00,6394,24,1265873930,1265874410,4,19,480
76151808@N00,6394,27,1265876049,1265877249,2,19,1200
76151808@N00,6394,16,1265885509,1265886229,3,19,720
76151808@N00,6394,12,1265887560,1265888400,2,19,840
76151808@N00,6394,2,1265888844,1265888934,2,19,90
76151808@N00,6395,20,1266364539,1266364738,2,10,199
76151808@N00,6395,26,1266364738,1266364918,2,10,180
76151808@N00,6395,21,1266367073,1266367523,7,10,450
76151808@N00,6395,8,1266377476,1266377596,3,10,120
76151808@N00,6395,11,1266377666,1266377846,3,10,180
76151808@N00,6395,8,1266379550,1266379670,2,10,120
76151808@N00,6395,16,1266380150,1266380870,3,10,720
76151808@N00,6395,18,1266387419,1266389219,2,10,1800
76151808@N00,6395,13,1266408544,1266408951,2,10,407
76151808@N00,6395,14,1266408951,1266409071,1,10,120
76151808@N00,6396,13,1298248651,1298249251,2,4,600
76151808@N00,6396,17,1298253703,1298255083,2,4,1380
76151808@N00,6396,21,1298258021,1298258471,3,4,450
76151808@N00,6396,24,1298260075,1298260555,1,4,480
76151808@N00,6397,27,1298456691,1298457891,1,1,1200
76151808@N00,6398,3,1345771962,1345772232,2,4,270
76151808@N00,6398,14,1345772991,1345773111,2,4,120
76151808@N00,6398,26,1345776180,1345776360,2,4,180
76151808@N00,6398,22,1345786852,1345787452,1,4,600
76151808@N00,6399,16,1360886236,1360886956,2,2,720
76151808@N00,6399,8,1360895547,1360895667,1,2,120
76151808@N00,6400,21,1361099237,1361099687,1,1,450
76151808@N00,6401,27,1361182814,1361184014,1,1,1200
76151808@N00,6402,10,1361270617,1361271037,1,1,420
76151808@N00,6403,19,1361318909,1361319329,1,1,420
76151808@N00,6404,10,1361349574,1361349994,2,2,420
76151808@N00,6404,26,1361359822,1361360002,1,2,180
76151808@N00,6405,26,1387530207,1387530387,1,1,180
76151808@N00,6406,11,1388201662,1388201842,1,1,180
76151808@N00,6407,14,1424313666,1424313786,2,2,120
76151808@N00,6407,27,1424321897,1424323097,1,2,1200
76151808@N00,6408,16,1424560426,1424561146,2,2,720
76151808@N00,6408,2,1424566230,1424566320,1,2,90
76151808@N00,6409,26,1424654014,1424654194,1,1,180
76151808@N00,6410,26,1451264920,1451265100,1,1,180
76151808@N00,6411,24,1451434432,1451434912,2,2,480
76151808@N00,6411,15,1451448490,1451448670,1,2,180
76193525@N05,6412,16,1328693172,1328693892,1,1,720
76193525@N05,6413,27,1328844924,1328846124,1,1,1200
76287763@N00,6414,16,1391214264,1391214984,1,1,720
76343652@N04,6415,27,1461642861,1461644061,2,2,1200
76343652@N04,6415,4,1461648810,1461649710,3,2,900
7635377@N05,6416,9,1221735666,1221735906,8,1,240
76356046@N05,6417,27,1272514541,1272515741,1,1,1200
76356046@N05,6418,4,1272858768,1272859668,2,1,900
7638121@N03,6419,16,1277811866,1277812586,1,1,720
76475184@N02,6420,27,1410586152,1410587352,19,1,1200
76485411@N00,6421,27,1398202515,1398203715,1,1,1200
76485411@N00,6422,27,1398726587,1398727787,1,1,1200
76500745@N03,6423,26,1320200617,1320200797,1,1,180
76663697@N00,6424,27,1212466726,1212467926,9,9,1200
76663697@N00,6424,4,1212471355,1212472255,2,9,900
76663697@N00,6424,25,1212472322,1212473072,5,9,750
76663697@N00,6424,21,1212477041,1212477491,3,9,450
76663697@N00,6424,20,1212480354,1212481434,6,9,1080
76663697@N00,6424,17,1212481696,1212482294,8,9,598
76663697@N00,6424,13,1212482294,1212482894,2,9,600
76663697@N00,6424,15,1212483687,1212483867,5,9,180
76663697@N00,6424,14,1212485985,1212486105,1,9,120
76663697@N00,6425,27,1212518237,1212519437,1,1,1200
76663697@N00,6426,6,1212900485,1212900740,17,1,255
76665138@N00,6427,27,1262934043,1262935243,2,2,1200
76665138@N00,6427,3,1262936982,1262937252,1,2,270
76665138@N00,6428,5,1262981861,1262982014,2,3,153
76665138@N00,6428,9,1262982014,1262982254,2,3,240
76665138@N00,6428,26,1262982371,1262982551,1,3,180
76665138@N00,6429,11,1263285841,1263286021,2,1,180
76665138@N00,6430,4,1273821288,1273822188,1,1,900
76665138@N00,6431,3,1274106437,1274106707,1,1,270
76665138@N00,6432,6,1325880591,1325880810,2,9,219
76665138@N00,6432,9,1325880810,1325881035,2,9,225
76665138@N00,6432,14,1325881035,1325881155,3,9,120
76665138@N00,6432,17,1325900558,1325901938,5,9,1380
76665138@N00,6432,18,1325902535,1325904335,3,9,1800
76665138@N00,6432,22,1325904469,1325905069,2,9,600
76665138@N00,6432,14,1325908451,1325908571,3,9,120
76665138@N00,6432,3,1325909214,1325909484,2,9,270
76665138@N00,6432,9,1325913016,1325913256,1,9,240
76665138@N00,6433,27,1325982471,1325983671,19,11,1200
76665138@N00,6433,17,1325986960,1325988340,2,11,1380
76665138@N00,6433,26,1325989281,1325989461,3,11,180
76665138@N00,6433,20,1325990058,1325991138,5,11,1080
76665138@N00,6433,19,1325991855,1325992275,9,11,420
76665138@N00,6433,25,1325994119,1325994869,3,11,750
76665138@N00,6433,2,1325996943,1325997033,5,11,90
76665138@N00,6433,3,1326000244,1326000514,3,11,270
76665138@N00,6433,9,1326001667,1326001907,2,11,240
76665138@N00,6433,14,1326002599,1326002719,3,11,120
76665138@N00,6433,27,1326003515,1326004715,12,11,1200
76665138@N00,6434,27,1326410557,1326411757,4,8,1200
76665138@N00,6434,4,1326414709,1326415357,2,8,648
76665138@N00,6434,1,1326415357,1326415546,2,8,189
76665138@N00,6434,2,1326415546,1326415636,3,8,90
76665138@N00,6434,3,1326418744,1326418996,2,8,252
76665138@N00,6434,1,1326418996,1326419596,2,8,600
76665138@N00,6434,9,1326423777,1326424017,7,8,240
76665138@N00,6434,14,1326425564,1326425684,4,8,120
76665138@N00,6435,17,1326504987,1326506367,3,2,1380
76665138@N00,6435,3,1326508403,1326508673,2,2,270
76698900@N00,6436,19,1214549564,1214549984,1,1,420
76701708@N00,6437,7,1369533425,1369533515,1,1,90
76704164@N00,6438,15,1371027375,1371027555,2,2,180
76704164@N00,6438,21,1371030163,1371030613,1,2,450
76730958@N07,6439,26,1364860354,1364860534,1,1,180
7675784@N04,6440,22,1376291337,1376291937,3,2,600
7675784@N04,6440,16,1376312650,1376313370,7,2,720
76786681@N00,6441,16,1300396062,1300396782,2,3,720
76786681@N00,6441,2,1300402073,1300402163,2,3,90
76786681@N00,6441,3,1300404020,1300404290,1,3,270
76786681@N00,6442,14,1300488542,1300488662,2,4,120
76786681@N00,6442,16,1300493939,1300494659,3,4,720
76786681@N00,6442,9,1300494957,1300495197,2,4,240
76786681@N00,6442,14,1300505547,1300505667,1,4,120
76795008@N04,6443,27,1356918104,1356919304,22,1,1200
7682911@N05,6444,25,1319284179,1319284929,1,1,750
76830337@N07,6445,9,1231858542,1231858782,4,3,240
76830337@N07,6445,26,1231863802,1231863982,2,3,180
76830337@N07,6445,19,1231865196,1231865616,1,3,420
76830337@N07,6446,13,1282974496,1282975096,1,1,600
76830337@N07,6447,27,1288416534,1288417734,1,1,1200
76830337@N07,6448,13,1317534431,1317535031,1,1,600
76830337@N07,6449,18,1331961659,1331963459,2,3,1800
76830337@N07,6449,16,1331967878,1331968598,2,3,720
76830337@N07,6449,14,1331979666,1331979786,1,3,120
76830337@N07,6450,14,1338343140,1338343260,1,1,120
76830337@N07,6451,13,1339502342,1339502942,1,1,600
76830337@N07,6452,15,1342015200,1342015380,1,1,180
76830337@N07,6453,13,1347662428,1347663028,2,1,600
76830337@N07,6454,13,1364907600,1364908200,1,1,600
76830337@N07,6455,13,1364994000,1364994600,1,1,600
76830337@N07,6456,13,1365429600,1365429600,2,2,0
76830337@N07,6456,22,1365429600,1365430200,1,2,600
76830337@N07,6457,13,1365600609,1365601209,2,2,600
76830337@N07,6457,8,1365602402,1365602522,1,2,120
76830337@N07,6458,13,1365861671,1365862271,1,1,600
76830337@N07,6459,8,1366165530,1366165650,1,1,120
76830337@N07,6460,10,1366402381,1366402382,2,4,1
76830337@N07,6460,14,1366402382,1366402383,2,4,1
76830337@N07,6460,16,1366402383,1366402388,2,4,5
76830337@N07,6460,27,1366402388,1366403588,1,4,1200
76939038@N00,6461,9,1295583126,1295583366,32,1,240
76939038@N00,6462,9,1295652646,1295652886,42,1,240
76939038@N00,6463,9,1295743936,1295744176,14,1,240
76939038@N00,6464,9,1295827089,1295827329,24,1,240
76939038@N00,6465,9,1295924529,1295924769,4,1,240
76939038@N00,6466,9,1296005411,1296005651,5,1,240
76954449@N08,6467,17,1259835479,1259836859,1,1,1380
76954449@N08,6468,14,1354970726,1354970846,1,1,120
76954449@N08,6469,4,1368697689,1368698589,2,2,900
76954449@N08,6469,16,1368708065,1368708785,1,2,720
76954449@N08,6470,27,1369339225,1369340425,1,1,1200
76954449@N08,6471,26,1369572782,1369572962,2,2,180
76954449@N08,6471,13,1369573443,1369574043,1,2,600
76954449@N08,6472,4,1369627070,1369627970,1,1,900
76954449@N08,6473,27,1399875398,1399876598,1,1,1200
76954449@N08,6474,27,1400159474,1400160674,2,2,1200
76954449@N08,6474,17,1400161168,1400162548,1,2,1380
76985374@N00,6475,27,1300409582,1300410782,38,1,1200
76991932@N00,6476,9,1433733564,1433733804,2,3,240
76991932@N00,6476,19,1433746260,1433746680,2,3,420
76991932@N00,6476,13,1433750127,1433750727,1,3,600
76991932@N00,6477,14,1433932024,1433932144,1,1,120
7704455@N02,6478,16,1254200096,1254200816,1,1,720
77179348@N00,6479,27,1342007022,1342007430,4,10,408
77179348@N00,6479,5,1342007430,1342007503,2,10,73
77179348@N00,6479,4,1342007503,1342007882,2,10,379
77179348@N00,6479,3,1342007882,1342008152,7,10,270
77179348@N00,6479,2,1342009366,1342009456,4,10,90
77179348@N00,6479,5,1342009527,1342009575,4,10,48
77179348@N00,6479,2,1342009575,1342009601,2,10,26
77179348@N00,6479,1,1342009601,1342009887,5,10,286
77179348@N00,6479,3,1342009887,1342009993,2,10,106
77179348@N00,6479,4,1342009993,1342010893,17,10,900
77179348@N00,6480,14,1342270604,1342270724,2,2,120
77179348@N00,6480,17,1342271889,1342273269,2,2,1380
77179348@N00,6481,27,1442530184,1442530899,2,71,715
77179348@N00,6481,9,1442530899,1442531139,33,71,240
77179348@N00,6481,11,1442532821,1442532828,2,71,7
77179348@N00,6481,10,1442532828,1442532883,3,71,55
77179348@N00,6481,9,1442532883,1442533123,6,71,240
77179348@N00,6481,10,1442535053,1442535131,7,71,78
77179348@N00,6481,9,1442535131,1442535236,3,71,105
77179348@N00,6481,14,1442535236,1442535291,5,71,55
77179348@N00,6481,15,1442535291,1442535471,11,71,180
77179348@N00,6481,16,1442535609,1442535645,3,71,36
77179348@N00,6481,15,1442535645,1442535825,10,71,180
77179348@N00,6481,12,1442535987,1442536297,9,71,310
77179348@N00,6481,13,1442536297,1442536443,5,71,146
77179348@N00,6481,12,1442536443,1442537283,3,71,840
77179348@N00,6481,15,1442537333,1442537454,3,71,121
77179348@N00,6481,13,1442537454,1442537473,3,71,19
77179348@N00,6481,18,1442537473,1442537589,2,71,116
77179348@N00,6481,13,1442537589,1442538189,22,71,600
77179348@N00,6481,15,1442538751,1442538918,4,71,167
77179348@N00,6481,14,1442538918,1442538949,3,71,31
77179348@N00,6481,10,1442538949,1442539369,39,71,420
77179348@N00,6481,9,1442540055,1442540146,2,71,91
77179348@N00,6481,10,1442540146,1442540566,4,71,420
77179348@N00,6481,15,1442543568,1442543735,4,71,167
77179348@N00,6481,17,1442543735,1442543778,5,71,43
77179348@N00,6481,26,1442543778,1442543887,3,71,109
77179348@N00,6481,22,1442543887,1442544487,32,71,600
77179348@N00,6481,18,1442544762,1442544814,2,71,52
77179348@N00,6481,20,1442544814,1442545894,89,71,1080
77179348@N00,6481,19,1442546226,1442546646,24,71,420
77179348@N00,6481,20,1442547330,1442547385,3,71,55
77179348@N00,6481,21,1442547385,1442547462,8,71,77
77179348@N00,6481,24,1442547462,1442547488,2,71,26
77179348@N00,6481,23,1442547488,1442547571,3,71,83
77179348@N00,6481,24,1442547571,1442548051,8,71,480
77179348@N00,6481,21,1442548848,1442548954,8,71,106
77179348@N00,6481,24,1442548954,1442549045,2,71,91
77179348@N00,6481,25,1442549045,1442549164,4,71,119
77179348@N00,6481,24,1442549164,1442549548,13,71,384
77179348@N00,6481,23,1442549548,1442549638,5,71,90
77179348@N00,6481,18,1442550375,1442550469,2,71,94
77179348@N00,6481,23,1442550469,1442550559,15,71,90
77179348@N00,6481,26,1442551173,1442551250,7,71,77
77179348@N00,6481,25,1442551250,1442551952,25,71,702
77179348@N00,6481,17,1442551952,1442552116,8,71,164
77179348@N00,6481,4,1442552116,1442553016,23,71,900
77179348@N00,6481,5,1442553942,1442554097,2,71,155
77179348@N00,6481,4,1442554097,1442554108,2,71,11
77179348@N00,6481,5,1442554108,1442554373,3,71,265
77179348@N00,6481,6,1442554373,1442554628,4,71,255
77179348@N00,6481,2,1442554969,1442555059,29,71,90
77179348@N00,6481,4,1442555261,1442555266,2,71,5
77179348@N00,6481,5,1442555266,1442555318,14,71,52
77179348@N00,6481,6,1442555318,1442555345,6,71,27
77179348@N00,6481,1,1442555345,1442555576,22,71,231
77179348@N00,6481,2,1442555576,1442555616,5,71,40
77179348@N00,6481,3,1442555616,1442555681,9,71,65
77179348@N00,6481,4,1442555681,1442555717,2,71,36
77179348@N00,6481,3,1442555717,1442555766,4,71,49
77179348@N00,6481,2,1442555766,1442555856,4,71,90
77179348@N00,6481,3,1442555908,1442556178,14,71,270
77179348@N00,6481,2,1442556985,1442557075,4,71,90
77179348@N00,6481,3,1442557456,1442557726,7,71,270
77179348@N00,6481,1,1442558388,1442558988,16,71,600
77179348@N00,6481,9,1442561175,1442561415,23,71,240
77179348@N00,6481,14,1442562414,1442562534,4,71,120
77179348@N00,6481,16,1442562678,1442563398,5,71,720
77179348@N00,6481,14,1442563698,1442563772,4,71,74
77179348@N00,6481,16,1442563772,1442563847,4,71,75
77179348@N00,6481,17,1442563847,1442564120,6,71,273
77179348@N00,6481,27,1442564120,1442565320,8,71,1200
77179348@N00,6482,17,1442665109,1442666489,2,11,1380
77179348@N00,6482,20,1442666890,1442667970,2,11,1080
77179348@N00,6482,26,1442668661,1442668841,2,11,180
77179348@N00,6482,17,1442668861,1442668903,2,11,42
77179348@N00,6482,26,1442668903,1442668912,2,11,9
77179348@N00,6482,17,1442668912,1442669133,5,11,221
77179348@N00,6482,26,1442669133,1442669241,4,11,108
77179348@N00,6482,17,1442669241,1442669348,4,11,107
77179348@N00,6482,26,1442669348,1442669436,5,11,88
77179348@N00,6482,17,1442669436,1442669990,4,11,554
77179348@N00,6482,27,1442669990,1442671190,4,11,1200
77205577@N06,6483,27,1429440345,1429441545,1,1,1200
77260531@N03,6484,16,1364387334,1364388054,1,1,720
77265242@N00,6485,10,1356334939,1356335359,1,1,420
77382220@N08,6486,27,1364630973,1364632173,1,1,1200
77382220@N08,6487,27,1364813755,1364814955,5,1,1200
77395664@N00,6488,9,1412317939,1412318179,1,1,240
77437178@N00,6489,17,1317439384,1317440764,1,1,1380
77437178@N00,6490,27,1345259624,1345260824,1,1,1200
77437178@N00,6491,13,1350712175,1350712775,1,1,600
77463997@N03,6492,19,1307354958,1307355378,1,1,420
77463997@N03,6493,21,1351128651,1351129101,1,1,450
77463997@N03,6494,27,1354159280,1354160480,1,1,1200
77463997@N03,6495,21,1359802288,1359802738,1,1,450
77463997@N03,6496,21,1360201341,1360201791,1,1,450
77463997@N03,6497,9,1360404194,1360404434,2,2,240
77463997@N03,6497,14,1360408403,1360408523,1,2,120
77463997@N03,6498,13,1373797639,1373798239,1,1,600
77463997@N03,6499,9,1375538403,1375538643,1,1,240
77463997@N03,6500,27,1378428510,1378429710,2,2,1200
77463997@N03,6500,20,1378443507,1378444587,1,2,1080
77463997@N03,6501,19,1378542123,1378542543,1,1,420
77463997@N03,6502,21,1379206742,1379207192,1,1,450
77463997@N03,6503,21,1382132944,1382133394,1,1,450
77463997@N03,6504,7,1384162883,1384162973,1,1,90
77463997@N03,6505,27,1384747713,1384748913,1,1,1200
77463997@N03,6506,14,1385018079,1385018199,1,1,120
77463997@N03,6507,19,1390185390,1390185810,2,3,420
77463997@N03,6507,21,1390188830,1390189280,3,3,450
77463997@N03,6507,27,1390215089,1390216289,1,3,1200
77463997@N03,6508,19,1390822675,1390823095,1,1,420
77463997@N03,6509,19,1391081351,1391081771,1,1,420
77463997@N03,6510,27,1395181053,1395182253,1,1,1200
77463997@N03,6511,27,1395269097,1395270297,1,1,1200
77463997@N03,6512,27,1395356978,1395358178,1,1,1200
77463997@N03,6513,27,1395619469,1395620669,2,1,1200
77463997@N03,6514,27,1395699245,1395700445,1,1,1200
77463997@N03,6515,27,1395870050,1395871250,1,1,1200
77463997@N03,6516,27,1398986711,1398987911,1,1,1200
77463997@N03,6517,27,1399417792,1399418992,1,1,1200
77463997@N03,6518,19,1401959214,1401959634,1,1,420
77463997@N03,6519,27,1414710859,1414712059,1,1,1200
77463997@N03,6520,27,1418813390,1418814590,1,1,1200
77463997@N03,6521,9,1421400954,1421401194,1,1,240
77463997@N03,6522,23,1421711624,1421711714,1,1,90
77463997@N03,6523,16,1425418339,1425419059,1,1,720
77463997@N03,6524,10,1429615053,1429615473,1,1,420
77463997@N03,6525,16,1430039203,1430039923,1,1,720
77463997@N03,6526,16,1434621914,1434622634,2,1,720
77463997@N03,6527,27,1441949290,1441950490,1,1,1200
77463997@N03,6528,21,1443134641,1443135091,1,1,450
77463997@N03,6529,13,1444342133,1444342733,1,1,600
77463997@N03,6530,27,1445637815,1445639015,1,1,1200
77463997@N03,6531,27,1446022139,1446023339,1,1,1200
77463997@N03,6532,13,1446241295,1446241895,1,1,600
77463997@N03,6533,4,1453588021,1453588921,1,1,900
77503031@N00,6534,27,1261492310,1261493510,1,1,1200
77503031@N00,6535,21,1261578289,1261578352,2,7,63
77503031@N00,6535,25,1261578352,1261579102,2,7,750
77503031@N00,6535,22,1261584461,1261584506,2,7,45
77503031@N00,6535,20,1261584506,1261584549,3,7,43
77503031@N00,6535,22,1261584549,1261584690,7,7,141
77503031@N00,6535,20,1261584690,1261585770,4,7,1080
77503031@N00,6535,16,1261598637,1261599357,6,7,720
77506321@N00,6536,27,1395720616,1395721816,1,1,1200
77506321@N00,6537,27,1395798446,1395799646,1,1,1200
77528595@N00,6538,27,1318549327,1318550527,2,8,1200
77528595@N00,6538,24,1318556135,1318556615,4,8,480
77528595@N00,6538,1,1318558613,1318559213,2,8,600
77528595@N00,6538,9,1318559800,1318560040,2,8,240
77528595@N00,6538,24,1318564930,1318565410,2,8,480
77528595@N00,6538,26,1318567703,1318567714,2,8,11
77528595@N00,6538,27,1318567714,1318567866,2,8,152
77528595@N00,6538,26,1318567866,1318568046,1,8,180
77528595@N00,6539,24,1318898155,1318898635,1,1,480
77545914@N00,6540,23,1268190188,1268190278,4,2,90
77545914@N00,6540,16,1268204010,1268204730,2,2,720
7755564@N06,6541,27,1354453419,1354454619,1,1,1200
77643438@N08,6542,4,1325738186,1325739086,1,1,900
77665450@N08,6543,16,1331530266,1331530986,1,1,720
7768857@N04,6544,14,1369128131,1369128251,1,1,120
77692940@N00,6545,6,1367133891,1367134146,1,1,255
77709469@N03,6546,27,1391986921,1391988121,1,1,1200
77709469@N03,6547,27,1392020770,1392021970,3,1,1200
7772172@N02,6548,16,1298620592,1298621312,10,1,720
7772172@N02,6549,4,1298752723,1298752953,2,4,230
7772172@N02,6549,14,1298752953,1298753053,3,4,100
7772172@N02,6549,16,1298753053,1298753174,5,4,121
7772172@N02,6549,26,1298753174,1298753354,2,4,180
77744839@N00,6550,2,1389490392,1389490482,2,2,90
77744839@N00,6550,3,1389491462,1389491732,1,2,270
77744839@N00,6551,27,1389580227,1389581427,2,11,1200
77744839@N00,6551,9,1389581870,1389582110,2,11,240
77744839@N00,6551,19,1389589503,1389589923,2,11,420
77744839@N00,6551,21,1389593370,1389593820,2,11,450
77744839@N00,6551,22,1389594426,1389595026,3,11,600
77744839@N00,6551,13,1389600755,1389601355,2,11,600
77744839@N00,6551,14,1389602510,1389602630,2,11,120
77744839@N00,6551,15,1389603372,1389603552,2,11,180
77744839@N00,6551,9,1389604528,1389604768,2,11,240
77744839@N00,6551,1,1389605781,1389606381,2,11,600
77744839@N00,6551,16,1389609040,1389609760,1,11,720
7776897@N02,6552,16,1223022036,1223022756,30,1,720
7776897@N02,6553,1,1223257146,1223257610,2,3,464
7776897@N02,6553,16,1223257610,1223258330,11,3,720
7776897@N02,6553,1,1223262521,1223263121,2,3,600
7784444@N07,6554,15,1325112674,1325112684,2,5,10
7784444@N07,6554,13,1325112684,1325113036,10,5,352
7784444@N07,6554,15,1325113036,1325113046,2,5,10
7784444@N07,6554,21,1325113046,1325113055,2,5,9
7784444@N07,6554,27,1325113055,1325114255,2,5,1200
77850199@N02,6555,14,1331075198,1331075318,3,11,120
77850199@N02,6555,13,1331078314,1331078641,3,11,327
77850199@N02,6555,14,1331078641,1331078761,3,11,120
77850199@N02,6555,26,1331079711,1331079891,5,11,180
77850199@N02,6555,27,1331086748,1331087948,3,11,1200
77850199@N02,6555,16,1331097888,1331098608,2,11,720
77850199@N02,6555,21,1331104476,1331104926,3,11,450
77850199@N02,6555,16,1331106089,1331106208,2,11,119
77850199@N02,6555,14,1331106208,1331106328,2,11,120
77850199@N02,6555,2,1331112382,1331112472,2,11,90
77850199@N02,6555,16,1331117429,1331118149,2,11,720
77865420@N00,6556,18,1343743200,1343745000,1,1,1800
77865420@N00,6557,13,1344780000,1344780007,8,8,7
77865420@N00,6557,18,1344780007,1344780008,2,8,1
77865420@N00,6557,13,1344780008,1344780009,2,8,1
77865420@N00,6557,10,1344780009,1344780011,3,8,2
77865420@N00,6557,16,1344780011,1344780021,11,8,10
77865420@N00,6557,4,1344780021,1344780026,5,8,5
77865420@N00,6557,27,1344780026,1344780031,4,8,5
77865420@N00,6557,13,1344780031,1344780631,14,8,600
77876033@N00,6558,9,1223697898,1223698138,3,2,240
77876033@N00,6558,25,1223714082,1223714832,1,2,750
77876033@N00,6559,25,1292553855,1292554605,1,1,750
77876033@N00,6560,27,1292992316,1292993516,1,1,1200
77876033@N00,6561,1,1293504785,1293505385,2,3,600
77876033@N00,6561,25,1293513053,1293513803,2,3,750
77876033@N00,6561,22,1293538338,1293538938,1,3,600
77919685@N00,6562,14,1196932248,1196932368,28,1,120
77932199@N07,6563,19,1312697431,1312697851,1,1,420
77932199@N07,6564,27,1334207368,1334208568,7,1,1200
77932199@N07,6565,27,1340868051,1340869251,4,7,1200
77932199@N07,6565,14,1340873524,1340873644,8,7,120
77932199@N07,6565,16,1340874925,1340875645,2,7,720
77932199@N07,6565,14,1340877908,1340878028,13,7,120
77932199@N07,6565,7,1340878747,1340878837,7,7,90
77932199@N07,6565,9,1340882056,1340882296,4,7,240
77932199@N07,6565,12,1340883667,1340884507,4,7,840
77932199@N07,6566,27,1341278148,1341279348,2,6,1200
77932199@N07,6566,24,1341288091,1341288571,3,6,480
77932199@N07,6566,22,1341291813,1341292413,15,6,600
77932199@N07,6566,18,1341296523,1341298323,2,6,1800
77932199@N07,6566,15,1341301716,1341301896,2,6,180
77932199@N07,6566,8,1341303964,1341304084,6,6,120
77932199@N07,6567,18,1374631329,1374633129,3,1,1800
77988256@N05,6568,17,1419839960,1419841340,2,1,1380
78027754@N00,6569,27,1355873619,1355874819,2,2,1200
78027754@N00,6569,12,1355885090,1355885930,1,2,840
78027754@N00,6570,17,1396915176,1396916556,2,1,1380
78027754@N00,6571,20,1406507628,1406507896,2,3,268
78027754@N00,6571,21,1406507896,1406507974,3,3,78
78027754@N00,6571,20,1406507974,1406509054,1,3,1080
78027754@N00,6572,27,1429436670,1429437870,11,14,1200
78027754@N00,6572,16,1429441849,1429442569,22,14,720
78027754@N00,6572,14,1429445830,1429445871,2,14,41
78027754@N00,6572,16,1429445871,1429445949,2,14,78
78027754@N00,6572,14,1429445949,1429446069,4,14,120
78027754@N00,6572,16,1429447048,1429447768,11,14,720
78027754@N00,6572,27,1429476270,1429477217,5,14,947
78027754@N00,6572,16,1429477217,1429477808,11,14,591
78027754@N00,6572,12,1429477808,1429478648,5,14,840
78027754@N00,6572,10,1429480733,1429481153,4,14,420
78027754@N00,6572,15,1429481764,1429481944,2,14,180
78027754@N00,6572,14,1429484705,1429484825,10,14,120
78027754@N00,6572,17,1429487638,1429489018,9,14,1380
78027754@N00,6572,16,1429494993,1429495713,8,14,720
78027754@N00,6573,17,1432543700,1432545080,1,1,1380
7804123@N08,6574,20,1410088458,1410089538,1,1,1080
7804123@N08,6575,14,1410189092,1410189212,1,1,120
78046504@N07,6576,14,1336387622,1336387742,1,1,120
7806128@N03,6577,16,1192949786,1192950506,1,1,720
78089576@N06,6578,18,1333177129,1333178929,1,1,1800
78132024@N00,6579,14,1389233793,1389233913,1,1,120
78147513@N00,6580,4,1291514211,1291515111,1,1,900
78147513@N00,6581,3,1357725069,1357725339,1,1,270
78166585@N05,6582,16,1414552497,1414553217,2,2,720
78166585@N05,6582,18,1414560852,1414562652,1,2,1800
78186649@N00,6583,12,1383374968,1383375808,4,2,840
78186649@N00,6583,8,1383376109,1383376229,5,2,120
7830943@N03,6584,4,1381533741,1381534116,2,8,375
7830943@N03,6584,6,1381534116,1381534371,2,8,255
7830943@N03,6584,2,1381535693,1381535783,3,8,90
7830943@N03,6584,10,1381538802,1381539222,2,8,420
7830943@N03,6584,9,1381543973,1381544213,2,8,240
7830943@N03,6584,23,1381547206,1381547296,2,8,90
7830943@N03,6584,18,1381555902,1381557702,3,8,1800
7830943@N03,6584,27,1381575942,1381577142,7,8,1200
78319592@N00,6585,27,1376364431,1376365631,8,11,1200
78319592@N00,6585,17,1376368881,1376369083,2,11,202
78319592@N00,6585,15,1376369083,1376369201,4,11,118
78319592@N00,6585,14,1376369201,1376369321,3,11,120
78319592@N00,6585,25,1376378440,1376378459,3,11,19
78319592@N00,6585,24,1376378459,1376378464,2,11,5
78319592@N00,6585,21,1376378464,1376378792,2,11,328
78319592@N00,6585,25,1376378792,1376378865,2,11,73
78319592@N00,6585,26,1376378865,1376378984,2,11,119
78319592@N00,6585,24,1376378984,1376379054,2,11,70
78319592@N00,6585,21,1376379054,1376379504,2,11,450
78345092@N07,6586,19,1372462634,1372463054,2,6,420
78345092@N07,6586,18,1372464297,1372466097,2,6,1800
78345092@N07,6586,14,1372486539,1372486659,2,6,120
78345092@N07,6586,16,1372487628,1372488348,2,6,720
78345092@N07,6586,2,1372500697,1372500787,2,6,90
78345092@N07,6586,16,1372502988,1372503708,2,6,720
78364960@N04,6587,21,1318646519,1318646969,1,1,450
78364960@N04,6588,27,1336811029,1336812229,2,2,1200
78364960@N04,6588,14,1336823651,1336823771,1,2,120
78364960@N04,6589,21,1341052951,1341053401,2,4,450
78364960@N04,6589,26,1341054702,1341054882,3,4,180
78364960@N04,6589,7,1341057234,1341057324,2,4,90
78364960@N04,6589,27,1341061145,1341062345,1,4,1200
78364960@N04,6590,21,1344510813,1344511263,1,1,450
78364960@N04,6591,27,1346592958,1346594158,1,1,1200
78364960@N04,6592,27,1350106136,1350107336,2,4,1200
78364960@N04,6592,10,1350108863,1350109283,3,4,420
78364960@N04,6592,14,1350113291,1350113411,2,4,120
78364960@N04,6592,9,1350115444,1350115684,1,4,240
78364960@N04,6593,14,1351731269,1351731389,1,1,120
78364960@N04,6594,22,1354350937,1354351537,2,2,600
78364960@N04,6594,10,1354363716,1354364136,2,2,420
78364960@N04,6595,10,1354935284,1354935704,2,3,420
78364960@N04,6595,14,1354944136,1354944256,2,3,120
78364960@N04,6595,13,1354945894,1354946494,2,3,600
78364960@N04,6596,27,1360391425,1360392625,2,4,1200
78364960@N04,6596,17,1360392802,1360394182,3,4,1380
78364960@N04,6596,9,1360406217,1360406457,2,4,240
78364960@N04,6596,10,1360407203,1360407623,1,4,420
78364960@N04,6597,27,1361076841,1361078041,2,1,1200
78364960@N04,6598,18,1363929365,1363931165,2,6,1800
78364960@N04,6598,9,1363936738,1363936978,2,6,240
78364960@N04,6598,23,1363938356,1363938446,2,6,90
78364960@N04,6598,21,1363938787,1363939237,3,6,450
78364960@N04,6598,10,1363946883,1363947303,3,6,420
78364960@N04,6598,14,1363947850,1363947970,1,6,120
78364960@N04,6599,27,1366419149,1366420349,2,2,1200
78364960@N04,6599,9,1366428429,1366428669,1,2,240
78364960@N04,6600,16,1368229689,1368230409,3,8,720
78364960@N04,6600,21,1368232504,1368232954,2,8,450
78364960@N04,6600,24,1368232963,1368233443,3,8,480
78364960@N04,6600,19,1368238903,1368239323,2,8,420
78364960@N04,6600,16,1368242172,1368242892,3,8,720
78364960@N04,6600,17,1368243176,1368243816,2,8,640
78364960@N04,6600,13,1368243816,1368244416,2,8,600
78364960@N04,6600,17,1368249522,1368250902,1,8,1380
78364960@N04,6601,27,1369339030,1369339646,2,3,616
78364960@N04,6601,16,1369339646,1369340366,2,3,720
78364960@N04,6601,19,1369343579,1369343999,1,3,420
78364960@N04,6602,16,1369386815,1369387535,2,5,720
78364960@N04,6602,10,1369388016,1369388436,3,5,420
78364960@N04,6602,9,1369388624,1369388864,2,5,240
78364960@N04,6602,14,1369400196,1369400316,2,5,120
78364960@N04,6602,16,1369413290,1369414010,1,5,720
78364960@N04,6603,10,1370092506,1370092926,2,1,420
78364960@N04,6604,14,1373019258,1373019277,2,5,19
78364960@N04,6604,10,1373019277,1373019697,3,5,420
78364960@N04,6604,15,1373029539,1373029719,2,5,180
78364960@N04,6604,17,1373030393,1373031773,3,5,1380
78364960@N04,6604,21,1373032583,1373033033,1,5,450
78364960@N04,6605,12,1375434943,1375435783,2,5,840
78364960@N04,6605,10,1375436629,1375437049,2,5,420
78364960@N04,6605,14,1375438468,1375438588,2,5,120
78364960@N04,6605,6,1375440759,1375441014,2,5,255
78364960@N04,6605,4,1375445221,1375446121,4,5,900
78364960@N04,6606,9,1379407181,1379407237,2,5,56
78364960@N04,6606,14,1379407237,1379407357,2,5,120
78364960@N04,6606,13,1379410508,1379411108,2,5,600
78364960@N04,6606,27,1379416046,1379417246,10,5,1200
78364960@N04,6606,13,1379426966,1379427566,1,5,600
78364960@N04,6607,10,1380360375,1380360795,2,2,420
78364960@N04,6607,27,1380370202,1380371402,1,2,1200
78364960@N04,6608,19,1382340910,1382341330,2,4,420
78364960@N04,6608,10,1382359289,1382359709,2,4,420
78364960@N04,6608,14,1382363243,1382363363,3,4,120
78364960@N04,6608,19,1382365079,1382365499,1,4,420
78364960@N04,6609,27,1382421569,1382422769,2,2,1200
78364960@N04,6609,9,1382426412,1382426652,1,2,240
78364960@N04,6610,13,1384076752,1384077352,2,3,600
78364960@N04,6610,26,1384081685,1384081865,3,3,180
78364960@N04,6610,13,1384085475,1384086075,1,3,600
78364960@N04,6611,10,1387693975,1387694395,2,2,420
78364960@N04,6611,26,1387711978,1387712158,1,2,180
78364960@N04,6612,16,1392627539,1392628259,2,2,720
78364960@N04,6612,10,1392631219,1392631639,1,2,420
78364960@N04,6613,26,1394939770,1394939950,2,2,180
78364960@N04,6613,15,1394942642,1394942822,1,2,180
78364960@N04,6614,14,1398081892,1398082012,2,1,120
78364960@N04,6615,13,1398763829,1398764111,2,3,282
78364960@N04,6615,16,1398764111,1398764831,2,3,720
78364960@N04,6615,9,1398770026,1398770266,1,3,240
78364960@N04,6616,17,1400794101,1400795481,3,2,1380
78364960@N04,6616,27,1400812522,1400813722,1,2,1200
78364960@N04,6617,17,1400850136,1400851516,2,2,1380
78364960@N04,6617,27,1400856404,1400857604,1,2,1200
78364960@N04,6618,27,1413692780,1413693980,2,1,1200
78364960@N04,6619,10,1417235557,1417235977,1,1,420
78364960@N04,6620,27,1421123507,1421124707,2,1,1200
78364960@N04,6621,9,1423281843,1423282083,2,2,240
78364960@N04,6621,10,1423307579,1423307999,1,2,420
78364960@N04,6622,17,1424308523,1424309903,2,2,1380
78364960@N04,6622,8,1424310992,1424311112,1,2,120
78364960@N04,6623,15,1428131328,1428131508,1,1,180
78364960@N04,6624,10,1430439369,1430439789,1,1,420
78364960@N04,6625,10,1430741815,1430742235,1,1,420
78364960@N04,6626,14,1432287389,1432287509,2,2,120
78364960@N04,6626,17,1432307752,1432309132,1,2,1380
78364960@N04,6627,27,1444125602,1444126802,5,1,1200
78364960@N04,6628,22,1450849635,1450850235,1,1,600
78364960@N04,6629,27,1452144521,1452145721,4,1,1200
78364960@N04,6630,27,1455945987,1455947187,4,1,1200
78364960@N04,6631,6,1457167420,1457167675,2,1,255
78364960@N04,6632,27,1461475489,1461476689,9,3,1200
78364960@N04,6632,10,1461485060,1461485480,3,3,420
78364960@N04,6632,4,1461487069,1461487969,1,3,900
78364960@N04,6633,27,1462598804,1462600004,8,2,1200
78364960@N04,6633,10,1462623198,1462623618,1,2,420
78364960@N04,6634,16,1466257733,1466258453,2,1,720
78364960@N04,6635,16,1467774581,1467775301,4,1,720
78364960@N04,6636,27,1471329005,1471330205,1,1,1200
78395763@N00,6637,20,1249181254,1249182334,1,1,1080
78427651@N00,6638,3,1357137762,1357138032,1,1,270
7846658@N05,6639,16,1204954200,1204954920,1,1,720
78473524@N00,6640,27,1344502025,1344503225,1,1,1200
78493611@N00,6641,25,1383713811,1383714561,1,1,750
7849988@N04,6642,27,1429182860,1429184060,16,1,1200
7849988@N04,6643,19,1466294789,1466295209,8,2,420
7849988@N04,6643,9,1466298812,1466299052,2,2,240
78562800@N05,6644,16,1355371620,1355372340,1,1,720
78569471@N00,6645,4,1209297565,1209298465,3,1,900
78569471@N00,6646,17,1211179628,1211181008,1,1,1380
78569471@N00,6647,27,1214135000,1214136200,25,3,1200
78569471@N00,6647,17,1214141604,1214142857,5,3,1253
78569471@N00,6647,16,1214142857,1214143577,2,3,720
78569471@N00,6648,27,1214266573,1214267505,2,16,932
78569471@N00,6648,4,1214267505,1214268405,3,16,900
78569471@N00,6648,6,1214268869,1214269124,7,16,255
78569471@N00,6648,2,1214270304,1214270394,5,16,90
78569471@N00,6648,6,1214273353,1214273608,4,16,255
78569471@N00,6648,17,1214274031,1214274366,3,16,335
78569471@N00,6648,13,1214274366,1214274378,3,16,12
78569471@N00,6648,18,1214274378,1214274749,4,16,371
78569471@N00,6648,19,1214274749,1214274781,2,16,32
78569471@N00,6648,18,1214274781,1214274797,2,16,16
78569471@N00,6648,19,1214274797,1214274910,4,16,113
78569471@N00,6648,18,1214274910,1214274957,2,16,47
78569471@N00,6648,13,1214274957,1214275348,11,16,391
78569471@N00,6648,18,1214275348,1214277148,2,16,1800
78569471@N00,6648,17,1214277974,1214278310,4,16,336
78569471@N00,6648,25,1214278310,1214279060,5,16,750
78569471@N00,6649,17,1227354654,1227356034,1,1,1380
78588112@N03,6650,27,1435632746,1435633946,27,1,1200
7859316@N03,6651,6,1276079523,1276079778,1,1,255
78644369@N03,6652,27,1383611570,1383611652,2,4,82
78644369@N03,6652,13,1383611652,1383611689,2,4,37
78644369@N03,6652,24,1383611689,1383611794,2,4,105
78644369@N03,6652,9,1383611794,1383612034,1,4,240
78672040@N00,6653,17,1197137666,1197139046,1,1,1380
78672040@N00,6654,25,1272061266,1272062016,1,1,750
78672040@N00,6655,25,1357335556,1357336306,1,1,750
78732663@N03,6656,14,1397518812,1397518932,3,3,120
78732663@N03,6656,15,1397519814,1397519994,2,3,180
78732663@N03,6656,9,1397527042,1397527282,1,3,240
78732663@N03,6657,27,1397692137,1397693190,3,10,1053
78732663@N03,6657,24,1397693190,1397693670,2,10,480
78732663@N03,6657,2,1397697643,1397697733,7,10,90
78732663@N03,6657,6,1397708668,1397708701,2,10,33
78732663@N03,6657,9,1397708701,1397708941,2,10,240
78732663@N03,6657,11,1397709625,1397709805,2,10,180
78732663@N03,6657,1,1397710581,1397711181,2,10,600
78732663@N03,6657,4,1397711302,1397712202,2,10,900
78732663@N03,6657,9,1397713405,1397713645,2,10,240
78732663@N03,6657,20,1397717723,1397718803,1,10,1080
78743109@N00,6658,27,1325549920,1325551120,12,7,1200
78743109@N00,6658,17,1325564757,1325566137,2,7,1380
78743109@N00,6658,14,1325566848,1325566968,2,7,120
78743109@N00,6658,9,1325571824,1325572064,4,7,240
78743109@N00,6658,17,1325575373,1325576753,4,7,1380
78743109@N00,6658,16,1325593850,1325594121,2,7,271
78743109@N00,6658,27,1325594121,1325595321,1,7,1200
78779574@N00,6659,27,1336094673,1336095873,7,1,1200
78779574@N00,6660,6,1336265240,1336265495,3,15,255
78779574@N00,6660,23,1336266768,1336266858,9,15,90
78779574@N00,6660,22,1336267654,1336268254,2,15,600
78779574@N00,6660,24,1336269339,1336269476,2,15,137
78779574@N00,6660,21,1336269476,1336269701,2,15,225
78779574@N00,6660,25,1336269701,1336269815,2,15,114
78779574@N00,6660,24,1336269815,1336270295,2,15,480
78779574@N00,6660,22,1336271132,1336271732,2,15,600
78779574@N00,6660,18,1336274684,1336276484,2,15,1800
78779574@N00,6660,20,1336277429,1336277906,3,15,477
78779574@N00,6660,24,1336277906,1336277922,2,15,16
78779574@N00,6660,23,1336277922,1336278012,2,15,90
78779574@N00,6660,25,1336278770,1336279391,4,15,621
78779574@N00,6660,26,1336279391,1336279571,2,15,180
78779574@N00,6660,20,1336279843,1336280923,31,15,1080
78798856@N00,6661,14,1316999995,1317000115,10,1,120
78798856@N00,6662,14,1317116869,1317116989,1,1,120
7883384@N04,6663,27,1276858931,1276860131,2,8,1200
7883384@N04,6663,5,1276860996,1276861716,3,8,720
7883384@N04,6663,2,1276863786,1276863876,5,8,90
7883384@N04,6663,7,1276868552,1276868642,2,8,90
7883384@N04,6663,6,1276869235,1276869444,4,8,209
7883384@N04,6663,9,1276869444,1276869684,9,8,240
7883384@N04,6663,14,1276870317,1276870437,10,8,120
7883384@N04,6663,18,1276872002,1276873802,2,8,1800
7886635@N06,6664,7,1425339772,1425339862,3,4,90
7886635@N06,6664,22,1425354217,1425354817,46,4,600
7886635@N06,6664,7,1425377618,1425377708,3,4,90
7886635@N06,6664,16,1425381537,1425382257,1,4,720
7886635@N06,6665,10,1425546438,1425546858,10,1,420
78956712@N02,6666,16,1333272764,1333273484,1,1,720
79023626@N00,6667,14,1274235115,1274235235,1,1,120
79023626@N00,6668,14,1308191492,1308191612,3,1,120
79023626@N00,6669,18,1335506806,1335507795,2,2,989
79023626@N00,6669,22,1335507795,1335508395,1,2,600
79023626@N00,6670,8,1351164254,1351164374,2,2,120
79023626@N00,6670,6,1351166312,1351166567,1,2,255
79023626@N00,6671,27,1352962577,1352963777,2,3,1200
79023626@N00,6671,3,1352978203,1352978473,2,3,270
79023626@N00,6671,8,1352985231,1352985351,1,3,120
79023626@N00,6672,3,1354446918,1354447188,2,1,270
79038884@N04,6673,1,1364993268,1364993868,1,1,600
7908450@N03,6674,27,1303937113,1303938313,1,1,1200
79092915@N00,6675,27,1280566047,1280567247,2,3,1200
79092915@N00,6675,20,1280568075,1280569155,2,3,1080
79092915@N00,6675,16,1280580701,1280581421,1,3,720
79121533@N00,6676,21,1335660395,1335660845,2,5,450
79121533@N00,6676,11,1335665406,1335665586,3,5,180
79121533@N00,6676,10,1335665616,1335666036,3,5,420
79121533@N00,6676,13,1335666648,1335666710,2,5,62
79121533@N00,6676,18,1335666710,1335668510,2,5,1800
79121533@N00,6677,10,1389152024,1389152444,2,1,420
79128990@N00,6678,22,1405858021,1405858621,1,1,600
79134215@N00,6679,20,1210665610,1210666690,2,1,1080
79134215@N00,6680,20,1211877097,1211878177,1,1,1080
79154294@N00,6681,1,1334277051,1334277096,2,7,45
79154294@N00,6681,6,1334277096,1334277351,2,7,255
79154294@N00,6681,11,1334277685,1334277865,2,7,180
79154294@N00,6681,14,1334291042,1334291162,2,7,120
79154294@N00,6681,11,1334292442,1334292622,3,7,180
79154294@N00,6681,8,1334302485,1334302605,2,7,120
79154294@N00,6681,11,1334304554,1334304734,1,7,180
7917124@N07,6682,27,1458085293,1458086493,2,8,1200
7917124@N07,6682,16,1458089668,1458090388,6,8,720
7917124@N07,6682,9,1458093994,1458094234,3,8,240
7917124@N07,6682,14,1458115438,1458115558,3,8,120
7917124@N07,6682,10,1458115605,1458116025,2,8,420
7917124@N07,6682,17,1458126086,1458127466,7,8,1380
7917124@N07,6682,22,1458129495,1458130095,2,8,600
7917124@N07,6682,27,1458134966,1458136166,1,8,1200
79172203@N00,6683,27,1291679547,1291680100,5,18,553
79172203@N00,6683,25,1291680100,1291680230,2,18,130
79172203@N00,6683,21,1291680230,1291680680,3,18,450
79172203@N00,6683,20,1291681672,1291682306,2,18,634
79172203@N00,6683,22,1291682306,1291682906,2,18,600
79172203@N00,6683,13,1291683347,1291683947,3,18,600
79172203@N00,6683,17,1291684578,1291685958,3,18,1380
79172203@N00,6683,15,1291688651,1291688771,2,18,120
79172203@N00,6683,12,1291688771,1291689611,6,18,840
79172203@N00,6683,16,1291691065,1291691222,3,18,157
79172203@N00,6683,14,1291691222,1291691342,2,18,120
79172203@N00,6683,9,1291691703,1291691943,2,18,240
79172203@N00,6683,14,1291692389,1291692509,6,18,120
79172203@N00,6683,16,1291696516,1291697236,2,18,720
79172203@N00,6683,25,1291697917,1291698667,5,18,750
79172203@N00,6683,4,1291711233,1291712133,21,18,900
79172203@N00,6683,15,1291721277,1291721457,2,18,180
79172203@N00,6683,27,1291721925,1291723125,1,18,1200
79172203@N00,6684,27,1292014556,1292015495,9,36,939
79172203@N00,6684,16,1292015495,1292016055,13,36,560
79172203@N00,6684,14,1292016055,1292016070,2,36,15
79172203@N00,6684,16,1292016070,1292016308,8,36,238
79172203@N00,6684,14,1292016308,1292016411,4,36,103
79172203@N00,6684,15,1292016411,1292016455,3,36,44
79172203@N00,6684,12,1292016455,1292016518,3,36,63
79172203@N00,6684,15,1292016518,1292016611,3,36,93
79172203@N00,6684,13,1292016611,1292016786,6,36,175
79172203@N00,6684,17,1292016786,1292017103,7,36,317
79172203@N00,6684,26,1292017103,1292017283,2,36,180
79172203@N00,6684,22,1292017502,1292017788,7,36,286
79172203@N00,6684,20,1292017788,1292017968,4,36,180
79172203@N00,6684,19,1292017968,1292018266,4,36,298
79172203@N00,6684,17,1292018266,1292018821,6,36,555
79172203@N00,6684,15,1292018821,1292018862,2,36,41
79172203@N00,6684,14,1292018862,1292018870,2,36,8
79172203@N00,6684,16,1292018870,1292018929,2,36,59
79172203@N00,6684,14,1292018929,1292019049,2,36,120
79172203@N00,6684,7,1292019144,1292019220,3,36,76
79172203@N00,6684,8,1292019220,1292019340,16,36,120
79172203@N00,6684,11,1292019659,1292019839,20,36,180
79172203@N00,6684,8,1292020190,1292020310,4,36,120
79172203@N00,6684,1,1292020561,1292020721,4,36,160
79172203@N00,6684,2,1292020721,1292020778,3,36,57
79172203@N00,6684,3,1292020778,1292020865,2,36,87
79172203@N00,6684,2,1292020865,1292020924,2,36,59
79172203@N00,6684,5,1292020924,1292020952,2,36,28
79172203@N00,6684,4,1292020952,1292021852,4,36,900
79172203@N00,6684,23,1292021982,1292022072,4,36,90
79172203@N00,6684,24,1292022096,1292022157,2,36,61
79172203@N00,6684,21,1292022157,1292022329,3,36,172
79172203@N00,6684,25,1292022329,1292023079,2,36,750
79172203@N00,6684,27,1292024238,1292025438,6,36,1200
79172203@N00,6684,21,1292048597,1292049047,2,36,450
79172203@N00,6684,16,1292052086,1292052806,38,36,720
79172203@N00,6685,15,1399328014,1399328098,2,3,84
79172203@N00,6685,13,1399328098,1399328698,6,3,600
79172203@N00,6685,10,1399337245,1399337665,29,3,420
79172203@N00,6686,27,1399493390,1399494400,19,20,1010
79172203@N00,6686,16,1399494400,1399494614,21,20,214
79172203@N00,6686,14,1399494614,1399494734,18,20,120
79172203@N00,6686,10,1399495306,1399495726,59,20,420
79172203@N00,6686,11,1399497043,1399497223,19,20,180
79172203@N00,6686,9,1399497579,1399497753,9,20,174
79172203@N00,6686,14,1399497753,1399497873,11,20,120
79172203@N00,6686,10,1399497973,1399498050,3,20,77
79172203@N00,6686,14,1399498050,1399498149,5,20,99
79172203@N00,6686,16,1399498149,1399498162,3,20,13
79172203@N00,6686,14,1399498162,1399498217,5,20,55
79172203@N00,6686,15,1399498217,1399498397,29,20,180
79172203@N00,6686,13,1399499372,1399499920,16,20,548
79172203@N00,6686,17,1399499920,1399500614,5,20,694
79172203@N00,6686,27,1399500614,1399501814,5,20,1200
79172203@N00,6686,26,1399515647,1399515827,71,20,180
79172203@N00,6686,10,1399517400,1399517820,6,20,420
79172203@N00,6686,9,1399518449,1399518686,4,20,237
79172203@N00,6686,4,1399518686,1399519586,2,20,900
79172203@N00,6686,14,1399527287,1399527407,1,20,120
79172203@N00,6687,26,1399624457,1399624637,67,3,180
79172203@N00,6687,12,1399626577,1399627417,2,3,840
79172203@N00,6687,27,1399640586,1399641786,1,3,1200
79344793@N02,6688,16,1330846188,1330846908,1,1,720
79344793@N02,6689,27,1331079660,1331080860,2,2,1200
79344793@N02,6689,14,1331093833,1331093953,1,2,120
79344793@N02,6690,11,1344478946,1344479126,2,2,180
79344793@N02,6690,17,1344490550,1344491930,3,2,1380
79366282@N00,6691,27,1385765924,1385767124,1,1,1200
79399703@N00,6692,9,1366967430,1366967670,1,1,240
79433444@N07,6693,27,1355290953,1355291426,5,8,473
79433444@N07,6693,17,1355291426,1355292806,5,8,1380
79433444@N07,6693,20,1355294571,1355295651,2,8,1080
79433444@N07,6693,18,1355296962,1355297891,2,8,929
79433444@N07,6693,23,1355297891,1355297981,2,8,90
79433444@N07,6693,18,1355299802,1355301602,5,8,1800
79433444@N07,6693,14,1355302139,1355302259,5,8,120
79433444@N07,6693,17,1355323734,1355325114,1,8,1380
7945368@N05,6694,27,1341644217,1341644300,2,2,83
7945368@N05,6694,16,1341644300,1341645020,7,2,720
7945368@N05,6695,18,1404860060,1404861860,3,5,1800
7945368@N05,6695,14,1404877583,1404877703,2,5,120
7945368@N05,6695,18,1404888205,1404890005,4,5,1800
7945368@N05,6695,16,1404906306,1404907026,6,5,720
7945368@N05,6695,18,1404908944,1404910744,1,5,1800
7945637@N07,6696,17,1189094249,1189095629,1,1,1380
7945637@N07,6697,22,1216289472,1216290072,1,1,600
7945637@N07,6698,16,1216723932,1216724652,1,1,720
7945637@N07,6699,22,1217587452,1217588052,3,2,600
7945637@N07,6699,19,1217588234,1217588654,1,2,420
7945637@N07,6700,16,1219036911,1219037631,1,1,720
7945637@N07,6701,16,1244717405,1244718125,1,1,720
7945637@N07,6702,16,1247222767,1247223487,2,2,720
7945637@N07,6702,5,1247230320,1247231040,1,2,720
7945637@N07,6703,16,1255749513,1255749909,2,4,396
7945637@N07,6703,26,1255749909,1255750089,5,4,180
7945637@N07,6703,23,1255750919,1255751009,2,4,90
7945637@N07,6703,21,1255752070,1255752520,2,4,450
7945637@N07,6704,1,1256961851,1256962451,4,1,600
7945637@N07,6705,1,1257496638,1257497238,2,1,600
7945637@N07,6706,14,1258171375,1258171495,2,2,120
7945637@N07,6706,26,1258175266,1258175446,1,2,180
7945637@N07,6707,16,1258795528,1258796248,2,1,720
7945637@N07,6708,19,1264222935,1264223355,1,1,420
7945637@N07,6709,17,1277714925,1277716305,2,1,1380
7945637@N07,6710,19,1281093113,1281093533,1,1,420
7945637@N07,6711,16,1289216536,1289217256,1,1,720
7945637@N07,6712,11,1293953836,1293954016,3,2,180
7945637@N07,6712,7,1293955758,1293955848,1,2,90
7945637@N07,6713,26,1296358128,1296358308,1,1,180
7945637@N07,6714,11,1297155768,1297155948,1,1,180
7945637@N07,6715,16,1297417990,1297418710,2,1,720
7945637@N07,6716,16,1323945974,1323946694,1,1,720
7945637@N07,6717,16,1330546723,1330547394,2,2,671
7945637@N07,6717,27,1330547394,1330548594,1,2,1200
7945637@N07,6718,14,1350693743,1350693863,2,1,120
79478905@N04,6719,14,1458663214,1458663334,1,1,120
79498503@N03,6720,19,1315715715,1315716135,1,1,420
7955606@N05,6721,27,1217402382,1217403582,2,1,1200
7956743@N08,6722,27,1257905422,1257906622,3,3,1200
7956743@N08,6722,17,1257915664,1257917044,2,3,1380
7956743@N08,6722,6,1257921653,1257921908,1,3,255
79577915@N00,6723,9,1290123277,1290123517,2,4,240
79577915@N00,6723,16,1290130467,1290131187,7,4,720
79577915@N00,6723,6,1290154292,1290154547,2,4,255
79577915@N00,6723,17,1290167950,1290169330,1,4,1380
79577915@N00,6724,19,1290551342,1290551762,3,3,420
79577915@N00,6724,17,1290560804,1290562184,2,3,1380
79577915@N00,6724,20,1290564899,1290565979,1,3,1080
79599121@N00,6725,9,1418982886,1418983126,3,2,240
79599121@N00,6725,27,1418992522,1418993722,1,2,1200
79620786@N08,6726,14,1363400366,1363400486,1,1,120
79639617@N00,6727,11,1452989831,1452990011,7,2,180
79639617@N00,6727,27,1453001453,1453002653,6,2,1200
79642617@N06,6728,14,1355965131,1355965251,1,1,120
7973770@N05,6729,27,1217990095,1217990634,3,7,539
7973770@N05,6729,17,1217990634,1217992014,3,7,1380
7973770@N05,6729,13,1217993000,1217993600,2,7,600
7973770@N05,6729,21,1217996366,1217996816,7,7,450
7973770@N05,6729,14,1218010930,1218011050,2,7,120
7973770@N05,6729,16,1218011704,1218012424,3,7,720
7973770@N05,6729,12,1218014037,1218014877,1,7,840
79761301@N00,6730,27,1287778096,1287779296,3,1,1200
79761301@N00,6731,27,1287823811,1287825011,16,12,1200
79761301@N00,6731,25,1287825439,1287826189,16,12,750
79761301@N00,6731,22,1287828170,1287828770,9,12,600
79761301@N00,6731,25,1287834208,1287834571,3,12,363
79761301@N00,6731,16,1287834571,1287835117,2,12,546
79761301@N00,6731,27,1287835117,1287835814,4,12,697
79761301@N00,6731,16,1287835814,1287836534,2,12,720
79761301@N00,6731,1,1287837522,1287838122,3,12,600
79761301@N00,6731,27,1287841330,1287842530,2,12,1200
79761301@N00,6731,22,1287843575,1287844175,2,12,600
79761301@N00,6731,25,1287845080,1287845555,2,12,475
79761301@N00,6731,27,1287845555,1287846755,9,12,1200
79761301@N00,6732,27,1288017357,1288017568,4,12,211
79761301@N00,6732,16,1288017568,1288017648,2,12,80
79761301@N00,6732,17,1288017648,1288017888,5,12,240
79761301@N00,6732,16,1288017888,1288017912,2,12,24
79761301@N00,6732,14,1288017912,1288018032,34,12,120
79761301@N00,6732,17,1288022573,1288023953,12,12,1380
79761301@N00,6732,25,1288023999,1288024120,2,12,121
79761301@N00,6732,16,1288024120,1288024840,3,12,720
79761301@N00,6732,25,1288026411,1288027161,2,12,750
79761301@N00,6732,16,1288034664,1288035384,2,12,720
79761301@N00,6732,17,1288041791,1288042421,2,12,630
79761301@N00,6732,14,1288042421,1288042541,1,12,120
79761301@N00,6733,27,1288257969,1288258870,6,10,901
79761301@N00,6733,25,1288258870,1288259406,5,10,536
79761301@N00,6733,22,1288259406,1288259655,4,10,249
79761301@N00,6733,17,1288259655,1288260012,5,10,357
79761301@N00,6733,14,1288260012,1288260132,7,10,120
79761301@N00,6733,1,1288260678,1288261278,11,10,600
79761301@N00,6733,16,1288265210,1288265484,2,10,274
79761301@N00,6733,25,1288265484,1288266234,10,10,750
79761301@N00,6733,22,1288269244,1288269844,3,10,600
79761301@N00,6733,25,1288271571,1288272321,4,10,750
79761301@N00,6734,27,1402091874,1402093074,5,22,1200
79761301@N00,6734,16,1402097129,1402097831,2,22,702
79761301@N00,6734,15,1402097831,1402098011,2,22,180
79761301@N00,6734,13,1402098028,1402098302,4,22,274
79761301@N00,6734,18,1402098302,1402098315,2,22,13
79761301@N00,6734,13,1402098315,1402098472,3,22,157
79761301@N00,6734,18,1402098472,1402099434,2,22,962
79761301@N00,6734,13,1402099434,1402099633,2,22,199
79761301@N00,6734,15,1402099633,1402099813,3,22,180
79761301@N00,6734,12,1402099985,1402100017,4,22,32
79761301@N00,6734,15,1402100017,1402100061,2,22,44
79761301@N00,6734,12,1402100061,1402100114,3,22,53
79761301@N00,6734,13,1402100114,1402100714,3,22,600
79761301@N00,6734,2,1402103108,1402103198,2,22,90
79761301@N00,6734,4,1402105782,1402106094,4,22,312
79761301@N00,6734,17,1402106094,1402107474,2,22,1380
79761301@N00,6734,22,1402108163,1402108763,9,22,600
79761301@N00,6734,26,1402109107,1402109287,2,22,180
79761301@N00,6734,27,1402125358,1402126558,2,22,1200
79761301@N00,6734,16,1402126577,1402127297,2,22,720
79761301@N00,6734,10,1402129477,1402129897,3,22,420
79761301@N00,6734,15,1402131286,1402131466,1,22,180
79761301@N00,6735,14,1402238708,1402238828,2,3,120
79761301@N00,6735,16,1402238861,1402239581,2,3,720
79761301@N00,6735,27,1402239889,1402241089,2,3,1200
7988769@N08,6736,10,1425693414,1425693834,1,1,420
7988769@N08,6737,17,1458863517,1458864897,1,1,1380
7989225@N08,6738,14,1336471506,1336471626,1,1,120
79939076@N02,6739,27,1342399954,1342401154,4,10,1200
79939076@N02,6739,20,1342402494,1342403574,6,10,1080
79939076@N02,6739,26,1342405352,1342405532,8,10,180
79939076@N02,6739,25,1342406678,1342407428,6,10,750
79939076@N02,6739,26,1342408539,1342408719,3,10,180
79939076@N02,6739,20,1342410430,1342411510,4,10,1080
79939076@N02,6739,18,1342411779,1342413579,3,10,1800
79939076@N02,6739,19,1342414112,1342414532,6,10,420
79939076@N02,6739,17,1342430061,1342431441,4,10,1380
79939076@N02,6739,25,1342435053,1342435803,1,10,750
79959485@N00,6740,25,1219103264,1219103754,6,7,490
79959485@N00,6740,24,1219103754,1219104234,3,7,480
79959485@N00,6740,20,1219105844,1219106924,3,7,1080
79959485@N00,6740,19,1219107217,1219107637,2,7,420
79959485@N00,6740,14,1219115942,1219116062,3,7,120
79959485@N00,6740,1,1219117575,1219118175,3,7,600
79959485@N00,6740,4,1219119258,1219120158,2,7,900
79959485@N00,6741,21,1219369151,1219369601,5,9,450
79959485@N00,6741,17,1219373191,1219373237,3,9,46
79959485@N00,6741,13,1219373237,1219373837,8,9,600
79959485@N00,6741,16,1219375341,1219375928,3,9,587
79959485@N00,6741,5,1219375928,1219375973,4,9,45
79959485@N00,6741,6,1219375973,1219376007,3,9,34
79959485@N00,6741,1,1219376007,1219376327,5,9,320
79959485@N00,6741,3,1219376327,1219376597,3,9,270
79959485@N00,6741,27,1219380469,1219381669,1,9,1200
79959485@N00,6742,20,1219475565,1219476645,3,6,1080
79959485@N00,6742,21,1219483900,1219484350,7,6,450
79959485@N00,6742,20,1219484431,1219484934,3,6,503
79959485@N00,6742,19,1219484934,1219485354,5,6,420
79959485@N00,6742,20,1219487251,1219487307,3,6,56
79959485@N00,6742,21,1219487307,1219487757,4,6,450
79959485@N00,6743,17,1219655705,1219656750,10,4,1045
79959485@N00,6743,13,1219656750,1219657350,5,4,600
79959485@N00,6743,20,1219657975,1219658074,2,4,99
79959485@N00,6743,21,1219658074,1219658524,1,4,450
79959485@N00,6744,25,1225364651,1225365401,2,1,750
79959485@N00,6745,27,1331626782,1331627227,3,10,445
79959485@N00,6745,4,1331627227,1331627453,5,10,226
79959485@N00,6745,1,1331627453,1331627665,3,10,212
79959485@N00,6745,2,1331627665,1331627755,4,10,90
79959485@N00,6745,1,1331627921,1331628521,10,10,600
79959485@N00,6745,16,1331632029,1331632749,4,10,720
79959485@N00,6745,17,1331633672,1331635052,3,10,1380
79959485@N00,6745,21,1331635353,1331635803,5,10,450
79959485@N00,6745,25,1331636636,1331637052,4,10,416
79959485@N00,6745,27,1331637052,1331638252,1,10,1200
79959485@N00,6746,27,1331770088,1331771288,8,13,1200
79959485@N00,6746,8,1331771691,1331771811,10,13,120
79959485@N00,6746,14,1331772255,1331772375,12,13,120
79959485@N00,6746,16,1331772603,1331773321,4,13,718
79959485@N00,6746,17,1331773321,1331774701,12,13,1380
79959485@N00,6746,18,1331776029,1331776120,3,13,91
79959485@N00,6746,13,1331776120,1331776720,5,13,600
79959485@N00,6746,16,1331777935,1331777975,2,13,40
79959485@N00,6746,14,1331777975,1331778095,5,13,120
79959485@N00,6746,9,1331778771,1331779011,4,13,240
79959485@N00,6746,23,1331781019,1331781109,18,13,90
79959485@N00,6746,25,1331783655,1331784405,4,13,750
79959485@N00,6746,27,1331784910,1331786110,2,13,1200
79959485@N00,6747,27,1332052847,1332054047,2,5,1200
79959485@N00,6747,24,1332054209,1332054689,2,5,480
79959485@N00,6747,13,1332057092,1332057692,3,5,600
79959485@N00,6747,3,1332059383,1332059653,8,5,270
79959485@N00,6747,27,1332061703,1332062903,12,5,1200
80084904@N00,6748,27,1200866053,1200866055,3,11,2
80084904@N00,6748,14,1200866055,1200866056,2,11,1
80084904@N00,6748,13,1200866056,1200866061,6,11,5
80084904@N00,6748,16,1200866061,1200866082,19,11,21
80084904@N00,6748,27,1200866082,1200866083,2,11,1
80084904@N00,6748,21,1200866083,1200866085,3,11,2
80084904@N00,6748,17,1200866085,1200866089,4,11,4
80084904@N00,6748,13,1200866089,1200866090,2,11,1
80084904@N00,6748,18,1200866090,1200866091,2,11,1
80084904@N00,6748,13,1200866091,1200866165,3,11,74
80084904@N00,6748,27,1200866165,1200867365,7,11,1200
80084904@N00,6749,27,1227009000,1227010200,4,7,1200
80084904@N00,6749,4,1227010912,1227011812,5,7,900
80084904@N00,6749,2,1227012709,1227012799,4,7,90
80084904@N00,6749,3,1227012833,1227013103,24,7,270
80084904@N00,6749,6,1227014433,1227014688,11,7,255
80084904@N00,6749,7,1227015081,1227015171,8,7,90
80084904@N00,6749,9,1227016663,1227016903,10,7,240
80084904@N00,6750,6,1227284545,1227284800,3,3,255
80084904@N00,6750,14,1227288898,1227289018,2,3,120
80084904@N00,6750,12,1227290636,1227291476,3,3,840
80172766@N04,6751,27,1337424715,1337425915,1,1,1200
80172766@N04,6752,16,1337579950,1337580670,1,1,720
8021465@N08,6753,14,1262565443,1262565563,1,1,120
8021465@N08,6754,14,1262822083,1262822203,4,1,120
8021465@N08,6755,27,1336913546,1336914746,1,1,1200
8021465@N08,6756,27,1383107133,1383108333,1,1,1200
80304458@N00,6757,6,1419396555,1419396810,2,4,255
80304458@N00,6757,9,1419397266,1419397389,2,4,123
80304458@N00,6757,4,1419397389,1419398289,2,4,900
80304458@N00,6757,15,1419399933,1419400113,1,4,180
80341011@N00,6758,16,1416017895,1416018615,1,1,720
8042568@N06,6759,22,1222086210,1222086810,1,1,600
80446452@N00,6760,23,1328662231,1328662321,1,1,90
80446452@N00,6761,27,1363483571,1363484771,3,2,1200
80446452@N00,6761,7,1363493950,1363494040,1,2,90
80446452@N00,6762,8,1367112632,1367112752,14,6,120
80446452@N00,6762,7,1367114710,1367114800,12,6,90
80446452@N00,6762,8,1367115035,1367115155,2,6,120
80446452@N00,6762,15,1367119605,1367119606,2,6,1
80446452@N00,6762,13,1367119606,1367120206,2,6,600
80446452@N00,6762,27,1367123465,1367124665,2,6,1200
80446452@N00,6763,7,1456995047,1456995137,1,1,90
8044860@N04,6764,15,1371888950,1371889130,1,1,180
8044860@N04,6765,6,1371984610,1371984865,1,1,255
80521687@N00,6766,27,1349229449,1349230649,5,11,1200
80521687@N00,6766,2,1349234405,1349234486,3,11,81
80521687@N00,6766,26,1349234486,1349234666,4,11,180
80521687@N00,6766,18,1349239675,1349239767,2,11,92
80521687@N00,6766,13,1349239767,1349240367,7,11,600
80521687@N00,6766,16,1349242395,1349243115,2,11,720
80521687@N00,6766,9,1349243477,1349243717,3,11,240
80521687@N00,6766,16,1349248696,1349249416,6,11,720
80521687@N00,6766,25,1349251222,1349251972,2,11,750
80521687@N00,6766,27,1349254691,1349255891,5,11,1200
80521687@N00,6766,16,1349258720,1349259440,1,11,720
8054352@N06,6767,27,1355833586,1355834786,1,1,1200
8054352@N06,6768,27,1384752558,1384753758,1,1,1200
8054352@N06,6769,27,1386365943,1386367143,1,1,1200
80558292@N00,6770,14,1382415805,1382415925,2,2,120
80558292@N00,6770,27,1382427161,1382428361,1,2,1200
80558292@N00,6771,27,1382663017,1382664217,2,4,1200
80558292@N00,6771,24,1382664596,1382665076,2,4,480
80558292@N00,6771,1,1382668513,1382668580,2,4,67
80558292@N00,6771,2,1382668580,1382668670,1,4,90
80558292@N00,6772,19,1383278839,1383279259,2,3,420
80558292@N00,6772,16,1383280842,1383281562,2,3,720
80558292@N00,6772,27,1383290271,1383291471,1,3,1200
80578129@N00,6773,27,1366496323,1366497523,2,3,1200
80578129@N00,6773,20,1366501616,1366502696,2,3,1080
80578129@N00,6773,27,1366523980,1366525180,2,3,1200
8066628@N02,6774,7,1287552898,1287552988,1,1,90
8068421@N07,6775,4,1192530880,1192531780,2,1,900
8068421@N07,6776,17,1200967338,1200968559,2,4,1221
8068421@N07,6776,13,1200968559,1200969159,2,4,600
8068421@N07,6776,18,1200969932,1200971732,2,4,1800
8068421@N07,6776,19,1200972084,1200972504,1,4,420
8068421@N07,6777,27,1209896905,1209898105,1,1,1200
8068421@N07,6778,27,1260100396,1260101596,1,1,1200
8068421@N07,6779,22,1260601769,1260602369,1,1,600
8068421@N07,6780,3,1287384559,1287384829,2,2,270
8068421@N07,6780,27,1287385491,1287386691,3,2,1200
8068421@N07,6781,27,1296008335,1296009535,2,1,1200
8068421@N07,6782,9,1337227331,1337227571,2,1,240
8068835@N04,6783,27,1333274365,1333275565,7,4,1200
8068835@N04,6783,6,1333277915,1333278170,27,4,255
8068835@N04,6783,1,1333282320,1333282920,18,4,600
8068835@N04,6783,27,1333286811,1333288011,3,4,1200
8068835@N04,6784,27,1333330838,1333332038,61,24,1200
8068835@N04,6784,17,1333333294,1333333650,10,24,356
8068835@N04,6784,18,1333333650,1333333687,7,24,37
8068835@N04,6784,17,1333333687,1333334272,4,24,585
8068835@N04,6784,19,1333334272,1333334637,4,24,365
8068835@N04,6784,13,1333334637,1333334709,3,24,72
8068835@N04,6784,18,1333334709,1333335251,23,24,542
8068835@N04,6784,17,1333335251,1333335440,7,24,189
8068835@N04,6784,15,1333335440,1333335478,7,24,38
8068835@N04,6784,14,1333335478,1333335478,2,24,0
8068835@N04,6784,15,1333335478,1333335494,3,24,16
8068835@N04,6784,14,1333335494,1333335533,4,24,39
8068835@N04,6784,15,1333335533,1333335547,4,24,14
8068835@N04,6784,14,1333335547,1333335547,2,24,0
8068835@N04,6784,15,1333335547,1333335701,2,24,154
8068835@N04,6784,14,1333335701,1333335821,27,24,120
8068835@N04,6784,9,1333336015,1333336171,9,24,156
8068835@N04,6784,6,1333336171,1333336248,7,24,77
8068835@N04,6784,5,1333336248,1333336344,7,24,96
8068835@N04,6784,2,1333336344,1333336434,29,24,90
8068835@N04,6784,3,1333337487,1333337656,10,24,169
8068835@N04,6784,2,1333337656,1333337746,3,24,90
8068835@N04,6784,9,1333340031,1333340271,7,24,240
8068835@N04,6784,27,1333340657,1333341857,419,24,1200
8068835@N04,6785,27,1333960436,1333961092,21,8,656
8068835@N04,6785,17,1333961092,1333961349,11,8,257
8068835@N04,6785,13,1333961349,1333961622,3,8,273
8068835@N04,6785,18,1333961622,1333962962,7,8,1340
8068835@N04,6785,13,1333962962,1333963311,4,8,349
8068835@N04,6785,15,1333963311,1333963491,13,8,180
8068835@N04,6785,17,1333963698,1333965078,12,8,1380
8068835@N04,6785,27,1333968712,1333969912,9,8,1200
8068835@N04,6786,27,1409795733,1409796933,27,16,1200
8068835@N04,6786,1,1409798896,1409799496,9,16,600
8068835@N04,6786,2,1409799868,1409799958,11,16,90
8068835@N04,6786,26,1409806656,1409806836,58,16,180
8068835@N04,6786,17,1409807959,1409808123,5,16,164
8068835@N04,6786,18,1409808123,1409808683,17,16,560
8068835@N04,6786,26,1409808683,1409808765,4,16,82
8068835@N04,6786,22,1409808765,1409808790,4,16,25
8068835@N04,6786,18,1409808790,1409808790,3,16,0
8068835@N04,6786,22,1409808790,1409808818,2,16,28
8068835@N04,6786,18,1409808818,1409808850,7,16,32
8068835@N04,6786,19,1409808850,1409809270,13,16,420
8068835@N04,6786,13,1409811366,1409811556,8,16,190
8068835@N04,6786,12,1409811556,1409812396,4,16,840
8068835@N04,6786,15,1409816637,1409816817,5,16,180
8068835@N04,6786,27,1409820300,1409821500,35,16,1200
80722134@N00,6787,17,1237052697,1237054077,1,1,1380
80729198@N00,6788,27,1358340639,1358341839,17,1,1200
80729198@N00,6789,27,1370612468,1370613668,10,1,1200
80729198@N00,6790,27,1382006865,1382008065,27,1,1200
80730316@N05,6791,6,1421721895,1421722150,3,2,255
80730316@N05,6791,27,1421748040,1421749240,2,2,1200
8074702@N06,6792,27,1371435855,1371437055,1,1,1200
80749386@N05,6793,7,1342053564,1342053654,2,2,90
80749386@N05,6793,1,1342053848,1342054448,1,2,600
80775532@N06,6794,27,1442700507,1442701707,2,2,1200
80775532@N06,6794,26,1442706275,1442706455,1,2,180
8077563@N08,6795,27,1357935725,1357936925,1,1,1200
80784859@N00,6796,16,1307939713,1307940433,1,1,720
8078549@N07,6797,14,1255569506,1255569626,2,1,120
80852176@N00,6798,14,1430868520,1430868640,3,3,120
80852176@N00,6798,26,1430873656,1430873836,3,3,180
80852176@N00,6798,23,1430884250,1430884340,1,3,90
80852176@N00,6799,27,1431044804,1431046004,2,2,1200
80852176@N00,6799,25,1431049870,1431050620,1,2,750
80874876@N07,6800,27,1471171223,1471172423,1,1,1200
80874876@N07,6801,27,1471847444,1471848644,25,1,1200
8089996@N06,6802,14,1459829638,1459829758,6,1,120
80954242@N00,6803,27,1229377774,1229378974,9,1,1200
80954242@N00,6804,27,1244247936,1244249136,10,10,1200
80954242@N00,6804,18,1244264678,1244266478,7,10,1800
80954242@N00,6804,17,1244279680,1244280026,4,10,346
80954242@N00,6804,26,1244280026,1244280189,3,10,163
80954242@N00,6804,25,1244280189,1244280894,2,10,705
80954242@N00,6804,26,1244280894,1244280965,5,10,71
80954242@N00,6804,18,1244280965,1244282765,9,10,1800
80954242@N00,6804,26,1244283952,1244284132,15,10,180
80954242@N00,6804,18,1244284249,1244285004,31,10,755
80954242@N00,6804,25,1244285004,1244285754,1,10,750
80994469@N00,6805,13,1267759679,1267760279,2,2,600
80994469@N00,6805,18,1267768514,1267770314,1,2,1800
8100133@N05,6806,18,1413254073,1413255873,2,2,1800
8100133@N05,6806,1,1413263750,1413264350,1,2,600
8100133@N05,6807,2,1413296628,1413296718,1,1,90
81092458@N05,6808,2,1352165128,1352165218,2,2,90
81092458@N05,6808,16,1352172890,1352173610,1,2,720
81092458@N05,6809,14,1352373598,1352373718,1,1,120
81118954@N00,6810,27,1418806251,1418807451,1,1,1200
8116972@N07,6811,25,1417565638,1417566388,1,1,750
8116972@N07,6812,9,1417638934,1417639174,1,1,240
8116972@N07,6813,15,1417915091,1417915271,1,1,180
8124939@N07,6814,16,1200553348,1200554068,2,1,720
81291546@N02,6815,26,1343779820,1343780000,1,1,180
81291546@N02,6816,14,1357960492,1357960612,4,5,120
81291546@N02,6816,25,1357974874,1357975056,2,5,182
81291546@N02,6816,21,1357975056,1357975506,2,5,450
81291546@N02,6816,14,1357989014,1357989134,2,5,120
81291546@N02,6816,27,1357992587,1357993787,1,5,1200
81291546@N02,6817,17,1382340819,1382342199,2,2,1380
81291546@N02,6817,22,1382347926,1382348526,1,2,600
81291546@N02,6818,21,1403356202,1403356652,1,1,450
81291546@N02,6819,14,1408049290,1408049410,1,1,120
81292745@N00,6820,21,1305245908,1305246358,1,1,450
81309725@N00,6821,22,1330045645,1330046245,1,1,600
81322238@N00,6822,2,1274338665,1274338755,2,9,90
81322238@N00,6822,27,1274338759,1274339566,2,9,807
81322238@N00,6822,4,1274339566,1274340466,4,9,900
81322238@N00,6822,13,1274340730,1274341330,3,9,600
81322238@N00,6822,24,1274344756,1274345236,3,9,480
81322238@N00,6822,15,1274345664,1274345844,2,9,180
81322238@N00,6822,1,1274347446,1274348046,6,9,600
81322238@N00,6822,22,1274352576,1274353176,8,9,600
81322238@N00,6822,16,1274354553,1274355273,1,9,720
81322238@N00,6823,20,1398985474,1398986554,1,1,1080
8136496@N05,6824,19,1262219117,1262219537,6,3,420
8136496@N05,6824,16,1262225216,1262225936,2,3,720
8136496@N05,6824,11,1262244167,1262244347,5,3,180
81383122@N05,6825,1,1298505844,1298506444,3,2,600
81383122@N05,6825,17,1298509615,1298510995,4,2,1380
81383122@N05,6826,16,1298547908,1298548628,1,1,720
8141469@N07,6827,16,1197800918,1197801638,1,1,720
81431079@N00,6828,14,1353293206,1353293326,1,1,120
81475308@N00,6829,16,1436744915,1436745635,7,3,720
81475308@N00,6829,17,1436760797,1436762177,25,3,1380
81475308@N00,6829,27,1436782168,1436783368,16,3,1200
81546947@N00,6830,1,1193401083,1193401683,1,1,600
81704044@N06,6831,24,1365669360,1365669840,1,1,480
81704044@N06,6832,19,1366187057,1366187477,1,1,420
81704044@N06,6833,17,1367921821,1367923201,1,1,1380
81704044@N06,6834,16,1368916353,1368917073,1,1,720
81704044@N06,6835,13,1370507050,1370507650,1,1,600
81713706@N05,6836,12,1399176211,1399177051,4,3,840
81713706@N05,6836,7,1399186276,1399186366,7,3,90
81713706@N05,6836,15,1399189611,1399189791,5,3,180
81713706@N05,6837,8,1399369060,1399369083,2,4,23
81713706@N05,6837,7,1399369083,1399369102,3,4,19
81713706@N05,6837,8,1399369102,1399369118,4,4,16
81713706@N05,6837,7,1399369118,1399369208,2,4,90
81713706@N05,6838,13,1399541732,1399542332,1,1,600
81713774@N03,6839,14,1445639576,1445639696,1,1,120
81714212@N05,6840,17,1415423311,1415424691,1,1,1380
8177037@N06,6841,27,1339103950,1339105150,27,1,1200
8177037@N06,6842,27,1372020702,1372021902,81,1,1200
81834077@N00,6843,16,1214368625,1214369345,10,2,720
81834077@N00,6843,27,1214408259,1214409459,1,2,1200
8184900@N02,6844,2,1383772638,1383772728,1,1,90
81855582@N00,6845,27,1255064847,1255066047,4,1,1200
81932021@N00,6846,9,1230068772,1230069012,3,1,240
81932021@N00,6847,9,1230107459,1230107699,1,1,240
8193351@N03,6848,27,1283372324,1283372888,2,3,564
8193351@N03,6848,14,1283372888,1283373008,4,3,120
8193351@N03,6848,4,1283376495,1283377395,6,3,900
81938914@N00,6849,16,1271541973,1271542693,2,5,720
81938914@N00,6849,3,1271563358,1271563364,2,5,6
81938914@N00,6849,2,1271563364,1271563376,2,5,12
81938914@N00,6849,1,1271563376,1271563814,2,5,438
81938914@N00,6849,4,1271563814,1271564714,1,5,900
82109786@N06,6850,10,1430620863,1430620866,2,4,3
82109786@N06,6850,17,1430620866,1430622246,2,4,1380
82109786@N06,6850,26,1430622957,1430623137,3,4,180
82109786@N06,6850,9,1430627588,1430627828,1,4,240
82109786@N06,6851,7,1430952052,1430952142,3,1,90
82109786@N06,6852,17,1445152667,1445153986,2,3,1319
82109786@N06,6852,15,1445153986,1445153989,2,3,3
82109786@N06,6852,12,1445153989,1445154829,13,3,840
82109786@N06,6853,27,1445219922,1445221122,4,1,1200
82109786@N06,6854,8,1461895827,1461895947,4,3,120
82109786@N06,6854,1,1461896011,1461896611,2,3,600
82109786@N06,6854,27,1461911899,1461913099,1,3,1200
82109786@N06,6855,13,1462231372,1462231378,2,2,6
82109786@N06,6855,17,1462231378,1462232758,2,2,1380
82211889@N00,6856,16,1326332133,1326332853,2,2,720
82211889@N00,6856,2,1326337857,1326337947,2,2,90
82211889@N00,6857,16,1326493419,1326494139,16,6,720
82211889@N00,6857,9,1326497760,1326498000,6,6,240
82211889@N00,6857,18,1326501125,1326501776,5,6,651
82211889@N00,6857,19,1326501776,1326502196,7,6,420
82211889@N00,6857,18,1326502511,1326504249,2,6,1738
82211889@N00,6857,16,1326504249,1326504969,18,6,720
82211889@N00,6858,16,1326613749,1326614469,1,1,720
82211889@N00,6859,27,1326697879,1326699079,48,1,1200
82211889@N00,6860,6,1326771225,1326771480,2,1,255
82211889@N00,6861,27,1459159644,1459160844,2,1,1200
82211889@N00,6862,14,1459314744,1459314864,3,5,120
82211889@N00,6862,6,1459315819,1459316039,4,5,220
82211889@N00,6862,7,1459316039,1459316068,2,5,29
82211889@N00,6862,6,1459316068,1459316323,2,5,255
82211889@N00,6862,27,1459329286,1459330486,1,5,1200
82211889@N00,6863,10,1459549065,1459549485,2,4,420
82211889@N00,6863,9,1459549980,1459550220,3,4,240
82211889@N00,6863,25,1459551044,1459551794,2,4,750
82211889@N00,6863,21,1459552688,1459553138,1,4,450
82251283@N08,6864,27,1421883126,1421884326,10,3,1200
82251283@N08,6864,14,1421886880,1421887000,10,3,120
82251283@N08,6864,15,1421888724,1421888904,2,3,180
8226446@N06,6865,2,1273054084,1273054174,15,2,90
8226446@N06,6865,4,1273056969,1273057869,7,2,900
8226892@N07,6866,27,1394022088,1394023288,52,1,1200
82335642@N00,6867,16,1258781330,1258782050,7,9,720
82335642@N00,6867,4,1258785073,1258785177,2,9,104
82335642@N00,6867,16,1258785177,1258785456,3,9,279
82335642@N00,6867,2,1258785456,1258785546,3,9,90
82335642@N00,6867,9,1258787785,1258787884,2,9,99
82335642@N00,6867,14,1258787884,1258788004,2,9,120
82335642@N00,6867,15,1258788561,1258788741,9,9,180
82335642@N00,6867,17,1258790377,1258790630,2,9,253
82335642@N00,6867,16,1258790630,1258791350,4,9,720
82335642@N00,6868,2,1258883119,1258883209,4,3,90
82335642@N00,6868,21,1258887148,1258887598,2,3,450
82335642@N00,6868,16,1258891440,1258892160,6,3,720
82335642@N00,6869,16,1259063168,1259063888,7,1,720
82418556@N00,6870,14,1357860049,1357860169,4,6,120
82418556@N00,6870,10,1357865948,1357866368,3,6,420
82418556@N00,6870,8,1357867748,1357867859,2,6,111
82418556@N00,6870,13,1357867859,1357868459,2,6,600
82418556@N00,6870,16,1357872804,1357873524,2,6,720
82418556@N00,6870,10,1357874174,1357874594,2,6,420
82418556@N00,6871,1,1357924458,1357924703,2,8,245
82418556@N00,6871,27,1357924703,1357924764,2,8,61
82418556@N00,6871,16,1357924764,1357925484,2,8,720
82418556@N00,6871,20,1357926067,1357927147,2,8,1080
82418556@N00,6871,27,1357935332,1357935478,2,8,146
82418556@N00,6871,4,1357935478,1357935721,3,8,243
82418556@N00,6871,14,1357935721,1357935777,2,8,56
82418556@N00,6871,16,1357935777,1357936497,2,8,720
82418556@N00,6872,16,1358010827,1358011547,2,5,720
82418556@N00,6872,14,1358021520,1358021640,3,5,120
82418556@N00,6872,16,1358036475,1358037195,2,5,720
82418556@N00,6872,24,1358043666,1358044146,3,5,480
82418556@N00,6872,14,1358056307,1358056427,1,5,120
82418556@N00,6873,16,1358224523,1358225243,1,1,720
82418556@N00,6874,16,1380758953,1380759673,2,12,720
82418556@N00,6874,17,1380763668,1380764077,2,12,409
82418556@N00,6874,14,1380764077,1380764197,2,12,120
82418556@N00,6874,11,1380767061,1380767241,2,12,180
82418556@N00,6874,10,1380767542,1380767962,2,12,420
82418556@N00,6874,8,1380770358,1380770478,2,12,120
82418556@N00,6874,3,1380770935,1380771205,2,12,270
82418556@N00,6874,1,1380771565,1380772165,2,12,600
82418556@N00,6874,2,1380772980,1380773070,2,12,90
82418556@N00,6874,20,1380775391,1380776471,3,12,1080
82418556@N00,6874,19,1380777535,1380777955,2,12,420
82418556@N00,6874,23,1380782117,1380782207,1,12,90
82418556@N00,6875,27,1389320402,1389321602,2,2,1200
82418556@N00,6875,16,1389324340,1389325060,1,2,720
82418556@N00,6876,10,1389405637,1389406057,1,1,420
82418556@N00,6877,14,1398997826,1398997946,3,3,120
82418556@N00,6877,27,1399011902,1399013102,2,3,1200
82418556@N00,6877,1,1399020383,1399020983,1,3,600
82418556@N00,6878,14,1399177910,1399178030,1,1,120
82432080@N00,6879,12,1317347605,1317348445,2,2,840
82432080@N00,6879,9,1317349930,1317350170,1,2,240
82432080@N00,6880,20,1317604031,1317605111,3,5,1080
82432080@N00,6880,14,1317605660,1317605780,2,5,120
82432080@N00,6880,16,1317608140,1317608672,2,5,532
82432080@N00,6880,27,1317608672,1317609872,3,5,1200
82432080@N00,6880,5,1317611597,1317612317,1,5,720
82507219@N08,6881,5,1381220083,1381220803,1,1,720
82539779@N00,6882,16,1196505359,1196506079,1,1,720
82541612@N00,6883,24,1395114761,1395115241,2,2,480
82541612@N00,6883,12,1395141666,1395142506,2,2,840
82624704@N00,6884,18,1273916472,1273917872,14,4,1400
82624704@N00,6884,14,1273917872,1273917992,4,4,120
82624704@N00,6884,8,1273919306,1273919426,17,4,120
82624704@N00,6884,5,1273920762,1273921482,3,4,720
82624704@N00,6885,27,1274095984,1274097184,26,4,1200
82624704@N00,6885,2,1274100855,1274100945,4,4,90
82624704@N00,6885,17,1274101188,1274101263,3,4,75
82624704@N00,6885,14,1274101263,1274101383,15,4,120
82624704@N00,6886,27,1274233017,1274233556,5,6,539
82624704@N00,6886,18,1274233556,1274235356,6,6,1800
82624704@N00,6886,6,1274240726,1274240812,4,6,86
82624704@N00,6886,1,1274240812,1274240989,2,6,177
82624704@N00,6886,2,1274240989,1274241079,5,6,90
82624704@N00,6886,18,1274245098,1274246898,16,6,1800
82647132@N03,6887,9,1443501466,1443501706,1,1,240
82651370@N03,6888,27,1381811946,1381813146,1,1,1200
82651989@N00,6889,6,1321491100,1321491355,2,3,255
82651989@N00,6889,16,1321492117,1321492400,2,3,283
82651989@N00,6889,9,1321492400,1321492640,1,3,240
82688850@N02,6890,16,1292219982,1292220166,2,2,184
82688850@N02,6890,17,1292220166,1292221546,1,2,1380
82697718@N07,6891,14,1422841395,1422841515,2,2,120
82697718@N07,6891,22,1422851961,1422852561,1,2,600
8270603@N02,6892,27,1368582887,1368584087,2,13,1200
8270603@N02,6892,25,1368586258,1368587008,2,13,750
8270603@N02,6892,22,1368588826,1368589004,4,13,178
8270603@N02,6892,26,1368589004,1368589184,3,13,180
8270603@N02,6892,17,1368589472,1368590852,3,13,1380
8270603@N02,6892,15,1368591802,1368591982,2,13,180
8270603@N02,6892,14,1368594008,1368594128,4,13,120
8270603@N02,6892,10,1368594286,1368594706,6,13,420
8270603@N02,6892,9,1368594755,1368594995,6,13,240
8270603@N02,6892,17,1368598649,1368600029,3,13,1380
8270603@N02,6892,9,1368603075,1368603315,2,13,240
8270603@N02,6892,4,1368604697,1368605597,2,13,900
8270603@N02,6892,16,1368608773,1368609493,1,13,720
82746306@N00,6893,16,1247792104,1247792686,4,7,582
82746306@N00,6893,18,1247792686,1247793319,2,7,633
82746306@N00,6893,19,1247793319,1247793739,2,7,420
82746306@N00,6893,7,1247814496,1247814586,2,7,90
82746306@N00,6893,16,1247818151,1247818871,2,7,720
82746306@N00,6893,27,1247827324,1247827967,3,7,643
82746306@N00,6893,16,1247827967,1247828687,16,7,720
82746306@N00,6894,16,1248426869,1248427282,4,3,413
82746306@N00,6894,14,1248427282,1248427402,2,3,120
82746306@N00,6894,16,1248435316,1248436036,7,3,720
8280384@N03,6895,21,1300326963,1300327413,1,1,450
8282554@N06,6896,1,1278293951,1278294551,2,2,600
8282554@N06,6896,5,1278295923,1278296643,1,2,720
8282554@N06,6897,27,1279795122,1279796322,1,1,1200
8282554@N06,6898,2,1324344565,1324344655,1,1,90
82841979@N04,6899,10,1398479372,1398479792,1,1,420
82841979@N04,6900,23,1436586537,1436586627,1,1,90
8285785@N06,6901,27,1404821972,1404823172,10,1,1200
82893865@N00,6902,14,1403051218,1403051338,2,2,120
82893865@N00,6902,22,1403068351,1403068951,1,2,600
8290293@N02,6903,19,1227833214,1227833634,2,2,420
8290293@N02,6903,16,1227837588,1227838308,2,2,720
8297555@N02,6904,27,1240112437,1240113637,2,2,1200
8297555@N02,6904,20,1240122426,1240123506,2,2,1080
8298273@N05,6905,20,1435113625,1435114705,1,1,1080
83035350@N06,6906,15,1362784291,1362784471,2,3,180
83035350@N06,6906,14,1362784716,1362784836,2,3,120
83035350@N06,6906,17,1362786470,1362787850,1,3,1380
83083483@N04,6907,14,1399465665,1399465785,2,2,120
83083483@N04,6907,9,1399479888,1399480128,1,2,240
83088992@N06,6908,27,1366051482,1366052682,1,1,1200
83092888@N03,6909,21,1379150019,1379150469,2,2,450
83092888@N03,6909,27,1379155677,1379156877,2,2,1200
83092888@N03,6910,27,1379369305,1379370505,1,1,1200
83092888@N03,6911,27,1380107321,1380108521,1,1,1200
83092888@N03,6912,20,1380280432,1380281512,1,1,1080
83106697@N00,6913,14,1225235880,1225236000,4,3,120
83106697@N00,6913,20,1225240552,1225241632,2,3,1080
83106697@N00,6913,4,1225250580,1225251480,2,3,900
83106697@N00,6914,8,1354491263,1354491383,3,3,120
83106697@N00,6914,14,1354496911,1354497031,2,3,120
83106697@N00,6914,16,1354514328,1354515048,1,3,720
83106697@N00,6915,6,1354586667,1354586922,3,3,255
83106697@N00,6915,2,1354589461,1354589551,3,3,90
83106697@N00,6915,16,1354598005,1354598725,2,3,720
8311873@N03,6916,27,1346808360,1346809560,1,1,1200
8311873@N03,6917,13,1349213832,1349214432,3,1,600
8311873@N03,6918,25,1351457799,1351458432,2,10,633
8311873@N03,6918,24,1351458432,1351458912,5,10,480
8311873@N03,6918,23,1351458974,1351459064,2,10,90
8311873@N03,6918,21,1351459168,1351459618,10,10,450
8311873@N03,6918,20,1351480193,1351480396,4,10,203
8311873@N03,6918,18,1351480396,1351480554,3,10,158
8311873@N03,6918,15,1351480554,1351480651,2,10,97
8311873@N03,6918,9,1351480651,1351480725,2,10,74
8311873@N03,6918,5,1351480725,1351480813,2,10,88
8311873@N03,6918,3,1351480813,1351481083,1,10,270
8311873@N03,6919,13,1354421359,1354421959,3,2,600
8311873@N03,6919,23,1354422633,1354422723,1,2,90
8311873@N03,6920,14,1354518064,1354518184,1,1,120
8311873@N03,6921,13,1357110012,1357110612,1,1,600
8311873@N03,6922,16,1365589469,1365589651,2,4,182
8311873@N03,6922,21,1365589651,1365589969,2,4,318
8311873@N03,6922,16,1365589969,1365590549,2,4,580
8311873@N03,6922,4,1365590549,1365591449,1,4,900
8311873@N03,6923,27,1392784728,1392785928,5,1,1200
8311873@N03,6924,27,1392875494,1392876694,3,1,1200
8311873@N03,6925,27,1393828779,1393829662,2,3,883
8311873@N03,6925,2,1393829662,1393829752,2,3,90
8311873@N03,6925,4,1393832455,1393833355,1,3,900
8311873@N03,6926,20,1394099464,1394099719,2,2,255
8311873@N03,6926,27,1394099719,1394100919,1,2,1200
8311873@N03,6927,6,1394441617,1394441872,1,1,255
8311873@N03,6928,27,1394522043,1394523243,1,1,1200
8311873@N03,6929,16,1401271711,1401272431,10,1,720
8311873@N03,6930,16,1401309696,1401310416,9,1,720
8311873@N03,6931,27,1419673174,1419673428,2,2,254
8311873@N03,6931,16,1419673428,1419674148,2,2,720
8311873@N03,6932,8,1420017526,1420017646,1,1,120
8311873@N03,6933,9,1420957769,1420958009,3,6,240
8311873@N03,6933,16,1420958401,1420959011,3,6,610
8311873@N03,6933,27,1420959011,1420959236,2,6,225
8311873@N03,6933,16,1420959236,1420959371,2,6,135
8311873@N03,6933,9,1420959371,1420959611,2,6,240
8311873@N03,6933,16,1420959960,1420960680,1,6,720
8311873@N03,6934,27,1421130689,1421131889,1,1,1200
8311873@N03,6935,14,1422172081,1422172201,3,1,120
8311873@N03,6936,8,1423436557,1423436677,2,2,120
8311873@N03,6936,14,1423464162,1423464282,3,2,120
8311873@N03,6937,14,1423894003,1423894123,1,1,120
8311873@N03,6938,15,1424424805,1424424985,1,1,180
8311873@N03,6939,27,1431992185,1431993385,1,1,1200
83133472@N05,6940,1,1300501318,1300501918,1,1,600
83133472@N05,6941,6,1347671024,1347671279,1,1,255
83133472@N05,6942,18,1360215197,1360215882,2,3,685
83133472@N05,6942,25,1360215882,1360216632,2,3,750
83133472@N05,6942,16,1360226490,1360227210,1,3,720
83133472@N05,6943,16,1368955996,1368956716,1,1,720
83133472@N05,6944,16,1369315300,1369316020,1,1,720
83133472@N05,6945,16,1369399891,1369400611,1,1,720
83133472@N05,6946,14,1370589143,1370589263,2,2,120
83133472@N05,6946,27,1370591689,1370592889,1,2,1200
83133472@N05,6947,24,1370698772,1370699252,1,1,480
83133472@N05,6948,16,1374311504,1374312224,1,1,720
83133472@N05,6949,1,1374838064,1374838664,1,1,600
83133472@N05,6950,16,1376208488,1376209208,1,1,720
83133472@N05,6951,27,1376471837,1376473037,1,1,1200
83133472@N05,6952,27,1385785929,1385787129,1,1,1200
83133472@N05,6953,27,1386058936,1386060136,1,1,1200
83133472@N05,6954,13,1397825450,1397826050,1,1,600
83133472@N05,6955,27,1400243056,1400243120,2,4,64
83133472@N05,6955,22,1400243120,1400243543,2,4,423
83133472@N05,6955,27,1400243543,1400243986,5,4,443
83133472@N05,6955,16,1400243986,1400244706,1,4,720
83133472@N05,6956,16,1400321596,1400322316,1,1,720
83133472@N05,6957,27,1410512530,1410513730,1,1,1200
83133472@N05,6958,27,1421050108,1421050196,2,2,88
83133472@N05,6958,1,1421050196,1421050796,1,2,600
83167112@N06,6959,15,1389156879,1389157059,1,1,180
83167112@N06,6960,27,1416475783,1416476983,1,1,1200
83168551@N00,6961,6,1233544738,1233544993,1,1,255
83206670@N05,6962,27,1314162738,1314163938,2,7,1200
83206670@N05,6962,23,1314169264,1314169354,3,7,90
83206670@N05,6962,25,1314173995,1314174080,3,7,85
83206670@N05,6962,23,1314174080,1314174091,2,7,11
83206670@N05,6962,25,1314174091,1314174537,4,7,446
83206670@N05,6962,23,1314174537,1314174627,5,7,90
83206670@N05,6962,17,1314181323,1314182703,32,7,1380
83206670@N05,6963,27,1314656665,1314657865,4,1,1200
8325414@N05,6964,14,1296279565,1296279685,2,3,120
8325414@N05,6964,12,1296284314,1296285154,2,3,840
8325414@N05,6964,14,1296286883,1296287003,1,3,120
8327824@N05,6965,16,1354724999,1354725719,8,1,720
8327824@N05,6966,16,1356664011,1356664130,3,4,119
8327824@N05,6966,10,1356664130,1356664550,2,4,420
8327824@N05,6966,16,1356667370,1356668090,2,4,720
8327824@N05,6966,10,1356692782,1356693202,1,4,420
83286805@N00,6967,23,1320607299,1320607389,1,1,90
8348059@N02,6968,8,1223460962,1223461082,1,1,120
8348059@N02,6969,27,1300655037,1300656146,4,32,1109
8348059@N02,6969,9,1300656146,1300656386,2,32,240
8348059@N02,6969,15,1300656460,1300656640,5,32,180
8348059@N02,6969,9,1300657283,1300657523,8,32,240
8348059@N02,6969,12,1300658887,1300659727,25,32,840
8348059@N02,6969,9,1300659936,1300660120,2,32,184
8348059@N02,6969,2,1300660120,1300660210,4,32,90
8348059@N02,6969,3,1300662669,1300662939,2,32,270
8348059@N02,6969,2,1300663276,1300663308,2,32,32
8348059@N02,6969,1,1300663308,1300663604,3,32,296
8348059@N02,6969,6,1300663604,1300663631,2,32,27
8348059@N02,6969,1,1300663631,1300663763,2,32,132
8348059@N02,6969,5,1300663763,1300663979,2,32,216
8348059@N02,6969,3,1300663979,1300664091,2,32,112
8348059@N02,6969,2,1300664091,1300664172,2,32,81
8348059@N02,6969,4,1300664172,1300664380,2,32,208
8348059@N02,6969,17,1300664380,1300664535,2,32,155
8348059@N02,6969,25,1300664535,1300664829,3,32,294
8348059@N02,6969,21,1300664829,1300665279,4,32,450
8348059@N02,6969,17,1300665967,1300667347,2,32,1380
8348059@N02,6969,13,1300667843,1300668443,4,32,600
8348059@N02,6969,17,1300669510,1300669766,3,32,256
8348059@N02,6969,24,1300669766,1300670246,19,32,480
8348059@N02,6969,21,1300670817,1300671267,7,32,450
8348059@N02,6969,19,1300672309,1300672729,4,32,420
8348059@N02,6969,20,1300672896,1300673141,2,32,245
8348059@N02,6969,19,1300673141,1300673561,4,32,420
8348059@N02,6969,18,1300676196,1300676575,2,32,379
8348059@N02,6969,17,1300676575,1300677955,22,32,1380
8348059@N02,6969,27,1300683785,1300684985,9,32,1200
8348059@N02,6969,4,1300699559,1300700459,36,32,900
8348059@N02,6969,27,1300708348,1300709548,1,32,1200
8348059@N02,6970,27,1448974877,1448976077,2,37,1200
8348059@N02,6970,10,1448978402,1448978822,2,37,420
8348059@N02,6970,27,1449003804,1449005004,5,37,1200
8348059@N02,6970,10,1449007364,1449007784,4,37,420
8348059@N02,6970,8,1449008322,1449008442,2,37,120
8348059@N02,6970,7,1449008499,1449008589,3,37,90
8348059@N02,6970,10,1449008679,1449009099,4,37,420
8348059@N02,6970,12,1449009301,1449009606,7,37,305
8348059@N02,6970,13,1449009606,1449009723,2,37,117
8348059@N02,6970,12,1449009723,1449010109,5,37,386
8348059@N02,6970,15,1449010109,1449010162,2,37,53
8348059@N02,6970,13,1449010162,1449010762,3,37,600
8348059@N02,6970,17,1449011132,1449011287,2,37,155
8348059@N02,6970,26,1449011287,1449011467,3,37,180
8348059@N02,6970,19,1449011994,1449012414,2,37,420
8348059@N02,6970,20,1449012498,1449013578,3,37,1080
8348059@N02,6970,21,1449014188,1449014478,2,37,290
8348059@N02,6970,23,1449014478,1449014568,2,37,90
8348059@N02,6970,15,1449015238,1449015418,3,37,180
8348059@N02,6970,27,1449018031,1449018457,3,37,426
8348059@N02,6970,19,1449018457,1449018553,2,37,96
8348059@N02,6970,4,1449018553,1449018996,2,37,443
8348059@N02,6970,17,1449018996,1449020376,4,37,1380
8348059@N02,6970,22,1449023593,1449024069,2,37,476
8348059@N02,6970,23,1449024069,1449024159,5,37,90
8348059@N02,6970,27,1449026073,1449027273,5,37,1200
8348059@N02,6970,17,1449029750,1449031130,17,37,1380
8348059@N02,6970,27,1449031223,1449032423,2,37,1200
8348059@N02,6970,17,1449047747,1449049109,2,37,1362
8348059@N02,6970,14,1449049109,1449049229,3,37,120
8348059@N02,6970,12,1449049656,1449049973,3,37,317
8348059@N02,6970,14,1449049973,1449050093,2,37,120
8348059@N02,6970,12,1449050449,1449050877,2,37,428
8348059@N02,6970,14,1449050877,1449050997,11,37,120
8348059@N02,6970,16,1449056691,1449056721,2,37,30
8348059@N02,6970,14,1449056721,1449056841,2,37,120
8348059@N02,6970,27,1449059934,1449061134,2,37,1200
8348059@N02,6971,27,1449111956,1449113156,3,9,1200
8348059@N02,6971,17,1449114848,1449116228,11,9,1380
8348059@N02,6971,21,1449128247,1449128697,3,9,450
8348059@N02,6971,20,1449129026,1449130106,2,9,1080
8348059@N02,6971,22,1449131031,1449131631,2,9,600
8348059@N02,6971,24,1449131891,1449132371,4,9,480
8348059@N02,6971,9,1449135063,1449135303,3,9,240
8348059@N02,6971,17,1449141630,1449143010,7,9,1380
8348059@N02,6971,27,1449145070,1449146270,5,9,1200
83599989@N00,6972,26,1351054508,1351054688,1,1,180
83657528@N00,6973,1,1299903924,1299904524,1,1,600
8372417@N05,6974,10,1437352343,1437352763,2,3,420
8372417@N05,6974,7,1437364090,1437364180,3,3,90
8372417@N05,6974,9,1437387303,1437387543,1,3,240
83794242@N07,6975,27,1435826836,1435828036,1,1,1200
83794242@N07,6976,21,1449282208,1449282658,1,1,450
83825280@N06,6977,20,1356835813,1356836893,1,1,1080
83825280@N06,6978,14,1358758998,1358759118,1,1,120
83825280@N06,6979,9,1359173175,1359173415,1,1,240
83825280@N06,6980,12,1362283540,1362284380,1,1,840
83825280@N06,6981,22,1362690460,1362691060,1,1,600
83848625@N00,6982,6,1456104030,1456104285,2,3,255
83848625@N00,6982,17,1456129746,1456130078,2,3,332
83848625@N00,6982,16,1456130078,1456130798,1,3,720
8391606@N06,6983,4,1210341253,1210342153,1,1,900
83935707@N00,6984,27,1240272702,1240273195,5,9,493
83935707@N00,6984,25,1240273195,1240273945,2,9,750
83935707@N00,6984,6,1240276703,1240276958,2,9,255
83935707@N00,6984,20,1240279542,1240280383,2,9,841
83935707@N00,6984,17,1240280383,1240281173,2,9,790
83935707@N00,6984,18,1240281173,1240282973,2,9,1800
83935707@N00,6984,6,1240283301,1240283556,2,9,255
83935707@N00,6984,5,1240285277,1240285997,2,9,720
83935707@N00,6984,6,1240286797,1240287052,3,9,255
83935707@N00,6985,27,1271893230,1271893893,4,9,663
83935707@N00,6985,4,1271893893,1271894793,2,9,900
83935707@N00,6985,1,1271896849,1271897449,2,9,600
83935707@N00,6985,4,1271897512,1271897614,2,9,102
83935707@N00,6985,1,1271897614,1271898214,2,9,600
83935707@N00,6985,6,1271898501,1271898756,2,9,255
83935707@N00,6985,9,1271901129,1271901322,3,9,193
83935707@N00,6985,6,1271901322,1271901577,2,9,255
83935707@N00,6985,19,1271913880,1271914300,1,9,420
83935707@N00,6986,27,1302993829,1302995029,1,1,1200
84013956@N00,6987,25,1325212412,1325213162,2,1,750
84013956@N00,6988,2,1325304355,1325304445,1,1,90
84013956@N00,6989,27,1357931263,1357932463,4,1,1200
84013956@N00,6990,27,1358018484,1358019684,6,1,1200
8404074@N04,6991,16,1214753757,1214754477,1,1,720
84057311@N04,6992,16,1415596665,1415597385,1,1,720
84057311@N04,6993,16,1415769000,1415769720,1,1,720
84057763@N00,6994,27,1453001078,1453002278,1,1,1200
84057763@N00,6995,27,1453368280,1453369480,1,1,1200
8405842@N02,6996,27,1235688812,1235690012,8,11,1200
8405842@N02,6996,23,1235691067,1235691157,2,11,90
8405842@N02,6996,21,1235691161,1235691611,5,11,450
8405842@N02,6996,20,1235692746,1235693641,3,11,895
8405842@N02,6996,26,1235693641,1235693821,3,11,180
8405842@N02,6996,20,1235695417,1235696497,3,11,1080
8405842@N02,6996,18,1235699097,1235700529,4,11,1432
8405842@N02,6996,15,1235700529,1235700709,2,11,180
8405842@N02,6996,9,1235703696,1235703779,2,11,83
8405842@N02,6996,6,1235703779,1235704034,2,11,255
8405842@N02,6996,4,1235707079,1235707979,1,11,900
8405842@N02,6997,27,1235898916,1235900116,2,1,1200
84132551@N00,6998,27,1450902610,1450903810,1,1,1200
8416606@N06,6999,9,1290757125,1290757365,1,1,240
84168064@N02,7000,19,1445814489,1445814909,2,4,420
84168064@N02,7000,26,1445833105,1445833285,3,4,180
84168064@N02,7000,17,1445833521,1445834901,4,4,1380
84168064@N02,7000,26,1445854894,1445855074,1,4,180
84169004@N00,7001,27,1228272720,1228273920,1,1,1200
84169004@N00,7002,20,1228525200,1228525560,3,5,360
84169004@N00,7002,23,1228525560,1228525650,3,5,90
84169004@N00,7002,14,1228526340,1228526460,2,5,120
84169004@N00,7002,15,1228526520,1228526700,2,5,180
84169004@N00,7002,27,1228527480,1228528680,4,5,1200
84169004@N00,7003,2,1228612740,1228612830,2,3,90
84169004@N00,7003,6,1228613940,1228614195,7,3,255
84169004@N00,7003,9,1228616160,1228616400,1,3,240
84169004@N00,7004,27,1228700040,1228700580,2,2,540
84169004@N00,7004,16,1228700580,1228701300,2,2,720
84169004@N00,7005,9,1228872060,1228872300,3,3,240
84169004@N00,7005,8,1228872720,1228872840,3,3,120
84169004@N00,7005,22,1228873680,1228874280,1,3,600
84169004@N00,7006,14,1228957380,1228957500,1,1,120
84169004@N00,7007,19,1386133229,1386133649,1,1,420
84169004@N00,7008,18,1386483981,1386485605,2,2,1624
84169004@N00,7008,17,1386485605,1386486985,1,2,1380
84221632@N00,7009,19,1359266091,1359266511,2,2,420
84221632@N00,7009,13,1359272231,1359272831,1,2,600
84221632@N00,7010,10,1359691299,1359691719,1,1,420
84221632@N00,7011,27,1381896445,1381897645,2,2,1200
84221632@N00,7011,19,1381898594,1381899014,1,2,420
84221632@N00,7012,18,1423049310,1423051110,1,1,1800
84221632@N00,7013,15,1423563228,1423563408,1,1,180
84227486@N02,7014,14,1354744530,1354744650,3,3,120
84227486@N02,7014,19,1354748902,1354749322,4,3,420
84227486@N02,7014,10,1354750162,1354750582,24,3,420
84227486@N02,7015,27,1354868539,1354869231,3,2,692
84227486@N02,7015,14,1354869231,1354869351,1,2,120
84227486@N02,7016,12,1366159510,1366160350,1,1,840
84227486@N02,7017,10,1366423618,1366424038,1,1,420
84227486@N02,7018,3,1374532741,1374533011,2,3,270
84227486@N02,7018,14,1374533580,1374533700,2,3,120
84227486@N02,7018,8,1374537300,1374537420,2,3,120
84227486@N02,7019,10,1374661165,1374661585,2,3,420
84227486@N02,7019,6,1374661886,1374662141,2,3,255
84227486@N02,7019,27,1374663490,1374664690,1,3,1200
84227486@N02,7020,14,1396144957,1396145077,2,2,120
84227486@N02,7020,4,1396148403,1396149303,2,2,900
84227486@N02,7021,15,1429058206,1429058386,1,1,180
84227486@N02,7022,8,1429249228,1429249348,4,1,120
84337669@N04,7023,16,1378036390,1378037110,1,1,720
84376126@N03,7024,22,1369024892,1369025492,2,4,600
84376126@N03,7024,16,1369026180,1369026258,3,4,78
84376126@N03,7024,27,1369026258,1369027458,5,4,1200
84376126@N03,7024,4,1369028578,1369029478,2,4,900
84496998@N00,7025,16,1257412281,1257413001,7,1,720
84512908@N07,7026,16,1442550619,1442551339,1,1,720
84512908@N07,7027,27,1448025359,1448026559,1,1,1200
84531937@N00,7028,16,1309297921,1309298641,2,2,720
84531937@N00,7028,18,1309301337,1309303137,2,2,1800
8459320@N03,7029,14,1246580326,1246580446,2,4,120
8459320@N03,7029,19,1246583927,1246584347,2,4,420
8459320@N03,7029,20,1246587518,1246588598,8,4,1080
8459320@N03,7029,9,1246597774,1246598014,1,4,240
8459320@N03,7030,27,1246663310,1246664510,6,1,1200
84624316@N03,7031,27,1330919197,1330920397,2,1,1200
84687470@N00,7032,16,1322894254,1322894974,1,1,720
84697271@N00,7033,16,1389376421,1389377141,1,1,720
84697271@N00,7034,16,1389462416,1389463136,1,1,720
84713471@N00,7035,15,1377730683,1377730863,2,3,180
84713471@N00,7035,9,1377732407,1377732647,2,3,240
84713471@N00,7035,20,1377733282,1377734362,1,3,1080
8476511@N03,7036,13,1304669876,1304670476,20,1,600
84808392@N03,7037,10,1373711779,1373712199,1,1,420
84824340@N07,7038,27,1409974502,1409975702,2,3,1200
84824340@N07,7038,22,1409984081,1409984431,2,3,350
84824340@N07,7038,19,1409984431,1409984851,1,3,420
84827867@N00,7039,19,1369606560,1369606980,2,1,420
84861343@N00,7040,2,1330647292,1330647382,3,1,90
84861343@N00,7041,14,1370745051,1370745171,2,2,120
84861343@N00,7041,1,1370758411,1370759011,1,2,600
84861343@N00,7042,2,1423630363,1423630453,1,1,90
84861343@N00,7043,7,1423798331,1423798421,1,1,90
84897223@N00,7044,15,1434022947,1434023127,1,1,180
8502118@N08,7045,14,1420010808,1420010928,2,3,120
8502118@N08,7045,13,1420015829,1420016429,3,3,600
8502118@N08,7045,27,1420020819,1420022019,5,3,1200
85095974@N05,7046,27,1374667257,1374668457,4,1,1200
85095974@N05,7047,2,1402669231,1402669238,2,2,7
85095974@N05,7047,4,1402669238,1402670138,2,2,900
85095974@N05,7048,10,1434447510,1434447930,9,7,420
85095974@N05,7048,15,1434455410,1434455413,3,7,3
85095974@N05,7048,12,1434455413,1434455546,13,7,133
85095974@N05,7048,13,1434455546,1434455602,5,7,56
85095974@N05,7048,12,1434455602,1434455652,6,7,50
85095974@N05,7048,13,1434455652,1434455826,15,7,174
85095974@N05,7048,12,1434455826,1434456666,2,7,840
85095974@N05,7049,3,1434539279,1434539456,7,4,177
85095974@N05,7049,2,1434539456,1434539546,7,4,90
85095974@N05,7049,3,1434539569,1434539587,4,4,18
85095974@N05,7049,2,1434539587,1434539677,10,4,90
85095974@N05,7050,13,1470354935,1470355535,2,13,600
85095974@N05,7050,15,1470356112,1470356210,6,13,98
85095974@N05,7050,12,1470356210,1470356562,17,13,352
85095974@N05,7050,13,1470356562,1470356762,6,13,200
85095974@N05,7050,15,1470356762,1470356942,2,13,180
85095974@N05,7050,16,1470357487,1470358207,2,13,720
85095974@N05,7050,15,1470358883,1470359063,2,13,180
85095974@N05,7050,17,1470360777,1470362157,4,13,1380
85095974@N05,7050,15,1470362801,1470362981,3,13,180
85095974@N05,7050,20,1470366361,1470367441,3,13,1080
85095974@N05,7050,4,1470387357,1470388257,2,13,900
85095974@N05,7050,25,1470392186,1470392548,3,13,362
85095974@N05,7050,4,1470392548,1470393448,3,13,900
85095974@N05,7051,9,1470439953,1470440193,3,9,240
85095974@N05,7051,19,1470444113,1470444533,5,9,420
85095974@N05,7051,25,1470467141,1470467161,2,9,20
85095974@N05,7051,23,1470467161,1470467251,5,9,90
85095974@N05,7051,25,1470469765,1470470515,8,9,750
85095974@N05,7051,22,1470470752,1470470787,2,9,35
85095974@N05,7051,26,1470470787,1470470967,3,9,180
85095974@N05,7051,25,1470471646,1470472396,8,9,750
85095974@N05,7051,26,1470473763,1470473943,2,9,180
85095974@N05,7052,13,1470739625,1470740225,2,5,600
85095974@N05,7052,17,1470742136,1470743516,6,5,1380
85095974@N05,7052,12,1470744471,1470744510,5,5,39
85095974@N05,7052,13,1470744510,1470744810,6,5,300
85095974@N05,7052,15,1470744810,1470744990,3,5,180
85095974@N05,7053,21,1470784861,1470785311,11,11,450
85095974@N05,7053,18,1470788897,1470789271,9,11,374
85095974@N05,7053,22,1470789271,1470789283,2,11,12
85095974@N05,7053,18,1470789283,1470791083,3,11,1800
85095974@N05,7053,14,1470791878,1470791998,3,11,120
85095974@N05,7053,3,1470796142,1470796412,3,11,270
85095974@N05,7053,20,1470821434,1470821843,2,11,409
85095974@N05,7053,21,1470821843,1470822293,7,11,450
85095974@N05,7053,26,1470823196,1470823376,2,11,180
85095974@N05,7053,2,1470825131,1470825221,7,11,90
85095974@N05,7053,9,1470827915,1470828155,1,11,240
85095974@N05,7054,2,1470877606,1470877642,8,9,36
85095974@N05,7054,5,1470877642,1470877652,2,9,10
85095974@N05,7054,4,1470877652,1470877678,4,9,26
85095974@N05,7054,5,1470877678,1470877697,4,9,19
85095974@N05,7054,6,1470877697,1470877767,11,9,70
85095974@N05,7054,1,1470877767,1470878160,6,9,393
85095974@N05,7054,2,1470878160,1470878190,4,9,30
85095974@N05,7054,3,1470878190,1470878251,4,9,61
85095974@N05,7054,4,1470878251,1470879151,3,9,900
85095974@N05,7055,21,1470914823,1470915273,33,1,450
85121305@N08,7056,16,1261583860,1261584580,1,1,720
85121305@N08,7057,16,1356163723,1356164443,2,5,720
85121305@N08,7057,14,1356172119,1356172239,2,5,120
85121305@N08,7057,16,1356174574,1356175198,4,5,624
85121305@N08,7057,4,1356175198,1356175218,2,5,20
85121305@N08,7057,16,1356175218,1356175938,1,5,720
85121305@N08,7058,16,1356348775,1356349495,1,1,720
85121305@N08,7059,13,1440747388,1440747988,2,2,600
85121305@N08,7059,22,1440763732,1440764332,1,2,600
8515441@N06,7060,27,1302043002,1302044202,2,2,1200
8515441@N06,7060,17,1302056364,1302057744,20,2,1380
8519304@N03,7061,18,1329850101,1329851901,1,1,1800
85213896@N00,7062,13,1353192737,1353193337,1,1,600
8523419@N08,7063,15,1214796773,1214796953,1,1,180
85281436@N03,7064,27,1362365175,1362366375,1,1,1200
85281436@N03,7065,8,1362491836,1362491956,1,1,120
85281436@N03,7066,21,1362573415,1362573865,1,1,450
85288320@N00,7067,18,1312365635,1312365918,14,5,283
85288320@N00,7067,13,1312365918,1312365964,4,5,46
85288320@N00,7067,18,1312365964,1312366937,5,5,973
85288320@N00,7067,9,1312366937,1312367177,2,5,240
85288320@N00,7067,24,1312367945,1312368425,1,5,480
85404061@N00,7068,17,1195860391,1195861771,2,1,1380
85433978@N00,7069,12,1449729911,1449730287,3,3,376
85433978@N00,7069,13,1449730287,1449730349,2,3,62
85433978@N00,7069,12,1449730349,1449731189,1,3,840
85433978@N00,7070,27,1449956509,1449957353,4,6,844
85433978@N00,7070,16,1449957353,1449958073,2,6,720
85433978@N00,7070,17,1449968945,1449970325,2,6,1380
85433978@N00,7070,1,1449974676,1449975276,2,6,600
85433978@N00,7070,15,1449984567,1449984747,2,6,180
85433978@N00,7070,27,1449987222,1449988422,1,6,1200
8544697@N08,7071,16,1267925436,1267926156,1,1,720
8544697@N08,7072,16,1295440406,1295441126,1,1,720
85466831@N00,7073,27,1280876109,1280877309,1,1,1200
85509341@N00,7074,14,1392688744,1392688864,5,5,120
85509341@N00,7074,23,1392711133,1392711223,2,5,90
85509341@N00,7074,17,1392719200,1392720580,2,5,1380
85509341@N00,7074,16,1392732343,1392732603,2,5,260
85509341@N00,7074,21,1392732603,1392733053,1,5,450
85509341@N00,7075,20,1435807262,1435808342,2,5,1080
85509341@N00,7075,2,1435822485,1435822575,2,5,90
85509341@N00,7075,22,1435833224,1435833824,3,5,600
85509341@N00,7075,13,1435837907,1435838507,2,5,600
85509341@N00,7075,25,1435840848,1435841598,1,5,750
85509341@N00,7076,20,1435899203,1435900283,2,2,1080
85509341@N00,7076,27,1435916300,1435917500,1,2,1200
85543411@N08,7077,27,1423344500,1423345700,1,1,1200
85543411@N08,7078,27,1423689930,1423691130,1,1,1200
85543411@N08,7079,27,1428792649,1428793849,1,1,1200
85543411@N08,7080,27,1430432799,1430433999,1,1,1200
85543411@N08,7081,27,1433110893,1433112093,1,1,1200
85543411@N08,7082,27,1438991280,1438992480,1,1,1200
85543411@N08,7083,27,1440282887,1440284087,1,1,1200
85566955@N00,7084,23,1379394519,1379394609,3,2,90
85566955@N00,7084,27,1379421348,1379422548,1,2,1200
85566955@N00,7085,16,1379655023,1379655095,2,2,72
85566955@N00,7085,17,1379655095,1379656475,1,2,1380
8562579@N08,7086,17,1315974924,1315976304,1,1,1380
8562768@N07,7087,16,1351290477,1351290882,2,7,405
8562768@N07,7087,14,1351290882,1351291002,26,7,120
8562768@N07,7087,16,1351294680,1351295400,3,7,720
8562768@N07,7087,20,1351298478,1351299558,3,7,1080
8562768@N07,7087,19,1351299892,1351300312,4,7,420
8562768@N07,7087,26,1351301761,1351301941,3,7,180
8562768@N07,7087,11,1351319711,1351319891,4,7,180
85631149@N00,7088,16,1393198169,1393198889,2,4,720
85631149@N00,7088,3,1393223681,1393223951,2,4,270
85631149@N00,7088,14,1393226069,1393226189,2,4,120
85631149@N00,7088,16,1393226880,1393227600,1,4,720
85632208@N03,7089,18,1329310260,1329312060,4,5,1800
85632208@N03,7089,13,1329312185,1329312785,2,5,600
85632208@N03,7089,12,1329327596,1329328436,2,5,840
85632208@N03,7089,27,1329346353,1329347553,3,5,1200
85632208@N03,7089,3,1329349565,1329349835,3,5,270
85639028@N02,7090,16,1386398279,1386398999,3,1,720
85644119@N00,7091,27,1198703975,1198704991,3,12,1016
85644119@N00,7091,17,1198704991,1198706371,2,12,1380
85644119@N00,7091,23,1198709879,1198709969,3,12,90
85644119@N00,7091,21,1198712051,1198712501,2,12,450
85644119@N00,7091,22,1198726573,1198726935,2,12,362
85644119@N00,7091,17,1198726935,1198727547,2,12,612
85644119@N00,7091,19,1198727547,1198727777,2,12,230
85644119@N00,7091,17,1198727777,1198729157,2,12,1380
85644119@N00,7091,11,1198730714,1198730894,2,12,180
85644119@N00,7091,17,1198739232,1198740612,2,12,1380
85644119@N00,7091,16,1198748699,1198749419,2,12,720
85644119@N00,7091,17,1198750089,1198751469,3,12,1380
85644119@N00,7092,17,1213055170,1213056550,1,1,1380
85644119@N00,7093,27,1213310119,1213311319,3,29,1200
85644119@N00,7093,17,1213311964,1213312015,2,29,51
85644119@N00,7093,5,1213312015,1213312735,3,29,720
85644119@N00,7093,17,1213314676,1213314953,3,29,277
85644119@N00,7093,26,1213314953,1213315066,2,29,113
85644119@N00,7093,22,1213315066,1213315121,2,29,55
85644119@N00,7093,17,1213315121,1213315312,3,29,191
85644119@N00,7093,20,1213315312,1213315363,2,29,51
85644119@N00,7093,17,1213315363,1213315725,2,29,362
85644119@N00,7093,19,1213315725,1213316145,4,29,420
85644119@N00,7093,13,1213317848,1213317862,2,29,14
85644119@N00,7093,17,1213317862,1213319242,2,29,1380
85644119@N00,7093,19,1213322409,1213322829,2,29,420
85644119@N00,7093,20,1213324743,1213325823,2,29,1080
85644119@N00,7093,22,1213327303,1213327386,2,29,83
85644119@N00,7093,17,1213327386,1213327452,2,29,66
85644119@N00,7093,18,1213327452,1213329252,2,29,1800
85644119@N00,7093,27,1213336245,1213337445,3,29,1200
85644119@N00,7093,17,1213338163,1213338226,3,29,63
85644119@N00,7093,27,1213338226,1213339178,2,29,952
85644119@N00,7093,17,1213339178,1213340558,2,29,1380
85644119@N00,7093,14,1213342030,1213342150,2,29,120
85644119@N00,7093,17,1213345405,1213345651,2,29,246
85644119@N00,7093,2,1213345651,1213345741,2,29,90
85644119@N00,7093,16,1213347117,1213347162,2,29,45
85644119@N00,7093,17,1213347162,1213347177,2,29,15
85644119@N00,7093,14,1213347177,1213347255,2,29,78
85644119@N00,7093,16,1213347255,1213347975,2,29,720
85644119@N00,7093,17,1213355351,1213356731,1,29,1380
85644119@N00,7094,17,1229036873,1229038253,1,1,1380
85644119@N00,7095,17,1229295870,1229297250,1,1,1380
85644119@N00,7096,27,1248213415,1248214573,3,25,1158
85644119@N00,7096,26,1248214573,1248214585,2,25,12
85644119@N00,7096,22,1248214585,1248214844,4,25,259
85644119@N00,7096,20,1248214844,1248215387,2,25,543
85644119@N00,7096,21,1248215387,1248215837,2,25,450
85644119@N00,7096,19,1248216868,1248216910,2,25,42
85644119@N00,7096,13,1248216910,1248217510,2,25,600
85644119@N00,7096,19,1248219243,1248219663,2,25,420
85644119@N00,7096,25,1248221168,1248221918,5,25,750
85644119@N00,7096,4,1248222692,1248223129,2,25,437
85644119@N00,7096,3,1248223129,1248223399,2,25,270
85644119@N00,7096,4,1248223695,1248223933,2,25,238
85644119@N00,7096,25,1248223933,1248224082,2,25,149
85644119@N00,7096,23,1248224082,1248224172,2,25,90
85644119@N00,7096,26,1248226443,1248226623,2,25,180
85644119@N00,7096,9,1248227060,1248227300,2,25,240
85644119@N00,7096,14,1248227776,1248227896,3,25,120
85644119@N00,7096,17,1248230033,1248231413,3,25,1380
85644119@N00,7096,20,1248233415,1248234495,2,25,1080
85644119@N00,7096,27,1248234725,1248235925,10,25,1200
85644119@N00,7096,8,1248240761,1248240881,2,25,120
85644119@N00,7096,12,1248243588,1248244428,2,25,840
85644119@N00,7096,14,1248244577,1248244697,3,25,120
85644119@N00,7096,4,1248254444,1248254533,2,25,89
85644119@N00,7096,16,1248254533,1248255253,2,25,720
85644119@N00,7097,27,1261948392,1261949399,4,15,1007
85644119@N00,7097,14,1261949399,1261949519,2,15,120
85644119@N00,7097,4,1261949848,1261949911,3,15,63
85644119@N00,7097,2,1261949911,1261950001,2,15,90
85644119@N00,7097,1,1261952047,1261952647,4,15,600
85644119@N00,7097,17,1261953949,1261954321,2,15,372
85644119@N00,7097,19,1261954321,1261954741,2,15,420
85644119@N00,7097,21,1261956138,1261956588,2,15,450
85644119@N00,7097,19,1261958856,1261959276,2,15,420
85644119@N00,7097,8,1261964226,1261964346,2,15,120
85644119@N00,7097,4,1261967133,1261968033,2,15,900
85644119@N00,7097,17,1261971095,1261972475,2,15,1380
85644119@N00,7097,23,1261982226,1261982316,2,15,90
85644119@N00,7097,17,1261989334,1261990714,3,15,1380
85644119@N00,7097,27,1262001347,1262002547,2,15,1200
85644119@N00,7098,27,1275862642,1275862900,3,20,258
85644119@N00,7098,4,1275862900,1275863800,3,20,900
85644119@N00,7098,1,1275864018,1275864618,3,20,600
85644119@N00,7098,3,1275866470,1275866740,2,20,270
85644119@N00,7098,4,1275867928,1275868147,2,20,219
85644119@N00,7098,17,1275868147,1275868230,2,20,83
85644119@N00,7098,22,1275868230,1275868830,2,20,600
85644119@N00,7098,20,1275873500,1275873957,3,20,457
85644119@N00,7098,19,1275873957,1275874377,2,20,420
85644119@N00,7098,27,1275875025,1275876225,4,20,1200
85644119@N00,7098,17,1275878429,1275879809,2,20,1380
85644119@N00,7098,13,1275882025,1275882625,2,20,600
85644119@N00,7098,23,1275884439,1275884529,2,20,90
85644119@N00,7098,20,1275889905,1275890985,2,20,1080
85644119@N00,7098,19,1275891358,1275891778,2,20,420
85644119@N00,7098,26,1275892770,1275892950,2,20,180
85644119@N00,7098,14,1275893580,1275893700,3,20,120
85644119@N00,7098,16,1275893897,1275894004,2,20,107
85644119@N00,7098,17,1275894004,1275894384,3,20,380
85644119@N00,7098,27,1275894384,1275895584,3,20,1200
85644119@N00,7099,16,1307402273,1307402555,4,13,282
85644119@N00,7099,26,1307402555,1307402735,2,13,180
85644119@N00,7099,20,1307406766,1307406962,2,13,196
85644119@N00,7099,17,1307406962,1307407052,2,13,90
85644119@N00,7099,13,1307407052,1307407652,2,13,600
85644119@N00,7099,21,1307415824,1307416274,2,13,450
85644119@N00,7099,6,1307417024,1307417279,2,13,255
85644119@N00,7099,7,1307424597,1307424687,2,13,90
85644119@N00,7099,14,1307425599,1307425719,2,13,120
85644119@N00,7099,27,1307432084,1307433284,2,13,1200
85644119@N00,7099,9,1307437910,1307438150,2,13,240
85644119@N00,7099,23,1307440865,1307440947,2,13,82
85644119@N00,7099,21,1307440947,1307441397,1,13,450
85644119@N00,7100,4,1324324840,1324325740,4,18,900
85644119@N00,7100,17,1324327357,1324327503,3,18,146
85644119@N00,7100,22,1324327503,1324327604,3,18,101
85644119@N00,7100,27,1324327604,1324327621,2,18,17
85644119@N00,7100,19,1324327621,1324328041,5,18,420
85644119@N00,7100,20,1324331006,1324331123,3,18,117
85644119@N00,7100,21,1324331123,1324331573,3,18,450
85644119@N00,7100,23,1324332082,1324332172,2,18,90
85644119@N00,7100,13,1324332338,1324332938,2,18,600
85644119@N00,7100,15,1324335030,1324335210,2,18,180
85644119@N00,7100,26,1324335234,1324335414,2,18,180
85644119@N00,7100,5,1324339489,1324340209,2,18,720
85644119@N00,7100,4,1324355275,1324355549,2,18,274
85644119@N00,7100,27,1324355549,1324356749,4,18,1200
85644119@N00,7100,17,1324359370,1324359527,3,18,157
85644119@N00,7100,16,1324359527,1324360247,3,18,720
85644119@N00,7100,9,1324372618,1324372858,2,18,240
85644119@N00,7100,16,1324375289,1324376009,3,18,720
85644119@N00,7101,20,1337651433,1337652513,1,1,1080
85644119@N00,7102,27,1339708012,1339708556,4,19,544
85644119@N00,7102,16,1339708556,1339708627,2,19,71
85644119@N00,7102,14,1339708627,1339708747,3,19,120
85644119@N00,7102,6,1339711791,1339712046,3,19,255
85644119@N00,7102,2,1339713001,1339713091,3,19,90
85644119@N00,7102,4,1339717618,1339718518,3,19,900
85644119@N00,7102,27,1339720420,1339721620,2,19,1200
85644119@N00,7102,23,1339726509,1339726599,2,19,90
85644119@N00,7102,26,1339727397,1339727577,2,19,180
85644119@N00,7102,23,1339727599,1339727689,2,19,90
85644119@N00,7102,21,1339729250,1339729700,3,19,450
85644119@N00,7102,23,1339730002,1339730092,2,19,90
85644119@N00,7102,20,1339736064,1339737144,3,19,1080
85644119@N00,7102,8,1339737265,1339737385,2,19,120
85644119@N00,7102,4,1339743994,1339744797,2,19,803
85644119@N00,7102,25,1339744797,1339745547,2,19,750
85644119@N00,7102,22,1339745856,1339746456,2,19,600
85644119@N00,7102,16,1339750289,1339750603,2,19,314
85644119@N00,7102,14,1339750603,1339750723,1,19,120
85644119@N00,7103,27,1370553982,1370555182,2,13,1200
85644119@N00,7103,17,1370559418,1370559587,2,13,169
85644119@N00,7103,26,1370559587,1370559767,2,13,180
85644119@N00,7103,24,1370562810,1370563290,2,13,480
85644119@N00,7103,19,1370565871,1370566291,3,13,420
85644119@N00,7103,13,1370570631,1370571231,3,13,600
85644119@N00,7103,14,1370571276,1370571396,4,13,120
85644119@N00,7103,9,1370580606,1370580718,2,13,112
85644119@N00,7103,10,1370580718,1370581138,2,13,420
85644119@N00,7103,9,1370583142,1370583382,2,13,240
85644119@N00,7103,10,1370587172,1370587592,3,13,420
85644119@N00,7103,14,1370591641,1370591761,2,13,120
85644119@N00,7103,27,1370594484,1370595684,2,13,1200
85644119@N00,7104,27,1402563496,1402564696,2,1,1200
85644119@N00,7105,27,1433674118,1433675318,2,1,1200
85644119@N00,7106,27,1433978462,1433978831,2,9,369
85644119@N00,7106,17,1433978831,1433980211,2,9,1380
85644119@N00,7106,24,1433980941,1433981421,2,9,480
85644119@N00,7106,19,1433986037,1433986457,2,9,420
85644119@N00,7106,17,1433992530,1433993910,2,9,1380
85644119@N00,7106,12,1434016571,1434016980,3,9,409
85644119@N00,7106,13,1434016980,1434017580,3,9,600
85644119@N00,7106,23,1434020019,1434020109,2,9,90
85644119@N00,7106,22,1434021044,1434021644,1,9,600
8565602@N03,7107,13,1330528347,1330528947,1,1,600
8567292@N04,7108,15,1441411461,1441411641,2,1,180
8569755@N06,7109,16,1289569506,1289570226,1,1,720
85744958@N00,7110,16,1255761664,1255762384,8,2,720
85744958@N00,7110,27,1255764013,1255765213,1,2,1200
85744958@N00,7111,27,1319131083,1319132283,14,1,1200
85744958@N00,7112,27,1327994672,1327995872,8,1,1200
85744958@N00,7113,27,1353756104,1353757304,4,1,1200
85744958@N00,7114,27,1353798024,1353798987,3,2,963
85744958@N00,7114,9,1353798987,1353799227,24,2,240
8576764@N02,7115,27,1335074166,1335075366,6,2,1200
8576764@N02,7115,15,1335077124,1335077304,3,2,180
8576764@N02,7116,15,1337185230,1337185356,2,2,126
8576764@N02,7116,27,1337185356,1337186556,1,2,1200
8576764@N02,7117,27,1409474546,1409475126,2,8,580
8576764@N02,7117,17,1409475126,1409475829,2,8,703
8576764@N02,7117,15,1409475829,1409476009,2,8,180
8576764@N02,7117,13,1409477695,1409477981,2,8,286
8576764@N02,7117,16,1409477981,1409478701,5,8,720
8576764@N02,7117,10,1409482393,1409482813,4,8,420
8576764@N02,7117,18,1409484755,1409486355,4,8,1600
8576764@N02,7117,25,1409486355,1409487105,1,8,750
8576764@N02,7118,27,1409629185,1409630385,4,7,1200
8576764@N02,7118,25,1409631420,1409632170,12,7,750
8576764@N02,7118,26,1409634890,1409635070,2,7,180
8576764@N02,7118,3,1409637003,1409637273,9,7,270
8576764@N02,7118,1,1409638750,1409639350,6,7,600
8576764@N02,7118,20,1409647160,1409648240,3,7,1080
8576764@N02,7118,9,1409648595,1409648835,1,7,240
8576764@N02,7119,9,1409820957,1409821197,2,5,240
8576764@N02,7119,10,1409823300,1409823720,7,5,420
8576764@N02,7119,7,1409824119,1409824209,9,5,90
8576764@N02,7119,10,1409828947,1409829367,4,5,420
8576764@N02,7119,9,1409834288,1409834528,3,5,240
8576764@N02,7120,27,1410075477,1410076677,1,1,1200
85813749@N00,7121,27,1418699533,1418700149,5,9,616
85813749@N00,7121,4,1418700149,1418701049,2,9,900
85813749@N00,7121,1,1418701678,1418702278,2,9,600
85813749@N00,7121,2,1418707514,1418707604,2,9,90
85813749@N00,7121,4,1418708203,1418709103,2,9,900
85813749@N00,7121,13,1418710026,1418710626,2,9,600
85813749@N00,7121,19,1418712082,1418712502,2,9,420
85813749@N00,7121,17,1418713732,1418715112,3,9,1380
85813749@N00,7121,27,1418721491,1418722691,4,9,1200
85813749@N00,7122,12,1419047753,1419048593,2,3,840
85813749@N00,7122,18,1419053787,1419055587,2,3,1800
85813749@N00,7122,22,1419079452,1419080052,2,3,600
85843151@N00,7123,14,1359856263,1359856383,2,5,120
85843151@N00,7123,15,1359860317,1359860497,2,5,180
85843151@N00,7123,10,1359861687,1359862107,3,5,420
85843151@N00,7123,2,1359865739,1359865829,2,5,90
85843151@N00,7123,27,1359876265,1359877465,4,5,1200
85855667@N00,7124,13,1309223865,1309224465,2,5,600
85855667@N00,7124,26,1309227582,1309227762,2,5,180
85855667@N00,7124,21,1309232605,1309233055,2,5,450
85855667@N00,7124,22,1309239003,1309239603,3,5,600
85855667@N00,7124,17,1309240675,1309242055,1,5,1380
85859494@N02,7125,27,1369348849,1369350049,13,9,1200
85859494@N02,7125,26,1369352337,1369352517,2,9,180
85859494@N02,7125,25,1369352746,1369353496,2,9,750
85859494@N02,7125,24,1369353557,1369354037,4,9,480
85859494@N02,7125,21,1369355641,1369356091,3,9,450
85859494@N02,7125,22,1369362891,1369362941,6,9,50
85859494@N02,7125,26,1369362941,1369363121,9,9,180
85859494@N02,7125,18,1369364192,1369365992,2,9,1800
85859494@N02,7125,27,1369392834,1369394034,1,9,1200
85859494@N02,7126,3,1369736338,1369736608,3,2,270
85859494@N02,7126,27,1369739019,1369740219,18,2,1200
85859494@N02,7127,11,1369790717,1369790897,3,2,180
85859494@N02,7127,13,1369795157,1369795757,1,2,600
85859494@N02,7128,27,1370127966,1370128549,5,4,583
85859494@N02,7128,9,1370128549,1370128789,9,4,240
85859494@N02,7128,14,1370130754,1370130874,2,4,120
85859494@N02,7128,17,1370130950,1370132330,1,4,1380
85859494@N02,7129,25,1370392835,1370393585,1,1,750
85863433@N04,7130,6,1323830252,1323830507,2,2,255
85863433@N04,7130,26,1323841076,1323841256,1,2,180
85863433@N04,7131,4,1323938498,1323939398,3,1,900
85864407@N08,7132,22,1384484822,1384485422,3,4,600
85864407@N08,7132,21,1384487138,1384487588,3,4,450
85864407@N08,7132,13,1384489189,1384489789,6,4,600
85864407@N08,7132,10,1384500741,1384501161,4,4,420
85864407@N08,7133,22,1384597154,1384597754,2,4,600
85864407@N08,7133,9,1384600401,1384600641,2,4,240
85864407@N08,7133,10,1384600908,1384601328,2,4,420
85864407@N08,7133,16,1384605601,1384606321,1,4,720
85864407@N08,7134,13,1384756043,1384756643,2,9,600
85864407@N08,7134,14,1384756893,1384757013,2,9,120
85864407@N08,7134,16,1384758873,1384759593,2,9,720
85864407@N08,7134,19,1384771256,1384771676,2,9,420
85864407@N08,7134,22,1384773798,1384774398,2,9,600
85864407@N08,7134,2,1384776639,1384776729,2,9,90
85864407@N08,7134,9,1384779893,1384780133,2,9,240
85864407@N08,7134,14,1384781395,1384781515,2,9,120
85864407@N08,7134,16,1384781636,1384782356,1,9,720
85864407@N08,7135,5,1384990919,1384991639,2,6,720
85864407@N08,7135,13,1384994497,1384995097,6,6,600
85864407@N08,7135,21,1385008877,1385009327,2,6,450
85864407@N08,7135,27,1385011369,1385012569,2,6,1200
85864407@N08,7135,14,1385017530,1385017650,2,6,120
85864407@N08,7135,4,1385021514,1385022414,1,6,900
85879323@N08,7136,10,1450256245,1450256665,1,1,420
85882671@N00,7137,21,1415503785,1415504235,2,2,450
85882671@N00,7137,16,1415508931,1415509651,1,2,720
85909608@N00,7138,27,1296945721,1296946921,2,3,1200
85909608@N00,7138,18,1296957174,1296958974,8,3,1800
85909608@N00,7138,17,1296960969,1296962349,2,3,1380
85909608@N00,7139,17,1337512843,1337514223,26,1,1380
85912588@N00,7140,8,1353540047,1353540167,1,1,120
85921343@N08,7141,27,1379972305,1379973505,1,1,1200
85940078@N07,7142,14,1362904489,1362904609,1,1,120
85977134@N00,7143,22,1356940745,1356941345,1,1,600
8599745@N08,7144,9,1210765119,1210765119,2,9,0
8599745@N08,7144,24,1210765119,1210765599,3,9,480
8599745@N08,7144,11,1210765768,1210765768,2,9,0
8599745@N08,7144,13,1210765768,1210766228,2,9,460
8599745@N08,7144,1,1210766228,1210766228,2,9,0
8599745@N08,7144,9,1210766228,1210766228,2,9,0
8599745@N08,7144,18,1210766228,1210766228,3,9,0
8599745@N08,7144,22,1210766228,1210766438,2,9,210
8599745@N08,7144,27,1210766438,1210767638,1,9,1200
86001309@N00,7145,5,1335775784,1335776504,1,1,720
86001309@N00,7146,10,1359098375,1359098795,1,1,420
86061580@N00,7147,4,1290753805,1290754705,2,2,900
86061580@N00,7147,14,1290759559,1290759679,8,2,120
86111910@N03,7148,9,1348380506,1348380746,3,3,240
86111910@N03,7148,26,1348394151,1348394331,2,3,180
86111910@N03,7148,24,1348397674,1348398154,1,3,480
86177168@N03,7149,15,1281931725,1281931905,1,1,180
8619760@N07,7150,22,1191725052,1191725652,66,1,600
86235456@N07,7151,9,1452669511,1452669751,1,1,240
86275327@N00,7152,9,1209423194,1209423434,3,2,240
86275327@N00,7152,22,1209425761,1209426361,1,2,600
86278660@N00,7153,14,1386143556,1386143676,2,1,120
86278660@N00,7154,14,1388308642,1388308762,1,1,120
86285103@N00,7155,25,1260773114,1260773864,17,3,750
86285103@N00,7155,16,1260778410,1260778458,5,3,48
86285103@N00,7155,17,1260778458,1260779838,79,3,1380
86285103@N00,7156,25,1260829371,1260829476,7,17,105
86285103@N00,7156,26,1260829476,1260829503,5,17,27
86285103@N00,7156,25,1260829503,1260829515,3,17,12
86285103@N00,7156,23,1260829515,1260829544,3,17,29
86285103@N00,7156,25,1260829544,1260829592,3,17,48
86285103@N00,7156,24,1260829592,1260830072,36,17,480
86285103@N00,7156,19,1260832311,1260832468,9,17,157
86285103@N00,7156,20,1260832468,1260832666,9,17,198
86285103@N00,7156,22,1260832666,1260833266,7,17,600
86285103@N00,7156,20,1260833559,1260833567,3,17,8
86285103@N00,7156,18,1260833567,1260835367,50,17,1800
86285103@N00,7156,22,1260835887,1260835980,5,17,93
86285103@N00,7156,18,1260835980,1260836029,7,17,49
86285103@N00,7156,13,1260836029,1260836474,3,17,445
86285103@N00,7156,12,1260836474,1260837314,74,17,840
86285103@N00,7156,27,1260838432,1260839632,5,17,1200
86285103@N00,7156,13,1260862381,1260862981,8,17,600
8638605@N02,7157,1,1211516133,1211516577,3,4,444
8638605@N02,7157,9,1211516577,1211516817,4,4,240
8638605@N02,7157,14,1211516909,1211516986,2,4,77
8638605@N02,7157,13,1211516986,1211517586,1,4,600
8638605@N02,7158,27,1275649517,1275650717,22,3,1200
8638605@N02,7158,24,1275651615,1275652095,4,3,480
8638605@N02,7158,20,1275653342,1275654422,1,3,1080
8638605@N02,7159,17,1275733036,1275734416,12,1,1380
8638605@N02,7160,3,1275830540,1275830810,4,4,270
8638605@N02,7160,5,1275831212,1275831233,2,4,21
8638605@N02,7160,6,1275831233,1275831488,2,4,255
8638605@N02,7160,9,1275832543,1275832783,4,4,240
8638605@N02,7161,4,1275951649,1275951790,2,13,141
8638605@N02,7161,2,1275951790,1275951880,7,13,90
8638605@N02,7161,14,1275953057,1275953177,2,13,120
8638605@N02,7161,20,1275953817,1275954897,4,13,1080
8638605@N02,7161,18,1275956028,1275957042,2,13,1014
8638605@N02,7161,19,1275957042,1275957462,23,13,420
8638605@N02,7161,11,1275958579,1275958620,4,13,41
8638605@N02,7161,8,1275958620,1275958635,3,13,15
8638605@N02,7161,11,1275958635,1275958815,4,13,180
8638605@N02,7161,8,1275958993,1275959030,3,13,37
8638605@N02,7161,7,1275959030,1275959120,4,13,90
8638605@N02,7161,9,1275959255,1275959394,4,13,139
8638605@N02,7161,6,1275959394,1275959649,3,13,255
86459399@N00,7162,27,1255246418,1255247618,1,1,1200
86459399@N00,7163,27,1255412565,1255413765,2,2,1200
86459399@N00,7163,21,1255414740,1255415190,5,2,450
86459399@N00,7164,27,1275173648,1275174848,4,2,1200
86459399@N00,7164,21,1275185361,1275185811,1,2,450
86459399@N00,7165,27,1291685485,1291686685,4,2,1200
86459399@N00,7165,11,1291687552,1291687732,1,2,180
86459399@N00,7166,19,1291794187,1291794607,2,1,420
86459399@N00,7167,19,1291860963,1291861383,4,3,420
86459399@N00,7167,21,1291865658,1291866108,2,3,450
86459399@N00,7167,27,1291871022,1291872222,1,3,1200
86459399@N00,7168,27,1296353276,1296354476,5,4,1200
86459399@N00,7168,2,1296360576,1296360619,2,4,43
86459399@N00,7168,27,1296360619,1296361819,9,4,1200
86459399@N00,7168,6,1296381780,1296382035,1,4,255
86459399@N00,7169,27,1318844662,1318845862,7,2,1200
86459399@N00,7169,20,1318847157,1318848237,2,2,1080
86459399@N00,7170,27,1318916771,1318917971,5,5,1200
86459399@N00,7170,17,1318923954,1318925334,2,5,1380
86459399@N00,7170,14,1318927468,1318927588,3,5,120
86459399@N00,7170,20,1318930865,1318931945,2,5,1080
86459399@N00,7170,27,1318943877,1318945077,1,5,1200
86459399@N00,7171,27,1319082183,1319083383,2,1,1200
86459399@N00,7172,14,1350101283,1350101403,2,3,120
86459399@N00,7172,25,1350125128,1350125878,2,3,750
86459399@N00,7172,14,1350130334,1350130454,1,3,120
86459399@N00,7173,27,1350192899,1350194099,2,4,1200
86459399@N00,7173,2,1350198690,1350198780,3,4,90
86459399@N00,7173,24,1350202950,1350203430,3,4,480
86459399@N00,7173,20,1350205639,1350206719,1,4,1080
86459399@N00,7174,17,1350267288,1350268668,1,1,1380
86459399@N00,7175,19,1350304289,1350304709,2,2,420
86459399@N00,7175,3,1350307916,1350308186,3,2,270
86459399@N00,7176,17,1350384040,1350385420,8,1,1380
86459399@N00,7177,4,1367051986,1367052886,6,4,900
86459399@N00,7177,7,1367054893,1367054983,3,4,90
86459399@N00,7177,27,1367057687,1367058887,9,4,1200
86459399@N00,7177,7,1367059872,1367059962,2,4,90
86459399@N00,7178,26,1367112664,1367112844,3,2,180
86459399@N00,7178,22,1367112890,1367113490,1,2,600
86476099@N00,7179,19,1261443151,1261443571,1,1,420
86482004@N00,7180,27,1337560359,1337560954,2,16,595
86482004@N00,7180,4,1337560954,1337561854,2,16,900
86482004@N00,7180,6,1337562649,1337562904,6,16,255
86482004@N00,7180,1,1337563122,1337563130,2,16,8
86482004@N00,7180,6,1337563130,1337563144,2,16,14
86482004@N00,7180,7,1337563144,1337563189,4,16,45
86482004@N00,7180,6,1337563189,1337563257,3,16,68
86482004@N00,7180,7,1337563257,1337563270,2,16,13
86482004@N00,7180,6,1337563270,1337563525,5,16,255
86482004@N00,7180,1,1337564113,1337564713,6,16,600
86482004@N00,7180,8,1337566919,1337567039,6,16,120
86482004@N00,7180,20,1337570216,1337571296,2,16,1080
86482004@N00,7180,24,1337572905,1337573385,10,16,480
86482004@N00,7180,23,1337574146,1337574236,6,16,90
86482004@N00,7180,20,1337579396,1337579689,2,16,293
86482004@N00,7180,11,1337579689,1337579869,1,16,180
86493735@N00,7181,16,1298466000,1298466720,1,1,720
86493735@N00,7182,19,1298504697,1298505117,2,6,420
86493735@N00,7182,17,1298507573,1298508092,2,6,519
86493735@N00,7182,13,1298508092,1298508692,2,6,600
86493735@N00,7182,20,1298510452,1298511532,2,6,1080
86493735@N00,7182,19,1298513150,1298513570,2,6,420
86493735@N00,7182,1,1298517966,1298518566,1,6,600
86499991@N00,7183,16,1198027128,1198027848,5,1,720
86643038@N07,7184,27,1399982880,1399984080,2,1,1200
86650842@N07,7185,27,1419806437,1419807637,1,1,1200
86694404@N00,7186,5,1244370425,1244371145,1,1,720
86694404@N00,7187,5,1244502536,1244503256,2,12,720
86694404@N00,7187,9,1244503437,1244503677,3,12,240
86694404@N00,7187,6,1244505932,1244506187,2,12,255
86694404@N00,7187,5,1244508981,1244509701,2,12,720
86694404@N00,7187,17,1244509831,1244511211,2,12,1380
86694404@N00,7187,5,1244518373,1244519093,2,12,720
86694404@N00,7187,2,1244520334,1244520424,7,12,90
86694404@N00,7187,5,1244524781,1244524805,3,12,24
86694404@N00,7187,17,1244524805,1244526185,4,12,1380
86694404@N00,7187,18,1244526811,1244526832,3,12,21
86694404@N00,7187,17,1244526832,1244528212,2,12,1380
86694404@N00,7187,5,1244528904,1244529624,2,12,720
86694404@N00,7188,5,1244763687,1244764407,4,4,720
86694404@N00,7188,18,1244775011,1244776811,2,4,1800
86694404@N00,7188,5,1244794121,1244794841,3,4,720
86694404@N00,7188,27,1244801343,1244802543,3,4,1200
86712012@N00,7189,17,1228875149,1228876529,1,1,1380
86719158@N00,7190,14,1299190402,1299190522,2,7,120
86719158@N00,7190,19,1299201314,1299201734,3,7,420
86719158@N00,7190,27,1299203931,1299205131,5,7,1200
86719158@N00,7190,7,1299216364,1299216454,2,7,90
86719158@N00,7190,9,1299216575,1299216815,2,7,240
86719158@N00,7190,12,1299216853,1299217693,3,7,840
86719158@N00,7190,27,1299220964,1299222164,10,7,1200
86761686@N00,7191,19,1227400752,1227401172,1,1,420
86840096@N03,7192,16,1420290288,1420291008,1,1,720
86843321@N04,7193,21,1381624199,1381624649,1,1,450
86864767@N00,7194,13,1205081084,1205081684,3,3,600
86864767@N00,7194,15,1205082853,1205083033,2,3,180
86864767@N00,7194,12,1205083542,1205084382,1,3,840
86864767@N00,7195,24,1205152889,1205153369,2,1,480
86889597@N00,7196,4,1233632290,1233633190,1,1,900
86889597@N00,7197,16,1233908163,1233908883,1,1,720
86902064@N02,7198,27,1397713045,1397714245,1,1,1200
86917764@N00,7199,7,1222058946,1222059036,2,3,90
86917764@N00,7199,6,1222059413,1222059668,3,3,255
86917764@N00,7199,17,1222078615,1222079995,28,3,1380
86961551@N00,7200,27,1419637501,1419638701,4,13,1200
86961551@N00,7200,25,1419640682,1419641432,5,13,750
86961551@N00,7200,21,1419641677,1419642118,2,13,441
86961551@N00,7200,20,1419642118,1419642308,8,13,190
86961551@N00,7200,22,1419642308,1419642348,2,13,40
86961551@N00,7200,20,1419642348,1419643428,25,13,1080
86961551@N00,7200,21,1419651303,1419651753,3,13,450
86961551@N00,7200,19,1419655649,1419656069,3,13,420
86961551@N00,7200,17,1419659420,1419659458,3,13,38
86961551@N00,7200,18,1419659458,1419661258,4,13,1800
86961551@N00,7200,6,1419666319,1419666574,8,13,255
86961551@N00,7200,9,1419679198,1419679438,3,13,240
86961551@N00,7200,14,1419685108,1419685228,1,13,120
8702124@N05,7201,26,1317205983,1317206163,1,1,180
8702274@N07,7202,17,1227672572,1227673952,1,1,1380
87029301@N00,7203,27,1364890975,1364892175,1,1,1200
87049901@N00,7204,1,1317207087,1317207687,1,1,600
87060797@N07,7205,16,1345942971,1345943000,4,7,29
87060797@N07,7205,14,1345943000,1345943020,2,7,20
87060797@N07,7205,16,1345943020,1345943415,13,7,395
87060797@N07,7205,14,1345943415,1345943535,2,7,120
87060797@N07,7205,16,1345943728,1345944448,6,7,720
87060797@N07,7205,11,1345954552,1345954732,2,7,180
87060797@N07,7205,15,1345957116,1345957296,1,7,180
87076987@N05,7206,10,1358216846,1358217266,1,1,420
87110377@N07,7207,1,1226666878,1226667478,1,1,600
87173471@N00,7208,12,1323218708,1323219548,1,1,840
87226959@N05,7209,21,1367116337,1367116787,55,1,450
87261736@N00,7210,14,1443143856,1443143976,1,1,120
87267387@N00,7211,19,1230691120,1230691540,1,1,420
87267387@N00,7212,1,1230775541,1230776141,1,1,600
8729032@N06,7213,27,1224312773,1224313973,3,1,1200
8729032@N06,7214,1,1224373498,1224373519,2,10,21
8729032@N06,7214,4,1224373519,1224373525,2,10,6
8729032@N06,7214,1,1224373525,1224373676,6,10,151
8729032@N06,7214,6,1224373676,1224373931,2,10,255
8729032@N06,7214,7,1224375293,1224375383,2,10,90
8729032@N06,7214,21,1224375420,1224375659,2,10,239
8729032@N06,7214,8,1224375659,1224375779,2,10,120
8729032@N06,7214,27,1224376032,1224377232,2,10,1200
8729032@N06,7214,18,1224396283,1224397163,2,10,880
8729032@N06,7214,26,1224397163,1224397343,1,10,180
8729032@N06,7215,27,1287869711,1287870911,23,24,1200
8729032@N06,7215,4,1287872288,1287872294,2,24,6
8729032@N06,7215,2,1287872294,1287872311,2,24,17
8729032@N06,7215,4,1287872311,1287872317,2,24,6
8729032@N06,7215,3,1287872317,1287872324,2,24,7
8729032@N06,7215,4,1287872324,1287872332,2,24,8
8729032@N06,7215,5,1287872332,1287872362,2,24,30
8729032@N06,7215,3,1287872362,1287872388,3,24,26
8729032@N06,7215,2,1287872388,1287872398,2,24,10
8729032@N06,7215,3,1287872398,1287872431,3,24,33
8729032@N06,7215,4,1287872431,1287872633,3,24,202
8729032@N06,7215,2,1287872633,1287872723,4,24,90
8729032@N06,7215,4,1287873644,1287874544,4,24,900
8729032@N06,7215,12,1287875421,1287876261,26,24,840
8729032@N06,7215,13,1287876294,1287876894,11,24,600
8729032@N06,7215,18,1287878819,1287878865,4,24,46
8729032@N06,7215,13,1287878865,1287878951,3,24,86
8729032@N06,7215,19,1287878951,1287878986,4,24,35
8729032@N06,7215,18,1287878986,1287879348,2,24,362
8729032@N06,7215,13,1287879348,1287879552,2,24,204
8729032@N06,7215,18,1287879552,1287879774,2,24,222
8729032@N06,7215,17,1287879774,1287880657,5,24,883
8729032@N06,7215,21,1287880657,1287881107,4,24,450
8729032@N06,7215,27,1287887430,1287888630,2,24,1200
8729032@N06,7216,27,1373330983,1373332183,5,11,1200
8729032@N06,7216,1,1373334795,1373335395,4,11,600
8729032@N06,7216,8,1373342691,1373342703,2,11,12
8729032@N06,7216,7,1373342703,1373342713,2,11,10
8729032@N06,7216,11,1373342713,1373342893,4,11,180
8729032@N06,7216,12,1373345227,1373345241,2,11,14
8729032@N06,7216,17,1373345241,1373345412,10,11,171
8729032@N06,7216,12,1373345412,1373345456,2,11,44
8729032@N06,7216,17,1373345456,1373345643,4,11,187
8729032@N06,7216,13,1373345643,1373345653,2,11,10
8729032@N06,7216,17,1373345653,1373347033,9,11,1380
8729032@N06,7217,27,1373499760,1373500167,5,4,407
8729032@N06,7217,25,1373500167,1373500556,3,4,389
8729032@N06,7217,21,1373500556,1373501006,14,4,450
8729032@N06,7217,17,1373510955,1373512335,3,4,1380
8729032@N06,7218,27,1387318759,1387319817,9,31,1058
8729032@N06,7218,9,1387319817,1387319831,3,31,14
8729032@N06,7218,5,1387319831,1387320551,2,31,720
8729032@N06,7218,27,1387320564,1387320932,3,31,368
8729032@N06,7218,8,1387320932,1387320962,2,31,30
8729032@N06,7218,7,1387320962,1387320967,2,31,5
8729032@N06,7218,8,1387320967,1387321025,5,31,58
8729032@N06,7218,7,1387321025,1387321059,3,31,34
8729032@N06,7218,6,1387321059,1387321081,3,31,22
8729032@N06,7218,1,1387321081,1387321378,2,31,297
8729032@N06,7218,10,1387321378,1387321650,5,31,272
8729032@N06,7218,8,1387321650,1387321770,7,31,120
8729032@N06,7218,11,1387321988,1387322168,8,31,180
8729032@N06,7218,9,1387322931,1387323171,13,31,240
8729032@N06,7218,8,1387324687,1387324807,15,31,120
8729032@N06,7218,10,1387325111,1387325407,5,31,296
8729032@N06,7218,13,1387325407,1387325547,2,31,140
8729032@N06,7218,10,1387325547,1387325967,18,31,420
8729032@N06,7218,12,1387327827,1387327873,3,31,46
8729032@N06,7218,13,1387327873,1387328473,26,31,600
8729032@N06,7218,18,1387329896,1387331696,91,31,1800
8729032@N06,7218,21,1387334429,1387334879,4,31,450
8729032@N06,7218,27,1387335569,1387335939,9,31,370
8729032@N06,7218,21,1387335939,1387335959,2,31,20
8729032@N06,7218,27,1387335959,1387337159,2,31,1200
8729032@N06,7218,17,1387344118,1387344120,2,31,2
8729032@N06,7218,26,1387344120,1387344122,2,31,2
8729032@N06,7218,17,1387344122,1387345502,2,31,1380
8729032@N06,7218,16,1387349445,1387350165,2,31,720
8729032@N06,7218,17,1387351253,1387352633,2,31,1380
8729032@N06,7218,27,1387355241,1387356441,1,31,1200
8729032@N06,7219,27,1418077763,1418078963,2,20,1200
8729032@N06,7219,17,1418079129,1418079338,3,20,209
8729032@N06,7219,13,1418079338,1418079938,4,20,600
8729032@N06,7219,26,1418080667,1418080847,30,20,180
8729032@N06,7219,18,1418083064,1418083813,26,20,749
8729032@N06,7219,9,1418083813,1418083822,4,20,9
8729032@N06,7219,18,1418083822,1418084376,12,20,554
8729032@N06,7219,13,1418084376,1418084407,2,20,31
8729032@N06,7219,12,1418084407,1418085247,57,20,840
8729032@N06,7219,14,1418085936,1418086056,3,20,120
8729032@N06,7219,9,1418086137,1418086377,5,20,240
8729032@N06,7219,10,1418087217,1418087637,14,20,420
8729032@N06,7219,6,1418089656,1418089911,2,20,255
8729032@N06,7219,1,1418090759,1418091359,23,20,600
8729032@N06,7219,2,1418093272,1418093362,12,20,90
8729032@N06,7219,13,1418096578,1418097178,9,20,600
8729032@N06,7219,20,1418102937,1418103532,3,20,595
8729032@N06,7219,19,1418103532,1418103698,6,20,166
8729032@N06,7219,11,1418103698,1418103878,7,20,180
8729032@N06,7219,27,1418104320,1418105520,2,20,1200
8729032@N06,7220,9,1428813932,1428813953,3,3,21
8729032@N06,7220,3,1428813953,1428814223,2,3,270
8729032@N06,7220,9,1428814556,1428814796,2,3,240
8729032@N06,7221,15,1456630211,1456630391,1,1,180
8729032@N06,7222,21,1458284294,1458284744,1,1,450
8730186@N03,7223,17,1427678946,1427680326,2,1,1380
8732544@N07,7224,26,1252286626,1252286806,24,1,180
8738175@N08,7225,22,1274599856,1274600456,4,1,600
87415005@N02,7226,27,1417390092,1417391292,3,5,1200
87415005@N02,7226,14,1417392724,1417392844,5,5,120
87415005@N02,7226,27,1417397471,1417398671,21,5,1200
87415005@N02,7226,9,1417404192,1417404432,2,5,240
87415005@N02,7226,7,1417406570,1417406660,7,5,90
87447493@N00,7227,27,1383173719,1383174919,3,2,1200
87447493@N00,7227,13,1383194080,1383194680,1,2,600
87507703@N04,7228,17,1356481979,1356481992,2,17,13
87507703@N04,7228,22,1356481992,1356482497,2,17,505
87507703@N04,7228,19,1356482497,1356482917,2,17,420
87507703@N04,7228,18,1356483357,1356485157,7,17,1800
87507703@N04,7228,20,1356488596,1356488877,3,17,281
87507703@N04,7228,22,1356488877,1356489477,5,17,600
87507703@N04,7228,21,1356489702,1356490152,3,17,450
87507703@N04,7228,20,1356492894,1356493226,3,17,332
87507703@N04,7228,19,1356493226,1356493646,3,17,420
87507703@N04,7228,27,1356493970,1356495165,7,17,1195
87507703@N04,7228,4,1356495165,1356496065,3,17,900
87507703@N04,7228,16,1356506937,1356507105,2,17,168
87507703@N04,7228,14,1356507105,1356507225,2,17,120
87507703@N04,7228,16,1356507385,1356507700,6,17,315
87507703@N04,7228,15,1356507700,1356507880,2,17,180
87507703@N04,7228,3,1356510394,1356510545,2,17,151
87507703@N04,7228,4,1356510545,1356511445,1,17,900
87549191@N00,7229,16,1338812612,1338813332,1,1,720
87598282@N03,7230,14,1355118615,1355118735,1,1,120
8760137@N08,7231,27,1189656097,1189657297,1,1,1200
8760137@N08,7232,18,1281579825,1281579825,2,2,0
8760137@N08,7232,20,1281579825,1281580905,1,2,1080
87621759@N05,7233,2,1289712219,1289712309,1,1,90
87635169@N02,7234,16,1197791960,1197792680,1,1,720
87723016@N00,7235,27,1379455342,1379456542,2,2,1200
87723016@N00,7235,13,1379466144,1379466744,1,2,600
87723016@N00,7236,21,1379632276,1379632726,1,1,450
87723016@N00,7237,22,1379751799,1379752399,2,2,600
87723016@N00,7237,27,1379755594,1379756794,1,2,1200
87744557@N00,7238,1,1201824559,1201824593,2,6,34
87744557@N00,7238,23,1201824593,1201824594,2,6,1
87744557@N00,7238,7,1201824594,1201824594,2,6,0
87744557@N00,7238,21,1201824594,1201824595,2,6,1
87744557@N00,7238,6,1201824595,1201824850,3,6,255
87744557@N00,7238,27,1201828411,1201829611,2,6,1200
8783683@N08,7239,18,1313304520,1313306320,1,1,1800
87847222@N03,7240,7,1363232883,1363232973,2,1,90
87847222@N03,7241,12,1401249084,1401249924,2,2,840
87847222@N03,7241,26,1401254291,1401254471,4,2,180
87847222@N03,7242,9,1401446229,1401446469,2,2,240
87847222@N03,7242,27,1401449450,1401450650,1,2,1200
87854506@N04,7243,10,1352332112,1352332532,1,1,420
87854506@N04,7244,4,1355551975,1355552875,1,1,900
87854506@N04,7245,1,1363406345,1363406945,2,3,600
87854506@N04,7245,25,1363417353,1363418103,5,3,750
87854506@N04,7245,6,1363423739,1363423994,1,3,255
87854506@N04,7246,27,1376641079,1376642279,4,1,1200
8789515@N06,7247,17,1310319917,1310321297,2,1,1380
87895332@N08,7248,16,1387342260,1387342384,2,2,124
87895332@N08,7248,27,1387342384,1387343584,1,2,1200
87903999@N03,7249,27,1441375211,1441376411,2,1,1200
87903999@N03,7250,16,1450443600,1450443601,2,7,1
87903999@N03,7250,14,1450443601,1450443603,2,7,2
87903999@N03,7250,17,1450443603,1450443604,2,7,1
87903999@N03,7250,24,1450443604,1450443623,4,7,19
87903999@N03,7250,17,1450443623,1450443641,3,7,18
87903999@N03,7250,14,1450443641,1450443643,3,7,2
87903999@N03,7250,16,1450443643,1450444363,3,7,720
87907279@N06,7251,27,1367018872,1367020072,1,1,1200
87953089@N04,7252,27,1389825263,1389826463,10,20,1200
87953089@N04,7252,26,1389827960,1389828140,4,20,180
87953089@N04,7252,24,1389828987,1389829374,14,20,387
87953089@N04,7252,25,1389829374,1389829506,6,20,132
87953089@N04,7252,24,1389829506,1389829827,3,20,321
87953089@N04,7252,21,1389829827,1389830277,3,20,450
87953089@N04,7252,20,1389831667,1389832173,5,20,506
87953089@N04,7252,17,1389832173,1389832300,6,20,127
87953089@N04,7252,13,1389832300,1389832900,5,20,600
87953089@N04,7252,15,1389834170,1389834350,2,20,180
87953089@N04,7252,12,1389834799,1389835115,6,20,316
87953089@N04,7252,13,1389835115,1389835606,4,20,491
87953089@N04,7252,15,1389835606,1389835786,3,20,180
87953089@N04,7252,9,1389837276,1389837516,4,20,240
87953089@N04,7252,2,1389840642,1389840732,3,20,90
87953089@N04,7252,9,1389841023,1389841263,2,20,240
87953089@N04,7252,14,1389850577,1389850697,3,20,120
87953089@N04,7252,15,1389851305,1389851324,3,20,19
87953089@N04,7252,14,1389851324,1389851444,9,20,120
87953089@N04,7252,2,1389853523,1389853613,2,20,90
87983801@N08,7253,6,1382264976,1382265231,12,1,255
87983801@N08,7254,6,1382756332,1382756587,34,1,255
88007935@N02,7255,15,1418690056,1418690236,2,3,180
88007935@N02,7255,17,1418701917,1418703297,2,3,1380
88007935@N02,7255,14,1418706096,1418706216,2,3,120
8803306@N02,7256,27,1224265516,1224266716,1,1,1200
8803306@N02,7257,27,1224325500,1224326700,5,1,1200
8803306@N02,7258,27,1224553259,1224554459,1,1,1200
8803306@N02,7259,27,1224666044,1224667244,1,1,1200
8803306@N02,7260,27,1225878324,1225879524,1,1,1200
8803306@N02,7261,27,1227348249,1227349449,4,1,1200
8803306@N02,7262,27,1227522168,1227523368,1,1,1200
8803306@N02,7263,27,1235706892,1235708092,1,1,1200
8803306@N02,7264,27,1235771068,1235772268,4,12,1200
8803306@N02,7264,23,1235774577,1235774667,2,12,90
8803306@N02,7264,27,1235774686,1235775372,2,12,686
8803306@N02,7264,19,1235775372,1235775792,5,12,420
8803306@N02,7264,26,1235779853,1235780033,2,12,180
8803306@N02,7264,15,1235784039,1235784135,4,12,96
8803306@N02,7264,14,1235784135,1235784255,2,12,120
8803306@N02,7264,16,1235786231,1235786951,2,12,720
8803306@N02,7264,8,1235787172,1235787292,2,12,120
8803306@N02,7264,27,1235789615,1235790815,7,12,1200
8803306@N02,7264,1,1235809009,1235809609,2,12,600
8803306@N02,7264,27,1235809794,1235810994,3,12,1200
8803306@N02,7265,27,1235894247,1235895447,1,1,1200
8803306@N02,7266,27,1251503555,1251504755,1,1,1200
8803306@N02,7267,16,1251546445,1251547165,1,1,720
8803306@N02,7268,14,1265419428,1265419548,1,1,120
8803306@N02,7269,27,1274567343,1274568543,2,4,1200
8803306@N02,7269,13,1274572557,1274573157,3,4,600
8803306@N02,7269,17,1274578258,1274579108,2,4,850
8803306@N02,7269,20,1274579108,1274580188,1,4,1080
8803306@N02,7270,15,1296970874,1296971054,2,4,180
8803306@N02,7270,13,1296972715,1296973315,2,4,600
8803306@N02,7270,27,1296978878,1296980078,2,4,1200
8803306@N02,7270,7,1296980791,1296980881,1,4,90
8803306@N02,7271,13,1305968651,1305969251,2,2,600
8803306@N02,7271,14,1305972896,1305973016,1,2,120
8803306@N02,7272,14,1327377759,1327377879,1,1,120
8803306@N02,7273,11,1331967383,1331967563,1,1,180
88078923@N04,7274,8,1415580366,1415580486,2,1,120
88078923@N04,7275,14,1415659289,1415659409,6,3,120
88078923@N04,7275,16,1415664110,1415664115,2,3,5
88078923@N04,7275,14,1415664115,1415664235,3,3,120
88078923@N04,7276,19,1415749575,1415749995,5,3,420
88078923@N04,7276,17,1415750697,1415752077,3,3,1380
88078923@N04,7276,10,1415769289,1415769709,1,3,420
88078923@N04,7277,27,1415864620,1415865820,3,2,1200
88078923@N04,7277,16,1415872765,1415873485,1,2,720
88087621@N00,7278,27,1345191982,1345193182,2,1,1200
88095899@N05,7279,14,1300663111,1300663231,1,1,120
88095899@N05,7280,17,1369889694,1369891074,1,1,1380
88095899@N05,7281,21,1377656984,1377657434,2,2,450
88095899@N05,7281,6,1377666610,1377666865,1,2,255
88095899@N05,7282,14,1425091021,1425091141,1,1,120
88158593@N00,7283,6,1305795810,1305796065,3,1,255
88158593@N00,7284,1,1334379200,1334379800,1,1,600
88168516@N02,7285,21,1344555336,1344555786,4,7,450
88168516@N02,7285,20,1344556108,1344557139,4,7,1031
88168516@N02,7285,19,1344557139,1344557462,2,7,323
88168516@N02,7285,17,1344557462,1344557635,2,7,173
88168516@N02,7285,18,1344557635,1344559073,3,7,1438
88168516@N02,7285,13,1344559073,1344559353,3,7,280
88168516@N02,7285,26,1344559353,1344559533,2,7,180
88201963@N00,7286,17,1444796304,1444797684,4,2,1380
88201963@N00,7286,18,1444799558,1444801358,4,2,1800
88201963@N00,7287,9,1444877220,1444877460,4,5,240
88201963@N00,7287,14,1444896537,1444896657,5,5,120
88201963@N00,7287,18,1444898503,1444898596,3,5,93
88201963@N00,7287,22,1444898596,1444899196,2,5,600
88201963@N00,7287,4,1444906849,1444907749,2,5,900
88201963@N00,7288,27,1445046703,1445047903,12,4,1200
88201963@N00,7288,3,1445083024,1445083042,2,4,18
88201963@N00,7288,5,1445083042,1445083090,2,4,48
88201963@N00,7288,4,1445083090,1445083990,7,4,900
88249284@N00,7289,14,1217419741,1217419861,2,1,120
8831977@N05,7290,14,1200455641,1200455761,1,1,120
88322185@N00,7291,16,1195814902,1195815622,3,1,720
8838492@N05,7292,27,1198196969,1198198169,7,8,1200
8838492@N05,7292,9,1198200523,1198200763,3,8,240
8838492@N05,7292,11,1198201907,1198202025,2,8,118
8838492@N05,7292,8,1198202025,1198202096,2,8,71
8838492@N05,7292,11,1198202096,1198202276,2,8,180
8838492@N05,7292,18,1198206237,1198208037,2,8,1800
8838492@N05,7292,17,1198210114,1198211494,31,8,1380
8838492@N05,7292,22,1198212350,1198212950,2,8,600
88479439@N03,7293,6,1350891279,1350891285,3,7,6
88479439@N03,7293,7,1350891285,1350891375,2,7,90
88479439@N03,7293,6,1350892631,1350892886,2,7,255
88479439@N03,7293,8,1350909292,1350909412,2,7,120
88479439@N03,7293,6,1350910099,1350910354,2,7,255
88479439@N03,7293,4,1350910719,1350910975,2,7,256
88479439@N03,7293,14,1350910975,1350911095,2,7,120
88487062@N00,7294,27,1319351753,1319352953,3,4,1200
88487062@N00,7294,9,1319358887,1319359127,19,4,240
88487062@N00,7294,27,1319364586,1319365786,8,4,1200
88487062@N00,7294,23,1319366430,1319366520,13,4,90
88487062@N00,7295,4,1319418431,1319419218,3,7,787
88487062@N00,7295,1,1319419218,1319419498,2,7,280
88487062@N00,7295,16,1319419498,1319420218,6,7,720
88487062@N00,7295,17,1319424106,1319425486,5,7,1380
88487062@N00,7295,27,1319427961,1319428377,2,7,416
88487062@N00,7295,14,1319428377,1319428497,9,7,120
88487062@N00,7295,27,1319434548,1319435748,1,7,1200
88504071@N00,7296,25,1211498986,1211499736,2,2,750
88504071@N00,7296,2,1211507115,1211507205,3,2,90
88504071@N00,7297,25,1211582452,1211583202,1,1,750
88518643@N06,7298,9,1375665066,1375665306,2,1,240
8854930@N07,7299,18,1351673773,1351675573,1,1,1800
8854930@N07,7300,9,1383535264,1383535504,2,1,240
88653431@N00,7301,17,1338599442,1338600822,1,1,1380
88653431@N00,7302,2,1338681873,1338681963,2,3,90
88653431@N00,7302,3,1338682981,1338683251,2,3,270
88653431@N00,7302,24,1338693186,1338693666,1,3,480
88689129@N07,7303,27,1322601546,1322602746,1,1,1200
88711965@N00,7304,27,1380461323,1380462523,1,1,1200
88711965@N00,7305,27,1380582092,1380583292,2,3,1200
88711965@N00,7305,16,1380589656,1380590376,2,3,720
88711965@N00,7305,24,1380593456,1380593936,1,3,480
88711965@N00,7306,27,1380629378,1380630578,1,1,1200
88785574@N00,7307,9,1339979097,1339979337,2,4,240
88785574@N00,7307,13,1339983921,1339984521,2,4,600
88785574@N00,7307,20,1339992663,1339993743,3,4,1080
88785574@N00,7307,17,1340001077,1340002457,2,4,1380
88785574@N00,7308,27,1340240234,1340241434,1,1,1200
88785574@N00,7309,22,1340422546,1340423146,1,1,600
88859710@N03,7310,17,1350700687,1350702067,1,1,1380
88859710@N03,7311,27,1378346443,1378347643,2,2,1200
88859710@N03,7311,17,1378350083,1378351463,1,2,1380
88859710@N03,7312,27,1379302322,1379303522,2,1,1200
88859710@N03,7313,5,1381538837,1381539557,1,1,720
88859710@N03,7314,27,1384735366,1384736566,3,1,1200
88859710@N03,7315,27,1384826329,1384827529,3,2,1200
88859710@N03,7315,22,1384842021,1384842621,2,2,600
8886608@N06,7316,16,1413246003,1413246723,1,1,720
88915883@N00,7317,27,1395698969,1395700169,55,1,1200
88949796@N00,7318,6,1374659982,1374660237,2,5,255
88949796@N00,7318,25,1374660371,1374660603,3,5,232
88949796@N00,7318,23,1374660603,1374660693,2,5,90
88949796@N00,7318,4,1374668137,1374669037,2,5,900
88949796@N00,7318,16,1374669178,1374669898,1,5,720
88959316@N00,7319,27,1193456018,1193457218,2,3,1200
88959316@N00,7319,1,1193470895,1193471495,4,3,600
88959316@N00,7319,27,1193479444,1193480644,1,3,1200
88984016@N00,7320,16,1348830115,1348830835,1,1,720
88984016@N00,7321,27,1349037474,1349038674,2,1,1200
88984016@N00,7322,20,1349194007,1349195087,2,2,1080
88984016@N00,7322,11,1349196979,1349197159,1,2,180
88984016@N00,7323,11,1349287073,1349287253,3,2,180
88984016@N00,7323,21,1349288740,1349289190,1,2,450
88994581@N00,7324,20,1351212559,1351213639,2,3,1080
88994581@N00,7324,1,1351219992,1351220009,2,3,17
88994581@N00,7324,13,1351220009,1351220609,1,3,600
88994581@N00,7325,10,1367050545,1367050965,1,1,420
89072528@N00,7326,18,1402101779,1402103579,2,1,1800
89076265@N02,7327,19,1357778194,1357778614,2,5,420
89076265@N02,7327,14,1357779842,1357779962,2,5,120
89076265@N02,7327,17,1357781961,1357783341,2,5,1380
89076265@N02,7327,11,1357799295,1357799475,3,5,180
89076265@N02,7327,4,1357809703,1357810603,2,5,900
89138020@N00,7328,27,1241134978,1241135620,6,10,642
89138020@N00,7328,23,1241135620,1241135710,12,10,90
89138020@N00,7328,20,1241137763,1241138180,4,10,417
89138020@N00,7328,19,1241138180,1241138600,2,10,420
89138020@N00,7328,20,1241139265,1241140345,3,10,1080
89138020@N00,7328,13,1241142312,1241142912,3,10,600
89138020@N00,7328,15,1241143835,1241144015,31,10,180
89138020@N00,7328,11,1241159931,1241160111,21,10,180
89138020@N00,7328,6,1241164648,1241164903,14,10,255
89138020@N00,7328,5,1241171138,1241171858,9,10,720
89138020@N00,7329,27,1241847096,1241848296,5,5,1200
89138020@N00,7329,25,1241850344,1241851094,3,5,750
89138020@N00,7329,11,1241857233,1241857413,9,5,180
89138020@N00,7329,15,1241858235,1241858282,2,5,47
89138020@N00,7329,16,1241858282,1241859002,9,5,720
89286166@N02,7330,16,1345756224,1345756944,1,1,720
89286166@N02,7331,16,1357302440,1357303160,1,1,720
89388234@N00,7332,25,1371687669,1371688419,2,3,750
89388234@N00,7332,6,1371692810,1371693065,2,3,255
89388234@N00,7332,10,1371694495,1371694915,1,3,420
89451823@N08,7333,19,1357079602,1357080022,2,1,420
89451823@N08,7334,5,1357110690,1357110720,2,2,30
89451823@N08,7334,4,1357110720,1357111620,1,2,900
89451823@N08,7335,9,1378978796,1378979036,2,3,240
89451823@N08,7335,10,1378979488,1378979908,2,3,420
89451823@N08,7335,4,1378980560,1378981460,1,3,900
89451823@N08,7336,23,1379029565,1379029655,2,2,90
89451823@N08,7336,27,1379042559,1379043759,1,2,1200
89451823@N08,7337,8,1388701053,1388701173,2,5,120
89451823@N08,7337,17,1388713904,1388715284,4,5,1380
89451823@N08,7337,2,1388716140,1388716230,2,5,90
89451823@N08,7337,6,1388718700,1388718955,2,5,255
89451823@N08,7337,19,1388724419,1388724839,3,5,420
89451823@N08,7338,4,1398330353,1398331253,3,4,900
89451823@N08,7338,7,1398338525,1398338615,2,4,90
89451823@N08,7338,8,1398338784,1398338904,2,4,120
89451823@N08,7338,9,1398338984,1398339224,2,4,240
89451823@N08,7339,14,1398463866,1398463986,2,4,120
89451823@N08,7339,26,1398464389,1398464569,3,4,180
89451823@N08,7339,20,1398467252,1398468332,2,4,1080
89451823@N08,7339,3,1398471978,1398472248,3,4,270
89451823@N08,7340,6,1398551529,1398551784,3,2,255
89451823@N08,7340,3,1398552094,1398552364,1,2,270
89455189@N05,7341,27,1396852285,1396853182,3,4,897
89455189@N05,7341,25,1396853182,1396853932,3,4,750
89455189@N05,7341,17,1396864670,1396866050,3,4,1380
89455189@N05,7341,13,1396866802,1396867402,1,4,600
89455201@N00,7342,19,1230694798,1230695218,1,1,420
8949620@N08,7343,27,1199106000,1199107200,2,1,1200
8949620@N08,7344,17,1209999731,1209999770,2,5,39
8949620@N08,7344,13,1209999770,1209999832,2,5,62
8949620@N08,7344,26,1209999832,1209999909,3,5,77
8949620@N08,7344,16,1209999909,1210000173,7,5,264
8949620@N08,7344,19,1210000173,1210000593,1,5,420
8949620@N08,7345,22,1244164575,1244164608,2,6,33
8949620@N08,7345,27,1244164608,1244165808,4,6,1200
8949620@N08,7345,12,1244190232,1244191072,7,6,840
8949620@N08,7345,22,1244200294,1244200763,3,6,469
8949620@N08,7345,18,1244200763,1244201316,3,6,553
8949620@N08,7345,27,1244201316,1244202516,6,6,1200
8951720@N04,7346,27,1304298279,1304299479,9,1,1200
89522530@N00,7347,27,1332276343,1332277145,3,26,802
89522530@N00,7347,16,1332277145,1332277324,4,26,179
89522530@N00,7347,14,1332277324,1332277358,2,26,34
89522530@N00,7347,16,1332277358,1332277617,2,26,259
89522530@N00,7347,14,1332277617,1332277737,2,26,120
89522530@N00,7347,16,1332278227,1332278947,10,26,720
89522530@N00,7347,9,1332281720,1332281960,8,26,240
89522530@N00,7347,14,1332283224,1332283344,2,26,120
89522530@N00,7347,13,1332283811,1332284411,2,26,600
89522530@N00,7347,15,1332287018,1332287198,2,26,180
89522530@N00,7347,14,1332290512,1332290632,2,26,120
89522530@N00,7347,9,1332292041,1332292281,4,26,240
89522530@N00,7347,7,1332292461,1332292551,4,26,90
89522530@N00,7347,8,1332293415,1332293535,6,26,120
89522530@N00,7347,5,1332298449,1332299169,5,26,720
89522530@N00,7347,4,1332299600,1332299819,2,26,219
89522530@N00,7347,25,1332299819,1332300569,3,26,750
89522530@N00,7347,24,1332304734,1332305214,2,26,480
89522530@N00,7347,27,1332309761,1332310961,2,26,1200
89522530@N00,7347,4,1332311395,1332312295,2,26,900
89522530@N00,7347,14,1332316348,1332316468,3,26,120
89522530@N00,7347,1,1332317728,1332317912,2,26,184
89522530@N00,7347,5,1332317912,1332317975,2,26,63
89522530@N00,7347,6,1332317975,1332318230,2,26,255
89522530@N00,7347,23,1332319755,1332319845,3,26,90
89522530@N00,7347,27,1332329056,1332330256,1,26,1200
89582403@N08,7348,27,1354404223,1354405423,1,1,1200
89634087@N00,7349,2,1298880923,1298880929,2,2,6
89634087@N00,7349,17,1298880929,1298882309,1,2,1380
89760541@N02,7350,27,1349494041,1349495241,2,1,1200
8980678@N03,7351,27,1190703882,1190705082,2,3,1200
8980678@N03,7351,18,1190706195,1190707995,3,3,1800
8980678@N03,7351,21,1190708423,1190708873,1,3,450
8980678@N03,7352,18,1194410954,1194411745,2,3,791
8980678@N03,7352,13,1194411745,1194412345,2,3,600
8980678@N03,7352,11,1194414697,1194414877,1,3,180
8980678@N03,7353,18,1197356625,1197358425,1,1,1800
8980678@N03,7354,27,1204088160,1204089360,2,1,1200
8980678@N03,7355,17,1205627842,1205629222,1,1,1380
8980678@N03,7356,8,1211340269,1211340389,1,1,120
8980678@N03,7357,21,1226472365,1226472815,3,1,450
8980678@N03,7358,14,1236746868,1236746988,2,2,120
8980678@N03,7358,9,1236747239,1236747479,1,2,240
8980678@N03,7359,27,1257116300,1257117500,1,1,1200
8980678@N03,7360,27,1258080780,1258081980,1,1,1200
8980678@N03,7361,22,1264751648,1264752248,1,1,600
8980678@N03,7362,21,1272182552,1272183002,1,1,450
8980678@N03,7363,17,1279110385,1279111765,1,1,1380
8980678@N03,7364,14,1282868881,1282869001,2,2,120
8980678@N03,7364,16,1282870144,1282870864,1,2,720
8980678@N03,7365,16,1290126099,1290126819,1,1,720
8980678@N03,7366,16,1290155342,1290156062,1,1,720
8980678@N03,7367,22,1297407569,1297408169,2,1,600
8980678@N03,7368,18,1302837195,1302838995,3,1,1800
8980678@N03,7369,9,1307058692,1307058932,2,5,240
8980678@N03,7369,21,1307062359,1307062809,2,5,450
8980678@N03,7369,26,1307063383,1307063563,2,5,180
8980678@N03,7369,14,1307067152,1307067272,4,5,120
8980678@N03,7369,27,1307075948,1307077148,1,5,1200
8980678@N03,7370,18,1308439261,1308440101,2,2,840
8980678@N03,7370,13,1308440101,1308440701,2,2,600
8980678@N03,7371,23,1315099769,1315099859,2,4,90
8980678@N03,7371,21,1315101101,1315101551,3,4,450
8980678@N03,7371,14,1315108919,1315109039,2,4,120
8980678@N03,7371,4,1315117306,1315118206,1,4,900
8980678@N03,7372,16,1326429570,1326430290,2,2,720
8980678@N03,7372,27,1326434853,1326436053,1,2,1200
8980678@N03,7373,10,1350099465,1350099885,12,1,420
8980678@N03,7374,16,1350717542,1350718262,2,2,720
8980678@N03,7374,8,1350721525,1350721645,1,2,120
8980678@N03,7375,10,1352677031,1352677451,4,1,420
8980678@N03,7376,27,1358817373,1358818573,19,1,1200
8980678@N03,7377,15,1369631061,1369631241,1,1,180
8980678@N03,7378,10,1379158950,1379159370,2,2,420
8980678@N03,7378,21,1379163163,1379163613,1,2,450
8980678@N03,7379,20,1400858263,1400859343,1,1,1080
8980678@N03,7380,27,1411278147,1411279347,1,1,1200
8980678@N03,7381,24,1418448022,1418448502,1,1,480
89823107@N00,7382,27,1233182744,1233183944,1,1,1200
89823107@N00,7383,27,1233255465,1233256665,5,1,1200
89862145@N00,7384,16,1353914838,1353915558,1,1,720
89938050@N07,7385,27,1350283362,1350284562,3,5,1200
89938050@N07,7385,7,1350285588,1350285678,2,5,90
89938050@N07,7385,6,1350288312,1350288567,2,5,255
89938050@N07,7385,4,1350296187,1350297087,2,5,900
89938050@N07,7385,8,1350298831,1350298951,1,5,120
89939063@N03,7386,17,1369104298,1369105678,2,1,1380
8996989@N02,7387,20,1238020624,1238021704,1,1,1080
90008840@N00,7388,15,1370944905,1370945085,1,1,180
90008840@N00,7389,1,1439031983,1439032583,1,1,600
90008840@N00,7390,4,1461990316,1461991216,1,1,900
90028379@N00,7391,26,1232273375,1232273555,6,1,180
90028379@N00,7392,27,1269662854,1269664054,3,1,1200
90067442@N03,7393,14,1376701534,1376701654,1,1,120
90099586@N00,7394,27,1314239800,1314241000,1,1,1200
90112536@N00,7395,18,1224728959,1224730759,3,3,1800
90112536@N00,7395,20,1224737891,1224738971,2,3,1080
90112536@N00,7395,24,1224749095,1224749575,1,3,480
90115276@N00,7396,26,1204278041,1204278221,1,1,180
90123960@N00,7397,16,1270254476,1270255196,2,1,720
9026784@N08,7398,14,1356565610,1356565730,2,1,120
9026784@N08,7399,17,1385435258,1385436638,2,3,1380
9026784@N08,7399,14,1385436945,1385437065,2,3,120
9026784@N08,7399,17,1385457166,1385458546,1,3,1380
90315279@N00,7400,18,1369182351,1369184151,2,5,1800
90315279@N00,7400,14,1369192513,1369192633,2,5,120
90315279@N00,7400,10,1369194740,1369195160,2,5,420
90315279@N00,7400,4,1369196118,1369197018,3,5,900
90315279@N00,7400,5,1369197648,1369198368,2,5,720
90315279@N00,7401,14,1443146448,1443146568,2,1,120
90347114@N05,7402,27,1397090891,1397092091,22,8,1200
90347114@N05,7402,6,1397094307,1397094562,8,8,255
90347114@N05,7402,2,1397096968,1397097058,5,8,90
90347114@N05,7402,1,1397098160,1397098564,2,8,404
90347114@N05,7402,3,1397098564,1397098834,5,8,270
90347114@N05,7402,9,1397107097,1397107337,2,8,240
90347114@N05,7402,18,1397117139,1397118939,4,8,1800
90347114@N05,7402,17,1397128431,1397129811,1,8,1380
90347114@N05,7403,27,1397698992,1397700192,3,1,1200
90351516@N00,7404,9,1451519598,1451519838,4,2,240
90351516@N00,7404,27,1451536471,1451537671,1,2,1200
9036688@N06,7405,27,1285853401,1285854601,5,10,1200
9036688@N06,7405,1,1285856261,1285856861,2,10,600
9036688@N06,7405,5,1285857480,1285858200,5,10,720
9036688@N06,7405,6,1285858411,1285858666,5,10,255
9036688@N06,7405,14,1285859520,1285859640,8,10,120
9036688@N06,7405,15,1285859935,1285860115,2,10,180
9036688@N06,7405,26,1285860418,1285860598,5,10,180
9036688@N06,7405,18,1285861795,1285862148,3,10,353
9036688@N06,7405,26,1285862148,1285862328,3,10,180
9036688@N06,7405,18,1285863054,1285864854,2,10,1800
9036688@N06,7406,16,1316996655,1316997375,7,7,720
9036688@N06,7406,3,1317004508,1317004778,2,7,270
9036688@N06,7406,16,1317004784,1317005504,2,7,720
9036688@N06,7406,3,1317005718,1317005988,2,7,270
9036688@N06,7406,16,1317010044,1317010632,2,7,588
9036688@N06,7406,3,1317010632,1317010902,20,7,270
9036688@N06,7406,16,1317013905,1317014625,1,7,720
9036688@N06,7407,16,1317121937,1317121944,2,3,7
9036688@N06,7407,26,1317121944,1317122124,3,3,180
9036688@N06,7407,2,1317127592,1317127682,1,3,90
9036688@N06,7408,14,1317345253,1317345373,2,3,120
9036688@N06,7408,9,1317351374,1317351384,2,3,10
9036688@N06,7408,25,1317351384,1317352134,1,3,750
9036688@N06,7409,16,1317454174,1317454894,2,4,720
9036688@N06,7409,27,1317463587,1317464460,10,4,873
9036688@N06,7409,16,1317464460,1317465180,2,4,720
9036688@N06,7409,27,1317465559,1317466759,3,4,1200
90367727@N00,7410,9,1366094261,1366094501,1,1,240
9036889@N06,7411,8,1352441258,1352441361,2,3,103
9036889@N06,7411,7,1352441361,1352441451,2,3,90
9036889@N06,7411,16,1352442670,1352443390,1,3,720
9036889@N06,7412,14,1384682815,1384682935,3,4,120
9036889@N06,7412,12,1384683908,1384684748,29,4,840
9036889@N06,7412,10,1384688233,1384688653,6,4,420
9036889@N06,7412,2,1384692758,1384692848,27,4,90
9036889@N06,7413,6,1417768667,1417768922,2,2,255
9036889@N06,7413,9,1417771180,1417771420,1,2,240
90370508@N02,7414,22,1436157122,1436157722,3,2,600
90370508@N02,7414,20,1436175300,1436176380,1,2,1080
90468007@N00,7415,9,1202730999,1202731239,1,1,240
90475653@N00,7416,16,1324984308,1324985028,1,1,720
90496636@N05,7417,17,1423386492,1423387872,1,1,1380
90496636@N05,7418,14,1432701657,1432701777,2,1,120
9051885@N06,7419,27,1275436093,1275437293,2,11,1200
9051885@N06,7419,14,1275441200,1275441320,7,11,120
9051885@N06,7419,9,1275446757,1275446997,2,11,240
9051885@N06,7419,11,1275460107,1275460287,4,11,180
9051885@N06,7419,7,1275461274,1275461364,3,11,90
9051885@N06,7419,8,1275461815,1275461935,9,11,120
9051885@N06,7419,21,1275464193,1275464643,2,11,450
9051885@N06,7419,24,1275466171,1275466651,3,11,480
9051885@N06,7419,23,1275467526,1275467616,2,11,90
9051885@N06,7419,25,1275467842,1275468592,5,11,750
9051885@N06,7419,11,1275473301,1275473481,7,11,180
9053157@N02,7420,17,1340502333,1340502346,2,2,13
9053157@N02,7420,14,1340502346,1340502466,1,2,120
9053157@N02,7421,27,1342433721,1342434921,1,1,1200
90533800@N00,7422,6,1329777546,1329777801,5,2,255
90533800@N00,7422,27,1329795163,1329796363,1,2,1200
90533800@N00,7423,2,1330057253,1330057276,3,3,23
90533800@N00,7423,6,1330057276,1330057293,2,3,17
90533800@N00,7423,7,1330057293,1330057383,2,3,90
90562571@N00,7424,27,1406766681,1406767881,5,2,1200
90562571@N00,7424,19,1406775370,1406775790,11,2,420
90584232@N07,7425,27,1353464221,1353465421,1,1,1200
90603065@N06,7426,10,1451354087,1451354507,2,2,420
90603065@N06,7426,14,1451373665,1451373785,2,2,120
90603065@N06,7427,27,1469257679,1469258879,1,1,1200
90603065@N06,7428,15,1470479181,1470479361,1,1,180
90642923@N00,7429,13,1193538100,1193538700,2,2,600
90642923@N00,7429,9,1193541239,1193541479,1,2,240
90642923@N00,7430,19,1199603364,1199603784,2,2,420
90642923@N00,7430,6,1199614794,1199615049,1,2,255
90642923@N00,7431,20,1199691993,1199692212,2,2,219
90642923@N00,7431,19,1199692212,1199692632,2,2,420
90642923@N00,7432,17,1205457984,1205459364,2,2,1380
90642923@N00,7432,4,1205460426,1205461326,1,2,900
90642923@N00,7433,6,1222770899,1222771154,3,5,255
90642923@N00,7433,22,1222778977,1222779577,34,5,600
90642923@N00,7433,17,1222780376,1222781756,2,5,1380
90642923@N00,7433,9,1222783775,1222784015,2,5,240
90642923@N00,7433,27,1222784326,1222785526,1,5,1200
90642923@N00,7434,24,1249356944,1249357424,3,1,480
90642923@N00,7435,17,1270094106,1270094996,2,6,890
90642923@N00,7435,26,1270094996,1270095176,2,6,180
90642923@N00,7435,20,1270096087,1270096698,2,6,611
90642923@N00,7435,7,1270096698,1270096788,2,6,90
90642923@N00,7435,6,1270097275,1270097530,3,6,255
90642923@N00,7435,1,1270098888,1270099488,1,6,600
9070451@N03,7436,27,1400444482,1400445129,4,8,647
9070451@N03,7436,20,1400445129,1400446209,12,8,1080
9070451@N03,7436,19,1400450172,1400450592,4,8,420
9070451@N03,7436,18,1400450869,1400452378,3,8,1509
9070451@N03,7436,22,1400452378,1400452978,3,8,600
9070451@N03,7436,9,1400454732,1400454972,3,8,240
9070451@N03,7436,6,1400457484,1400457739,2,8,255
9070451@N03,7436,2,1400458288,1400458378,4,8,90
9070451@N03,7437,25,1400572334,1400573084,4,2,750
9070451@N03,7437,18,1400576502,1400578302,1,2,1800
9070451@N03,7438,22,1400740730,1400741330,2,1,600
9070451@N03,7439,8,1400827589,1400827689,2,6,100
9070451@N03,7439,7,1400827689,1400827779,2,6,90
9070451@N03,7439,10,1400827810,1400828230,6,6,420
9070451@N03,7439,9,1400842277,1400842517,2,6,240
9070451@N03,7439,13,1400845672,1400846272,2,6,600
9070451@N03,7439,22,1400848650,1400849250,1,6,600
9070451@N03,7440,27,1400889087,1400890287,5,6,1200
9070451@N03,7440,9,1400892176,1400892416,8,6,240
9070451@N03,7440,14,1400893360,1400893480,2,6,120
9070451@N03,7440,13,1400897681,1400898281,29,6,600
9070451@N03,7440,22,1400900775,1400901375,3,6,600
9070451@N03,7440,20,1400906444,1400907524,4,6,1080
90728477@N00,7441,21,1369408721,1369409171,2,2,450
90728477@N00,7441,25,1369410829,1369411579,1,2,750
90728477@N00,7442,21,1369557399,1369557849,2,2,450
90728477@N00,7442,4,1369564854,1369565754,1,2,900
90728477@N00,7443,27,1371851403,1371852603,3,16,1200
90728477@N00,7443,10,1371860276,1371860696,2,16,420
90728477@N00,7443,7,1371861567,1371861657,2,16,90
90728477@N00,7443,8,1371861807,1371861927,2,16,120
90728477@N00,7443,14,1371862520,1371862640,3,16,120
90728477@N00,7443,21,1371869071,1371869521,2,16,450
90728477@N00,7443,1,1371873724,1371874324,3,16,600
90728477@N00,7443,9,1371877763,1371878003,2,16,240
90728477@N00,7443,14,1371879605,1371879725,3,16,120
90728477@N00,7443,17,1371882865,1371884245,2,16,1380
90728477@N00,7443,18,1371885431,1371887231,2,16,1800
90728477@N00,7443,23,1371888564,1371888654,2,16,90
90728477@N00,7443,21,1371889366,1371889816,3,16,450
90728477@N00,7443,1,1371896506,1371896925,2,16,419
90728477@N00,7443,4,1371896925,1371897825,2,16,900
90728477@N00,7443,17,1371907213,1371908593,2,16,1380
90745831@N00,7444,24,1348844467,1348844514,2,2,47
90745831@N00,7444,27,1348844514,1348845714,1,2,1200
90755543@N00,7445,10,1396408696,1396409116,3,4,420
90755543@N00,7445,16,1396409877,1396410597,2,4,720
90755543@N00,7445,4,1396417495,1396418395,2,4,900
90755543@N00,7445,11,1396425324,1396425504,1,4,180
90791262@N00,7446,16,1267587582,1267588302,1,1,720
90844305@N00,7447,20,1215318661,1215319741,2,2,1080
90844305@N00,7447,19,1215321799,1215322219,1,2,420
90850703@N04,7448,27,1364998899,1364999158,2,2,259
90850703@N04,7448,9,1364999158,1364999398,1,2,240
90863949@N00,7449,16,1259486859,1259486866,2,2,7
90863949@N00,7449,12,1259486866,1259487706,2,2,840
90906438@N03,7450,27,1364858818,1364860018,9,1,1200
91013187@N00,7451,26,1191207369,1191207549,1,1,180
91045059@N02,7452,7,1358462487,1358462577,7,8,90
91045059@N02,7452,15,1358465080,1358465260,21,8,180
91045059@N02,7452,17,1358467084,1358468464,2,8,1380
91045059@N02,7452,20,1358469516,1358470596,5,8,1080
91045059@N02,7452,21,1358471289,1358471739,3,8,450
91045059@N02,7452,18,1358476583,1358478383,2,8,1800
91045059@N02,7452,27,1358482387,1358483587,4,8,1200
91045059@N02,7452,6,1358485023,1358485278,43,8,255
91065735@N08,7453,17,1394075540,1394076920,3,2,1380
91065735@N08,7453,16,1394085824,1394086544,4,2,720
91080660@N08,7454,14,1407398634,1407398754,1,1,120
91087719@N08,7455,14,1355880288,1355880408,1,1,120
91087719@N08,7456,14,1356207066,1356207186,2,2,120
91087719@N08,7456,10,1356207324,1356207744,1,2,420
91087719@N08,7457,27,1369255526,1369256726,1,1,1200
91087719@N08,7458,27,1369336171,1369337371,1,1,1200
91087719@N08,7459,13,1416475642,1416476242,2,2,600
91087719@N08,7459,10,1416487775,1416488195,1,2,420
91110029@N02,7460,1,1363490398,1363490998,1,1,600
91110029@N02,7461,27,1414619189,1414619196,2,3,7
91110029@N02,7461,14,1414619196,1414619226,2,3,30
91110029@N02,7461,15,1414619226,1414619406,1,3,180
91129684@N00,7462,14,1256428894,1256429014,1,1,120
91132397@N08,7463,8,1417391856,1417391976,2,2,120
91132397@N08,7463,11,1417392727,1417392907,1,2,180
91132397@N08,7464,27,1417780672,1417781872,1,1,1200
91138989@N00,7465,9,1403678483,1403678723,1,1,240
91144647@N06,7466,27,1333920168,1333921368,5,4,1200
91144647@N06,7466,14,1333927978,1333928098,11,4,120
91144647@N06,7466,18,1333933677,1333935477,2,4,1800
91144647@N06,7466,20,1333937989,1333939069,1,4,1080
91144647@N06,7467,25,1334038854,1334039604,1,1,750
91194707@N06,7468,13,1389061598,1389062198,1,1,600
91207697@N08,7469,27,1413235548,1413236748,3,5,1200
91207697@N08,7469,14,1413251428,1413251548,2,5,120
91207697@N08,7469,27,1413252303,1413253503,5,5,1200
91207697@N08,7469,14,1413259589,1413259709,2,5,120
91207697@N08,7469,27,1413268837,1413270037,2,5,1200
91207697@N08,7470,16,1413326021,1413326741,2,5,720
91207697@N08,7470,10,1413326793,1413327213,2,5,420
91207697@N08,7470,15,1413329924,1413330104,2,5,180
91207697@N08,7470,23,1413332932,1413333022,2,5,90
91207697@N08,7470,9,1413336393,1413336633,1,5,240
91207697@N08,7471,27,1413797192,1413798392,4,1,1200
91207697@N08,7472,25,1413926870,1413927620,3,2,750
91207697@N08,7472,14,1413935213,1413935333,1,2,120
91207697@N08,7473,27,1414052139,1414053339,1,1,1200
91207697@N08,7474,17,1414300175,1414301555,3,2,1380
91207697@N08,7474,10,1414306308,1414306728,1,2,420
91207697@N08,7475,23,1445354341,1445354431,1,1,90
91219782@N07,7476,27,1370179291,1370179570,2,2,279
91219782@N07,7476,4,1370179570,1370180470,1,2,900
91220827@N02,7477,27,1376946610,1376947810,1,1,1200
91220827@N02,7478,19,1376978047,1376978467,1,1,420
91227166@N06,7479,20,1353213714,1353214794,1,1,1080
91227166@N06,7480,16,1354361561,1354362281,1,1,720
91227166@N06,7481,9,1393149555,1393149795,2,1,240
91227690@N08,7482,16,1459665238,1459665958,2,3,720
91227690@N08,7482,20,1459666719,1459666805,2,3,86
91227690@N08,7482,18,1459666805,1459668605,2,3,1800
91227690@N08,7483,27,1460003456,1460004656,5,6,1200
91227690@N08,7483,9,1460004680,1460004920,4,6,240
91227690@N08,7483,19,1460006265,1460006685,4,6,420
91227690@N08,7483,18,1460006878,1460007022,6,6,144
91227690@N08,7483,19,1460007022,1460007080,2,6,58
91227690@N08,7483,18,1460007080,1460008880,2,6,1800
91227690@N08,7484,27,1460521986,1460523186,4,3,1200
91227690@N08,7484,19,1460524584,1460525004,8,3,420
91227690@N08,7484,24,1460527760,1460528240,5,3,480
91227690@N08,7485,3,1461214646,1461214916,4,2,270
91227690@N08,7485,9,1461217551,1461217791,1,2,240
91227690@N08,7486,14,1461474293,1461474413,3,2,120
91227690@N08,7486,10,1461474461,1461474881,6,2,420
91255056@N07,7487,9,1353751213,1353751453,2,2,240
91255056@N07,7487,16,1353751960,1353752680,2,2,720
91288922@N03,7488,14,1387608264,1387608384,1,1,120
91315857@N02,7489,19,1377548204,1377548624,2,2,420
91315857@N02,7489,21,1377558920,1377559370,1,2,450
91315857@N02,7490,4,1444079988,1444080888,1,1,900
91363409@N07,7491,14,1416355465,1416355585,2,2,120
91363409@N07,7491,20,1416359079,1416360159,1,2,1080
91363409@N07,7492,14,1416449852,1416449972,1,1,120
91372718@N04,7493,27,1374706681,1374707881,4,11,1200
91372718@N04,7493,13,1374721547,1374721571,2,11,24
91372718@N04,7493,15,1374721571,1374721592,2,11,21
91372718@N04,7493,13,1374721592,1374721682,2,11,90
91372718@N04,7493,15,1374721682,1374721862,2,11,180
91372718@N04,7493,22,1374724070,1374724670,2,11,600
91372718@N04,7493,21,1374725970,1374726420,5,11,450
91372718@N04,7493,20,1374726618,1374727698,3,11,1080
91372718@N04,7493,15,1374732430,1374732610,3,11,180
91372718@N04,7493,12,1374734158,1374734998,2,11,840
91372718@N04,7493,20,1374735463,1374736543,1,11,1080
91372846@N04,7494,14,1384330275,1384330395,4,2,120
91372846@N04,7494,6,1384332668,1384332923,1,2,255
91401980@N02,7495,6,1461720475,1461720730,2,6,255
91401980@N02,7495,2,1461722887,1461722977,2,6,90
91401980@N02,7495,6,1461724392,1461724647,2,6,255
91401980@N02,7495,9,1461730215,1461730455,2,6,240
91401980@N02,7495,20,1461735108,1461736188,2,6,1080
91401980@N02,7495,27,1461741502,1461742702,1,6,1200
91407288@N07,7496,20,1352151845,1352152925,2,6,1080
91407288@N07,7496,4,1352162943,1352163843,9,6,900
91407288@N07,7496,3,1352189537,1352189635,4,6,98
91407288@N07,7496,4,1352189635,1352190535,3,6,900
91407288@N07,7496,6,1352198299,1352198554,2,6,255
91407288@N07,7496,14,1352200726,1352200846,1,6,120
91407458@N00,7497,27,1305331053,1305332253,1,1,1200
91409399@N07,7498,4,1379461777,1379462677,2,9,900
91409399@N07,7498,18,1379469785,1379471585,3,9,1800
91409399@N07,7498,14,1379474139,1379474259,2,9,120
91409399@N07,7498,10,1379476499,1379476919,8,9,420
91409399@N07,7498,11,1379480429,1379480609,3,9,180
91409399@N07,7498,22,1379483899,1379484499,5,9,600
91409399@N07,7498,17,1379487401,1379488781,2,9,1380
91409399@N07,7498,13,1379491866,1379492466,4,9,600
91409399@N07,7498,12,1379500491,1379501331,1,9,840
91409399@N07,7499,26,1379845412,1379845592,5,2,180
91409399@N07,7499,14,1379859036,1379859156,2,2,120
91409399@N07,7500,27,1380015147,1380016347,3,3,1200
91409399@N07,7500,13,1380029001,1380029601,2,3,600
91409399@N07,7500,17,1380032292,1380033672,1,3,1380
91435349@N03,7501,1,1381533573,1381534173,1,1,600
91456744@N00,7502,17,1322296534,1322297225,2,2,691
91456744@N00,7502,9,1322297225,1322297465,1,2,240
91456744@N00,7503,14,1322722769,1322722889,2,2,120
91456744@N00,7503,24,1322724090,1322724570,1,2,480
91501015@N07,7504,27,1357597010,1357598210,54,1,1200
91511594@N02,7505,13,1370959280,1370959880,1,1,600
91511594@N02,7506,27,1385291634,1385292834,2,2,1200
91511594@N02,7506,14,1385304130,1385304250,1,2,120
91511594@N02,7507,27,1388823296,1388824496,1,1,1200
91513146@N00,7508,20,1451185656,1451186736,1,1,1080
91569514@N05,7509,9,1432944223,1432944463,21,2,240
91569514@N05,7509,16,1432976293,1432977013,31,2,720
91569514@N05,7510,9,1433508807,1433509047,1,1,240
91603829@N00,7511,3,1425937026,1425937296,2,3,270
91603829@N00,7511,15,1425944538,1425944718,2,3,180
91603829@N00,7511,20,1425960887,1425961967,2,3,1080
91605234@N05,7512,24,1357944268,1357944748,2,3,480
91605234@N05,7512,21,1357955542,1357955992,2,3,450
91605234@N05,7512,13,1357958550,1357959150,1,3,600
9161595@N03,7513,16,1329259678,1329260296,4,21,618
9161595@N03,7513,14,1329260296,1329260416,2,21,120
9161595@N03,7513,9,1329260481,1329260721,3,21,240
9161595@N03,7513,1,1329260926,1329261473,3,21,547
9161595@N03,7513,2,1329261473,1329261563,2,21,90
9161595@N03,7513,9,1329261898,1329262138,2,21,240
9161595@N03,7513,4,1329265426,1329266326,14,21,900
9161595@N03,7513,16,1329270394,1329271114,9,21,720
9161595@N03,7513,18,1329272382,1329273307,2,21,925
9161595@N03,7513,22,1329273307,1329273907,13,21,600
9161595@N03,7513,25,1329274730,1329274943,3,21,213
9161595@N03,7513,27,1329274943,1329276143,5,21,1200
9161595@N03,7513,15,1329291361,1329291541,20,21,180
9161595@N03,7513,13,1329292219,1329292781,4,21,562
9161595@N03,7513,15,1329292781,1329292961,4,21,180
9161595@N03,7513,18,1329294868,1329295348,2,21,480
9161595@N03,7513,26,1329295348,1329295403,2,21,55
9161595@N03,7513,23,1329295403,1329295493,20,21,90
9161595@N03,7513,17,1329297209,1329297450,3,21,241
9161595@N03,7513,25,1329297450,1329297872,2,21,422
9161595@N03,7513,27,1329297872,1329299072,1,21,1200
91619162@N06,7514,3,1391638995,1391639265,1,1,270
91621746@N00,7515,27,1330291508,1330292708,3,5,1200
91621746@N00,7515,2,1330295128,1330295135,3,5,7
91621746@N00,7515,1,1330295135,1330295341,4,5,206
91621746@N00,7515,6,1330295341,1330295596,2,5,255
91621746@N00,7515,17,1330302130,1330303510,10,5,1380
91621746@N00,7516,27,1330401851,1330403051,3,3,1200
91621746@N00,7516,17,1330411034,1330412414,3,3,1380
91621746@N00,7516,14,1330412952,1330413072,1,3,120
91646799@N06,7517,9,1439791619,1439791859,1,1,240
91678850@N02,7518,16,1355403296,1355404016,1,1,720
91694685@N00,7519,27,1221045155,1221046355,1,1,1200
91742441@N04,7520,17,1325666335,1325667715,1,1,1380
91759611@N06,7521,19,1337326476,1337326896,2,1,420
91761857@N00,7522,12,1396143043,1396143059,3,2,16
91761857@N00,7522,14,1396143059,1396143179,2,2,120
91761857@N00,7523,16,1396439491,1396440211,8,1,720
91761857@N00,7524,27,1400760339,1400761539,2,1,1200
9176927@N08,7525,22,1212803903,1212804503,2,3,600
9176927@N08,7525,17,1212811779,1212813159,9,3,1380
9176927@N08,7525,22,1212821809,1212822409,1,3,600
9176927@N08,7526,27,1230270435,1230271635,1,1,1200
9176927@N08,7527,27,1239253428,1239253636,2,4,208
9176927@N08,7527,4,1239253636,1239254536,2,4,900
9176927@N08,7527,9,1239257446,1239257686,2,4,240
9176927@N08,7527,17,1239279369,1239280749,1,4,1380
91779914@N00,7528,27,1241675709,1241676909,1,1,1200
91792400@N00,7529,14,1436332835,1436332955,1,1,120
91831221@N00,7530,4,1325509234,1325510134,1,1,900
91835518@N00,7531,18,1236240889,1236242689,1,1,1800
91855896@N00,7532,27,1319844261,1319845461,4,6,1200
91855896@N00,7532,14,1319846654,1319846774,3,6,120
91855896@N00,7532,9,1319849330,1319849570,3,6,240
91855896@N00,7532,14,1319856611,1319856625,2,6,14
91855896@N00,7532,16,1319856625,1319857345,3,6,720
91855896@N00,7532,27,1319860323,1319861523,3,6,1200
91855896@N00,7533,16,1319962338,1319963058,4,4,720
91855896@N00,7533,14,1319964971,1319964981,4,4,10
91855896@N00,7533,16,1319964981,1319965701,4,4,720
91855896@N00,7533,27,1319972871,1319974071,3,4,1200
91869814@N05,7534,27,1327574662,1327575862,1,1,1200
91930279@N04,7535,27,1373518121,1373519321,4,1,1200
91966035@N00,7536,7,1401864340,1401864430,2,1,90
9197147@N03,7537,22,1400419717,1400420317,1,1,600
92008781@N05,7538,17,1344248474,1344249854,1,1,1380
92026547@N05,7539,27,1409731795,1409732995,1,1,1200
92026547@N05,7540,22,1410853523,1410854123,2,2,600
92026547@N05,7540,27,1410857956,1410859156,2,2,1200
92026547@N05,7541,18,1411538600,1411538863,2,6,263
92026547@N05,7541,19,1411538863,1411539283,2,6,420
92026547@N05,7541,13,1411539345,1411539945,2,6,600
92026547@N05,7541,20,1411540369,1411541034,2,6,665
92026547@N05,7541,18,1411541034,1411542834,6,6,1800
92026547@N05,7541,27,1411547641,1411548841,2,6,1200
92026547@N05,7542,2,1412073455,1412073545,3,3,90
92026547@N05,7542,20,1412076160,1412077240,2,3,1080
92026547@N05,7542,16,1412077360,1412078080,1,3,720
92026547@N05,7543,15,1412646183,1412646363,2,3,180
92026547@N05,7543,9,1412647678,1412647918,2,3,240
92026547@N05,7543,3,1412648213,1412648483,1,3,270
92096485@N04,7544,14,1353477379,1353477499,1,1,120
9211132@N07,7545,25,1335067836,1335068586,2,1,750
92243116@N08,7546,25,1375334273,1375335023,1,1,750
9228491@N06,7547,4,1267262459,1267262581,2,12,122
9228491@N06,7547,16,1267262581,1267262714,2,12,133
9228491@N06,7547,14,1267262714,1267262834,3,12,120
9228491@N06,7547,9,1267262834,1267263026,3,12,192
9228491@N06,7547,1,1267263026,1267263106,2,12,80
9228491@N06,7547,2,1267263106,1267263155,2,12,49
9228491@N06,7547,4,1267263155,1267263382,2,12,227
9228491@N06,7547,16,1267263382,1267263420,2,12,38
9228491@N06,7547,17,1267263420,1267263526,2,12,106
9228491@N06,7547,16,1267263526,1267264245,3,12,719
9228491@N06,7547,27,1267264245,1267265445,4,12,1200
9228491@N06,7547,9,1267273526,1267273766,1,12,240
9228491@N06,7548,27,1267392984,1267394184,10,28,1200
9228491@N06,7548,21,1267394881,1267395331,2,28,450
9228491@N06,7548,24,1267395653,1267396133,2,28,480
9228491@N06,7548,4,1267397110,1267397164,2,28,54
9228491@N06,7548,2,1267397164,1267397254,2,28,90
9228491@N06,7548,1,1267397306,1267397317,2,28,11
9228491@N06,7548,6,1267397317,1267397350,2,28,33
9228491@N06,7548,5,1267397350,1267397405,2,28,55
9228491@N06,7548,6,1267397405,1267397409,2,28,4
9228491@N06,7548,1,1267397409,1267397424,2,28,15
9228491@N06,7548,6,1267397424,1267397486,2,28,62
9228491@N06,7548,1,1267397486,1267397621,3,28,135
9228491@N06,7548,6,1267397621,1267397638,2,28,17
9228491@N06,7548,1,1267397638,1267397766,2,28,128
9228491@N06,7548,5,1267397766,1267397901,2,28,135
9228491@N06,7548,2,1267397901,1267397991,2,28,90
9228491@N06,7548,9,1267398117,1267398357,2,28,240
9228491@N06,7548,8,1267398371,1267398491,2,28,120
9228491@N06,7548,27,1267398744,1267399131,2,28,387
9228491@N06,7548,19,1267399131,1267399551,2,28,420
9228491@N06,7548,1,1267399643,1267400243,2,28,600
9228491@N06,7548,16,1267400366,1267401086,13,28,720
9228491@N06,7548,2,1267402238,1267402328,2,28,90
9228491@N06,7548,18,1267405066,1267405688,4,28,622
9228491@N06,7548,19,1267405688,1267406108,3,28,420
9228491@N06,7548,18,1267406286,1267408086,3,28,1800
9228491@N06,7548,26,1267409456,1267409636,3,28,180
9228491@N06,7548,27,1267411296,1267412496,2,28,1200
9228491@N06,7549,12,1267501686,1267502526,6,3,840
9228491@N06,7549,26,1267503021,1267503201,28,3,180
9228491@N06,7549,16,1267513430,1267514150,4,3,720
9228491@N06,7550,27,1267739849,1267741049,10,5,1200
9228491@N06,7550,2,1267744357,1267744447,2,5,90
9228491@N06,7550,12,1267745417,1267746257,3,5,840
9228491@N06,7550,19,1267752403,1267752823,2,5,420
9228491@N06,7550,27,1267761811,1267763011,1,5,1200
9228491@N06,7551,22,1267863832,1267864432,17,1,600
9228491@N06,7552,17,1268010058,1268011438,1,1,1380
9228491@N06,7553,2,1268365199,1268365289,2,3,90
9228491@N06,7553,27,1268367744,1268368944,11,3,1200
9228491@N06,7553,1,1268369415,1268370015,2,3,600
9228491@N06,7554,27,1269852665,1269853865,1,1,1200
9228491@N06,7555,27,1322945356,1322946556,1,1,1200
9228491@N06,7556,27,1323134836,1323136036,1,1,1200
9228491@N06,7557,16,1323471691,1323472411,1,1,720
9228491@N06,7558,1,1323739185,1323739785,1,1,600
9228491@N06,7559,22,1323854670,1323855270,5,1,600
92320528@N07,7560,27,1387132054,1387133254,2,1,1200
92320528@N07,7561,27,1431925579,1431926779,1,1,1200
9233146@N03,7562,23,1208864277,1208864277,2,2,0
9233146@N03,7562,25,1208864277,1208865027,1,2,750
9233146@N03,7563,17,1208950737,1208952117,1,1,1380
92391434@N05,7564,13,1420604047,1420604647,1,1,600
92398584@N02,7565,2,1353559635,1353559725,1,1,90
9243200@N04,7566,14,1361283189,1361283309,1,1,120
92504072@N06,7567,25,1291264847,1291265597,4,1,750
92504072@N06,7568,17,1291459310,1291460690,1,1,1380
92504072@N06,7569,17,1305959034,1305959364,4,4,330
92504072@N06,7569,21,1305959364,1305959814,4,4,450
92504072@N06,7569,9,1305964253,1305964493,5,4,240
92504072@N06,7569,21,1305968840,1305969290,1,4,450
92533979@N00,7570,1,1359674005,1359674605,2,10,600
92533979@N00,7570,5,1359674738,1359675458,2,10,720
92533979@N00,7570,6,1359675650,1359675905,2,10,255
92533979@N00,7570,22,1359681098,1359681698,2,10,600
92533979@N00,7570,24,1359687628,1359688108,2,10,480
92533979@N00,7570,23,1359691202,1359691292,2,10,90
92533979@N00,7570,10,1359702036,1359702456,3,10,420
92533979@N00,7570,14,1359702948,1359703068,2,10,120
92533979@N00,7570,17,1359703485,1359704865,2,10,1380
92533979@N00,7570,2,1359711195,1359711285,1,10,90
9261503@N08,7571,17,1434338659,1434338681,2,6,22
9261503@N08,7571,16,1434338681,1434338989,3,6,308
9261503@N08,7571,9,1434338989,1434339229,2,6,240
9261503@N08,7571,5,1434341832,1434342552,2,6,720
9261503@N08,7571,16,1434356749,1434357079,2,6,330
9261503@N08,7571,4,1434357079,1434357979,1,6,900
92622262@N08,7572,27,1369480456,1369481656,2,4,1200
92622262@N08,7572,19,1369485375,1369485795,2,4,420
92622262@N08,7572,13,1369486689,1369487289,3,4,600
92622262@N08,7572,15,1369488672,1369488852,1,4,180
92622262@N08,7573,10,1375524770,1375525190,2,3,420
92622262@N08,7573,9,1375528792,1375529032,4,3,240
92622262@N08,7573,3,1375531952,1375532222,2,3,270
92622262@N08,7574,20,1378517960,1378519040,9,6,1080
92622262@N08,7574,9,1378525780,1378526020,3,6,240
92622262@N08,7574,14,1378526327,1378526335,2,6,8
92622262@N08,7574,15,1378526335,1378526353,3,6,18
92622262@N08,7574,14,1378526353,1378526473,5,6,120
92622262@N08,7574,16,1378527186,1378527906,4,6,720
92622262@N08,7575,19,1392430108,1392430528,2,1,420
92622262@N08,7576,7,1400926973,1400927063,4,4,90
92622262@N08,7576,10,1400928156,1400928576,3,4,420
92622262@N08,7576,20,1400937113,1400938193,2,4,1080
92622262@N08,7576,27,1400939597,1400940797,1,4,1200
92678857@N02,7577,16,1388658996,1388659716,6,1,720
92682932@N08,7578,12,1381146319,1381147159,1,1,840
9274852@N08,7579,4,1349349715,1349350615,1,1,900
9275923@N03,7580,27,1231109066,1231110266,3,8,1200
9275923@N03,7580,12,1231110580,1231111420,4,8,840
9275923@N03,7580,26,1231112941,1231113121,2,8,180
9275923@N03,7580,16,1231115284,1231116004,2,8,720
9275923@N03,7580,15,1231116093,1231116273,2,8,180
9275923@N03,7580,25,1231117127,1231117463,2,8,336
9275923@N03,7580,4,1231117463,1231118363,2,8,900
9275923@N03,7580,16,1231122556,1231123276,2,8,720
92824695@N03,7581,16,1366171373,1366172093,2,2,720
92824695@N03,7581,27,1366176479,1366177679,1,2,1200
92854641@N00,7582,8,1192868204,1192868324,2,1,120
92859253@N04,7583,27,1403854617,1403855817,2,14,1200
92859253@N04,7583,16,1403856108,1403856828,2,14,720
92859253@N04,7583,10,1403857341,1403857761,5,14,420
92859253@N04,7583,6,1403863752,1403863854,2,14,102
92859253@N04,7583,12,1403863854,1403864058,10,14,204
92859253@N04,7583,13,1403864058,1403864292,3,14,234
92859253@N04,7583,7,1403864292,1403864382,2,14,90
92859253@N04,7583,12,1403864554,1403864946,2,14,392
92859253@N04,7583,15,1403864946,1403865126,2,14,180
92859253@N04,7583,1,1403867558,1403867937,4,14,379
92859253@N04,7583,8,1403867937,1403867974,2,14,37
92859253@N04,7583,7,1403867974,1403868064,3,14,90
92859253@N04,7583,1,1403868093,1403868196,3,14,103
92859253@N04,7583,8,1403868196,1403868316,1,14,120
9290765@N06,7584,20,1222135883,1222136963,4,2,1080
9290765@N06,7584,2,1222149939,1222150029,1,2,90
93003498@N05,7585,27,1360966495,1360967695,1,1,1200
93003498@N05,7586,27,1363313411,1363314611,2,2,1200
93003498@N05,7586,10,1363321379,1363321799,1,2,420
93003498@N05,7587,14,1366079721,1366079841,2,1,120
93004366@N08,7588,14,1456728696,1456728816,1,1,120
93081598@N05,7589,27,1360808724,1360809924,1,1,1200
93081598@N05,7590,3,1361442751,1361443021,1,1,270
93081598@N05,7591,27,1361517589,1361518789,22,2,1200
93081598@N05,7591,10,1361520639,1361521059,8,2,420
93081598@N05,7592,9,1364796169,1364796409,1,1,240
93081598@N05,7593,27,1366192199,1366193399,1,1,1200
93081598@N05,7594,27,1366327468,1366328495,5,7,1027
93081598@N05,7594,6,1366328495,1366328750,17,7,255
93081598@N05,7594,9,1366330781,1366330801,3,7,20
93081598@N05,7594,6,1366330801,1366331056,8,7,255
93081598@N05,7594,9,1366331230,1366331238,3,7,8
93081598@N05,7594,6,1366331238,1366331493,5,7,255
93081598@N05,7594,26,1366335424,1366335604,10,7,180
93081598@N05,7595,27,1366690362,1366691562,9,1,1200
93081598@N05,7596,25,1367151500,1367152250,2,1,750
93081598@N05,7597,14,1367714832,1367714952,2,3,120
93081598@N05,7597,25,1367727560,1367727746,2,3,186
93081598@N05,7597,26,1367727746,1367727926,1,3,180
93081598@N05,7598,27,1367822051,1367823251,9,1,1200
93086051@N00,7599,8,1333877529,1333877649,1,1,120
93117900@N03,7600,13,1383189805,1383190405,2,3,600
93117900@N03,7600,14,1383199593,1383199713,2,3,120
93117900@N03,7600,9,1383199762,1383200002,1,3,240
93123267@N00,7601,23,1209783099,1209783189,1,1,90
93126204@N00,7602,9,1368319543,1368319783,2,10,240
93126204@N00,7602,12,1368320995,1368321835,4,10,840
93126204@N00,7602,23,1368330641,1368330731,2,10,90
93126204@N00,7602,4,1368340833,1368341733,5,10,900
93126204@N00,7602,1,1368342443,1368343043,3,10,600
93126204@N00,7602,2,1368343156,1368343246,6,10,90
93126204@N00,7602,1,1368344192,1368344792,3,10,600
93126204@N00,7602,7,1368350300,1368350390,2,10,90
93126204@N00,7602,11,1368351538,1368351718,4,10,180
93126204@N00,7602,22,1368354458,1368355058,2,10,600
93132003@N00,7603,14,1225179990,1225180110,12,1,120
93150071@N06,7604,16,1364005380,1364006100,1,1,720
93175351@N02,7605,14,1361673787,1361673907,1,1,120
93192429@N00,7606,27,1273432824,1273433419,2,5,595
93192429@N00,7606,16,1273433419,1273434139,2,5,720
93192429@N00,7606,14,1273434573,1273434693,2,5,120
93192429@N00,7606,12,1273434800,1273435640,3,5,840
93192429@N00,7606,9,1273437752,1273437992,1,5,240
93194990@N08,7607,10,1358834245,1358834665,1,1,420
93218256@N03,7608,8,1410940431,1410940551,1,1,120
93260943@N08,7609,14,1360919213,1360919333,1,1,120
93260943@N08,7610,16,1380374802,1380375522,1,1,720
93273458@N00,7611,13,1297719898,1297720498,2,3,600
93273458@N00,7611,20,1297724445,1297725525,2,3,1080
93273458@N00,7611,25,1297729925,1297730675,3,3,750
93273458@N00,7612,20,1410594452,1410595532,1,1,1080
93283041@N00,7613,20,1217925246,1217926326,2,1,1080
93283041@N00,7614,27,1229374452,1229374812,7,27,360
93283041@N00,7614,16,1229374812,1229374949,2,27,137
93283041@N00,7614,17,1229374949,1229375552,2,27,603
93283041@N00,7614,20,1229375552,1229376632,9,27,1080
93283041@N00,7614,19,1229376935,1229377003,2,27,68
93283041@N00,7614,20,1229377003,1229378083,2,27,1080
93283041@N00,7614,13,1229378891,1229379178,2,27,287
93283041@N00,7614,12,1229379178,1229379738,2,27,560
93283041@N00,7614,15,1229379738,1229379843,2,27,105
93283041@N00,7614,12,1229379843,1229380683,15,27,840
93283041@N00,7614,14,1229381422,1229381542,2,27,120
93283041@N00,7614,16,1229381662,1229382281,2,27,619
93283041@N00,7614,9,1229382281,1229382521,4,27,240
93283041@N00,7614,2,1229382924,1229382935,2,27,11
93283041@N00,7614,1,1229382935,1229383535,2,27,600
93283041@N00,7614,5,1229386464,1229386550,2,27,86
93283041@N00,7614,16,1229386550,1229386556,2,27,6
93283041@N00,7614,4,1229386556,1229387456,2,27,900
93283041@N00,7614,27,1229387832,1229387845,2,27,13
93283041@N00,7614,16,1229387845,1229388273,4,27,428
93283041@N00,7614,2,1229388273,1229388363,2,27,90
93283041@N00,7614,1,1229391033,1229391276,2,27,243
93283041@N00,7614,21,1229391276,1229391726,4,27,450
93283041@N00,7614,20,1229393318,1229393725,2,27,407
93283041@N00,7614,17,1229393725,1229393882,2,27,157
93283041@N00,7614,13,1229393882,1229394482,2,27,600
93283041@N00,7614,27,1229398135,1229399335,5,27,1200
93283041@N00,7615,27,1229582384,1229582909,7,12,525
93283041@N00,7615,16,1229582909,1229583629,2,12,720
93283041@N00,7615,9,1229583630,1229583870,7,12,240
93283041@N00,7615,16,1229585568,1229586288,3,12,720
93283041@N00,7615,3,1229588046,1229588316,5,12,270
93283041@N00,7615,13,1229589951,1229590551,3,12,600
93283041@N00,7615,16,1229592434,1229593154,12,12,720
93283041@N00,7615,27,1229593851,1229594063,3,12,212
93283041@N00,7615,16,1229594063,1229594783,6,12,720
93283041@N00,7615,26,1229596719,1229596899,16,12,180
93283041@N00,7615,20,1229599807,1229600887,2,12,1080
93283041@N00,7615,16,1229601566,1229602286,1,12,720
93283041@N00,7616,27,1229759337,1229760537,3,4,1200
93283041@N00,7616,26,1229761410,1229761590,21,4,180
93283041@N00,7616,22,1229763535,1229764135,2,4,600
93283041@N00,7616,12,1229769803,1229770643,2,4,840
93283041@N00,7617,27,1264628553,1264629753,2,12,1200
93283041@N00,7617,20,1264630193,1264631273,2,12,1080
93283041@N00,7617,19,1264633614,1264634034,3,12,420
93283041@N00,7617,9,1264638776,1264639016,2,12,240
93283041@N00,7617,6,1264640310,1264640565,2,12,255
93283041@N00,7617,17,1264648403,1264649783,18,12,1380
93283041@N00,7617,2,1264652075,1264652165,3,12,90
93283041@N00,7617,1,1264654174,1264654280,2,12,106
93283041@N00,7617,2,1264654280,1264654370,2,12,90
93283041@N00,7617,1,1264654518,1264655118,2,12,600
93283041@N00,7617,2,1264658149,1264658239,2,12,90
93283041@N00,7617,24,1264661680,1264662160,5,12,480
93283041@N00,7618,22,1276680204,1276680804,21,1,600
93283041@N00,7619,27,1286151922,1286153122,14,8,1200
93283041@N00,7619,18,1286157506,1286158014,7,8,508
93283041@N00,7619,19,1286158014,1286158434,3,8,420
93283041@N00,7619,17,1286159156,1286160347,2,8,1191
93283041@N00,7619,9,1286160347,1286160587,2,8,240
93283041@N00,7619,7,1286161031,1286161121,2,8,90
93283041@N00,7619,11,1286161154,1286161334,15,8,180
93283041@N00,7619,27,1286164182,1286165382,3,8,1200
93283041@N00,7620,27,1291794457,1291795657,1,1,1200
93283041@N00,7621,12,1318740494,1318741334,2,3,840
93283041@N00,7621,16,1318755592,1318756312,2,3,720
93283041@N00,7621,9,1318757708,1318757948,2,3,240
93283041@N00,7622,27,1323404755,1323405808,5,4,1053
93283041@N00,7622,24,1323405808,1323406288,3,4,480
93283041@N00,7622,13,1323409518,1323410118,3,4,600
93283041@N00,7622,27,1323425124,1323426324,2,4,1200
93283041@N00,7623,18,1334478501,1334480301,2,1,1800
93294943@N08,7624,14,1357008698,1357008818,1,1,120
93294943@N08,7625,24,1362051142,1362051622,1,1,480
93294943@N08,7626,16,1403620162,1403620882,1,1,720
9329633@N04,7627,19,1353993623,1353994043,1,1,420
9329633@N04,7628,14,1354072118,1354072238,1,1,120
93334382@N02,7629,8,1375436149,1375436269,1,1,120
93334382@N02,7630,16,1376346465,1376347185,3,2,720
93334382@N02,7630,27,1376347369,1376348569,2,2,1200
93334382@N02,7631,23,1380246764,1380246854,2,5,90
93334382@N02,7631,18,1380247481,1380248040,4,5,559
93334382@N02,7631,23,1380248040,1380248130,2,5,90
93334382@N02,7631,13,1380248192,1380248721,2,5,529
93334382@N02,7631,8,1380248721,1380248841,1,5,120
93334382@N02,7632,15,1391375624,1391375745,2,2,121
93334382@N02,7632,10,1391375745,1391376165,2,2,420
93334382@N02,7633,9,1425815788,1425816028,1,1,240
93334382@N02,7634,16,1431465607,1431466327,1,1,720
93387506@N02,7635,16,1381216790,1381217510,1,1,720
93393982@N00,7636,21,1426561289,1426561739,1,1,450
9349788@N07,7637,13,1364320697,1364321297,1,1,600
93503884@N03,7638,20,1351521102,1351522182,2,1,1080
93538524@N06,7639,4,1374194650,1374195550,2,7,900
93538524@N06,7639,6,1374196185,1374196440,5,7,255
93538524@N06,7639,2,1374196703,1374196786,3,7,83
93538524@N06,7639,6,1374196786,1374197041,3,7,255
93538524@N06,7639,1,1374198415,1374199015,2,7,600
93538524@N06,7639,19,1374201949,1374202369,2,7,420
93538524@N06,7639,8,1374203593,1374203713,2,7,120
93575563@N08,7640,27,1331489630,1331490830,19,1,1200
93628549@N00,7641,27,1302759355,1302759910,3,10,555
93628549@N00,7641,16,1302759910,1302760630,2,10,720
93628549@N00,7641,24,1302761809,1302762289,2,10,480
93628549@N00,7641,16,1302763146,1302763866,4,10,720
93628549@N00,7641,24,1302766568,1302767048,2,10,480
93628549@N00,7641,19,1302767785,1302768205,3,10,420
93628549@N00,7641,26,1302775502,1302775682,3,10,180
93628549@N00,7641,14,1302783127,1302783247,3,10,120
93628549@N00,7641,16,1302791399,1302792119,2,10,720
93628549@N00,7641,14,1302792958,1302793078,5,10,120
93629101@N05,7642,27,1430269193,1430270393,2,22,1200
93629101@N05,7642,13,1430271339,1430271939,5,22,600
93629101@N05,7642,14,1430272698,1430272818,8,22,120
93629101@N05,7642,10,1430274662,1430275082,20,22,420
93629101@N05,7642,14,1430276339,1430276459,9,22,120
93629101@N05,7642,10,1430282190,1430282610,2,22,420
93629101@N05,7642,4,1430285456,1430285599,2,22,143
93629101@N05,7642,3,1430285599,1430285869,9,22,270
93629101@N05,7642,4,1430286684,1430287584,5,22,900
93629101@N05,7642,10,1430287631,1430288051,6,22,420
93629101@N05,7642,12,1430292087,1430292116,3,22,29
93629101@N05,7642,15,1430292116,1430292296,5,22,180
93629101@N05,7642,13,1430292818,1430292999,3,22,181
93629101@N05,7642,12,1430292999,1430293088,2,22,89
93629101@N05,7642,13,1430293088,1430293688,2,22,600
93629101@N05,7642,21,1430293741,1430294191,5,22,450
93629101@N05,7642,22,1430295192,1430295792,11,22,600
93629101@N05,7642,17,1430297231,1430298611,15,22,1380
93629101@N05,7642,9,1430301015,1430301255,10,22,240
93629101@N05,7642,6,1430301963,1430302218,2,22,255
93629101@N05,7642,9,1430303585,1430303825,2,22,240
93629101@N05,7642,27,1430309834,1430311034,2,22,1200
9365143@N07,7643,27,1364087748,1364088948,1,1,1200
93743574@N08,7644,14,1416777492,1416777612,3,1,120
93762817@N08,7645,21,1388196275,1388196725,2,2,450
93762817@N08,7645,16,1388200692,1388201412,1,2,720
9381285@N07,7646,27,1300995989,1300997189,1,1,1200
93890245@N05,7647,27,1376952127,1376953327,1,1,1200
93890245@N05,7648,25,1377300786,1377301536,1,1,750
93928120@N03,7649,27,1444856061,1444857261,1,1,1200
9395016@N08,7650,27,1210383560,1210384760,2,20,1200
9395016@N08,7650,21,1210386520,1210386970,5,20,450
9395016@N08,7650,20,1210387229,1210388309,2,20,1080
9395016@N08,7650,22,1210391303,1210391903,2,20,600
9395016@N08,7650,26,1210392440,1210392620,3,20,180
9395016@N08,7650,19,1210397369,1210397789,4,20,420
9395016@N08,7650,17,1210399482,1210400201,2,20,719
9395016@N08,7650,13,1210400201,1210400801,3,20,600
9395016@N08,7650,15,1210401125,1210401305,2,20,180
9395016@N08,7650,16,1210401480,1210402200,3,20,720
9395016@N08,7650,17,1210403107,1210404487,3,20,1380
9395016@N08,7650,20,1210405707,1210406787,5,20,1080
9395016@N08,7650,17,1210407685,1210408278,5,20,593
9395016@N08,7650,4,1210408278,1210409178,2,20,900
9395016@N08,7650,2,1210409845,1210409935,6,20,90
9395016@N08,7650,3,1210411069,1210411339,8,20,270
9395016@N08,7650,4,1210416828,1210417728,11,20,900
9395016@N08,7650,3,1210422388,1210422658,3,20,270
9395016@N08,7650,20,1210425422,1210426228,2,20,806
9395016@N08,7650,27,1210426228,1210427428,9,20,1200
94011132@N06,7651,4,1407461375,1407461518,3,6,143
94011132@N06,7651,5,1407461518,1407461558,2,6,40
94011132@N06,7651,3,1407461558,1407461588,3,6,30
94011132@N06,7651,2,1407461588,1407461666,2,6,78
94011132@N06,7651,5,1407461666,1407462386,2,6,720
94011132@N06,7651,4,1407463418,1407464318,5,6,900
94024282@N00,7652,27,1324206667,1324207867,1,1,1200
94078193@N03,7653,16,1330223739,1330224459,3,1,720
94078193@N03,7654,16,1362266445,1362267165,1,1,720
94078193@N03,7655,27,1362305345,1362306545,1,1,1200
94078193@N03,7656,27,1362618297,1362619497,2,3,1200
94078193@N03,7656,24,1362619545,1362620025,2,3,480
94078193@N03,7656,14,1362640607,1362640727,1,3,120
94100125@N07,7657,22,1452761842,1452762442,1,1,600
94126498@N00,7658,27,1445903926,1445905126,2,5,1200
94126498@N00,7658,3,1445908033,1445908303,3,5,270
94126498@N00,7658,24,1445912098,1445912578,2,5,480
94126498@N00,7658,2,1445922811,1445922901,2,5,90
94126498@N00,7658,27,1445935249,1445936449,1,5,1200
94155755@N00,7659,15,1356036095,1356036275,2,2,180
94155755@N00,7659,27,1356055043,1356056243,1,2,1200
94155755@N00,7660,27,1370390429,1370391629,4,1,1200
9426006@N04,7661,27,1207563361,1207564561,2,1,1200
9426006@N04,7662,12,1207705593,1207706208,2,2,615
9426006@N04,7662,27,1207706208,1207707408,13,2,1200
94272898@N05,7663,14,1394393786,1394393906,2,1,120
9432653@N05,7664,27,1362947871,1362949071,1,1,1200
94358021@N08,7665,27,1376865685,1376866885,1,1,1200
94378868@N00,7666,10,1361081160,1361081580,1,1,420
9442309@N03,7667,27,1339549116,1339550316,3,1,1200
9442309@N03,7668,16,1366850636,1366851356,12,1,720
94436430@N00,7669,27,1360376674,1360377874,2,4,1200
94436430@N00,7669,2,1360384735,1360384825,2,4,90
94436430@N00,7669,3,1360388960,1360389230,2,4,270
94436430@N00,7669,5,1360403847,1360404567,1,4,720
94450464@N02,7670,16,1278072284,1278072284,2,2,0
94450464@N02,7670,17,1278072284,1278073664,1,2,1380
94472595@N03,7671,16,1366293047,1366293767,1,1,720
94472595@N03,7672,9,1370875596,1370875836,2,2,240
94472595@N03,7672,18,1370877158,1370878958,1,2,1800
94473284@N04,7673,2,1455323532,1455323622,5,5,90
94473284@N04,7673,1,1455330912,1455330918,3,5,6
94473284@N04,7673,6,1455330918,1455331173,2,5,255
94473284@N04,7673,13,1455332131,1455332731,2,5,600
94473284@N04,7673,26,1455334027,1455334207,2,5,180
94511303@N04,7674,27,1414227229,1414228429,1,1,1200
94512378@N00,7675,16,1336437716,1336438436,1,1,720
94512378@N00,7676,17,1460101419,1460102799,1,1,1380
94529757@N00,7677,9,1255861492,1255861732,1,1,240
9456601@N03,7678,25,1308188101,1308188270,2,9,169
9456601@N03,7678,26,1308188270,1308188450,2,9,180
9456601@N03,7678,25,1308188484,1308189234,3,9,750
9456601@N03,7678,17,1308194052,1308195432,2,9,1380
9456601@N03,7678,9,1308197100,1308197340,2,9,240
9456601@N03,7678,3,1308199812,1308200082,2,9,270
9456601@N03,7678,4,1308201523,1308201977,2,9,454
9456601@N03,7678,26,1308201977,1308202157,3,9,180
9456601@N03,7678,16,1308218104,1308218824,2,9,720
9461342@N03,7679,27,1397442901,1397444101,1,1,1200
9461342@N03,7680,17,1459839596,1459840976,1,1,1380
94622063@N07,7681,22,1365476744,1365477344,1,1,600
94687753@N00,7682,4,1372463677,1372464577,1,1,900
94697173@N00,7683,23,1443309473,1443309563,2,9,90
94697173@N00,7683,12,1443318352,1443319176,2,9,824
94697173@N00,7683,10,1443319176,1443319596,4,9,420
94697173@N00,7683,11,1443321948,1443322128,2,9,180
94697173@N00,7683,27,1443334186,1443335386,22,9,1200
94697173@N00,7683,2,1443344107,1443344197,3,9,90
94697173@N00,7683,9,1443345741,1443345981,2,9,240
94697173@N00,7683,16,1443345998,1443346718,6,9,720
94697173@N00,7683,27,1443351737,1443352937,23,9,1200
94697173@N00,7684,27,1443484121,1443485321,5,3,1200
94697173@N00,7684,26,1443489833,1443490013,5,3,180
94697173@N00,7684,14,1443493242,1443493362,1,3,120
94697173@N00,7685,27,1443822605,1443823805,2,1,1200
94697173@N00,7686,27,1454625958,1454626907,2,3,949
94697173@N00,7686,17,1454626907,1454628287,5,3,1380
94697173@N00,7686,9,1454633713,1454633953,4,3,240
94738051@N05,7687,17,1375340170,1375341550,1,1,1380
94817984@N02,7688,4,1382050903,1382051803,1,1,900
94817984@N02,7689,4,1384501587,1384502487,1,1,900
94817984@N02,7690,15,1384844702,1384844882,1,1,180
94817984@N02,7691,9,1390464748,1390464988,1,1,240
94817984@N02,7692,15,1390885485,1390885607,4,3,122
94817984@N02,7692,13,1390885607,1390886207,2,3,600
94817984@N02,7692,16,1390886411,1390887131,1,3,720
94817984@N02,7693,15,1391941401,1391941581,3,1,180
94867877@N02,7694,27,1353742593,1353743793,1,1,1200
94921086@N08,7695,27,1384120724,1384121924,2,2,1200
94921086@N08,7695,16,1384146532,1384147252,1,2,720
94921086@N08,7696,14,1384495757,1384495877,3,1,120
94987380@N08,7697,27,1398278029,1398279229,2,4,1200
94987380@N08,7697,1,1398283096,1398283696,2,4,600
94987380@N08,7697,22,1398301372,1398301972,2,4,600
94987380@N08,7697,17,1398321881,1398323261,2,4,1380
94988491@N02,7698,3,1347002957,1347003227,2,1,270
95095552@N02,7699,19,1401504404,1401504824,1,1,420
95095552@N02,7700,14,1401788716,1401788836,1,1,120
95198134@N00,7701,27,1191286435,1191287206,3,25,771
95198134@N00,7701,19,1191287206,1191287626,3,25,420
95198134@N00,7701,27,1191287989,1191288964,13,25,975
95198134@N00,7701,4,1191288964,1191289864,3,25,900
95198134@N00,7701,6,1191291028,1191291283,2,25,255
95198134@N00,7701,1,1191291600,1191292200,2,25,600
95198134@N00,7701,6,1191293934,1191294189,3,25,255
95198134@N00,7701,14,1191296216,1191296336,3,25,120
95198134@N00,7701,15,1191296841,1191297021,4,25,180
95198134@N00,7701,9,1191298847,1191298983,2,25,136
95198134@N00,7701,16,1191298983,1191299142,2,25,159
95198134@N00,7701,17,1191299142,1191300522,2,25,1380
95198134@N00,7701,13,1191300714,1191301314,5,25,600
95198134@N00,7701,18,1191302256,1191303236,4,25,980
95198134@N00,7701,19,1191303236,1191303656,3,25,420
95198134@N00,7701,18,1191303781,1191304199,3,25,418
95198134@N00,7701,26,1191304199,1191304379,2,25,180
95198134@N00,7701,22,1191304441,1191304649,2,25,208
95198134@N00,7701,20,1191304649,1191305729,4,25,1080
95198134@N00,7701,21,1191307948,1191308398,3,25,450
95198134@N00,7701,24,1191310304,1191310784,6,25,480
95198134@N00,7701,25,1191311522,1191312272,4,25,750
95198134@N00,7701,4,1191312871,1191313771,3,25,900
95198134@N00,7701,6,1191315850,1191316105,2,25,255
95198134@N00,7701,27,1191321613,1191322813,2,25,1200
95208154@N03,7702,12,1380325295,1380326135,2,2,840
95208154@N03,7702,14,1380327528,1380327648,1,2,120
95225007@N00,7703,27,1383737362,1383738562,1,1,1200
95230267@N07,7704,9,1409350910,1409351150,1,1,240
95258067@N00,7705,14,1386578202,1386578322,1,1,120
95341382@N05,7706,14,1443569261,1443569381,1,1,120
95356654@N00,7707,27,1223295253,1223296453,2,1,1200
95356654@N00,7708,27,1223551309,1223551777,2,4,468
95356654@N00,7708,5,1223551777,1223552497,4,4,720
95356654@N00,7708,20,1223555586,1223556666,3,4,1080
95356654@N00,7708,16,1223558436,1223559156,2,4,720
95356654@N00,7709,27,1223593200,1223594400,1,1,1200
95356654@N00,7710,27,1328527135,1328528335,1,1,1200
95356654@N00,7711,1,1431250307,1431250907,2,2,600
95356654@N00,7711,27,1431253721,1431254921,1,2,1200
95356654@N00,7712,2,1431433622,1431433712,3,3,90
95356654@N00,7712,1,1431434795,1431435179,3,3,384
95356654@N00,7712,4,1431435179,1431436079,3,3,900
95356654@N00,7713,5,1431601592,1431601790,2,4,198
95356654@N00,7713,4,1431601790,1431602344,3,4,554
95356654@N00,7713,1,1431602344,1431602944,5,4,600
95356654@N00,7713,2,1431603316,1431603406,2,4,90
95356654@N00,7714,27,1431695647,1431696847,6,1,1200
95386011@N06,7715,27,1397608340,1397609540,5,1,1200
95400328@N03,7716,25,1371619125,1371619875,2,3,750
95400328@N03,7716,12,1371620119,1371620959,2,3,840
95400328@N03,7716,27,1371638494,1371639694,1,3,1200
95415513@N07,7717,27,1365379105,1365380305,2,2,1200
95415513@N07,7717,14,1365405992,1365406112,1,2,120
95432764@N04,7718,8,1375491273,1375491393,2,2,120
95432764@N04,7718,23,1375495261,1375495351,1,2,90
95462179@N04,7719,16,1429193341,1429194061,2,2,720
95462179@N04,7719,18,1429201202,1429203002,1,2,1800
95462179@N04,7720,18,1432316072,1432317872,1,1,1800
9549670@N05,7721,27,1467759120,1467760320,5,5,1200
9549670@N05,7721,4,1467764215,1467765115,2,5,900
9549670@N05,7721,27,1467770800,1467772000,8,5,1200
9549670@N05,7721,9,1467773279,1467773519,3,5,240
9549670@N05,7721,27,1467778841,1467780041,60,5,1200
95536755@N00,7722,27,1215569004,1215569030,2,2,26
95536755@N00,7722,16,1215569030,1215569750,1,2,720
95551576@N00,7723,27,1280012074,1280013274,2,11,1200
95551576@N00,7723,8,1280020151,1280020271,2,11,120
95551576@N00,7723,6,1280021432,1280021687,2,11,255
95551576@N00,7723,8,1280022075,1280022195,2,11,120
95551576@N00,7723,11,1280022513,1280022693,2,11,180
95551576@N00,7723,8,1280024286,1280024355,2,11,69
95551576@N00,7723,11,1280024355,1280024535,2,11,180
95551576@N00,7723,9,1280026448,1280026688,2,11,240
95551576@N00,7723,2,1280031198,1280031288,2,11,90
95551576@N00,7723,14,1280045304,1280045424,3,11,120
95551576@N00,7723,17,1280048073,1280049453,1,11,1380
95555783@N05,7724,27,1365906325,1365907525,1,1,1200
95559818@N00,7725,16,1190444780,1190445500,2,2,720
95559818@N00,7725,14,1190447203,1190447323,1,2,120
95559818@N00,7726,16,1190780005,1190780725,3,1,720
95559818@N00,7727,18,1207165591,1207167391,1,1,1800
95559818@N00,7728,19,1207269922,1207270342,1,1,420
95559818@N00,7729,27,1333271969,1333273169,3,2,1200
95559818@N00,7729,17,1333274796,1333276176,1,2,1380
95559818@N00,7730,9,1333592133,1333592325,3,4,192
95559818@N00,7730,6,1333592325,1333592580,3,4,255
95559818@N00,7730,20,1333595926,1333597006,3,4,1080
95559818@N00,7730,22,1333620004,1333620604,1,4,600
95598685@N00,7731,26,1275314400,1275314580,1,1,180
95611282@N05,7732,27,1368582484,1368583684,1,1,1200
95611282@N05,7733,27,1368612342,1368613542,1,1,1200
95611282@N05,7734,27,1370565828,1370567028,1,1,1200
95611282@N05,7735,27,1402543435,1402544635,1,1,1200
95611282@N05,7736,27,1432263244,1432264444,9,1,1200
95611282@N05,7737,27,1434590465,1434591665,9,9,1200
95611282@N05,7737,17,1434591723,1434593103,2,9,1380
95611282@N05,7737,25,1434601483,1434601500,2,9,17
95611282@N05,7737,24,1434601500,1434601587,3,9,87
95611282@N05,7737,21,1434601587,1434601633,2,9,46
95611282@N05,7737,24,1434601633,1434602113,3,9,480
95611282@N05,7737,17,1434602553,1434603022,3,9,469
95611282@N05,7737,15,1434603022,1434603202,2,9,180
95611282@N05,7737,27,1434626441,1434627641,1,9,1200
95611942@N00,7738,27,1381967844,1381968197,3,4,353
95611942@N00,7738,4,1381968197,1381969097,3,4,900
95611942@N00,7738,14,1381972084,1381972204,2,4,120
95611942@N00,7738,12,1381972486,1381973326,8,4,840
95611942@N00,7739,8,1468360063,1468360183,2,11,120
95611942@N00,7739,6,1468361056,1468361311,2,11,255
95611942@N00,7739,10,1468363181,1468363601,7,11,420
95611942@N00,7739,14,1468365175,1468365295,4,11,120
95611942@N00,7739,12,1468367736,1468368576,6,11,840
95611942@N00,7739,16,1468369930,1468370650,6,11,720
95611942@N00,7739,26,1468383667,1468383847,2,11,180
95611942@N00,7739,21,1468391541,1468391991,2,11,450
95611942@N00,7739,24,1468393390,1468393870,2,11,480
95611942@N00,7739,9,1468394448,1468394688,2,11,240
95611942@N00,7739,14,1468396862,1468396982,3,11,120
95646877@N00,7740,13,1273912186,1273912786,2,5,600
95646877@N00,7740,17,1273913350,1273914730,2,5,1380
95646877@N00,7740,5,1273920146,1273920815,2,5,669
95646877@N00,7740,14,1273920815,1273920935,3,5,120
95646877@N00,7740,4,1273925339,1273926239,1,5,900
95653839@N03,7741,18,1416375834,1416377634,2,2,1800
95653839@N03,7741,4,1416381921,1416382821,1,2,900
95691495@N08,7742,17,1422051270,1422052650,2,3,1380
95691495@N08,7742,23,1422053351,1422053441,15,3,90
95691495@N08,7742,6,1422061593,1422061848,1,3,255
95692999@N05,7743,3,1381614437,1381614707,2,5,270
95692999@N05,7743,11,1381616854,1381617034,2,5,180
95692999@N05,7743,22,1381634498,1381635098,2,5,600
95692999@N05,7743,19,1381637614,1381638034,2,5,420
95692999@N05,7743,14,1381645375,1381645495,1,5,120
95692999@N05,7744,6,1408170310,1408170565,1,1,255
95694198@N00,7745,13,1362964293,1362964688,3,2,395
95694198@N00,7745,10,1362964688,1362965108,1,2,420
95694198@N00,7746,13,1363163047,1363163292,3,2,245
95694198@N00,7746,17,1363163292,1363164672,2,2,1380
95736828@N07,7747,11,1369895165,1369895345,5,2,180
95736828@N07,7747,8,1369895667,1369895787,1,2,120
95736828@N07,7748,9,1370403438,1370403678,2,1,240
95743859@N00,7749,14,1215331192,1215331312,1,1,120
95748568@N02,7750,16,1421140022,1421140742,1,1,720
95760272@N03,7751,17,1354147548,1354148928,1,1,1380
95769700@N00,7752,27,1380846363,1380847563,3,8,1200
95769700@N00,7752,16,1380848269,1380848989,3,8,720
95769700@N00,7752,14,1380851991,1380852111,6,8,120
95769700@N00,7752,9,1380854357,1380854597,6,8,240
95769700@N00,7752,14,1380854979,1380855099,2,8,120
95769700@N00,7752,21,1380859289,1380859739,2,8,450
95769700@N00,7752,10,1380865084,1380865504,4,8,420
95769700@N00,7752,12,1380872786,1380873626,1,8,840
95778894@N00,7753,13,1380756016,1380756616,2,2,600
95778894@N00,7753,22,1380776766,1380777366,1,2,600
95778894@N00,7754,14,1381027498,1381027618,2,3,120
95778894@N00,7754,19,1381055888,1381055897,2,3,9
95778894@N00,7754,13,1381055897,1381056497,1,3,600
95778894@N00,7755,20,1457064302,1457065382,4,5,1080
95778894@N00,7755,22,1457067027,1457067627,2,5,600
95778894@N00,7755,17,1457074439,1457075819,2,5,1380
95778894@N00,7755,15,1457081073,1457081253,2,5,180
95778894@N00,7755,23,1457087245,1457087335,1,5,90
95778894@N00,7756,22,1457330929,1457331529,4,4,600
95778894@N00,7756,26,1457339710,1457339890,2,4,180
95778894@N00,7756,23,1457346703,1457346793,2,4,90
95778894@N00,7756,18,1457350557,1457352357,1,4,1800
9578142@N02,7757,17,1365062338,1365063450,2,5,1112
9578142@N02,7757,13,1365063450,1365064050,2,5,600
9578142@N02,7757,6,1365064964,1365065219,2,5,255
9578142@N02,7757,3,1365067635,1365067905,2,5,270
9578142@N02,7757,14,1365073437,1365073557,4,5,120
95782054@N05,7758,27,1382760165,1382761365,20,13,1200
95782054@N05,7758,14,1382763240,1382763360,17,13,120
95782054@N05,7758,15,1382764159,1382764339,7,13,180
95782054@N05,7758,12,1382764555,1382764600,2,13,45
95782054@N05,7758,15,1382764600,1382764780,3,13,180
95782054@N05,7758,26,1382765031,1382765211,10,13,180
95782054@N05,7758,23,1382765697,1382765787,2,13,90
95782054@N05,7758,20,1382766212,1382766955,8,13,743
95782054@N05,7758,19,1382766955,1382767167,6,13,212
95782054@N05,7758,11,1382767167,1382767347,2,13,180
95782054@N05,7758,8,1382767417,1382767489,3,13,72
95782054@N05,7758,1,1382767489,1382767571,2,13,82
95782054@N05,7758,27,1382767571,1382768771,4,13,1200
95839603@N02,7759,27,1395697216,1395698416,6,12,1200
95839603@N02,7759,15,1395700817,1395700997,2,12,180
95839603@N02,7759,14,1395703662,1395703782,4,12,120
95839603@N02,7759,10,1395706814,1395707234,2,12,420
95839603@N02,7759,7,1395710267,1395710357,2,12,90
95839603@N02,7759,12,1395712087,1395712927,4,12,840
95839603@N02,7759,2,1395714458,1395714548,3,12,90
95839603@N02,7759,24,1395726061,1395726541,2,12,480
95839603@N02,7759,2,1395728847,1395728937,3,12,90
95839603@N02,7759,9,1395731299,1395731539,2,12,240
95839603@N02,7759,4,1395733818,1395734718,4,12,900
95839603@N02,7759,18,1395737698,1395739498,1,12,1800
95911107@N02,7760,8,1442736958,1442737078,2,2,120
95911107@N02,7760,27,1442737758,1442738958,2,2,1200
95916581@N03,7761,26,1378467644,1378467824,1,1,180
95928051@N04,7762,6,1277953095,1277953158,2,2,63
95928051@N04,7762,14,1277953158,1277953278,2,2,120
95979850@N00,7763,27,1237006258,1237007458,6,1,1200
95992643@N08,7764,2,1370601264,1370601354,3,2,90
95992643@N08,7764,14,1370609164,1370609284,1,2,120
96062950@N02,7765,27,1385853148,1385853934,3,13,786
96062950@N02,7765,17,1385853934,1385855314,2,13,1380
96062950@N02,7765,16,1385855625,1385856345,2,13,720
96062950@N02,7765,20,1385859128,1385859987,2,13,859
96062950@N02,7765,9,1385859987,1385860227,4,13,240
96062950@N02,7765,22,1385862092,1385862692,2,13,600
96062950@N02,7765,21,1385866327,1385866357,2,13,30
96062950@N02,7765,24,1385866357,1385866837,2,13,480
96062950@N02,7765,14,1385866879,1385866999,6,13,120
96062950@N02,7765,17,1385878315,1385879695,5,13,1380
96062950@N02,7765,27,1385881348,1385882548,2,13,1200
96062950@N02,7765,14,1385883662,1385883782,2,13,120
96062950@N02,7765,15,1385891033,1385891213,3,13,180
96062950@N02,7766,22,1386388967,1386389567,2,3,600
96062950@N02,7766,15,1386391665,1386391845,2,3,180
96062950@N02,7766,18,1386406478,1386408278,1,3,1800
96074685@N04,7767,7,1373770925,1373771015,6,3,90
96074685@N04,7767,14,1373771990,1373772031,4,3,41
96074685@N04,7767,16,1373772031,1373772751,1,3,720
96074685@N04,7768,14,1374048383,1374048503,5,2,120
96074685@N04,7768,25,1374054299,1374055049,1,2,750
96077153@N00,7769,27,1228718295,1228719495,1,1,1200
96077153@N00,7770,27,1287245773,1287246973,2,11,1200
96077153@N00,7770,1,1287265230,1287265306,2,11,76
96077153@N00,7770,3,1287265306,1287265576,3,11,270
96077153@N00,7770,16,1287267463,1287268183,2,11,720
96077153@N00,7770,13,1287269753,1287270353,2,11,600
96077153@N00,7770,15,1287273993,1287274173,2,11,180
96077153@N00,7770,27,1287283874,1287285074,2,11,1200
96077153@N00,7770,23,1287288642,1287288732,2,11,90
96077153@N00,7770,21,1287290035,1287290485,2,11,450
96077153@N00,7770,22,1287290915,1287291515,2,11,600
96077153@N00,7770,27,1287298327,1287299527,1,11,1200
96077153@N00,7771,27,1291793109,1291794309,1,1,1200
96077153@N00,7772,12,1295055158,1295055998,3,3,840
96077153@N00,7772,23,1295062716,1295062806,2,3,90
96077153@N00,7772,25,1295066985,1295067735,1,3,750
96077153@N00,7773,27,1303380282,1303381482,1,1,1200
96077153@N00,7774,27,1303503588,1303504380,2,9,792
96077153@N00,7774,19,1303504380,1303504800,2,9,420
96077153@N00,7774,13,1303506964,1303507564,2,9,600
96077153@N00,7774,14,1303508760,1303508880,7,9,120
96077153@N00,7774,2,1303511039,1303511129,2,9,90
96077153@N00,7774,25,1303515675,1303516425,3,9,750
96077153@N00,7774,24,1303517225,1303517225,2,9,0
96077153@N00,7774,26,1303517225,1303517233,2,9,8
96077153@N00,7774,23,1303517233,1303517323,1,9,90
96077153@N00,7775,13,1305245425,1305246025,2,1,600
96077153@N00,7776,17,1338021192,1338022572,2,2,1380
96077153@N00,7776,14,1338025401,1338025521,1,2,120
96077153@N00,7777,18,1338193604,1338195404,1,1,1800
96084178@N00,7778,27,1257977460,1257978660,4,6,1200
96084178@N00,7778,14,1257980663,1257980783,5,6,120
96084178@N00,7778,26,1257996429,1257996609,4,6,180
96084178@N00,7778,17,1257996650,1257998030,2,6,1380
96084178@N00,7778,11,1257999994,1258000174,2,6,180
96084178@N00,7778,8,1258001306,1258001426,1,6,120
96084178@N00,7779,27,1368170168,1368171368,3,5,1200
96084178@N00,7779,8,1368172457,1368172507,2,5,50
96084178@N00,7779,7,1368172507,1368172597,2,5,90
96084178@N00,7779,8,1368172830,1368172950,5,5,120
96084178@N00,7779,27,1368175236,1368176436,6,5,1200
96084178@N00,7780,27,1368226627,1368227827,2,3,1200
96084178@N00,7780,17,1368232678,1368234058,7,3,1380
96084178@N00,7780,9,1368241355,1368241595,6,3,240
96084178@N00,7781,14,1395460221,1395460341,4,2,120
96084178@N00,7781,8,1395467652,1395467772,1,2,120
96084178@N00,7782,14,1395571541,1395571661,2,2,120
96084178@N00,7782,16,1395575380,1395576100,1,2,720
96088830@N07,7783,13,1298609786,1298610386,5,4,600
96088830@N07,7783,24,1298612296,1298612413,5,4,117
96088830@N07,7783,21,1298612413,1298612863,2,4,450
96088830@N07,7783,24,1298612866,1298613346,6,4,480
96088830@N07,7784,12,1310377966,1310378806,2,1,840
9611843@N04,7785,19,1193742309,1193742729,1,1,420
9611843@N04,7786,4,1193939798,1193940698,1,1,900
9611843@N04,7787,21,1265599600,1265600050,1,1,450
9611843@N04,7788,13,1317290652,1317291252,1,1,600
9611843@N04,7789,19,1317439346,1317439766,2,2,420
9611843@N04,7789,6,1317460120,1317460375,1,2,255
9611843@N04,7790,9,1317548391,1317548449,2,2,58
9611843@N04,7790,14,1317548449,1317548569,1,2,120
9611843@N04,7791,19,1328400132,1328400552,2,2,420
9611843@N04,7791,26,1328421894,1328422074,1,2,180
9611843@N04,7792,19,1350176313,1350176733,2,3,420
9611843@N04,7792,14,1350186049,1350186169,2,3,120
9611843@N04,7792,27,1350202293,1350203493,4,3,1200
9611843@N04,7793,12,1350295863,1350296703,1,1,840
9611843@N04,7794,1,1360016787,1360017387,1,1,600
96119805@N03,7795,27,1269664872,1269666072,2,1,1200
96128002@N00,7796,11,1225170605,1225170785,5,1,180
96139953@N06,7797,17,1448506835,1448508215,1,1,1380
96196973@N02,7798,19,1363904906,1363905326,6,4,420
96196973@N02,7798,20,1363907522,1363908602,3,4,1080
96196973@N02,7798,26,1363909679,1363909859,2,4,180
96196973@N02,7798,25,1363910750,1363911500,1,4,750
9621505@N08,7799,16,1411040100,1411040206,4,3,106
9621505@N08,7799,17,1411040206,1411040581,5,3,375
9621505@N08,7799,15,1411040581,1411040761,2,3,180
96225726@N08,7800,27,1302149475,1302150675,1,1,1200
9623061@N06,7801,27,1365116591,1365117791,2,2,1200
9623061@N06,7801,6,1365129547,1365129802,1,2,255
96244139@N03,7802,25,1280018801,1280019551,105,1,750
96244139@N03,7803,25,1333410817,1333411567,1,1,750
96244139@N03,7804,25,1333786107,1333786857,1,1,750
96244139@N03,7805,25,1364005078,1364005828,1,1,750
9624826@N05,7806,1,1310339639,1310340239,1,1,600
96249470@N03,7807,10,1378197955,1378198375,3,2,420
96249470@N03,7807,3,1378200383,1378200653,1,2,270
96249470@N03,7808,14,1378333493,1378333613,3,7,120
96249470@N03,7808,18,1378336052,1378337660,2,7,1608
96249470@N03,7808,19,1378337660,1378338080,3,7,420
96249470@N03,7808,22,1378340987,1378341587,2,7,600
96249470@N03,7808,21,1378342657,1378343107,3,7,450
96249470@N03,7808,26,1378345365,1378345545,4,7,180
96249470@N03,7808,9,1378351538,1378351778,1,7,240
96269557@N00,7809,7,1245637740,1245637830,3,3,90
96269557@N00,7809,1,1245639541,1245640141,4,3,600
96269557@N00,7809,14,1245643731,1245643851,7,3,120
96274088@N05,7810,4,1356045920,1356046820,2,2,900
96274088@N05,7810,9,1356048911,1356049151,1,2,240
96274088@N05,7811,3,1356504782,1356505017,5,3,235
96274088@N05,7811,4,1356505017,1356505404,3,3,387
96274088@N05,7811,27,1356505404,1356506604,6,3,1200
96312503@N08,7812,17,1369340240,1369341620,2,2,1380
96312503@N08,7812,26,1369343486,1369343666,1,2,180
96312503@N08,7813,6,1369576088,1369576343,1,1,255
96312503@N08,7814,4,1372562848,1372563748,1,1,900
96312503@N08,7815,27,1372798705,1372799905,2,2,1200
96312503@N08,7815,21,1372814264,1372814714,1,2,450
96312503@N08,7816,27,1372958582,1372959782,1,1,1200
96312503@N08,7817,14,1372991866,1372991986,1,1,120
96312503@N08,7818,21,1373049691,1373050141,2,3,450
96312503@N08,7818,13,1373073188,1373073788,2,3,600
96312503@N08,7818,22,1373075085,1373075685,1,3,600
96312503@N08,7819,14,1373163730,1373163850,2,2,120
96312503@N08,7819,13,1373166511,1373167111,1,2,600
96312503@N08,7820,19,1382364771,1382365191,1,1,420
96312503@N08,7821,13,1382617758,1382618358,2,1,600
96312503@N08,7822,13,1382936380,1382936980,1,1,600
96312503@N08,7823,27,1386151911,1386153111,1,1,1200
96312503@N08,7824,27,1386237053,1386238253,1,1,1200
96312503@N08,7825,27,1389527933,1389529133,1,1,1200
96312503@N08,7826,13,1399103595,1399104195,1,1,600
96312503@N08,7827,14,1399283127,1399283247,2,2,120
96312503@N08,7827,22,1399290636,1399291236,1,2,600
96312503@N08,7828,17,1400785762,1400786402,2,7,640
96312503@N08,7828,15,1400786402,1400786582,2,7,180
96312503@N08,7828,18,1400786830,1400787974,2,7,1144
96312503@N08,7828,14,1400787974,1400788094,2,7,120
96312503@N08,7828,7,1400788399,1400788489,3,7,90
96312503@N08,7828,16,1400789412,1400790132,2,7,720
96312503@N08,7828,17,1400790608,1400791988,1,7,1380
96312503@N08,7829,16,1404660856,1404661576,1,1,720
96331620@N03,7830,27,1328231968,1328233168,4,1,1200
96333180@N05,7831,14,1323605088,1323605208,3,1,120
9639902@N04,7832,27,1223156105,1223157305,2,2,1200
9639902@N04,7832,19,1223167315,1223167735,1,2,420
96430093@N05,7833,23,1370129927,1370130017,2,1,90
96430093@N05,7834,3,1372857941,1372858093,2,2,152
96430093@N05,7834,10,1372858093,1372858513,1,2,420
96430093@N05,7835,27,1372893127,1372894327,2,3,1200
96430093@N05,7835,10,1372919032,1372919452,2,3,420
96430093@N05,7835,21,1372923241,1372923691,1,3,450
96430093@N05,7836,10,1373088458,1373088878,2,1,420
96430093@N05,7837,13,1382353089,1382353689,2,2,600
96430093@N05,7837,10,1382353935,1382354355,1,2,420
96430093@N05,7838,1,1382653641,1382654241,2,3,600
96430093@N05,7838,17,1382657312,1382658692,4,3,1380
96430093@N05,7838,10,1382673375,1382673795,2,3,420
96430093@N05,7839,11,1383190895,1383191075,1,1,180
96430093@N05,7840,17,1391560626,1391561841,2,5,1215
96430093@N05,7840,27,1391561841,1391563041,2,5,1200
96430093@N05,7840,17,1391571696,1391573076,2,5,1380
96430093@N05,7840,9,1391577307,1391577547,2,5,240
96430093@N05,7840,23,1391581732,1391581822,1,5,90
96430093@N05,7841,23,1391822058,1391822148,2,2,90
96430093@N05,7841,14,1391823936,1391824056,1,2,120
96430093@N05,7842,27,1394934237,1394935437,1,1,1200
96430093@N05,7843,4,1395035397,1395035561,2,2,164
96430093@N05,7843,27,1395035561,1395036761,1,2,1200
96430093@N05,7844,13,1425108042,1425108642,2,5,600
96430093@N05,7844,14,1425109305,1425109425,2,5,120
96430093@N05,7844,25,1425120214,1425120964,2,5,750
96430093@N05,7844,19,1425121391,1425121811,2,5,420
96430093@N05,7844,18,1425122733,1425124533,1,5,1800
96430093@N05,7845,13,1429305631,1429306231,4,1,600
96430093@N05,7846,18,1430193499,1430195299,2,2,1800
96430093@N05,7846,6,1430195413,1430195668,1,2,255
96430093@N05,7847,18,1446784812,1446786612,1,1,1800
96430093@N05,7848,25,1454118557,1454119307,2,3,750
96430093@N05,7848,21,1454120823,1454121273,2,3,450
96430093@N05,7848,26,1454125700,1454125880,4,3,180
96430093@N05,7849,22,1454366602,1454367202,1,1,600
96430093@N05,7850,27,1454622041,1454623241,6,1,1200
96430093@N05,7851,17,1460517476,1460518856,1,1,1380
96430093@N05,7852,27,1463817571,1463818771,1,1,1200
96430093@N05,7853,27,1464235939,1464237139,1,1,1200
96466494@N00,7854,10,1470559439,1470559859,1,1,420
96466494@N00,7855,6,1471788110,1471788365,1,1,255
96467992@N05,7856,10,1362618847,1362619267,3,3,420
96467992@N05,7856,7,1362621299,1362621389,2,3,90
96467992@N05,7856,10,1362623438,1362623858,2,3,420
96472796@N00,7857,27,1386219422,1386220622,2,3,1200
96472796@N00,7857,20,1386231387,1386232467,2,3,1080
96472796@N00,7857,16,1386240061,1386240781,2,3,720
96525092@N00,7858,27,1254485495,1254486695,3,2,1200
96525092@N00,7858,1,1254488989,1254489589,1,2,600
96525092@N00,7859,16,1257322463,1257323183,2,2,720
96525092@N00,7859,14,1257323410,1257323530,1,2,120
96525092@N00,7860,1,1267654411,1267655011,1,1,600
96525092@N00,7861,8,1288680139,1288680259,1,1,120
96525092@N00,7862,27,1289024622,1289025822,1,1,1200
96525092@N00,7863,9,1317551949,1317552189,1,1,240
96525092@N00,7864,24,1320503260,1320503740,1,1,480
96525092@N00,7865,14,1352083221,1352083341,1,1,120
9653109@N04,7866,27,1252533816,1252535016,1,1,1200
9653109@N04,7867,17,1252796780,1252798160,1,1,1380
9653109@N04,7868,25,1285200811,1285201561,2,1,750
9653109@N04,7869,26,1285670108,1285670288,1,1,180
96581496@N06,7870,9,1401076687,1401076927,3,2,240
96581496@N06,7870,27,1401096796,1401097996,1,2,1200
96581740@N03,7871,27,1442107195,1442108395,16,23,1200
96581740@N03,7871,17,1442110728,1442110861,3,23,133
96581740@N03,7871,16,1442110861,1442111359,3,23,498
96581740@N03,7871,14,1442111359,1442111479,59,23,120
96581740@N03,7871,9,1442120758,1442120786,2,23,28
96581740@N03,7871,10,1442120786,1442121124,6,23,338
96581740@N03,7871,14,1442121124,1442121176,2,23,52
96581740@N03,7871,15,1442121176,1442121356,7,23,180
96581740@N03,7871,12,1442122058,1442122898,2,23,840
96581740@N03,7871,14,1442123066,1442123186,2,23,120
96581740@N03,7871,26,1442124326,1442124444,2,23,118
96581740@N03,7871,22,1442124444,1442124446,2,23,2
96581740@N03,7871,20,1442124446,1442125332,2,23,886
96581740@N03,7871,21,1442125332,1442125355,2,23,23
96581740@N03,7871,24,1442125355,1442125395,3,23,40
96581740@N03,7871,23,1442125395,1442125485,10,23,90
96581740@N03,7871,21,1442126451,1442126826,2,23,375
96581740@N03,7871,22,1442126826,1442127426,7,23,600
96581740@N03,7871,27,1442128383,1442129583,2,23,1200
96581740@N03,7871,20,1442130006,1442130264,3,23,258
96581740@N03,7871,19,1442130264,1442130578,5,23,314
96581740@N03,7871,8,1442130578,1442130698,3,23,120
96581740@N03,7871,27,1442131516,1442132716,21,23,1200
96581740@N03,7872,8,1442456190,1442456310,2,10,120
96581740@N03,7872,7,1442456609,1442456699,4,10,90
96581740@N03,7872,6,1442458009,1442458264,2,10,255
96581740@N03,7872,2,1442461097,1442461187,5,10,90
96581740@N03,7872,26,1442465052,1442465075,2,10,23
96581740@N03,7872,25,1442465075,1442465825,9,10,750
96581740@N03,7872,24,1442473498,1442473673,2,10,175
96581740@N03,7872,21,1442473673,1442473714,2,10,41
96581740@N03,7872,24,1442473714,1442473802,2,10,88
96581740@N03,7872,25,1442473802,1442474552,3,10,750
96586459@N00,7873,16,1422851294,1422852014,2,2,720
96586459@N00,7873,8,1422861337,1422861457,1,2,120
96603081@N02,7874,14,1310906129,1310906249,2,1,120
96603081@N02,7875,12,1369459460,1369460300,1,1,840
9663436@N03,7876,18,1396161341,1396161367,2,3,26
9663436@N03,7876,13,1396161367,1396161967,4,3,600
9663436@N03,7876,27,1396168982,1396170182,8,3,1200
96634395@N05,7877,22,1389338826,1389339426,1,1,600
96634395@N05,7878,10,1392981970,1392982390,1,1,420
96634395@N05,7879,22,1393500442,1393501042,1,1,600
96634395@N05,7880,17,1394345203,1394346583,1,1,1380
96639807@N00,7881,14,1418192485,1418192605,4,5,120
96639807@N00,7881,16,1418204210,1418204930,2,5,720
96639807@N00,7881,22,1418207119,1418207719,10,5,600
96639807@N00,7881,4,1418212878,1418213458,2,5,580
96639807@N00,7881,27,1418213458,1418214658,1,5,1200
9664341@N05,7882,14,1215071994,1215072114,4,5,120
9664341@N05,7882,13,1215084436,1215085036,2,5,600
9664341@N05,7882,14,1215085357,1215085477,2,5,120
9664341@N05,7882,17,1215089039,1215090288,2,5,1249
9664341@N05,7882,27,1215090288,1215091488,1,5,1200
96678288@N02,7883,21,1367736735,1367737185,1,1,450
96678288@N02,7884,24,1369656737,1369657217,2,2,480
96678288@N02,7884,27,1369660465,1369661665,8,2,1200
96678288@N02,7885,10,1370438905,1370439022,4,2,117
96678288@N02,7885,3,1370439022,1370439292,6,2,270
96678288@N02,7886,27,1378282870,1378284070,16,8,1200
96678288@N02,7886,14,1378284771,1378284891,8,8,120
96678288@N02,7886,9,1378286925,1378287165,2,8,240
96678288@N02,7886,5,1378287184,1378287343,2,8,159
96678288@N02,7886,2,1378287343,1378287433,2,8,90
96678288@N02,7886,1,1378287806,1378288406,5,8,600
96678288@N02,7886,14,1378291072,1378291192,18,8,120
96678288@N02,7886,10,1378292377,1378292797,4,8,420
96678288@N02,7887,1,1380367664,1380368264,2,3,600
96678288@N02,7887,21,1380375456,1380375906,3,3,450
96678288@N02,7887,26,1380376547,1380376727,1,3,180
96678288@N02,7888,27,1381566205,1381567128,8,17,923
96678288@N02,7888,25,1381567128,1381567350,2,17,222
96678288@N02,7888,23,1381567350,1381567440,2,17,90
96678288@N02,7888,22,1381567465,1381568065,2,17,600
96678288@N02,7888,15,1381568067,1381568247,2,17,180
96678288@N02,7888,6,1381569105,1381569360,5,17,255
96678288@N02,7888,2,1381570887,1381570898,2,17,11
96678288@N02,7888,1,1381570898,1381570951,2,17,53
96678288@N02,7888,3,1381570951,1381571156,2,17,205
96678288@N02,7888,4,1381571156,1381571600,2,17,444
96678288@N02,7888,14,1381571600,1381571720,2,17,120
96678288@N02,7888,10,1381571880,1381572300,32,17,420
96678288@N02,7888,15,1381573560,1381573740,3,17,180
96678288@N02,7888,20,1381574152,1381575232,5,17,1080
96678288@N02,7888,21,1381576319,1381576769,11,17,450
96678288@N02,7888,25,1381577869,1381578519,4,17,650
96678288@N02,7888,27,1381578519,1381579719,6,17,1200
96678288@N02,7889,27,1383118288,1383119488,11,11,1200
96678288@N02,7889,26,1383123215,1383123395,11,11,180
96678288@N02,7889,23,1383123664,1383123754,2,11,90
96678288@N02,7889,15,1383124122,1383124302,7,11,180
96678288@N02,7889,13,1383124498,1383125098,3,11,600
96678288@N02,7889,15,1383125859,1383126039,9,11,180
96678288@N02,7889,11,1383126588,1383126768,49,11,180
96678288@N02,7889,8,1383128717,1383128837,9,11,120
96678288@N02,7889,10,1383129338,1383129758,6,11,420
96678288@N02,7889,7,1383129843,1383129933,3,11,90
96678288@N02,7889,27,1383130531,1383131731,3,11,1200
96678288@N02,7890,27,1383978661,1383979861,1,1,1200
96678288@N02,7891,6,1386411514,1386411769,2,6,255
96678288@N02,7891,7,1386412213,1386412303,3,6,90
96678288@N02,7891,10,1386412661,1386413081,3,6,420
96678288@N02,7891,1,1386416742,1386417342,2,6,600
96678288@N02,7891,5,1386419070,1386419464,2,6,394
96678288@N02,7891,27,1386419464,1386420664,1,6,1200
96678288@N02,7892,27,1387946635,1387947835,15,1,1200
96678288@N02,7893,3,1388490061,1388490331,2,5,270
96678288@N02,7893,10,1388491673,1388492093,2,5,420
96678288@N02,7893,14,1388495865,1388495985,2,5,120
96678288@N02,7893,17,1388499516,1388500896,3,5,1380
96678288@N02,7893,27,1388502690,1388503890,3,5,1200
96678288@N02,7894,5,1391250542,1391251262,3,4,720
96678288@N02,7894,9,1391252902,1391253142,3,4,240
96678288@N02,7894,14,1391253493,1391253613,2,4,120
96678288@N02,7894,10,1391253618,1391254038,8,4,420
96678288@N02,7895,22,1393665153,1393665753,3,8,600
96678288@N02,7895,19,1393666625,1393667045,2,8,420
96678288@N02,7895,13,1393667935,1393668535,2,8,600
96678288@N02,7895,18,1393669011,1393670811,2,8,1800
96678288@N02,7895,14,1393671889,1393672009,5,8,120
96678288@N02,7895,9,1393673719,1393673959,2,8,240
96678288@N02,7895,6,1393674386,1393674641,4,8,255
96678288@N02,7895,3,1393675517,1393675787,3,8,270
96678288@N02,7896,27,1395807403,1395808603,96,10,1200
96678288@N02,7896,2,1395810020,1395810057,2,10,37
96678288@N02,7896,1,1395810057,1395810657,3,10,600
96678288@N02,7896,2,1395812913,1395813003,5,10,90
96678288@N02,7896,14,1395815430,1395815550,2,10,120
96678288@N02,7896,9,1395815639,1395815879,4,10,240
96678288@N02,7896,10,1395816061,1395816481,2,10,420
96678288@N02,7896,22,1395821047,1395821389,2,10,342
96678288@N02,7896,17,1395821389,1395822769,3,10,1380
96678288@N02,7896,27,1395822781,1395823981,4,10,1200
96678288@N02,7897,9,1398506275,1398506515,17,5,240
96678288@N02,7897,7,1398507113,1398507203,2,5,90
96678288@N02,7897,14,1398507466,1398507586,3,5,120
96678288@N02,7897,6,1398510743,1398510998,3,5,255
96678288@N02,7897,3,1398513855,1398514125,1,5,270
96678288@N02,7898,14,1403099751,1403099871,15,1,120
96678288@N02,7899,14,1403179456,1403179576,14,2,120
96678288@N02,7899,16,1403186263,1403186983,2,2,720
96678288@N02,7900,14,1405512561,1405512681,2,2,120
96678288@N02,7900,16,1405522643,1405523363,1,2,720
96678288@N02,7901,17,1407338527,1407339907,1,1,1380
96678288@N02,7902,27,1412152345,1412153545,7,1,1200
96678288@N02,7903,15,1412767660,1412767840,1,1,180
96678288@N02,7904,27,1414566371,1414567571,1,1,1200
96678288@N02,7905,27,1419481947,1419483147,1,1,1200
96678288@N02,7906,14,1419513057,1419513177,1,1,120
96678288@N02,7907,14,1435307593,1435307713,1,1,120
96678288@N02,7908,24,1440235019,1440235499,2,3,480
96678288@N02,7908,23,1440235541,1440235631,3,3,90
96678288@N02,7908,24,1440235824,1440236304,1,3,480
96678288@N02,7909,27,1451095093,1451096293,3,2,1200
96678288@N02,7909,1,1451103609,1451104209,1,2,600
96678288@N02,7910,10,1451554511,1451554931,3,1,420
96678288@N02,7911,21,1451629047,1451629497,2,3,450
96678288@N02,7911,26,1451632430,1451632610,2,3,180
96678288@N02,7911,27,1451647504,1451648704,1,3,1200
96678288@N02,7912,2,1452836784,1452836874,3,5,90
96678288@N02,7912,1,1452844300,1452844900,2,5,600
96678288@N02,7912,6,1452846042,1452846297,2,5,255
96678288@N02,7912,27,1452849944,1452851144,3,5,1200
96678288@N02,7912,18,1452859094,1452860894,3,5,1800
96678288@N02,7913,2,1454910374,1454910464,1,1,90
96678288@N02,7914,21,1456725816,1456726266,3,7,450
96678288@N02,7914,13,1456730693,1456731293,2,7,600
96678288@N02,7914,8,1456732607,1456732727,2,7,120
96678288@N02,7914,13,1456734009,1456734609,2,7,600
96678288@N02,7914,8,1456734760,1456734880,2,7,120
96678288@N02,7914,9,1456736292,1456736532,2,7,240
96678288@N02,7914,27,1456739871,1456741071,2,7,1200
96678288@N02,7915,22,1456802784,1456803384,1,1,600
96678288@N02,7916,20,1457421164,1457422244,1,1,1080
96678288@N02,7917,21,1457617582,1457618032,1,1,450
96678288@N02,7918,13,1458635832,1458636432,1,1,600
96678288@N02,7919,20,1459238799,1459239879,3,1,1080
96678288@N02,7920,20,1459825002,1459826082,1,1,1080
96678288@N02,7921,20,1460365292,1460366372,2,2,1080
96678288@N02,7921,15,1460371947,1460372127,1,2,180
96678288@N02,7922,15,1460416091,1460416271,2,1,180
96678288@N02,7923,2,1461564579,1461564669,2,3,90
96678288@N02,7923,4,1461565690,1461566590,2,3,900
96678288@N02,7923,9,1461578309,1461578549,2,3,240
96678288@N02,7924,22,1461679276,1461679876,1,1,600
96678288@N02,7925,3,1462254480,1462254750,2,4,270
96678288@N02,7925,20,1462258362,1462259442,2,4,1080
96678288@N02,7925,4,1462266037,1462266937,2,4,900
96678288@N02,7925,27,1462279700,1462280900,1,4,1200
96678288@N02,7926,3,1462401665,1462401935,1,1,270
96678288@N02,7927,4,1462488131,1462489031,1,1,900
96678288@N02,7928,4,1462749007,1462749907,1,1,900
96678288@N02,7929,19,1463382980,1463383400,2,3,420
96678288@N02,7929,2,1463390833,1463390923,3,3,90
96678288@N02,7929,1,1463401800,1463402400,1,3,600
96678288@N02,7930,10,1467616506,1467616926,4,1,420
96678288@N02,7931,10,1467659104,1467659524,1,1,420
96678288@N02,7932,27,1468307047,1468308247,3,1,1200
96678288@N02,7933,27,1468410637,1468411292,3,2,655
96678288@N02,7933,14,1468411292,1468411412,1,2,120
96678288@N02,7934,27,1468588050,1468589250,3,1,1200
96678288@N02,7935,2,1470108812,1470108902,2,5,90
96678288@N02,7935,10,1470115011,1470115431,5,5,420
96678288@N02,7935,7,1470121751,1470121841,2,5,90
96678288@N02,7935,24,1470125905,1470126385,2,5,480
96678288@N02,7935,2,1470135262,1470135352,7,5,90
96678288@N02,7936,15,1470309454,1470309634,2,3,180
96678288@N02,7936,3,1470310107,1470310377,2,3,270
96678288@N02,7936,27,1470313128,1470314328,1,3,1200
96678288@N02,7937,27,1471245018,1471246218,2,3,1200
96678288@N02,7937,26,1471257212,1471257392,2,3,180
96678288@N02,7937,22,1471257411,1471258011,1,3,600
96678288@N02,7938,27,1471311374,1471312574,2,1,1200
96678288@N02,7939,15,1471440129,1471440309,1,1,180
96739093@N00,7940,18,1279275004,1279275382,2,2,378
96739093@N00,7940,8,1279275382,1279275502,1,2,120
96739093@N00,7941,18,1279337194,1279338994,2,1,1800
96740336@N06,7942,12,1438744815,1438745655,1,1,840
96846534@N05,7943,27,1363387110,1363388310,7,1,1200
96846534@N05,7944,7,1363575272,1363575362,12,4,90
96846534@N05,7944,14,1363577591,1363577711,13,4,120
96846534@N05,7944,26,1363587539,1363587719,9,4,180
96846534@N05,7944,10,1363590809,1363591229,1,4,420
96882800@N08,7945,14,1370076574,1370076575,2,2,1
96882800@N08,7945,27,1370076575,1370077775,1,2,1200
96899238@N00,7946,27,1451428931,1451430131,2,9,1200
96899238@N00,7946,15,1451438025,1451438205,11,9,180
96899238@N00,7946,16,1451441126,1451441846,2,9,720
96899238@N00,7946,15,1451444250,1451444430,3,9,180
96899238@N00,7946,2,1451451838,1451451928,3,9,90
96899238@N00,7946,4,1451453340,1451453357,2,9,17
96899238@N00,7946,5,1451453357,1451454077,2,9,720
96899238@N00,7946,6,1451461433,1451461688,4,9,255
96899238@N00,7946,27,1451462631,1451463831,5,9,1200
96905971@N05,7947,17,1370598027,1370599407,1,1,1380
96913191@N00,7948,27,1330058962,1330060162,1,1,1200
96926231@N00,7949,27,1341095105,1341096305,2,2,1200
96926231@N00,7949,9,1341102353,1341102593,1,2,240
96934975@N05,7950,23,1371003868,1371003958,2,1,90
96934975@N05,7951,17,1371381121,1371382501,9,1,1380
96954838@N03,7952,27,1397106778,1397107978,5,18,1200
96954838@N03,7952,4,1397110626,1397111526,2,18,900
96954838@N03,7952,2,1397112289,1397112379,2,18,90
96954838@N03,7952,1,1397112589,1397112928,4,18,339
96954838@N03,7952,3,1397112928,1397113198,2,18,270
96954838@N03,7952,2,1397113390,1397113480,12,18,90
96954838@N03,7952,1,1397116158,1397116243,2,18,85
96954838@N03,7952,2,1397116243,1397116333,2,18,90
96954838@N03,7952,1,1397116350,1397116687,5,18,337
96954838@N03,7952,5,1397116687,1397117099,3,18,412
96954838@N03,7952,2,1397117099,1397117189,4,18,90
96954838@N03,7952,6,1397117567,1397117817,2,18,250
96954838@N03,7952,7,1397117817,1397117907,2,18,90
96954838@N03,7952,10,1397118023,1397118443,11,18,420
96954838@N03,7952,14,1397118582,1397118702,6,18,120
96954838@N03,7952,17,1397119061,1397120441,7,18,1380
96954838@N03,7952,27,1397120555,1397121755,2,18,1200
96954838@N03,7952,21,1397122450,1397122900,1,18,450
9698992@N06,7953,14,1297580200,1297580320,2,2,120
9698992@N06,7953,16,1297586946,1297587666,2,2,720
96991828@N07,7954,14,1324707261,1324707381,3,9,120
96991828@N07,7954,4,1324707466,1324708366,2,9,900
96991828@N07,7954,10,1324727180,1324727600,2,9,420
96991828@N07,7954,14,1324729126,1324729187,6,9,61
96991828@N07,7954,10,1324729187,1324729535,7,9,348
96991828@N07,7954,14,1324729535,1324729655,4,9,120
96991828@N07,7954,9,1324729704,1324729834,5,9,130
96991828@N07,7954,10,1324729834,1324730006,5,9,172
96991828@N07,7954,14,1324730006,1324730126,7,9,120
97023479@N08,7955,20,1444006898,1444007978,2,9,1080
97023479@N08,7955,19,1444008768,1444009188,3,9,420
97023479@N08,7955,22,1444010329,1444010825,2,9,496
97023479@N08,7955,13,1444010825,1444011425,2,9,600
97023479@N08,7955,26,1444016719,1444016899,15,9,180
97023479@N08,7955,17,1444023419,1444024799,2,9,1380
97023479@N08,7955,27,1444036857,1444038057,2,9,1200
97023479@N08,7955,17,1444040393,1444041773,2,9,1380
97023479@N08,7955,4,1444043043,1444043943,4,9,900
9708101@N02,7956,1,1218958585,1218959185,2,3,600
9708101@N02,7956,19,1218966706,1218967126,2,3,420
9708101@N02,7956,22,1218968261,1218968861,2,3,600
97137858@N00,7957,27,1261465023,1261466223,2,11,1200
97137858@N00,7957,15,1261467916,1261468096,3,11,180
97137858@N00,7957,12,1261468857,1261469697,5,11,840
97137858@N00,7957,15,1261471156,1261471336,3,11,180
97137858@N00,7957,14,1261472052,1261472172,4,11,120
97137858@N00,7957,21,1261477832,1261478282,8,11,450
97137858@N00,7957,24,1261482138,1261482618,4,11,480
97137858@N00,7957,17,1261484580,1261485960,2,11,1380
97137858@N00,7957,18,1261488260,1261490060,2,11,1800
97137858@N00,7957,9,1261490254,1261490494,2,11,240
97137858@N00,7957,7,1261491061,1261491151,1,11,90
97156490@N00,7958,1,1324014858,1324015458,1,1,600
97225209@N00,7959,12,1382052839,1382053679,2,2,840
97225209@N00,7959,27,1382060066,1382061266,3,2,1200
97225209@N00,7960,3,1419547923,1419548193,2,2,270
97225209@N00,7960,6,1419552979,1419553234,1,2,255
97267319@N00,7961,14,1365568522,1365568642,7,4,120
97267319@N00,7961,27,1365577484,1365578684,4,4,1200
97267319@N00,7961,7,1365583383,1365583473,2,4,90
97267319@N00,7961,6,1365584561,1365584816,1,4,255
97267319@N00,7962,3,1365733549,1365733819,3,3,270
97267319@N00,7962,2,1365744803,1365744893,2,3,90
97267319@N00,7962,4,1365745811,1365746711,1,3,900
97316061@N05,7963,27,1426540733,1426541525,2,4,792
97316061@N05,7963,16,1426541525,1426542245,2,4,720
97316061@N05,7963,25,1426550868,1426551618,2,4,750
97316061@N05,7963,7,1426557337,1426557427,1,4,90
97316886@N04,7964,27,1452330858,1452331312,4,8,454
97316886@N04,7964,4,1452331312,1452332212,2,8,900
97316886@N04,7964,8,1452337398,1452337417,2,8,19
97316886@N04,7964,7,1452337417,1452337507,22,8,90
97316886@N04,7964,8,1452337754,1452337874,2,8,120
97316886@N04,7964,7,1452337908,1452337998,10,8,90
97316886@N04,7964,14,1452338462,1452338582,2,8,120
97316886@N04,7964,17,1452341320,1452342700,3,8,1380
97316886@N04,7965,13,1452577026,1452577626,1,1,600
97321472@N00,7966,27,1308352026,1308353226,1,1,1200
97408089@N00,7967,14,1363124027,1363124059,3,6,32
97408089@N00,7967,12,1363124059,1363124899,5,6,840
97408089@N00,7967,7,1363136926,1363137016,3,6,90
97408089@N00,7967,5,1363142629,1363143349,3,6,720
97408089@N00,7967,3,1363154434,1363154704,3,6,270
97408089@N00,7967,27,1363155659,1363156859,2,6,1200
97413516@N00,7968,8,1287056445,1287056565,1,1,120
97428135@N07,7969,27,1415860714,1415861914,1,1,1200
97435799@N07,7970,10,1433552329,1433552749,3,3,420
97435799@N07,7970,17,1433554537,1433555917,3,3,1380
97435799@N07,7970,22,1433555952,1433556552,10,3,600
97477255@N00,7971,27,1359605282,1359606482,3,2,1200
97477255@N00,7971,18,1359608057,1359609857,1,2,1800
97477255@N00,7972,17,1359686659,1359686831,2,4,172
97477255@N00,7972,25,1359686831,1359687581,7,4,750
97477255@N00,7972,21,1359689090,1359689540,3,4,450
97477255@N00,7972,4,1359706390,1359707290,1,4,900
97477255@N00,7973,27,1423184958,1423186019,2,14,1061
97477255@N00,7973,17,1423186019,1423186344,3,14,325
97477255@N00,7973,14,1423186344,1423186464,2,14,120
97477255@N00,7973,17,1423188573,1423188783,2,14,210
97477255@N00,7973,23,1423188783,1423188873,2,14,90
97477255@N00,7973,20,1423191562,1423192642,7,14,1080
97477255@N00,7973,19,1423192818,1423193238,2,14,420
97477255@N00,7973,22,1423194522,1423195122,2,14,600
97477255@N00,7973,17,1423198296,1423199676,2,14,1380
97477255@N00,7973,13,1423200189,1423200789,2,14,600
97477255@N00,7973,22,1423202937,1423203442,3,14,505
97477255@N00,7973,20,1423203442,1423204522,2,14,1080
97477255@N00,7973,19,1423205177,1423205597,5,14,420
97477255@N00,7973,10,1423207815,1423208235,4,14,420
97477255@N00,7974,9,1423532590,1423532830,2,10,240
97477255@N00,7974,14,1423533404,1423533524,2,10,120
97477255@N00,7974,15,1423533927,1423534107,2,10,180
97477255@N00,7974,14,1423534501,1423534621,2,10,120
97477255@N00,7974,10,1423534741,1423535161,10,10,420
97477255@N00,7974,7,1423540121,1423540211,2,10,90
97477255@N00,7974,9,1423544447,1423544687,3,10,240
97477255@N00,7974,6,1423548174,1423548429,2,10,255
97477255@N00,7974,22,1423560961,1423561561,4,10,600
97477255@N00,7974,26,1423561577,1423561757,1,10,180
97480752@N07,7975,13,1371895116,1371895716,3,1,600
97489023@N00,7976,13,1323138118,1323138718,2,3,600
97489023@N00,7976,23,1323147679,1323147769,2,3,90
97489023@N00,7976,14,1323151526,1323151646,1,3,120
97489023@N00,7977,27,1323652370,1323653570,2,2,1200
97489023@N00,7977,25,1323667923,1323668673,1,2,750
97522763@N07,7978,27,1381017622,1381018822,37,1,1200
97522763@N07,7979,27,1445040222,1445041422,3,4,1200
97522763@N07,7979,13,1445048550,1445049150,3,4,600
97522763@N07,7979,15,1445051430,1445051513,2,4,83
97522763@N07,7979,14,1445051513,1445051633,1,4,120
97550352@N08,7980,27,1381549018,1381550218,1,1,1200
97550352@N08,7981,27,1381642239,1381643439,1,1,1200
97550352@N08,7982,27,1387613832,1387615032,2,1,1200
97586961@N05,7983,17,1395629754,1395631134,1,1,1380
97586961@N05,7984,18,1395710345,1395712145,1,1,1800
97586961@N05,7985,19,1395803530,1395803950,1,1,420
97586978@N07,7986,10,1350053985,1350054405,1,1,420
97599663@N05,7987,26,1434413750,1434413930,5,4,180
97599663@N05,7987,6,1434430551,1434430806,2,4,255
97599663@N05,7987,10,1434436494,1434436914,2,4,420
97599663@N05,7987,25,1434454273,1434455023,13,4,750
97599663@N05,7988,16,1434766107,1434766158,4,4,51
97599663@N05,7988,14,1434766158,1434766158,2,4,0
97599663@N05,7988,16,1434766158,1434766171,2,4,13
97599663@N05,7988,14,1434766171,1434766291,1,4,120
97621779@N03,7989,14,1339503658,1339503778,2,1,120
97621779@N03,7990,27,1378252343,1378253543,2,2,1200
97621779@N03,7990,10,1378253885,1378254305,3,2,420
97639305@N00,7991,27,1300103120,1300104320,2,1,1200
97662785@N07,7992,14,1313628553,1313628673,1,1,120
97675277@N00,7993,12,1350824137,1350824150,2,5,13
97675277@N00,7993,15,1350824150,1350824330,2,5,180
97675277@N00,7993,23,1350825229,1350825312,2,5,83
97675277@N00,7993,4,1350825312,1350825340,2,5,28
97675277@N00,7993,14,1350825340,1350825460,1,5,120
97721343@N08,7994,27,1420030830,1420032030,1,1,1200
97721343@N08,7995,8,1420242905,1420243025,4,1,120
97721343@N08,7996,27,1438994807,1438996007,1,1,1200
97721343@N08,7997,8,1439094942,1439095062,5,4,120
97721343@N08,7997,27,1439099863,1439100169,2,4,306
97721343@N08,7997,17,1439100169,1439100775,2,4,606
97721343@N08,7997,27,1439100775,1439101975,1,4,1200
97721343@N08,7998,8,1463627916,1463628036,2,1,120
97797214@N02,7999,27,1450313924,1450315124,3,1,1200
97818848@N05,8000,22,1402126343,1402126943,1,1,600
97818848@N05,8001,14,1438001502,1438001622,2,1,120
97818848@N05,8002,27,1453422308,1453423508,2,2,1200
97818848@N05,8002,9,1453444950,1453445190,3,2,240
97831130@N00,8003,27,1333463439,1333464639,1,1,1200
97831130@N00,8004,16,1333509359,1333510079,2,3,720
97831130@N00,8004,6,1333533820,1333534075,2,3,255
97831130@N00,8004,14,1333535097,1333535217,1,3,120
97831130@N00,8005,6,1333955747,1333956002,1,1,255
97831130@N00,8006,14,1334058873,1334058993,1,1,120
97838235@N00,8007,16,1381352142,1381352422,2,5,280
97838235@N00,8007,14,1381352422,1381352542,7,5,120
97838235@N00,8007,9,1381356368,1381356608,3,5,240
97838235@N00,8007,2,1381357659,1381357749,2,5,90
97838235@N00,8007,9,1381368542,1381368782,1,5,240
97838235@N00,8008,14,1381443732,1381443852,14,7,120
97838235@N00,8008,12,1381446938,1381447778,18,7,840
97838235@N00,8008,10,1381449053,1381449473,2,7,420
97838235@N00,8008,19,1381458805,1381459225,2,7,420
97838235@N00,8008,25,1381460660,1381461410,3,7,750
97838235@N00,8008,23,1381462825,1381462915,2,7,90
97838235@N00,8008,21,1381463555,1381464005,2,7,450
97845599@N04,8009,10,1423523645,1423524065,1,1,420
9790304@N07,8010,16,1364029799,1364030519,2,4,720
9790304@N07,8010,27,1364031491,1364032691,28,4,1200
9790304@N07,8010,10,1364036885,1364037305,6,4,420
9790304@N07,8010,27,1364039511,1364040711,1,4,1200
9790304@N07,8011,27,1364088250,1364089177,2,3,927
9790304@N07,8011,8,1364089177,1364089297,4,3,120
9790304@N07,8011,2,1364089923,1364090013,1,3,90
97927316@N02,8012,27,1388799739,1388800939,2,2,1200
97927316@N02,8012,16,1388815712,1388816432,1,2,720
97964364@N00,8013,14,1191645519,1191645639,1,1,120
97964364@N00,8014,14,1191880270,1191880390,5,1,120
97994710@N03,8015,27,1403101458,1403102658,1,1,1200
98051750@N04,8016,14,1369477787,1369477907,1,1,120
98066314@N07,8017,18,1362011847,1362013647,2,2,1800
98066314@N07,8017,17,1362037157,1362038537,2,2,1380
9806845@N03,8018,4,1308096017,1308096917,16,1,900
9806845@N03,8019,4,1308222721,1308223621,9,1,900
9806845@N03,8020,4,1308545486,1308546386,11,1,900
9806845@N03,8021,4,1308786981,1308787881,23,1,900
98109106@N00,8022,27,1246163185,1246164385,2,8,1200
98109106@N00,8022,2,1246167612,1246167702,6,8,90
98109106@N00,8022,6,1246171606,1246171861,2,8,255
98109106@N00,8022,11,1246173505,1246173685,3,8,180
98109106@N00,8022,14,1246175250,1246175370,2,8,120
98109106@N00,8022,8,1246180096,1246180216,2,8,120
98109106@N00,8022,11,1246181391,1246181571,2,8,180
98109106@N00,8022,27,1246182409,1246183609,1,8,1200
98109106@N00,8023,27,1246638552,1246639752,6,2,1200
98109106@N00,8023,14,1246639825,1246639945,9,2,120
98109106@N00,8024,27,1246952379,1246953268,3,11,889
98109106@N00,8024,14,1246953268,1246953388,2,11,120
98109106@N00,8024,16,1246954159,1246954879,2,11,720
98109106@N00,8024,14,1246959132,1246959252,4,11,120
98109106@N00,8024,12,1246960803,1246961643,2,11,840
98109106@N00,8024,17,1246964422,1246965802,2,11,1380
98109106@N00,8024,15,1246967654,1246967785,2,11,131
98109106@N00,8024,14,1246967785,1246967905,4,11,120
98109106@N00,8024,21,1246972427,1246972877,2,11,450
98109106@N00,8024,23,1246973202,1246973292,2,11,90
98109106@N00,8024,20,1246974879,1246975959,4,11,1080
98111413@N05,8025,3,1445418697,1445418967,1,1,270
9813050@N08,8026,27,1257156177,1257156506,9,8,329
9813050@N08,8026,16,1257156506,1257157226,40,8,720
9813050@N08,8026,9,1257162400,1257162640,2,8,240
9813050@N08,8026,6,1257163692,1257163947,2,8,255
9813050@N08,8026,5,1257163969,1257164680,6,8,711
9813050@N08,8026,13,1257164680,1257165280,5,8,600
9813050@N08,8026,18,1257165673,1257165948,4,8,275
9813050@N08,8026,22,1257165948,1257166548,7,8,600
9813050@N08,8027,27,1257308167,1257309244,15,13,1077
9813050@N08,8027,11,1257309244,1257309410,9,13,166
9813050@N08,8027,9,1257309410,1257309650,7,13,240
9813050@N08,8027,15,1257309681,1257309861,11,13,180
9813050@N08,8027,26,1257310150,1257310330,8,13,180
9813050@N08,8027,17,1257310365,1257311745,3,13,1380
9813050@N08,8027,22,1257312923,1257313523,10,13,600
9813050@N08,8027,16,1257315294,1257316014,35,13,720
9813050@N08,8027,2,1257316311,1257316328,2,13,17
9813050@N08,8027,4,1257316328,1257316410,6,13,82
9813050@N08,8027,2,1257316410,1257316500,20,13,90
9813050@N08,8027,4,1257317066,1257317966,13,13,900
9813050@N08,8027,27,1257319863,1257321063,13,13,1200
9813050@N08,8028,27,1257471137,1257472337,19,3,1200
9813050@N08,8028,20,1257482119,1257483199,17,3,1080
9813050@N08,8028,9,1257485836,1257486076,3,3,240
98223232@N00,8029,27,1255327275,1255328475,4,1,1200
98223232@N00,8030,27,1255646704,1255647904,7,1,1200
98234674@N06,8031,27,1332022648,1332023848,1,1,1200
98283794@N05,8032,24,1369185868,1369186348,2,2,480
98283794@N05,8032,14,1369193479,1369193599,1,2,120
98297562@N04,8033,18,1395042396,1395044196,2,1,1800
98297562@N04,8034,1,1395320611,1395321211,1,1,600
98323063@N07,8035,27,1375955440,1375956640,1,1,1200
98327728@N00,8036,10,1418539182,1418539602,1,1,420
98327728@N00,8037,17,1418956060,1418957440,2,2,1380
98327728@N00,8037,9,1418963625,1418963865,1,2,240
98387918@N07,8038,16,1417164882,1417165602,1,1,720
98474523@N00,8039,16,1322818304,1322819024,15,3,720
98474523@N00,8039,17,1322825994,1322827374,3,3,1380
98474523@N00,8039,19,1322828927,1322829347,3,3,420
98474523@N00,8040,19,1322953938,1322954358,5,5,420
98474523@N00,8040,16,1322959628,1322960348,3,5,720
98474523@N00,8040,17,1322961253,1322962633,12,5,1380
98474523@N00,8040,21,1322976785,1322977235,8,5,450
98474523@N00,8040,14,1322979299,1322979419,1,5,120
98474523@N00,8041,14,1323149376,1323149496,3,1,120
98497282@N00,8042,27,1369954409,1369955609,2,9,1200
98497282@N00,8042,11,1369958802,1369958982,2,9,180
98497282@N00,8042,7,1369960600,1369960690,2,9,90
98497282@N00,8042,16,1369962383,1369962558,2,9,175
98497282@N00,8042,14,1369962558,1369962678,3,9,120
98497282@N00,8042,9,1369966909,1369967149,3,9,240
98497282@N00,8042,17,1369972876,1369974256,2,9,1380
98497282@N00,8042,13,1369985653,1369986253,3,9,600
98497282@N00,8042,9,1369986819,1369987059,2,9,240
98497282@N00,8043,24,1370314165,1370314645,1,1,480
98537131@N08,8044,6,1398215170,1398215425,1,1,255
9858951@N03,8045,16,1230199892,1230200290,11,2,398
9858951@N03,8045,27,1230200290,1230201490,26,2,1200
9858951@N03,8046,27,1230354679,1230354957,3,5,278
9858951@N03,8046,16,1230354957,1230355677,206,5,720
9858951@N03,8046,27,1230356790,1230357061,34,5,271
9858951@N03,8046,16,1230357061,1230357106,20,5,45
9858951@N03,8046,27,1230357106,1230358306,17,5,1200
9858951@N03,8047,19,1241317197,1241317617,1,1,420
98593368@N02,8048,15,1408526595,1408526775,2,3,180
98593368@N02,8048,12,1408527049,1408527068,2,3,19
98593368@N02,8048,15,1408527068,1408527248,2,3,180
9860213@N08,8049,27,1343025047,1343026247,1,1,1200
9860213@N08,8050,27,1343181716,1343182916,2,3,1200
9860213@N08,8050,14,1343185868,1343185972,2,3,104
9860213@N08,8050,27,1343185972,1343187172,1,3,1200
9860213@N08,8051,5,1343218165,1343218885,1,1,720
9860213@N08,8052,27,1441520849,1441522049,1,1,1200
9860213@N08,8053,21,1447905067,1447905517,1,1,450
98645300@N00,8054,27,1308739999,1308741199,1,1,1200
98672908@N07,8055,27,1451347747,1451348947,2,4,1200
98672908@N07,8055,1,1451349924,1451350524,2,4,600
98672908@N07,8055,9,1451362222,1451362462,2,4,240
98672908@N07,8055,22,1451371091,1451371691,1,4,600
9868739@N04,8056,19,1467978476,1467978896,1,1,420
98713175@N04,8057,4,1372892614,1372893514,1,1,900
98713175@N04,8058,21,1372926207,1372926657,4,3,450
98713175@N04,8058,24,1372926826,1372927124,3,3,298
98713175@N04,8058,26,1372927124,1372927304,3,3,180
98767429@N00,8059,27,1197230596,1197231796,3,8,1200
98767429@N00,8059,25,1197235623,1197236373,11,8,750
98767429@N00,8059,17,1197244018,1197245398,7,8,1380
98767429@N00,8059,22,1197248194,1197248794,7,8,600
98767429@N00,8059,16,1197253894,1197254614,3,8,720
98767429@N00,8059,5,1197283866,1197284586,4,8,720
98767429@N00,8059,16,1197284689,1197285308,2,8,619
98767429@N00,8059,14,1197285308,1197285428,4,8,120
98876406@N00,8060,2,1356736137,1356736227,1,1,90
98889314@N02,8061,23,1403490990,1403491080,1,1,90
98889314@N02,8062,10,1403675163,1403675583,1,1,420
98889314@N02,8063,27,1403771161,1403771344,2,3,183
98889314@N02,8063,17,1403771344,1403772428,3,3,1084
98889314@N02,8063,27,1403772428,1403773628,1,3,1200
98889314@N02,8064,27,1403905776,1403906088,10,21,312
98889314@N02,8064,16,1403906088,1403906144,8,21,56
98889314@N02,8064,14,1403906144,1403906264,8,21,120
98889314@N02,8064,9,1403906341,1403906581,12,21,240
98889314@N02,8064,17,1403908271,1403908668,9,21,397
98889314@N02,8064,27,1403908668,1403909868,12,21,1200
98889314@N02,8064,4,1403920029,1403920929,2,21,900
98889314@N02,8064,5,1403921358,1403921368,2,21,10
98889314@N02,8064,6,1403921368,1403921483,3,21,115
98889314@N02,8064,7,1403921483,1403921547,3,21,64
98889314@N02,8064,10,1403921547,1403921967,8,21,420
98889314@N02,8064,14,1403922878,1403922998,5,21,120
98889314@N02,8064,16,1403923498,1403924003,3,21,505
98889314@N02,8064,27,1403924003,1403924852,11,21,849
98889314@N02,8064,5,1403924852,1403924943,4,21,91
98889314@N02,8064,2,1403924943,1403924984,3,21,41
98889314@N02,8064,1,1403924984,1403925584,11,21,600
98889314@N02,8064,2,1403926115,1403926127,2,21,12
98889314@N02,8064,5,1403926127,1403926233,4,21,106
98889314@N02,8064,4,1403926233,1403926453,3,21,220
98889314@N02,8064,27,1403926453,1403927653,13,21,1200
98889314@N02,8065,15,1404035946,1404036126,1,1,180
98889314@N02,8066,15,1405591815,1405591995,1,1,180
98889314@N02,8067,17,1417212251,1417213631,1,1,1380
98889314@N02,8068,17,1430872728,1430874108,1,1,1380
98889314@N02,8069,10,1432467476,1432467896,2,1,420
98926431@N07,8070,6,1381412946,1381413201,2,1,255
98926431@N07,8071,6,1383632807,1383633062,2,1,255
9907136@N02,8072,27,1252010963,1252012163,3,2,1200
9907136@N02,8072,13,1252018655,1252019255,2,2,600
9907136@N02,8073,27,1252378021,1252379221,1,1,1200
9907136@N02,8074,9,1252448787,1252449027,2,5,240
9907136@N02,8074,13,1252453599,1252454199,2,5,600
9907136@N02,8074,20,1252459570,1252460650,2,5,1080
9907136@N02,8074,19,1252461121,1252461541,2,5,420
9907136@N02,8074,17,1252477810,1252479190,3,5,1380
9907136@N02,8075,6,1333491574,1333491829,2,6,255
9907136@N02,8075,8,1333492467,1333492587,2,6,120
9907136@N02,8075,9,1333492838,1333493078,2,6,240
9907136@N02,8075,14,1333494870,1333494990,2,6,120
9907136@N02,8075,12,1333499562,1333500402,2,6,840
9907136@N02,8075,13,1333500775,1333501375,2,6,600
9907136@N02,8076,27,1333708328,1333709528,2,2,1200
9907136@N02,8076,17,1333719010,1333720390,1,2,1380
9907136@N02,8077,9,1333762405,1333762645,2,1,240
99078571@N02,8078,20,1426132895,1426133975,3,3,1080
99078571@N02,8078,21,1426144367,1426144817,6,3,450
99078571@N02,8078,19,1426151770,1426152190,4,3,420
99119735@N06,8079,27,1382566767,1382567606,3,9,839
99119735@N06,8079,14,1382567606,1382567702,3,9,96
99119735@N06,8079,10,1382567702,1382567761,2,9,59
99119735@N06,8079,9,1382567761,1382567838,2,9,77
99119735@N06,8079,10,1382567838,1382568258,4,9,420
99119735@N06,8079,8,1382569173,1382569293,2,9,120
99119735@N06,8079,15,1382573940,1382574120,3,9,180
99119735@N06,8079,1,1382583832,1382584432,4,9,600
99119735@N06,8079,3,1382587208,1382587478,3,9,270
99119735@N06,8080,27,1382655020,1382656220,2,8,1200
99119735@N06,8080,7,1382657502,1382657592,2,8,90
99119735@N06,8080,15,1382661923,1382662103,2,8,180
99119735@N06,8080,27,1382664704,1382665904,6,8,1200
99119735@N06,8080,9,1382672537,1382672777,2,8,240
99119735@N06,8080,26,1382675005,1382675185,13,8,180
99119735@N06,8080,23,1382678381,1382678471,2,8,90
99119735@N06,8080,4,1382680385,1382681285,2,8,900
99119735@N06,8081,13,1383041788,1383042388,2,2,600
99119735@N06,8081,17,1383042663,1383044043,1,2,1380
99146615@N07,8082,16,1382773914,1382774634,1,1,720
9919720@N04,8083,14,1380185801,1380185921,1,1,120
9919720@N04,8084,9,1380252471,1380252711,3,1,240
99219204@N00,8085,16,1358925411,1358926131,2,8,720
99219204@N00,8085,12,1358929187,1358929516,4,8,329
99219204@N00,8085,13,1358929516,1358929846,4,8,330
99219204@N00,8085,15,1358929846,1358930026,2,8,180
99219204@N00,8085,10,1358930814,1358931234,2,8,420
99219204@N00,8085,7,1358931984,1358932074,2,8,90
99219204@N00,8085,2,1358933868,1358933958,2,8,90
99219204@N00,8085,8,1358937188,1358937308,1,8,120
99219204@N00,8086,27,1358970625,1358971825,1,1,1200
99219204@N00,8087,10,1359238989,1359239409,2,8,420
99219204@N00,8087,25,1359248865,1359249615,3,8,750
99219204@N00,8087,18,1359253916,1359255716,2,8,1800
99219204@N00,8087,17,1359256227,1359257607,4,8,1380
99219204@N00,8087,13,1359258211,1359258811,2,8,600
99219204@N00,8087,11,1359266916,1359267096,2,8,180
99219204@N00,8087,14,1359268916,1359269036,4,8,120
99219204@N00,8087,10,1359275441,1359275861,1,8,420
99250440@N05,8088,14,1386405995,1386406115,1,1,120
99250440@N05,8089,25,1386474239,1386474989,1,1,750
99259935@N03,8090,7,1374125897,1374125987,3,4,90
99259935@N03,8090,16,1374131301,1374132021,3,4,720
99259935@N03,8090,22,1374133013,1374133613,4,4,600
99259935@N03,8090,17,1374134020,1374135400,1,4,1380
9926279@N03,8091,10,1460861395,1460861815,2,1,420
99290939@N03,8092,12,1418176281,1418176508,2,7,227
99290939@N03,8092,13,1418176508,1418176760,2,7,252
99290939@N03,8092,15,1418176760,1418176940,4,7,180
99290939@N03,8092,9,1418196416,1418196656,3,7,240
99290939@N03,8092,19,1418200650,1418201070,4,7,420
99290939@N03,8092,20,1418201873,1418202953,2,7,1080
99290939@N03,8092,17,1418206695,1418208075,21,7,1380
99331736@N00,8093,12,1376034331,1376035171,2,4,840
99331736@N00,8093,24,1376035726,1376036206,2,4,480
99331736@N00,8093,9,1376038122,1376038362,2,4,240
99331736@N00,8093,8,1376041093,1376041213,1,4,120
99331736@N00,8094,16,1376094978,1376095698,1,1,720
99357496@N07,8095,3,1466808932,1466809202,2,1,270
99383273@N03,8096,16,1394349482,1394350202,4,1,720
99385068@N00,8097,18,1258862534,1258862755,2,4,221
99385068@N00,8097,26,1258862755,1258862761,2,4,6
99385068@N00,8097,18,1258862761,1258862822,2,4,61
99385068@N00,8097,26,1258862822,1258863002,1,4,180
99385068@N00,8098,14,1259185913,1259186033,2,2,120
99385068@N00,8098,16,1259188143,1259188863,1,2,720
99385068@N00,8099,14,1383308417,1383308537,5,2,120
99385068@N00,8099,2,1383309136,1383309226,16,2,90
99385068@N00,8100,12,1383436907,1383437747,8,1,840
99385068@N00,8101,9,1383694922,1383695162,12,2,240
99385068@N00,8101,14,1383715639,1383715759,3,2,120
99385068@N00,8102,20,1383900891,1383901971,2,1,1080
99413924@N08,8103,27,1372932280,1372933480,1,1,1200
99422834@N05,8104,2,1331636473,1331636563,2,4,90
99422834@N05,8104,9,1331639739,1331639979,5,4,240
99422834@N05,8104,12,1331641168,1331641781,13,4,613
99422834@N05,8104,14,1331641781,1331641901,1,4,120
99422834@N05,8105,18,1331895287,1331897087,1,1,1800
9943459@N04,8106,16,1331672449,1331673169,1,1,720
99467063@N06,8107,27,1376220156,1376221356,3,1,1200
99467063@N06,8108,8,1376371822,1376371942,1,1,120
99471343@N00,8109,1,1366070014,1366070614,3,8,600
99471343@N00,8109,2,1366071173,1366071263,2,8,90
99471343@N00,8109,4,1366073176,1366074076,3,8,900
99471343@N00,8109,2,1366075212,1366075302,4,8,90
99471343@N00,8109,5,1366075801,1366076521,2,8,720
99471343@N00,8109,7,1366077582,1366077672,3,8,90
99471343@N00,8109,17,1366089715,1366091095,11,8,1380
99471343@N00,8109,15,1366093819,1366093999,1,8,180
99471343@N00,8110,9,1366240081,1366240321,2,7,240
99471343@N00,8110,14,1366240587,1366240707,4,7,120
99471343@N00,8110,10,1366249820,1366250240,4,7,420
99471343@N00,8110,9,1366250633,1366250873,2,7,240
99471343@N00,8110,8,1366251457,1366251577,3,7,120
99471343@N00,8110,25,1366257388,1366258138,3,7,750
99471343@N00,8110,24,1366258505,1366258985,1,7,480
99471343@N00,8111,27,1366351152,1366352352,2,2,1200
99471343@N00,8111,23,1366356068,1366356158,1,2,90
99476430@N00,8112,14,1434509812,1434509932,2,2,120
99476430@N00,8112,5,1434510469,1434511189,1,2,720
99502551@N08,8113,20,1406943715,1406944795,6,3,1080
99502551@N08,8113,10,1406948096,1406948516,2,3,420
99502551@N08,8113,19,1406950626,1406951046,1,3,420
99503665@N00,8114,19,1324867749,1324868169,1,1,420
99655398@N04,8115,16,1371730076,1371730796,1,1,720
9969286@N04,8116,4,1373169174,1373170074,1,1,900
99770522@N07,8117,14,1374277970,1374278090,1,1,120
9979792@N04,8118,2,1318378033,1318378123,2,1,90
99813844@N00,8119,13,1340531976,1340532027,2,4,51
99813844@N00,8119,1,1340532027,1340532589,2,4,562
99813844@N00,8119,16,1340532589,1340532642,2,4,53
99813844@N00,8119,27,1340532642,1340533842,1,4,1200
99842259@N06,8120,2,1359330989,1359331079,1,1,90
99948019@N00,8121,13,1385860935,1385861535,2,2,600
99948019@N00,8121,14,1385877676,1385877796,1,2,120
99948019@N00,8122,6,1386487292,1386487547,2,4,255
99948019@N00,8122,9,1386488081,1386488321,2,4,240
99948019@N00,8122,16,1386489505,1386490225,2,4,720
99948019@N00,8122,19,1386498190,1386498610,1,4,420
99948019@N00,8123,16,1386727916,1386728636,2,3,720
99948019@N00,8123,14,1386754687,1386754807,3,3,120
99948019@N00,8123,10,1386759970,1386760390,1,3,420
99948019@N00,8124,27,1386889912,1386891112,2,3,1200
99948019@N00,8124,19,1386910531,1386910951,2,3,420
99948019@N00,8124,16,1386915318,1386916038,1,3,720
99977334@N00,8125,4,1317128191,1317129091,1,1,900
99983775@N00,8126,27,1335484143,1335485343,5,3,1200
99983775@N00,8126,9,1335487318,1335487558,2,3,240
99983775@N00,8126,6,1335490718,1335490973,1,3,255
