userID,trajID,poiID,startTime,endTime,#photo,trajLen,poiDuration
100049423@N05,1,11,1376565773,1376566733,1,1,960
100063617@N06,2,11,1451012071,1451013031,2,1,960
10008488@N07,3,17,1354153386,1354156086,1,1,2700
10008488@N07,4,5,1354580494,1354580914,1,1,420
100214981@N03,5,11,1374451523,1374452483,145,1,960
100214981@N03,6,11,1378167118,1378168078,1,1,960
100354657@N04,7,11,1363604909,1363605869,1,1,960
100363554@N07,8,11,1462850364,1462851324,1,1,960
100436193@N03,9,14,1419464468,1419465668,2,2,1200
100436193@N03,9,4,1419466160,1419466520,1,2,360
100448554@N06,10,10,1371363018,1371363918,1,1,900
100459519@N02,11,13,1462765469,1462766549,2,2,1080
100459519@N02,11,15,1462770945,1462772145,1,2,1200
100459519@N02,12,2,1462941587,1462941827,1,1,240
10048675@N02,13,10,1233348588,1233349488,3,1,900
10048675@N02,14,8,1233528573,1233529413,3,4,840
10048675@N02,14,10,1233531817,1233531829,2,4,12
10048675@N02,14,13,1233531829,1233532909,10,4,1080
10048675@N02,14,10,1233545712,1233546612,4,4,900
10048675@N02,15,1,1234142295,1234142535,2,2,240
10048675@N02,15,10,1234144700,1234145600,1,2,900
10048675@N02,16,8,1234314519,1234315359,2,6,840
10048675@N02,16,6,1234316806,1234317526,2,6,720
10048675@N02,16,8,1234324562,1234325402,2,6,840
10048675@N02,16,13,1234327057,1234328137,5,6,1080
10048675@N02,16,10,1234331502,1234332402,3,6,900
10048675@N02,16,13,1234336048,1234337128,11,6,1080
10048675@N02,17,13,1234504968,1234506048,4,5,1080
10048675@N02,17,1,1234506689,1234506929,3,5,240
10048675@N02,17,9,1234508181,1234509081,5,5,900
10048675@N02,17,1,1234510556,1234510796,10,5,240
10048675@N02,17,11,1234513275,1234514235,2,5,960
100506822@N02,18,15,1387860460,1387861379,3,3,919
100506822@N02,18,17,1387861379,1387864079,3,3,2700
100506822@N02,18,11,1387872225,1387873185,11,3,960
100506822@N02,19,6,1388056931,1388057651,2,1,720
100523630@N04,20,13,1384847821,1384848901,3,2,1080
100523630@N04,20,8,1384851704,1384852544,1,2,840
100524190@N04,21,8,1389855575,1389856415,1,1,840
10061441@N03,22,11,1229533072,1229534032,1,1,960
10061441@N03,23,13,1229627071,1229628151,1,1,1080
100620414@N03,24,11,1461712118,1461713078,9,11,960
100620414@N03,24,1,1461718283,1461718523,4,11,240
100620414@N03,24,5,1461719152,1461719572,4,11,420
100620414@N03,24,8,1461719960,1461720800,8,11,840
100620414@N03,24,13,1461723839,1461724800,6,11,961
100620414@N03,24,15,1461724800,1461724932,3,11,132
100620414@N03,24,17,1461724932,1461725228,2,11,296
100620414@N03,24,15,1461725228,1461726428,9,11,1200
100620414@N03,24,17,1461727211,1461727727,10,11,516
100620414@N03,24,10,1461727727,1461728627,8,11,900
100620414@N03,24,5,1461729208,1461729628,11,11,420
100657680@N02,25,5,1395530058,1395530478,1,1,420
10068791@N08,26,11,1251425652,1251426612,2,2,960
10068791@N08,26,14,1251430414,1251431614,1,2,1200
100692786@N04,27,11,1377225508,1377226468,1,1,960
100692786@N04,28,11,1394244306,1394245266,1,1,960
100692786@N04,29,17,1394928488,1394931188,1,1,2700
100692786@N04,30,11,1400360079,1400361039,1,1,960
10076246@N06,31,11,1209662791,1209663751,1,1,960
100775193@N08,32,2,1389753952,1389754192,1,1,240
100775237@N03,33,11,1311389608,1311390568,1,1,960
100775237@N03,34,3,1341064800,1341064800,2,2,0
100775237@N03,34,11,1341064800,1341065760,2,2,960
100775237@N03,35,11,1372600800,1372600800,2,2,0
100775237@N03,35,14,1372600800,1372602000,1,2,1200
100775237@N03,36,14,1405644303,1405644476,5,4,173
100775237@N03,36,3,1405644476,1405644806,8,4,330
100775237@N03,36,4,1405645010,1405645370,2,4,360
100775237@N03,36,11,1405653257,1405654217,4,4,960
100822654@N07,37,13,1400647105,1400648185,1,1,1080
100822654@N07,38,5,1400708131,1400708551,5,2,420
100822654@N07,38,4,1400733548,1400733908,1,2,360
100822654@N07,39,13,1400956813,1400957893,1,1,1080
10084809@N04,40,11,1459820341,1459821301,2,1,960
100948027@N07,41,8,1315281409,1315282249,7,2,840
100948027@N07,41,13,1315296132,1315297212,1,2,1080
101102803@N06,42,8,1344318648,1344319488,1,1,840
101118128@N08,43,17,1446957626,1446960326,1,1,2700
101195207@N02,44,11,1467023380,1467024340,3,1,960
10128570@N04,45,17,1218858723,1218861423,4,3,2700
10128570@N04,45,10,1218862691,1218863591,6,3,900
10128570@N04,45,8,1218879135,1218879975,4,3,840
101355546@N05,46,5,1433557433,1433557853,1,1,420
101445497@N05,47,11,1222265010,1222265970,2,1,960
101445497@N05,48,9,1316493033,1316493933,2,2,900
101445497@N05,48,11,1316519128,1316520088,1,2,960
101445497@N05,49,11,1316658792,1316659752,2,2,960
101445497@N05,49,9,1316662683,1316663583,1,2,900
101445497@N05,50,5,1353127016,1353127436,1,1,420
101445497@N05,51,13,1369536010,1369537090,2,2,1080
101445497@N05,51,1,1369545567,1369545807,1,2,240
101445497@N05,52,9,1380770999,1380771899,3,4,900
101445497@N05,52,17,1380775831,1380778531,2,4,2700
101445497@N05,52,8,1380790923,1380791763,3,4,840
101445497@N05,52,5,1380793304,1380793724,1,4,420
101445497@N05,53,10,1380876245,1380877145,2,2,900
101445497@N05,53,9,1380883314,1380884214,1,2,900
101445497@N05,54,3,1389334716,1389335046,2,2,330
101445497@N05,54,15,1389337291,1389338491,1,2,1200
101445497@N05,55,11,1433294694,1433295654,2,3,960
101445497@N05,55,5,1433301323,1433301743,3,3,420
101445497@N05,55,13,1433319502,1433320582,1,3,1080
101445497@N05,56,4,1452220565,1452220925,2,4,360
101445497@N05,56,8,1452224936,1452225776,2,4,840
101445497@N05,56,16,1452230529,1452232629,2,4,2100
101445497@N05,56,11,1452234523,1452235483,2,4,960
101473404@N07,57,11,1388726894,1388727854,3,3,960
101473404@N07,57,8,1388728274,1388729114,2,3,840
101473404@N07,57,11,1388751001,1388751961,1,3,960
101473404@N07,58,11,1453636986,1453637946,5,8,960
101473404@N07,58,15,1453638922,1453640122,2,8,1200
101473404@N07,58,10,1453642338,1453642608,5,8,270
101473404@N07,58,17,1453642608,1453642806,2,8,198
101473404@N07,58,15,1453642806,1453643037,2,8,231
101473404@N07,58,13,1453643037,1453644117,4,8,1080
101473404@N07,58,15,1453644137,1453644329,2,8,192
101473404@N07,58,10,1453644329,1453645229,1,8,900
10148198@N00,59,11,1388902220,1388903180,1,1,960
101503011@N06,60,2,1443749161,1443749401,3,4,240
101503011@N06,60,7,1443751173,1443751225,2,4,52
101503011@N06,60,2,1443751225,1443751465,2,4,240
101503011@N06,60,11,1443759456,1443760416,1,4,960
10156308@N03,61,15,1418971435,1418972635,2,2,1200
10156308@N03,61,1,1418988089,1418988329,3,2,240
10156308@N03,62,4,1419034591,1419034951,1,1,360
10175710@N03,63,11,1374103345,1374104305,2,2,960
10175710@N03,63,8,1374121822,1374122662,2,2,840
10182842@N08,64,11,1215141337,1215142297,3,1,960
10183029@N00,65,11,1326782023,1326782983,1,1,960
10183029@N00,66,11,1326836472,1326837432,152,1,960
101924327@N08,67,11,1416397007,1416397967,1,1,960
102284959@N03,68,11,1380404414,1380405374,2,1,960
102284959@N03,69,6,1398447381,1398448101,1,1,720
102284959@N03,70,11,1443166515,1443167475,1,1,960
102284959@N03,71,11,1443703316,1443704276,2,3,960
102284959@N03,71,8,1443717629,1443718469,3,3,840
102284959@N03,71,11,1443719121,1443720081,3,3,960
102284959@N03,72,11,1450759509,1450760469,1,1,960
10245322@N05,73,11,1197675088,1197676048,1,1,960
10245322@N05,74,8,1197780519,1197781359,1,1,840
10259875@N03,75,11,1204290000,1204290000,2,2,0
10259875@N03,75,13,1204290000,1204291080,1,2,1080
10259875@N03,76,15,1206233100,1206234300,1,1,1200
10259875@N03,77,10,1231370678,1231371578,2,5,900
10259875@N03,77,2,1231387716,1231387956,2,5,240
10259875@N03,77,11,1231389573,1231390533,2,5,960
10259875@N03,77,10,1231404055,1231404955,3,5,900
10259875@N03,77,11,1231411174,1231412134,1,5,960
10259875@N03,78,11,1262515088,1262516048,3,1,960
10259875@N03,79,11,1262645553,1262646033,2,6,480
10259875@N03,79,4,1262646033,1262646393,5,6,360
10259875@N03,79,11,1262647689,1262648649,3,6,960
10259875@N03,79,5,1262664288,1262664708,2,6,420
10259875@N03,79,8,1262667656,1262668496,2,6,840
10259875@N03,79,13,1262675473,1262676553,1,6,1080
10259875@N03,80,5,1273991643,1273992063,2,8,420
10259875@N03,80,10,1273993136,1273993418,2,8,282
10259875@N03,80,8,1273993418,1273994258,3,8,840
10259875@N03,80,13,1274003541,1274004621,10,8,1080
10259875@N03,80,15,1274004836,1274004978,2,8,142
10259875@N03,80,17,1274004978,1274005061,2,8,83
10259875@N03,80,15,1274005061,1274006261,2,8,1200
10259875@N03,80,11,1274009773,1274010733,1,8,960
10259875@N03,81,11,1303094675,1303095635,2,6,960
10259875@N03,81,15,1303112790,1303112963,2,6,173
10259875@N03,81,17,1303112963,1303113199,2,6,236
10259875@N03,81,10,1303113199,1303114099,2,6,900
10259875@N03,81,11,1303114627,1303115587,2,6,960
10259875@N03,81,13,1303122517,1303123597,5,6,1080
10259875@N03,82,11,1364611881,1364612841,4,6,960
10259875@N03,82,5,1364624998,1364625418,2,6,420
10259875@N03,82,13,1364628066,1364629146,11,6,1080
10259875@N03,82,15,1364629884,1364630157,3,6,273
10259875@N03,82,17,1364630157,1364630926,3,6,769
10259875@N03,82,10,1364630926,1364631826,6,6,900
10259875@N03,83,10,1392516289,1392517189,2,6,900
10259875@N03,83,15,1392517870,1392519070,2,6,1200
10259875@N03,83,13,1392519630,1392520710,2,6,1080
10259875@N03,83,2,1392534568,1392534808,2,6,240
10259875@N03,83,7,1392535756,1392536596,2,6,840
10259875@N03,83,11,1392540659,1392541619,1,6,960
10259875@N03,84,8,1392714201,1392715041,2,2,840
10259875@N03,84,13,1392719629,1392720709,1,2,1080
10259875@N03,85,11,1428546335,1428547295,2,6,960
10259875@N03,85,9,1428557045,1428557945,2,6,900
10259875@N03,85,17,1428564519,1428565637,2,6,1118
10259875@N03,85,10,1428565637,1428566537,2,6,900
10259875@N03,85,13,1428567477,1428568557,4,6,1080
10259875@N03,85,5,1428572272,1428572692,2,6,420
10287709@N08,86,11,1257338639,1257339599,2,2,960
10287709@N08,86,1,1257343412,1257343652,1,2,240
10287709@N08,87,7,1257517115,1257517955,1,1,840
10295241@N02,88,4,1236468059,1236468419,2,3,360
10295241@N02,88,8,1236491899,1236492739,2,3,840
10295241@N02,88,11,1236501116,1236502076,2,3,960
10295241@N02,89,11,1371891137,1371892097,1,1,960
103400918@N03,90,10,1370300958,1370301858,1,1,900
103400918@N03,91,10,1370331016,1370331916,2,1,900
103482436@N07,92,11,1441365828,1441366788,1,1,960
10350193@N07,93,5,1212195910,1212196330,2,2,420
10350193@N07,93,8,1212197769,1212198609,1,2,840
10350193@N07,94,11,1260669109,1260670069,5,1,960
10350193@N07,95,9,1289019298,1289020198,1,1,900
10350193@N07,96,8,1301100472,1301101312,2,2,840
10350193@N07,96,17,1301106879,1301109579,2,2,2700
10350193@N07,97,11,1419510997,1419511957,2,1,960
10360498@N02,98,11,1335576555,1335577515,2,1,960
10360498@N02,99,11,1335629511,1335630471,3,1,960
10360498@N02,100,11,1336117977,1336118937,1,1,960
103662148@N03,101,11,1426763940,1426764900,1,1,960
103845490@N03,102,11,1380870929,1380871889,1,1,960
103845490@N03,103,11,1387339284,1387340244,1,1,960
103845490@N03,104,11,1391495082,1391496042,2,2,960
103845490@N03,104,17,1391498262,1391500962,1,2,2700
104009266@N06,105,5,1352357123,1352357543,1,1,420
10403093@N06,106,11,1353454131,1353455091,7,3,960
10403093@N06,106,13,1353463415,1353464495,3,3,1080
10403093@N06,106,10,1353468946,1353469846,2,3,900
10414404@N08,107,3,1405829092,1405829422,2,3,330
10414404@N08,107,8,1405840203,1405841043,2,3,840
10414404@N08,107,5,1405844241,1405844661,1,3,420
104152796@N05,108,11,1423272410,1423273370,1,1,960
104468853@N05,109,8,1432800117,1432800957,1,1,840
10474978@N05,110,2,1308990910,1308991150,1,1,240
10485077@N06,111,7,1202774520,1202775360,1,1,840
10500812@N04,112,11,1326445023,1326445983,2,2,960
10500812@N04,112,5,1326450908,1326451328,1,2,420
105156445@N06,113,11,1408581103,1408582063,2,8,960
105156445@N06,113,2,1408583271,1408583511,2,8,240
105156445@N06,113,10,1408584852,1408585469,2,8,617
105156445@N06,113,17,1408585469,1408585546,2,8,77
105156445@N06,113,15,1408585546,1408585695,4,8,149
105156445@N06,113,13,1408585695,1408586775,2,8,1080
105156445@N06,113,5,1408587985,1408588405,4,8,420
105156445@N06,113,11,1408589211,1408590171,1,8,960
10529536@N05,114,17,1298944638,1298947338,2,4,2700
10529536@N05,114,4,1298947486,1298947846,2,4,360
10529536@N05,114,8,1298957499,1298958339,2,4,840
10529536@N05,114,13,1298964960,1298966040,1,4,1080
10529536@N05,115,5,1299210988,1299211408,1,1,420
105380744@N04,116,3,1381996929,1381997259,2,2,330
105380744@N04,116,11,1382004508,1382005468,4,2,960
10546731@N07,117,2,1311416748,1311416988,2,1,240
10570686@N02,118,11,1268540991,1268541951,2,1,960
10570686@N02,119,11,1268685740,1268686700,2,1,960
10572043@N03,120,11,1305352674,1305353634,1,1,960
105763347@N06,121,8,1357111902,1357112742,1,1,840
105916543@N07,122,11,1453080137,1453081097,1,1,960
106025342@N02,123,8,1372401090,1372401930,1,1,840
106045902@N02,124,11,1366243452,1366244412,2,3,960
106045902@N02,124,10,1366256299,1366257199,2,3,900
106045902@N02,124,17,1366259701,1366262401,2,3,2700
106112977@N06,125,6,1441655288,1441656008,1,1,720
10617321@N00,126,11,1464513492,1464514452,1,1,960
106475835@N05,127,11,1361536912,1361537872,1,1,960
106475835@N05,128,11,1361623987,1361624947,3,1,960
106475835@N05,129,11,1365155303,1365156263,2,1,960
106475835@N05,130,11,1372425960,1372426920,2,1,960
106475835@N05,131,11,1382437124,1382438084,18,1,960
10655470@N06,132,11,1324594061,1324595021,15,1,960
10670886@N08,133,4,1397697184,1397697544,1,1,360
10692931@N08,134,11,1229640732,1229641692,8,2,960
10692931@N08,134,12,1229648321,1229649341,3,2,1020
106980455@N06,135,8,1383372686,1383373526,1,1,840
107084948@N08,136,11,1383790060,1383791020,58,1,960
10764262@N06,137,12,1359597279,1359598299,3,1,1020
10774763@N05,138,11,1251952995,1251953805,5,12,810
10774763@N05,138,5,1251953805,1251954225,6,12,420
10774763@N05,138,1,1251955527,1251955767,10,12,240
10774763@N05,138,9,1251956791,1251957691,9,12,900
10774763@N05,138,16,1251958134,1251958410,3,12,276
10774763@N05,138,11,1251958410,1251959370,4,12,960
10774763@N05,138,7,1251959744,1251960584,6,12,840
10774763@N05,138,2,1251961261,1251961501,4,12,240
10774763@N05,138,4,1251962266,1251962626,2,12,360
10774763@N05,138,17,1251962647,1251962763,3,12,116
10774763@N05,138,15,1251962763,1251963963,6,12,1200
10774763@N05,138,5,1251964729,1251965149,4,12,420
108140637@N08,139,11,1375330783,1375331743,21,7,960
108140637@N08,139,10,1375333669,1375334569,6,7,900
108140637@N08,139,17,1375335387,1375335740,10,7,353
108140637@N08,139,15,1375335740,1375336080,4,7,340
108140637@N08,139,17,1375336080,1375336269,3,7,189
108140637@N08,139,13,1375336269,1375337349,3,7,1080
108140637@N08,139,6,1375338128,1375338848,8,7,720
108207234@N02,140,16,1426205370,1426207470,3,1,2100
108207234@N02,141,11,1426389848,1426390808,1,1,960
108207234@N02,142,6,1464380841,1464381561,1,1,720
108207234@N02,143,11,1464409819,1464410779,1,1,960
108231769@N08,144,11,1396839694,1396840654,2,5,960
108231769@N08,144,8,1396850959,1396851799,3,5,840
108231769@N08,144,13,1396856465,1396857097,8,5,632
108231769@N08,144,17,1396857097,1396858102,3,5,1005
108231769@N08,144,10,1396858102,1396859002,1,5,900
10857883@N05,145,10,1270772023,1270772923,3,2,900
10857883@N05,145,11,1270786318,1270787278,2,2,960
10858077@N00,146,17,1207188738,1207191438,1,1,2700
108592555@N04,147,11,1400245860,1400245865,2,2,5
108592555@N04,147,8,1400245865,1400246705,1,2,840
10893867@N03,148,11,1211000057,1211001017,28,1,960
108942230@N03,149,5,1395646307,1395646727,1,1,420
10899502@N05,150,7,1256093920,1256094760,42,1,840
10899502@N05,151,11,1271818758,1271818767,8,3,9
10899502@N05,151,6,1271818767,1271818769,2,3,2
10899502@N05,151,11,1271818769,1271819729,1,3,960
10901345@N05,152,2,1446619714,1446619954,1,1,240
10905622@N03,153,11,1189150559,1189151519,1,1,960
10925918@N03,154,13,1362522701,1362523354,2,2,653
10925918@N03,154,17,1362523354,1362526054,1,2,2700
10925918@N03,155,8,1362612947,1362613787,3,2,840
10925918@N03,155,15,1362634933,1362636133,1,2,1200
109554486@N07,156,2,1384395099,1384395339,2,5,240
109554486@N07,156,4,1384400326,1384400686,2,5,360
109554486@N07,156,15,1384401571,1384402771,3,5,1200
109554486@N07,156,8,1384407784,1384408624,10,5,840
109554486@N07,156,11,1384425169,1384426129,2,5,960
10967865@N04,157,6,1352544446,1352545166,1,1,720
10983978@N03,158,17,1215163387,1215163643,2,5,256
10983978@N03,158,15,1215163643,1215164386,2,5,743
10983978@N03,158,6,1215164386,1215165106,14,5,720
10983978@N03,158,8,1215174577,1215175185,3,5,608
10983978@N03,158,5,1215175185,1215175605,1,5,420
10983978@N03,159,3,1217230841,1217231171,1,1,330
10983978@N03,160,11,1217665282,1217666242,1,1,960
10983978@N03,161,16,1218789711,1218791307,2,2,1596
10983978@N03,161,1,1218791307,1218791547,2,2,240
10983978@N03,162,16,1222587402,1222588105,3,2,703
10983978@N03,162,9,1222588105,1222589005,3,2,900
10983978@N03,163,17,1226152939,1226155639,1,1,2700
10983978@N03,164,6,1229333036,1229333756,1,1,720
10983978@N03,165,11,1234935143,1234936103,1,1,960
10983978@N03,166,2,1235036449,1235036689,2,2,240
10983978@N03,166,11,1235036716,1235037676,1,2,960
10983978@N03,167,4,1239278162,1239278522,1,1,360
10983978@N03,168,8,1240102856,1240103696,1,1,840
10983978@N03,169,6,1246709530,1246710250,2,1,720
10983978@N03,170,6,1246770145,1246770865,2,1,720
10983978@N03,171,6,1250556285,1250556806,4,6,521
10983978@N03,171,10,1250556806,1250556932,2,6,126
10983978@N03,171,6,1250556932,1250557652,5,6,720
10983978@N03,171,5,1250582560,1250582627,2,6,67
10983978@N03,171,8,1250582627,1250583240,2,6,613
10983978@N03,171,11,1250583240,1250584200,2,6,960
10983978@N03,172,4,1252413201,1252413561,1,1,360
10983978@N03,173,11,1260930699,1260931659,1,1,960
10983978@N03,174,10,1261802440,1261803340,1,1,900
10983978@N03,175,8,1286630095,1286630356,2,3,261
10983978@N03,175,15,1286630356,1286630729,2,3,373
10983978@N03,175,8,1286630729,1286631569,1,3,840
10983978@N03,176,16,1291504643,1291506743,1,1,2100
10983978@N03,177,4,1313157600,1313157600,3,4,0
10983978@N03,177,11,1313157600,1313157600,2,4,0
10983978@N03,177,15,1313157600,1313157600,4,4,0
10983978@N03,177,17,1313157600,1313160300,3,4,2700
10983978@N03,178,17,1313326360,1313329060,1,1,2700
10983978@N03,179,1,1333790417,1333790657,2,4,240
10983978@N03,179,6,1333792424,1333793144,2,4,720
10983978@N03,179,8,1333794076,1333794916,2,4,840
10983978@N03,179,1,1333796409,1333796649,6,4,240
10983978@N03,180,6,1333878989,1333879709,2,2,720
10983978@N03,180,1,1333879860,1333880100,1,2,240
10983978@N03,181,6,1334325600,1334326320,14,1,720
10983978@N03,182,6,1334495010,1334495730,1,1,720
10989907@N07,183,15,1386021256,1386022456,2,10,1200
10989907@N07,183,11,1386028568,1386028747,3,10,179
10989907@N07,183,16,1386028747,1386030847,2,10,2100
10989907@N07,183,11,1386031947,1386032907,2,10,960
10989907@N07,183,3,1386045966,1386046296,4,10,330
10989907@N07,183,2,1386049216,1386049456,5,10,240
10989907@N07,183,3,1386053032,1386053113,2,10,81
10989907@N07,183,4,1386053113,1386053288,3,10,175
10989907@N07,183,9,1386053288,1386053438,2,10,150
10989907@N07,183,13,1386053438,1386054518,3,10,1080
10989907@N07,184,13,1386139143,1386140223,12,2,1080
10989907@N07,184,17,1386157420,1386160120,1,2,2700
10989907@N07,185,17,1386196217,1386198917,3,2,2700
10989907@N07,185,11,1386199117,1386200077,2,2,960
10989907@N07,186,15,1386289000,1386290200,2,5,1200
10989907@N07,186,8,1386299311,1386300151,2,5,840
10989907@N07,186,17,1386310585,1386312501,3,5,1916
10989907@N07,186,13,1386312501,1386312596,2,5,95
10989907@N07,186,15,1386312596,1386313796,2,5,1200
109920749@N03,187,1,1334729699,1334729939,1,1,240
11011638@N02,188,11,1400900100,1400901060,4,1,960
110166673@N02,189,11,1385421072,1385422032,7,5,960
110166673@N02,189,2,1385430436,1385430676,31,5,240
110166673@N02,189,9,1385438980,1385439880,4,5,900
110166673@N02,189,15,1385447347,1385448547,10,5,1200
110166673@N02,189,5,1385451439,1385451859,12,5,420
110166673@N02,190,1,1385610860,1385611100,10,1,240
11017709@N07,191,11,1318648391,1318649351,1,1,960
110223705@N07,192,11,1463699667,1463700297,3,5,630
110223705@N07,192,1,1463700297,1463700537,4,5,240
110223705@N07,192,4,1463713456,1463713816,2,5,360
110223705@N07,192,8,1463732310,1463733150,5,5,840
110223705@N07,192,11,1463743121,1463744081,1,5,960
11041171@N06,193,11,1302389629,1302390589,2,3,960
11041171@N06,193,2,1302393689,1302393929,2,3,240
11041171@N06,193,8,1302405002,1302405842,1,3,840
11041171@N06,194,14,1321136966,1321138166,1,1,1200
11054536@N00,195,1,1209079942,1209080140,2,4,198
11054536@N00,195,16,1209080140,1209082240,2,4,2100
11054536@N00,195,11,1209085196,1209086156,4,4,960
11054536@N00,195,10,1209094374,1209095274,2,4,900
110806683@N02,196,11,1387941133,1387942093,1,1,960
11102586@N00,197,14,1283641401,1283641552,2,6,151
11102586@N00,197,2,1283641552,1283641792,4,6,240
11102586@N00,197,1,1283642934,1283643174,3,6,240
11102586@N00,197,9,1283644454,1283645354,7,6,900
11102586@N00,197,11,1283646941,1283647901,4,6,960
11102586@N00,197,5,1283649700,1283650120,9,6,420
111107017@N08,198,11,1384125216,1384126128,2,2,912
111107017@N08,198,4,1384126128,1384126488,1,2,360
111107017@N08,199,16,1386407394,1386409494,1,1,2100
11136034@N06,200,11,1242741773,1242742733,58,1,960
11136034@N06,201,11,1243048893,1243049853,51,1,960
11145342@N04,202,8,1212898219,1212899059,4,1,840
11145342@N04,203,8,1272021567,1272022407,1,1,840
11149127@N05,204,1,1300223858,1300224098,2,2,240
11149127@N05,204,17,1300234816,1300237516,1,2,2700
11154831@N06,205,13,1193885232,1193886312,2,2,1080
11154831@N06,205,11,1193899491,1193900451,1,2,960
11158788@N00,206,5,1210386284,1210386704,1,1,420
11158788@N00,207,13,1225533201,1225534281,1,1,1080
111603867@N06,208,11,1390533708,1390534668,2,2,960
111603867@N06,208,9,1390537932,1390538832,5,2,900
11171054@N04,209,7,1440154599,1440154604,3,2,5
11171054@N04,209,11,1440154604,1440155564,1,2,960
11191102@N07,210,11,1379498437,1379499397,3,1,960
111991502@N02,211,16,1385991329,1385993429,1,1,2100
11199582@N03,212,8,1329182238,1329183078,3,3,840
11199582@N03,212,4,1329191216,1329191576,2,3,360
11199582@N03,212,13,1329207171,1329208251,1,3,1080
112023512@N04,213,11,1382438036,1382438996,1,1,960
112045904@N02,214,4,1388743711,1388744071,2,2,360
112045904@N02,214,11,1388750955,1388751915,1,2,960
112162011@N02,215,11,1387606442,1387607402,2,1,960
112283958@N06,216,1,1377924609,1377924849,27,1,240
11230735@N07,217,15,1194175845,1194176054,2,2,209
11230735@N07,217,10,1194176054,1194176954,1,2,900
11230735@N07,218,16,1219469124,1219471224,1,1,2100
11240815@N03,219,11,1366975384,1366976344,1,1,960
11260538@N06,220,6,1348791029,1348791592,2,3,563
11260538@N06,220,10,1348791592,1348792492,2,3,900
11260538@N06,220,6,1348794708,1348795428,2,3,720
11260538@N06,221,9,1348876338,1348877238,1,1,900
11260538@N06,222,6,1352613389,1352614109,1,1,720
11260538@N06,223,11,1355650271,1355651231,1,1,960
112709393@N04,224,8,1365203035,1365203875,1,1,840
112734542@N02,225,11,1396762877,1396763837,3,2,960
112734542@N02,225,17,1396777941,1396780641,2,2,2700
11279883@N00,226,5,1233973339,1233973759,4,1,420
11279883@N00,227,3,1390781187,1390781517,1,1,330
11284904@N02,228,17,1348312003,1348314703,1,1,2700
11292395@N05,229,11,1218910539,1218911499,1,1,960
112941383@N05,230,11,1436521835,1436522795,1,1,960
112985786@N07,231,5,1353802868,1353803288,1,1,420
113040137@N08,232,11,1461499539,1461500499,1,1,960
113086034@N04,233,10,1394427325,1394428225,1,1,900
113086034@N04,234,10,1458265704,1458266604,1,1,900
113086034@N04,235,5,1458822511,1458822931,2,2,420
113086034@N04,235,10,1458824420,1458825320,1,2,900
11342926@N04,236,15,1318665902,1318667102,1,1,1200
11355999@N08,237,11,1374443421,1374444381,2,3,960
11355999@N08,237,13,1374454935,1374456015,2,3,1080
11355999@N08,237,8,1374467709,1374468549,1,3,840
11355999@N08,238,11,1374569398,1374570358,3,2,960
11355999@N08,238,2,1374575544,1374575784,1,2,240
11355999@N08,239,11,1374825576,1374826536,1,1,960
11374644@N06,240,13,1368589826,1368590906,1,1,1080
11374644@N06,241,8,1412841323,1412842163,2,2,840
11374644@N06,241,17,1412848057,1412850757,13,2,2700
113875683@N02,242,4,1378083991,1378084351,1,1,360
11429691@N03,243,9,1299925810,1299925819,2,2,9
11429691@N03,243,15,1299925819,1299927019,1,2,1200
114343416@N06,244,11,1378019214,1378020174,1,1,960
11438118@N00,245,11,1188457863,1188458823,2,2,960
11438118@N00,245,13,1188464235,1188465315,6,2,1080
11438118@N00,246,9,1189066184,1189067084,8,1,900
11438118@N00,247,1,1189730376,1189730616,19,6,240
11438118@N00,247,11,1189735157,1189736117,2,6,960
11438118@N00,247,4,1189746788,1189747148,2,6,360
11438118@N00,247,16,1189750665,1189752765,6,6,2100
11438118@N00,247,1,1189754734,1189754960,3,6,226
11438118@N00,247,6,1189754960,1189755680,1,6,720
11438118@N00,248,11,1190871240,1190872200,8,1,960
11438118@N00,249,13,1191220322,1191221402,1,1,1080
11438118@N00,250,9,1191730367,1191731267,5,3,900
11438118@N00,250,16,1191732260,1191734360,4,3,2100
11438118@N00,250,13,1191740859,1191741939,3,3,1080
11438118@N00,251,11,1193385174,1193386134,2,1,960
11438118@N00,252,13,1196390743,1196391823,2,4,1080
11438118@N00,252,1,1196395141,1196395381,2,4,240
11438118@N00,252,5,1196397797,1196398217,5,4,420
11438118@N00,252,13,1196399994,1196401074,1,4,1080
11438118@N00,253,11,1197587860,1197588820,5,1,960
11438118@N00,254,11,1197969440,1197970400,2,1,960
11438118@N00,255,11,1207887521,1207888481,1,1,960
11438118@N00,256,11,1222324272,1222325232,8,9,960
11438118@N00,256,15,1222326033,1222326387,6,9,354
11438118@N00,256,13,1222326387,1222327467,3,9,1080
11438118@N00,256,11,1222328343,1222329303,2,9,960
11438118@N00,256,8,1222333894,1222333925,3,9,31
11438118@N00,256,11,1222333925,1222334710,2,9,785
11438118@N00,256,8,1222334710,1222335550,51,9,840
11438118@N00,256,5,1222338096,1222338516,4,9,420
11438118@N00,256,11,1222338888,1222339848,5,9,960
11438118@N00,257,16,1222928003,1222930103,2,10,2100
11438118@N00,257,5,1222930332,1222930715,2,10,383
11438118@N00,257,11,1222930715,1222931675,7,10,960
11438118@N00,257,13,1222934521,1222935601,3,10,1080
11438118@N00,257,11,1222935876,1222936286,4,10,410
11438118@N00,257,17,1222936286,1222936436,2,10,150
11438118@N00,257,10,1222936436,1222937336,2,10,900
11438118@N00,257,11,1222937338,1222938298,3,10,960
11438118@N00,257,5,1222938434,1222938849,2,10,415
11438118@N00,257,11,1222938849,1222939809,3,10,960
11438118@N00,258,13,1223797324,1223798404,1,1,1080
11438118@N00,259,5,1223961393,1223961813,3,2,420
11438118@N00,259,13,1223967583,1223968663,1,2,1080
11438118@N00,260,13,1224917737,1224918072,2,3,335
11438118@N00,260,10,1224918072,1224918271,4,3,199
11438118@N00,260,6,1224918271,1224918991,2,3,720
11438118@N00,261,6,1224987253,1224987973,1,1,720
11438118@N00,262,11,1244728827,1244729787,1,1,960
11438118@N00,263,12,1250291407,1250291839,2,5,432
11438118@N00,263,11,1250291839,1250292799,2,5,960
11438118@N00,263,3,1250296400,1250296730,2,5,330
11438118@N00,263,2,1250299825,1250300065,2,5,240
11438118@N00,263,11,1250305895,1250306855,7,5,960
11438118@N00,264,11,1254117877,1254118837,3,3,960
11438118@N00,264,6,1254120368,1254121088,17,3,720
11438118@N00,264,11,1254125346,1254126306,2,3,960
11438118@N00,265,17,1255423918,1255426618,11,1,2700
11439401@N07,266,8,1232463560,1232464400,1,1,840
11441631@N00,267,11,1348604510,1348605470,2,4,960
11441631@N00,267,2,1348619290,1348619530,2,4,240
11441631@N00,267,17,1348630079,1348632779,2,4,2700
11441631@N00,267,13,1348633061,1348634141,2,4,1080
11441631@N00,268,10,1348819815,1348820715,3,3,900
11441631@N00,268,6,1348823738,1348824242,2,3,504
11441631@N00,268,11,1348824242,1348825202,1,3,960
114434902@N04,269,3,1401074437,1401074767,2,1,330
114677615@N06,270,11,1350018679,1350019639,1,1,960
11479795@N00,271,1,1191213440,1191213680,2,2,240
11479795@N00,271,9,1191218365,1191219265,1,2,900
11479795@N00,272,5,1191297600,1191298020,2,2,420
11479795@N00,272,17,1191305083,1191307783,1,2,2700
11493860@N02,273,8,1317864491,1317865331,5,2,840
11493860@N02,273,11,1317886596,1317887556,1,2,960
11504889@N06,274,15,1446257491,1446258691,3,4,1200
11504889@N06,274,13,1446259625,1446260705,10,4,1080
11504889@N06,274,8,1446274374,1446275214,24,4,840
11504889@N06,274,11,1446286100,1446287060,1,4,960
115400338@N03,275,8,1401100625,1401101465,5,6,840
115400338@N03,275,13,1401103935,1401104064,2,6,129
115400338@N03,275,15,1401104064,1401104535,3,6,471
115400338@N03,275,17,1401104535,1401104631,2,6,96
115400338@N03,275,10,1401104631,1401105103,2,6,472
115400338@N03,275,11,1401105103,1401106063,2,6,960
11541209@N06,276,5,1193908419,1193908839,1,1,420
11541209@N06,277,11,1250028259,1250029219,2,5,960
11541209@N06,277,10,1250032402,1250033302,2,5,900
11541209@N06,277,17,1250035079,1250035753,2,5,674
11541209@N06,277,13,1250035753,1250036833,4,5,1080
11541209@N06,277,5,1250050681,1250051101,1,5,420
11541209@N06,278,8,1250233387,1250234227,3,2,840
11541209@N06,278,6,1250237680,1250238400,3,2,720
11581147@N06,279,11,1432776587,1432777547,4,2,960
11581147@N06,279,9,1432788517,1432789417,1,2,900
116066345@N06,280,11,1401747449,1401748409,1,1,960
116112674@N02,281,16,1461594448,1461596548,3,6,2100
116112674@N02,281,9,1461597118,1461598018,2,6,900
116112674@N02,281,10,1461614030,1461614930,3,6,900
116112674@N02,281,8,1461620091,1461620931,14,6,840
116112674@N02,281,6,1461623246,1461623341,2,6,95
116112674@N02,281,13,1461623341,1461624421,3,6,1080
11654579@N07,282,11,1361484929,1361485889,2,4,960
11654579@N07,282,9,1361487067,1361487967,3,4,900
11654579@N07,282,17,1361494432,1361496612,2,4,2180
11654579@N07,282,13,1361496612,1361497692,1,4,1080
11654579@N07,283,11,1393658937,1393659897,1,1,960
116801007@N03,284,10,1392518158,1392519058,2,1,900
11724486@N02,285,11,1384833698,1384834658,2,3,960
11724486@N02,285,1,1384835738,1384835978,4,3,240
11724486@N02,285,17,1384850908,1384853608,2,3,2700
117386007@N08,286,1,1323937433,1323937673,1,1,240
117386007@N08,287,11,1368682461,1368683421,3,2,960
117386007@N08,287,5,1368700334,1368700754,1,2,420
11752574@N06,288,4,1194754212,1194754572,1,1,360
11752574@N06,289,11,1259625022,1259625982,2,1,960
11752574@N06,290,11,1348122530,1348123490,1,1,960
11771947@N03,291,11,1205888400,1205889360,43,1,960
11774512@N05,292,5,1298236218,1298236638,9,4,420
11774512@N05,292,8,1298237484,1298238324,26,4,840
11774512@N05,292,13,1298255589,1298256669,3,4,1080
11774512@N05,292,10,1298261004,1298261904,3,4,900
11785705@N02,293,14,1291610999,1291612199,2,3,1200
11785705@N02,293,2,1291614339,1291614579,2,3,240
11785705@N02,293,8,1291626786,1291627626,1,3,840
117898742@N02,294,11,1394412616,1394413576,2,1,960
118160923@N04,295,11,1392159830,1392160790,6,2,960
118160923@N04,295,5,1392180475,1392180895,1,2,420
11825945@N00,296,5,1378433451,1378433871,1,1,420
11825945@N00,297,11,1385846907,1385847867,8,1,960
11825945@N00,298,5,1389650945,1389651365,1,1,420
11825945@N00,299,10,1389981011,1389981911,1,1,900
11825945@N00,300,13,1390168476,1390169556,1,1,1080
11831873@N00,301,7,1286097347,1286098187,16,1,840
11874382@N02,302,2,1275546041,1275546281,2,2,240
11874382@N02,302,11,1275560722,1275561682,1,2,960
11928454@N04,303,2,1244270031,1244270271,3,11,240
11928454@N04,303,12,1244270912,1244271932,6,11,1020
11928454@N04,303,2,1244273866,1244274106,2,11,240
11928454@N04,303,14,1244274208,1244274987,5,11,779
11928454@N04,303,3,1244274987,1244275317,5,11,330
11928454@N04,303,4,1244275640,1244276000,4,11,360
11928454@N04,303,10,1244277614,1244278514,13,11,900
11928454@N04,303,17,1244280371,1244280723,3,11,352
11928454@N04,303,15,1244280723,1244281775,12,11,1052
11928454@N04,303,13,1244281775,1244282855,9,11,1080
11928454@N04,303,11,1244287922,1244288882,1,11,960
11928454@N04,304,9,1244505650,1244506550,4,5,900
11928454@N04,304,1,1244508160,1244508400,2,5,240
11928454@N04,304,16,1244510752,1244512852,2,5,2100
11928454@N04,304,5,1244515165,1244515585,14,5,420
11928454@N04,304,8,1244521189,1244522029,14,5,840
11928454@N04,305,11,1244767488,1244768448,2,4,960
11928454@N04,305,10,1244769350,1244769779,4,4,429
11928454@N04,305,15,1244769779,1244770979,3,4,1200
11928454@N04,305,13,1244771031,1244772111,4,4,1080
11935368@N00,306,8,1292134002,1292134842,2,3,840
11935368@N00,306,5,1292141955,1292142375,2,3,420
11935368@N00,306,6,1292147150,1292147870,1,3,720
11935368@N00,307,3,1292447266,1292447596,2,6,330
11935368@N00,307,9,1292451674,1292452574,3,6,900
11935368@N00,307,2,1292456487,1292456727,2,6,240
11935368@N00,307,11,1292457958,1292458918,2,6,960
11935368@N00,307,16,1292462165,1292464265,2,6,2100
11935368@N00,307,8,1292473180,1292474020,2,6,840
11935368@N00,308,13,1292833812,1292833850,2,3,38
11935368@N00,308,10,1292833850,1292833859,2,3,9
11935368@N00,308,17,1292833859,1292836559,1,3,2700
119422749@N03,309,11,1395116159,1395117119,7,2,960
119422749@N03,309,2,1395134394,1395134634,2,2,240
119422749@N03,310,4,1395209320,1395209680,1,1,360
119435566@N06,311,11,1457238907,1457239867,1,1,960
119796978@N03,312,8,1393301126,1393301966,2,1,840
119796978@N03,313,10,1393455158,1393456058,2,1,900
119796978@N03,314,13,1393641742,1393642822,1,1,1080
119908732@N04,315,11,1408337388,1408338348,1,1,960
119955613@N07,316,11,1444641033,1444641993,1,1,960
12004667@N02,317,10,1294278711,1294279611,2,3,900
12004667@N02,317,15,1294282507,1294282850,2,3,343
12004667@N02,317,13,1294282850,1294283930,1,3,1080
120115443@N02,318,2,1371709051,1371709291,2,2,240
120115443@N02,318,11,1371710060,1371711020,1,2,960
120147674@N05,319,1,1395466806,1395467046,2,1,240
120147674@N05,320,11,1396037268,1396038228,2,1,960
120210303@N04,321,11,1394624358,1394625318,1,1,960
12036424@N04,322,1,1305590233,1305590473,5,4,240
12036424@N04,322,5,1305602682,1305603102,2,4,420
12036424@N04,322,6,1305612962,1305613682,3,4,720
12036424@N04,322,12,1305619086,1305620106,1,4,1020
12044368@N04,323,10,1395268643,1395269543,1,1,900
120533378@N03,324,2,1443053158,1443053398,2,3,240
120533378@N03,324,1,1443057432,1443057672,2,3,240
120533378@N03,324,5,1443073283,1443073703,2,3,420
120533378@N03,325,1,1443397450,1443397690,5,2,240
120533378@N03,325,10,1443406433,1443407333,5,2,900
12059076@N05,326,11,1188908971,1188909931,1,1,960
12071396@N00,327,11,1368949846,1368950806,1,1,960
120756153@N05,328,5,1307765690,1307766110,1,1,420
12083014@N05,329,17,1222213706,1222214162,2,7,456
12083014@N05,329,4,1222214162,1222214522,2,7,360
12083014@N05,329,2,1222216482,1222216722,2,7,240
12083014@N05,329,17,1222218751,1222221451,2,7,2700
12083014@N05,329,9,1222228539,1222229439,2,7,900
12083014@N05,329,3,1222240899,1222241229,2,7,330
12083014@N05,329,5,1222255025,1222255445,1,7,420
12083014@N05,330,11,1253495576,1253496465,2,2,889
12083014@N05,330,10,1253496465,1253497365,3,2,900
12088605@N08,331,1,1301131001,1301131241,1,1,240
12088724@N02,332,5,1211164931,1211165351,2,4,420
12088724@N02,332,16,1211166599,1211168699,2,4,2100
12088724@N02,332,1,1211180749,1211180989,2,4,240
12088724@N02,332,11,1211182536,1211183496,1,4,960
12130680@N05,333,2,1407043296,1407043536,13,7,240
12130680@N05,333,11,1407045168,1407046128,2,7,960
12130680@N05,333,8,1407047318,1407048158,8,7,840
12130680@N05,333,13,1407052487,1407052997,5,7,510
12130680@N05,333,17,1407052997,1407053509,4,7,512
12130680@N05,333,5,1407053509,1407053929,11,7,420
12130680@N05,333,11,1407056354,1407057314,1,7,960
121354827@N08,334,2,1370586433,1370586673,3,1,240
12149318@N07,335,11,1229910762,1229911722,1,1,960
121499845@N05,336,11,1404268132,1404269092,2,5,960
121499845@N05,336,8,1404276677,1404277517,2,5,840
121499845@N05,336,10,1404286442,1404287342,2,5,900
121499845@N05,336,13,1404288567,1404289647,2,5,1080
121499845@N05,336,5,1404297641,1404298061,1,5,420
121499845@N05,337,13,1427877381,1427878461,3,3,1080
121499845@N05,337,8,1427880746,1427881110,2,3,364
121499845@N05,337,5,1427881110,1427881530,1,3,420
121655138@N03,338,11,1395644077,1395645037,2,2,960
121655138@N03,338,3,1395647317,1395647647,1,2,330
121861619@N03,339,11,1423518520,1423519480,4,16,960
121861619@N03,339,2,1423523911,1423524151,4,16,240
121861619@N03,339,5,1423527800,1423528209,2,16,409
121861619@N03,339,8,1423528209,1423529049,4,16,840
121861619@N03,339,13,1423529903,1423530983,5,16,1080
121861619@N03,339,15,1423531166,1423531264,5,16,98
121861619@N03,339,17,1423531264,1423533319,10,16,2055
121861619@N03,339,6,1423533319,1423534039,2,16,720
121861619@N03,339,15,1423536718,1423537208,3,16,490
121861619@N03,339,10,1423537208,1423538108,11,16,900
121861619@N03,339,17,1423546833,1423547254,6,16,421
121861619@N03,339,10,1423547254,1423547733,2,16,479
121861619@N03,339,17,1423547733,1423547859,2,16,126
121861619@N03,339,10,1423547859,1423548479,2,16,620
121861619@N03,339,13,1423548479,1423549559,5,16,1080
121861619@N03,339,5,1423549847,1423550267,11,16,420
12186997@N00,340,11,1356729006,1356729966,1,1,960
12197785@N03,341,8,1246159064,1246159904,1,1,840
12197785@N03,342,5,1246499983,1246500403,1,1,420
12197785@N03,343,7,1259627599,1259628439,2,4,840
12197785@N03,343,2,1259628506,1259628746,2,4,240
12197785@N03,343,11,1259635232,1259636192,2,4,960
12197785@N03,343,6,1259655582,1259656302,1,4,720
12197785@N03,344,16,1288074338,1288076438,2,2,2100
12197785@N03,344,11,1288086123,1288087083,2,2,960
12199307@N08,345,11,1241830297,1241831257,5,7,960
12199307@N08,345,2,1241839531,1241839606,2,7,75
12199307@N08,345,10,1241839606,1241840506,4,7,900
12199307@N08,345,15,1241843148,1241843329,2,7,181
12199307@N08,345,13,1241843329,1241844409,4,7,1080
12199307@N08,345,5,1241854845,1241855265,5,7,420
12199307@N08,345,11,1241868024,1241868984,3,7,960
12205233@N02,346,11,1227426500,1227427460,1,1,960
12238277@N04,347,11,1311636036,1311636996,2,3,960
12238277@N04,347,3,1311641179,1311641509,22,3,330
12238277@N04,347,5,1311649345,1311649765,1,3,420
12247055@N00,348,11,1461284945,1461285905,1,1,960
122575123@N04,349,11,1393727009,1393727969,1,1,960
12261016@N00,350,3,1329951049,1329951379,1,1,330
12261016@N00,351,11,1329989463,1329990423,2,1,960
12277777@N04,352,11,1311309027,1311309987,4,3,960
12277777@N04,352,17,1311312341,1311315041,6,3,2700
12277777@N04,352,11,1311330832,1311331792,1,3,960
122876725@N05,353,11,1406153497,1406153820,5,10,323
122876725@N05,353,1,1406153820,1406154060,6,10,240
122876725@N05,353,9,1406157714,1406158614,16,10,900
122876725@N05,353,7,1406160365,1406160416,4,10,51
122876725@N05,353,3,1406160416,1406160449,2,10,33
122876725@N05,353,7,1406160449,1406161289,4,10,840
122876725@N05,353,8,1406166821,1406167661,4,10,840
122876725@N05,353,5,1406168577,1406168997,3,10,420
122876725@N05,353,8,1406170638,1406171478,8,10,840
122876725@N05,353,11,1406190950,1406191910,5,10,960
122876725@N05,354,7,1406848743,1406849583,3,14,840
122876725@N05,354,13,1406871990,1406873070,2,14,1080
122876725@N05,354,15,1406875734,1406875917,6,14,183
122876725@N05,354,17,1406875917,1406875924,3,14,7
122876725@N05,354,10,1406875924,1406876824,2,14,900
122876725@N05,354,15,1406877867,1406877883,3,14,16
122876725@N05,354,17,1406877883,1406880583,5,14,2700
122876725@N05,354,15,1406881403,1406881978,4,14,575
122876725@N05,354,17,1406881978,1406882135,12,14,157
122876725@N05,354,10,1406882135,1406882164,3,14,29
122876725@N05,354,17,1406882164,1406882266,2,14,102
122876725@N05,354,10,1406882266,1406883166,6,14,900
122876725@N05,354,5,1406886855,1406887275,33,14,420
122876725@N05,354,11,1406888434,1406889394,6,14,960
122876725@N05,355,11,1407540952,1407541153,2,6,201
122876725@N05,355,7,1407541153,1407541993,7,6,840
122876725@N05,355,9,1407546844,1407547744,3,6,900
122876725@N05,355,16,1407548989,1407551089,4,6,2100
122876725@N05,355,8,1407552897,1407553737,2,6,840
122876725@N05,355,4,1407560661,1407561021,11,6,360
123157079@N03,356,10,1397193527,1397194427,1,1,900
12381123@N06,357,11,1324250645,1324251605,5,3,960
12381123@N06,357,9,1324252329,1324253229,7,3,900
12381123@N06,357,11,1324254191,1324255151,5,3,960
124313309@N04,358,11,1402536132,1402537092,3,1,960
124370052@N08,359,17,1396846199,1396848899,1,1,2700
12440183@N04,360,2,1346122358,1346122598,6,1,240
124439338@N05,361,16,1426899930,1426902030,1,1,2100
12445726@N06,362,16,1335577524,1335579624,1,1,2100
12445963@N00,363,11,1412650173,1412651133,2,5,960
12445963@N00,363,7,1412652903,1412653743,2,5,840
12445963@N00,363,12,1412659456,1412660377,2,5,921
12445963@N00,363,4,1412660377,1412660737,2,5,360
12445963@N00,363,8,1412662626,1412663466,3,5,840
12456985@N00,364,11,1396839103,1396840063,1,1,960
124601595@N06,365,11,1398502222,1398503182,2,3,960
124601595@N06,365,15,1398506326,1398507526,7,3,1200
124601595@N06,365,11,1398513203,1398514163,1,3,960
124601595@N06,366,15,1398644781,1398645981,22,1,1200
124897697@N02,367,11,1427581162,1427582122,2,8,960
124897697@N02,367,9,1427584043,1427584943,2,8,900
124897697@N02,367,5,1427590805,1427591225,7,8,420
124897697@N02,367,8,1427595066,1427595906,4,8,840
124897697@N02,367,13,1427603314,1427603983,4,8,669
124897697@N02,367,15,1427603983,1427605052,3,8,1069
124897697@N02,367,10,1427605052,1427605952,2,8,900
124897697@N02,367,11,1427608108,1427609068,1,8,960
124948917@N04,368,8,1433477787,1433478627,3,3,840
124948917@N04,368,1,1433495287,1433495527,2,3,240
124948917@N04,368,11,1433504213,1433505173,1,3,960
12508217@N08,369,10,1189308889,1189309789,5,2,900
12508217@N08,369,15,1189315053,1189316253,1,2,1200
12508217@N08,370,11,1193554576,1193555536,1,1,960
12508217@N08,371,9,1193825845,1193826745,2,1,900
12508217@N08,372,13,1194151473,1194152553,1,1,1080
12508217@N08,373,11,1198905368,1198906328,1,1,960
12508217@N08,374,13,1221618474,1221619554,4,2,1080
12508217@N08,374,15,1221626921,1221628121,3,2,1200
12508217@N08,375,15,1222951559,1222952169,4,3,610
12508217@N08,375,17,1222952169,1222952381,2,3,212
12508217@N08,375,13,1222952381,1222953461,1,3,1080
12508217@N08,376,11,1264227687,1264228647,2,1,960
12508217@N08,377,11,1318717969,1318718929,37,6,960
12508217@N08,377,9,1318722198,1318723098,14,6,900
12508217@N08,377,16,1318726128,1318727716,3,6,1588
12508217@N08,377,7,1318727716,1318727857,2,6,141
12508217@N08,377,3,1318727857,1318728187,5,6,330
12508217@N08,377,5,1318734116,1318734536,8,6,420
12508217@N08,378,11,1332476529,1332477489,3,4,960
12508217@N08,378,9,1332478252,1332479152,3,4,900
12508217@N08,378,16,1332479468,1332481568,7,4,2100
12508217@N08,378,4,1332485976,1332486336,1,4,360
12508217@N08,379,17,1335678340,1335678706,4,6,366
12508217@N08,379,10,1335678706,1335679606,7,6,900
12508217@N08,379,5,1335680779,1335681199,6,6,420
12508217@N08,379,8,1335685401,1335686241,10,6,840
12508217@N08,379,13,1335695965,1335696623,4,6,658
12508217@N08,379,17,1335696623,1335699323,6,6,2700
12508217@N08,380,5,1348786785,1348787205,2,1,420
12508217@N08,381,1,1349607007,1349607247,16,1,240
12508217@N08,382,6,1349991661,1349992381,35,1,720
12508217@N08,383,11,1357952296,1357953256,1,1,960
12508217@N08,384,8,1367747831,1367748671,28,2,840
12508217@N08,384,11,1367753952,1367754912,1,2,960
12508217@N08,385,11,1384006649,1384007609,11,1,960
12508217@N08,386,11,1384060114,1384061074,3,3,960
12508217@N08,386,13,1384062806,1384063886,9,3,1080
12508217@N08,386,6,1384065069,1384065789,43,3,720
12577376@N04,387,15,1352696177,1352697377,1,1,1200
125837856@N05,388,8,1404261751,1404262591,30,2,840
125837856@N05,388,1,1404267400,1404267640,20,2,240
12586305@N04,389,11,1266720039,1266720999,2,4,960
12586305@N04,389,8,1266723367,1266724207,4,4,840
12586305@N04,389,13,1266726620,1266727700,2,4,1080
12586305@N04,389,17,1266728615,1266731315,1,4,2700
125863683@N08,390,11,1417778638,1417779598,1,1,960
125863683@N08,391,11,1417921213,1417922173,1,1,960
12592520@N03,392,11,1230683722,1230684682,2,4,960
12592520@N03,392,9,1230697193,1230698093,3,4,900
12592520@N03,392,11,1230699041,1230700001,2,4,960
12592520@N03,392,17,1230703111,1230705811,1,4,2700
12650001@N08,393,11,1388536511,1388537471,1,1,960
126527286@N03,394,9,1288576819,1288577203,3,3,384
126527286@N03,394,16,1288577203,1288579303,2,3,2100
126527286@N03,394,10,1288596462,1288597362,2,3,900
12658090@N00,395,11,1358334589,1358335549,1,1,960
12658090@N00,396,11,1358414290,1358415250,3,1,960
12658090@N00,397,5,1358526033,1358526453,2,2,420
12658090@N00,397,11,1358527058,1358528018,1,2,960
12658090@N00,398,5,1358571156,1358571576,1,1,420
12658090@N00,399,5,1400856234,1400856654,1,1,420
12659736@N02,400,1,1210049742,1210049841,2,4,99
12659736@N02,400,9,1210049841,1210050741,6,4,900
12659736@N02,400,8,1210063625,1210064465,19,4,840
12659736@N02,400,11,1210068466,1210069426,3,4,960
126647792@N06,401,11,1453243262,1453244222,1,1,960
126776752@N03,402,3,1422077559,1422077889,1,1,330
126776752@N03,403,3,1437197643,1437197973,1,1,330
127015663@N02,404,11,1415320729,1415321689,2,5,960
127015663@N02,404,1,1415326419,1415326659,3,5,240
127015663@N02,404,8,1415337515,1415338355,2,5,840
127015663@N02,404,13,1415342214,1415343294,2,5,1080
127015663@N02,404,10,1415343645,1415344545,4,5,900
12711998@N00,405,11,1424674939,1424675899,1,1,960
127278883@N08,406,4,1439522383,1439522743,9,4,360
127278883@N08,406,2,1439524498,1439524738,14,4,240
127278883@N08,406,1,1439532377,1439532617,12,4,240
127278883@N08,406,9,1439535369,1439536269,3,4,900
127278883@N08,407,13,1439619184,1439620264,3,4,1080
127278883@N08,407,5,1439625651,1439625681,4,4,30
127278883@N08,407,1,1439625681,1439625852,4,4,171
127278883@N08,407,5,1439625852,1439626272,1,4,420
12738795@N00,408,11,1231586974,1231587934,1,1,960
12738795@N00,409,11,1231673382,1231673387,2,2,5
12738795@N00,409,15,1231673387,1231674587,1,2,1200
12742129@N00,410,11,1300510088,1300511048,1,1,960
12742129@N00,411,11,1300580348,1300581308,1,1,960
127429516@N03,412,11,1426111779,1426112739,2,8,960
127429516@N03,412,17,1426136510,1426137058,3,8,548
127429516@N03,412,13,1426137058,1426137504,2,8,446
127429516@N03,412,6,1426137504,1426138224,3,8,720
127429516@N03,412,13,1426139962,1426140254,2,8,292
127429516@N03,412,6,1426140254,1426140974,4,8,720
127429516@N03,412,8,1426143753,1426144593,3,8,840
127429516@N03,412,11,1426154010,1426154970,1,8,960
127484878@N05,413,8,1442471409,1442472249,1,1,840
127484878@N05,414,8,1467842392,1467843232,1,1,840
127662106@N04,415,17,1413543736,1413546436,2,1,2700
127662106@N04,416,6,1414736037,1414736757,20,1,720
127662106@N04,417,16,1416639005,1416641105,4,2,2100
127662106@N04,417,11,1416644868,1416645828,1,2,960
127662106@N04,418,11,1423385181,1423386141,14,2,960
127662106@N04,418,17,1423390132,1423392832,77,2,2700
127662106@N04,419,11,1425179686,1425180646,8,3,960
127662106@N04,419,2,1425186150,1425186390,14,3,240
127662106@N04,419,4,1425187096,1425187456,2,3,360
127662106@N04,420,10,1426122893,1426123793,2,2,900
127662106@N04,420,11,1426134542,1426135502,1,2,960
127662106@N04,421,11,1457490202,1457491162,4,1,960
127662106@N04,422,3,1464664515,1464664541,2,6,26
127662106@N04,422,7,1464664541,1464664588,3,6,47
127662106@N04,422,3,1464664588,1464664870,5,6,282
127662106@N04,422,7,1464664870,1464664939,4,6,69
127662106@N04,422,4,1464664939,1464665299,2,6,360
127662106@N04,422,3,1464667569,1464667899,3,6,330
127662106@N04,423,7,1466145439,1466146279,2,1,840
127662106@N04,424,10,1467634025,1467634925,24,1,900
127810693@N08,425,11,1259146338,1259147298,2,1,960
12784818@N04,426,11,1465086191,1465087151,5,14,960
12784818@N04,426,9,1465088058,1465088958,5,14,900
12784818@N04,426,1,1465090577,1465090817,6,14,240
12784818@N04,426,4,1465093426,1465093786,2,14,360
12784818@N04,426,10,1465094090,1465094471,3,14,381
12784818@N04,426,17,1465094471,1465097171,4,14,2700
12784818@N04,426,15,1465098416,1465099412,8,14,996
12784818@N04,426,13,1465099412,1465100492,4,14,1080
12784818@N04,426,8,1465103374,1465104115,5,14,741
12784818@N04,426,5,1465104115,1465104535,5,14,420
12784818@N04,426,2,1465114870,1465115110,4,14,240
12784818@N04,426,8,1465122510,1465123350,2,14,840
12784818@N04,426,5,1465125528,1465125948,2,14,420
12784818@N04,426,11,1465126181,1465127141,7,14,960
12786525@N08,427,13,1188608967,1188610047,3,2,1080
12786525@N08,427,5,1188632478,1188632898,1,2,420
12786525@N08,428,15,1211125875,1211127075,1,1,1200
127885330@N05,429,11,1334489085,1334490045,1,1,960
127991665@N08,430,11,1241691976,1241692936,1,1,960
128025409@N08,431,8,1409931270,1409932110,2,1,840
128210777@N08,432,2,1383434961,1383435201,1,1,240
12834171@N06,433,11,1192399636,1192400596,3,1,960
128509080@N04,434,14,1409421573,1409422773,1,1,1200
128509080@N04,435,11,1417352400,1417353360,2,1,960
128509080@N04,436,11,1417626676,1417627636,2,1,960
128509080@N04,437,11,1417670327,1417671287,2,1,960
128526407@N07,438,3,1415734040,1415734125,2,2,85
128526407@N07,438,5,1415734125,1415734545,1,2,420
128526407@N07,439,2,1416246811,1416247051,1,1,240
128526407@N07,440,4,1416509964,1416510324,2,2,360
128526407@N07,440,17,1416510401,1416513101,1,2,2700
128526407@N07,441,3,1416771421,1416771751,1,1,330
128526407@N07,442,11,1417146468,1417147428,1,1,960
128526407@N07,443,8,1417546230,1417547070,1,1,840
128526407@N07,444,2,1417577685,1417577925,1,1,240
128526407@N07,445,8,1417648024,1417648864,1,1,840
128959272@N04,446,11,1421457321,1421458281,2,1,960
129418129@N03,447,5,1385965275,1385965695,1,1,420
129438227@N06,448,13,1414841129,1414842209,1,1,1080
129438227@N06,449,5,1431165225,1431165645,1,1,420
129438227@N06,450,13,1456914828,1456915908,1,1,1080
129451096@N08,451,5,1426209921,1426210341,8,1,420
129451096@N08,452,16,1426670605,1426672705,2,1,2100
129451096@N08,453,16,1426811310,1426813410,1,1,2100
129455250@N03,454,11,1438601921,1438602881,1,1,960
129455250@N03,455,11,1438827535,1438828495,1,1,960
12962494@N00,456,11,1443692617,1443693577,1,1,960
12980856@N06,457,15,1389262365,1389263565,2,1,1200
12982579@N00,458,11,1339740490,1339741252,4,8,762
12982579@N00,458,16,1339741252,1339743352,2,8,2100
12982579@N00,458,5,1339743869,1339744125,3,8,256
12982579@N00,458,8,1339744125,1339744965,7,8,840
12982579@N00,458,15,1339745768,1339745786,2,8,18
12982579@N00,458,17,1339745786,1339748431,6,8,2645
12982579@N00,458,15,1339748431,1339748436,2,8,5
12982579@N00,458,10,1339748436,1339749336,3,8,900
12989776@N03,459,15,1291189966,1291191166,1,1,1200
12989776@N03,460,5,1318385617,1318386037,1,1,420
130069612@N06,461,4,1433135296,1433135656,1,1,360
130069612@N06,462,11,1433588124,1433589084,1,1,960
130069612@N06,463,13,1463283089,1463284169,1,1,1080
130069612@N06,464,11,1463567586,1463568546,1,1,960
130069612@N06,465,13,1463614468,1463615548,2,1,1080
130069612@N06,466,4,1463784662,1463785022,2,3,360
130069612@N06,466,9,1463786907,1463787807,2,3,900
130069612@N06,466,16,1463788716,1463790816,1,3,2100
130127205@N04,467,2,1456276469,1456276709,4,4,240
130127205@N04,467,10,1456279030,1456279383,2,4,353
130127205@N04,467,17,1456279383,1456280923,8,4,1540
130127205@N04,467,13,1456280923,1456282003,4,4,1080
13032456@N05,468,5,1381901706,1381902126,3,2,420
13032456@N05,468,11,1381916275,1381917235,2,2,960
13032456@N05,469,11,1382047742,1382048702,2,4,960
13032456@N05,469,13,1382067677,1382068757,2,4,1080
13032456@N05,469,10,1382070375,1382071275,2,4,900
13032456@N05,469,17,1382072647,1382075347,1,4,2700
130361105@N07,470,5,1406154852,1406155272,2,2,420
130361105@N07,470,17,1406179297,1406181997,1,2,2700
13051628@N00,471,5,1299119055,1299119475,4,1,420
130809171@N06,472,11,1428728148,1428729108,1,1,960
130895783@N02,473,15,1424782800,1424784000,1,1,1200
131018110@N07,474,2,1439601045,1439601285,3,2,240
131018110@N07,474,8,1439611997,1439612837,4,2,840
131150099@N04,475,8,1426224413,1426225253,2,2,840
131150099@N04,475,15,1426229742,1426230942,1,2,1200
13116303@N03,476,8,1331016907,1331017747,1,1,840
131213971@N07,477,3,1440295202,1440295532,1,1,330
13137063@N05,478,11,1370139641,1370140601,5,3,960
13137063@N05,478,10,1370142041,1370142941,3,3,900
13137063@N05,478,13,1370145742,1370146822,4,3,1080
131412080@N05,479,11,1450650601,1450651561,4,25,960
131412080@N05,479,7,1450655801,1450655835,3,25,34
131412080@N05,479,3,1450655835,1450656060,3,25,225
131412080@N05,479,14,1450656060,1450656224,2,25,164
131412080@N05,479,3,1450656224,1450656554,3,25,330
131412080@N05,479,9,1450657343,1450657436,3,25,93
131412080@N05,479,1,1450657436,1450657676,3,25,240
131412080@N05,479,16,1450659121,1450661221,5,25,2100
131412080@N05,479,1,1450667586,1450667826,6,25,240
131412080@N05,479,2,1450671295,1450671535,7,25,240
131412080@N05,479,7,1450671561,1450671602,2,25,41
131412080@N05,479,1,1450671602,1450671842,2,25,240
131412080@N05,479,2,1450672107,1450672347,9,25,240
131412080@N05,479,11,1450673167,1450674127,6,25,960
131412080@N05,479,4,1450684101,1450684461,9,25,360
131412080@N05,479,2,1450685558,1450685798,5,25,240
131412080@N05,479,4,1450686069,1450686112,2,25,43
131412080@N05,479,2,1450686112,1450686352,3,25,240
131412080@N05,479,12,1450686410,1450686456,3,25,46
131412080@N05,479,2,1450686456,1450686696,10,25,240
131412080@N05,479,5,1450688455,1450688694,2,25,239
131412080@N05,479,8,1450688694,1450689534,3,25,840
131412080@N05,479,13,1450693452,1450693668,3,25,216
131412080@N05,479,17,1450693668,1450693875,3,25,207
131412080@N05,479,10,1450693875,1450694775,3,25,900
13156986@N08,480,8,1391952497,1391953337,4,1,840
13156986@N08,481,8,1391988074,1391988914,1,1,840
131849702@N06,482,11,1436055902,1436056480,6,3,578
131849702@N06,482,1,1436056480,1436056720,3,3,240
131849702@N06,482,7,1436063067,1436063907,1,3,840
13191676@N07,483,3,1243778400,1243778400,2,2,0
13191676@N07,483,11,1243778400,1243779360,1,2,960
131918782@N02,484,8,1422504326,1422505166,1,1,840
131918782@N02,485,4,1442201086,1442201446,2,1,360
132097980@N07,486,5,1457663706,1457663980,2,4,274
132097980@N07,486,8,1457663980,1457664820,2,4,840
132097980@N07,486,17,1457668632,1457668733,2,4,101
132097980@N07,486,10,1457668733,1457669633,1,4,900
132132547@N04,487,16,1428111912,1428114012,2,1,2100
132132547@N04,488,8,1428545795,1428546635,2,1,840
13230685@N08,489,5,1359002164,1359002584,2,6,420
13230685@N08,489,8,1359004176,1359004194,2,6,18
13230685@N08,489,5,1359004194,1359004240,4,6,46
13230685@N08,489,8,1359004240,1359005080,5,6,840
13230685@N08,489,13,1359009304,1359010384,20,6,1080
13230685@N08,489,5,1359017193,1359017613,1,6,420
13230685@N08,490,11,1359440777,1359441737,1,1,960
132357461@N07,491,5,1405223685,1405224105,1,1,420
13259518@N00,492,11,1245105962,1245106922,2,3,960
13259518@N00,492,2,1245120708,1245120948,2,3,240
13259518@N00,492,4,1245124358,1245124718,3,3,360
13259518@N00,493,11,1245458709,1245459669,2,4,960
13259518@N00,493,5,1245471681,1245472025,2,4,344
13259518@N00,493,8,1245472025,1245472865,4,4,840
13259518@N00,493,11,1245489214,1245490174,1,4,960
13271166@N06,494,11,1401881347,1401882307,1,1,960
132959156@N02,495,11,1433845944,1433846904,1,1,960
132959156@N02,496,13,1439891317,1439892397,1,1,1080
132959156@N02,497,11,1443780015,1443780975,1,1,960
13310991@N04,498,11,1188803803,1188804763,9,1,960
133471560@N03,499,11,1442226420,1442227380,2,1,960
13353749@N06,500,11,1195797792,1195798752,1,1,960
13355109@N08,501,5,1363826102,1363826522,2,2,420
13355109@N08,501,8,1363834923,1363835763,1,2,840
133557193@N03,502,11,1433983183,1433984143,1,1,960
13359849@N00,503,11,1383605169,1383606129,2,1,960
13359849@N00,504,11,1383861288,1383862248,1,1,960
13359849@N00,505,11,1389480311,1389481271,1,1,960
13359849@N00,506,11,1424552780,1424553740,5,1,960
13444787@N08,507,5,1303278106,1303278526,2,1,420
134814033@N03,508,12,1451953384,1451954404,2,6,1020
134814033@N03,508,11,1451956609,1451957569,2,6,960
134814033@N03,508,3,1451959880,1451960210,4,6,330
134814033@N03,508,15,1451981038,1451982238,2,6,1200
134814033@N03,508,5,1451986712,1451987132,3,6,420
134814033@N03,508,15,1451988470,1451989670,5,6,1200
134944545@N04,509,15,1419747160,1419748360,1,1,1200
135084898@N08,510,2,1424302644,1424302884,12,1,240
13516406@N00,511,9,1367124808,1367125708,2,5,900
13516406@N00,511,2,1367126607,1367126847,2,5,240
13516406@N00,511,12,1367128809,1367129829,2,5,1020
13516406@N00,511,15,1367132410,1367133610,5,5,1200
13516406@N00,511,5,1367138550,1367138970,1,5,420
135322752@N06,512,11,1440348416,1440349376,1,1,960
13533794@N00,513,11,1212773595,1212774555,10,19,960
13533794@N00,513,14,1212774671,1212775867,6,19,1196
13533794@N00,513,3,1212775867,1212776197,11,19,330
13533794@N00,513,11,1212777532,1212778492,9,19,960
13533794@N00,513,10,1212779337,1212779394,4,19,57
13533794@N00,513,17,1212779394,1212779558,6,19,164
13533794@N00,513,15,1212779558,1212779608,2,19,50
13533794@N00,513,13,1212779608,1212780688,5,19,1080
13533794@N00,513,9,1212785982,1212786882,12,19,900
13533794@N00,513,1,1212787889,1212788129,9,19,240
13533794@N00,513,16,1212791580,1212792041,2,19,461
13533794@N00,513,4,1212792041,1212792401,2,19,360
13533794@N00,513,11,1212802688,1212803648,3,19,960
13533794@N00,513,14,1212804570,1212804691,4,19,121
13533794@N00,513,3,1212804691,1212805021,13,19,330
13533794@N00,513,11,1212806435,1212807395,2,19,960
13533794@N00,513,9,1212814834,1212815734,2,19,900
13533794@N00,513,1,1212817995,1212818235,10,19,240
13533794@N00,513,4,1212820996,1212821356,13,19,360
13559836@N03,514,17,1321068009,1321068733,2,3,724
13559836@N03,514,15,1321068733,1321069933,2,3,1200
13559836@N03,514,8,1321090843,1321091683,2,3,840
13559836@N03,515,6,1436609199,1436609919,1,1,720
13604385@N00,516,11,1352498250,1352499210,1,1,960
13604385@N00,517,11,1352543359,1352544319,1,1,960
13613904@N05,518,1,1211435227,1211435467,5,1,240
13636518@N05,519,6,1300208506,1300209226,1,1,720
13644648@N03,520,8,1254021522,1254021534,2,2,12
13644648@N03,520,14,1254021534,1254022734,1,2,1200
13644648@N03,521,8,1254659288,1254659304,2,3,16
13644648@N03,521,9,1254659304,1254659322,2,3,18
13644648@N03,521,11,1254659322,1254660282,1,3,960
13644648@N03,522,4,1287809048,1287809050,3,14,2
13644648@N03,522,2,1287809050,1287809052,2,14,2
13644648@N03,522,10,1287809052,1287809059,5,14,7
13644648@N03,522,8,1287809059,1287809064,3,14,5
13644648@N03,522,13,1287809064,1287809066,2,14,2
13644648@N03,522,8,1287809066,1287809625,3,14,559
13644648@N03,522,5,1287809625,1287809627,2,14,2
13644648@N03,522,15,1287809627,1287809629,2,14,2
13644648@N03,522,2,1287809629,1287809631,3,14,2
13644648@N03,522,1,1287809631,1287809634,3,14,3
13644648@N03,522,10,1287809634,1287809635,2,14,1
13644648@N03,522,2,1287809635,1287809636,2,14,1
13644648@N03,522,5,1287809636,1287809637,2,14,1
13644648@N03,522,11,1287809637,1287810597,1,14,960
13696688@N02,523,1,1322436395,1322436635,1,1,240
13703871@N00,524,11,1320655410,1320656370,1,1,960
13725122@N02,525,11,1368835712,1368836672,2,3,960
13725122@N02,525,13,1368838992,1368840072,2,3,1080
13725122@N02,525,8,1368848318,1368849158,1,3,840
13772877@N00,526,11,1398943669,1398944629,3,1,960
13775066@N00,527,11,1382827840,1382828800,13,1,960
137778335@N08,528,6,1413810000,1413810720,2,1,720
137778335@N08,529,6,1414933200,1414933920,1,1,720
137778335@N08,530,6,1415397956,1415398676,1,1,720
137778335@N08,531,6,1447365970,1447366690,1,1,720
13813159@N00,532,2,1353795123,1353795363,2,5,240
13813159@N00,532,10,1353801572,1353802472,2,5,900
13813159@N00,532,15,1353802926,1353803095,2,5,169
13813159@N00,532,13,1353803095,1353804175,2,5,1080
13813159@N00,532,11,1353820920,1353821880,2,5,960
13818837@N05,533,11,1308719075,1308720035,2,2,960
13818837@N05,533,8,1308721640,1308722480,1,2,840
13818837@N05,534,11,1308797978,1308798938,1,1,960
13844015@N07,535,11,1367051671,1367052631,1,1,960
13844015@N07,536,11,1367200942,1367201902,1,1,960
13880897@N06,537,11,1361003867,1361004827,5,1,960
13885531@N00,538,10,1225852862,1225853762,2,3,900
13885531@N00,538,8,1225859741,1225860581,3,3,840
13885531@N00,538,11,1225861959,1225862919,2,3,960
13901020@N02,539,5,1190405420,1190405472,2,2,52
13901020@N02,539,10,1190405472,1190406372,2,2,900
13901020@N02,540,4,1193641710,1193641985,2,2,275
13901020@N02,540,13,1193641985,1193643065,1,2,1080
139081931@N05,541,13,1408686733,1408687813,2,2,1080
139081931@N05,541,11,1408712683,1408713643,1,2,960
139081931@N05,542,6,1409310532,1409311252,1,1,720
139081931@N05,543,11,1409627514,1409628474,2,1,960
13913844@N00,544,11,1343018965,1343019925,16,1,960
139205459@N03,545,13,1464582676,1464582951,3,2,275
139205459@N03,545,17,1464582951,1464585651,2,2,2700
13929738@N04,546,8,1195190519,1195191359,2,2,840
13929738@N04,546,11,1195198512,1195199472,1,2,960
13929738@N04,547,10,1195344871,1195345771,1,1,900
13933131@N08,548,11,1316838300,1316839260,6,4,960
13933131@N08,548,16,1316839976,1316842076,3,4,2100
13933131@N08,548,13,1316851378,1316852458,15,4,1080
13933131@N08,548,11,1316853397,1316854357,2,4,960
13933131@N08,549,2,1381784265,1381784300,2,3,35
13933131@N08,549,3,1381784300,1381784630,2,3,330
13933131@N08,549,11,1381797183,1381798143,19,3,960
13933131@N08,550,1,1393725743,1393725983,4,2,240
13933131@N08,550,15,1393736655,1393737855,4,2,1200
13959240@N08,551,4,1346114903,1346115263,1,1,360
13959240@N08,552,6,1346147151,1346147871,1,1,720
13959240@N08,553,6,1346321487,1346322207,2,1,720
14013358@N06,554,8,1228547157,1228547997,1,1,840
14013358@N06,555,10,1339809172,1339809538,2,10,366
14013358@N06,555,17,1339809538,1339810345,3,10,807
14013358@N06,555,10,1339810345,1339810754,2,10,409
14013358@N06,555,5,1339810754,1339811080,2,10,326
14013358@N06,555,8,1339811080,1339811920,7,10,840
14013358@N06,555,3,1339814749,1339815079,2,10,330
14013358@N06,555,15,1339817932,1339819132,4,10,1200
14013358@N06,555,10,1339820552,1339821452,2,10,900
14013358@N06,555,5,1339824504,1339824924,2,10,420
14013358@N06,555,11,1339841631,1339842591,3,10,960
14013358@N06,556,11,1351382538,1351383498,11,1,960
14022320@N00,557,15,1314680627,1314681827,1,1,1200
14130502@N07,558,15,1310173467,1310173589,2,2,122
14130502@N07,558,17,1310173589,1310176289,2,2,2700
14135751@N07,559,9,1398393043,1398393070,2,3,27
14135751@N07,559,16,1398393070,1398393870,2,3,800
14135751@N07,559,1,1398393870,1398394110,3,3,240
14169447@N07,560,11,1375246463,1375247423,1,1,960
141774505@N07,561,11,1459300131,1459301091,2,3,960
141774505@N07,561,5,1459305268,1459305688,11,3,420
141774505@N07,561,11,1459307489,1459308449,18,3,960
141774505@N07,562,11,1459394267,1459395227,1,1,960
142375287@N03,563,15,1388380361,1388381561,1,1,1200
14242488@N02,564,15,1193113096,1193114296,1,1,1200
14242929@N02,565,9,1191397463,1191398363,1,1,900
14244677@N08,566,8,1404749666,1404750506,2,3,840
14244677@N08,566,6,1404752593,1404753313,2,3,720
14244677@N08,566,11,1404779524,1404780484,1,3,960
14246866@N05,567,9,1296959589,1296960489,2,4,900
14246866@N05,567,4,1296962078,1296962438,3,4,360
14246866@N05,567,7,1296965257,1296966097,2,4,840
14246866@N05,567,11,1296968113,1296969073,1,4,960
14261584@N00,568,17,1300056229,1300057575,3,3,1346
14261584@N00,568,1,1300057575,1300057815,3,3,240
14261584@N00,568,17,1300063792,1300066492,1,3,2700
14275801@N04,569,11,1193521696,1193522656,1,1,960
14280234@N04,570,13,1317428691,1317429771,1,1,1080
14319961@N08,571,11,1448881480,1448882440,1,1,960
14334279@N02,572,1,1420410718,1420410958,2,1,240
14344313@N05,573,2,1203982944,1203983184,1,1,240
14344313@N05,574,8,1204940140,1204940410,3,2,270
14344313@N05,574,2,1204940410,1204940650,1,2,240
14370802@N05,575,7,1386310298,1386311138,1,1,840
14370802@N05,576,11,1400310742,1400311702,1,1,960
14370802@N05,577,8,1401524957,1401525797,1,1,840
14370802@N05,578,8,1412402007,1412402847,1,1,840
14375907@N00,579,15,1326440603,1326441803,89,1,1200
14375907@N00,580,15,1326532611,1326533811,105,1,1200
14423128@N00,581,11,1274572653,1274573613,1,1,960
14428367@N00,582,10,1226635344,1226636244,17,2,900
14428367@N00,582,13,1226637157,1226638237,25,2,1080
144474523@N02,583,7,1218102082,1218102922,1,1,840
144474523@N02,584,13,1246251715,1246252795,2,2,1080
144474523@N02,584,8,1246261000,1246261840,1,2,840
14449931@N08,585,11,1378707364,1378708324,2,3,960
14449931@N08,585,5,1378712119,1378712539,2,3,420
14449931@N08,585,8,1378717878,1378718718,1,3,840
14449931@N08,586,11,1378954408,1378955368,2,1,960
14449931@N08,587,11,1400149296,1400150256,1,1,960
14449931@N08,588,2,1411004784,1411005024,1,1,240
14472753@N02,589,8,1335146169,1335147009,1,1,840
14472753@N02,590,17,1368835276,1368837976,1,1,2700
14479515@N03,591,11,1199918908,1199919868,26,15,960
14479515@N03,591,16,1199920279,1199922379,2,15,2100
14479515@N03,591,10,1199926578,1199927032,6,15,454
14479515@N03,591,17,1199927032,1199927503,8,15,471
14479515@N03,591,15,1199927503,1199927683,3,15,180
14479515@N03,591,13,1199927683,1199928763,4,15,1080
14479515@N03,591,8,1199935311,1199936151,13,15,840
14479515@N03,591,5,1199938585,1199939005,4,15,420
14479515@N03,591,13,1199945649,1199946729,2,15,1080
14479515@N03,591,10,1199953810,1199954710,2,15,900
14479515@N03,591,17,1199954834,1199954905,2,15,71
14479515@N03,591,15,1199954905,1199956105,3,15,1200
14479515@N03,591,8,1199961511,1199961717,2,15,206
14479515@N03,591,5,1199961717,1199962137,2,15,420
14479515@N03,591,11,1199962260,1199963220,1,15,960
14479515@N03,592,11,1254185482,1254186442,7,1,960
14484378@N08,593,13,1221328905,1221329985,1,1,1080
14487451@N00,594,11,1379149869,1379150829,3,1,960
14489732@N00,595,11,1275703664,1275704624,1,1,960
14489732@N00,596,11,1276081416,1276082376,1,1,960
14500034@N06,597,13,1388505366,1388506446,1,1,1080
14504365@N00,598,11,1359156756,1359157716,4,5,960
14504365@N00,598,2,1359161323,1359161563,5,5,240
14504365@N00,598,4,1359164717,1359165077,5,5,360
14504365@N00,598,10,1359166673,1359167573,3,5,900
14504365@N00,598,11,1359172307,1359173267,4,5,960
14541788@N06,599,1,1429462051,1429462291,1,1,240
14542870@N03,600,8,1264149001,1264149841,1,1,840
14561857@N02,601,11,1369269776,1369270736,1,1,960
14572041@N08,602,11,1448319140,1448320100,1,1,960
14572041@N08,603,11,1448353756,1448354716,1,1,960
14580956@N08,604,11,1273279186,1273280146,7,12,960
14580956@N08,604,9,1273283103,1273284003,2,12,900
14580956@N08,604,3,1273284595,1273284925,3,12,330
14580956@N08,604,9,1273286224,1273287124,7,12,900
14580956@N08,604,1,1273288972,1273289212,2,12,240
14580956@N08,604,8,1273294404,1273295244,15,12,840
14580956@N08,604,1,1273297960,1273298200,9,12,240
14580956@N08,604,12,1273300967,1273301987,9,12,1020
14580956@N08,604,4,1273303213,1273303573,3,12,360
14580956@N08,604,6,1273307538,1273308258,17,12,720
14580956@N08,604,17,1273318087,1273318459,2,12,372
14580956@N08,604,11,1273318459,1273319419,2,12,960
14617498@N00,605,3,1229056246,1229056576,2,3,330
14617498@N00,605,1,1229062745,1229062985,9,3,240
14617498@N00,605,6,1229077934,1229078654,5,3,720
14617498@N00,606,11,1297555604,1297556564,1,1,960
14625004@N00,607,11,1195361858,1195362818,3,3,960
14625004@N00,607,8,1195371833,1195372673,3,3,840
14625004@N00,607,6,1195376993,1195377713,2,3,720
14625004@N00,608,9,1195686894,1195687794,2,7,900
14625004@N00,608,2,1195688365,1195688605,5,7,240
14625004@N00,608,3,1195693783,1195694113,3,7,330
14625004@N00,608,10,1195694465,1195695365,4,7,900
14625004@N00,608,17,1195696324,1195699024,2,7,2700
14625004@N00,608,13,1195701689,1195702769,9,7,1080
14625004@N00,608,8,1195708991,1195709831,1,7,840
14631943@N08,609,4,1190512287,1190512311,2,3,24
14631943@N08,609,11,1190512311,1190512320,2,3,9
14631943@N08,609,9,1190512320,1190513220,1,3,900
14639823@N05,610,8,1221976082,1221976922,1,1,840
14639823@N05,611,5,1235707847,1235708267,2,1,420
14639823@N05,612,7,1300674171,1300675011,2,2,840
14639823@N05,612,15,1300681442,1300682642,1,2,1200
14769156@N08,613,6,1417954282,1417955002,19,1,720
14769156@N08,614,12,1433427694,1433427815,2,4,121
14769156@N08,614,11,1433427815,1433428063,22,4,248
14769156@N08,614,5,1433428063,1433428145,2,4,82
14769156@N08,614,8,1433428145,1433428985,3,4,840
14788107@N07,615,2,1420095958,1420096198,1,1,240
14845075@N00,616,10,1407378740,1407379640,4,5,900
14845075@N00,616,1,1407380487,1407380493,2,5,6
14845075@N00,616,9,1407380493,1407381393,3,5,900
14845075@N00,616,11,1407389023,1407389983,4,5,960
14845075@N00,616,1,1407405327,1407405567,1,5,240
14873749@N02,617,5,1309864953,1309865373,2,3,420
14873749@N02,617,6,1309875611,1309876331,3,3,720
14873749@N02,617,11,1309881057,1309882017,2,3,960
14877714@N00,618,11,1193460803,1193461763,3,2,960
14877714@N00,618,9,1193464761,1193465661,3,2,900
14898307@N00,619,11,1360299992,1360300952,1,1,960
14903923@N07,620,11,1241861190,1241862150,1,1,960
14903923@N07,621,11,1242961227,1242962187,3,1,960
14904592@N04,622,4,1292013986,1292014346,4,3,360
14904592@N04,622,2,1292025170,1292025410,2,3,240
14904592@N04,622,1,1292034869,1292035109,1,3,240
14915921@N00,623,13,1196558432,1196558580,2,9,148
14915921@N00,623,17,1196558580,1196558877,11,9,297
14915921@N00,623,10,1196558877,1196559777,22,9,900
14915921@N00,623,13,1196561747,1196562827,4,9,1080
14915921@N00,623,8,1196566713,1196567553,8,9,840
14915921@N00,623,5,1196568035,1196568455,6,9,420
14915921@N00,623,1,1196569820,1196570060,6,9,240
14915921@N00,623,9,1196573612,1196574512,7,9,900
14915921@N00,623,11,1196575349,1196576309,16,9,960
14934218@N03,624,10,1214903505,1214904405,2,2,900
14934218@N03,624,17,1214905134,1214907834,1,2,2700
14934218@N03,625,8,1252045682,1252046522,10,3,840
14934218@N03,625,10,1252052658,1252053558,3,3,900
14934218@N03,625,15,1252062033,1252063233,1,3,1200
15021432@N00,626,8,1190343113,1190343953,3,1,840
15021432@N00,627,11,1191103320,1191104280,2,4,960
15021432@N00,627,2,1191120835,1191121075,2,4,240
15021432@N00,627,4,1191122949,1191123309,2,4,360
15021432@N00,627,8,1191134991,1191135831,1,4,840
15021432@N00,628,10,1191219002,1191219902,2,1,900
15021432@N00,629,4,1192146072,1192146432,2,4,360
15021432@N00,629,10,1192156954,1192157854,2,4,900
15021432@N00,629,15,1192164493,1192165693,2,4,1200
15021432@N00,629,11,1192169443,1192170403,1,4,960
15021432@N00,630,11,1209007811,1209008771,4,3,960
15021432@N00,630,15,1209017267,1209018467,3,3,1200
15021432@N00,630,13,1209018885,1209019965,1,3,1080
15021432@N00,631,10,1222486222,1222487122,2,1,900
15021432@N00,632,16,1225931829,1225933929,4,1,2100
15021432@N00,633,13,1229821296,1229822376,2,1,1080
15021432@N00,634,17,1234001490,1234004190,7,2,2700
15021432@N00,634,11,1234006550,1234007510,1,2,960
15048974@N00,635,11,1452987235,1452988195,2,1,960
15048974@N00,636,11,1464942810,1464943770,5,1,960
15048974@N00,637,11,1465168953,1465169913,1,1,960
15048974@N00,638,11,1465253031,1465253991,1,1,960
15079826@N00,639,5,1327735474,1327735894,1,1,420
15079826@N00,640,5,1386992350,1386992770,2,1,420
15079826@N00,641,13,1400913780,1400914860,4,2,1080
15079826@N00,641,5,1400930901,1400931321,8,2,420
15265115@N06,642,11,1359272471,1359273431,3,4,960
15265115@N06,642,10,1359273472,1359274372,2,4,900
15265115@N06,642,17,1359276523,1359277553,6,4,1030
15265115@N06,642,11,1359277553,1359278513,4,4,960
15268966@N00,643,11,1212557089,1212558049,2,1,960
15403331@N00,644,11,1420376621,1420377581,2,1,960
15409357@N07,645,11,1393573768,1393574728,1,1,960
15409357@N07,646,17,1431856330,1431859030,1,1,2700
15429890@N08,647,1,1191233224,1191233464,1,1,240
15473418@N00,648,11,1212456796,1212457756,2,2,960
15473418@N00,648,2,1212458499,1212458739,3,2,240
15473418@N00,649,8,1212549163,1212550003,4,7,840
15473418@N00,649,5,1212551743,1212552163,4,7,420
15473418@N00,649,10,1212553914,1212554814,7,7,900
15473418@N00,649,17,1212558205,1212558775,2,7,570
15473418@N00,649,13,1212558775,1212559855,2,7,1080
15473418@N00,649,15,1212564504,1212564620,2,7,116
15473418@N00,649,13,1212564620,1212565700,9,7,1080
15473418@N00,650,16,1212883018,1212885118,2,8,2100
15473418@N00,650,9,1212886317,1212887217,3,8,900
15473418@N00,650,7,1212888498,1212889338,2,8,840
15473418@N00,650,14,1212895077,1212896277,3,8,1200
15473418@N00,650,12,1212897840,1212898860,4,8,1020
15473418@N00,650,2,1212900239,1212900479,2,8,240
15473418@N00,650,14,1212900756,1212901956,2,8,1200
15473418@N00,650,11,1212903014,1212903974,1,8,960
15473418@N00,651,2,1215831618,1215831858,2,1,240
15473418@N00,652,11,1216035038,1216035998,1,1,960
15474023@N03,653,11,1396318127,1396319087,2,8,960
15474023@N03,653,1,1396322778,1396323018,2,8,240
15474023@N03,653,10,1396324083,1396324983,2,8,900
15474023@N03,653,17,1396326467,1396328594,4,8,2127
15474023@N03,653,13,1396328594,1396329674,4,8,1080
15474023@N03,653,8,1396336509,1396337349,8,8,840
15474023@N03,653,5,1396342209,1396342629,2,8,420
15474023@N03,653,11,1396343704,1396344664,1,8,960
15510693@N08,654,8,1362288970,1362289810,2,2,840
15510693@N08,654,5,1362290671,1362291091,1,2,420
15518367@N03,655,16,1303371297,1303373397,2,2,2100
15518367@N03,655,11,1303383765,1303384725,1,2,960
15525927@N04,656,11,1296271570,1296272530,1,1,960
15530177@N05,657,15,1418265642,1418266034,9,3,392
15530177@N05,657,10,1418266034,1418266648,11,3,614
15530177@N05,657,13,1418266648,1418267728,6,3,1080
15531512@N00,658,11,1365378255,1365379215,10,1,960
15531512@N00,659,17,1426492471,1426494344,3,2,1873
15531512@N00,659,2,1426494344,1426494584,2,2,240
15531512@N00,660,4,1426568635,1426568995,2,2,360
15531512@N00,660,5,1426576396,1426576816,2,2,420
15533594@N00,661,11,1296946963,1296947923,3,2,960
15533594@N00,661,5,1296966276,1296966696,1,2,420
15545914@N00,662,11,1313127143,1313128103,1,1,960
15551876@N04,663,13,1376812189,1376813269,2,2,1080
15551876@N04,663,11,1376816099,1376817059,1,2,960
15578904@N00,664,8,1381740547,1381741387,1,1,840
15605437@N08,665,4,1203601852,1203601858,3,9,6
15605437@N08,665,11,1203601858,1203601892,12,9,34
15605437@N08,665,3,1203601892,1203601893,2,9,1
15605437@N08,665,12,1203601893,1203601948,7,9,55
15605437@N08,665,6,1203601948,1203601969,4,9,21
15605437@N08,665,15,1203601969,1203601984,4,9,15
15605437@N08,665,8,1203601984,1203601990,2,9,6
15605437@N08,665,13,1203601990,1203602033,2,9,43
15605437@N08,665,5,1203602033,1203602453,6,9,420
15756745@N06,666,8,1335261878,1335262718,1,1,840
15790231@N02,667,11,1222393175,1222393404,2,7,229
15790231@N02,667,2,1222393404,1222393644,22,7,240
15790231@N02,667,12,1222401601,1222401661,2,7,60
15790231@N02,667,2,1222401661,1222401901,2,7,240
15790231@N02,667,14,1222414044,1222415244,19,7,1200
15790231@N02,667,13,1222418544,1222419624,2,7,1080
15790231@N02,667,6,1222422027,1222422747,4,7,720
15802258@N04,668,11,1384035360,1384036320,1,1,960
15802258@N04,669,17,1384077748,1384080448,4,1,2700
15802258@N04,670,11,1392446081,1392447041,1,1,960
15802258@N04,671,17,1417826774,1417829474,1,1,2700
15802258@N04,672,11,1449361757,1449362717,1,1,960
15802258@N04,673,11,1460748513,1460749473,1,1,960
15823562@N00,674,11,1255577493,1255578453,1,1,960
15823562@N00,675,10,1255870124,1255871024,3,1,900
15823562@N00,676,11,1275645564,1275646524,4,1,960
15834837@N08,677,4,1376456551,1376456911,2,1,360
15834837@N08,678,11,1381558358,1381559318,3,3,960
15834837@N08,678,7,1381565610,1381566450,3,3,840
15834837@N08,678,11,1381575339,1381576299,7,3,960
16088786@N03,679,11,1402986096,1402987056,1,1,960
16088786@N03,680,3,1403598568,1403598898,1,1,330
16093042@N00,681,11,1351559072,1351559136,2,4,64
16093042@N00,681,10,1351559136,1351559428,2,4,292
16093042@N00,681,13,1351559428,1351560508,2,4,1080
16093042@N00,681,17,1351575210,1351577910,2,4,2700
16299212@N03,682,11,1232785138,1232786098,1,1,960
16299212@N03,683,11,1232839075,1232840035,2,1,960
16355945@N00,684,4,1300175716,1300176076,1,1,360
16355945@N00,685,8,1323402960,1323403800,2,2,840
16355945@N00,685,5,1323403827,1323404247,1,2,420
16417121@N00,686,13,1452834085,1452835165,2,2,1080
16417121@N00,686,11,1452848166,1452849126,1,2,960
16429538@N00,687,11,1246785183,1246786143,1,1,960
16429538@N00,688,15,1247041955,1247043155,13,2,1200
16429538@N00,688,11,1247051125,1247052085,1,2,960
16476321@N02,689,17,1333940199,1333942899,1,1,2700
16605570@N08,690,2,1243405801,1243406041,2,2,240
16605570@N08,690,12,1243409687,1243410707,1,2,1020
16644192@N02,691,6,1217340000,1217340720,2,1,720
16985502@N04,692,4,1292977784,1292978144,1,1,360
16985502@N04,693,11,1324008041,1324009001,1,1,960
16985502@N04,694,3,1324173015,1324173150,2,2,135
16985502@N04,694,7,1324173150,1324173990,1,2,840
16985502@N04,695,13,1324273061,1324273829,3,6,768
16985502@N04,695,15,1324273829,1324273935,2,6,106
16985502@N04,695,10,1324273935,1324274500,2,6,565
16985502@N04,695,5,1324274500,1324274688,2,6,188
16985502@N04,695,8,1324274688,1324275528,2,6,840
16985502@N04,695,6,1324276214,1324276934,2,6,720
16985502@N04,696,16,1353814973,1353817073,2,3,2100
16985502@N04,696,6,1353829861,1353830581,2,3,720
16985502@N04,696,16,1353840493,1353842593,1,3,2100
16991061@N00,697,11,1211423722,1211424682,19,1,960
16991061@N00,698,11,1211509790,1211510750,1,1,960
16994861@N08,699,11,1380692112,1380693072,2,5,960
16994861@N08,699,10,1380694412,1380694495,2,5,83
16994861@N08,699,17,1380694495,1380697195,3,5,2700
16994861@N08,699,13,1380699733,1380700813,2,5,1080
16994861@N08,699,17,1380702179,1380704879,1,5,2700
16994861@N08,700,9,1380757835,1380758331,4,7,496
16994861@N08,700,16,1380758331,1380760431,4,7,2100
16994861@N08,700,9,1380761144,1380761349,2,7,205
16994861@N08,700,2,1380761349,1380761589,4,7,240
16994861@N08,700,7,1380762206,1380763046,2,7,840
16994861@N08,700,5,1380770392,1380770812,2,7,420
16994861@N08,700,8,1380774162,1380775002,2,7,840
16994861@N08,701,11,1380805181,1380806141,4,1,960
17057923@N06,702,11,1311202128,1311203088,2,18,960
17057923@N06,702,7,1311203161,1311204001,2,18,840
17057923@N06,702,9,1311205284,1311206184,4,18,900
17057923@N06,702,1,1311207025,1311207265,5,18,240
17057923@N06,702,10,1311212521,1311213421,18,18,900
17057923@N06,702,17,1311216804,1311217198,3,18,394
17057923@N06,702,10,1311217198,1311218098,8,18,900
17057923@N06,702,17,1311218714,1311218970,2,18,256
17057923@N06,702,15,1311218970,1311219240,5,18,270
17057923@N06,702,13,1311219240,1311220320,7,18,1080
17057923@N06,702,5,1311231645,1311232058,2,18,413
17057923@N06,702,1,1311232058,1311232171,2,18,113
17057923@N06,702,16,1311232171,1311234271,3,18,2100
17057923@N06,702,11,1311235125,1311236085,7,18,960
17057923@N06,702,3,1311238176,1311238506,33,18,330
17057923@N06,702,7,1311239235,1311240075,3,18,840
17057923@N06,702,4,1311241277,1311241637,2,18,360
17057923@N06,702,5,1311244388,1311244808,37,18,420
17057923@N06,703,11,1311540811,1311541771,2,5,960
17057923@N06,703,5,1311545664,1311546084,5,5,420
17057923@N06,703,2,1311549808,1311550048,31,5,240
17057923@N06,703,4,1311555905,1311556265,2,5,360
17057923@N06,703,14,1311574726,1311575926,18,5,1200
17099253@N00,704,11,1350169218,1350170178,2,10,960
17099253@N00,704,7,1350173516,1350174356,2,10,840
17099253@N00,704,2,1350176087,1350176327,3,10,240
17099253@N00,704,12,1350176685,1350177705,2,10,1020
17099253@N00,704,10,1350184692,1350185592,3,10,900
17099253@N00,704,17,1350185731,1350186609,2,10,878
17099253@N00,704,15,1350186609,1350187809,3,10,1200
17099253@N00,704,13,1350188451,1350189531,2,10,1080
17099253@N00,704,5,1350199975,1350200395,2,10,420
17099253@N00,704,11,1350210669,1350211629,1,10,960
17099253@N00,705,11,1350780299,1350780343,2,6,44
17099253@N00,705,2,1350780343,1350780407,2,6,64
17099253@N00,705,10,1350780407,1350780571,3,6,164
17099253@N00,705,5,1350780571,1350780617,2,6,46
17099253@N00,705,11,1350780617,1350781577,2,6,960
17099253@N00,705,5,1350802910,1350803330,1,6,420
17145135@N00,706,11,1318547580,1318548540,3,7,960
17145135@N00,706,5,1318550632,1318551052,2,7,420
17145135@N00,706,8,1318553406,1318554246,2,7,840
17145135@N00,706,13,1318563981,1318564067,2,7,86
17145135@N00,706,4,1318564067,1318564427,2,7,360
17145135@N00,706,11,1318571016,1318571976,2,7,960
17145135@N00,706,10,1318580398,1318581298,1,7,900
17299643@N00,707,11,1301885503,1301886463,7,8,960
17299643@N00,707,16,1301889925,1301891711,3,8,1786
17299643@N00,707,1,1301891711,1301891951,3,8,240
17299643@N00,707,5,1301896029,1301896449,10,8,420
17299643@N00,707,8,1301900034,1301900874,5,8,840
17299643@N00,707,13,1301906027,1301907107,4,8,1080
17299643@N00,707,15,1301909410,1301909811,9,8,401
17299643@N00,707,17,1301909811,1301912511,2,8,2700
17328804@N05,708,11,1268823685,1268824645,1,1,960
17386110@N00,709,17,1373548256,1373550956,1,1,2700
17539749@N00,710,3,1266644052,1266644382,1,1,330
17567960@N00,711,10,1322871649,1322872549,3,3,900
17567960@N00,711,13,1322873283,1322874363,6,3,1080
17567960@N00,711,11,1322885289,1322886249,1,3,960
17599044@N08,712,17,1220262393,1220265093,1,1,2700
17671095@N04,713,17,1244395091,1244397791,1,1,2700
17725987@N00,714,11,1380298962,1380299922,1,1,960
17725987@N00,715,11,1387025971,1387026931,1,1,960
17754571@N02,716,8,1353047906,1353048326,2,3,420
17754571@N02,716,5,1353048326,1353048746,2,3,420
17754571@N02,716,11,1353051151,1353052111,1,3,960
17762186@N00,717,11,1325108818,1325109778,2,1,960
17883439@N08,718,5,1363855554,1363855974,1,1,420
18004163@N00,719,11,1336881855,1336882815,1,1,960
18081271@N00,720,11,1324281173,1324282133,1,1,960
18081271@N00,721,3,1324516809,1324517139,1,1,330
18158822@N06,722,14,1257110982,1257112182,93,1,1200
18214853@N00,723,11,1346191910,1346192870,4,5,960
18214853@N00,723,4,1346214774,1346215134,2,5,360
18214853@N00,723,10,1346216069,1346216969,2,5,900
18214853@N00,723,2,1346218810,1346219050,3,5,240
18214853@N00,723,11,1346236558,1346237518,1,5,960
18229944@N04,724,11,1272650104,1272651064,1,1,960
18229944@N04,725,4,1285947365,1285947725,2,1,360
18334814@N00,726,11,1461109296,1461110256,2,4,960
18334814@N00,726,10,1461115220,1461116120,3,4,900
18334814@N00,726,13,1461150395,1461151475,2,4,1080
18334814@N00,726,11,1461151703,1461152663,2,4,960
18334814@N00,727,17,1461387644,1461390344,1,1,2700
18427074@N00,728,11,1346803664,1346804624,1,1,960
18647653@N08,729,1,1376798941,1376799181,2,2,240
18647653@N08,729,4,1376810487,1376810847,4,2,360
18681277@N00,730,11,1410485028,1410485988,2,1,960
18697834@N00,731,11,1321241581,1321242541,1,1,960
18703622@N06,732,11,1359583403,1359584363,2,5,960
18703622@N06,732,9,1359589427,1359590327,3,5,900
18703622@N06,732,3,1359593000,1359593330,4,5,330
18703622@N06,732,9,1359608354,1359609254,2,5,900
18703622@N06,732,5,1359613281,1359613701,1,5,420
18748204@N00,733,11,1401245140,1401246100,3,4,960
18748204@N00,733,4,1401257307,1401257667,25,4,360
18748204@N00,733,9,1401267581,1401268481,6,4,900
18748204@N00,733,2,1401271673,1401271913,15,4,240
18835181@N05,734,8,1232674637,1232675477,1,1,840
18835181@N05,735,4,1258081232,1258081592,2,2,360
18835181@N05,735,8,1258106340,1258107180,1,2,840
18928626@N00,736,11,1218094623,1218095583,1,1,960
19017254@N03,737,10,1394672586,1394673486,1,1,900
19026178@N00,738,11,1194911012,1194911612,7,9,600
19026178@N00,738,9,1194911612,1194912512,2,9,900
19026178@N00,738,10,1194912818,1194913094,5,9,276
19026178@N00,738,17,1194913094,1194913674,16,9,580
19026178@N00,738,15,1194913674,1194913919,4,9,245
19026178@N00,738,13,1194913919,1194914999,7,9,1080
19026178@N00,738,8,1194923104,1194923944,6,9,840
19026178@N00,738,5,1194929162,1194929582,2,9,420
19026178@N00,738,12,1194934523,1194935543,1,9,1020
19262297@N03,739,8,1286611669,1286612509,1,1,840
19262297@N03,740,11,1368853052,1368854012,1,1,960
19356293@N08,741,6,1244103248,1244103968,1,1,720
19555551@N00,742,11,1197928499,1197929459,2,11,960
19555551@N00,742,14,1197929808,1197931008,3,11,1200
19555551@N00,742,2,1197935098,1197935107,2,11,9
19555551@N00,742,12,1197935107,1197936127,2,11,1020
19555551@N00,742,5,1197937873,1197938293,2,11,420
19555551@N00,742,8,1197940416,1197941256,4,11,840
19555551@N00,742,13,1197951429,1197952509,4,11,1080
19555551@N00,742,15,1197956685,1197957885,4,11,1200
19555551@N00,742,10,1197958071,1197958971,2,11,900
19555551@N00,742,15,1197964957,1197966157,2,11,1200
19555551@N00,742,11,1197968297,1197969257,2,11,960
19555551@N00,743,2,1276654140,1276654380,3,3,240
19555551@N00,743,5,1276675178,1276675598,2,3,420
19555551@N00,743,11,1276687515,1276688475,1,3,960
19594436@N00,744,3,1242690096,1242690426,26,1,330
19594436@N00,745,6,1242954902,1242955622,85,1,720
19594436@N00,746,6,1244701366,1244702086,1,1,720
19594436@N00,747,6,1254031689,1254032409,1,1,720
19609393@N03,748,5,1303346604,1303347024,3,1,420
19653633@N03,749,13,1208904510,1208905590,1,1,1080
19709423@N04,750,9,1387876206,1387877106,3,1,900
19762975@N06,751,10,1329721556,1329721928,2,2,372
19762975@N06,751,11,1329721928,1329722888,1,2,960
19800853@N07,752,2,1427140967,1427141207,1,1,240
19936517@N07,753,3,1386240949,1386241279,1,1,330
19951106@N03,754,11,1320028060,1320029020,3,1,960
19951106@N03,755,13,1320283305,1320284385,2,1,1080
20008009@N05,756,13,1430792019,1430793099,2,2,1080
20008009@N05,756,11,1430807513,1430808473,1,2,960
20035490@N00,757,9,1355397837,1355398737,1,1,900
20154444@N04,758,11,1300268790,1300269750,1,1,960
20154444@N04,759,11,1469226488,1469227448,2,3,960
20154444@N04,759,4,1469248559,1469248919,2,3,360
20154444@N04,759,1,1469262459,1469262699,1,3,240
20229609@N03,760,11,1341301898,1341302858,2,1,960
20278762@N00,761,11,1461771023,1461771983,1,1,960
20287222@N00,762,1,1289965414,1289965654,2,1,240
20287222@N00,763,8,1290159166,1290160006,3,1,840
20319059@N06,764,8,1253610704,1253611544,1,1,840
20322483@N05,765,8,1198945365,1198946205,3,1,840
20322483@N05,766,8,1204255025,1204255865,2,2,840
20322483@N05,766,11,1204258691,1204259651,1,2,960
20322483@N05,767,3,1204330281,1204330611,1,1,330
20322483@N05,768,11,1218428214,1218429174,5,2,960
20322483@N05,768,10,1218449981,1218450881,1,2,900
20322483@N05,769,4,1218506091,1218506451,2,2,360
20322483@N05,769,16,1218507444,1218509544,1,2,2100
20322483@N05,770,9,1218669941,1218670179,2,3,238
20322483@N05,770,16,1218670179,1218671932,2,3,1753
20322483@N05,770,7,1218671932,1218672772,1,3,840
20322483@N05,771,11,1225411595,1225412555,2,1,960
20322483@N05,772,11,1225517632,1225518592,2,1,960
20342624@N00,773,1,1286066798,1286067038,2,5,240
20342624@N00,773,9,1286068432,1286069332,2,5,900
20342624@N00,773,11,1286070810,1286071770,2,5,960
20342624@N00,773,8,1286076266,1286077106,2,5,840
20342624@N00,773,16,1286088513,1286090613,1,5,2100
20509582@N00,774,4,1304347773,1304348133,1,1,360
20544000@N00,775,11,1363132914,1363133874,1,1,960
20544648@N06,776,11,1284852313,1284853273,3,1,960
20544648@N06,777,10,1285149884,1285149989,3,4,105
20544648@N06,777,17,1285149989,1285150212,5,4,223
20544648@N06,777,15,1285150212,1285150321,2,4,109
20544648@N06,777,13,1285150321,1285151401,2,4,1080
20544648@N06,778,8,1285293023,1285293863,8,2,840
20544648@N06,778,5,1285294767,1285295187,1,2,420
20677928@N06,779,11,1236951963,1236952923,3,4,960
20677928@N06,779,3,1236976443,1236976773,4,4,330
20677928@N06,779,10,1236983282,1236984182,3,4,900
20677928@N06,779,13,1236984912,1236985992,1,4,1080
20677928@N06,780,13,1239075556,1239076636,2,1,1080
20683088@N03,781,11,1450916995,1450917955,1,1,960
20701570@N00,782,13,1319185019,1319185275,2,2,256
20701570@N00,782,15,1319185275,1319186475,1,2,1200
20701570@N00,783,4,1348965332,1348965692,2,2,360
20701570@N00,783,10,1348971864,1348972764,1,2,900
20701570@N00,784,13,1379755429,1379756509,1,1,1080
20701570@N00,785,12,1402198616,1402198617,2,3,1
20701570@N00,785,7,1402198617,1402198626,2,3,9
20701570@N00,785,10,1402198626,1402199526,1,3,900
20701570@N00,786,11,1450488702,1450489662,1,1,960
20704576@N04,787,11,1197954041,1197955001,2,1,960
20715134@N00,788,11,1237836602,1237836962,2,7,360
20715134@N00,788,9,1237836962,1237837862,2,7,900
20715134@N00,788,16,1237839519,1237841619,2,7,2100
20715134@N00,788,15,1237842140,1237843340,2,7,1200
20715134@N00,788,13,1237848126,1237849206,3,7,1080
20715134@N00,788,1,1237853694,1237853934,2,7,240
20715134@N00,788,11,1237881554,1237882514,2,7,960
20725537@N04,789,6,1382394828,1382395548,8,1,720
20727999@N06,790,1,1304979522,1304979762,2,6,240
20727999@N06,790,2,1304981784,1304982024,2,6,240
20727999@N06,790,5,1305009504,1305009924,3,6,420
20727999@N06,790,8,1305010590,1305011430,6,6,840
20727999@N06,790,17,1305015925,1305018625,5,6,2700
20727999@N06,790,10,1305018976,1305019876,1,6,900
20727999@N06,791,11,1305152074,1305153034,2,5,960
20727999@N06,791,1,1305153615,1305153623,2,5,8
20727999@N06,791,9,1305153623,1305154523,4,5,900
20727999@N06,791,8,1305179333,1305180173,5,5,840
20727999@N06,791,5,1305193038,1305193458,1,5,420
20742002@N00,792,11,1229767494,1229768454,1,1,960
20771338@N00,793,8,1222222731,1222223571,2,4,840
20771338@N00,793,13,1222231839,1222232048,3,4,209
20771338@N00,793,8,1222232048,1222232739,4,4,691
20771338@N00,793,11,1222232739,1222233699,4,4,960
20864470@N00,794,9,1333113208,1333114108,2,2,900
20864470@N00,794,11,1333137878,1333138838,1,2,960
20885794@N00,795,11,1467460420,1467461380,1,1,960
20895877@N04,796,17,1349061907,1349063611,2,3,1704
20895877@N04,796,13,1349063611,1349064691,2,3,1080
20895877@N04,796,8,1349070961,1349071801,3,3,840
20925955@N03,797,1,1208662673,1208662913,4,1,240
20944525@N04,798,11,1369124033,1369124993,1,1,960
20961008@N08,799,11,1461489855,1461490815,1,1,960
21029801@N05,800,11,1241230566,1241231526,3,4,960
21029801@N05,800,3,1241259466,1241259796,4,4,330
21029801@N05,800,4,1241259940,1241260300,2,4,360
21029801@N05,800,11,1241263911,1241264871,1,4,960
21038859@N08,801,12,1209687593,1209688613,2,2,1020
21038859@N08,801,1,1209701182,1209701422,4,2,240
21038859@N08,802,11,1209731738,1209732698,1,1,960
21038859@N08,803,11,1209969812,1209970679,3,2,867
21038859@N08,803,15,1209970679,1209971879,1,2,1200
21100210@N05,804,11,1195640120,1195641080,1,1,960
21138471@N00,805,5,1224721138,1224721558,3,1,420
21138471@N00,806,11,1235873459,1235874419,1,1,960
21212744@N07,807,11,1199147625,1199148585,3,1,960
21212744@N07,808,8,1199232595,1199233435,6,1,840
21212744@N07,809,11,1199668030,1199668990,2,1,960
21212744@N07,810,13,1199948611,1199948954,6,4,343
21212744@N07,810,17,1199948954,1199950405,5,4,1451
21212744@N07,810,10,1199950405,1199951305,4,4,900
21212744@N07,810,11,1199952215,1199953175,2,4,960
21228638@N00,811,1,1237684875,1237685115,2,2,240
21228638@N00,811,8,1237705339,1237706179,1,2,840
21228638@N00,812,6,1238111985,1238112705,1,1,720
21242385@N04,813,8,1367050603,1367051443,2,1,840
21242740@N00,814,4,1259293648,1259294008,4,1,360
21242740@N00,815,4,1259388032,1259388392,1,1,360
21242740@N00,816,4,1263549442,1263549802,1,1,360
21242740@N00,817,4,1280471522,1280471882,2,1,360
21254904@N02,818,11,1219631142,1219632102,2,3,960
21254904@N02,818,5,1219655714,1219656134,2,3,420
21254904@N02,818,11,1219658843,1219659803,1,3,960
21254904@N02,819,16,1219984724,1219986824,1,1,2100
21299180@N02,820,13,1356305526,1356306606,3,1,1080
21299180@N02,821,13,1362282011,1362283091,30,1,1080
21299180@N02,822,6,1366448371,1366449091,14,2,720
21299180@N02,822,13,1366451204,1366452284,3,2,1080
21299180@N02,823,4,1366947432,1366947792,13,2,360
21299180@N02,823,11,1366955541,1366956501,3,2,960
21301462@N02,824,11,1311472251,1311473211,2,4,960
21301462@N02,824,2,1311476501,1311476741,8,4,240
21301462@N02,824,16,1311498533,1311500633,2,4,2100
21301462@N02,824,5,1311500997,1311501417,20,4,420
21301462@N02,825,13,1311560433,1311561513,10,5,1080
21301462@N02,825,8,1311575554,1311576394,6,5,840
21301462@N02,825,17,1311582386,1311582973,4,5,587
21301462@N02,825,10,1311582973,1311583873,2,5,900
21301462@N02,825,17,1311584612,1311587312,1,5,2700
21328392@N06,826,11,1311378384,1311379344,4,9,960
21328392@N06,826,7,1311380958,1311381798,2,9,840
21328392@N06,826,4,1311384085,1311384445,2,9,360
21328392@N06,826,5,1311390557,1311390977,4,9,420
21328392@N06,826,8,1311392842,1311393682,3,9,840
21328392@N06,826,13,1311401947,1311403027,2,9,1080
21328392@N06,826,17,1311404699,1311405198,3,9,499
21328392@N06,826,10,1311405198,1311406098,4,9,900
21328392@N06,826,17,1311415434,1311418134,3,9,2700
21369373@N00,827,10,1353652012,1353652912,4,1,900
21377282@N00,828,10,1221348923,1221349823,1,1,900
21383026@N06,829,15,1247373311,1247373457,2,2,146
21383026@N06,829,17,1247373457,1247376157,1,2,2700
21383026@N06,830,6,1249290388,1249291108,5,1,720
21383026@N06,831,13,1255048859,1255049939,2,1,1080
21383026@N06,832,13,1255740369,1255741449,1,1,1080
21383026@N06,833,13,1285233588,1285234668,2,1,1080
21383026@N06,834,6,1286952184,1286952904,1,1,720
21383026@N06,835,11,1288764071,1288765031,4,1,960
21383026@N06,836,6,1289206359,1289207079,3,1,720
21383026@N06,837,6,1289287251,1289287971,2,1,720
21383026@N06,838,13,1293687846,1293688926,1,1,1080
21383026@N06,839,13,1294896931,1294898011,2,2,1080
21383026@N06,839,5,1294902940,1294903360,1,2,420
21383026@N06,840,15,1296788715,1296789915,1,1,1200
21383026@N06,841,4,1298623907,1298624267,1,1,360
21383026@N06,842,15,1305009226,1305010426,3,2,1200
21383026@N06,842,13,1305017116,1305018196,1,2,1080
21383026@N06,843,15,1311245041,1311246241,4,2,1200
21383026@N06,843,8,1311247889,1311248729,1,2,840
21383026@N06,844,13,1318486603,1318487683,4,1,1080
21407390@N00,845,10,1364033378,1364034278,1,1,900
21422300@N00,846,8,1198569649,1198570489,2,2,840
21422300@N00,846,11,1198573959,1198574919,1,2,960
21467315@N00,847,11,1376036828,1376037788,2,1,960
21472383@N03,848,8,1200547437,1200548277,2,2,840
21472383@N03,848,11,1200550646,1200551606,1,2,960
21482165@N05,849,10,1196641296,1196642196,2,1,900
21537772@N02,850,16,1196357149,1196359249,1,1,2100
21591624@N00,851,11,1215989621,1215990581,3,2,960
21591624@N00,851,1,1215991000,1215991240,1,2,240
21591624@N00,852,8,1216030352,1216031192,1,1,840
21619670@N03,853,11,1196728870,1196729830,3,3,960
21619670@N03,853,8,1196736950,1196737790,2,3,840
21619670@N03,853,17,1196745002,1196747702,1,3,2700
21619670@N03,854,15,1197091723,1197091934,3,2,211
21619670@N03,854,13,1197091934,1197093014,3,2,1080
21637807@N07,855,9,1242450738,1242451073,2,2,335
21637807@N07,855,16,1242451073,1242453173,1,2,2100
21641933@N00,856,5,1336286255,1336286675,1,1,420
21641933@N00,857,12,1377735981,1377737001,2,2,1020
21641933@N00,857,2,1377738387,1377738627,1,2,240
21657144@N06,858,11,1204928355,1204929315,4,1,960
21667128@N00,859,11,1293392027,1293392987,33,1,960
21667128@N00,860,11,1293484838,1293485798,46,1,960
21667128@N00,861,11,1293568556,1293569516,50,1,960
21667128@N00,862,11,1293623676,1293624636,68,1,960
21667128@N00,863,11,1293751937,1293752897,2,1,960
21667128@N00,864,8,1293784300,1293785140,6,2,840
21667128@N00,864,11,1293786616,1293787576,1,2,960
21675394@N03,865,11,1197115202,1197116162,1,1,960
21685693@N02,866,13,1195563955,1195565035,6,2,1080
21685693@N02,866,11,1195575393,1195576353,1,2,960
21685693@N02,867,1,1257049359,1257049599,2,1,240
21739162@N04,868,11,1253917885,1253918526,5,9,641
21739162@N04,868,1,1253918526,1253918691,2,9,165
21739162@N04,868,9,1253918691,1253919591,2,9,900
21739162@N04,868,2,1253925001,1253925241,4,9,240
21739162@N04,868,11,1253927460,1253928420,2,9,960
21739162@N04,868,16,1253938405,1253938794,2,9,389
21739162@N04,868,1,1253938794,1253939034,2,9,240
21739162@N04,868,8,1253940172,1253941012,9,9,840
21739162@N04,868,13,1253946151,1253947231,2,9,1080
21739162@N04,869,11,1302216869,1302217829,3,10,960
21739162@N04,869,16,1302223824,1302225362,2,10,1538
21739162@N04,869,2,1302225362,1302225602,5,10,240
21739162@N04,869,10,1302228933,1302229519,4,10,586
21739162@N04,869,17,1302229519,1302231287,3,10,1768
21739162@N04,869,13,1302231287,1302232367,8,10,1080
21739162@N04,869,11,1302243410,1302244370,2,10,960
21739162@N04,869,5,1302248557,1302248977,2,10,420
21739162@N04,869,8,1302255187,1302256027,2,10,840
21739162@N04,869,11,1302258555,1302259515,1,10,960
21748548@N00,870,8,1420661055,1420661895,5,3,840
21748548@N00,870,17,1420662351,1420662906,2,3,555
21748548@N00,870,11,1420662906,1420663866,1,3,960
21748548@N00,871,8,1420746334,1420747174,3,8,840
21748548@N00,871,11,1420754440,1420755400,3,8,960
21748548@N00,871,3,1420762715,1420763045,10,8,330
21748548@N00,871,2,1420770653,1420770893,13,8,240
21748548@N00,871,14,1420774971,1420775172,3,8,201
21748548@N00,871,3,1420775172,1420775502,6,8,330
21748548@N00,871,15,1420781137,1420782337,2,8,1200
21748548@N00,871,17,1420784163,1420786863,2,8,2700
21748548@N00,872,17,1420941987,1420942130,3,2,143
21748548@N00,872,13,1420942130,1420943210,2,2,1080
21758755@N04,873,8,1194324407,1194325247,6,1,840
21768535@N06,874,11,1351641503,1351641739,2,3,236
21768535@N06,874,9,1351641739,1351642639,2,3,900
21768535@N06,874,13,1351652507,1351653587,1,3,1080
21807174@N04,875,5,1309754803,1309755223,2,2,420
21807174@N04,875,8,1309767164,1309768004,1,2,840
21807174@N04,876,4,1310208661,1310209021,1,1,360
21851811@N04,877,2,1270111045,1270111285,1,1,240
21882182@N03,878,10,1347116187,1347116405,4,3,218
21882182@N03,878,17,1347116405,1347116625,2,3,220
21882182@N03,878,15,1347116625,1347117825,3,3,1200
21933943@N02,879,11,1379397461,1379398421,1,1,960
21933943@N02,880,11,1379562813,1379563773,1,1,960
21960471@N06,881,10,1252903588,1252904488,1,1,900
21978090@N03,882,11,1323299729,1323300689,5,4,960
21978090@N03,882,2,1323312404,1323312644,2,4,240
21978090@N03,882,17,1323313668,1323315036,3,4,1368
21978090@N03,882,15,1323315036,1323316236,1,4,1200
22046456@N04,883,1,1279987041,1279987281,2,2,240
22046456@N04,883,16,1279991781,1279993881,2,2,2100
22046456@N04,884,9,1289698266,1289699166,1,1,900
22055481@N04,885,13,1198467695,1198467696,2,2,1
22055481@N04,885,6,1198467696,1198468416,1,2,720
22058355@N06,886,4,1288746850,1288747210,3,2,360
22058355@N06,886,11,1288750758,1288751718,2,2,960
22065354@N08,887,13,1291443327,1291444407,2,1,1080
22068918@N00,888,11,1237756372,1237757332,2,9,960
22068918@N00,888,1,1237761618,1237761858,8,9,240
22068918@N00,888,10,1237769312,1237770034,4,9,722
22068918@N00,888,13,1237770034,1237771114,2,9,1080
22068918@N00,888,8,1237778464,1237779304,3,9,840
22068918@N00,888,5,1237779822,1237780242,6,9,420
22068918@N00,888,11,1237783648,1237784493,4,9,845
22068918@N00,888,12,1237784493,1237785513,2,9,1020
22068918@N00,888,4,1237789220,1237789580,2,9,360
22071371@N00,889,11,1232316678,1232317638,1,1,960
22092583@N05,890,11,1434799713,1434800673,1,1,960
22107206@N00,891,5,1369634957,1369635377,2,1,420
22119513@N00,892,8,1251083106,1251083946,1,1,840
22133066@N05,893,13,1382057764,1382058844,1,1,1080
22151340@N02,894,11,1207822125,1207823085,2,1,960
22151340@N02,895,4,1212302423,1212302783,2,2,360
22151340@N02,895,11,1212309654,1212310614,1,2,960
22151340@N02,896,11,1216547876,1216548836,1,1,960
22151340@N02,897,4,1217398951,1217399311,1,1,360
22158588@N00,898,11,1194656201,1194657161,1,1,960
22158588@N00,899,13,1201342004,1201343084,2,1,1080
22158588@N00,900,5,1204366177,1204366597,1,1,420
22161498@N00,901,2,1195351017,1195351257,13,4,240
22161498@N00,901,13,1195366857,1195367937,5,4,1080
22161498@N00,901,17,1195368269,1195369990,2,4,1721
22161498@N00,901,1,1195369990,1195370230,1,4,240
22162211@N07,902,11,1331481273,1331482233,1,1,960
22204656@N00,903,11,1447866375,1447867335,1,1,960
22207764@N06,904,9,1212302498,1212303398,3,1,900
22207764@N06,905,8,1220776143,1220776983,2,1,840
22207764@N06,906,2,1226643828,1226644068,1,1,240
22207764@N06,907,9,1243650872,1243651772,1,1,900
22207764@N06,908,3,1280535065,1280535395,2,6,330
22207764@N06,908,9,1280540133,1280540346,3,6,213
22207764@N06,908,16,1280540346,1280542446,2,6,2100
22207764@N06,908,4,1280543273,1280543633,2,6,360
22207764@N06,908,5,1280547674,1280548094,2,6,420
22207764@N06,908,11,1280549372,1280550332,1,6,960
22207764@N06,909,8,1280716859,1280717699,3,1,840
22218920@N08,910,4,1260773156,1260773516,2,1,360
22218920@N08,911,4,1394410288,1394410553,2,6,265
22218920@N08,911,14,1394410553,1394411753,7,6,1200
22218920@N08,911,2,1394414620,1394414860,5,6,240
22218920@N08,911,4,1394415481,1394415841,2,6,360
22218920@N08,911,14,1394420998,1394422198,14,6,1200
22218920@N08,911,4,1394434704,1394435064,2,6,360
22232518@N05,912,4,1305470353,1305470713,2,1,360
22232518@N05,913,4,1306503440,1306503800,4,1,360
22232518@N05,914,4,1306804086,1306804446,1,1,360
22232518@N05,915,4,1306887191,1306887551,1,1,360
22232518@N05,916,4,1312952602,1312952962,4,3,360
22232518@N05,916,10,1312954337,1312954656,2,3,319
22232518@N05,916,15,1312954656,1312955856,4,3,1200
22232518@N05,917,4,1343543452,1343543812,14,1,360
22261589@N00,918,15,1194915990,1194917190,1,1,1200
22261589@N00,919,5,1240828190,1240828610,1,1,420
22261589@N00,920,11,1292028930,1292029890,1,1,960
22261589@N00,921,11,1292363833,1292364793,3,4,960
22261589@N00,921,17,1292382105,1292384805,2,4,2700
22261589@N00,921,8,1292388673,1292389513,4,4,840
22261589@N00,921,11,1292399501,1292400461,2,4,960
22261589@N00,922,8,1292492977,1292493817,2,1,840
22261589@N00,923,11,1296288951,1296289911,1,1,960
22261589@N00,924,1,1337127117,1337127357,2,1,240
22261589@N00,925,11,1337469630,1337470590,3,3,960
22261589@N00,925,8,1337486868,1337487708,4,3,840
22261589@N00,925,9,1337504885,1337505785,2,3,900
22261589@N00,926,11,1341833852,1341834812,1,1,960
22261589@N00,927,9,1391161201,1391162101,1,1,900
22265703@N06,928,11,1246970422,1246971382,1,1,960
22273519@N07,929,11,1315884679,1315885639,2,2,960
22273519@N07,929,5,1315888225,1315888645,1,2,420
22311971@N04,930,13,1322383573,1322384653,2,2,1080
22311971@N04,930,2,1322393258,1322393498,1,2,240
22316898@N07,931,7,1397779524,1397780364,3,1,840
22316898@N07,932,7,1414801814,1414802654,1,1,840
22326950@N05,933,11,1199130486,1199131446,1,1,960
22326950@N05,934,3,1217656104,1217656434,14,1,330
22326950@N05,935,11,1217759153,1217759349,2,2,196
22326950@N05,935,9,1217759349,1217760249,3,2,900
22326950@N05,936,13,1217987856,1217988936,2,1,1080
22351148@N02,937,9,1205995505,1205996405,2,1,900
22375931@N03,938,10,1298587350,1298588250,3,1,900
22404194@N03,939,11,1370922425,1370923385,1,1,960
22423587@N03,940,8,1284811131,1284811971,1,1,840
22423587@N03,941,3,1297501928,1297502258,2,2,330
22423587@N03,941,8,1297504459,1297505299,1,2,840
22423587@N03,942,11,1299220996,1299221806,2,2,810
22423587@N03,942,17,1299221806,1299224506,1,2,2700
22423587@N03,943,11,1301026997,1301027957,1,1,960
22423587@N03,944,1,1308468044,1308468284,1,1,240
22423587@N03,945,6,1319879649,1319880369,1,1,720
22423587@N03,946,15,1323503064,1323504264,1,1,1200
22423587@N03,947,8,1323576424,1323577264,1,1,840
22423587@N03,948,13,1324785035,1324786115,1,1,1080
22423587@N03,949,1,1412392173,1412392413,1,1,240
22446827@N02,950,11,1401152416,1401153376,1,1,960
22446827@N02,951,5,1401185103,1401185523,2,1,420
22462637@N00,952,11,1301636752,1301637712,1,1,960
22474934@N00,953,5,1382521214,1382521634,5,2,420
22474934@N00,953,11,1382530175,1382531135,8,2,960
22496843@N03,954,1,1207890107,1207890347,5,2,240
22496843@N03,954,13,1207906506,1207907586,2,2,1080
22500161@N06,955,11,1332455321,1332456281,1,1,960
22575554@N05,956,13,1378788354,1378789434,1,1,1080
22575554@N05,957,11,1410385710,1410386670,1,1,960
22585033@N00,958,11,1371768119,1371769079,1,1,960
22602665@N02,959,11,1358191083,1358192043,11,1,960
22602665@N02,960,11,1358283502,1358284462,50,1,960
22616926@N08,961,13,1198724752,1198725832,1,1,1080
22618933@N08,962,16,1309842993,1309845093,1,1,2100
22629506@N00,963,10,1222395227,1222396127,4,1,900
22629506@N00,964,10,1222479665,1222480565,1,1,900
22659528@N06,965,2,1347412787,1347413027,2,2,240
22659528@N06,965,11,1347421712,1347422672,2,2,960
22659528@N06,966,2,1348041637,1348041877,2,2,240
22659528@N06,966,11,1348054342,1348055302,1,2,960
22659528@N06,967,11,1348297411,1348298371,1,1,960
22659528@N06,968,2,1348397172,1348397412,1,1,240
22659528@N06,969,11,1402272824,1402273784,1,1,960
22659528@N06,970,13,1402479440,1402480520,1,1,1080
22659528@N06,971,9,1403747105,1403748005,2,1,900
22659528@N06,972,13,1403865188,1403866268,1,1,1080
22659528@N06,973,13,1404720538,1404721618,1,1,1080
22659528@N06,974,13,1405246240,1405247320,2,2,1080
22659528@N06,974,5,1405248283,1405248703,1,2,420
22659528@N06,975,4,1405760271,1405760631,1,1,360
22659528@N06,976,11,1407049645,1407050605,4,1,960
22659528@N06,977,11,1407209256,1407210216,1,1,960
22659528@N06,978,11,1407479421,1407480381,3,1,960
22659528@N06,979,11,1409471582,1409472542,1,1,960
22687691@N02,980,10,1194244960,1194245860,1,1,900
22687691@N02,981,1,1209039696,1209039936,2,1,240
22687691@N02,982,16,1213011114,1213013214,1,1,2100
22687691@N02,983,11,1225512006,1225512966,4,4,960
22687691@N02,983,16,1225517779,1225519879,2,4,2100
22687691@N02,983,8,1225521498,1225522338,4,4,840
22687691@N02,983,12,1225531349,1225532369,2,4,1020
22687691@N02,984,11,1225846633,1225847593,1,1,960
22720103@N06,985,11,1346150611,1346151571,1,1,960
22720103@N06,986,8,1349010283,1349011123,3,1,840
22741934@N04,987,8,1347182018,1347182858,4,1,840
22772553@N05,988,4,1213093046,1213093406,1,1,360
22786107@N06,989,16,1206927990,1206930090,2,1,2100
22791773@N07,990,11,1280011494,1280012454,2,3,960
22791773@N07,990,7,1280015311,1280016151,2,3,840
22791773@N07,990,10,1280027815,1280028715,1,3,900
22802028@N08,991,2,1209725055,1209725295,3,3,240
22802028@N08,991,4,1209729839,1209730199,2,3,360
22802028@N08,991,11,1209733017,1209733977,5,3,960
22802028@N08,992,15,1209884680,1209885880,3,1,1200
22802028@N08,993,11,1209960915,1209961875,4,3,960
22802028@N08,993,1,1209968096,1209968336,2,3,240
22802028@N08,993,5,1209970862,1209971282,6,3,420
22810906@N06,994,11,1324734341,1324735301,1,1,960
22854594@N07,995,11,1380162425,1380163385,2,2,960
22854594@N07,995,5,1380183302,1380183722,2,2,420
22866792@N00,996,5,1291590060,1291590480,6,5,420
22866792@N00,996,8,1291592318,1291593158,2,5,840
22866792@N00,996,13,1291610960,1291612040,3,5,1080
22866792@N00,996,17,1291612145,1291612347,2,5,202
22866792@N00,996,10,1291612347,1291613247,1,5,900
22866792@N00,997,11,1291685430,1291686390,3,6,960
22866792@N00,997,12,1291690482,1291691502,2,6,1020
22866792@N00,997,2,1291696066,1291696306,3,6,240
22866792@N00,997,12,1291696548,1291697568,2,6,1020
22866792@N00,997,11,1291699065,1291700025,2,6,960
22866792@N00,997,4,1291702990,1291703350,1,6,360
22925214@N04,998,3,1419908713,1419909043,1,1,330
22937808@N04,999,10,1368226985,1368227885,1,1,900
22937808@N04,1000,8,1430826630,1430827470,2,2,840
22937808@N04,1000,11,1430829360,1430830320,1,2,960
22937808@N04,1001,11,1430962164,1430963124,1,1,960
22937808@N04,1002,11,1431002057,1431003017,1,1,960
22937808@N04,1003,8,1462265196,1462266036,1,1,840
22966062@N04,1004,11,1198547602,1198548562,3,2,960
22966062@N04,1004,15,1198562772,1198563972,2,2,1200
22969152@N05,1005,11,1389579970,1389580930,1,1,960
23012921@N08,1006,11,1323837067,1323838027,1,1,960
23025449@N05,1007,11,1255821076,1255822036,2,3,960
23025449@N05,1007,8,1255837383,1255838223,2,3,840
23025449@N05,1007,17,1255861665,1255864365,1,3,2700
23028801@N03,1008,11,1348898318,1348899278,3,2,960
23028801@N03,1008,8,1348912800,1348913640,1,2,840
23028801@N03,1009,11,1349591631,1349592591,2,2,960
23028801@N03,1009,4,1349594474,1349594834,5,2,360
23036992@N08,1010,11,1264926197,1264927157,2,3,960
23036992@N08,1010,13,1264927726,1264928093,2,3,367
23036992@N08,1010,10,1264928093,1264928993,3,3,900
23036992@N08,1011,9,1265155500,1265156400,2,2,900
23036992@N08,1011,10,1265159526,1265160426,1,2,900
23043254@N03,1012,9,1208048719,1208049619,2,2,900
23043254@N03,1012,17,1208062114,1208064814,1,2,2700
23071450@N02,1013,10,1287962810,1287963710,1,1,900
23074913@N00,1014,5,1338431115,1338431535,1,1,420
23108813@N00,1015,2,1226226752,1226226992,3,2,240
23108813@N00,1015,16,1226230628,1226232728,1,2,2100
23108813@N00,1016,14,1237680628,1237681828,1,1,1200
23108813@N00,1017,14,1256634452,1256635652,1,1,1200
23108813@N00,1018,17,1286600988,1286603688,1,1,2700
23108813@N00,1019,10,1287020401,1287021301,1,1,900
23108813@N00,1020,5,1288322746,1288323166,1,1,420
23108813@N00,1021,17,1288925793,1288928493,1,1,2700
23108813@N00,1022,12,1290834872,1290835892,1,1,1020
23108813@N00,1023,11,1296812989,1296813949,1,1,960
23108813@N00,1024,14,1302919381,1302920581,1,1,1200
23108813@N00,1025,11,1305241416,1305242376,1,1,960
23108813@N00,1026,9,1305959577,1305960477,1,1,900
23108813@N00,1027,11,1337312950,1337313910,1,1,960
23108813@N00,1028,11,1349571153,1349572113,1,1,960
23108813@N00,1029,1,1354695709,1354695949,1,1,240
23108813@N00,1030,11,1375851879,1375852839,1,1,960
23108813@N00,1031,17,1383364881,1383367581,1,1,2700
23108813@N00,1032,7,1390007715,1390008555,1,1,840
23108813@N00,1033,13,1398940682,1398941762,1,1,1080
23108813@N00,1034,4,1417771457,1417771817,1,1,360
23108813@N00,1035,4,1432503631,1432503991,1,1,360
23108813@N00,1036,6,1447310493,1447311213,1,1,720
23108813@N00,1037,11,1451115613,1451116573,1,1,960
23108813@N00,1038,11,1459247949,1459248909,1,1,960
23108813@N00,1039,11,1462848534,1462849494,1,1,960
23108813@N00,1040,17,1463116584,1463119284,1,1,2700
23117061@N05,1041,8,1331373509,1331374349,2,1,840
23126267@N02,1042,3,1411100441,1411100771,1,1,330
23172783@N07,1043,15,1343377424,1343377610,2,2,186
23172783@N07,1043,13,1343377610,1343378690,1,2,1080
23172783@N07,1044,15,1344131345,1344132545,2,1,1200
23172783@N07,1045,11,1376042094,1376043054,2,3,960
23172783@N07,1045,3,1376044159,1376044489,2,3,330
23172783@N07,1045,5,1376046757,1376047177,1,3,420
23198304@N02,1046,13,1193276242,1193277322,1,1,1080
23205379@N02,1047,11,1400973202,1400974162,2,5,960
23205379@N02,1047,13,1400988603,1400989683,3,5,1080
23205379@N02,1047,17,1400996196,1400998896,2,5,2700
23205379@N02,1047,13,1401001904,1401002984,2,5,1080
23205379@N02,1047,11,1401010141,1401011101,1,5,960
23205379@N02,1048,13,1408850804,1408851884,1,1,1080
23207003@N05,1049,11,1464312675,1464313635,5,8,960
23207003@N05,1049,10,1464317134,1464317246,3,8,112
23207003@N05,1049,17,1464317246,1464319946,6,8,2700
23207003@N05,1049,10,1464320917,1464321817,3,8,900
23207003@N05,1049,15,1464322959,1464323102,2,8,143
23207003@N05,1049,13,1464323102,1464324182,3,8,1080
23207003@N05,1049,8,1464326303,1464327143,7,8,840
23207003@N05,1049,1,1464333666,1464333906,1,8,240
23209784@N00,1050,5,1439094661,1439095081,1,1,420
23212779@N04,1051,3,1287904317,1287904647,2,2,330
23212779@N04,1051,11,1287908124,1287909084,1,2,960
23212779@N04,1052,4,1291782197,1291782557,1,1,360
23212779@N04,1053,4,1299055399,1299055759,2,3,360
23212779@N04,1053,8,1299057829,1299058669,2,3,840
23212779@N04,1053,11,1299059712,1299060672,2,3,960
23212779@N04,1054,1,1299125539,1299125779,1,1,240
23212779@N04,1055,11,1300712798,1300713758,1,1,960
23212779@N04,1056,11,1308666977,1308667937,1,1,960
23212779@N04,1057,4,1318564859,1318565219,1,1,360
23212779@N04,1058,11,1348946092,1348947052,1,1,960
23212779@N04,1059,8,1348996136,1348996976,1,1,840
23212779@N04,1060,12,1349043284,1349044304,1,1,1020
23237004@N06,1061,6,1351311642,1351312362,1,1,720
23288611@N00,1062,8,1232249525,1232250365,2,1,840
23304890@N00,1063,8,1283657799,1283658639,1,1,840
23319775@N04,1064,11,1394706939,1394707899,2,5,960
23319775@N04,1064,4,1394710640,1394711000,2,5,360
23319775@N04,1064,15,1394712492,1394713545,2,5,1053
23319775@N04,1064,13,1394713545,1394714625,2,5,1080
23319775@N04,1064,8,1394728018,1394728858,1,5,840
23322134@N02,1065,8,1192836526,1192837366,1,1,840
23322134@N02,1066,11,1201400770,1201401730,2,4,960
23322134@N02,1066,5,1201403182,1201403602,2,4,420
23322134@N02,1066,1,1201406170,1201406410,2,4,240
23322134@N02,1066,4,1201407705,1201408065,1,4,360
23322134@N02,1067,15,1213950896,1213952096,2,2,1200
23322134@N02,1067,11,1213955010,1213955970,1,2,960
23322134@N02,1068,3,1226700368,1226700698,2,13,330
23322134@N02,1068,2,1226702476,1226702716,2,13,240
23322134@N02,1068,12,1226702930,1226703950,2,13,1020
23322134@N02,1068,14,1226705793,1226706993,2,13,1200
23322134@N02,1068,11,1226724325,1226725285,3,13,960
23322134@N02,1068,8,1226736051,1226736891,2,13,840
23322134@N02,1068,5,1226737673,1226738093,2,13,420
23322134@N02,1068,9,1226738845,1226739296,3,13,451
23322134@N02,1068,16,1226739296,1226740679,2,13,1383
23322134@N02,1068,4,1226740679,1226741039,2,13,360
23322134@N02,1068,13,1226745095,1226745572,2,13,477
23322134@N02,1068,10,1226745572,1226746472,2,13,900
23322134@N02,1068,11,1226746902,1226747862,1,13,960
23322134@N02,1069,4,1245382480,1245382840,3,6,360
23322134@N02,1069,2,1245394690,1245394748,2,6,58
23322134@N02,1069,1,1245394748,1245394988,2,6,240
23322134@N02,1069,11,1245395158,1245396118,2,6,960
23322134@N02,1069,5,1245403158,1245403578,3,6,420
23322134@N02,1069,1,1245408477,1245408717,1,6,240
23322134@N02,1070,10,1254437904,1254438804,2,3,900
23322134@N02,1070,9,1254440962,1254441862,2,3,900
23322134@N02,1070,16,1254442884,1254444984,1,3,2100
23322134@N02,1071,11,1254474380,1254475340,1,1,960
23322134@N02,1072,15,1254523014,1254523475,2,5,461
23322134@N02,1072,17,1254523475,1254523777,2,5,302
23322134@N02,1072,10,1254523777,1254524677,2,5,900
23322134@N02,1072,2,1254527867,1254528107,2,5,240
23322134@N02,1072,16,1254530168,1254532268,2,5,2100
23322134@N02,1073,8,1254571614,1254572439,2,2,825
23322134@N02,1073,5,1254572439,1254572859,1,2,420
23322134@N02,1074,13,1267601822,1267602902,2,4,1080
23322134@N02,1074,15,1267613563,1267614227,2,4,664
23322134@N02,1074,17,1267614227,1267614600,2,4,373
23322134@N02,1074,10,1267614600,1267615500,1,4,900
23322134@N02,1075,4,1267743117,1267743477,2,5,360
23322134@N02,1075,8,1267755188,1267756028,3,5,840
23322134@N02,1075,13,1267783242,1267784322,3,5,1080
23322134@N02,1075,1,1267791442,1267791682,2,5,240
23322134@N02,1075,11,1267792395,1267793355,2,5,960
23322134@N02,1076,11,1273358852,1273359812,2,3,960
23322134@N02,1076,5,1273364686,1273365106,2,3,420
23322134@N02,1076,4,1273382441,1273382801,1,3,360
23322134@N02,1077,5,1287103909,1287104329,1,1,420
23322134@N02,1078,17,1291504430,1291507130,2,1,2700
23322134@N02,1079,2,1291588966,1291589206,4,5,240
23322134@N02,1079,11,1291594176,1291595136,2,5,960
23322134@N02,1079,8,1291596849,1291597689,2,5,840
23322134@N02,1079,11,1291612075,1291613035,2,5,960
23322134@N02,1079,8,1291615189,1291616029,2,5,840
23322134@N02,1080,8,1301384369,1301385209,1,1,840
23322134@N02,1081,11,1310365073,1310366033,1,1,960
23322134@N02,1082,11,1331154092,1331155052,1,1,960
23322134@N02,1083,11,1331203131,1331204091,1,1,960
23385595@N07,1084,11,1331078712,1331079672,19,1,960
23400884@N07,1085,5,1237416064,1237416484,1,1,420
23400894@N08,1086,11,1419419050,1419420010,1,1,960
23429318@N00,1087,17,1317502884,1317505584,2,3,2700
23429318@N00,1087,8,1317506198,1317507038,3,3,840
23429318@N00,1087,5,1317513681,1317514101,1,3,420
23531496@N02,1088,8,1291012861,1291013701,1,1,840
23567711@N06,1089,11,1368086457,1368087417,1,1,960
23573205@N05,1090,14,1279153356,1279154556,9,4,1200
23573205@N05,1090,3,1279159066,1279159396,17,4,330
23573205@N05,1090,11,1279160532,1279161492,4,4,960
23573205@N05,1090,2,1279168240,1279168480,3,4,240
23604805@N07,1091,17,1300322934,1300325634,3,4,2700
23604805@N07,1091,10,1300326331,1300327231,2,4,900
23604805@N07,1091,5,1300330268,1300330688,2,4,420
23604805@N07,1091,8,1300332920,1300333760,1,4,840
23604805@N07,1092,11,1331940452,1331941412,2,3,960
23604805@N07,1092,17,1331942963,1331945663,2,3,2700
23604805@N07,1092,5,1331946662,1331947082,1,3,420
23621391@N00,1093,8,1212714542,1212715382,2,1,840
23673310@N02,1094,12,1200271572,1200272592,20,4,1020
23673310@N02,1094,11,1200278478,1200279438,15,4,960
23673310@N02,1094,5,1200288879,1200289299,16,4,420
23673310@N02,1094,8,1200290637,1200291477,3,4,840
23673310@N02,1095,10,1200463235,1200464135,3,2,900
23673310@N02,1095,13,1200466501,1200467581,1,2,1080
23673310@N02,1096,15,1202113188,1202114388,1,1,1200
23673310@N02,1097,4,1209286481,1209286841,2,1,360
23673310@N02,1098,16,1213685489,1213687589,2,5,2100
23673310@N02,1098,6,1213692057,1213692777,2,5,720
23673310@N02,1098,13,1213698327,1213699407,2,5,1080
23673310@N02,1098,6,1213700651,1213701371,7,5,720
23673310@N02,1098,1,1213706624,1213706864,1,5,240
23673310@N02,1099,14,1292020528,1292021728,2,2,1200
23673310@N02,1099,12,1292023073,1292024093,1,2,1020
23673310@N02,1100,17,1292056716,1292059416,3,2,2700
23673310@N02,1100,6,1292059530,1292060250,2,2,720
23673310@N02,1101,11,1292708846,1292709806,4,8,960
23673310@N02,1101,12,1292720092,1292721112,2,8,1020
23673310@N02,1101,11,1292723602,1292724562,7,8,960
23673310@N02,1101,8,1292738119,1292738959,2,8,840
23673310@N02,1101,5,1292740075,1292740495,11,8,420
23673310@N02,1101,11,1292742381,1292743341,4,8,960
23673310@N02,1101,15,1292746689,1292747889,6,8,1200
23673310@N02,1101,10,1292750263,1292751163,7,8,900
23673310@N02,1102,16,1304210517,1304210700,3,10,183
23673310@N02,1102,11,1304210700,1304211660,3,10,960
23673310@N02,1102,12,1304213269,1304214289,2,10,1020
23673310@N02,1102,4,1304215521,1304215881,3,10,360
23673310@N02,1102,11,1304217951,1304218911,3,10,960
23673310@N02,1102,5,1304234859,1304235279,4,10,420
23673310@N02,1102,8,1304236605,1304237445,2,10,840
23673310@N02,1102,6,1304238546,1304239266,4,10,720
23673310@N02,1102,13,1304243073,1304244153,5,10,1080
23673310@N02,1102,17,1304245479,1304248179,2,10,2700
23673310@N02,1103,12,1339285443,1339286463,3,3,1020
23673310@N02,1103,11,1339288137,1339289097,6,3,960
23673310@N02,1103,16,1339291238,1339293338,4,3,2100
23679036@N04,1104,11,1412389134,1412390094,1,1,960
23681262@N02,1105,11,1222431691,1222432651,1,1,960
23684642@N08,1106,4,1253063730,1253064090,2,2,360
23684642@N08,1106,17,1253067903,1253070603,1,2,2700
23684642@N08,1107,11,1254398021,1254398981,1,1,960
23684642@N08,1108,17,1254566607,1254569307,1,1,2700
23684642@N08,1109,11,1255427926,1255428631,2,2,705
23684642@N08,1109,17,1255428631,1255431331,1,2,2700
23684642@N08,1110,10,1260935341,1260936043,4,4,702
23684642@N08,1110,15,1260936043,1260937243,2,4,1200
23684642@N08,1110,13,1260938289,1260939369,4,4,1080
23684642@N08,1110,5,1260960396,1260960816,1,4,420
23684642@N08,1111,16,1261104490,1261105886,2,2,1396
23684642@N08,1111,5,1261105886,1261106306,1,2,420
23684642@N08,1112,1,1264407145,1264407385,1,1,240
23684642@N08,1113,5,1271821380,1271821800,2,3,420
23684642@N08,1113,8,1271822017,1271822857,2,3,840
23684642@N08,1113,17,1271829431,1271832131,2,3,2700
23684642@N08,1114,11,1272088987,1272089947,2,4,960
23684642@N08,1114,8,1272092001,1272092841,2,4,840
23684642@N08,1114,5,1272093749,1272094169,2,4,420
23684642@N08,1114,11,1272097963,1272098923,1,4,960
23684642@N08,1115,3,1275532233,1275532563,2,1,330
23684642@N08,1116,6,1284770030,1284770750,1,1,720
23684642@N08,1117,13,1285060082,1285061162,2,2,1080
23684642@N08,1117,5,1285070726,1285071146,1,2,420
23684642@N08,1118,17,1285231162,1285233862,10,3,2700
23684642@N08,1118,10,1285237789,1285237948,2,3,159
23684642@N08,1118,17,1285237948,1285240648,3,3,2700
23684642@N08,1119,17,1288078166,1288080866,1,1,2700
23693999@N05,1120,1,1224905921,1224906161,1,1,240
23693999@N05,1121,2,1224979053,1224979293,2,3,240
23693999@N05,1121,8,1224986855,1224987695,2,3,840
23693999@N05,1121,16,1224992283,1224994383,1,3,2100
23693999@N05,1122,4,1243048722,1243049082,1,1,360
23693999@N05,1123,4,1346113033,1346113393,1,1,360
23693999@N05,1124,2,1346405137,1346405377,1,1,240
23693999@N05,1125,8,1346661970,1346662152,2,2,182
23693999@N05,1125,2,1346662152,1346662392,1,2,240
23701913@N04,1126,5,1442886108,1442886528,2,2,420
23701913@N04,1126,13,1442900355,1442901435,6,2,1080
23716112@N06,1127,10,1254140040,1254140940,1,1,900
23716112@N06,1128,1,1408383057,1408383181,2,5,124
23716112@N06,1128,4,1408383181,1408383243,2,5,62
23716112@N06,1128,3,1408383243,1408383573,2,5,330
23716112@N06,1128,17,1408400209,1408400262,2,5,53
23716112@N06,1128,13,1408400262,1408401342,1,5,1080
23720661@N08,1129,11,1244419246,1244420206,4,4,960
23720661@N08,1129,3,1244421292,1244421622,2,4,330
23720661@N08,1129,4,1244423999,1244424359,2,4,360
23720661@N08,1129,8,1244428364,1244429204,2,4,840
23720661@N08,1130,16,1244598804,1244600904,1,1,2100
23720661@N08,1131,9,1244871931,1244872831,3,2,900
23720661@N08,1131,1,1244884444,1244884684,1,2,240
23720661@N08,1132,4,1245040371,1245040731,2,5,360
23720661@N08,1132,10,1245048033,1245048933,7,5,900
23720661@N08,1132,17,1245049232,1245050174,2,5,942
23720661@N08,1132,13,1245050174,1245051254,3,5,1080
23720661@N08,1132,6,1245055109,1245055829,1,5,720
23720661@N08,1133,5,1245129473,1245129893,2,2,420
23720661@N08,1133,16,1245131645,1245133745,1,2,2100
23720661@N08,1134,10,1262573601,1262574501,2,6,900
23720661@N08,1134,16,1262580741,1262582841,3,6,2100
23720661@N08,1134,9,1262584273,1262585173,3,6,900
23720661@N08,1134,5,1262586230,1262586650,2,6,420
23720661@N08,1134,4,1262590444,1262590804,2,6,360
23720661@N08,1134,11,1262594921,1262595881,2,6,960
23720661@N08,1135,11,1262828786,1262829746,2,3,960
23720661@N08,1135,5,1262830265,1262830685,2,3,420
23720661@N08,1135,8,1262832801,1262833641,1,3,840
23720661@N08,1136,17,1275024772,1275024914,2,3,142
23720661@N08,1136,10,1275024914,1275025814,2,3,900
23720661@N08,1136,4,1275030417,1275030777,1,3,360
23720661@N08,1137,13,1275095164,1275096244,2,4,1080
23720661@N08,1137,8,1275100379,1275101219,2,4,840
23720661@N08,1137,5,1275101429,1275101849,3,4,420
23720661@N08,1137,1,1275103038,1275103278,1,4,240
23720661@N08,1138,15,1275354678,1275354696,2,3,18
23720661@N08,1138,17,1275354696,1275357396,2,3,2700
23720661@N08,1138,3,1275374940,1275375270,1,3,330
23720661@N08,1139,10,1275540416,1275541316,1,1,900
23720661@N08,1140,11,1275724812,1275725772,2,4,960
23720661@N08,1140,3,1275727690,1275728020,2,4,330
23720661@N08,1140,4,1275729190,1275729550,2,4,360
23720661@N08,1140,5,1275735028,1275735448,1,4,420
23720661@N08,1141,11,1306991129,1306992089,2,4,960
23720661@N08,1141,10,1306993453,1306994353,5,4,900
23720661@N08,1141,5,1307002235,1307002655,3,4,420
23720661@N08,1141,11,1307003216,1307004176,3,4,960
23720661@N08,1142,11,1307143818,1307144373,5,8,555
23720661@N08,1142,16,1307144373,1307146473,4,8,2100
23720661@N08,1142,9,1307147170,1307148070,4,8,900
23720661@N08,1142,1,1307149347,1307149587,2,8,240
23720661@N08,1142,14,1307151000,1307151046,2,8,46
23720661@N08,1142,3,1307151046,1307151376,2,8,330
23720661@N08,1142,1,1307152908,1307153148,10,8,240
23720661@N08,1142,11,1307156688,1307157648,3,8,960
23720661@N08,1143,15,1307404332,1307405532,5,3,1200
23720661@N08,1143,5,1307406209,1307406629,4,3,420
23720661@N08,1143,8,1307407336,1307408176,3,3,840
23720661@N08,1144,3,1330927176,1330927506,3,4,330
23720661@N08,1144,1,1330928442,1330928682,3,4,240
23720661@N08,1144,5,1330930422,1330930842,2,4,420
23720661@N08,1144,11,1330934132,1330935092,2,4,960
23720661@N08,1145,11,1331164340,1331165300,8,9,960
23720661@N08,1145,16,1331166530,1331166787,4,9,257
23720661@N08,1145,9,1331166787,1331166799,2,9,12
23720661@N08,1145,16,1331166799,1331168899,12,9,2100
23720661@N08,1145,3,1331175488,1331175818,7,9,330
23720661@N08,1145,2,1331176740,1331176841,2,9,101
23720661@N08,1145,4,1331176841,1331177201,3,9,360
23720661@N08,1145,2,1331178477,1331178717,4,9,240
23720661@N08,1145,1,1331181558,1331181798,2,9,240
23720661@N08,1146,10,1331337324,1331338224,13,6,900
23720661@N08,1146,17,1331341557,1331341958,2,6,401
23720661@N08,1146,10,1331341958,1331342858,5,6,900
23720661@N08,1146,13,1331348254,1331349334,6,6,1080
23720661@N08,1146,3,1331355464,1331355794,2,6,330
23720661@N08,1146,4,1331357193,1331357553,1,6,360
23720661@N08,1147,11,1369292688,1369293648,7,5,960
23720661@N08,1147,3,1369296358,1369296688,5,5,330
23720661@N08,1147,9,1369300576,1369300864,2,5,288
23720661@N08,1147,1,1369300864,1369301104,2,5,240
23720661@N08,1147,11,1369301321,1369302281,4,5,960
23720661@N08,1148,11,1369360652,1369361612,5,10,960
23720661@N08,1148,10,1369363919,1369364819,7,10,900
23720661@N08,1148,17,1369366249,1369366653,2,10,404
23720661@N08,1148,13,1369366653,1369367733,3,10,1080
23720661@N08,1148,5,1369374405,1369374746,3,10,341
23720661@N08,1148,1,1369374746,1369374842,2,10,96
23720661@N08,1148,5,1369374842,1369375262,2,10,420
23720661@N08,1148,1,1369380475,1369380715,3,10,240
23720661@N08,1148,16,1369384336,1369384836,2,10,500
23720661@N08,1148,11,1369384836,1369385796,2,10,960
23720661@N08,1149,11,1369622285,1369623245,13,5,960
23720661@N08,1149,5,1369625484,1369625904,2,5,420
23720661@N08,1149,8,1369628346,1369629186,5,5,840
23720661@N08,1149,17,1369635188,1369637888,2,5,2700
23720661@N08,1149,3,1369637935,1369638265,1,5,330
23720661@N08,1150,15,1369803795,1369804995,18,3,1200
23720661@N08,1150,5,1369808671,1369808679,2,3,8
23720661@N08,1150,17,1369808679,1369811379,2,3,2700
23720661@N08,1151,13,1370052888,1370053968,3,6,1080
23720661@N08,1151,3,1370055134,1370055464,5,6,330
23720661@N08,1151,16,1370060190,1370062290,4,6,2100
23720661@N08,1151,9,1370062724,1370063624,5,6,900
23720661@N08,1151,16,1370064695,1370064708,2,6,13
23720661@N08,1151,9,1370064708,1370065608,1,6,900
23722651@N05,1152,11,1457331666,1457332626,1,1,960
23724661@N00,1153,10,1299365829,1299366729,1,1,900
23748789@N02,1154,6,1383376236,1383376956,1,1,720
23748789@N02,1155,10,1411643090,1411643990,1,1,900
23748789@N02,1156,8,1412065604,1412066444,1,1,840
23764040@N08,1157,11,1460260828,1460261788,1,1,960
23828731@N02,1158,11,1226284005,1226284965,2,5,960
23828731@N02,1158,9,1226294687,1226294721,2,5,34
23828731@N02,1158,1,1226294721,1226294754,3,5,33
23828731@N02,1158,9,1226294754,1226295654,2,5,900
23828731@N02,1158,11,1226307395,1226308355,1,5,960
23828731@N02,1159,11,1340608845,1340608874,4,4,29
23828731@N02,1159,16,1340608874,1340608878,2,4,4
23828731@N02,1159,1,1340608878,1340608956,3,4,78
23828731@N02,1159,11,1340608956,1340609916,3,4,960
23828731@N02,1160,11,1349069127,1349070087,2,4,960
23828731@N02,1160,17,1349072624,1349072773,3,4,149
23828731@N02,1160,13,1349072773,1349073471,2,4,698
23828731@N02,1160,8,1349073471,1349074311,1,4,840
23828731@N02,1161,4,1367455487,1367455529,2,2,42
23828731@N02,1161,7,1367455529,1367456369,2,2,840
23828731@N02,1162,1,1367920694,1367920934,2,2,240
23828731@N02,1162,10,1367924738,1367925638,8,2,900
23833168@N04,1163,11,1222578677,1222579637,2,20,960
23833168@N04,1163,1,1222580362,1222580468,2,20,106
23833168@N04,1163,9,1222580468,1222580537,2,20,69
23833168@N04,1163,16,1222580537,1222582637,3,20,2100
23833168@N04,1163,11,1222582795,1222583755,5,20,960
23833168@N04,1163,1,1222585121,1222585283,2,20,162
23833168@N04,1163,16,1222585283,1222587383,3,20,2100
23833168@N04,1163,14,1222592813,1222594013,7,20,1200
23833168@N04,1163,5,1222598325,1222598559,5,20,234
23833168@N04,1163,4,1222598559,1222598601,2,20,42
23833168@N04,1163,5,1222598601,1222598612,3,20,11
23833168@N04,1163,4,1222598612,1222598640,2,20,28
23833168@N04,1163,5,1222598640,1222599060,13,20,420
23833168@N04,1163,8,1222600114,1222600954,22,20,840
23833168@N04,1163,13,1222602114,1222602447,2,20,333
23833168@N04,1163,6,1222602447,1222603167,2,20,720
23833168@N04,1163,14,1222603880,1222604109,4,20,229
23833168@N04,1163,8,1222604109,1222604949,5,20,840
23833168@N04,1163,6,1222605933,1222606189,5,20,256
23833168@N04,1163,10,1222606189,1222607089,10,20,900
23833168@N04,1164,11,1222998880,1222999129,3,15,249
23833168@N04,1164,2,1222999129,1222999369,3,15,240
23833168@N04,1164,12,1222999429,1223000449,39,15,1020
23833168@N04,1164,2,1223001463,1223001548,3,15,85
23833168@N04,1164,7,1223001548,1223001945,2,15,397
23833168@N04,1164,15,1223001945,1223002036,2,15,91
23833168@N04,1164,17,1223002036,1223002169,3,15,133
23833168@N04,1164,13,1223002169,1223003249,2,15,1080
23833168@N04,1164,8,1223009065,1223009905,9,15,840
23833168@N04,1164,1,1223012143,1223012383,3,15,240
23833168@N04,1164,9,1223013103,1223013841,3,15,738
23833168@N04,1164,16,1223013841,1223015941,2,15,2100
23833168@N04,1164,11,1223016048,1223017008,7,15,960
23833168@N04,1164,6,1223023011,1223023731,8,15,720
23833168@N04,1164,13,1223036435,1223037515,1,15,1080
23833168@N04,1165,17,1223270868,1223271059,4,3,191
23833168@N04,1165,15,1223271059,1223272259,10,3,1200
23833168@N04,1165,7,1223275629,1223276469,6,3,840
23833168@N04,1166,11,1354445582,1354446365,3,5,783
23833168@N04,1166,2,1354446365,1354446605,21,5,240
23833168@N04,1166,3,1354447697,1354448027,6,5,330
23833168@N04,1166,4,1354455093,1354455453,26,5,360
23833168@N04,1166,11,1354459609,1354460569,2,5,960
23833168@N04,1167,15,1354946593,1354947793,4,2,1200
23833168@N04,1167,5,1354949118,1354949538,35,2,420
23833168@N04,1168,8,1355133393,1355134233,2,1,840
23833168@N04,1169,8,1355222141,1355222981,6,2,840
23833168@N04,1169,13,1355223928,1355225008,8,2,1080
23833168@N04,1170,13,1355540495,1355541575,5,3,1080
23833168@N04,1170,5,1355544153,1355544573,2,3,420
23833168@N04,1170,8,1355545237,1355546077,3,3,840
23942903@N00,1171,11,1326429590,1326430550,1,1,960
23942903@N00,1172,3,1326760698,1326761028,10,4,330
23942903@N00,1172,15,1326780275,1326780515,2,4,240
23942903@N00,1172,13,1326780515,1326781595,5,4,1080
23942903@N00,1172,11,1326789147,1326790107,1,4,960
23942903@N00,1173,16,1326944898,1326946998,1,1,2100
23953488@N03,1174,1,1226648555,1226648795,2,1,240
24021297@N00,1175,11,1338607025,1338607985,1,1,960
24021297@N00,1176,9,1343463899,1343464799,2,2,900
24021297@N00,1176,11,1343471972,1343472932,3,2,960
24021297@N00,1177,15,1350357135,1350358335,1,1,1200
24021297@N00,1178,17,1355542085,1355542143,2,4,58
24021297@N00,1178,11,1355542143,1355543103,2,4,960
24021297@N00,1178,1,1355545011,1355545251,2,4,240
24021297@N00,1178,4,1355545644,1355546004,1,4,360
24021297@N00,1179,1,1402227518,1402227758,1,1,240
24048284@N02,1180,11,1203846269,1203847229,24,1,960
24048284@N02,1181,11,1205141706,1205141801,4,9,95
24048284@N02,1181,15,1205141801,1205142110,4,9,309
24048284@N02,1181,1,1205142110,1205142247,6,9,137
24048284@N02,1181,16,1205142247,1205142300,3,9,53
24048284@N02,1181,11,1205142300,1205142574,6,9,274
24048284@N02,1181,2,1205142574,1205142576,2,9,2
24048284@N02,1181,11,1205142576,1205142668,2,9,92
24048284@N02,1181,4,1205142668,1205142700,3,9,32
24048284@N02,1181,11,1205142700,1205143660,2,9,960
24083444@N03,1182,5,1299383243,1299383663,1,1,420
24143798@N08,1183,11,1193528995,1193529955,2,2,960
24143798@N08,1183,8,1193539378,1193540218,2,2,840
24143798@N08,1184,9,1207463364,1207463392,2,5,28
24143798@N08,1184,8,1207463392,1207463410,3,5,18
24143798@N08,1184,17,1207463410,1207463422,3,5,12
24143798@N08,1184,2,1207463422,1207463433,3,5,11
24143798@N08,1184,11,1207463433,1207464393,1,5,960
24143798@N08,1185,11,1320455022,1320455982,3,4,960
24143798@N08,1185,8,1320458404,1320459244,4,4,840
24143798@N08,1185,13,1320465477,1320466557,14,4,1080
24143798@N08,1185,11,1320471006,1320471966,25,4,960
24143798@N08,1186,11,1393649566,1393650526,1,1,960
24143798@N08,1187,13,1394852379,1394853459,1,1,1080
24143798@N08,1188,17,1401105070,1401107770,1,1,2700
24143798@N08,1189,11,1409980246,1409981206,12,4,960
24143798@N08,1189,10,1409982384,1409983284,2,4,900
24143798@N08,1189,13,1410005615,1410006615,2,4,1000
24143798@N08,1189,11,1410006615,1410007575,4,4,960
24143798@N08,1190,3,1422674600,1422674930,2,2,330
24143798@N08,1190,8,1422686726,1422687566,1,2,840
24166619@N05,1191,11,1199515290,1199516250,2,1,960
24201217@N08,1192,11,1371177586,1371178546,2,2,960
24201217@N08,1192,5,1371183143,1371183563,1,2,420
24230954@N06,1193,11,1265494579,1265495539,1,1,960
24230954@N06,1194,11,1265588794,1265589754,2,2,960
24230954@N06,1194,5,1265596088,1265596508,1,2,420
24230954@N06,1195,2,1266020451,1266020691,1,1,240
24232695@N00,1196,2,1325469599,1325469839,3,5,240
24232695@N00,1196,15,1325473196,1325474396,6,5,1200
24232695@N00,1196,17,1325474506,1325474611,2,5,105
24232695@N00,1196,6,1325474611,1325475331,3,5,720
24232695@N00,1196,1,1325482025,1325482265,1,5,240
24276365@N03,1197,11,1387955308,1387956268,1,1,960
24301080@N07,1198,11,1198759940,1198760900,1,1,960
24332304@N08,1199,4,1265361008,1265361368,1,1,360
24345053@N06,1200,11,1290649312,1290650272,2,2,960
24345053@N06,1200,13,1290660423,1290661503,1,2,1080
24364325@N00,1201,11,1462358231,1462359131,2,2,900
24364325@N00,1201,5,1462359131,1462359551,1,2,420
24364447@N05,1202,11,1438861284,1438862244,1,1,960
24364723@N08,1203,5,1349484227,1349484589,4,2,362
24364723@N08,1203,17,1349484589,1349487289,3,2,2700
24364723@N08,1204,11,1382747203,1382748163,7,3,960
24364723@N08,1204,13,1382770748,1382771478,3,3,730
24364723@N08,1204,5,1382771478,1382771898,1,3,420
24372063@N00,1205,11,1447404371,1447405331,2,1,960
24376530@N00,1206,17,1327881532,1327884232,3,2,2700
24376530@N00,1206,13,1327884426,1327885506,1,2,1080
24386268@N05,1207,11,1204247279,1204248239,3,6,960
24386268@N05,1207,2,1204248491,1204248731,2,6,240
24386268@N05,1207,4,1204253762,1204253790,2,6,28
24386268@N05,1207,2,1204253790,1204254030,2,6,240
24386268@N05,1207,17,1204255175,1204257875,2,6,2700
24386268@N05,1207,15,1204262746,1204263946,1,6,1200
24386374@N00,1208,11,1378626531,1378627491,6,1,960
24386374@N00,1209,11,1378691877,1378692837,15,1,960
24435279@N00,1210,11,1198900423,1198901383,3,3,960
24435279@N00,1210,12,1198912861,1198913881,2,3,1020
24435279@N00,1210,16,1198935779,1198937879,1,3,2100
24435279@N00,1211,8,1198995738,1198996578,10,1,840
24435279@N00,1212,10,1199071630,1199072530,1,1,900
24435279@N00,1213,5,1209005818,1209006238,6,2,420
24435279@N00,1213,11,1209017588,1209018548,3,2,960
24435279@N00,1214,1,1209082755,1209082995,3,3,240
24435279@N00,1214,5,1209095220,1209095640,46,3,420
24435279@N00,1214,11,1209105362,1209106322,5,3,960
24435279@N00,1215,10,1224316348,1224317248,3,3,900
24435279@N00,1215,17,1224319070,1224321770,3,3,2700
24435279@N00,1215,11,1224328833,1224329793,12,3,960
24435279@N00,1216,11,1224378201,1224379161,9,3,960
24435279@N00,1216,8,1224395349,1224396189,5,3,840
24435279@N00,1216,11,1224398609,1224399569,4,3,960
24435279@N00,1217,15,1237001566,1237002766,5,1,1200
24435279@N00,1218,14,1239430890,1239432090,11,1,1200
24435279@N00,1219,15,1241175954,1241177154,8,1,1200
24436359@N07,1220,10,1308881034,1308881934,1,1,900
24471842@N04,1221,11,1304548776,1304549736,2,1,960
24481280@N03,1222,11,1235962886,1235963846,2,1,960
24496852@N00,1223,13,1327989055,1327990135,1,1,1080
24508806@N04,1224,8,1345144174,1345145014,1,1,840
24519194@N08,1225,11,1381184220,1381185180,1,1,960
24537422@N02,1226,17,1421057342,1421060042,6,1,2700
24589316@N06,1227,16,1331862302,1331862740,3,6,438
24589316@N06,1227,9,1331862740,1331863030,2,6,290
24589316@N06,1227,16,1331863030,1331865130,2,6,2100
24589316@N06,1227,15,1331868830,1331870030,2,6,1200
24589316@N06,1227,13,1331871426,1331872506,2,6,1080
24589316@N06,1227,16,1331874956,1331877056,1,6,2100
24616128@N00,1228,5,1285924128,1285924548,2,3,420
24616128@N00,1228,15,1285930611,1285930817,2,3,206
24616128@N00,1228,17,1285930817,1285933517,2,3,2700
24616128@N00,1229,1,1285974631,1285974871,3,8,240
24616128@N00,1229,12,1285978831,1285979718,10,8,887
24616128@N00,1229,2,1285979718,1285979958,4,8,240
24616128@N00,1229,12,1285980644,1285981664,23,8,1020
24616128@N00,1229,7,1285984825,1285985665,3,8,840
24616128@N00,1229,13,1285992830,1285993507,3,8,677
24616128@N00,1229,17,1285993507,1285996207,2,8,2700
24616128@N00,1229,5,1286020129,1286020549,1,8,420
24616128@N00,1230,8,1286091872,1286092712,4,4,840
24616128@N00,1230,13,1286097009,1286097643,3,4,634
24616128@N00,1230,15,1286097643,1286098192,3,4,549
24616128@N00,1230,17,1286098192,1286100892,1,4,2700
24626151@N06,1231,11,1445665597,1445666557,1,1,960
24638406@N08,1232,8,1353030281,1353031121,2,2,840
24638406@N08,1232,10,1353036569,1353037469,1,2,900
24638406@N08,1233,15,1377404005,1377405205,1,1,1200
24640659@N05,1234,4,1188348831,1188349191,2,5,360
24640659@N05,1234,5,1188360520,1188360940,3,5,420
24640659@N05,1234,13,1188362469,1188362919,2,5,450
24640659@N05,1234,17,1188362919,1188363713,6,5,794
24640659@N05,1234,2,1188363713,1188363953,3,5,240
24675445@N00,1235,11,1352153382,1352154342,3,3,960
24675445@N00,1235,9,1352158705,1352159605,2,3,900
24675445@N00,1235,2,1352175523,1352175763,1,3,240
24704473@N07,1236,16,1189464206,1189464683,2,12,477
24704473@N07,1236,7,1189464683,1189465523,6,12,840
24704473@N07,1236,4,1189467566,1189467926,10,12,360
24704473@N07,1236,7,1189468265,1189468354,2,12,89
24704473@N07,1236,2,1189468354,1189468594,9,12,240
24704473@N07,1236,12,1189470176,1189471196,10,12,1020
24704473@N07,1236,9,1189472145,1189472413,5,12,268
24704473@N07,1236,1,1189472413,1189472653,5,12,240
24704473@N07,1236,9,1189476223,1189476652,3,12,429
24704473@N07,1236,16,1189476652,1189478752,5,12,2100
24704473@N07,1236,11,1189480410,1189481370,2,12,960
24704473@N07,1236,15,1189496372,1189497572,1,12,1200
24704473@N07,1237,14,1189744253,1189744545,4,10,292
24704473@N07,1237,3,1189744545,1189744875,2,10,330
24704473@N07,1237,4,1189745018,1189745378,4,10,360
24704473@N07,1237,1,1189746494,1189746734,4,10,240
24704473@N07,1237,9,1189747641,1189748541,9,10,900
24704473@N07,1237,16,1189752502,1189752677,4,10,175
24704473@N07,1237,1,1189752677,1189752917,4,10,240
24704473@N07,1237,4,1189754261,1189754621,2,10,360
24704473@N07,1237,5,1189756384,1189756804,9,10,420
24704473@N07,1237,8,1189757849,1189758689,11,10,840
24704473@N07,1238,10,1234080477,1234081377,1,1,900
24704473@N07,1239,16,1234426084,1234428184,1,1,2100
24704473@N07,1240,11,1237615085,1237616045,8,7,960
24704473@N07,1240,3,1237621962,1237621978,2,7,16
24704473@N07,1240,14,1237621978,1237621983,2,7,5
24704473@N07,1240,3,1237621983,1237622313,8,7,330
24704473@N07,1240,1,1237626636,1237626876,16,7,240
24704473@N07,1240,16,1237629394,1237629483,2,7,89
24704473@N07,1240,9,1237629483,1237630383,2,7,900
24704473@N07,1241,7,1237845116,1237845250,3,36,134
24704473@N07,1241,2,1237845250,1237845490,8,36,240
24704473@N07,1241,12,1237846508,1237847429,7,36,921
24704473@N07,1241,2,1237847429,1237847669,5,36,240
24704473@N07,1241,12,1237847886,1237848209,4,36,323
24704473@N07,1241,2,1237848209,1237848395,2,36,186
24704473@N07,1241,12,1237848395,1237849415,9,36,1020
24704473@N07,1241,2,1237849473,1237849713,5,36,240
24704473@N07,1241,7,1237850010,1237850761,3,36,751
24704473@N07,1241,4,1237850761,1237851121,16,36,360
24704473@N07,1241,7,1237855300,1237855496,2,36,196
24704473@N07,1241,3,1237855496,1237855575,2,36,79
24704473@N07,1241,4,1237855575,1237855935,2,36,360
24704473@N07,1241,7,1237857133,1237857543,4,36,410
24704473@N07,1241,16,1237857543,1237858213,2,36,670
24704473@N07,1241,1,1237858213,1237858453,6,36,240
24704473@N07,1241,10,1237858879,1237859028,2,36,149
24704473@N07,1241,1,1237859028,1237859268,6,36,240
24704473@N07,1241,17,1237861982,1237862029,2,36,47
24704473@N07,1241,10,1237862029,1237862929,22,36,900
24704473@N07,1241,17,1237864319,1237864397,3,36,78
24704473@N07,1241,15,1237864397,1237864439,2,36,42
24704473@N07,1241,17,1237864439,1237864581,2,36,142
24704473@N07,1241,15,1237864581,1237865781,5,36,1200
24704473@N07,1241,17,1237867024,1237867097,2,36,73
24704473@N07,1241,15,1237867097,1237867121,2,36,24
24704473@N07,1241,17,1237867121,1237867248,2,36,127
24704473@N07,1241,15,1237867248,1237868448,3,36,1200
24704473@N07,1241,13,1237869206,1237870286,14,36,1080
24704473@N07,1241,10,1237873241,1237873241,2,36,0
24704473@N07,1241,17,1237873241,1237875941,2,36,2700
24704473@N07,1241,10,1237876841,1237877741,2,36,900
24704473@N07,1241,8,1237880253,1237881093,58,36,840
24704473@N07,1241,5,1237883897,1237884317,7,36,420
24704473@N07,1241,1,1237886033,1237886273,2,36,240
24704473@N07,1241,9,1237886289,1237887189,6,36,900
24704473@N07,1242,11,1238135183,1238136143,17,10,960
24704473@N07,1242,2,1238137617,1238137857,2,10,240
24704473@N07,1242,9,1238140802,1238141702,9,10,900
24704473@N07,1242,16,1238143119,1238145219,2,10,2100
24704473@N07,1242,4,1238145365,1238145725,9,10,360
24704473@N07,1242,10,1238149175,1238149380,3,10,205
24704473@N07,1242,17,1238149380,1238152080,4,10,2700
24704473@N07,1242,8,1238154565,1238154990,4,10,425
24704473@N07,1242,5,1238154990,1238155410,2,10,420
24704473@N07,1242,11,1238155994,1238156954,7,10,960
24738911@N08,1243,5,1218263687,1218264107,2,1,420
24738911@N08,1244,8,1223790712,1223791552,2,1,840
24738911@N08,1245,17,1239346742,1239349442,1,1,2700
24738911@N08,1246,8,1310595850,1310596690,1,1,840
24738911@N08,1247,13,1315429428,1315430508,1,1,1080
24745847@N00,1248,17,1362267888,1362270588,5,5,2700
24745847@N00,1248,3,1362275100,1362275430,5,5,330
24745847@N00,1248,14,1362277505,1362278705,5,5,1200
24745847@N00,1248,11,1362278822,1362279782,4,5,960
24745847@N00,1248,9,1362281581,1362282481,3,5,900
24767349@N02,1249,11,1207728728,1207729688,2,2,960
24767349@N02,1249,6,1207738830,1207739550,1,2,720
24793767@N00,1250,11,1358289613,1358290573,1,1,960
24793767@N00,1251,7,1358320230,1358321070,2,2,840
24793767@N00,1251,11,1358323382,1358324342,1,2,960
24834202@N03,1252,5,1216614587,1216615007,1,1,420
24834202@N03,1253,8,1245730240,1245731080,2,2,840
24834202@N03,1253,5,1245738134,1245738554,2,2,420
24834202@N03,1254,15,1245899784,1245900984,1,1,1200
24850040@N07,1255,1,1245059592,1245059832,3,1,240
24850040@N07,1256,11,1245140650,1245141610,4,3,960
24850040@N07,1256,9,1245141857,1245142480,4,3,623
24850040@N07,1256,1,1245142480,1245142720,2,3,240
24850040@N07,1257,9,1249739789,1249740689,1,1,900
24872311@N07,1258,1,1317370876,1317371116,1,1,240
24889779@N03,1259,11,1253087563,1253087570,6,3,7
24889779@N03,1259,1,1253087570,1253087625,13,3,55
24889779@N03,1259,11,1253087625,1253088585,1,3,960
24889779@N03,1260,11,1254718801,1254719761,3,4,960
24889779@N03,1260,9,1254724010,1254724910,3,4,900
24889779@N03,1260,11,1254725753,1254726250,2,4,497
24889779@N03,1260,9,1254726250,1254727150,1,4,900
24889779@N03,1261,11,1254896982,1254897942,1,1,960
24897645@N04,1262,15,1212394450,1212395650,1,1,1200
24897645@N04,1263,8,1215146660,1215147500,1,1,840
24897645@N04,1264,2,1217400139,1217400379,1,1,240
24942535@N08,1265,9,1437988207,1437989107,2,2,900
24942535@N08,1265,11,1437990531,1437991491,2,2,960
24942535@N08,1266,17,1438340331,1438343031,63,1,2700
24965986@N00,1267,9,1310280325,1310281225,1,1,900
25001998@N08,1268,3,1235010541,1235010871,17,1,330
25027171@N08,1269,11,1399936956,1399937916,8,12,960
25027171@N08,1269,3,1399942451,1399942781,6,12,330
25027171@N08,1269,5,1399949488,1399949908,16,12,420
25027171@N08,1269,8,1399950577,1399951417,40,12,840
25027171@N08,1269,13,1399964341,1399965309,20,12,968
25027171@N08,1269,17,1399965309,1399965522,15,12,213
25027171@N08,1269,15,1399965522,1399966249,34,12,727
25027171@N08,1269,17,1399966249,1399968949,35,12,2700
25027171@N08,1269,10,1399973578,1399974478,56,12,900
25027171@N08,1269,17,1399976663,1399979363,2,12,2700
25027171@N08,1269,10,1399979865,1399980610,3,12,745
25027171@N08,1269,11,1399980610,1399981570,5,12,960
25027171@N08,1270,11,1400042408,1400043368,2,5,960
25027171@N08,1270,3,1400043514,1400043844,3,5,330
25027171@N08,1270,13,1400060963,1400062043,39,5,1080
25027171@N08,1270,17,1400063416,1400066116,54,5,2700
25027171@N08,1270,11,1400067028,1400067988,3,5,960
25027171@N08,1271,10,1400132076,1400132976,6,2,900
25027171@N08,1271,17,1400133095,1400135795,3,2,2700
25027171@N08,1272,2,1449278745,1449278985,3,8,240
25027171@N08,1272,14,1449280708,1449280895,4,8,187
25027171@N08,1272,3,1449280895,1449281225,4,8,330
25027171@N08,1272,17,1449295803,1449298503,16,8,2700
25027171@N08,1272,10,1449301693,1449301883,11,8,190
25027171@N08,1272,17,1449301883,1449301905,3,8,22
25027171@N08,1272,10,1449301905,1449302805,5,8,900
25027171@N08,1272,11,1449304900,1449305860,13,8,960
25027171@N08,1273,5,1449367666,1449368086,2,3,420
25027171@N08,1273,4,1449377394,1449377754,5,3,360
25027171@N08,1273,15,1449377774,1449378974,3,3,1200
25027171@N08,1274,11,1449887961,1449888921,2,5,960
25027171@N08,1274,10,1449891322,1449891941,4,5,619
25027171@N08,1274,17,1449891941,1449892559,2,5,618
25027171@N08,1274,15,1449892559,1449893759,6,5,1200
25027171@N08,1274,8,1449904740,1449905580,5,5,840
25027171@N08,1275,11,1449954246,1449955110,7,10,864
25027171@N08,1275,8,1449955110,1449955950,13,10,840
25027171@N08,1275,5,1449960778,1449961198,4,10,420
25027171@N08,1275,3,1449966452,1449966483,3,10,31
25027171@N08,1275,14,1449966483,1449966553,6,10,70
25027171@N08,1275,3,1449966553,1449966883,22,10,330
25027171@N08,1275,17,1449973050,1449975750,11,10,2700
25027171@N08,1275,6,1449976625,1449977345,7,10,720
25027171@N08,1275,3,1449984385,1449984715,24,10,330
25027171@N08,1275,5,1450001043,1450001463,3,10,420
25027171@N08,1276,17,1450873958,1450876658,1,1,2700
25050086@N07,1277,11,1389332832,1389333792,1,1,960
25083094@N04,1278,15,1394941617,1394942804,2,2,1187
25083094@N04,1278,13,1394942804,1394943884,1,2,1080
25107556@N02,1279,11,1335576295,1335577255,1,1,960
25112704@N05,1280,11,1264718662,1264719622,2,1,960
25126729@N00,1281,15,1229051708,1229052200,3,5,492
25126729@N00,1281,17,1229052200,1229054900,2,5,2700
25126729@N00,1281,8,1229060544,1229061384,3,5,840
25126729@N00,1281,2,1229070337,1229070577,2,5,240
25126729@N00,1281,8,1229075324,1229076164,1,5,840
25126729@N00,1282,11,1276151545,1276152505,1,1,960
25126729@N00,1283,5,1276479331,1276479751,1,1,420
25126729@N00,1284,10,1276509058,1276509958,4,1,900
25126729@N00,1285,9,1307253174,1307254074,2,2,900
25126729@N00,1285,16,1307254976,1307257076,3,2,2100
25126729@N00,1286,15,1307400993,1307402193,2,5,1200
25126729@N00,1286,14,1307402917,1307404117,2,5,1200
25126729@N00,1286,11,1307405718,1307406678,2,5,960
25126729@N00,1286,10,1307411371,1307412271,4,5,900
25126729@N00,1286,13,1307414377,1307415457,1,5,1080
25126729@N00,1287,4,1307443709,1307444069,4,2,360
25126729@N00,1287,2,1307446531,1307446771,1,2,240
25127614@N03,1288,13,1452732090,1452733170,3,1,1080
25138015@N03,1289,5,1330229972,1330230090,2,2,118
25138015@N03,1289,15,1330230090,1330231290,4,2,1200
25138015@N03,1290,10,1335087865,1335088765,3,1,900
25149550@N06,1291,13,1212272476,1212273556,3,2,1080
25149550@N06,1291,15,1212280697,1212281897,2,2,1200
25149550@N06,1292,1,1228089252,1228089492,2,1,240
25149550@N06,1293,13,1228193110,1228194190,6,2,1080
25149550@N06,1293,17,1228194321,1228197021,1,2,2700
25152546@N04,1294,1,1188857655,1188857655,2,4,0
25152546@N04,1294,11,1188857655,1188857655,2,4,0
25152546@N04,1294,13,1188857655,1188857679,2,4,24
25152546@N04,1294,10,1188857679,1188858579,1,4,900
25248468@N08,1295,13,1210923063,1210924143,2,1,1080
25248468@N08,1296,17,1211114356,1211114390,2,2,34
25248468@N08,1296,13,1211114390,1211115470,2,2,1080
25343363@N05,1297,10,1338364890,1338365790,1,1,900
25358521@N05,1298,11,1330075636,1330076596,2,1,960
25360342@N02,1299,3,1395440797,1395441127,2,6,330
25360342@N02,1299,1,1395444354,1395444594,2,6,240
25360342@N02,1299,2,1395453074,1395453314,3,6,240
25360342@N02,1299,6,1395462149,1395462869,2,6,720
25360342@N02,1299,11,1395472806,1395473450,2,6,644
25360342@N02,1299,17,1395473450,1395476150,1,6,2700
25360342@N02,1300,17,1395815147,1395815615,2,4,468
25360342@N02,1300,10,1395815615,1395816515,3,4,900
25360342@N02,1300,16,1395818239,1395820339,2,4,2100
25360342@N02,1300,11,1395822465,1395823425,3,4,960
25360342@N02,1301,11,1454621374,1454622334,6,7,960
25360342@N02,1301,2,1454627821,1454627830,3,7,9
25360342@N02,1301,11,1454627830,1454627975,3,7,145
25360342@N02,1301,2,1454627975,1454628215,4,7,240
25360342@N02,1301,4,1454632475,1454632835,2,7,360
25360342@N02,1301,16,1454633405,1454634897,2,7,1492
25360342@N02,1301,1,1454634897,1454635137,1,7,240
25360342@N02,1302,11,1454714851,1454715811,2,3,960
25360342@N02,1302,17,1454715872,1454716217,2,3,345
25360342@N02,1302,15,1454716217,1454717417,3,3,1200
25361220@N07,1303,8,1269723981,1269724821,1,1,840
25373956@N06,1304,17,1229568296,1229570996,1,1,2700
25382096@N05,1305,11,1462596695,1462597655,4,1,960
25387061@N06,1306,8,1327022397,1327023237,2,1,840
25402555@N08,1307,11,1325731767,1325732727,1,1,960
25418288@N02,1308,16,1207538471,1207540571,1,1,2100
25435542@N08,1309,1,1367896399,1367896639,1,1,240
25440549@N06,1310,13,1197508195,1197509275,2,2,1080
25440549@N06,1310,8,1197511027,1197511867,1,2,840
25440549@N06,1311,1,1210638522,1210638762,1,1,240
25440549@N06,1312,8,1210760549,1210761389,2,3,840
25440549@N06,1312,6,1210762570,1210762815,2,3,245
25440549@N06,1312,8,1210762815,1210763655,1,3,840
25440549@N06,1313,13,1231918227,1231918629,2,2,402
25440549@N06,1313,8,1231918629,1231919469,1,2,840
25440549@N06,1314,11,1232150712,1232151672,2,2,960
25440549@N06,1314,4,1232163475,1232163835,1,2,360
25440549@N06,1315,2,1257030751,1257030991,1,1,240
25455760@N02,1316,3,1374110319,1374110649,2,2,330
25455760@N02,1316,1,1374125223,1374125463,1,2,240
25515164@N04,1317,11,1402304869,1402305829,1,1,960
25543343@N02,1318,11,1284709493,1284710453,1,1,960
25548984@N06,1319,4,1190415088,1190415448,1,1,360
25548984@N06,1320,2,1210351753,1210351993,1,1,240
25548984@N06,1321,13,1221176594,1221177674,1,1,1080
25548984@N06,1322,6,1228087281,1228088001,1,1,720
25555616@N02,1323,17,1317636630,1317639330,1,1,2700
25564364@N07,1324,11,1214821869,1214822829,1,1,960
25585962@N06,1325,1,1412731853,1412732093,2,11,240
25585962@N06,1325,2,1412732219,1412732459,2,11,240
25585962@N06,1325,1,1412734262,1412734359,2,11,97
25585962@N06,1325,4,1412734359,1412734719,2,11,360
25585962@N06,1325,10,1412735835,1412736735,2,11,900
25585962@N06,1325,17,1412736810,1412737756,2,11,946
25585962@N06,1325,13,1412737756,1412738836,2,11,1080
25585962@N06,1325,8,1412747286,1412748126,4,11,840
25585962@N06,1325,5,1412748720,1412749140,3,11,420
25585962@N06,1325,11,1412760890,1412761828,3,11,938
25585962@N06,1325,4,1412761828,1412762188,1,11,360
25601992@N00,1326,11,1412896241,1412897201,2,2,960
25601992@N00,1326,17,1412911202,1412913902,1,2,2700
25627071@N00,1327,11,1312086041,1312087001,8,1,960
25651350@N06,1328,13,1222425221,1222425787,2,2,566
25651350@N06,1328,6,1222425787,1222426507,1,2,720
25651350@N06,1329,8,1244168421,1244169261,4,1,840
25703511@N06,1330,11,1241403184,1241404144,13,7,960
25703511@N06,1330,2,1241412245,1241412485,6,7,240
25703511@N06,1330,17,1241416177,1241416713,10,7,536
25703511@N06,1330,13,1241416713,1241417793,19,7,1080
25703511@N06,1330,11,1241419219,1241419705,2,7,486
25703511@N06,1330,8,1241419705,1241420545,3,7,840
25703511@N06,1330,11,1241436625,1241437585,3,7,960
25737136@N06,1331,11,1307493946,1307494906,1,1,960
25772785@N00,1332,8,1420466012,1420466852,2,2,840
25772785@N00,1332,5,1420469635,1420470055,1,2,420
25839240@N08,1333,11,1354320928,1354321888,3,10,960
25839240@N08,1333,5,1354322339,1354322759,3,10,420
25839240@N08,1333,8,1354324431,1354325271,5,10,840
25839240@N08,1333,13,1354334419,1354335135,4,10,716
25839240@N08,1333,17,1354335135,1354335139,2,10,4
25839240@N08,1333,15,1354335139,1354335243,2,10,104
25839240@N08,1333,17,1354335243,1354335541,3,10,298
25839240@N08,1333,10,1354335541,1354336441,2,10,900
25839240@N08,1333,12,1354341277,1354342297,8,10,1020
25839240@N08,1333,8,1354345836,1354346676,1,10,840
25846522@N00,1334,5,1360223859,1360224279,1,1,420
25854008@N00,1335,11,1352521262,1352522222,1,1,960
25865463@N00,1336,2,1401088356,1401088596,1,1,240
25905065@N00,1337,15,1337136423,1337137623,9,7,1200
25905065@N00,1337,17,1337139541,1337139562,2,7,21
25905065@N00,1337,15,1337139562,1337140762,14,7,1200
25905065@N00,1337,8,1337143923,1337144763,3,7,840
25905065@N00,1337,6,1337146573,1337147293,12,7,720
25905065@N00,1337,13,1337148734,1337149814,3,7,1080
25905065@N00,1337,6,1337166400,1337167120,2,7,720
25958284@N04,1338,5,1454312633,1454313053,2,2,420
25958284@N04,1338,10,1454317500,1454318400,1,2,900
26094090@N00,1339,11,1345170683,1345171643,1,1,960
26127154@N00,1340,11,1322216172,1322217132,1,1,960
26143366@N00,1341,12,1205653324,1205654344,1,1,1020
26143366@N00,1342,11,1205711169,1205712129,1,1,960
26176576@N07,1343,11,1444713779,1444714739,3,2,960
26176576@N07,1343,5,1444727512,1444727932,3,2,420
26211887@N07,1344,5,1223891175,1223891595,3,1,420
26211887@N07,1345,12,1224126149,1224127169,2,2,1020
26211887@N07,1345,17,1224144470,1224147170,1,2,2700
26211887@N07,1346,11,1224248365,1224249325,2,1,960
26236829@N00,1347,5,1291615763,1291615794,2,2,31
26236829@N00,1347,8,1291615794,1291616634,1,2,840
26236829@N00,1348,5,1295826139,1295826559,1,1,420
26247897@N03,1349,11,1197372138,1197373098,1,1,960
26247897@N03,1350,8,1232529551,1232530391,1,1,840
26284290@N05,1351,13,1221141602,1221142682,2,1,1080
26284290@N05,1352,13,1253196000,1253196001,2,2,1
26284290@N05,1352,15,1253196001,1253197201,1,2,1200
26284290@N05,1353,13,1285164000,1285165080,1,1,1080
26284290@N05,1354,8,1285250400,1285251240,1,1,840
26284290@N05,1355,13,1305295201,1305296281,4,1,1080
26284290@N05,1356,5,1321607420,1321607840,1,1,420
26302808@N07,1357,11,1263873621,1263874581,1,1,960
26302808@N07,1358,11,1263930842,1263931802,3,1,960
26302808@N07,1359,11,1263973282,1263974242,1,1,960
26342127@N00,1360,11,1264377493,1264378453,2,1,960
26393454@N00,1361,2,1423103161,1423103401,2,2,240
26393454@N00,1361,17,1423109651,1423112351,1,2,2700
26447682@N05,1362,11,1390167021,1390167981,1,1,960
26486487@N06,1363,15,1211247896,1211248155,3,10,259
26486487@N06,1363,10,1211248155,1211249055,10,10,900
26486487@N06,1363,17,1211249660,1211249989,7,10,329
26486487@N06,1363,15,1211249989,1211250171,3,10,182
26486487@N06,1363,13,1211250171,1211251251,9,10,1080
26486487@N06,1363,1,1211257001,1211257241,3,10,240
26486487@N06,1363,9,1211257319,1211257410,2,10,91
26486487@N06,1363,16,1211257410,1211258849,5,10,1439
26486487@N06,1363,9,1211258849,1211259749,4,10,900
26486487@N06,1363,4,1211259865,1211260225,1,10,360
26522673@N07,1364,1,1212480699,1212480939,1,1,240
26522673@N07,1365,2,1217920637,1217920877,2,3,240
26522673@N07,1365,9,1217931537,1217931542,2,3,5
26522673@N07,1365,1,1217931542,1217931782,1,3,240
26522673@N07,1366,4,1225586920,1225587280,1,1,360
26522673@N07,1367,11,1283227789,1283228749,4,9,960
26522673@N07,1367,1,1283231357,1283231443,2,9,86
26522673@N07,1367,16,1283231443,1283233091,2,9,1648
26522673@N07,1367,4,1283233091,1283233451,4,9,360
26522673@N07,1367,14,1283237596,1283238796,6,9,1200
26522673@N07,1367,2,1283241235,1283241475,6,9,240
26522673@N07,1367,10,1283243880,1283244733,4,9,853
26522673@N07,1367,15,1283244733,1283245933,3,9,1200
26522673@N07,1367,11,1283256988,1283257948,2,9,960
26522673@N07,1368,11,1283561824,1283562784,4,13,960
26522673@N07,1368,5,1283564206,1283564626,9,13,420
26522673@N07,1368,8,1283566380,1283567220,14,13,840
26522673@N07,1368,13,1283573056,1283574136,4,13,1080
26522673@N07,1368,17,1283575714,1283576397,2,13,683
26522673@N07,1368,15,1283576397,1283576467,2,13,70
26522673@N07,1368,17,1283576467,1283576552,2,13,85
26522673@N07,1368,10,1283576552,1283577452,2,13,900
26522673@N07,1368,1,1283578244,1283578484,2,13,240
26522673@N07,1368,9,1283578617,1283579109,5,13,492
26522673@N07,1368,1,1283579109,1283579349,4,13,240
26522673@N07,1368,16,1283579795,1283580274,2,13,479
26522673@N07,1368,11,1283580274,1283581234,1,13,960
26522673@N07,1369,5,1346392106,1346392526,5,4,420
26522673@N07,1369,8,1346402833,1346403673,6,4,840
26522673@N07,1369,13,1346410969,1346412049,2,4,1080
26522673@N07,1369,11,1346420184,1346421144,2,4,960
26522673@N07,1370,11,1346734190,1346735150,2,4,960
26522673@N07,1370,2,1346749396,1346749636,2,4,240
26522673@N07,1370,4,1346750384,1346750744,4,4,360
26522673@N07,1370,13,1346756494,1346757574,1,4,1080
26522673@N07,1371,11,1382488945,1382489905,2,6,960
26522673@N07,1371,10,1382492008,1382492908,4,6,900
26522673@N07,1371,13,1382500409,1382501489,2,6,1080
26522673@N07,1371,8,1382513266,1382514106,6,6,840
26522673@N07,1371,4,1382519400,1382519760,3,6,360
26522673@N07,1371,11,1382532485,1382533445,2,6,960
26531284@N02,1372,5,1320403581,1320404001,1,1,420
26531284@N02,1373,11,1351979568,1351980528,8,3,960
26531284@N02,1373,3,1351986304,1351986634,2,3,330
26531284@N02,1373,11,1351991918,1351992878,5,3,960
26553713@N04,1374,11,1239963393,1239964353,1,1,960
26556494@N00,1375,11,1316427798,1316428758,1,1,960
26559120@N06,1376,11,1391173200,1391174160,1,1,960
26568149@N00,1377,11,1273875659,1273876619,17,1,960
26573031@N05,1378,15,1465804109,1465805309,1,1,1200
26603119@N00,1379,5,1367296170,1367296590,2,3,420
26603119@N00,1379,2,1367301791,1367302031,2,3,240
26603119@N00,1379,1,1367305159,1367305399,3,3,240
26603119@N00,1380,2,1400319815,1400320055,2,1,240
26603119@N00,1381,2,1463220720,1463220960,3,3,240
26603119@N00,1381,10,1463230463,1463231218,2,3,755
26603119@N00,1381,1,1463231218,1463231458,1,3,240
26616207@N00,1382,11,1209084918,1209084922,3,3,4
26616207@N00,1382,15,1209084922,1209085040,2,3,118
26616207@N00,1382,11,1209085040,1209086000,1,3,960
26616207@N00,1383,11,1328784026,1328784026,2,2,0
26616207@N00,1383,17,1328784026,1328786726,1,2,2700
26633936@N03,1384,11,1400122531,1400123491,1,1,960
26652894@N06,1385,11,1195250004,1195250964,1,1,960
26652894@N06,1386,11,1199512669,1199513629,1,1,960
26660641@N02,1387,10,1344135422,1344136322,1,1,900
26670433@N07,1388,10,1233115890,1233116049,2,5,159
26670433@N07,1388,17,1233116049,1233116634,2,5,585
26670433@N07,1388,13,1233116634,1233117714,3,5,1080
26670433@N07,1388,5,1233122117,1233122477,2,5,360
26670433@N07,1388,8,1233122477,1233123317,1,5,840
26678134@N04,1389,11,1325037717,1325038677,2,2,960
26678134@N04,1389,5,1325057861,1325058281,1,2,420
26678134@N04,1390,11,1340015083,1340016043,2,3,960
26678134@N04,1390,5,1340016221,1340016641,3,3,420
26678134@N04,1390,11,1340017623,1340018583,1,3,960
26678134@N04,1391,11,1340967626,1340968586,1,1,960
26678134@N04,1392,14,1347788081,1347789281,2,2,1200
26678134@N04,1392,11,1347791610,1347792570,1,2,960
26678134@N04,1393,10,1350027736,1350028636,3,2,900
26678134@N04,1393,5,1350034177,1350034597,1,2,420
26678134@N04,1394,10,1351237396,1351237708,4,2,312
26678134@N04,1394,15,1351237708,1351238908,1,2,1200
26678134@N04,1395,11,1354861636,1354862596,2,2,960
26678134@N04,1395,8,1354863463,1354864303,1,2,840
26678134@N04,1396,17,1356244295,1356246995,1,1,2700
26678134@N04,1397,2,1358567974,1358568214,3,2,240
26678134@N04,1397,12,1358568728,1358569748,2,2,1020
26678134@N04,1398,17,1360892788,1360895488,1,1,2700
26678134@N04,1399,5,1364025340,1364025760,4,1,420
26678134@N04,1400,15,1364631599,1364632799,1,1,1200
26678134@N04,1401,11,1365144328,1365145288,2,4,960
26678134@N04,1401,1,1365145636,1365145876,2,4,240
26678134@N04,1401,4,1365147419,1365147779,6,4,360
26678134@N04,1401,7,1365147794,1365148634,1,4,840
26678134@N04,1402,8,1387442090,1387442930,1,1,840
26678134@N04,1403,11,1393657296,1393658256,1,1,960
26678134@N04,1404,4,1394180624,1394180984,2,3,360
26678134@N04,1404,1,1394181863,1394182103,2,3,240
26678134@N04,1404,10,1394186595,1394187495,1,3,900
26678134@N04,1405,1,1397012520,1397012760,4,3,240
26678134@N04,1405,3,1397017733,1397018063,2,3,330
26678134@N04,1405,11,1397025955,1397026915,1,3,960
26678134@N04,1406,7,1398234836,1398235676,2,2,840
26678134@N04,1406,17,1398238514,1398241214,1,2,2700
26678134@N04,1407,3,1402627673,1402628003,2,3,330
26678134@N04,1407,2,1402629344,1402629584,7,3,240
26678134@N04,1407,5,1402633729,1402634149,2,3,420
26678134@N04,1408,11,1404372578,1404373417,2,3,839
26678134@N04,1408,5,1404373417,1404373837,2,3,420
26678134@N04,1408,11,1404380247,1404381207,1,3,960
26678134@N04,1409,11,1407977974,1407978934,2,2,960
26678134@N04,1409,5,1407980023,1407980443,1,2,420
26678134@N04,1410,2,1408696926,1408697166,1,1,240
26678134@N04,1411,11,1410409248,1410410208,2,4,960
26678134@N04,1411,3,1410413652,1410413982,2,4,330
26678134@N04,1411,1,1410415038,1410415278,2,4,240
26678134@N04,1411,5,1410417066,1410417486,1,4,420
26678134@N04,1412,11,1412306613,1412307573,2,7,960
26678134@N04,1412,5,1412308887,1412309151,2,7,264
26678134@N04,1412,8,1412309151,1412309991,2,7,840
26678134@N04,1412,3,1412313441,1412313771,2,7,330
26678134@N04,1412,14,1412315519,1412316719,2,7,1200
26678134@N04,1412,8,1412325826,1412326666,2,7,840
26678134@N04,1412,11,1412328528,1412329488,1,7,960
26678134@N04,1413,11,1412477229,1412478189,3,3,960
26678134@N04,1413,8,1412484725,1412485565,4,3,840
26678134@N04,1413,11,1412501885,1412502845,1,3,960
26678134@N04,1414,11,1418196422,1418197382,2,1,960
26678134@N04,1415,11,1423200677,1423201637,2,3,960
26678134@N04,1415,14,1423203464,1423203662,2,3,198
26678134@N04,1415,3,1423203662,1423203992,1,3,330
26678134@N04,1416,11,1423794404,1423795364,2,3,960
26678134@N04,1416,1,1423796449,1423796689,2,3,240
26678134@N04,1416,11,1423797209,1423798169,1,3,960
26678134@N04,1417,5,1424416277,1424416697,3,5,420
26678134@N04,1417,8,1424416909,1424417749,2,5,840
26678134@N04,1417,14,1424423142,1424423852,2,5,710
26678134@N04,1417,3,1424423852,1424424118,2,5,266
26678134@N04,1417,11,1424424118,1424425078,2,5,960
26678134@N04,1418,10,1425269762,1425270325,2,4,563
26678134@N04,1418,7,1425270325,1425271165,2,4,840
26678134@N04,1418,11,1425272993,1425273953,2,4,960
26678134@N04,1418,17,1425301156,1425303856,1,4,2700
26678134@N04,1419,10,1426311279,1426312020,4,4,741
26678134@N04,1419,7,1426312020,1426312632,2,4,612
26678134@N04,1419,2,1426312632,1426312872,3,4,240
26678134@N04,1419,11,1426314843,1426315803,3,4,960
26678134@N04,1420,11,1426922581,1426923541,6,2,960
26678134@N04,1420,2,1426927369,1426927609,1,2,240
26678134@N04,1421,11,1427511377,1427512244,6,13,867
26678134@N04,1421,3,1427512244,1427512287,2,13,43
26678134@N04,1421,7,1427512287,1427512803,2,13,516
26678134@N04,1421,3,1427512803,1427513133,3,13,330
26678134@N04,1421,14,1427515009,1427515236,5,13,227
26678134@N04,1421,3,1427515236,1427515566,2,13,330
26678134@N04,1421,5,1427527909,1427528272,3,13,363
26678134@N04,1421,1,1427528272,1427528438,2,13,166
26678134@N04,1421,16,1427528438,1427529029,2,13,591
26678134@N04,1421,4,1427529029,1427529389,4,13,360
26678134@N04,1421,10,1427529833,1427530733,3,13,900
26678134@N04,1421,17,1427532084,1427534784,2,13,2700
26678134@N04,1421,11,1427536751,1427537711,1,13,960
26678134@N04,1422,11,1430004954,1430005914,3,3,960
26678134@N04,1422,16,1430026696,1430028796,2,3,2100
26678134@N04,1422,11,1430030187,1430031147,2,3,960
26678134@N04,1423,11,1435446594,1435447554,3,1,960
26678134@N04,1424,8,1437257719,1437258559,2,2,840
26678134@N04,1424,11,1437259216,1437260176,2,2,960
26678134@N04,1425,5,1438237628,1438238048,1,1,420
26678134@N04,1426,5,1439528078,1439528498,2,7,420
26678134@N04,1426,8,1439528555,1439529395,3,7,840
26678134@N04,1426,5,1439532196,1439532616,2,7,420
26678134@N04,1426,8,1439533398,1439534238,2,7,840
26678134@N04,1426,14,1439539449,1439539607,2,7,158
26678134@N04,1426,3,1439539607,1439539937,2,7,330
26678134@N04,1426,8,1439544775,1439545615,3,7,840
26678134@N04,1427,14,1440638006,1440639206,11,1,1200
26678134@N04,1428,8,1440731422,1440732262,2,4,840
26678134@N04,1428,9,1440737407,1440737578,2,4,171
26678134@N04,1428,16,1440737578,1440739678,2,4,2100
26678134@N04,1428,11,1440740741,1440741701,3,4,960
26678134@N04,1429,8,1441507334,1441508174,2,3,840
26678134@N04,1429,10,1441511297,1441511696,2,3,399
26678134@N04,1429,1,1441511696,1441511936,1,3,240
26678134@N04,1430,7,1441957094,1441957934,2,3,840
26678134@N04,1430,8,1441962285,1441963125,2,3,840
26678134@N04,1430,11,1441963399,1441964359,1,3,960
26678134@N04,1431,11,1443166568,1443167528,1,1,960
26678134@N04,1432,3,1443915535,1443915865,1,1,330
26678134@N04,1433,11,1444530940,1444531900,1,1,960
26678134@N04,1434,11,1446803045,1446804005,2,1,960
26678134@N04,1435,17,1448602781,1448603102,2,4,321
26678134@N04,1435,10,1448603102,1448603617,2,4,515
26678134@N04,1435,9,1448603617,1448604439,3,4,822
26678134@N04,1435,11,1448604439,1448605399,1,4,960
26678134@N04,1436,13,1451190308,1451191388,2,4,1080
26678134@N04,1436,8,1451191488,1451191781,3,4,293
26678134@N04,1436,5,1451191781,1451192201,2,4,420
26678134@N04,1436,14,1451194922,1451196122,2,4,1200
26678134@N04,1437,11,1451376556,1451377516,1,1,960
26678134@N04,1438,3,1451776921,1451777251,2,7,330
26678134@N04,1438,7,1451780011,1451780851,2,7,840
26678134@N04,1438,10,1451782351,1451782782,5,7,431
26678134@N04,1438,17,1451782782,1451783029,2,7,247
26678134@N04,1438,13,1451783029,1451784109,6,7,1080
26678134@N04,1438,5,1451785301,1451785721,2,7,420
26678134@N04,1438,11,1451786402,1451787362,1,7,960
26678134@N04,1439,11,1452996498,1452997003,2,4,505
26678134@N04,1439,7,1452997003,1452997843,2,4,840
26678134@N04,1439,14,1452999757,1453000957,2,4,1200
26678134@N04,1439,11,1453002518,1453003478,2,4,960
26678134@N04,1440,14,1456028816,1456030016,2,2,1200
26678134@N04,1440,11,1456031767,1456032727,1,2,960
26678134@N04,1441,8,1456793622,1456794462,2,2,840
26678134@N04,1441,11,1456795019,1456795979,1,2,960
26678134@N04,1442,3,1457235023,1457235353,1,1,330
26678134@N04,1443,11,1458282746,1458283557,3,2,811
26678134@N04,1443,3,1458283557,1458283887,1,2,330
26678134@N04,1444,11,1460174098,1460175058,3,2,960
26678134@N04,1444,7,1460175187,1460176027,1,2,840
26678134@N04,1445,10,1463124668,1463125568,2,1,900
26680632@N04,1446,11,1276128873,1276129833,2,5,960
26680632@N04,1446,17,1276139388,1276142088,2,5,2700
26680632@N04,1446,8,1276150410,1276151250,2,5,840
26680632@N04,1446,15,1276151300,1276152500,2,5,1200
26680632@N04,1446,13,1276153219,1276154299,1,5,1080
26686716@N02,1447,12,1211024957,1211025977,2,8,1020
26686716@N02,1447,4,1211026218,1211026578,2,8,360
26686716@N02,1447,16,1211028482,1211028581,2,8,99
26686716@N02,1447,9,1211028581,1211028672,2,8,91
26686716@N02,1447,16,1211028672,1211030772,2,8,2100
26686716@N02,1447,8,1211031882,1211032722,2,8,840
26686716@N02,1447,15,1211036090,1211037290,5,8,1200
26686716@N02,1447,16,1211045542,1211047642,1,8,2100
26686716@N02,1448,16,1211471279,1211473379,2,1,2100
26695377@N00,1449,11,1330098173,1330099133,3,1,960
26750032@N03,1450,5,1205999626,1206000046,1,1,420
26847486@N05,1451,11,1377173375,1377174335,1,1,960
26859501@N00,1452,10,1281306823,1281307723,1,1,900
26874770@N06,1453,3,1187996893,1187997223,2,11,330
26874770@N06,1453,1,1187998203,1187998443,2,11,240
26874770@N06,1453,9,1187999734,1188000634,2,11,900
26874770@N06,1453,2,1188003031,1188003271,2,11,240
26874770@N06,1453,16,1188005723,1188007591,2,11,1868
26874770@N06,1453,1,1188007591,1188007831,2,11,240
26874770@N06,1453,16,1188007996,1188010096,2,11,2100
26874770@N06,1453,5,1188013038,1188013458,2,11,420
26874770@N06,1453,8,1188014608,1188015448,3,11,840
26874770@N06,1453,11,1188017590,1188018550,2,11,960
26874770@N06,1453,13,1188030144,1188031224,1,11,1080
26874770@N06,1454,3,1191543189,1191543519,2,4,330
26874770@N06,1454,11,1191561725,1191562685,2,4,960
26874770@N06,1454,4,1191579895,1191580255,2,4,360
26874770@N06,1454,11,1191591150,1191592110,1,4,960
26874770@N06,1455,6,1197272138,1197272858,2,2,720
26874770@N06,1455,11,1197274457,1197275417,1,2,960
26874770@N06,1456,11,1197339937,1197340897,2,1,960
26874770@N06,1457,15,1198901094,1198902294,2,4,1200
26874770@N06,1457,11,1198905813,1198906773,3,4,960
26874770@N06,1457,16,1198906997,1198909097,2,4,2100
26874770@N06,1457,6,1198915208,1198915928,1,4,720
26874770@N06,1458,4,1199076977,1199077337,2,3,360
26874770@N06,1458,11,1199088463,1199089423,2,3,960
26874770@N06,1458,10,1199108159,1199109059,1,3,900
26874770@N06,1459,11,1199174819,1199175779,1,1,960
26874770@N06,1460,6,1225790768,1225790982,2,2,214
26874770@N06,1460,8,1225790982,1225791822,1,2,840
26874770@N06,1461,11,1228732215,1228733175,1,1,960
26874770@N06,1462,11,1230540785,1230541745,1,1,960
26874770@N06,1463,11,1235867195,1235868155,1,1,960
26874770@N06,1464,8,1235896271,1235897111,1,1,840
26874770@N06,1465,4,1245484333,1245484693,2,5,360
26874770@N06,1465,13,1245485518,1245486598,3,5,1080
26874770@N06,1465,15,1245488990,1245490021,2,5,1031
26874770@N06,1465,5,1245490021,1245490441,4,5,420
26874770@N06,1465,11,1245492511,1245493471,2,5,960
26874770@N06,1466,11,1281845970,1281846930,1,1,960
26893219@N07,1467,9,1213001056,1213001956,5,4,900
26893219@N07,1467,17,1213005583,1213008283,2,4,2700
26893219@N07,1467,6,1213008517,1213009237,3,4,720
26893219@N07,1467,8,1213011181,1213012021,1,4,840
26893219@N07,1468,13,1213092079,1213093159,3,1,1080
26893219@N07,1469,8,1213180731,1213181571,3,1,840
26893219@N07,1470,15,1213336801,1213337780,4,2,979
26893219@N07,1470,13,1213337780,1213338860,2,2,1080
26901589@N00,1471,11,1326799155,1326800115,1,1,960
26913230@N03,1472,11,1248071909,1248072869,1,1,960
26913230@N03,1473,11,1248324514,1248325474,1,1,960
26931534@N04,1474,17,1425122810,1425125510,1,1,2700
27064297@N04,1475,15,1360122137,1360123337,3,2,1200
27064297@N04,1475,13,1360124119,1360125199,4,2,1080
27124343@N00,1476,11,1220653442,1220654402,6,6,960
27124343@N00,1476,12,1220655920,1220656940,6,6,1020
27124343@N00,1476,14,1220660255,1220661455,5,6,1200
27124343@N00,1476,5,1220662903,1220663323,8,6,420
27124343@N00,1476,8,1220669811,1220670651,10,6,840
27124343@N00,1476,11,1220676686,1220677646,6,6,960
27174905@N03,1477,5,1336634910,1336635330,1,1,420
27174905@N03,1478,11,1338103684,1338104644,1,1,960
27193990@N00,1479,11,1364179343,1364180303,1,1,960
27233089@N04,1480,8,1251763740,1251764580,1,1,840
27270108@N05,1481,11,1243817983,1243818943,1,1,960
27270108@N05,1482,11,1244196136,1244197096,1,1,960
27270108@N05,1483,13,1275445309,1275446389,2,1,1080
27270108@N05,1484,15,1306662726,1306663926,2,2,1200
27270108@N05,1484,11,1306670617,1306671577,2,2,960
27270108@N05,1485,3,1306973353,1306973683,1,1,330
27270108@N05,1486,11,1307144409,1307145369,3,4,960
27270108@N05,1486,9,1307145664,1307146564,8,4,900
27270108@N05,1486,1,1307149199,1307149439,4,4,240
27270108@N05,1486,2,1307155732,1307155972,1,4,240
27270108@N05,1487,5,1339320765,1339321185,1,1,420
27270108@N05,1488,11,1339374242,1339375202,3,5,960
27270108@N05,1488,14,1339375720,1339376920,2,5,1200
27270108@N05,1488,4,1339380787,1339381147,2,5,360
27270108@N05,1488,5,1339384000,1339384420,2,5,420
27270108@N05,1488,8,1339387723,1339388563,17,5,840
27270108@N05,1489,11,1339628555,1339629515,3,7,960
27270108@N05,1489,16,1339632441,1339632626,2,7,185
27270108@N05,1489,9,1339632626,1339633526,3,7,900
27270108@N05,1489,17,1339642182,1339642883,4,7,701
27270108@N05,1489,15,1339642883,1339644083,5,7,1200
27270108@N05,1489,13,1339645304,1339646384,5,7,1080
27270108@N05,1489,15,1339647179,1339648379,1,7,1200
27270108@N05,1490,15,1357021932,1357022328,3,6,396
27270108@N05,1490,13,1357022328,1357023408,2,6,1080
27270108@N05,1490,15,1357034890,1357036090,11,6,1200
27270108@N05,1490,17,1357036742,1357036941,2,6,199
27270108@N05,1490,10,1357036941,1357037841,2,6,900
27270108@N05,1490,11,1357038081,1357039041,2,6,960
27270108@N05,1491,8,1370258076,1370258916,3,1,840
27270108@N05,1492,17,1434107426,1434110126,2,1,2700
27312248@N04,1493,5,1203643822,1203644242,8,2,420
27312248@N04,1493,8,1203645460,1203646300,1,2,840
27314026@N06,1494,11,1276561845,1276562805,1,1,960
27316914@N02,1495,5,1194457740,1194458160,2,1,420
27338137@N06,1496,17,1242731452,1242734152,1,1,2700
27338137@N06,1497,17,1242817631,1242820331,1,1,2700
27372897@N00,1498,8,1353025729,1353026569,1,1,840
27373375@N03,1499,11,1443576434,1443577394,3,1,960
27373375@N03,1500,11,1443714551,1443715511,2,1,960
27429042@N08,1501,2,1191160800,1191161040,1,1,240
27429042@N08,1502,11,1212910480,1212911440,1,1,960
27429042@N08,1503,8,1219475748,1219476588,1,1,840
27429042@N08,1504,6,1227918856,1227919576,1,1,720
27429042@N08,1505,12,1231460461,1231461481,2,2,1020
27429042@N08,1505,11,1231463372,1231464332,1,2,960
27429042@N08,1506,16,1231494600,1231496700,1,1,2100
27429042@N08,1507,13,1231723997,1231725077,2,1,1080
27429042@N08,1508,10,1232839170,1232840070,1,1,900
27429042@N08,1509,4,1261911862,1261912052,2,2,190
27429042@N08,1509,11,1261912052,1261913012,1,2,960
27429042@N08,1510,3,1265772185,1265772515,2,3,330
27429042@N08,1510,8,1265776841,1265777681,2,3,840
27429042@N08,1510,15,1265783664,1265784864,2,3,1200
27429042@N08,1511,11,1268258152,1268259112,2,7,960
27429042@N08,1511,2,1268260171,1268260411,2,7,240
27429042@N08,1511,4,1268262293,1268262653,3,7,360
27429042@N08,1511,16,1268266269,1268267101,2,7,832
27429042@N08,1511,2,1268267101,1268267341,2,7,240
27429042@N08,1511,5,1268274711,1268275131,2,7,420
27429042@N08,1511,4,1268281337,1268281697,1,7,360
27429042@N08,1512,9,1268529405,1268529760,2,3,355
27429042@N08,1512,11,1268529760,1268530720,2,3,960
27429042@N08,1512,10,1268531759,1268532659,1,3,900
27429042@N08,1513,11,1277023969,1277024929,1,1,960
27429042@N08,1514,11,1292645573,1292646533,1,1,960
27429042@N08,1515,17,1292816527,1292819227,1,1,2700
27429042@N08,1516,1,1293061342,1293061420,2,6,78
27429042@N08,1516,9,1293061420,1293061738,2,6,318
27429042@N08,1516,16,1293061738,1293063838,2,6,2100
27429042@N08,1516,8,1293065721,1293066561,4,6,840
27429042@N08,1516,17,1293071813,1293073261,2,6,1448
27429042@N08,1516,15,1293073261,1293074461,1,6,1200
27429042@N08,1517,2,1300934309,1300934549,4,2,240
27429042@N08,1517,11,1300942321,1300943281,2,2,960
27429042@N08,1518,10,1301103263,1301104163,1,1,900
27429042@N08,1519,15,1321807435,1321808635,1,1,1200
27429042@N08,1520,15,1324169431,1324170631,2,2,1200
27429042@N08,1520,5,1324172822,1324173242,1,2,420
27429042@N08,1521,14,1331164285,1331165485,2,3,1200
27429042@N08,1521,10,1331166979,1331167879,2,3,900
27429042@N08,1521,13,1331168802,1331169882,1,3,1080
27457334@N02,1522,11,1333685533,1333686493,2,2,960
27457334@N02,1522,4,1333690222,1333690582,1,2,360
27472404@N02,1523,8,1286005544,1286006384,1,1,840
27511563@N06,1524,4,1202103664,1202104024,1,1,360
27527078@N05,1525,11,1360390613,1360391573,4,3,960
27527078@N05,1525,2,1360394441,1360394681,3,3,240
27527078@N05,1525,8,1360396494,1360397334,1,3,840
27539218@N06,1526,11,1207375568,1207376528,1,1,960
27539218@N06,1527,15,1208331225,1208332425,2,1,1200
27539218@N06,1528,8,1209195972,1209196812,2,1,840
27539218@N06,1529,10,1212221513,1212222413,2,1,900
27539218@N06,1530,15,1213241144,1213242344,1,1,1200
27539218@N06,1531,8,1223348393,1223349233,2,1,840
27539218@N06,1532,5,1230352565,1230352985,1,1,420
27539218@N06,1533,6,1237620219,1237620939,1,1,720
27539218@N06,1534,10,1247543356,1247543942,3,6,586
27539218@N06,1534,17,1247543942,1247544000,2,6,58
27539218@N06,1534,15,1247544000,1247544612,5,6,612
27539218@N06,1534,13,1247544612,1247545692,7,6,1080
27539218@N06,1534,8,1247549259,1247550099,7,6,840
27539218@N06,1534,5,1247550736,1247551156,6,6,420
27539218@N06,1535,11,1248176620,1248177580,1,1,960
27539218@N06,1536,6,1254296311,1254297031,24,1,720
27539218@N06,1537,12,1257068682,1257069702,10,1,1020
27539218@N06,1538,11,1257297799,1257298759,2,2,960
27539218@N06,1538,5,1257300988,1257301408,4,2,420
27539218@N06,1539,5,1260852881,1260853301,1,1,420
27539218@N06,1540,8,1270278827,1270279667,1,1,840
27539218@N06,1541,11,1300509040,1300510000,1,1,960
27599409@N02,1542,11,1200270820,1200271780,22,1,960
27599409@N02,1543,11,1200556964,1200557924,3,1,960
27601113@N06,1544,11,1373840506,1373841466,1,1,960
27734159@N00,1545,11,1290392350,1290393310,1,1,960
27746179@N05,1546,11,1358063891,1358064851,1,1,960
27810107@N08,1547,11,1232948087,1232949047,2,3,960
27810107@N08,1547,1,1232949078,1232949318,3,3,240
27810107@N08,1547,11,1232959467,1232960427,1,3,960
27866187@N06,1548,13,1201671204,1201672284,1,1,1080
27866187@N06,1549,17,1214111946,1214114646,2,1,2700
27866187@N06,1550,10,1214201577,1214202477,2,2,900
27866187@N06,1550,17,1214202796,1214205496,1,2,2700
27874898@N00,1551,12,1349737546,1349738566,191,1,1020
27874898@N00,1552,17,1349852630,1349854373,10,6,1743
27874898@N00,1552,11,1349854373,1349855333,10,6,960
27874898@N00,1552,12,1349855358,1349856378,18,6,1020
27874898@N00,1552,11,1349858142,1349859102,4,6,960
27874898@N00,1552,17,1349863117,1349865817,22,6,2700
27874898@N00,1552,9,1349866948,1349867848,7,6,900
27874898@N00,1553,5,1350175249,1350175669,12,2,420
27874898@N00,1553,8,1350177602,1350178442,3,2,840
27874898@N00,1554,1,1367987795,1367988035,1,1,240
27874898@N00,1555,11,1368148224,1368149086,2,3,862
27874898@N00,1555,5,1368149086,1368149506,11,3,420
27874898@N00,1555,1,1368157523,1368157763,7,3,240
27874898@N00,1556,5,1370669448,1370669868,6,1,420
27874898@N00,1557,1,1378948228,1378948468,6,5,240
27874898@N00,1557,12,1378951340,1378952360,6,5,1020
27874898@N00,1557,1,1378953595,1378953835,5,5,240
27874898@N00,1557,5,1378956316,1378956736,2,5,420
27874898@N00,1557,13,1378963272,1378964352,2,5,1080
27938532@N00,1558,11,1292986140,1292987100,1,1,960
27967379@N08,1559,2,1410148063,1410148303,2,2,240
27967379@N08,1559,5,1410167709,1410168129,2,2,420
27969085@N00,1560,11,1327668052,1327669012,1,1,960
28004076@N04,1561,10,1399623747,1399624647,3,2,900
28004076@N04,1561,11,1399626626,1399627586,2,2,960
28019195@N07,1562,11,1419111083,1419111402,2,2,319
28019195@N07,1562,15,1419111402,1419112602,1,2,1200
28044128@N03,1563,11,1388705463,1388706423,2,1,960
28057734@N03,1564,17,1314073228,1314075928,1,1,2700
28069677@N00,1565,6,1224061798,1224062518,3,1,720
28083255@N00,1566,8,1416189347,1416190187,1,1,840
28083255@N00,1567,11,1443395126,1443396086,2,1,960
28090908@N04,1568,11,1241226728,1241227688,2,7,960
28090908@N04,1568,5,1241230068,1241230488,3,7,420
28090908@N04,1568,8,1241231469,1241232309,2,7,840
28090908@N04,1568,9,1241234909,1241235809,2,7,900
28090908@N04,1568,13,1241250699,1241251779,3,7,1080
28090908@N04,1568,8,1241257188,1241258028,2,7,840
28090908@N04,1568,11,1241258131,1241259091,3,7,960
28092308@N00,1569,11,1207096938,1207097898,3,6,960
28092308@N00,1569,14,1207100276,1207100978,15,6,702
28092308@N00,1569,4,1207100978,1207101338,5,6,360
28092308@N00,1569,15,1207106499,1207106727,2,6,228
28092308@N00,1569,13,1207106727,1207107807,3,6,1080
28092308@N00,1569,8,1207112048,1207112888,1,6,840
28132447@N00,1570,11,1292548087,1292549047,7,2,960
28132447@N00,1570,17,1292552565,1292555265,6,2,2700
28148319@N08,1571,11,1265190871,1265191831,1,1,960
28148319@N08,1572,11,1298285778,1298286738,1,1,960
28163344@N08,1573,11,1446797867,1446798827,1,1,960
28163344@N08,1574,11,1446866399,1446866454,2,2,55
28163344@N08,1574,9,1446866454,1446867354,4,2,900
28203925@N08,1575,8,1345111607,1345112447,3,2,840
28203925@N08,1575,17,1345115853,1345118553,2,2,2700
28215341@N07,1576,11,1367816512,1367817472,2,2,960
28215341@N07,1576,9,1367826557,1367827457,1,2,900
28215341@N07,1577,1,1424316825,1424317065,2,2,240
28215341@N07,1577,4,1424320391,1424320751,1,2,360
28215341@N07,1578,15,1445501662,1445502862,5,1,1200
28245557@N00,1579,17,1416792477,1416795177,1,1,2700
28258189@N08,1580,11,1203482774,1203483734,1,1,960
28289576@N08,1581,11,1356937040,1356938000,1,1,960
28373086@N07,1582,11,1242061921,1242062881,6,4,960
28373086@N07,1582,17,1242069392,1242071160,2,4,1768
28373086@N07,1582,13,1242071160,1242072240,3,4,1080
28373086@N07,1582,8,1242077514,1242078354,3,4,840
28407078@N08,1583,11,1215428055,1215429015,1,1,960
28446856@N00,1584,11,1383253125,1383254085,1,1,960
28446856@N00,1585,11,1383286229,1383287189,1,1,960
28450912@N02,1586,11,1238813914,1238814874,2,5,960
28450912@N02,1586,10,1238815250,1238816150,2,5,900
28450912@N02,1586,8,1238819601,1238820083,3,5,482
28450912@N02,1586,5,1238820083,1238820503,2,5,420
28450912@N02,1586,11,1238824647,1238825607,5,5,960
28450912@N02,1587,4,1249893045,1249893048,2,12,3
28450912@N02,1587,17,1249893048,1249893049,3,12,1
28450912@N02,1587,13,1249893049,1249893049,4,12,0
28450912@N02,1587,15,1249893049,1249893062,3,12,13
28450912@N02,1587,1,1249893062,1249893063,3,12,1
28450912@N02,1587,9,1249893063,1249893064,2,12,1
28450912@N02,1587,11,1249893064,1249893114,8,12,50
28450912@N02,1587,5,1249893114,1249893117,4,12,3
28450912@N02,1587,1,1249893117,1249893118,2,12,1
28450912@N02,1587,8,1249893118,1249893195,3,12,77
28450912@N02,1587,5,1249893195,1249893211,2,12,16
28450912@N02,1587,11,1249893211,1249894171,1,12,960
28450912@N02,1588,11,1252049786,1252050746,4,1,960
28450912@N02,1589,17,1263605568,1263608268,5,4,2700
28450912@N02,1589,1,1263620469,1263620709,2,4,240
28450912@N02,1589,4,1263625679,1263626039,2,4,360
28450912@N02,1589,3,1263626101,1263626431,5,4,330
28450912@N02,1590,8,1275051565,1275052405,1,1,840
28450912@N02,1591,11,1324115601,1324116561,7,2,960
28450912@N02,1591,13,1324118177,1324119257,1,2,1080
28450912@N02,1592,10,1324170922,1324171678,12,3,756
28450912@N02,1592,17,1324171678,1324174378,7,3,2700
28450912@N02,1592,1,1324178899,1324179139,1,3,240
28450912@N02,1593,10,1331350130,1331351030,5,2,900
28450912@N02,1593,13,1331351440,1331352520,1,2,1080
28450912@N02,1594,10,1354872962,1354873862,3,2,900
28450912@N02,1594,13,1354874389,1354875469,1,2,1080
28450912@N02,1595,11,1362733752,1362734712,1,1,960
28450912@N02,1596,11,1362804005,1362804965,3,1,960
28450912@N02,1597,11,1363144813,1363145773,10,7,960
28450912@N02,1597,4,1363147112,1363147472,2,7,360
28450912@N02,1597,17,1363149323,1363152023,5,7,2700
28450912@N02,1597,15,1363152050,1363152176,2,7,126
28450912@N02,1597,13,1363152176,1363153256,3,7,1080
28450912@N02,1597,6,1363153805,1363154525,2,7,720
28450912@N02,1597,8,1363160591,1363161431,2,7,840
28450912@N02,1598,5,1400323908,1400324328,1,1,420
28450912@N02,1599,17,1400381068,1400381372,5,3,304
28450912@N02,1599,10,1400381372,1400381382,2,3,10
28450912@N02,1599,17,1400381382,1400384082,2,3,2700
28469514@N05,1600,11,1380949653,1380950613,1,1,960
28478615@N03,1601,11,1331969930,1331970890,1,1,960
28495936@N03,1602,4,1292287456,1292287816,2,2,360
28495936@N03,1602,13,1292307489,1292308569,1,2,1080
28495936@N03,1603,17,1302056337,1302056956,2,6,619
28495936@N03,1603,13,1302056956,1302057154,2,6,198
28495936@N03,1603,15,1302057154,1302057951,2,6,797
28495936@N03,1603,11,1302057951,1302058911,2,6,960
28495936@N03,1603,17,1302064389,1302066651,3,6,2262
28495936@N03,1603,11,1302066651,1302067611,1,6,960
28495936@N03,1604,11,1317510196,1317510231,2,3,35
28495936@N03,1604,16,1317510231,1317510260,2,3,29
28495936@N03,1604,11,1317510260,1317511220,1,3,960
28495936@N03,1605,11,1318544331,1318545291,2,1,960
28495936@N03,1606,4,1327714575,1327714935,2,2,360
28495936@N03,1606,8,1327716321,1327717161,1,2,840
28495936@N03,1607,15,1328324779,1328325979,1,1,1200
28495936@N03,1608,13,1329441673,1329442753,1,1,1080
28495936@N03,1609,11,1330218023,1330218983,2,3,960
28495936@N03,1609,7,1330220545,1330221385,2,3,840
28495936@N03,1609,1,1330226914,1330227154,1,3,240
28495936@N03,1610,17,1330487981,1330489646,2,2,1665
28495936@N03,1610,6,1330489646,1330490366,1,2,720
28495936@N03,1611,11,1331083444,1331084404,3,2,960
28495936@N03,1611,13,1331088652,1331089732,1,2,1080
28495936@N03,1612,11,1333410774,1333411734,1,1,960
28495936@N03,1613,8,1336112067,1336112907,5,2,840
28495936@N03,1613,13,1336113784,1336114864,2,2,1080
28495936@N03,1614,11,1340415231,1340416191,2,3,960
28495936@N03,1614,8,1340422188,1340423028,2,3,840
28495936@N03,1614,11,1340423920,1340424880,1,3,960
28495936@N03,1615,7,1346637209,1346638049,1,1,840
28495936@N03,1616,11,1354848754,1354849714,1,1,960
28527853@N00,1617,11,1335566609,1335567569,2,7,960
28527853@N00,1617,3,1335574496,1335574572,2,7,76
28527853@N00,1617,2,1335574572,1335574812,2,7,240
28527853@N00,1617,10,1335575922,1335576822,2,7,900
28527853@N00,1617,17,1335577498,1335580198,3,7,2700
28527853@N00,1617,13,1335581010,1335582090,2,7,1080
28527853@N00,1617,11,1335604192,1335605152,1,7,960
28527853@N00,1618,1,1354772080,1354772320,1,1,240
28527853@N00,1619,15,1354848370,1354849570,1,1,1200
28530387@N06,1620,17,1408161266,1408163966,3,1,2700
28530387@N06,1621,5,1443156708,1443157128,2,1,420
28530387@N06,1622,3,1470367269,1470367599,2,3,330
28530387@N06,1622,2,1470369916,1470370156,5,3,240
28530387@N06,1622,5,1470371898,1470372318,2,3,420
28559908@N00,1623,6,1389057138,1389057858,70,1,720
28572085@N03,1624,11,1216734253,1216735213,2,3,960
28572085@N03,1624,12,1216738932,1216739952,5,3,1020
28572085@N03,1624,13,1216748860,1216749940,4,3,1080
28572085@N03,1625,11,1217078719,1217079679,2,4,960
28572085@N03,1625,1,1217081985,1217082225,6,4,240
28572085@N03,1625,8,1217092449,1217093289,7,4,840
28572085@N03,1625,5,1217100780,1217101200,5,4,420
28572085@N03,1626,15,1219054693,1219054783,8,14,90
28572085@N03,1626,8,1219054783,1219054800,6,14,17
28572085@N03,1626,5,1219054800,1219054965,8,14,165
28572085@N03,1626,15,1219054965,1219055171,23,14,206
28572085@N03,1626,8,1219055171,1219055233,18,14,62
28572085@N03,1626,5,1219055233,1219055369,25,14,136
28572085@N03,1626,8,1219055369,1219056209,8,14,840
28572085@N03,1626,11,1219069324,1219069325,2,14,1
28572085@N03,1626,13,1219069325,1219069366,3,14,41
28572085@N03,1626,10,1219069366,1219069373,7,14,7
28572085@N03,1626,15,1219069373,1219069380,8,14,7
28572085@N03,1626,13,1219069380,1219069402,4,14,22
28572085@N03,1626,8,1219069402,1219069430,16,14,28
28572085@N03,1626,5,1219069430,1219069850,18,14,420
28581468@N00,1627,17,1263789983,1263792683,6,1,2700
28598412@N04,1628,10,1251581300,1251582200,1,1,900
28643802@N03,1629,8,1309655246,1309656086,1,1,840
28691893@N04,1630,11,1334346468,1334347428,2,1,960
28691893@N04,1631,9,1350162569,1350163469,3,2,900
28691893@N04,1631,2,1350169910,1350170150,2,2,240
28691893@N04,1632,9,1350261515,1350262415,2,2,900
28691893@N04,1632,8,1350271737,1350272577,1,2,840
28691893@N04,1633,9,1350354534,1350355434,1,1,900
28691893@N04,1634,9,1350444791,1350445691,2,2,900
28691893@N04,1634,5,1350448164,1350448584,2,2,420
28691893@N04,1635,9,1350591258,1350592158,1,1,900
28704523@N03,1636,10,1312867024,1312867924,1,1,900
28705786@N05,1637,6,1221189205,1221189925,2,1,720
28712708@N06,1638,13,1282643936,1282645016,1,1,1080
28713051@N05,1639,1,1294927437,1294927677,1,1,240
28720651@N04,1640,16,1219355919,1219358019,31,1,2100
28724781@N04,1641,15,1229135722,1229136922,2,3,1200
28724781@N04,1641,2,1229145664,1229145904,3,3,240
28724781@N04,1641,17,1229149700,1229152400,1,3,2700
28724781@N04,1642,11,1231316699,1231316993,2,3,294
28724781@N04,1642,1,1231316993,1231317233,2,3,240
28724781@N04,1642,12,1231318252,1231319272,1,3,1020
28724781@N04,1643,9,1231457825,1231458555,2,4,730
28724781@N04,1643,10,1231458555,1231459455,2,4,900
28724781@N04,1643,8,1231466921,1231467761,7,4,840
28724781@N04,1643,5,1231473842,1231474262,1,4,420
28754076@N05,1644,10,1198432604,1198433504,3,2,900
28754076@N05,1644,11,1198433718,1198434678,1,2,960
28790043@N05,1645,13,1237002674,1237003754,2,1,1080
28815288@N06,1646,17,1320891142,1320893842,1,1,2700
28827391@N03,1647,11,1365229672,1365230632,1,1,960
28827568@N05,1648,11,1222422394,1222423354,2,1,960
28827568@N05,1649,11,1223872199,1223873159,3,1,960
28836018@N02,1650,3,1337401718,1337402048,41,1,330
28836018@N02,1651,15,1358056785,1358056904,3,4,119
28836018@N02,1651,13,1358056904,1358057602,2,4,698
28836018@N02,1651,5,1358057602,1358058022,2,4,420
28836018@N02,1651,11,1358061474,1358062434,1,4,960
28936728@N04,1652,14,1222783200,1222784400,1,1,1200
28946471@N00,1653,11,1373099537,1373100497,1,1,960
28971971@N00,1654,2,1194741854,1194742094,3,7,240
28971971@N00,1654,12,1194744200,1194745220,2,7,1020
28971971@N00,1654,7,1194745777,1194746617,3,7,840
28971971@N00,1654,5,1194747789,1194748209,10,7,420
28971971@N00,1654,8,1194750426,1194751266,2,7,840
28971971@N00,1654,10,1194753675,1194754575,7,7,900
28971971@N00,1654,11,1194759145,1194760105,1,7,960
28971971@N00,1655,11,1194955335,1194956295,2,1,960
28971971@N00,1656,7,1297377308,1297378148,4,7,840
28971971@N00,1656,2,1297379059,1297379299,7,7,240
28971971@N00,1656,12,1297379752,1297380772,6,7,1020
28971971@N00,1656,7,1297385799,1297386639,3,7,840
28971971@N00,1656,16,1297389608,1297391708,6,7,2100
28971971@N00,1656,15,1297404554,1297405597,7,7,1043
28971971@N00,1656,13,1297405597,1297406677,1,7,1080
28971971@N00,1657,13,1315014432,1315015512,5,1,1080
28971971@N00,1658,13,1346067383,1346068463,1,1,1080
28977782@N00,1659,2,1192063181,1192063421,3,2,240
28977782@N00,1659,12,1192067099,1192068119,1,2,1020
28977782@N00,1660,12,1324223146,1324224166,1,1,1020
28977782@N00,1661,16,1324649193,1324651293,2,3,2100
28977782@N00,1661,8,1324656035,1324656875,2,3,840
28977782@N00,1661,5,1324664011,1324664431,1,3,420
28977782@N00,1662,1,1334355790,1334356030,1,1,240
28989691@N05,1663,13,1317184164,1317185244,1,1,1080
29000027@N05,1664,11,1444788631,1444789591,1,1,960
29044494@N00,1665,4,1272426510,1272426870,2,2,360
29044494@N00,1665,10,1272432427,1272433327,2,2,900
29057323@N07,1666,11,1207742648,1207743608,2,1,960
29075130@N00,1667,8,1307855740,1307856580,2,2,840
29075130@N00,1667,11,1307862668,1307863628,1,2,960
29078580@N00,1668,2,1216429860,1216430100,3,4,240
29078580@N00,1668,4,1216431960,1216432320,3,4,360
29078580@N00,1668,11,1216432980,1216433940,2,4,960
29078580@N00,1668,5,1216450320,1216450740,5,4,420
29078580@N00,1669,11,1278635562,1278636522,1,1,960
29078580@N00,1670,4,1278666761,1278667121,2,2,360
29078580@N00,1670,5,1278670804,1278671224,3,2,420
29108089@N04,1671,11,1385765926,1385766886,4,10,960
29108089@N04,1671,4,1385775904,1385776264,2,10,360
29108089@N04,1671,10,1385776663,1385777046,2,10,383
29108089@N04,1671,17,1385777046,1385777647,2,10,601
29108089@N04,1671,15,1385777647,1385778003,2,10,356
29108089@N04,1671,13,1385778003,1385779083,2,10,1080
29108089@N04,1671,6,1385788369,1385789089,7,10,720
29108089@N04,1671,17,1385807550,1385808297,2,10,747
29108089@N04,1671,10,1385808297,1385809197,2,10,900
29108089@N04,1671,11,1385810822,1385811782,3,10,960
29129621@N05,1672,11,1246602818,1246603778,2,4,960
29129621@N05,1672,16,1246605761,1246607861,2,4,2100
29129621@N05,1672,8,1246611481,1246612321,2,4,840
29129621@N05,1672,13,1246618319,1246619399,2,4,1080
29129621@N05,1673,4,1269129532,1269129892,1,1,360
29129621@N05,1674,4,1289033107,1289033467,1,1,360
29129621@N05,1675,16,1291592114,1291593928,3,2,1814
29129621@N05,1675,5,1291593928,1291594348,1,2,420
29129621@N05,1676,9,1299285604,1299286504,2,4,900
29129621@N05,1676,4,1299298859,1299299219,2,4,360
29129621@N05,1676,5,1299321621,1299322041,2,4,420
29129621@N05,1676,13,1299325240,1299326320,1,4,1080
29129621@N05,1677,16,1317534089,1317536189,1,1,2100
29129621@N05,1678,11,1317699917,1317700877,2,4,960
29129621@N05,1678,4,1317706502,1317706862,2,4,360
29129621@N05,1678,9,1317710113,1317710704,2,4,591
29129621@N05,1678,1,1317710704,1317710944,1,4,240
29129621@N05,1679,2,1321061680,1321061920,2,2,240
29129621@N05,1679,13,1321077219,1321078299,1,2,1080
29129621@N05,1680,2,1327109827,1327110067,2,3,240
29129621@N05,1680,10,1327120432,1327121332,2,3,900
29129621@N05,1680,11,1327126231,1327127191,2,3,960
29129621@N05,1681,11,1348790932,1348791892,1,1,960
29129621@N05,1682,2,1348965372,1348965612,1,1,240
29129621@N05,1683,2,1358653426,1358653666,1,1,240
29129621@N05,1684,11,1410504309,1410505269,1,1,960
29168905@N00,1685,8,1313477738,1313478578,6,2,840
29168905@N00,1685,5,1313482458,1313482878,10,2,420
29196274@N02,1686,5,1201633184,1201633604,1,1,420
29196274@N02,1687,2,1201710374,1201710614,1,1,240
29225947@N00,1688,6,1380254103,1380254823,8,1,720
29225947@N00,1689,2,1380358962,1380359202,2,1,240
29225947@N00,1690,7,1380663735,1380664575,5,8,840
29225947@N00,1690,2,1380666823,1380667063,5,8,240
29225947@N00,1690,10,1380673307,1380674207,18,8,900
29225947@N00,1690,13,1380676501,1380677581,13,8,1080
29225947@N00,1690,17,1380678081,1380678625,4,8,544
29225947@N00,1690,13,1380678625,1380679705,4,8,1080
29225947@N00,1690,5,1380681503,1380681923,2,8,420
29225947@N00,1690,11,1380705398,1380706358,1,8,960
29232178@N03,1691,11,1410641541,1410642501,1,1,960
29232178@N03,1692,8,1432310868,1432311708,1,1,840
29236889@N07,1693,11,1268317419,1268317421,2,2,2
29236889@N07,1693,10,1268317421,1268318321,1,2,900
29259314@N04,1694,11,1285797815,1285798196,2,8,381
29259314@N04,1694,9,1285798196,1285799096,3,8,900
29259314@N04,1694,11,1285799897,1285800137,2,8,240
29259314@N04,1694,16,1285800137,1285802202,2,8,2065
29259314@N04,1694,17,1285802202,1285804902,8,8,2700
29259314@N04,1694,11,1285806430,1285806594,3,8,164
29259314@N04,1694,13,1285806594,1285807674,2,8,1080
29259314@N04,1694,8,1285811651,1285812491,1,8,840
29259314@N04,1695,14,1285969275,1285970475,7,6,1200
29259314@N04,1695,13,1285971101,1285972181,2,6,1080
29259314@N04,1695,2,1285972853,1285973093,2,6,240
29259314@N04,1695,13,1285979153,1285979399,2,6,246
29259314@N04,1695,15,1285979399,1285979784,2,6,385
29259314@N04,1695,17,1285979784,1285982484,4,6,2700
29259314@N04,1696,6,1411859217,1411859937,8,1,720
29259314@N04,1697,11,1411957368,1411958328,4,1,960
29352917@N00,1698,4,1255486415,1255486775,5,1,360
29352917@N00,1699,11,1255593452,1255594412,1,1,960
29398148@N05,1700,8,1226076612,1226077452,3,1,840
29426902@N02,1701,11,1286851506,1286852466,2,1,960
29460926@N08,1702,13,1299917540,1299918372,2,3,832
29460926@N08,1702,17,1299918372,1299921072,2,3,2700
29460926@N08,1702,11,1299922001,1299922961,1,3,960
29465267@N00,1703,11,1344899201,1344900161,2,2,960
29465267@N00,1703,13,1344907662,1344908742,1,2,1080
29498908@N05,1704,14,1258972244,1258973444,1,1,1200
29530452@N06,1705,8,1355111584,1355112424,1,1,840
29568026@N07,1706,11,1397131729,1397132688,3,3,959
29568026@N07,1706,17,1397132688,1397135388,3,3,2700
29568026@N07,1706,13,1397135508,1397136588,5,3,1080
29583624@N04,1707,13,1223030813,1223031893,1,1,1080
29583624@N04,1708,10,1223169280,1223170180,3,1,900
29619840@N00,1709,11,1209896450,1209897410,3,3,960
29619840@N00,1709,17,1209898529,1209900815,31,3,2286
29619840@N00,1709,11,1209900815,1209901775,4,3,960
29619840@N00,1710,3,1210208266,1210208581,3,24,315
29619840@N00,1710,2,1210208581,1210208821,2,24,240
29619840@N00,1710,12,1210209417,1210209760,3,24,343
29619840@N00,1710,2,1210209760,1210209927,2,24,167
29619840@N00,1710,3,1210209927,1210210257,2,24,330
29619840@N00,1710,14,1210211588,1210212169,2,24,581
29619840@N00,1710,4,1210212169,1210212529,4,24,360
29619840@N00,1710,1,1210216053,1210216293,6,24,240
29619840@N00,1710,15,1210220415,1210220621,3,24,206
29619840@N00,1710,17,1210220621,1210223321,2,24,2700
29619840@N00,1710,11,1210223516,1210224476,10,24,960
29619840@N00,1710,9,1210224975,1210225875,8,24,900
29619840@N00,1710,16,1210226497,1210228597,3,24,2100
29619840@N00,1710,13,1210231906,1210232820,17,24,914
29619840@N00,1710,15,1210232820,1210232929,4,24,109
29619840@N00,1710,17,1210232929,1210233136,6,24,207
29619840@N00,1710,15,1210233136,1210234323,8,24,1187
29619840@N00,1710,17,1210234323,1210234496,2,24,173
29619840@N00,1710,10,1210234496,1210235315,8,24,819
29619840@N00,1710,5,1210235315,1210235735,14,24,420
29619840@N00,1710,8,1210238256,1210239096,37,24,840
29619840@N00,1710,13,1210242065,1210242222,3,24,157
29619840@N00,1710,15,1210242222,1210243422,2,24,1200
29619840@N00,1710,11,1210244300,1210245260,8,24,960
29648523@N05,1711,8,1258544393,1258545233,2,3,840
29648523@N05,1711,9,1258548271,1258548761,2,3,490
29648523@N05,1711,11,1258548761,1258549721,1,3,960
29648523@N05,1712,17,1258765643,1258768343,2,5,2700
29648523@N05,1712,2,1258770821,1258771061,2,5,240
29648523@N05,1712,5,1258780287,1258780707,3,5,420
29648523@N05,1712,8,1258783230,1258784070,2,5,840
29648523@N05,1712,10,1258793041,1258793941,1,5,900
29648523@N05,1713,8,1258861083,1258861923,1,1,840
29651901@N00,1714,11,1374469196,1374470156,2,1,960
29675024@N05,1715,17,1276138985,1276141685,4,3,2700
29675024@N05,1715,11,1276165494,1276166454,2,3,960
29675024@N05,1715,17,1276167980,1276170680,2,3,2700
29756928@N03,1716,13,1399084591,1399085671,1,1,1080
29757228@N06,1717,9,1389648030,1389648930,1,1,900
29758442@N00,1718,10,1217208028,1217208928,2,2,900
29758442@N00,1718,13,1217212178,1217213258,1,2,1080
29775332@N00,1719,1,1383784797,1383785037,2,2,240
29775332@N00,1719,11,1383800398,1383801358,2,2,960
29845947@N00,1720,1,1278751222,1278751462,3,1,240
29847315@N00,1721,11,1220730539,1220731499,2,1,960
29847315@N00,1722,11,1220811346,1220812306,3,1,960
29847315@N00,1723,11,1220955225,1220956185,1,1,960
29847315@N00,1724,11,1221033976,1221034936,2,1,960
29847315@N00,1725,11,1221136835,1221137795,2,1,960
29847315@N00,1726,11,1221183791,1221184751,1,1,960
29865634@N04,1727,4,1214643915,1214644275,1,1,360
29865634@N04,1728,11,1221294525,1221295485,4,2,960
29865634@N04,1728,3,1221296197,1221296527,1,2,330
29865634@N04,1729,5,1223607199,1223607619,2,2,420
29865634@N04,1729,1,1223610234,1223610474,1,2,240
29865634@N04,1730,8,1226729669,1226730509,1,1,840
29865634@N04,1731,11,1233989528,1233990488,6,3,960
29865634@N04,1731,8,1233991545,1233992385,3,3,840
29865634@N04,1731,13,1233993891,1233994971,2,3,1080
29865634@N04,1732,11,1238201117,1238202051,2,6,934
29865634@N04,1732,2,1238202051,1238202291,3,6,240
29865634@N04,1732,12,1238205812,1238206832,7,6,1020
29865634@N04,1732,10,1238209940,1238210840,6,6,900
29865634@N04,1732,15,1238216139,1238216598,2,6,459
29865634@N04,1732,13,1238216598,1238217678,1,6,1080
29865634@N04,1733,11,1240034440,1240035400,9,5,960
29865634@N04,1733,15,1240041555,1240042755,5,5,1200
29865634@N04,1733,8,1240046598,1240047438,2,5,840
29865634@N04,1733,6,1240049847,1240050567,2,5,720
29865634@N04,1733,13,1240055270,1240056350,1,5,1080
29865634@N04,1734,11,1250321404,1250322364,5,1,960
29865634@N04,1735,11,1252009089,1252010049,2,4,960
29865634@N04,1735,3,1252012728,1252013058,3,4,330
29865634@N04,1735,15,1252013944,1252014118,3,4,174
29865634@N04,1735,5,1252014118,1252014538,1,4,420
29865634@N04,1736,2,1252063914,1252064154,2,4,240
29865634@N04,1736,17,1252064546,1252066008,2,4,1462
29865634@N04,1736,7,1252066008,1252066848,2,4,840
29865634@N04,1736,13,1252067550,1252068630,2,4,1080
29865634@N04,1737,8,1254031930,1254032770,3,5,840
29865634@N04,1737,17,1254050741,1254051031,2,5,290
29865634@N04,1737,15,1254051031,1254051333,2,5,302
29865634@N04,1737,13,1254051333,1254052413,2,5,1080
29865634@N04,1737,8,1254055551,1254056391,1,5,840
29865634@N04,1738,11,1254133253,1254134213,2,3,960
29865634@N04,1738,5,1254134402,1254134744,2,3,342
29865634@N04,1738,8,1254134744,1254135584,2,3,840
29875277@N02,1739,11,1389000706,1389001666,1,1,960
29875277@N02,1740,13,1389143516,1389144596,2,3,1080
29875277@N02,1740,8,1389151267,1389152107,3,3,840
29875277@N02,1740,11,1389153895,1389154855,1,3,960
29896241@N06,1741,6,1220160153,1220160873,4,1,720
29914374@N05,1742,11,1240703336,1240704296,2,2,960
29914374@N05,1742,1,1240714536,1240714776,1,2,240
29924665@N05,1743,1,1454540752,1454540992,2,3,240
29924665@N05,1743,15,1454551919,1454553119,2,3,1200
29924665@N05,1743,13,1454553196,1454554276,7,3,1080
29954772@N00,1744,6,1353947575,1353948295,74,2,720
29954772@N00,1744,5,1353949367,1353949787,1,2,420
29957186@N04,1745,11,1378289010,1378289970,1,1,960
29980560@N06,1746,16,1287373074,1287375174,1,1,2100
30030726@N05,1747,17,1437369067,1437371767,2,2,2700
30030726@N05,1747,8,1437375507,1437376347,3,2,840
30042168@N03,1748,11,1328484018,1328484978,5,4,960
30042168@N03,1748,2,1328487064,1328487304,2,4,240
30042168@N03,1748,12,1328488811,1328489831,4,4,1020
30042168@N03,1748,2,1328492651,1328492891,1,4,240
30042168@N03,1749,11,1328763323,1328764283,6,1,960
30143403@N07,1750,3,1256772681,1256773011,3,2,330
30143403@N07,1750,2,1256776183,1256776423,3,2,240
30171461@N05,1751,8,1310463531,1310464371,1,1,840
30180330@N07,1752,11,1383375055,1383376015,7,1,960
30213408@N00,1753,11,1233394660,1233394662,3,6,2
30213408@N00,1753,9,1233394662,1233394663,5,6,1
30213408@N00,1753,16,1233394663,1233394664,2,6,1
30213408@N00,1753,4,1233394664,1233394664,2,6,0
30213408@N00,1753,16,1233394664,1233394665,2,6,1
30213408@N00,1753,4,1233394665,1233395025,5,6,360
30256684@N02,1754,5,1190168811,1190168811,3,4,0
30256684@N02,1754,8,1190168811,1190168811,2,4,0
30256684@N02,1754,10,1190168811,1190168811,2,4,0
30256684@N02,1754,11,1190168811,1190169771,2,4,960
30269754@N05,1755,11,1327650305,1327651033,2,3,728
30269754@N05,1755,5,1327651033,1327651453,3,3,420
30269754@N05,1755,11,1327663737,1327664697,2,3,960
30269754@N05,1756,15,1380961137,1380962337,2,1,1200
30302460@N03,1757,11,1373180618,1373181578,1,1,960
30373545@N06,1758,11,1365843527,1365844487,3,1,960
30375952@N02,1759,11,1351678440,1351679400,1,1,960
30422798@N00,1760,11,1327964602,1327965562,1,1,960
30446909@N07,1761,11,1345621787,1345622747,1,1,960
30485540@N03,1762,15,1244330280,1244330997,2,3,717
30485540@N03,1762,8,1244330997,1244331496,3,3,499
30485540@N03,1762,11,1244331496,1244332456,1,3,960
30485540@N03,1763,9,1244914600,1244915500,1,1,900
30493847@N04,1764,15,1317528388,1317529588,2,3,1200
30493847@N04,1764,5,1317536715,1317537135,2,3,420
30493847@N04,1764,11,1317545204,1317546164,1,3,960
30498272@N07,1765,5,1231568654,1231569074,1,1,420
30514233@N05,1766,5,1382691266,1382691686,2,2,420
30514233@N05,1766,11,1382693656,1382694616,1,2,960
30550906@N06,1767,11,1365852071,1365853031,1,1,960
30571673@N07,1768,5,1355980981,1355981401,1,1,420
30629351@N00,1769,11,1218424123,1218425083,3,11,960
30629351@N00,1769,4,1218426576,1218426936,4,11,360
30629351@N00,1769,10,1218429211,1218429305,2,11,94
30629351@N00,1769,15,1218429305,1218429510,2,11,205
30629351@N00,1769,17,1218429510,1218432023,2,11,2513
30629351@N00,1769,15,1218432023,1218432326,3,11,303
30629351@N00,1769,13,1218432326,1218433406,5,11,1080
30629351@N00,1769,8,1218435754,1218436594,3,11,840
30629351@N00,1769,5,1218437866,1218438286,7,11,420
30629351@N00,1769,1,1218441306,1218441546,2,11,240
30629351@N00,1769,12,1218444037,1218445057,2,11,1020
30650680@N02,1770,8,1411775218,1411776058,1,1,840
30667744@N00,1771,17,1392346404,1392349104,1,1,2700
30673732@N06,1772,9,1326433707,1326434607,1,1,900
30683917@N07,1773,11,1310194659,1310195619,8,4,960
30683917@N07,1773,13,1310199194,1310200274,4,4,1080
30683917@N07,1773,17,1310200282,1310202982,7,4,2700
30683917@N07,1773,10,1310207411,1310208311,4,4,900
30696089@N05,1774,17,1230189368,1230192068,1,1,2700
30699184@N03,1775,11,1354498319,1354499279,1,1,960
30708841@N05,1776,2,1327885558,1327885798,1,1,240
30708841@N05,1777,11,1328684139,1328685099,2,2,960
30708841@N05,1777,9,1328695208,1328696108,1,2,900
30708841@N05,1778,13,1359017037,1359018117,1,1,1080
30738244@N07,1779,11,1201835094,1201836004,2,3,910
30738244@N07,1779,5,1201836004,1201836424,3,3,420
30738244@N07,1779,2,1201845119,1201845359,1,3,240
30743089@N05,1780,8,1292976831,1292977671,2,1,840
30793917@N07,1781,13,1275117278,1275118358,1,1,1080
30831872@N08,1782,17,1241417294,1241419994,2,2,2700
30831872@N08,1782,11,1241431717,1241432677,2,2,960
30831872@N08,1783,12,1241744512,1241745532,2,6,1020
30831872@N08,1783,11,1241753533,1241754493,4,6,960
30831872@N08,1783,1,1241758556,1241758796,3,6,240
30831872@N08,1783,5,1241761480,1241761900,4,6,420
30831872@N08,1783,17,1241774214,1241776914,8,6,2700
30831872@N08,1783,11,1241785613,1241786573,3,6,960
30868771@N03,1784,2,1464088484,1464088724,1,1,240
30891516@N08,1785,11,1304841746,1304842028,3,2,282
30891516@N08,1785,2,1304842028,1304842268,1,2,240
30891516@N08,1786,2,1304906073,1304906313,3,5,240
30891516@N08,1786,5,1304919699,1304920119,2,5,420
30891516@N08,1786,8,1304922188,1304923028,5,5,840
30891516@N08,1786,13,1304937983,1304938381,4,5,398
30891516@N08,1786,17,1304938381,1304941081,1,5,2700
30960094@N04,1787,17,1262835753,1262836820,3,4,1067
30960094@N04,1787,15,1262836820,1262837184,2,4,364
30960094@N04,1787,13,1262837184,1262838264,5,4,1080
30960094@N04,1787,8,1262845613,1262846453,1,4,840
31006502@N04,1788,1,1402190964,1402191204,1,1,240
31006502@N04,1789,13,1433058595,1433059675,1,1,1080
31058815@N00,1790,8,1356245259,1356246099,1,1,840
31072721@N02,1791,11,1252222012,1252222972,1,1,960
31164678@N08,1792,11,1210563457,1210564417,1,1,960
31223689@N00,1793,11,1199061721,1199062681,2,2,960
31223689@N00,1793,15,1199085868,1199087068,1,2,1200
31223689@N00,1794,3,1222321061,1222321391,2,1,330
31272004@N06,1795,11,1344174000,1344174960,1,1,960
31281767@N04,1796,11,1348881577,1348882537,2,2,960
31281767@N04,1796,13,1348888155,1348889235,1,2,1080
31291728@N05,1797,13,1415067879,1415068959,2,1,1080
31291728@N05,1798,1,1415229088,1415229328,2,3,240
31291728@N05,1798,13,1415234343,1415235423,4,3,1080
31291728@N05,1798,8,1415236485,1415237325,2,3,840
31291728@N05,1799,11,1431042924,1431043884,2,2,960
31291728@N05,1799,1,1431060669,1431060909,2,2,240
31291728@N05,1800,11,1431162235,1431163195,4,2,960
31291728@N05,1800,15,1431167266,1431168466,3,2,1200
31291728@N05,1801,13,1431243367,1431244447,8,2,1080
31291728@N05,1801,11,1431253775,1431254735,1,2,960
31291728@N05,1802,6,1431334488,1431335208,1,1,720
31291728@N05,1803,11,1461632933,1461633893,2,2,960
31291728@N05,1803,10,1461642647,1461643547,1,2,900
31291728@N05,1804,13,1461832467,1461833547,7,2,1080
31291728@N05,1804,11,1461841200,1461842160,1,2,960
31291728@N05,1805,8,1461918564,1461919404,3,1,840
31295108@N00,1806,11,1451399789,1451400749,1,1,960
31331814@N04,1807,1,1376264157,1376264397,3,1,240
31348155@N03,1808,11,1326388297,1326389257,1,1,960
31369133@N04,1809,11,1291962702,1291963662,1,1,960
31449648@N05,1810,11,1378024102,1378025062,1,1,960
31474844@N02,1811,11,1269214592,1269215552,3,3,960
31474844@N02,1811,13,1269223269,1269224349,2,3,1080
31474844@N02,1811,1,1269230028,1269230268,1,3,240
31499593@N03,1812,11,1321958674,1321959634,1,1,960
31535569@N00,1813,7,1255299603,1255300443,1,1,840
31535569@N00,1814,17,1255341717,1255344417,2,1,2700
31535569@N00,1815,11,1255503624,1255504584,1,1,960
31541646@N06,1816,11,1271028893,1271029853,30,1,960
31545574@N02,1817,11,1313724696,1313725656,2,2,960
31545574@N02,1817,8,1313734143,1313734983,1,2,840
31559075@N00,1818,11,1257634221,1257635181,2,11,960
31559075@N00,1818,2,1257640813,1257641053,2,11,240
31559075@N00,1818,17,1257647493,1257650193,2,11,2700
31559075@N00,1818,10,1257654131,1257655031,2,11,900
31559075@N00,1818,15,1257658022,1257659222,3,11,1200
31559075@N00,1818,13,1257662682,1257663762,2,11,1080
31559075@N00,1818,1,1257669698,1257669938,2,11,240
31559075@N00,1818,11,1257670272,1257671232,2,11,960
31559075@N00,1818,1,1257673307,1257673547,2,11,240
31559075@N00,1818,9,1257675845,1257676745,4,11,900
31559075@N00,1818,11,1257679617,1257680577,1,11,960
31572810@N04,1819,5,1353823050,1353823470,1,1,420
31616435@N04,1820,11,1311379107,1311380067,2,4,960
31616435@N04,1820,8,1311395954,1311396794,2,4,840
31616435@N04,1820,13,1311405245,1311406325,4,4,1080
31616435@N04,1820,11,1311418209,1311419169,3,4,960
31616435@N04,1821,13,1324253991,1324255071,31,1,1080
31646024@N00,1822,11,1192283415,1192284375,4,2,960
31646024@N00,1822,5,1192305473,1192305893,1,2,420
31646024@N00,1823,13,1194023069,1194024149,2,2,1080
31646024@N00,1823,17,1194029317,1194032017,1,2,2700
31646024@N00,1824,11,1210382318,1210383278,6,7,960
31646024@N00,1824,2,1210385900,1210386140,2,7,240
31646024@N00,1824,9,1210390362,1210391150,5,7,788
31646024@N00,1824,1,1210391150,1210391390,12,7,240
31646024@N00,1824,10,1210392388,1210393288,18,7,900
31646024@N00,1824,15,1210403691,1210404639,13,7,948
31646024@N00,1824,13,1210404639,1210405719,7,7,1080
31646024@N00,1825,10,1284187179,1284187217,2,5,38
31646024@N00,1825,15,1284187217,1284187320,2,5,103
31646024@N00,1825,10,1284187320,1284188220,2,5,900
31646024@N00,1825,13,1284195336,1284196416,4,5,1080
31646024@N00,1825,11,1284210526,1284211486,2,5,960
31681108@N07,1826,11,1246529913,1246530873,1,1,960
31692641@N00,1827,13,1228533751,1228534039,2,13,288
31692641@N00,1827,15,1228534039,1228535239,3,13,1200
31692641@N00,1827,10,1228535959,1228536859,4,13,900
31692641@N00,1827,11,1228539527,1228540487,4,13,960
31692641@N00,1827,13,1228541400,1228541402,3,13,2
31692641@N00,1827,11,1228541402,1228542362,5,13,960
31692641@N00,1827,2,1228542838,1228543078,2,13,240
31692641@N00,1827,1,1228543200,1228543201,2,13,1
31692641@N00,1827,11,1228543201,1228543202,2,13,1
31692641@N00,1827,10,1228543202,1228543203,2,13,1
31692641@N00,1827,4,1228543203,1228543204,2,13,1
31692641@N00,1827,5,1228543204,1228543624,2,13,420
31692641@N00,1827,11,1228548939,1228549899,1,13,960
31692641@N00,1828,9,1238504400,1238505300,1,1,900
31692641@N00,1829,12,1317819600,1317819601,2,4,1
31692641@N00,1829,10,1317819601,1317819602,2,4,1
31692641@N00,1829,13,1317819602,1317819611,5,4,9
31692641@N00,1829,5,1317819611,1317820031,1,4,420
31692641@N00,1830,1,1317852462,1317852702,3,4,240
31692641@N00,1830,2,1317870720,1317870960,7,4,240
31692641@N00,1830,11,1317871157,1317872117,2,4,960
31692641@N00,1830,13,1317873115,1317874195,6,4,1080
31764887@N02,1831,5,1333198800,1333198800,2,4,0
31764887@N02,1831,8,1333198800,1333198800,3,4,0
31764887@N02,1831,13,1333198800,1333198800,3,4,0
31764887@N02,1831,15,1333198800,1333200000,1,4,1200
31764887@N02,1832,17,1335163979,1335166679,1,1,2700
31764887@N02,1833,8,1364734800,1364734800,2,3,0
31764887@N02,1833,15,1364734800,1364734800,2,3,0
31764887@N02,1833,17,1364734800,1364737500,1,3,2700
31764887@N02,1834,5,1383224400,1383224820,1,1,420
31764887@N02,1835,15,1396270800,1396272000,2,1,1200
31764887@N02,1836,13,1398866400,1398866400,2,2,0
31764887@N02,1836,15,1398866400,1398867600,1,2,1200
31770349@N02,1837,11,1223521723,1223522683,4,3,960
31770349@N02,1837,1,1223526992,1223527232,4,3,240
31770349@N02,1837,17,1223536575,1223539275,3,3,2700
31770349@N02,1838,5,1223617796,1223618216,2,2,420
31770349@N02,1838,11,1223619923,1223620883,1,2,960
31821378@N00,1839,9,1256038351,1256039251,1,1,900
31846143@N08,1840,11,1238903349,1238904309,32,1,960
31858821@N07,1841,11,1448849960,1448850920,2,1,960
31858821@N07,1842,11,1448881594,1448882554,1,1,960
31868255@N00,1843,11,1313487477,1313488437,1,1,960
31911001@N00,1844,11,1414147856,1414148816,1,1,960
31911001@N00,1845,5,1414314322,1414314742,2,1,420
31912731@N08,1846,11,1225845278,1225846238,1,1,960
31924266@N02,1847,4,1304681309,1304681669,1,1,360
31937081@N07,1848,9,1421972077,1421972977,3,1,900
31937081@N07,1849,10,1422013850,1422014750,2,1,900
31957707@N08,1850,8,1419748293,1419749133,1,1,840
31962189@N04,1851,11,1401139205,1401140165,1,1,960
32037921@N06,1852,11,1414479895,1414480855,1,1,960
32040587@N04,1853,11,1304603176,1304604136,1,1,960
32072533@N08,1854,2,1344348010,1344348250,1,1,240
32263245@N00,1855,8,1289020511,1289021351,13,2,840
32263245@N00,1855,11,1289027554,1289028514,2,2,960
32263245@N00,1856,17,1291635539,1291638239,5,1,2700
32301780@N06,1857,11,1399429035,1399429995,2,2,960
32301780@N06,1857,17,1399437833,1399440533,1,2,2700
32359947@N00,1858,1,1243655900,1243656140,2,2,240
32359947@N00,1858,3,1243670970,1243671300,2,2,330
32372198@N00,1859,11,1360984250,1360985210,2,1,960
32388039@N03,1860,17,1381874641,1381877341,13,5,2700
32388039@N03,1860,6,1381879576,1381880296,8,5,720
32388039@N03,1860,8,1381883888,1381884728,2,5,840
32388039@N03,1860,5,1381884876,1381885296,2,5,420
32388039@N03,1860,1,1381890073,1381890313,1,5,240
32399171@N00,1861,5,1300664200,1300664620,1,1,420
32399171@N00,1862,11,1373503149,1373504109,1,1,960
32399171@N00,1863,11,1468195946,1468196906,1,1,960
32527241@N04,1864,11,1266213983,1266214943,2,3,960
32527241@N04,1864,1,1266215172,1266215412,4,3,240
32527241@N04,1864,6,1266223270,1266223990,27,3,720
32536732@N00,1865,11,1204185251,1204186211,1,1,960
32617425@N00,1866,15,1351383384,1351383438,2,2,54
32617425@N00,1866,17,1351383438,1351386138,1,2,2700
32617425@N00,1867,17,1352601421,1352604121,1,1,2700
32644191@N07,1868,10,1254634391,1254635291,2,2,900
32644191@N07,1868,17,1254642997,1254645697,4,2,2700
32644191@N07,1869,6,1254927705,1254928425,3,1,720
32644191@N07,1870,17,1255730744,1255733444,2,1,2700
32663429@N04,1871,17,1351854121,1351856821,13,1,2700
32663429@N04,1872,11,1457855022,1457855982,2,1,960
32734603@N05,1873,17,1413693932,1413696632,6,1,2700
32744581@N05,1874,11,1277243852,1277244812,1,1,960
32858590@N00,1875,14,1188087200,1188088400,9,1,1200
32858590@N00,1876,14,1188775891,1188777091,30,1,1200
32858590@N00,1877,14,1189149298,1189150498,30,1,1200
32858590@N00,1878,14,1189215096,1189216296,39,1,1200
32858590@N00,1879,14,1189817432,1189818632,8,1,1200
32858590@N00,1880,14,1189921465,1189922665,1,1,1200
32858590@N00,1881,14,1190360248,1190361448,9,1,1200
32858590@N00,1882,14,1191304108,1191305308,10,1,1200
32858590@N00,1883,14,1191974485,1191975685,6,1,1200
32858590@N00,1884,14,1194066128,1194067328,17,1,1200
32858590@N00,1885,14,1194652594,1194653794,29,1,1200
32858590@N00,1886,14,1194733537,1194734737,3,1,1200
32858590@N00,1887,14,1195186288,1195187488,17,1,1200
32858590@N00,1888,14,1195375566,1195376766,9,1,1200
32858590@N00,1889,14,1197778215,1197779415,8,1,1200
32858590@N00,1890,14,1198223246,1198224446,7,1,1200
32858590@N00,1891,14,1199578850,1199580050,18,1,1200
32858590@N00,1892,14,1200791035,1200792235,16,1,1200
32858590@N00,1893,14,1201411954,1201413154,10,1,1200
32858590@N00,1894,14,1203838529,1203839729,6,1,1200
32858590@N00,1895,14,1204934174,1204935374,27,1,1200
32858590@N00,1896,14,1205034077,1205035277,22,1,1200
32858590@N00,1897,14,1206752210,1206753410,68,1,1200
32858590@N00,1898,14,1208000358,1208001558,1,1,1200
32858590@N00,1899,14,1208509739,1208510939,10,1,1200
32858590@N00,1900,14,1209769888,1209771088,5,1,1200
32858590@N00,1901,14,1212223502,1212224702,4,1,1200
32858590@N00,1902,14,1218785188,1218786388,8,1,1200
32858590@N00,1903,14,1218844689,1218845889,3,1,1200
32858590@N00,1904,14,1218933501,1218934701,1,1,1200
32858590@N00,1905,14,1219456713,1219457913,7,1,1200
32858590@N00,1906,14,1220143561,1220144761,2,1,1200
32858590@N00,1907,14,1220599746,1220600946,8,1,1200
32858590@N00,1908,14,1220688577,1220689777,5,1,1200
32858590@N00,1909,14,1220747289,1220748489,3,1,1200
32858590@N00,1910,14,1221281520,1221282720,4,1,1200
32858590@N00,1911,14,1223193029,1223194229,1,1,1200
32858590@N00,1912,14,1223691436,1223692636,6,1,1200
32858590@N00,1913,14,1223751376,1223752576,24,1,1200
32858590@N00,1914,14,1224142128,1224143328,22,1,1200
32858590@N00,1915,14,1224904667,1224905867,18,1,1200
32858590@N00,1916,14,1224970750,1224971950,21,1,1200
32904352@N00,1917,11,1346968263,1346969223,1,1,960
32904352@N00,1918,11,1347236287,1347237247,1,1,960
32904352@N00,1919,11,1347442503,1347443463,1,1,960
32935283@N06,1920,17,1357030252,1357032952,1,1,2700
33050020@N08,1921,17,1360967344,1360970044,1,1,2700
33063488@N02,1922,4,1286529029,1286529389,1,1,360
33063488@N02,1923,2,1301051554,1301051794,2,2,240
33063488@N02,1923,11,1301053342,1301054302,1,2,960
33115152@N06,1924,11,1248072899,1248073859,1,1,960
33121758@N04,1925,11,1229211084,1229212044,2,2,960
33121758@N04,1925,10,1229212330,1229213230,9,2,900
33121758@N04,1926,13,1345265674,1345266754,1,1,1080
33121758@N04,1927,6,1350272837,1350273557,1,1,720
33121758@N04,1928,11,1354334018,1354334978,1,1,960
33121758@N04,1929,1,1359155389,1359155629,2,1,240
33121758@N04,1930,11,1362263721,1362264681,2,2,960
33121758@N04,1930,13,1362265538,1362266618,1,2,1080
33121758@N04,1931,15,1365816779,1365817979,1,1,1200
33121758@N04,1932,11,1368781206,1368782166,1,1,960
33121758@N04,1933,11,1378533166,1378534126,1,1,960
33121758@N04,1934,5,1380935646,1380936066,1,1,420
33121758@N04,1935,5,1383445863,1383446283,1,1,420
33197996@N07,1936,11,1397066717,1397067677,1,1,960
33197996@N07,1937,8,1403467491,1403468331,1,1,840
33197996@N07,1938,11,1452302609,1452303569,1,1,960
33237989@N06,1939,11,1238055393,1238056353,2,1,960
33244915@N00,1940,2,1329264198,1329264438,2,1,240
33244915@N00,1941,14,1329299510,1329299560,4,6,50
33244915@N00,1941,3,1329299560,1329299662,6,6,102
33244915@N00,1941,4,1329299662,1329299704,3,6,42
33244915@N00,1941,2,1329299704,1329299944,21,6,240
33244915@N00,1941,5,1329300460,1329300736,13,6,276
33244915@N00,1941,8,1329300736,1329301576,12,6,840
33244915@N00,1942,11,1329540904,1329541864,25,1,960
33257765@N05,1943,11,1333855530,1333856490,1,1,960
33257765@N05,1944,9,1373784817,1373785717,1,1,900
33272592@N00,1945,11,1381049514,1381050474,3,2,960
33272592@N00,1945,17,1381058459,1381061159,1,2,2700
33334548@N05,1946,11,1221907721,1221908681,1,1,960
33360568@N05,1947,1,1389067419,1389067659,2,6,240
33360568@N05,1947,15,1389068394,1389068526,2,6,132
33360568@N05,1947,13,1389068526,1389069606,2,6,1080
33360568@N05,1947,8,1389074512,1389075352,8,6,840
33360568@N05,1947,5,1389078219,1389078639,2,6,420
33360568@N05,1947,11,1389080540,1389081500,1,6,960
33419223@N08,1948,11,1342847593,1342848553,1,1,960
33433883@N02,1949,5,1276263265,1276263685,1,1,420
33455872@N05,1950,3,1306773494,1306773663,2,3,169
33455872@N05,1950,13,1306773663,1306773782,2,3,119
33455872@N05,1950,8,1306773782,1306774622,2,3,840
33455872@N05,1951,1,1313578994,1313579234,1,1,240
33455872@N05,1952,11,1345009196,1345010156,2,3,960
33455872@N05,1952,5,1345013543,1345013963,4,3,420
33455872@N05,1952,10,1345021734,1345022634,2,3,900
33462708@N06,1953,11,1272248918,1272249878,1,1,960
33479020@N04,1954,5,1263507955,1263508375,1,1,420
33479020@N04,1955,12,1263566268,1263567288,1,1,1020
33479020@N04,1956,1,1265260158,1265260398,1,1,240
33479020@N04,1957,5,1267797387,1267797807,1,1,420
33479020@N04,1958,9,1268026934,1268027834,1,1,900
33479020@N04,1959,14,1270021798,1270022998,1,1,1200
33479020@N04,1960,16,1290449759,1290451859,1,1,2100
33479020@N04,1961,11,1291184611,1291185571,1,1,960
33479020@N04,1962,1,1295233711,1295233951,1,1,240
33479020@N04,1963,1,1296713084,1296713324,1,1,240
33479020@N04,1964,13,1297662271,1297663351,1,1,1080
33479020@N04,1965,5,1299648173,1299648593,1,1,420
33479020@N04,1966,11,1302679521,1302680481,1,1,960
33479020@N04,1967,11,1303109906,1303110866,1,1,960
33479020@N04,1968,4,1306909773,1306910133,1,1,360
33479020@N04,1969,2,1312357037,1312357277,1,1,240
33479020@N04,1970,1,1313564072,1313564312,1,1,240
33479020@N04,1971,11,1314771555,1314772515,1,1,960
33494202@N04,1972,11,1252276753,1252277713,11,9,960
33494202@N04,1972,16,1252279712,1252281091,2,9,1379
33494202@N04,1972,12,1252281091,1252282111,4,9,1020
33494202@N04,1972,2,1252283243,1252283331,2,9,88
33494202@N04,1972,12,1252283331,1252284351,3,9,1020
33494202@N04,1972,14,1252290794,1252290888,2,9,94
33494202@N04,1972,7,1252290888,1252291728,3,9,840
33494202@N04,1972,5,1252293554,1252293974,7,9,420
33494202@N04,1972,4,1252296548,1252296908,2,9,360
33494202@N04,1973,5,1252659424,1252659844,7,1,420
33507605@N03,1974,15,1250052702,1250053265,5,6,563
33507605@N03,1974,4,1250053265,1250053625,8,6,360
33507605@N03,1974,10,1250060224,1250061124,8,6,900
33507605@N03,1974,15,1250062237,1250063034,4,6,797
33507605@N03,1974,13,1250063034,1250064114,7,6,1080
33507605@N03,1974,8,1250087442,1250088282,5,6,840
33507605@N03,1975,15,1250165608,1250166808,2,1,1200
33507605@N03,1976,13,1250256214,1250257294,3,3,1080
33507605@N03,1976,8,1250260102,1250260611,6,3,509
33507605@N03,1976,5,1250260611,1250261031,1,3,420
33515112@N00,1977,1,1382917652,1382917892,1,1,240
33539876@N06,1978,11,1261471229,1261472189,1,1,960
33546659@N08,1979,7,1323740241,1323741081,1,1,840
33546659@N08,1980,16,1323833736,1323835836,2,4,2100
33546659@N08,1980,2,1323836989,1323837229,2,4,240
33546659@N08,1980,8,1323854253,1323855093,2,4,840
33546659@N08,1980,11,1323855942,1323856902,1,4,960
33563310@N06,1981,11,1349424333,1349425293,4,8,960
33563310@N06,1981,9,1349427256,1349427882,2,8,626
33563310@N06,1981,1,1349427882,1349428122,4,8,240
33563310@N06,1981,5,1349428324,1349428744,2,8,420
33563310@N06,1981,17,1349429577,1349429922,2,8,345
33563310@N06,1981,13,1349429922,1349431002,2,8,1080
33563310@N06,1981,11,1349433288,1349434248,2,8,960
33563310@N06,1981,1,1349448821,1349449061,1,8,240
33563310@N06,1982,11,1357118301,1357119261,2,3,960
33563310@N06,1982,17,1357121040,1357123740,4,3,2700
33563310@N06,1982,11,1357125090,1357126050,1,3,960
33590021@N04,1983,11,1327731758,1327732718,1,1,960
33593400@N04,1984,16,1326271524,1326273624,1,1,2100
33598193@N03,1985,8,1325340094,1325340934,1,1,840
33598193@N03,1986,2,1368265039,1368265279,1,1,240
33598193@N03,1987,1,1379917458,1379917698,1,1,240
33598193@N03,1988,9,1381204424,1381204744,2,3,320
33598193@N03,1988,15,1381204744,1381205013,2,3,269
33598193@N03,1988,13,1381205013,1381206093,1,3,1080
33598193@N03,1989,14,1389423206,1389424406,1,1,1200
33598193@N03,1990,15,1394269276,1394269823,2,2,547
33598193@N03,1990,11,1394269823,1394270783,1,2,960
33598193@N03,1991,5,1394409996,1394410416,1,1,420
33598193@N03,1992,11,1394494666,1394495626,1,1,960
33598193@N03,1993,11,1395461960,1395462920,1,1,960
33598193@N03,1994,13,1396153182,1396154262,1,1,1080
33598193@N03,1995,8,1412164646,1412165486,2,1,840
33598193@N03,1996,11,1463285271,1463286231,1,1,960
33623158@N04,1997,11,1230197356,1230198316,1,1,960
33636257@N06,1998,13,1415924580,1415925660,1,1,1080
33667899@N07,1999,11,1318455875,1318456835,4,3,960
33667899@N07,1999,8,1318470519,1318471359,3,3,840
33667899@N07,1999,11,1318482646,1318483606,1,3,960
33667899@N07,2000,8,1318838646,1318838709,2,2,63
33667899@N07,2000,11,1318838709,1318839669,2,2,960
33667899@N07,2001,12,1349913892,1349914912,3,3,1020
33667899@N07,2001,11,1349916367,1349917327,2,3,960
33667899@N07,2001,9,1349927204,1349928104,2,3,900
33667899@N07,2002,11,1350278548,1350279508,3,3,960
33667899@N07,2002,2,1350282521,1350282761,2,3,240
33667899@N07,2002,8,1350292402,1350293242,1,3,840
33667899@N07,2003,11,1382079944,1382080904,2,4,960
33667899@N07,2003,8,1382087152,1382087992,2,4,840
33667899@N07,2003,14,1382090921,1382091301,2,4,380
33667899@N07,2003,7,1382091301,1382092141,2,4,840
33700145@N05,2004,6,1278922010,1278922730,4,8,720
33700145@N05,2004,13,1278925754,1278926834,7,8,1080
33700145@N05,2004,17,1278927534,1278927553,2,8,19
33700145@N05,2004,15,1278927553,1278928606,6,8,1053
33700145@N05,2004,17,1278928606,1278928899,4,8,293
33700145@N05,2004,15,1278928899,1278929472,5,8,573
33700145@N05,2004,13,1278929472,1278930552,2,8,1080
33700145@N05,2004,11,1278937790,1278938750,1,8,960
33700145@N05,2005,13,1279015899,1279016979,1,1,1080
33704098@N00,2006,11,1389220348,1389221308,3,5,960
33704098@N00,2006,10,1389226645,1389227545,3,5,900
33704098@N00,2006,15,1389228089,1389228471,3,5,382
33704098@N00,2006,13,1389228471,1389229551,4,5,1080
33704098@N00,2006,8,1389242530,1389243370,4,5,840
33719077@N06,2007,17,1323680143,1323682843,3,1,2700
33719077@N06,2008,11,1323934159,1323935119,6,2,960
33719077@N06,2008,5,1323935623,1323936043,1,2,420
33719077@N06,2009,1,1390863124,1390863364,2,3,240
33719077@N06,2009,2,1390872124,1390872364,3,3,240
33719077@N06,2009,12,1390872717,1390873737,2,3,1020
33719077@N06,2010,1,1391216045,1391216285,6,2,240
33719077@N06,2010,16,1391224942,1391227042,2,2,2100
33722213@N06,2011,15,1355823400,1355824600,1,1,1200
33725927@N00,2012,7,1299017967,1299018807,1,1,840
33754377@N03,2013,11,1363507760,1363508720,1,1,960
33754377@N03,2014,13,1395541753,1395541807,3,13,54
33754377@N03,2014,11,1395541807,1395541835,2,13,28
33754377@N03,2014,15,1395541835,1395541847,2,13,12
33754377@N03,2014,5,1395541847,1395542054,2,13,207
33754377@N03,2014,11,1395542054,1395542222,5,13,168
33754377@N03,2014,13,1395542222,1395542294,2,13,72
33754377@N03,2014,11,1395542294,1395542388,2,13,94
33754377@N03,2014,3,1395542388,1395542505,2,13,117
33754377@N03,2014,11,1395542505,1395542806,2,13,301
33754377@N03,2014,17,1395542806,1395542843,3,13,37
33754377@N03,2014,8,1395542843,1395542964,3,13,121
33754377@N03,2014,13,1395542964,1395543180,2,13,216
33754377@N03,2014,11,1395543180,1395544140,4,13,960
33754377@N03,2015,13,1396145214,1396145224,2,2,10
33754377@N03,2015,8,1396145224,1396146064,1,2,840
33754377@N03,2016,9,1412993171,1412994071,3,1,900
33754377@N03,2017,16,1414721000,1414723100,2,2,2100
33754377@N03,2017,9,1414723877,1414724777,1,2,900
33754377@N03,2018,9,1415489652,1415490552,2,1,900
33754377@N03,2019,13,1425686395,1425687475,3,2,1080
33754377@N03,2019,8,1425693707,1425694547,1,2,840
33754377@N03,2020,8,1425799368,1425800208,2,1,840
33754377@N03,2021,11,1443868677,1443869637,1,1,960
33754377@N03,2022,6,1444544964,1444545684,1,1,720
33754377@N03,2023,11,1445056007,1445056967,1,1,960
33754377@N03,2024,11,1445745363,1445746323,1,1,960
33765978@N00,2025,5,1204074447,1204074867,6,5,420
33765978@N00,2025,8,1204078220,1204079060,13,5,840
33765978@N00,2025,10,1204096360,1204097260,5,5,900
33765978@N00,2025,13,1204102508,1204103322,2,5,814
33765978@N00,2025,17,1204103322,1204106022,5,5,2700
33786609@N02,2026,11,1437032853,1437033813,2,4,960
33786609@N02,2026,2,1437034815,1437035055,2,4,240
33786609@N02,2026,15,1437036302,1437037332,3,4,1030
33786609@N02,2026,2,1437037332,1437037572,4,4,240
33817868@N00,2027,11,1268877445,1268878405,1,1,960
33822743@N08,2028,11,1230306655,1230307615,2,1,960
33822743@N08,2029,11,1257741377,1257742337,5,1,960
33822743@N08,2030,11,1259895898,1259896858,4,1,960
33822743@N08,2031,11,1273226980,1273227940,2,2,960
33822743@N08,2031,6,1273230594,1273231314,1,2,720
33822743@N08,2032,8,1273876775,1273877615,1,1,840
33822743@N08,2033,4,1274665017,1274665377,1,1,360
33822743@N08,2034,11,1275004661,1275005621,1,1,960
33822743@N08,2035,17,1289014931,1289017631,1,1,2700
33822743@N08,2036,5,1291618111,1291618531,1,1,420
33822743@N08,2037,17,1297993568,1297996268,1,1,2700
33822883@N06,2038,16,1231450305,1231452405,1,1,2100
33824882@N07,2039,17,1398049217,1398051917,1,1,2700
33877234@N07,2040,10,1211405897,1211406797,4,1,900
33877234@N07,2041,5,1211441810,1211442230,1,1,420
33912195@N05,2042,11,1305616906,1305617866,1,1,960
33929547@N03,2043,11,1431059289,1431060249,3,3,960
33929547@N03,2043,9,1431060707,1431061512,2,3,805
33929547@N03,2043,11,1431061512,1431062472,1,3,960
33931717@N03,2044,8,1230344642,1230345482,2,2,840
33931717@N03,2044,4,1230351021,1230351381,3,2,360
33934966@N00,2045,11,1290237635,1290238595,4,9,960
33934966@N00,2045,9,1290239931,1290240831,3,9,900
33934966@N00,2045,15,1290247286,1290248486,4,9,1200
33934966@N00,2045,8,1290250402,1290251242,5,9,840
33934966@N00,2045,5,1290252149,1290252569,12,9,420
33934966@N00,2045,13,1290255339,1290255643,2,9,304
33934966@N00,2045,15,1290255643,1290255954,2,9,311
33934966@N00,2045,10,1290255954,1290256533,2,9,579
33934966@N00,2045,11,1290256533,1290257493,2,9,960
33934966@N00,2046,14,1290567684,1290568884,6,3,1200
33934966@N00,2046,10,1290579992,1290580541,2,3,549
33934966@N00,2046,13,1290580541,1290581621,4,3,1080
33934966@N00,2047,1,1320201753,1320201993,2,6,240
33934966@N00,2047,4,1320204324,1320204684,2,6,360
33934966@N00,2047,2,1320205889,1320206129,3,6,240
33934966@N00,2047,5,1320214028,1320214448,2,6,420
33934966@N00,2047,8,1320215708,1320216548,3,6,840
33934966@N00,2047,11,1320219550,1320220510,2,6,960
33934966@N00,2048,11,1320587940,1320588900,3,1,960
33971415@N07,2049,13,1248683716,1248684796,3,2,1080
33971415@N07,2049,8,1248685119,1248685959,1,2,840
34003939@N08,2050,6,1356084070,1356084790,2,1,720
34008523@N06,2051,1,1292938448,1292938688,1,1,240
34008756@N07,2052,17,1268886673,1268889373,1,1,2700
34012582@N04,2053,11,1209718316,1209719276,1,1,960
34021154@N00,2054,1,1300761697,1300761937,2,2,240
34021154@N00,2054,11,1300771333,1300772293,1,2,960
34038355@N06,2055,11,1353019707,1353020667,6,3,960
34038355@N06,2055,17,1353024610,1353024902,2,3,292
34038355@N06,2055,13,1353024902,1353025982,1,3,1080
34056195@N00,2056,17,1341829043,1341831743,1,1,2700
34091054@N00,2057,17,1286928624,1286929018,2,2,394
34091054@N00,2057,13,1286929018,1286930098,1,2,1080
34104198@N06,2058,11,1350706283,1350707243,1,1,960
34104198@N06,2059,8,1379257254,1379258094,1,1,840
34127338@N04,2060,11,1445740213,1445741173,251,1,960
34153311@N05,2061,11,1318751704,1318752664,2,1,960
34153311@N05,2062,12,1361080307,1361081327,3,2,1020
34153311@N05,2062,11,1361084328,1361085288,1,2,960
34153311@N05,2063,11,1361173594,1361174554,1,1,960
34153311@N05,2064,14,1361256817,1361258017,7,1,1200
34153311@N05,2065,5,1361434327,1361434747,1,1,420
34153311@N05,2066,11,1408158215,1408159045,5,3,830
34153311@N05,2066,12,1408159045,1408160065,4,3,1020
34153311@N05,2066,11,1408178727,1408179687,4,3,960
34153311@N05,2067,1,1408402423,1408402663,3,2,240
34153311@N05,2067,2,1408419260,1408419500,3,2,240
34153311@N05,2068,2,1408518930,1408519170,15,1,240
34157227@N04,2069,13,1319178610,1319179690,3,1,1080
34157227@N04,2070,2,1324523114,1324523354,2,1,240
34168306@N08,2071,8,1296477260,1296478100,1,1,840
34176066@N00,2072,2,1319591659,1319591899,8,2,240
34176066@N00,2072,11,1319595458,1319596418,6,2,960
34176066@N00,2073,1,1319629719,1319629959,2,1,240
34239398@N00,2074,16,1197520454,1197522554,2,3,2100
34239398@N00,2074,12,1197527362,1197528382,2,3,1020
34239398@N00,2074,1,1197550800,1197551040,1,3,240
34361916@N00,2075,16,1339657906,1339660006,2,2,2100
34361916@N00,2075,13,1339670279,1339671359,1,2,1080
34387526@N02,2076,16,1253431010,1253433110,1,1,2100
34390084@N07,2077,11,1200249105,1200250065,2,1,960
34390084@N07,2078,11,1231787718,1231788678,6,1,960
34390084@N07,2079,11,1234840705,1234841665,2,7,960
34390084@N07,2079,8,1234852751,1234853591,2,7,840
34390084@N07,2079,5,1234854445,1234854865,2,7,420
34390084@N07,2079,2,1234855327,1234855567,3,7,240
34390084@N07,2079,11,1234856106,1234856857,4,7,751
34390084@N07,2079,9,1234856857,1234857757,3,7,900
34390084@N07,2079,11,1234858388,1234859348,1,7,960
34390084@N07,2080,5,1235634511,1235634931,2,2,420
34390084@N07,2080,8,1235635875,1235636715,1,2,840
34390084@N07,2081,11,1236566148,1236567108,1,1,960
34390084@N07,2082,16,1238465844,1238466044,2,5,200
34390084@N07,2082,11,1238466044,1238467004,3,5,960
34390084@N07,2082,5,1238467641,1238468059,2,5,418
34390084@N07,2082,8,1238468059,1238468899,2,5,840
34390084@N07,2082,11,1238473013,1238473973,4,5,960
34390084@N07,2083,11,1238736650,1238737610,8,4,960
34390084@N07,2083,16,1238738449,1238739666,2,4,1217
34390084@N07,2083,8,1238739666,1238740506,2,4,840
34390084@N07,2083,13,1238740857,1238741937,1,4,1080
34390084@N07,2084,10,1238801756,1238802656,2,1,900
34390084@N07,2085,11,1239160052,1239161012,2,4,960
34390084@N07,2085,16,1239162005,1239162139,2,4,134
34390084@N07,2085,9,1239162139,1239163039,2,4,900
34390084@N07,2085,11,1239170471,1239171431,3,4,960
34390084@N07,2086,10,1241224346,1241225246,2,1,900
34390084@N07,2087,5,1260593811,1260594231,3,1,420
34396244@N05,2088,11,1249048800,1249049760,1,1,960
34396697@N00,2089,6,1329991584,1329992304,2,1,720
34396697@N00,2090,9,1334192599,1334193499,1,1,900
34407909@N07,2091,2,1202157627,1202157867,2,1,240
34444521@N03,2092,8,1317767154,1317767994,1,1,840
34463478@N08,2093,11,1364085152,1364086112,1,1,960
34482114@N07,2094,17,1398887430,1398890130,1,1,2700
34486247@N00,2095,11,1234230619,1234231579,1,1,960
34595143@N07,2096,7,1294047081,1294047921,1,1,840
34659812@N03,2097,17,1246878491,1246881191,1,1,2700
34664691@N03,2098,5,1301708317,1301708737,1,1,420
34677189@N07,2099,5,1459840991,1459841411,1,1,420
34695134@N00,2100,5,1197855794,1197856214,2,2,420
34695134@N00,2100,17,1197869897,1197872597,4,2,2700
34703628@N00,2101,6,1300584722,1300585442,1,1,720
34709732@N08,2102,11,1373677629,1373678589,3,2,960
34709732@N08,2102,10,1373692273,1373693173,1,2,900
34727974@N05,2103,8,1291861505,1291862345,2,3,840
34727974@N05,2103,17,1291867510,1291870210,7,3,2700
34727974@N05,2103,8,1291874677,1291875517,4,3,840
34736908@N05,2104,8,1318766436,1318767276,1,1,840
34737607@N00,2105,11,1234331346,1234332306,9,8,960
34737607@N00,2105,5,1234336120,1234336540,4,8,420
34737607@N00,2105,1,1234338709,1234338949,12,8,240
34737607@N00,2105,11,1234340402,1234341362,12,8,960
34737607@N00,2105,1,1234344682,1234344922,6,8,240
34737607@N00,2105,10,1234347749,1234348649,7,8,900
34737607@N00,2105,13,1234350661,1234351741,4,8,1080
34737607@N00,2105,11,1234359758,1234360718,1,8,960
34748748@N02,2106,5,1295000076,1295000496,7,3,420
34748748@N02,2106,13,1295013894,1295014974,2,3,1080
34748748@N02,2106,5,1295016972,1295017392,1,3,420
34771728@N00,2107,11,1200781579,1200782539,2,5,960
34771728@N00,2107,8,1200799560,1200800400,2,5,840
34771728@N00,2107,5,1200803719,1200804139,2,5,420
34771728@N00,2107,8,1200812800,1200813640,2,5,840
34771728@N00,2107,11,1200815326,1200816286,1,5,960
34866307@N05,2108,14,1323579288,1323580488,1,1,1200
34982494@N06,2109,16,1295932105,1295934205,1,1,2100
35034348373@N01,2110,11,1363830542,1363831502,2,3,960
35034348373@N01,2110,10,1363837587,1363838487,2,3,900
35034348373@N01,2110,11,1363854391,1363855351,1,3,960
35034348373@N01,2111,11,1364009600,1364010560,1,1,960
35034348373@N01,2112,11,1364374930,1364375890,3,1,960
35034348373@N01,2113,16,1364606296,1364608396,3,2,2100
35034348373@N01,2113,8,1364610102,1364610942,3,2,840
35034354650@N01,2114,11,1301006136,1301007096,4,5,960
35034354650@N01,2114,5,1301014694,1301015114,2,5,420
35034354650@N01,2114,8,1301020496,1301021336,2,5,840
35034354650@N01,2114,17,1301026676,1301029376,3,5,2700
35034354650@N01,2114,11,1301030125,1301031085,1,5,960
35034363370@N01,2115,11,1414792599,1414793452,6,24,853
35034363370@N01,2115,1,1414793452,1414793692,10,24,240
35034363370@N01,2115,2,1414795283,1414795523,3,24,240
35034363370@N01,2115,12,1414796031,1414797051,9,24,1020
35034363370@N01,2115,7,1414797905,1414798745,4,24,840
35034363370@N01,2115,14,1414800285,1414800514,4,24,229
35034363370@N01,2115,3,1414800514,1414800844,2,24,330
35034363370@N01,2115,11,1414801453,1414801499,2,24,46
35034363370@N01,2115,2,1414801499,1414801739,3,24,240
35034363370@N01,2115,11,1414801990,1414802950,6,24,960
35034363370@N01,2115,17,1414804745,1414805015,4,24,270
35034363370@N01,2115,13,1414805015,1414805447,4,24,432
35034363370@N01,2115,15,1414805447,1414806532,2,24,1085
35034363370@N01,2115,4,1414806532,1414806892,2,24,360
35034363370@N01,2115,2,1414808772,1414808967,3,24,195
35034363370@N01,2115,11,1414808967,1414809927,2,24,960
35034363370@N01,2115,16,1414811377,1414812761,5,24,1384
35034363370@N01,2115,9,1414812761,1414812798,2,24,37
35034363370@N01,2115,16,1414812798,1414813172,2,24,374
35034363370@N01,2115,9,1414813172,1414814072,3,24,900
35034363370@N01,2115,17,1414814476,1414815002,3,24,526
35034363370@N01,2115,13,1414815002,1414816082,2,24,1080
35034363370@N01,2115,8,1414816308,1414816628,3,24,320
35034363370@N01,2115,5,1414816628,1414817048,2,24,420
35034364890@N01,2116,13,1194510925,1194512005,1,1,1080
35034364890@N01,2117,9,1194565558,1194566458,3,12,900
35034364890@N01,2117,16,1194568032,1194570132,3,12,2100
35034364890@N01,2117,2,1194571625,1194571865,4,12,240
35034364890@N01,2117,14,1194575591,1194575701,2,12,110
35034364890@N01,2117,3,1194575701,1194576031,5,12,330
35034364890@N01,2117,1,1194579114,1194579354,3,12,240
35034364890@N01,2117,9,1194583637,1194584011,2,12,374
35034364890@N01,2117,1,1194584011,1194584251,2,12,240
35034364890@N01,2117,5,1194584610,1194585030,3,12,420
35034364890@N01,2117,8,1194589403,1194590243,2,12,840
35034364890@N01,2117,17,1194597233,1194599933,3,12,2700
35034364890@N01,2117,11,1194613416,1194614376,3,12,960
35041397@N00,2118,2,1309509890,1309510130,5,2,240
35041397@N00,2118,11,1309514740,1309515700,1,2,960
35071666@N00,2119,11,1351984151,1351985111,2,2,960
35071666@N00,2119,9,1351995452,1351996352,1,2,900
35082889@N05,2120,6,1415336871,1415337591,2,1,720
35122574@N00,2121,11,1222726666,1222727626,9,1,960
35144236@N07,2122,13,1326348274,1326349354,1,1,1080
35209467@N02,2123,11,1295645627,1295646587,2,2,960
35209467@N02,2123,2,1295649805,1295650045,4,2,240
35209467@N02,2124,11,1295683046,1295684006,1,1,960
35261894@N00,2125,8,1404345323,1404346163,2,11,840
35261894@N00,2125,11,1404347387,1404348347,4,11,960
35261894@N00,2125,5,1404348495,1404348915,5,11,420
35261894@N00,2125,8,1404349302,1404350142,26,11,840
35261894@N00,2125,1,1404362519,1404362759,3,11,240
35261894@N00,2125,2,1404370418,1404370658,20,11,240
35261894@N00,2125,11,1404371369,1404372329,15,11,960
35261894@N00,2125,15,1404375975,1404377175,3,11,1200
35261894@N00,2125,13,1404382192,1404382396,3,11,204
35261894@N00,2125,15,1404382396,1404382590,9,11,194
35261894@N00,2125,17,1404382590,1404385290,4,11,2700
35285073@N08,2126,11,1414311066,1414312026,1,1,960
35285073@N08,2127,8,1424857133,1424857973,2,2,840
35285073@N08,2127,11,1424859050,1424860010,1,2,960
35285073@N08,2128,11,1425452260,1425453220,2,4,960
35285073@N08,2128,17,1425457267,1425459419,2,4,2152
35285073@N08,2128,4,1425459419,1425459779,2,4,360
35285073@N08,2128,11,1425460690,1425461650,2,4,960
35313641@N02,2129,8,1297870849,1297871689,2,1,840
35356940@N00,2130,11,1393711008,1393711943,2,10,935
35356940@N00,2130,3,1393711943,1393712273,3,10,330
35356940@N00,2130,1,1393715573,1393715813,4,10,240
35356940@N00,2130,9,1393718184,1393719084,2,10,900
35356940@N00,2130,11,1393725158,1393726118,4,10,960
35356940@N00,2130,10,1393726878,1393727778,2,10,900
35356940@N00,2130,17,1393728954,1393731337,6,10,2383
35356940@N00,2130,10,1393731337,1393732237,3,10,900
35356940@N00,2130,17,1393732749,1393733824,3,10,1075
35356940@N00,2130,13,1393733824,1393734904,3,10,1080
35378947@N07,2131,11,1205060822,1205061782,85,1,960
35378947@N07,2132,11,1205334907,1205335867,19,1,960
35378947@N07,2133,11,1205432914,1205433874,4,1,960
35378947@N07,2134,11,1233812670,1233813630,1,1,960
35378947@N07,2135,11,1233960757,1233961717,23,1,960
35378947@N07,2136,11,1234134504,1234135464,42,1,960
35378947@N07,2137,11,1234342189,1234343149,8,1,960
35378947@N07,2138,11,1234396960,1234397920,1,1,960
35378947@N07,2139,11,1260324270,1260325230,2,2,960
35378947@N07,2139,17,1260340580,1260343280,3,2,2700
35378947@N07,2140,11,1260397421,1260398381,4,3,960
35378947@N07,2140,15,1260405874,1260407074,4,3,1200
35378947@N07,2140,11,1260409996,1260410956,2,3,960
35378947@N07,2141,4,1281569807,1281570167,3,6,360
35378947@N07,2141,11,1281582259,1281583219,4,6,960
35378947@N07,2141,17,1281605744,1281608444,5,6,2700
35378947@N07,2141,4,1281614583,1281614943,2,6,360
35378947@N07,2141,11,1281615074,1281616034,3,6,960
35378947@N07,2141,9,1281617138,1281618038,1,6,900
35378947@N07,2142,15,1281750377,1281750905,6,3,528
35378947@N07,2142,13,1281750905,1281751985,4,3,1080
35378947@N07,2142,17,1281756609,1281759309,1,3,2700
35378947@N07,2143,15,1284798373,1284799573,1,1,1200
35378947@N07,2144,15,1285029277,1285030477,4,3,1200
35378947@N07,2144,11,1285031247,1285032207,2,3,960
35378947@N07,2144,14,1285032790,1285033990,1,3,1200
35378947@N07,2145,11,1304900573,1304901533,4,11,960
35378947@N07,2145,4,1304904036,1304904396,2,11,360
35378947@N07,2145,1,1304907400,1304907640,2,11,240
35378947@N07,2145,16,1304910210,1304910867,2,11,657
35378947@N07,2145,1,1304910867,1304911107,2,11,240
35378947@N07,2145,5,1304911213,1304911633,2,11,420
35378947@N07,2145,15,1304913544,1304914744,3,11,1200
35378947@N07,2145,17,1304915076,1304917776,6,11,2700
35378947@N07,2145,11,1304924581,1304925541,3,11,960
35378947@N07,2145,10,1304926447,1304927347,4,11,900
35378947@N07,2145,5,1304928421,1304928841,2,11,420
35378947@N07,2146,4,1305292284,1305292644,1,1,360
35378947@N07,2147,4,1305333121,1305333252,2,3,131
35378947@N07,2147,11,1305333252,1305334212,6,3,960
35378947@N07,2147,4,1305338886,1305339246,1,3,360
35378947@N07,2148,15,1305508394,1305509594,5,1,1200
35378947@N07,2149,16,1305681411,1305683511,2,5,2100
35378947@N07,2149,11,1305686620,1305687580,2,5,960
35378947@N07,2149,10,1305687636,1305688536,3,5,900
35378947@N07,2149,4,1305698898,1305699258,2,5,360
35378947@N07,2149,5,1305702702,1305703122,1,5,420
35378947@N07,2150,3,1328483670,1328484000,2,2,330
35378947@N07,2150,7,1328493581,1328494421,1,2,840
35378947@N07,2151,10,1328609461,1328610361,2,1,900
35378947@N07,2152,15,1328834576,1328835776,3,2,1200
35378947@N07,2152,11,1328840188,1328841148,1,2,960
35380796@N03,2153,3,1230728400,1230728400,6,2,0
35380796@N03,2153,11,1230728400,1230729360,1,2,960
35380796@N03,2154,16,1292195582,1292196097,3,15,515
35380796@N03,2154,1,1292196097,1292196337,4,15,240
35380796@N03,2154,11,1292198414,1292199374,5,15,960
35380796@N03,2154,4,1292200818,1292201011,3,15,193
35380796@N03,2154,1,1292201011,1292201251,2,15,240
35380796@N03,2154,3,1292203167,1292203497,13,15,330
35380796@N03,2154,4,1292204527,1292204887,3,15,360
35380796@N03,2154,11,1292209558,1292210376,2,15,818
35380796@N03,2154,1,1292210376,1292210616,2,15,240
35380796@N03,2154,5,1292211966,1292212386,5,15,420
35380796@N03,2154,13,1292218788,1292219868,2,15,1080
35380796@N03,2154,10,1292224591,1292225491,4,15,900
35380796@N03,2154,2,1292228527,1292228767,2,15,240
35380796@N03,2154,11,1292228829,1292229789,2,15,960
35380796@N03,2154,6,1292230925,1292231645,4,15,720
35380796@N03,2155,14,1318547800,1318548265,5,11,465
35380796@N03,2155,3,1318548265,1318548595,3,11,330
35380796@N03,2155,2,1318548801,1318549041,4,11,240
35380796@N03,2155,4,1318549937,1318550297,2,11,360
35380796@N03,2155,5,1318555129,1318555549,3,11,420
35380796@N03,2155,10,1318565250,1318565566,2,11,316
35380796@N03,2155,17,1318565566,1318567463,3,11,1897
35380796@N03,2155,16,1318567463,1318569563,7,11,2100
35380796@N03,2155,1,1318573480,1318573720,3,11,240
35380796@N03,2155,4,1318574112,1318574472,3,11,360
35380796@N03,2155,11,1318578777,1318579737,6,11,960
35404547@N02,2156,11,1375144240,1375145200,3,3,960
35404547@N02,2156,9,1375150415,1375151315,3,3,900
35404547@N02,2156,8,1375159430,1375160270,2,3,840
35457947@N04,2157,11,1280191819,1280192779,3,4,960
35457947@N04,2157,3,1280203579,1280203909,2,4,330
35457947@N04,2157,4,1280207933,1280208293,2,4,360
35457947@N04,2157,13,1280221160,1280222240,2,4,1080
35466736@N04,2158,11,1360556464,1360557424,34,1,960
35468140399@N01,2159,11,1333071582,1333072542,6,1,960
35473328@N00,2160,11,1197017800,1197018760,2,1,960
35473328@N00,2161,8,1356435754,1356436594,1,1,840
35498711@N04,2162,2,1346115281,1346115521,3,4,240
35498711@N04,2162,5,1346123400,1346123820,3,4,420
35498711@N04,2162,9,1346132083,1346132983,2,4,900
35498711@N04,2162,13,1346137667,1346138747,1,4,1080
35498711@N04,2163,13,1346642718,1346643798,2,4,1080
35498711@N04,2163,10,1346650400,1346650805,2,4,405
35498711@N04,2163,15,1346650805,1346652005,2,4,1200
35498711@N04,2163,4,1346653913,1346654273,1,4,360
35501722@N05,2164,10,1383964799,1383965699,1,1,900
35501722@N05,2165,11,1394688266,1394689226,2,2,960
35501722@N05,2165,5,1394704004,1394704424,1,2,420
35509457@N00,2166,8,1367660975,1367661815,1,1,840
35509457@N00,2167,3,1367879914,1367880244,1,1,330
35509457@N00,2168,11,1367923642,1367924602,1,1,960
35559589@N04,2169,11,1369275975,1369276935,3,2,960
35559589@N04,2169,8,1369303230,1369304070,1,2,840
35617346@N02,2170,11,1375405913,1375406873,1,1,960
35617346@N02,2171,11,1375757641,1375758601,1,1,960
35629408@N03,2172,2,1248366727,1248366967,3,3,240
35629408@N03,2172,3,1248369746,1248370076,2,3,330
35629408@N03,2172,8,1248378694,1248379534,2,3,840
35654250@N04,2173,11,1236782209,1236783169,32,1,960
35665675@N04,2174,2,1197248768,1197249008,1,1,240
35674933@N03,2175,11,1228820460,1228821420,1,1,960
35721568@N00,2176,11,1221275634,1221276594,2,5,960
35721568@N00,2176,3,1221281426,1221281756,2,5,330
35721568@N00,2176,11,1221283084,1221284044,2,5,960
35721568@N00,2176,8,1221293635,1221294475,4,5,840
35721568@N00,2176,17,1221299558,1221302258,1,5,2700
35736481@N00,2177,11,1258493299,1258494259,6,9,960
35736481@N00,2177,12,1258495413,1258496433,12,9,1020
35736481@N00,2177,14,1258502674,1258503874,4,9,1200
35736481@N00,2177,4,1258509662,1258510022,8,9,360
35736481@N00,2177,17,1258510548,1258510758,3,9,210
35736481@N00,2177,15,1258510758,1258511929,10,9,1171
35736481@N00,2177,13,1258511929,1258513009,7,9,1080
35736481@N00,2177,15,1258513601,1258514801,3,9,1200
35736481@N00,2177,8,1258533116,1258533956,1,9,840
35736481@N00,2178,11,1258597173,1258598133,2,2,960
35736481@N00,2178,8,1258609762,1258610602,2,2,840
35736481@N00,2179,11,1296170331,1296171291,4,9,960
35736481@N00,2179,14,1296171384,1296172584,2,9,1200
35736481@N00,2179,8,1296181800,1296182640,4,9,840
35736481@N00,2179,5,1296187053,1296187473,3,9,420
35736481@N00,2179,11,1296188179,1296189139,2,9,960
35736481@N00,2179,13,1296192354,1296193150,2,9,796
35736481@N00,2179,5,1296193150,1296193570,2,9,420
35736481@N00,2179,10,1296194466,1296195366,2,9,900
35736481@N00,2179,15,1296195919,1296197119,4,9,1200
35736481@N00,2180,11,1296514488,1296515138,3,8,650
35736481@N00,2180,9,1296515138,1296516038,4,8,900
35736481@N00,2180,4,1296518521,1296518881,6,8,360
35736481@N00,2180,9,1296523711,1296524611,4,8,900
35736481@N00,2180,5,1296526630,1296527050,4,8,420
35736481@N00,2180,8,1296532901,1296533741,2,8,840
35736481@N00,2180,13,1296543544,1296544624,19,8,1080
35736481@N00,2180,11,1296554913,1296555873,1,8,960
35737340@N08,2181,11,1370173192,1370174152,1,1,960
35758162@N00,2182,11,1194768116,1194768119,2,4,3
35758162@N00,2182,4,1194768119,1194768121,2,4,2
35758162@N00,2182,9,1194768121,1194768127,3,4,6
35758162@N00,2182,8,1194768127,1194768967,1,4,840
35772202@N00,2183,11,1448801125,1448802085,1,1,960
35808173@N04,2184,11,1358897783,1358898743,1,1,960
35808173@N04,2185,11,1359001400,1359002360,1,1,960
35816811@N04,2186,14,1379362514,1379363714,1,1,1200
35816811@N04,2187,14,1379402814,1379404014,1,1,1200
35816811@N04,2188,8,1389139809,1389140649,2,2,840
35816811@N04,2188,7,1389164783,1389165623,1,2,840
35838612@N03,2189,5,1328589194,1328589614,1,1,420
35853462@N00,2190,11,1231304091,1231305051,1,1,960
35853462@N00,2191,1,1283579098,1283579338,2,6,240
35853462@N00,2191,17,1283588439,1283589782,3,6,1343
35853462@N00,2191,15,1283589782,1283590460,2,6,678
35853462@N00,2191,17,1283590460,1283592195,4,6,1735
35853462@N00,2191,13,1283592195,1283593275,4,6,1080
35853462@N00,2191,1,1283597494,1283597734,1,6,240
35853462@N00,2192,3,1283740998,1283741328,2,6,330
35853462@N00,2192,4,1283744466,1283744826,2,6,360
35853462@N00,2192,17,1283749676,1283749687,2,6,11
35853462@N00,2192,15,1283749687,1283750887,2,6,1200
35853462@N00,2192,17,1283751290,1283751293,2,6,3
35853462@N00,2192,13,1283751293,1283752373,4,6,1080
35853462@N00,2193,11,1283937932,1283938892,3,1,960
35853462@N00,2194,11,1284081164,1284082124,3,8,960
35853462@N00,2194,3,1284087073,1284087403,4,8,330
35853462@N00,2194,2,1284087828,1284087833,2,8,5
35853462@N00,2194,3,1284087833,1284088163,6,8,330
35853462@N00,2194,14,1284090225,1284090752,13,8,527
35853462@N00,2194,3,1284090752,1284091082,2,8,330
35853462@N00,2194,2,1284094304,1284094544,3,8,240
35853462@N00,2194,11,1284103512,1284104472,4,8,960
35853462@N00,2195,13,1284174062,1284175142,3,2,1080
35853462@N00,2195,17,1284179370,1284182070,6,2,2700
35853462@N00,2196,11,1388904272,1388905232,2,2,960
35853462@N00,2196,13,1388905710,1388906790,8,2,1080
35853462@N00,2197,11,1388975454,1388976414,2,3,960
35853462@N00,2197,8,1388978490,1388978680,5,3,190
35853462@N00,2197,5,1388978680,1388979100,2,3,420
35853462@N00,2198,1,1389051689,1389051929,3,6,240
35853462@N00,2198,3,1389057037,1389057367,2,6,330
35853462@N00,2198,5,1389068415,1389068835,2,6,420
35853462@N00,2198,17,1389068848,1389069372,2,6,524
35853462@N00,2198,8,1389069372,1389070212,2,6,840
35853462@N00,2198,11,1389087767,1389088727,1,6,960
35853462@N00,2199,4,1389322554,1389322584,19,4,30
35853462@N00,2199,11,1389322584,1389323544,4,4,960
35853462@N00,2199,7,1389323656,1389324496,8,4,840
35853462@N00,2199,13,1389328507,1389329587,7,4,1080
35853462@N00,2200,13,1389405202,1389406031,2,5,829
35853462@N00,2200,6,1389406031,1389406751,5,5,720
35853462@N00,2200,5,1389409825,1389410245,2,5,420
35853462@N00,2200,3,1389412945,1389413275,2,5,330
35853462@N00,2200,11,1389415464,1389416424,1,5,960
35872939@N00,2201,12,1233622340,1233623360,3,7,1020
35872939@N00,2201,4,1233629697,1233630057,2,7,360
35872939@N00,2201,5,1233632493,1233632913,2,7,420
35872939@N00,2201,8,1233633602,1233634442,5,7,840
35872939@N00,2201,13,1233638093,1233638674,2,7,581
35872939@N00,2201,15,1233638674,1233638780,2,7,106
35872939@N00,2201,10,1233638780,1233639680,1,7,900
35872939@N00,2202,11,1267490270,1267491230,2,4,960
35872939@N00,2202,2,1267491718,1267491958,2,4,240
35872939@N00,2202,15,1267494917,1267496117,8,4,1200
35872939@N00,2202,4,1267501465,1267501825,1,4,360
35872939@N00,2203,2,1267661909,1267662149,2,7,240
35872939@N00,2203,12,1267664846,1267665866,3,7,1020
35872939@N00,2203,2,1267666627,1267666867,2,7,240
35872939@N00,2203,9,1267667790,1267668286,2,7,496
35872939@N00,2203,16,1267668286,1267670386,12,7,2100
35872939@N00,2203,9,1267674300,1267675200,2,7,900
35872939@N00,2203,12,1267680510,1267681530,2,7,1020
35872939@N00,2204,15,1364263279,1364264479,1,1,1200
35888901@N00,2205,13,1325158597,1325159677,2,2,1080
35888901@N00,2205,11,1325160726,1325161686,2,2,960
35888901@N00,2206,9,1325396874,1325397774,2,2,900
35888901@N00,2206,8,1325413401,1325414241,1,2,840
35897523@N04,2207,11,1243212480,1243213440,2,3,960
35897523@N04,2207,8,1243219518,1243220358,2,3,840
35897523@N04,2207,11,1243223895,1243224855,2,3,960
35897523@N04,2208,13,1251272115,1251273195,1,1,1080
35897523@N04,2209,15,1251446567,1251447767,1,1,1200
35897523@N04,2210,11,1314066916,1314067876,3,1,960
35897523@N04,2211,11,1314108037,1314108997,2,1,960
35897587@N08,2212,1,1402196254,1402196494,1,1,240
35928519@N00,2213,1,1260877991,1260878231,1,1,240
35928519@N00,2214,17,1323141731,1323144431,1,1,2700
35928519@N00,2215,11,1323316883,1323317843,1,1,960
35928519@N00,2216,9,1323403266,1323404166,1,1,900
35928519@N00,2217,13,1385874529,1385875609,2,1,1080
35928519@N00,2218,11,1385951601,1385952561,1,1,960
35928519@N00,2219,2,1386061461,1386061701,1,1,240
35928519@N00,2220,1,1386187215,1386187455,2,9,240
35928519@N00,2220,9,1386188105,1386189005,2,9,900
35928519@N00,2220,7,1386190920,1386191760,2,9,840
35928519@N00,2220,3,1386193810,1386194140,2,9,330
35928519@N00,2220,14,1386198571,1386199771,3,9,1200
35928519@N00,2220,7,1386204911,1386205751,2,9,840
35928519@N00,2220,9,1386209319,1386210219,2,9,900
35928519@N00,2220,5,1386219373,1386219793,2,9,420
35928519@N00,2220,11,1386244413,1386245373,1,9,960
35928519@N00,2221,13,1386298701,1386299781,4,2,1080
35928519@N00,2221,11,1386306932,1386307892,3,2,960
36017094@N04,2222,8,1358570504,1358571101,7,4,597
36017094@N04,2222,10,1358571101,1358572001,3,4,900
36017094@N04,2222,5,1358572239,1358572659,2,4,420
36017094@N04,2222,1,1358574976,1358575216,4,4,240
36041393@N06,2223,5,1415410409,1415410829,3,4,420
36041393@N06,2223,8,1415411646,1415412406,2,4,760
36041393@N06,2223,6,1415412406,1415413126,3,4,720
36041393@N06,2223,11,1415427506,1415428466,4,4,960
36041393@N06,2224,12,1415691876,1415692178,2,2,302
36041393@N06,2224,2,1415692178,1415692418,1,2,240
36048845@N06,2225,11,1392771596,1392772556,2,3,960
36048845@N06,2225,2,1392775791,1392776031,2,3,240
36048845@N06,2225,11,1392795352,1392796312,1,3,960
36101699901@N01,2226,8,1317522560,1317523400,1,1,840
36101699901@N01,2227,6,1334911427,1334912147,1,1,720
36112910@N02,2228,11,1355712446,1355713406,1,1,960
36125909@N00,2229,8,1232565708,1232566548,2,3,840
36125909@N00,2229,1,1232575722,1232575962,3,3,240
36125909@N00,2229,5,1232578606,1232579026,1,3,420
36191363@N00,2230,8,1214831828,1214832668,4,1,840
36226805@N03,2231,7,1221969194,1221970034,3,3,840
36226805@N03,2231,11,1221978664,1221979624,2,3,960
36226805@N03,2231,6,1221981648,1221982368,1,3,720
36226805@N03,2232,13,1242498217,1242499297,1,1,1080
36226805@N03,2233,5,1253433287,1253433707,2,2,420
36226805@N03,2233,3,1253441791,1253442121,1,2,330
36226805@N03,2234,11,1253527774,1253528734,1,1,960
36226805@N03,2235,15,1284883405,1284884605,1,1,1200
36226805@N03,2236,8,1285233838,1285234678,1,1,840
36226805@N03,2237,14,1316315831,1316315839,2,28,8
36226805@N03,2237,3,1316315839,1316316169,2,28,330
36226805@N03,2237,14,1316316694,1316316719,2,28,25
36226805@N03,2237,3,1316316719,1316316853,2,28,134
36226805@N03,2237,12,1316316853,1316317025,5,28,172
36226805@N03,2237,14,1316317025,1316317052,3,28,27
36226805@N03,2237,12,1316317052,1316318072,2,28,1020
36226805@N03,2237,2,1316321273,1316321287,2,28,14
36226805@N03,2237,12,1316321287,1316321364,3,28,77
36226805@N03,2237,2,1316321364,1316321584,2,28,220
36226805@N03,2237,12,1316321584,1316321884,2,28,300
36226805@N03,2237,2,1316321884,1316321989,3,28,105
36226805@N03,2237,12,1316321989,1316322158,2,28,169
36226805@N03,2237,11,1316322158,1316322846,2,28,688
36226805@N03,2237,3,1316322846,1316323176,3,28,330
36226805@N03,2237,14,1316324427,1316324902,2,28,475
36226805@N03,2237,11,1316324902,1316325513,2,28,611
36226805@N03,2237,9,1316325513,1316325629,3,28,116
36226805@N03,2237,1,1316325629,1316325690,2,28,61
36226805@N03,2237,9,1316325690,1316326590,4,28,900
36226805@N03,2237,5,1316326913,1316327333,7,28,420
36226805@N03,2237,8,1316330360,1316330663,3,28,303
36226805@N03,2237,5,1316330663,1316330986,2,28,323
36226805@N03,2237,9,1316330986,1316331886,3,28,900
36226805@N03,2237,6,1316335367,1316336087,2,28,720
36226805@N03,2237,11,1316344163,1316344200,2,28,37
36226805@N03,2237,16,1316344200,1316344324,2,28,124
36226805@N03,2237,11,1316344324,1316345284,3,28,960
36226805@N03,2238,11,1316757121,1316757178,3,10,57
36226805@N03,2238,1,1316757178,1316757186,2,10,8
36226805@N03,2238,11,1316757186,1316758146,5,10,960
36226805@N03,2238,10,1316761059,1316761934,2,10,875
36226805@N03,2238,6,1316761934,1316762654,5,10,720
36226805@N03,2238,4,1316776719,1316777079,3,10,360
36226805@N03,2238,3,1316777663,1316777849,2,10,186
36226805@N03,2238,4,1316777849,1316778209,2,10,360
36226805@N03,2238,2,1316779945,1316780185,2,10,240
36226805@N03,2238,11,1316780242,1316781202,1,10,960
36226805@N03,2239,3,1347444962,1347445242,3,3,280
36226805@N03,2239,16,1347445242,1347447342,2,3,2100
36226805@N03,2239,11,1347454224,1347455184,6,3,960
36226805@N03,2240,15,1347610904,1347611140,2,6,236
36226805@N03,2240,10,1347611140,1347612017,2,6,877
36226805@N03,2240,13,1347612017,1347613097,4,6,1080
36226805@N03,2240,9,1347621366,1347621366,2,6,0
36226805@N03,2240,12,1347621366,1347621505,2,6,139
36226805@N03,2240,11,1347621505,1347622465,4,6,960
36226805@N03,2241,11,1378607492,1378607762,2,21,270
36226805@N03,2241,3,1378607762,1378608092,7,21,330
36226805@N03,2241,7,1378614974,1378615771,2,21,797
36226805@N03,2241,11,1378615771,1378616297,3,21,526
36226805@N03,2241,9,1378616297,1378617197,6,21,900
36226805@N03,2241,16,1378617409,1378617588,3,21,179
36226805@N03,2241,9,1378617588,1378617697,4,21,109
36226805@N03,2241,16,1378617697,1378617708,2,21,11
36226805@N03,2241,1,1378617708,1378617805,2,21,97
36226805@N03,2241,11,1378617805,1378618765,2,21,960
36226805@N03,2241,9,1378619245,1378620145,2,21,900
36226805@N03,2241,1,1378620594,1378620834,5,21,240
36226805@N03,2241,14,1378627392,1378627410,2,21,18
36226805@N03,2241,3,1378627410,1378627420,2,21,10
36226805@N03,2241,14,1378627420,1378627423,2,21,3
36226805@N03,2241,3,1378627423,1378627490,2,21,67
36226805@N03,2241,14,1378627490,1378628042,2,21,552
36226805@N03,2241,3,1378628042,1378628235,2,21,193
36226805@N03,2241,14,1378628235,1378628247,2,21,12
36226805@N03,2241,3,1378628247,1378628577,2,21,330
36226805@N03,2241,14,1378629205,1378630405,1,21,1200
36226805@N03,2242,11,1378712149,1378713109,5,4,960
36226805@N03,2242,3,1378713277,1378713607,2,4,330
36226805@N03,2242,6,1378714541,1378715261,6,4,720
36226805@N03,2242,11,1378723307,1378724267,2,4,960
36226805@N03,2243,11,1379041387,1379041909,3,19,522
36226805@N03,2243,3,1379041909,1379042239,2,19,330
36226805@N03,2243,14,1379043893,1379045093,5,19,1200
36226805@N03,2243,3,1379046033,1379046363,3,19,330
36226805@N03,2243,4,1379046483,1379046630,2,19,147
36226805@N03,2243,3,1379046630,1379046633,2,19,3
36226805@N03,2243,4,1379046633,1379046993,2,19,360
36226805@N03,2243,10,1379048421,1379049321,3,19,900
36226805@N03,2243,11,1379049557,1379050517,7,19,960
36226805@N03,2243,1,1379051937,1379052024,2,19,87
36226805@N03,2243,9,1379052024,1379052924,6,19,900
36226805@N03,2243,1,1379054992,1379055232,4,19,240
36226805@N03,2243,3,1379056544,1379056874,6,19,330
36226805@N03,2243,5,1379057263,1379057683,3,19,420
36226805@N03,2243,8,1379058195,1379059035,20,19,840
36226805@N03,2243,6,1379059824,1379060144,2,19,320
36226805@N03,2243,13,1379060144,1379061224,7,19,1080
36226805@N03,2243,15,1379067628,1379068828,2,19,1200
36226805@N03,2243,11,1379069373,1379070333,1,19,960
36231632@N00,2244,11,1432253513,1432254473,1,1,960
36255480@N08,2245,15,1382183620,1382184820,1,1,1200
36310471@N04,2246,11,1386324515,1386325475,1,1,960
36319399@N00,2247,11,1232604142,1232605102,2,2,960
36319399@N00,2247,5,1232615253,1232615673,1,2,420
36399194@N03,2248,11,1389303408,1389304368,1,1,960
36399194@N03,2249,11,1389496856,1389497816,1,1,960
36459656@N00,2250,1,1360927371,1360927611,5,1,240
36521963326@N01,2251,12,1361150839,1361151859,2,2,1020
36521963326@N01,2251,11,1361155864,1361156824,1,2,960
36521965790@N01,2252,11,1285239576,1285240536,1,1,960
36521978259@N01,2253,11,1304329809,1304330769,1,1,960
36524061@N04,2254,11,1320492474,1320493434,1,1,960
36607954@N05,2255,11,1246418969,1246419929,7,10,960
36607954@N05,2255,1,1246422175,1246422323,2,10,148
36607954@N05,2255,9,1246422323,1246423223,5,10,900
36607954@N05,2255,16,1246427014,1246429114,2,10,2100
36607954@N05,2255,4,1246430506,1246430866,3,10,360
36607954@N05,2255,14,1246434615,1246435815,6,10,1200
36607954@N05,2255,10,1246436549,1246437449,2,10,900
36607954@N05,2255,8,1246441205,1246442045,2,10,840
36607954@N05,2255,6,1246445661,1246446381,18,10,720
36607954@N05,2255,11,1246448133,1246449093,4,10,960
36607954@N05,2256,14,1246953455,1246954655,12,7,1200
36607954@N05,2256,11,1246955452,1246955509,2,7,57
36607954@N05,2256,2,1246955509,1246955749,2,7,240
36607954@N05,2256,5,1246956701,1246957121,4,7,420
36607954@N05,2256,8,1246960681,1246960740,2,7,59
36607954@N05,2256,6,1246960740,1246961460,3,7,720
36607954@N05,2256,13,1246961824,1246962904,2,7,1080
36662788@N00,2257,11,1258239183,1258240143,1,1,960
36671802@N04,2258,11,1364358706,1364359666,72,1,960
36671802@N04,2259,11,1425863201,1425864161,35,1,960
36671802@N04,2260,11,1426068353,1426069313,15,1,960
36675073@N02,2261,11,1250159747,1250160707,1,1,960
36694655@N08,2262,1,1402217832,1402218072,1,1,240
36694655@N08,2263,11,1402443181,1402444141,2,8,960
36694655@N08,2263,1,1402449000,1402449037,3,8,37
36694655@N08,2263,3,1402449037,1402449367,3,8,330
36694655@N08,2263,11,1402455102,1402455125,2,8,23
36694655@N08,2263,2,1402455125,1402455365,2,8,240
36694655@N08,2263,4,1402467524,1402467884,2,8,360
36694655@N08,2263,16,1402469455,1402471555,2,8,2100
36694655@N08,2263,9,1402472887,1402473787,1,8,900
36694655@N08,2264,5,1402547787,1402548207,4,5,420
36694655@N08,2264,8,1402548984,1402549824,4,5,840
36694655@N08,2264,13,1402554147,1402555227,2,5,1080
36694655@N08,2264,17,1402557161,1402558439,3,5,1278
36694655@N08,2264,10,1402558439,1402559339,2,5,900
36702908@N05,2265,11,1421709608,1421710568,2,7,960
36702908@N05,2265,2,1421712287,1421712527,7,7,240
36702908@N05,2265,3,1421717243,1421717573,2,7,330
36702908@N05,2265,4,1421719884,1421720244,4,7,360
36702908@N05,2265,10,1421720859,1421721759,5,7,900
36702908@N05,2265,17,1421722247,1421724947,3,7,2700
36702908@N05,2265,2,1421743205,1421743445,9,7,240
36702908@N05,2266,3,1421978430,1421978760,2,3,330
36702908@N05,2266,17,1421983096,1421985796,3,3,2700
36702908@N05,2266,8,1421989094,1421989934,1,3,840
36702908@N05,2267,13,1422320334,1422321414,4,1,1080
36702908@N05,2268,15,1422412206,1422413406,5,2,1200
36702908@N05,2268,11,1422428204,1422429164,1,2,960
36735086@N07,2269,15,1252207850,1252207893,3,3,43
36735086@N07,2269,17,1252207893,1252210593,2,3,2700
36735086@N07,2269,1,1252217244,1252217484,4,3,240
36771701@N00,2270,11,1392350371,1392351331,7,1,960
36801190@N00,2271,11,1357340089,1357341049,1,1,960
36814245@N00,2272,8,1325315730,1325316570,1,1,840
36819642@N00,2273,11,1200089802,1200090762,1,1,960
36864630@N00,2274,11,1370306150,1370307110,1,1,960
36864630@N00,2275,11,1401839811,1401840771,1,1,960
36895960@N00,2276,11,1422947517,1422948477,1,1,960
36911028@N00,2277,2,1410671300,1410671540,2,3,240
36911028@N00,2277,5,1410676909,1410677329,2,3,420
36911028@N00,2277,10,1410681781,1410682681,1,3,900
36916766@N08,2278,13,1275887415,1275888495,1,1,1080
36916766@N08,2279,17,1276329302,1276329333,4,2,31
36916766@N08,2279,9,1276329333,1276330233,2,2,900
36916766@N08,2280,6,1285921879,1285922599,3,1,720
36916766@N08,2281,13,1287721795,1287722875,1,1,1080
36916766@N08,2282,17,1287811023,1287813723,4,2,2700
36916766@N08,2282,6,1287820166,1287820886,1,2,720
36916766@N08,2283,17,1319258721,1319261421,4,3,2700
36916766@N08,2283,15,1319277997,1319279197,2,3,1200
36916766@N08,2283,10,1319280060,1319280960,1,3,900
36964870@N00,2284,11,1445413386,1445414346,1,1,960
37020356@N06,2285,11,1307263166,1307264126,4,1,960
37046031@N00,2286,2,1225748739,1225748769,2,6,30
37046031@N00,2286,9,1225748769,1225749669,2,6,900
37046031@N00,2286,14,1225753201,1225754401,2,6,1200
37046031@N00,2286,12,1225758041,1225759061,6,6,1020
37046031@N00,2286,5,1225761177,1225761597,6,6,420
37046031@N00,2286,11,1225765336,1225766296,3,6,960
37046031@N00,2287,11,1225807658,1225808618,5,3,960
37046031@N00,2287,13,1225809437,1225810517,4,3,1080
37046031@N00,2287,11,1225815568,1225816528,1,3,960
37046031@N00,2288,17,1226138473,1226139629,3,2,1156
37046031@N00,2288,11,1226139629,1226140589,1,2,960
37046031@N00,2289,13,1226221650,1226222730,4,2,1080
37046031@N00,2289,17,1226225352,1226228052,3,2,2700
37046031@N00,2290,11,1226384502,1226385462,2,4,960
37046031@N00,2290,16,1226385776,1226387876,4,4,2100
37046031@N00,2290,11,1226389532,1226390492,2,4,960
37046031@N00,2290,5,1226395495,1226395915,2,4,420
37046031@N00,2291,11,1226667600,1226668560,1,1,960
37046031@N00,2292,5,1236256589,1236257009,1,1,420
37084921@N04,2293,13,1336182243,1336183323,1,1,1080
37084963@N08,2294,11,1393572898,1393573858,1,1,960
37088822@N00,2295,2,1236932713,1236932953,6,2,240
37088822@N00,2295,11,1236937889,1236938849,4,2,960
37088822@N00,2296,10,1237444333,1237445233,11,2,900
37088822@N00,2296,11,1237451173,1237452133,11,2,960
37097738@N02,2297,8,1444300373,1444300547,3,2,174
37097738@N02,2297,5,1444300547,1444300967,1,2,420
37097738@N02,2298,11,1450153568,1450154528,6,12,960
37097738@N02,2298,2,1450155046,1450155286,8,12,240
37097738@N02,2298,3,1450156739,1450157069,2,12,330
37097738@N02,2298,14,1450157224,1450157414,3,12,190
37097738@N02,2298,3,1450157414,1450157744,6,12,330
37097738@N02,2298,5,1450158506,1450158926,3,12,420
37097738@N02,2298,8,1450160429,1450161269,6,12,840
37097738@N02,2298,13,1450166522,1450167157,4,12,635
37097738@N02,2298,15,1450167157,1450167187,2,12,30
37097738@N02,2298,17,1450167187,1450167948,3,12,761
37097738@N02,2298,10,1450167948,1450168848,2,12,900
37097738@N02,2298,11,1450178140,1450179100,2,12,960
37159320@N00,2299,11,1274408150,1274409110,2,3,960
37159320@N00,2299,5,1274424268,1274424688,2,3,420
37159320@N00,2299,6,1274428688,1274429408,1,3,720
37159320@N00,2300,11,1274667713,1274668673,1,1,960
37159320@N00,2301,11,1345592635,1345593595,2,2,960
37159320@N00,2301,10,1345600800,1345601700,1,2,900
37159320@N00,2302,6,1345634436,1345635156,1,1,720
37159320@N00,2303,11,1360022426,1360023386,1,1,960
37159320@N00,2304,5,1360459020,1360459440,1,1,420
37159320@N00,2305,10,1360656626,1360657526,2,2,900
37159320@N00,2305,1,1360664152,1360664392,1,2,240
37159320@N00,2306,11,1379207676,1379208636,3,2,960
37159320@N00,2306,5,1379227737,1379228157,3,2,420
37159320@N00,2307,4,1379295160,1379295520,1,1,360
37159320@N00,2308,5,1379469593,1379470013,2,4,420
37159320@N00,2308,11,1379495360,1379496320,4,4,960
37159320@N00,2308,2,1379500570,1379500810,3,4,240
37159320@N00,2308,4,1379506539,1379506899,2,4,360
37182874@N04,2309,12,1259021479,1259022499,1,1,1020
37186095@N08,2310,1,1306111948,1306112188,2,3,240
37186095@N08,2310,16,1306112444,1306114544,2,3,2100
37186095@N08,2310,14,1306119379,1306120579,1,3,1200
37186095@N08,2311,11,1306150777,1306151737,1,1,960
37186095@N08,2312,13,1306652816,1306653896,1,1,1080
37186095@N08,2313,11,1308830002,1308830962,1,1,960
37186095@N08,2314,11,1317513666,1317514626,2,7,960
37186095@N08,2314,13,1317517798,1317518878,2,7,1080
37186095@N08,2314,2,1317537339,1317537579,2,7,240
37186095@N08,2314,12,1317538711,1317539731,4,7,1020
37186095@N08,2314,1,1317543153,1317543393,2,7,240
37186095@N08,2314,4,1317544057,1317544417,2,7,360
37186095@N08,2314,11,1317552882,1317553842,2,7,960
37186095@N08,2315,9,1330640714,1330641614,3,12,900
37186095@N08,2315,14,1330645526,1330646726,2,12,1200
37186095@N08,2315,12,1330652129,1330653149,3,12,1020
37186095@N08,2315,11,1330654967,1330655927,5,12,960
37186095@N08,2315,16,1330657359,1330659459,2,12,2100
37186095@N08,2315,4,1330660778,1330661138,3,12,360
37186095@N08,2315,17,1330662689,1330662696,2,12,7
37186095@N08,2315,10,1330662696,1330662703,2,12,7
37186095@N08,2315,17,1330662703,1330662858,2,12,155
37186095@N08,2315,15,1330662858,1330662993,3,12,135
37186095@N08,2315,13,1330662993,1330664073,3,12,1080
37186095@N08,2315,5,1330679082,1330679502,1,12,420
37216383@N05,2316,15,1338597400,1338598600,4,2,1200
37216383@N05,2316,17,1338599841,1338602541,3,2,2700
37216383@N05,2317,17,1348187956,1348190656,2,1,2700
37216383@N05,2318,17,1348923587,1348926287,1,1,2700
37216383@N05,2319,15,1349046460,1349047660,3,1,1200
37216383@N05,2320,17,1350458226,1350460926,1,1,2700
37216383@N05,2321,17,1351731329,1351734029,1,1,2700
37216383@N05,2322,15,1352076251,1352077451,2,1,1200
37216383@N05,2323,15,1364706643,1364707843,2,2,1200
37216383@N05,2323,17,1364730363,1364733063,1,2,2700
37230837@N04,2324,17,1371356287,1371358987,1,1,2700
37242378@N02,2325,17,1245300219,1245302919,3,1,2700
37274056@N05,2326,5,1295334452,1295334872,7,1,420
37274056@N05,2327,1,1295594855,1295595095,3,2,240
37274056@N05,2327,9,1295599967,1295600867,2,2,900
37287420@N08,2328,11,1325311657,1325312617,2,2,960
37287420@N08,2328,8,1325326421,1325327261,2,2,840
37288603@N08,2329,3,1239276820,1239277150,2,1,330
37306398@N08,2330,6,1319263078,1319263798,2,1,720
37306398@N08,2331,2,1389429156,1389429396,2,1,240
37324769@N06,2332,4,1255562840,1255563200,1,1,360
37335919@N02,2333,15,1237344241,1237344975,2,3,734
37335919@N02,2333,10,1237344975,1237345875,3,3,900
37335919@N02,2333,8,1237346971,1237347811,1,3,840
37335919@N02,2334,8,1243735868,1243736708,1,1,840
37504803@N00,2335,11,1200886889,1200887849,3,3,960
37504803@N00,2335,10,1200891107,1200892007,3,3,900
37504803@N00,2335,17,1200893303,1200896003,1,3,2700
37515566@N00,2336,6,1447673914,1447674634,2,2,720
37515566@N00,2336,11,1447677630,1447678590,1,2,960
37541950@N08,2337,11,1286181078,1286182038,8,1,960
37553034@N03,2338,11,1313962290,1313963250,2,3,960
37553034@N03,2338,3,1313975794,1313976124,2,3,330
37553034@N03,2338,8,1313993127,1313993967,1,3,840
37553034@N03,2339,8,1315641546,1315641829,2,2,283
37553034@N03,2339,5,1315641829,1315642249,1,2,420
37553034@N03,2340,13,1317277682,1317278762,2,1,1080
37553034@N03,2341,4,1317352214,1317352574,1,1,360
37556258@N03,2342,11,1256373719,1256374679,2,1,960
37556258@N03,2343,11,1257402845,1257403502,2,3,657
37556258@N03,2343,13,1257403502,1257403777,2,3,275
37556258@N03,2343,6,1257403777,1257404497,2,3,720
37561427@N04,2344,11,1345433079,1345434039,3,1,960
37561427@N04,2345,11,1345482474,1345483434,3,1,960
37572076@N08,2346,17,1329536324,1329539024,1,1,2700
37585370@N00,2347,11,1263592129,1263593089,1,1,960
37595844@N08,2348,5,1287109252,1287109672,6,7,420
37595844@N08,2348,10,1287123832,1287124732,2,7,900
37595844@N08,2348,5,1287131150,1287131570,2,7,420
37595844@N08,2348,17,1287137063,1287137215,2,7,152
37595844@N08,2348,8,1287137215,1287138055,2,7,840
37595844@N08,2348,17,1287144110,1287146810,3,7,2700
37595844@N08,2348,11,1287147558,1287148518,1,7,960
37606273@N07,2349,17,1360808906,1360811606,1,1,2700
37620552@N06,2350,11,1368103056,1368104016,1,1,960
37620552@N06,2351,11,1368162314,1368163274,1,1,960
37620552@N06,2352,1,1368194397,1368194637,1,1,240
37657436@N04,2353,2,1262291112,1262291352,2,2,240
37657436@N04,2353,15,1262292101,1262293301,1,2,1200
37657436@N04,2354,13,1262449905,1262450883,7,2,978
37657436@N04,2354,15,1262450883,1262452083,3,2,1200
37657436@N04,2355,11,1262483095,1262484055,3,1,960
37657436@N04,2356,17,1262736995,1262737556,5,2,561
37657436@N04,2356,13,1262737556,1262738636,2,2,1080
37657436@N04,2357,17,1310178796,1310178934,2,3,138
37657436@N04,2357,15,1310178934,1310180134,4,3,1200
37657436@N04,2357,11,1310182540,1310183500,5,3,960
37657436@N04,2358,5,1461713832,1461714252,3,2,420
37657436@N04,2358,10,1461714773,1461715673,2,2,900
37657436@N04,2359,1,1461789106,1461789346,3,1,240
37657436@N04,2360,8,1461834624,1461835464,3,4,840
37657436@N04,2360,13,1461837423,1461837649,2,4,226
37657436@N04,2360,17,1461837649,1461837835,2,4,186
37657436@N04,2360,10,1461837835,1461838735,1,4,900
37657436@N04,2361,11,1461871678,1461872638,1,1,960
37673257@N06,2362,11,1369525748,1369526708,1,1,960
37700500@N04,2363,8,1250264836,1250265676,1,1,840
37709784@N00,2364,11,1239170686,1239171646,3,2,960
37709784@N00,2364,7,1239175061,1239175901,1,2,840
37714481@N00,2365,1,1189483550,1189483790,2,3,240
37714481@N00,2365,2,1189484069,1189484309,6,3,240
37714481@N00,2365,7,1189493363,1189494203,4,3,840
37718677660@N01,2366,15,1290572724,1290573924,1,1,1200
37729827@N05,2367,3,1337562326,1337562348,2,6,22
37729827@N05,2367,7,1337562348,1337562357,2,6,9
37729827@N05,2367,3,1337562357,1337562687,13,6,330
37729827@N05,2367,7,1337565478,1337566318,3,6,840
37729827@N05,2367,4,1337567715,1337568075,7,6,360
37729827@N05,2367,5,1337575940,1337576360,6,6,420
37729827@N05,2368,5,1337684479,1337684899,4,1,420
37747991@N02,2369,11,1240710668,1240711628,1,1,960
37775700@N02,2370,11,1265370476,1265371436,1,1,960
37775700@N02,2371,13,1274555099,1274556179,1,1,1080
37775700@N02,2372,9,1304019020,1304019920,2,2,900
37775700@N02,2372,8,1304023881,1304024721,1,2,840
37775700@N02,2373,13,1304174910,1304175990,1,1,1080
37785868@N05,2374,11,1273885400,1273886360,1,1,960
37841068@N04,2375,8,1303544263,1303545103,1,1,840
37869753@N06,2376,8,1312855420,1312856260,6,2,840
37869753@N06,2376,1,1312870730,1312870970,2,2,240
37896708@N06,2377,11,1394821869,1394822829,1,1,960
37908196@N07,2378,10,1329610143,1329610798,2,3,655
37908196@N07,2378,13,1329610798,1329611878,2,3,1080
37908196@N07,2378,11,1329617180,1329618140,1,3,960
37908196@N07,2379,11,1355270150,1355271110,1,1,960
37996603748@N01,2380,11,1418104945,1418105905,2,2,960
37996603748@N01,2380,6,1418117197,1418117917,1,2,720
37996654902@N01,2381,6,1355715444,1355716164,2,1,720
37998051@N00,2382,11,1278210936,1278211896,2,3,960
37998051@N00,2382,7,1278214687,1278215527,2,3,840
37998051@N00,2382,8,1278225275,1278226115,1,3,840
37998051@N00,2383,10,1278664664,1278665564,1,1,900
37998051@N00,2384,8,1310045163,1310046003,1,1,840
37998051@N00,2385,11,1334227955,1334228915,1,1,960
38022350@N04,2386,9,1241729168,1241730068,2,2,900
38022350@N04,2386,10,1241745603,1241746503,1,2,900
38022350@N04,2387,13,1241901596,1241902676,1,1,1080
38067879@N08,2388,17,1323491081,1323493781,1,1,2700
38067879@N08,2389,4,1348553331,1348553691,2,2,360
38067879@N08,2389,11,1348565897,1348566857,1,2,960
38067879@N08,2390,16,1349053717,1349055817,2,3,2100
38067879@N08,2390,9,1349059620,1349060520,2,3,900
38067879@N08,2390,4,1349073446,1349073806,1,3,360
38067879@N08,2391,5,1363839393,1363839759,2,2,366
38067879@N08,2391,8,1363839759,1363840599,1,2,840
38067879@N08,2392,11,1368607559,1368608519,1,1,960
38067879@N08,2393,1,1368646936,1368647176,1,1,240
38067879@N08,2394,14,1368836542,1368837742,1,1,1200
38067879@N08,2395,3,1412124514,1412124844,1,1,330
38067879@N08,2396,15,1449466484,1449467684,1,1,1200
38067879@N08,2397,3,1457568200,1457568530,1,1,330
38084526@N06,2398,15,1229424995,1229426195,1,1,1200
38084526@N06,2399,5,1230181354,1230181774,2,2,420
38084526@N06,2399,11,1230205555,1230206515,1,2,960
38084526@N06,2400,12,1240390150,1240391170,1,1,1020
38084526@N06,2401,15,1241012634,1241013834,1,1,1200
38084526@N06,2402,16,1284260664,1284262764,2,2,2100
38084526@N06,2402,12,1284277101,1284278121,1,2,1020
38084526@N06,2403,11,1315650790,1315651750,2,2,960
38084526@N06,2403,13,1315652444,1315653524,1,2,1080
38088964@N00,2404,4,1330683356,1330683716,1,1,360
38090510@N06,2405,11,1246881013,1246881973,1,1,960
38102706@N05,2406,16,1200281030,1200283130,1,1,2100
38102706@N05,2407,1,1238130420,1238130660,2,1,240
38102706@N05,2408,13,1252729517,1252730597,2,1,1080
38102706@N05,2409,11,1254637508,1254638468,4,3,960
38102706@N05,2409,4,1254639658,1254640018,3,3,360
38102706@N05,2409,11,1254644740,1254645700,1,3,960
38102706@N05,2410,11,1260086828,1260087788,12,1,960
38102706@N05,2411,11,1260929696,1260930656,1,1,960
38102706@N05,2412,3,1261039099,1261039429,3,1,330
38102706@N05,2413,11,1262145635,1262146595,1,1,960
38102706@N05,2414,11,1263637361,1263638321,1,1,960
38102706@N05,2415,3,1263719290,1263719620,2,1,330
38102706@N05,2416,3,1266721192,1266721522,2,2,330
38102706@N05,2416,11,1266728278,1266729238,2,2,960
38102706@N05,2417,3,1267161112,1267161442,9,1,330
38102706@N05,2418,3,1268710273,1268710603,2,1,330
38102706@N05,2419,11,1274001451,1274002411,1,1,960
38102706@N05,2420,4,1277545499,1277545859,1,1,360
38102706@N05,2421,3,1283739746,1283740076,1,1,330
38102706@N05,2422,4,1297500541,1297500901,1,1,360
38102706@N05,2423,6,1299474417,1299475137,1,1,720
38102706@N05,2424,11,1304239633,1304240593,1,1,960
38102706@N05,2425,8,1309770696,1309771536,2,2,840
38102706@N05,2425,2,1309789061,1309789301,2,2,240
38102706@N05,2426,3,1319357957,1319358287,1,1,330
38102706@N05,2427,17,1350897738,1350900438,1,1,2700
38102706@N05,2428,10,1352698533,1352699433,1,1,900
38102706@N05,2429,8,1356952964,1356953804,4,1,840
38102706@N05,2430,11,1360120334,1360121294,1,1,960
38102706@N05,2431,11,1364696353,1364697313,1,1,960
38102706@N05,2432,9,1368603261,1368604161,2,2,900
38102706@N05,2432,11,1368607962,1368608922,1,2,960
38102706@N05,2433,13,1369478291,1369479371,2,2,1080
38102706@N05,2433,11,1369483337,1369484297,1,2,960
38102706@N05,2434,11,1379852379,1379853339,1,1,960
38102706@N05,2435,11,1388564002,1388564962,3,2,960
38102706@N05,2435,13,1388567297,1388568377,1,2,1080
38102706@N05,2436,11,1390701887,1390702847,1,1,960
38102706@N05,2437,8,1402389690,1402390530,1,1,840
38117199@N07,2438,11,1253415793,1253416753,2,1,960
38153332@N00,2439,11,1372642546,1372643506,1,1,960
38189526@N02,2440,2,1241532001,1241532002,2,3,1
38189526@N02,2440,3,1241532002,1241532003,2,3,1
38189526@N02,2440,16,1241532003,1241534103,1,3,2100
38194020@N00,2441,2,1219823079,1219823319,17,1,240
38194020@N00,2442,5,1219982419,1219982839,10,2,420
38194020@N00,2442,12,1220004216,1220005236,4,2,1020
38194020@N00,2443,5,1220249310,1220249625,4,3,315
38194020@N00,2443,6,1220249625,1220250345,2,3,720
38194020@N00,2443,8,1220250899,1220251739,7,3,840
38194020@N00,2444,11,1220307207,1220308167,2,5,960
38194020@N00,2444,15,1220308493,1220309693,4,5,1200
38194020@N00,2444,13,1220310141,1220311221,2,5,1080
38194020@N00,2444,1,1220314319,1220314559,10,5,240
38194020@N00,2444,9,1220315140,1220316040,2,5,900
38235069@N00,2445,11,1450832062,1450833022,3,2,960
38235069@N00,2445,2,1450836651,1450836891,16,2,240
38235069@N00,2446,10,1451278749,1451279649,11,3,900
38235069@N00,2446,8,1451290421,1451291261,4,3,840
38235069@N00,2446,9,1451295427,1451296327,1,3,900
38257984@N04,2447,8,1337238099,1337238939,1,1,840
38275458@N05,2448,15,1244541947,1244543147,1,1,1200
38308378@N05,2449,15,1291961050,1291962250,2,2,1200
38308378@N05,2449,11,1291976408,1291977368,1,2,960
38331851@N00,2450,11,1466938059,1466939019,4,3,960
38331851@N00,2450,2,1466940772,1466940902,2,3,130
38331851@N00,2450,11,1466940902,1466941862,1,3,960
38505413@N06,2451,11,1322348602,1322349562,1,1,960
38505413@N06,2452,5,1322782912,1322783332,2,3,420
38505413@N06,2452,15,1322802136,1322803336,2,3,1200
38505413@N06,2452,13,1322819293,1322820373,2,3,1080
38505413@N06,2453,1,1324702613,1324702853,1,1,240
38555308@N02,2454,10,1318947145,1318948045,1,1,900
38604142@N08,2455,17,1317529680,1317532380,1,1,2700
38646505@N03,2456,11,1456623333,1456624293,1,1,960
38653388@N00,2457,11,1426321197,1426322157,1,1,960
38773853@N06,2458,11,1342861396,1342862356,3,1,960
38773853@N06,2459,11,1342961910,1342962870,1,1,960
38803734@N06,2460,2,1408077104,1408077344,1,1,240
38806446@N05,2461,10,1435051616,1435052516,10,4,900
38806446@N05,2461,15,1435053130,1435054330,3,4,1200
38806446@N05,2461,10,1435056294,1435056553,2,4,259
38806446@N05,2461,15,1435056553,1435057753,4,4,1200
38848642@N00,2462,6,1217917717,1217918437,1,1,720
38848642@N00,2463,6,1217987181,1217987901,2,1,720
38848642@N00,2464,12,1218098504,1218099524,1,1,1020
38848642@N00,2465,6,1218175370,1218176090,1,1,720
38848642@N00,2466,5,1255577997,1255578417,3,2,420
38848642@N00,2466,15,1255586526,1255587726,1,2,1200
38848642@N00,2467,17,1255860623,1255862838,4,2,2215
38848642@N00,2467,6,1255862838,1255863558,2,2,720
38848642@N00,2468,11,1255952840,1255953800,5,1,960
38848642@N00,2469,8,1256295977,1256296817,22,1,840
38848642@N00,2470,11,1338873550,1338874510,4,1,960
38848642@N00,2471,11,1339133235,1339134195,20,1,960
38848642@N00,2472,17,1339323042,1339325742,1,1,2700
38848642@N00,2473,11,1339740881,1339741841,11,1,960
38848642@N00,2474,11,1339807250,1339808210,7,1,960
38879474@N04,2475,10,1242944076,1242944976,1,1,900
38879474@N04,2476,8,1288227814,1288228654,1,1,840
38879474@N04,2477,6,1350879169,1350879889,1,1,720
38879474@N04,2478,4,1380490962,1380491322,1,1,360
38880314@N07,2479,14,1189935762,1189936962,1,1,1200
38937312@N00,2480,13,1449072277,1449073357,1,1,1080
38937312@N00,2481,13,1449207114,1449208194,1,1,1080
38959313@N02,2482,17,1398309537,1398312237,1,1,2700
39008310@N05,2483,3,1368396002,1368396332,1,1,330
39024895@N00,2484,13,1309325151,1309325537,3,3,386
39024895@N00,2484,15,1309325537,1309326002,3,3,465
39024895@N00,2484,10,1309326002,1309326902,38,3,900
39037826@N00,2485,10,1449016544,1449017444,16,6,900
39037826@N00,2485,15,1449019755,1449020602,3,6,847
39037826@N00,2485,17,1449020602,1449020785,3,6,183
39037826@N00,2485,13,1449020785,1449021865,4,6,1080
39037826@N00,2485,8,1449033941,1449034781,5,6,840
39037826@N00,2485,11,1449038512,1449039472,1,6,960
39039509@N05,2486,16,1267672846,1267674946,1,1,2100
39078602@N04,2487,3,1464833892,1464834222,2,1,330
39104390@N07,2488,11,1284950885,1284951845,2,1,960
39146060@N00,2489,10,1188007634,1188008534,2,3,900
39146060@N00,2489,9,1188010388,1188011288,2,3,900
39146060@N00,2489,13,1188013378,1188014458,1,3,1080
39146060@N00,2490,13,1188168218,1188169298,2,2,1080
39146060@N00,2490,1,1188176984,1188177224,2,2,240
39146060@N00,2491,12,1190359502,1190360522,1,1,1020
39146060@N00,2492,5,1190439446,1190439866,2,1,420
39146060@N00,2493,7,1190587306,1190588146,2,4,840
39146060@N00,2493,10,1190593650,1190594550,7,4,900
39146060@N00,2493,8,1190614120,1190614960,3,4,840
39146060@N00,2493,17,1190619900,1190622600,2,4,2700
39146060@N00,2494,11,1190843468,1190844428,2,7,960
39146060@N00,2494,16,1190846108,1190848208,2,7,2100
39146060@N00,2494,5,1190848942,1190849362,2,7,420
39146060@N00,2494,8,1190850028,1190850868,8,7,840
39146060@N00,2494,13,1190854630,1190855710,2,7,1080
39146060@N00,2494,10,1190859966,1190860696,3,7,730
39146060@N00,2494,16,1190860696,1190862796,1,7,2100
39146060@N00,2495,6,1190968242,1190968526,2,11,284
39146060@N00,2495,11,1190968526,1190969486,2,11,960
39146060@N00,2495,8,1190970476,1190970908,3,11,432
39146060@N00,2495,5,1190970908,1190971328,4,11,420
39146060@N00,2495,1,1190971684,1190971886,2,11,202
39146060@N00,2495,9,1190971886,1190972670,5,11,784
39146060@N00,2495,2,1190972670,1190972910,5,11,240
39146060@N00,2495,12,1190973274,1190973576,2,11,302
39146060@N00,2495,4,1190973576,1190973936,2,11,360
39146060@N00,2495,10,1190974874,1190975342,2,11,468
39146060@N00,2495,17,1190975342,1190978042,1,11,2700
39146060@N00,2496,4,1192266373,1192266382,2,12,9
39146060@N00,2496,9,1192266382,1192266385,4,12,3
39146060@N00,2496,4,1192266385,1192266385,2,12,0
39146060@N00,2496,7,1192266385,1192266390,2,12,5
39146060@N00,2496,13,1192266390,1192266392,2,12,2
39146060@N00,2496,15,1192266392,1192266393,2,12,1
39146060@N00,2496,1,1192266393,1192266403,2,12,10
39146060@N00,2496,16,1192266403,1192266406,2,12,3
39146060@N00,2496,1,1192266406,1192266412,2,12,6
39146060@N00,2496,3,1192266412,1192266418,2,12,6
39146060@N00,2496,4,1192266418,1192266421,2,12,3
39146060@N00,2496,11,1192266421,1192267381,2,12,960
39146060@N00,2497,6,1223126814,1223126817,2,9,3
39146060@N00,2497,9,1223126817,1223126820,4,9,3
39146060@N00,2497,1,1223126820,1223126821,2,9,1
39146060@N00,2497,2,1223126821,1223126822,2,9,1
39146060@N00,2497,1,1223126822,1223126824,4,9,2
39146060@N00,2497,17,1223126824,1223126825,2,9,1
39146060@N00,2497,1,1223126825,1223126829,3,9,4
39146060@N00,2497,3,1223126829,1223126830,2,9,1
39146060@N00,2497,4,1223126830,1223127190,1,9,360
39146060@N00,2498,11,1228828948,1228829908,4,5,960
39146060@N00,2498,4,1228831949,1228832309,2,5,360
39146060@N00,2498,10,1228833130,1228834030,2,5,900
39146060@N00,2498,13,1228834668,1228835709,2,5,1041
39146060@N00,2498,17,1228835709,1228838409,1,5,2700
39146060@N00,2499,11,1229116716,1229117676,2,1,960
39146060@N00,2500,16,1229246879,1229248979,3,3,2100
39146060@N00,2500,15,1229249106,1229250306,3,3,1200
39146060@N00,2500,4,1229260263,1229260623,1,3,360
39146060@N00,2501,5,1311566688,1311567108,1,1,420
39149225@N08,2502,11,1418786721,1418787681,2,2,960
39149225@N08,2502,9,1418791085,1418791985,1,2,900
39149225@N08,2503,10,1418938778,1418939678,4,1,900
39156069@N03,2504,4,1451452686,1451453046,3,2,360
39156069@N03,2504,5,1451457797,1451458217,8,2,420
39179826@N04,2505,11,1302488575,1302489535,1,1,960
39181997@N08,2506,13,1316299232,1316300312,1,1,1080
39276962@N07,2507,11,1265768938,1265769898,5,1,960
39312075@N06,2508,4,1249856624,1249856984,2,2,360
39312075@N06,2508,15,1249866090,1249867290,1,2,1200
39312075@N06,2509,17,1250160410,1250163110,2,2,2700
39312075@N06,2509,5,1250164128,1250164548,1,2,420
39360988@N05,2510,5,1273969876,1273970121,2,2,245
39360988@N05,2510,13,1273970121,1273971201,1,2,1080
39364877@N05,2511,17,1391159502,1391162202,3,1,2700
39478938@N03,2512,6,1231299461,1231300181,1,1,720
39482180@N00,2513,10,1257910573,1257911473,2,1,900
39487324@N08,2514,11,1334735859,1334736819,1,1,960
39635921@N02,2515,2,1313748020,1313748260,1,1,240
39707801@N00,2516,11,1195367829,1195368789,1,1,960
39803308@N08,2517,11,1451390460,1451391420,1,1,960
39864275@N02,2518,13,1417652687,1417653767,4,1,1080
39893757@N00,2519,8,1409720254,1409720408,2,2,154
39893757@N00,2519,11,1409720408,1409721368,3,2,960
39909510@N07,2520,5,1233021868,1233022288,2,1,420
39953677@N06,2521,11,1348244253,1348245213,1,1,960
40048950@N04,2522,11,1337765042,1337766002,2,1,960
40048950@N04,2523,4,1343465576,1343465936,1,1,360
40067092@N00,2524,11,1372206266,1372207226,1,1,960
40084924@N08,2525,15,1206153235,1206153352,2,4,117
40084924@N08,2525,11,1206153352,1206154312,3,4,960
40084924@N08,2525,15,1206155971,1206157171,3,4,1200
40084924@N08,2525,11,1206173525,1206174485,1,4,960
40084924@N08,2526,15,1206219593,1206220793,1,1,1200
40116549@N03,2527,16,1247298584,1247300684,2,1,2100
40172365@N00,2528,11,1324856253,1324857213,2,2,960
40172365@N00,2528,13,1324877137,1324878217,2,2,1080
40172365@N00,2529,13,1337820916,1337821996,1,1,1080
40205611@N04,2530,11,1351078369,1351079329,1,1,960
40262057@N06,2531,11,1236637114,1236637582,3,12,468
40262057@N06,2531,1,1236637582,1236637822,12,12,240
40262057@N06,2531,7,1236640852,1236641692,3,12,840
40262057@N06,2531,4,1236645812,1236646172,6,12,360
40262057@N06,2531,5,1236651197,1236651617,4,12,420
40262057@N06,2531,8,1236653028,1236653868,5,12,840
40262057@N06,2531,17,1236655851,1236658440,2,12,2589
40262057@N06,2531,13,1236658440,1236659355,4,12,915
40262057@N06,2531,15,1236659355,1236660212,3,12,857
40262057@N06,2531,10,1236660212,1236660947,4,12,735
40262057@N06,2531,17,1236660947,1236663647,2,12,2700
40262057@N06,2531,10,1236678345,1236679245,2,12,900
40262057@N06,2532,11,1236819543,1236820200,7,2,657
40262057@N06,2532,2,1236820200,1236820440,2,2,240
40262057@N06,2533,11,1236853756,1236854716,10,1,960
40262057@N06,2534,11,1355007792,1355008752,1,1,960
40262057@N06,2535,11,1355187366,1355188326,9,2,960
40262057@N06,2535,2,1355191213,1355191453,5,2,240
40279984@N00,2536,16,1395869183,1395869547,4,7,364
40279984@N00,2536,9,1395869547,1395870261,4,7,714
40279984@N00,2536,1,1395870261,1395870501,2,7,240
40279984@N00,2536,13,1395883288,1395884368,2,7,1080
40279984@N00,2536,15,1395886873,1395886975,2,7,102
40279984@N00,2536,17,1395886975,1395889675,2,7,2700
40279984@N00,2536,4,1395889739,1395890099,1,7,360
40286663@N06,2537,17,1254474052,1254474294,3,4,242
40286663@N06,2537,10,1254474294,1254475194,9,4,900
40286663@N06,2537,5,1254475824,1254476244,2,4,420
40286663@N06,2537,8,1254476639,1254477479,4,4,840
40303166@N06,2538,16,1288139083,1288141183,1,1,2100
40303166@N06,2539,5,1288478419,1288478839,3,4,420
40303166@N06,2539,8,1288481389,1288482229,2,4,840
40303166@N06,2539,15,1288488937,1288490137,2,4,1200
40303166@N06,2539,11,1288490437,1288491397,3,4,960
40303166@N06,2540,6,1289027138,1289027858,18,1,720
40303166@N06,2541,2,1289378332,1289378572,2,10,240
40303166@N06,2541,4,1289378754,1289379114,4,10,360
40303166@N06,2541,16,1289382285,1289382594,2,10,309
40303166@N06,2541,1,1289382594,1289382834,2,10,240
40303166@N06,2541,5,1289384461,1289384881,2,10,420
40303166@N06,2541,8,1289385213,1289386053,2,10,840
40303166@N06,2541,13,1289387597,1289387787,2,10,190
40303166@N06,2541,15,1289387787,1289387970,2,10,183
40303166@N06,2541,17,1289387970,1289388088,2,10,118
40303166@N06,2541,10,1289388088,1289388988,1,10,900
40356131@N04,2542,11,1247368902,1247369862,1,1,960
40437944@N00,2543,11,1389207456,1389208416,2,1,960
40437944@N00,2544,11,1389291596,1389292556,2,1,960
40437944@N00,2545,11,1389394739,1389395699,1,1,960
40437944@N00,2546,11,1389484931,1389485891,1,1,960
40547030@N00,2547,5,1393815033,1393815453,7,1,420
40563308@N02,2548,13,1250144715,1250145795,1,1,1080
40563308@N02,2549,8,1250200041,1250200881,2,3,840
40563308@N02,2549,2,1250223994,1250224234,6,3,240
40563308@N02,2549,15,1250230926,1250232126,1,3,1200
40563308@N02,2550,11,1250539333,1250540293,1,1,960
40563308@N02,2551,2,1312438039,1312438279,4,1,240
40563308@N02,2552,8,1312668096,1312668936,2,2,840
40563308@N02,2552,13,1312681077,1312682157,1,2,1080
40563308@N02,2553,10,1312845063,1312845963,1,1,900
40563308@N02,2554,10,1340317271,1340318171,1,1,900
40571088@N00,2555,5,1463626456,1463626876,7,2,420
40571088@N00,2555,13,1463644467,1463645547,10,2,1080
40571088@N00,2556,11,1463723928,1463724888,12,8,960
40571088@N00,2556,10,1463725442,1463725798,3,8,356
40571088@N00,2556,17,1463725798,1463725936,2,8,138
40571088@N00,2556,13,1463725936,1463727016,5,8,1080
40571088@N00,2556,8,1463731219,1463732059,3,8,840
40571088@N00,2556,1,1463732482,1463732722,8,8,240
40571088@N00,2556,9,1463733459,1463734359,3,8,900
40571088@N00,2556,11,1463736027,1463736987,1,8,960
40598203@N08,2557,4,1210773694,1210774054,1,1,360
40598203@N08,2558,11,1279769927,1279770887,5,7,960
40598203@N08,2558,9,1279776631,1279777531,2,7,900
40598203@N08,2558,4,1279781050,1279781410,5,7,360
40598203@N08,2558,3,1279783449,1279783779,2,7,330
40598203@N08,2558,11,1279796175,1279797135,4,7,960
40598203@N08,2558,16,1279806240,1279806749,2,7,509
40598203@N08,2558,9,1279806749,1279807649,3,7,900
40610681@N06,2559,15,1387254692,1387254757,2,3,65
40610681@N06,2559,13,1387254757,1387255020,2,3,263
40610681@N06,2559,11,1387255020,1387255980,1,3,960
40646519@N00,2560,7,1191632203,1191633043,2,14,840
40646519@N00,2560,3,1191633524,1191633854,2,14,330
40646519@N00,2560,4,1191634161,1191634521,2,14,360
40646519@N00,2560,17,1191635827,1191636208,2,14,381
40646519@N00,2560,13,1191636208,1191636240,2,14,32
40646519@N00,2560,15,1191636240,1191637440,2,14,1200
40646519@N00,2560,5,1191641655,1191642075,4,14,420
40646519@N00,2560,2,1191647389,1191647629,3,14,240
40646519@N00,2560,12,1191647812,1191648832,12,14,1020
40646519@N00,2560,16,1191649712,1191649744,2,14,32
40646519@N00,2560,12,1191649744,1191649753,2,14,9
40646519@N00,2560,16,1191649753,1191651853,3,14,2100
40646519@N00,2560,10,1191653348,1191654248,4,14,900
40646519@N00,2560,11,1191655561,1191656521,9,14,960
40646519@N00,2561,11,1274570204,1274571164,4,17,960
40646519@N00,2561,7,1274572867,1274573707,2,17,840
40646519@N00,2561,14,1274573815,1274574468,3,17,653
40646519@N00,2561,3,1274574468,1274574798,2,17,330
40646519@N00,2561,2,1274576333,1274576573,5,17,240
40646519@N00,2561,12,1274577634,1274578474,2,17,840
40646519@N00,2561,2,1274578474,1274578559,3,17,85
40646519@N00,2561,4,1274578559,1274578919,5,17,360
40646519@N00,2561,3,1274580697,1274581027,4,17,330
40646519@N00,2561,4,1274582587,1274582947,2,17,360
40646519@N00,2561,10,1274583013,1274583169,3,17,156
40646519@N00,2561,17,1274583169,1274583522,5,17,353
40646519@N00,2561,13,1274583522,1274584602,3,17,1080
40646519@N00,2561,8,1274592997,1274593837,8,17,840
40646519@N00,2561,5,1274595927,1274596347,6,17,420
40646519@N00,2561,2,1274598590,1274598662,3,17,72
40646519@N00,2561,11,1274598662,1274599622,8,17,960
40646519@N00,2562,11,1286411937,1286412897,7,18,960
40646519@N00,2562,12,1286415946,1286416966,3,18,1020
40646519@N00,2562,2,1286417228,1286417468,5,18,240
40646519@N00,2562,4,1286417486,1286417846,10,18,360
40646519@N00,2562,10,1286423787,1286423910,2,18,123
40646519@N00,2562,17,1286423910,1286424056,2,18,146
40646519@N00,2562,10,1286424056,1286424553,5,18,497
40646519@N00,2562,17,1286424553,1286424783,4,18,230
40646519@N00,2562,15,1286424783,1286425577,4,18,794
40646519@N00,2562,17,1286425577,1286425610,3,18,33
40646519@N00,2562,15,1286425610,1286425942,3,18,332
40646519@N00,2562,13,1286425942,1286427022,19,18,1080
40646519@N00,2562,6,1286432664,1286433384,12,18,720
40646519@N00,2562,8,1286436640,1286437480,7,18,840
40646519@N00,2562,5,1286439367,1286439787,21,18,420
40646519@N00,2562,15,1286444128,1286444387,6,18,259
40646519@N00,2562,17,1286444387,1286447087,2,18,2700
40646519@N00,2562,11,1286447294,1286448254,4,18,960
40646519@N00,2563,11,1320977354,1320978314,5,11,960
40646519@N00,2563,4,1320982314,1320982674,7,11,360
40646519@N00,2563,2,1320984636,1320984876,2,11,240
40646519@N00,2563,12,1320984958,1320985978,11,11,1020
40646519@N00,2563,5,1320988873,1320989293,36,11,420
40646519@N00,2563,8,1320994400,1320995240,6,11,840
40646519@N00,2563,15,1320999875,1321000569,4,11,694
40646519@N00,2563,17,1321000569,1321000810,2,11,241
40646519@N00,2563,10,1321000810,1321001710,2,11,900
40646519@N00,2563,2,1321005139,1321005275,3,11,136
40646519@N00,2563,11,1321005275,1321006235,14,11,960
40647915@N03,2564,2,1290384514,1290384754,1,1,240
40692503@N07,2565,8,1246668311,1246669151,1,1,840
40727760@N08,2566,11,1299747492,1299748452,1,1,960
40732558787@N01,2567,15,1327122008,1327123208,1,1,1200
40732565660@N01,2568,11,1201935567,1201936527,6,3,960
40732565660@N01,2568,12,1201937724,1201938744,2,3,1020
40732565660@N01,2568,11,1201940915,1201941875,5,3,960
40732565660@N01,2569,7,1238042430,1238043270,3,1,840
40732565660@N01,2570,7,1298783997,1298784837,2,1,840
40745887@N05,2571,14,1284685933,1284687133,5,2,1200
40745887@N05,2571,4,1284687744,1284688104,1,2,360
40802704@N05,2572,11,1274230598,1274231558,33,1,960
40802704@N05,2573,11,1274423205,1274424165,1,1,960
40812847@N05,2574,11,1396411563,1396412523,1,1,960
40814689@N00,2575,5,1451259673,1451260093,2,3,420
40814689@N00,2575,3,1451267847,1451268177,2,3,330
40814689@N00,2575,11,1451269808,1451270768,1,3,960
40827705@N04,2576,11,1208236518,1208237478,1,1,960
40897907@N08,2577,13,1354265716,1354266796,3,2,1080
40897907@N08,2577,15,1354306307,1354307507,1,2,1200
40899173@N05,2578,11,1261831897,1261832857,1,1,960
40919416@N06,2579,11,1281306484,1281307444,10,1,960
40919416@N06,2580,5,1326521021,1326521441,4,2,420
40919416@N06,2580,15,1326522537,1326523737,3,2,1200
40937461@N02,2581,11,1329260498,1329261458,2,11,960
40937461@N02,2581,1,1329262644,1329262884,3,11,240
40937461@N02,2581,5,1329265539,1329265959,6,11,420
40937461@N02,2581,2,1329270284,1329270524,3,11,240
40937461@N02,2581,1,1329282467,1329282707,2,11,240
40937461@N02,2581,8,1329285709,1329286549,3,11,840
40937461@N02,2581,13,1329288473,1329289553,4,11,1080
40937461@N02,2581,16,1329294510,1329296610,3,11,2100
40937461@N02,2581,6,1329299312,1329300032,2,11,720
40937461@N02,2581,15,1329301354,1329302083,2,11,729
40937461@N02,2581,11,1329302083,1329303043,1,11,960
40937461@N02,2582,10,1329615711,1329616611,7,1,900
40947197@N06,2583,11,1466685063,1466686023,1,1,960
40968098@N07,2584,8,1432261982,1432262822,7,15,840
40968098@N07,2584,9,1432270865,1432271765,7,15,900
40968098@N07,2584,1,1432278924,1432279164,5,15,240
40968098@N07,2584,9,1432279728,1432279988,2,15,260
40968098@N07,2584,11,1432279988,1432280937,2,15,949
40968098@N07,2584,1,1432280937,1432281177,2,15,240
40968098@N07,2584,11,1432281642,1432282602,5,15,960
40968098@N07,2584,2,1432283866,1432284106,7,15,240
40968098@N07,2584,4,1432286474,1432286834,3,15,360
40968098@N07,2584,11,1432290519,1432291479,4,15,960
40968098@N07,2584,3,1432295870,1432296200,4,15,330
40968098@N07,2584,14,1432296650,1432297850,2,15,1200
40968098@N07,2584,17,1432302372,1432302441,2,15,69
40968098@N07,2584,3,1432302441,1432302771,2,15,330
40968098@N07,2584,13,1432302880,1432303960,2,15,1080
40968098@N07,2585,8,1432355804,1432356644,2,2,840
40968098@N07,2585,1,1432380648,1432380888,1,2,240
40983857@N00,2586,11,1261170535,1261171495,1,1,960
40983857@N00,2587,11,1261204754,1261205714,1,1,960
41019626@N00,2588,11,1296606247,1296607207,1,1,960
41019626@N00,2589,11,1296637758,1296638718,2,1,960
41111981@N02,2590,5,1302506916,1302507336,1,1,420
41126359@N00,2591,4,1278720065,1278720425,2,2,360
41126359@N00,2591,3,1278724449,1278724779,1,2,330
41126359@N00,2592,8,1280565166,1280566006,1,1,840
41126359@N00,2593,16,1283500179,1283502279,2,3,2100
41126359@N00,2593,8,1283506851,1283507691,2,3,840
41126359@N00,2593,11,1283517528,1283518488,2,3,960
41126359@N00,2594,6,1295176297,1295177017,1,1,720
41126359@N00,2595,11,1362647054,1362648014,1,1,960
41134616@N00,2596,11,1225147687,1225148647,3,4,960
41134616@N00,2596,2,1225153081,1225153321,7,4,240
41134616@N00,2596,9,1225168953,1225169853,2,4,900
41134616@N00,2596,16,1225178029,1225180129,1,4,2100
41134616@N00,2597,10,1225418992,1225419091,2,3,99
41134616@N00,2597,15,1225419091,1225420291,6,3,1200
41134616@N00,2597,8,1225429510,1225430350,1,3,840
41138825@N00,2598,11,1393492657,1393492991,4,2,334
41138825@N00,2598,17,1393492991,1393495691,3,2,2700
41138825@N00,2599,11,1393653099,1393654059,6,1,960
41197583@N00,2600,11,1250400301,1250401261,2,2,960
41197583@N00,2600,5,1250405040,1250405460,1,2,420
41197583@N00,2601,11,1250458392,1250459352,2,7,960
41197583@N00,2601,2,1250460477,1250460717,2,7,240
41197583@N00,2601,10,1250465377,1250465781,3,7,404
41197583@N00,2601,17,1250465781,1250465984,2,7,203
41197583@N00,2601,13,1250465984,1250466066,2,7,82
41197583@N00,2601,15,1250466066,1250467266,2,7,1200
41197583@N00,2601,5,1250468919,1250469339,1,7,420
41211080@N02,2602,11,1336429336,1336430296,2,1,960
41221221@N02,2603,11,1212714067,1212715027,1,1,960
41236077@N02,2604,14,1326590085,1326591285,2,4,1200
41236077@N02,2604,10,1326600597,1326601497,2,4,900
41236077@N02,2604,8,1326610366,1326611206,2,4,840
41236077@N02,2604,11,1326623447,1326624407,1,4,960
41236077@N02,2605,8,1335491385,1335492225,3,4,840
41236077@N02,2605,13,1335499742,1335500407,3,4,665
41236077@N02,2605,17,1335500407,1335503107,2,4,2700
41236077@N02,2605,11,1335518606,1335519566,1,4,960
41251621@N00,2606,11,1352386881,1352387841,1,1,960
41277655@N07,2607,8,1399250275,1399251115,2,1,840
41299606@N00,2608,11,1425029146,1425030106,1,1,960
41335227@N00,2609,5,1360640439,1360640859,1,1,420
41365056@N00,2610,5,1251863989,1251864409,1,1,420
41365794@N07,2611,11,1310124954,1310125914,1,1,960
41395151@N04,2612,11,1325639504,1325640464,1,1,960
41396402@N03,2613,11,1396568762,1396569722,2,6,960
41396402@N03,2613,1,1396575426,1396575666,3,6,240
41396402@N03,2613,13,1396589233,1396589645,3,6,412
41396402@N03,2613,15,1396589645,1396589743,2,6,98
41396402@N03,2613,17,1396589743,1396592443,5,6,2700
41396402@N03,2613,2,1396598256,1396598496,2,6,240
41407408@N00,2614,8,1272021007,1272021847,1,1,840
41407408@N00,2615,9,1273134688,1273135588,1,1,900
41407408@N00,2616,4,1277767175,1277767535,1,1,360
41407408@N00,2617,16,1306463305,1306463587,2,4,282
41407408@N00,2617,11,1306463587,1306464547,2,4,960
41407408@N00,2617,9,1306464627,1306464948,2,4,321
41407408@N00,2617,4,1306464948,1306465308,2,4,360
41407408@N00,2618,2,1375867753,1375867993,1,1,240
41407408@N00,2619,11,1416371287,1416372247,1,1,960
41407408@N00,2620,13,1419060818,1419061042,2,2,224
41407408@N00,2620,15,1419061042,1419062242,1,2,1200
41419160@N03,2621,11,1256362117,1256363077,3,3,960
41419160@N03,2621,1,1256378361,1256378601,2,3,240
41419160@N03,2621,2,1256393819,1256394059,1,3,240
41427544@N00,2622,13,1298086621,1298087701,1,1,1080
41454017@N05,2623,8,1310365101,1310365941,3,2,840
41454017@N05,2623,9,1310377534,1310378434,1,2,900
41491112@N00,2624,11,1192681667,1192682627,3,2,960
41491112@N00,2624,10,1192693955,1192694855,1,2,900
41508163@N07,2625,8,1307771811,1307772651,1,1,840
41545932@N02,2626,11,1356929223,1356930183,1,1,960
41545932@N02,2627,9,1357204294,1357205194,1,1,900
41610763@N04,2628,9,1326868061,1326868700,2,3,639
41610763@N04,2628,8,1326868700,1326869376,3,3,676
41610763@N04,2628,11,1326869376,1326870336,1,3,960
41624223@N08,2629,11,1338433033,1338433993,4,4,960
41624223@N08,2629,8,1338444433,1338445273,2,4,840
41624223@N08,2629,13,1338455305,1338455886,2,4,581
41624223@N08,2629,17,1338455886,1338458586,2,4,2700
41644332@N07,2630,11,1263072153,1263073113,1,1,960
41644332@N07,2631,11,1263456527,1263457487,2,1,960
41644332@N07,2632,11,1267160224,1267161184,1,1,960
41661621@N00,2633,13,1215236794,1215237874,1,1,1080
41661621@N00,2634,11,1392092338,1392093298,3,9,960
41661621@N00,2634,2,1392094144,1392094384,19,9,240
41661621@N00,2634,14,1392096829,1392097062,2,9,233
41661621@N00,2634,3,1392097062,1392097392,13,9,330
41661621@N00,2634,4,1392098241,1392098601,2,9,360
41661621@N00,2634,13,1392099496,1392100576,4,9,1080
41661621@N00,2634,8,1392100894,1392101734,3,9,840
41661621@N00,2634,9,1392102625,1392103525,4,9,900
41661621@N00,2634,11,1392104398,1392105358,2,9,960
41663556@N00,2635,11,1302995607,1302996567,6,8,960
41663556@N00,2635,1,1303003409,1303003649,3,8,240
41663556@N00,2635,9,1303005870,1303006770,6,8,900
41663556@N00,2635,8,1303010508,1303011348,2,8,840
41663556@N00,2635,1,1303016678,1303016918,2,8,240
41663556@N00,2635,5,1303019114,1303019534,2,8,420
41663556@N00,2635,8,1303020846,1303021686,2,8,840
41663556@N00,2635,13,1303029281,1303030361,1,8,1080
41685885@N05,2636,11,1291212933,1291213893,1,1,960
41693381@N00,2637,2,1292293383,1292293623,2,4,240
41693381@N00,2637,3,1292298392,1292298722,2,4,330
41693381@N00,2637,9,1292301987,1292302887,3,4,900
41693381@N00,2637,6,1292308090,1292308810,2,4,720
41693381@N00,2638,11,1292383784,1292384744,3,2,960
41693381@N00,2638,1,1292387927,1292388167,1,2,240
41693381@N00,2639,17,1292495594,1292496051,2,2,457
41693381@N00,2639,6,1292496051,1292496771,1,2,720
41693381@N00,2640,9,1337574723,1337575623,2,3,900
41693381@N00,2640,4,1337592972,1337593332,3,3,360
41693381@N00,2640,11,1337593811,1337594771,1,3,960
41693381@N00,2641,17,1337684548,1337686996,7,2,2448
41693381@N00,2641,11,1337686996,1337687956,1,2,960
41693381@N00,2642,11,1349081808,1349082768,2,1,960
41693381@N00,2643,11,1365680746,1365681706,2,1,960
41693381@N00,2644,11,1408610718,1408611678,1,1,960
41693381@N00,2645,11,1419581644,1419582604,1,1,960
41693381@N00,2646,11,1423875784,1423876744,1,1,960
41693381@N00,2647,5,1425707723,1425708143,1,1,420
41693381@N00,2648,15,1426232285,1426233485,1,1,1200
41693381@N00,2649,11,1427179937,1427180897,1,1,960
41693381@N00,2650,4,1430641004,1430641364,2,2,360
41693381@N00,2650,13,1430645801,1430646881,1,2,1080
41693381@N00,2651,5,1438852413,1438852833,3,2,420
41693381@N00,2651,11,1438860953,1438861913,1,2,960
41693381@N00,2652,5,1443251583,1443252003,1,1,420
41693381@N00,2653,16,1443596687,1443598787,2,2,2100
41693381@N00,2653,11,1443606297,1443607257,1,2,960
41693381@N00,2654,13,1447542135,1447543215,1,1,1080
41693381@N00,2655,5,1456555988,1456556408,3,1,420
41693381@N00,2656,11,1459650434,1459651394,2,2,960
41693381@N00,2656,8,1459654549,1459655389,1,2,840
41693381@N00,2657,17,1460196675,1460199375,1,1,2700
41693381@N00,2658,2,1464513534,1464513774,1,1,240
41808955@N00,2659,4,1288746766,1288747126,2,3,360
41808955@N00,2659,17,1288753217,1288755917,2,3,2700
41808955@N00,2659,11,1288765470,1288766430,1,3,960
41850050@N02,2660,1,1307831368,1307831608,1,1,240
41872770@N05,2661,17,1272117600,1272117602,3,3,2
41872770@N05,2661,15,1272117602,1272117603,2,3,1
41872770@N05,2661,13,1272117603,1272118683,1,3,1080
41872770@N05,2662,5,1272162958,1272163378,1,1,420
41894165897@N01,2663,11,1356651522,1356652482,3,2,960
41894165897@N01,2663,15,1356674817,1356676017,1,2,1200
41894178016@N01,2664,11,1345274369,1345275329,1,1,960
41894185936@N01,2665,11,1381449561,1381450521,1,1,960
41903519@N07,2666,15,1379674870,1379676070,2,4,1200
41903519@N07,2666,2,1379692629,1379692869,2,4,240
41903519@N07,2666,13,1379693190,1379693249,2,4,59
41903519@N07,2666,15,1379693249,1379694449,1,4,1200
41903519@N07,2667,16,1380267725,1380269825,1,1,2100
41903519@N07,2668,4,1411826635,1411826995,2,2,360
41903519@N07,2668,11,1411831488,1411832448,1,2,960
41967511@N00,2669,11,1244293444,1244294404,1,1,960
41972914@N07,2670,13,1342677951,1342678249,3,3,298
41972914@N07,2670,17,1342678249,1342678253,2,3,4
41972914@N07,2670,13,1342678253,1342679333,1,3,1080
41976006@N02,2671,11,1401965136,1401966096,1,1,960
41995153@N08,2672,4,1277541990,1277542350,1,1,360
42034882@N00,2673,15,1365779387,1365780587,1,1,1200
42034882@N00,2674,11,1365833476,1365834436,1,1,960
42045401@N00,2675,11,1350029538,1350030498,1,1,960
42048765@N03,2676,3,1247608938,1247609268,1,1,330
42048765@N03,2677,13,1343105066,1343106146,1,1,1080
42048765@N03,2678,13,1398486208,1398487288,2,2,1080
42048765@N03,2678,8,1398503877,1398504717,1,2,840
42118699@N08,2679,8,1210128568,1210129408,2,2,840
42118699@N08,2679,17,1210138195,1210140895,1,2,2700
42118699@N08,2680,8,1254458592,1254459432,1,1,840
42118699@N08,2681,10,1254786057,1254786957,2,4,900
42118699@N08,2681,15,1254789913,1254791113,2,4,1200
42118699@N08,2681,8,1254795403,1254796243,3,4,840
42118699@N08,2681,17,1254809447,1254812147,1,4,2700
42118699@N08,2682,9,1254873749,1254874649,1,1,900
42118699@N08,2683,13,1257810410,1257811490,1,1,1080
42118699@N08,2684,2,1257993012,1257993252,7,3,240
42118699@N08,2684,16,1257997559,1257999659,2,3,2100
42118699@N08,2684,8,1257999875,1258000715,1,3,840
42118699@N08,2685,13,1286665210,1286666290,2,3,1080
42118699@N08,2685,9,1286685079,1286685702,3,3,623
42118699@N08,2685,16,1286685702,1286687802,1,3,2100
42118699@N08,2686,16,1286755532,1286757632,1,1,2100
42118699@N08,2687,10,1286930642,1286931542,2,2,900
42118699@N08,2687,11,1286934567,1286935527,1,2,960
42118699@N08,2688,11,1305164828,1305165788,3,6,960
42118699@N08,2688,10,1305167619,1305168519,2,6,900
42118699@N08,2688,13,1305169705,1305170785,2,6,1080
42118699@N08,2688,11,1305197090,1305198050,2,6,960
42118699@N08,2688,5,1305200387,1305200807,2,6,420
42118699@N08,2688,2,1305206039,1305206279,1,6,240
42118699@N08,2689,8,1351140989,1351141829,2,1,840
42118699@N08,2690,17,1367375880,1367378580,2,2,2700
42118699@N08,2690,13,1367379625,1367380705,1,2,1080
42118699@N08,2691,11,1367522675,1367523635,3,4,960
42118699@N08,2691,17,1367524136,1367526836,3,4,2700
42118699@N08,2691,9,1367551049,1367551499,2,4,450
42118699@N08,2691,16,1367551499,1367553599,1,4,2100
42118699@N08,2692,8,1368235391,1368236231,2,1,840
42118699@N08,2693,13,1368423289,1368424369,1,1,1080
42118699@N08,2694,8,1368485711,1368486551,1,1,840
42118699@N08,2695,17,1368603809,1368606509,1,1,2700
42118699@N08,2696,8,1430023243,1430024083,1,1,840
42118699@N08,2697,11,1460277301,1460278261,2,2,960
42118699@N08,2697,10,1460288497,1460289397,1,2,900
42118699@N08,2698,13,1460449439,1460450519,1,1,1080
42118699@N08,2699,17,1460501774,1460504474,1,1,2700
42118699@N08,2700,13,1460612520,1460613600,1,1,1080
42118699@N08,2701,9,1460693762,1460694662,1,1,900
42151752@N05,2702,11,1448390526,1448391486,2,5,960
42151752@N05,2702,1,1448392987,1448393227,2,5,240
42151752@N05,2702,17,1448403794,1448406494,2,5,2700
42151752@N05,2702,8,1448426715,1448427555,2,5,840
42151752@N05,2702,2,1448433646,1448433886,1,5,240
42201001@N07,2703,8,1286951529,1286952369,1,1,840
42229053@N03,2704,11,1391217116,1391218076,1,1,960
42285443@N04,2705,5,1253014017,1253014437,1,1,420
42299049@N06,2706,1,1453726800,1453727040,1,1,240
42320709@N06,2707,11,1453848466,1453849426,2,1,960
42320709@N06,2708,11,1453881766,1453882726,1,1,960
42327762@N03,2709,8,1258165984,1258166824,2,2,840
42327762@N03,2709,13,1258170160,1258171240,3,2,1080
42327762@N03,2710,16,1286247574,1286249674,2,2,2100
42327762@N03,2710,5,1286253206,1286253626,1,2,420
42340071@N05,2711,11,1349662914,1349663874,2,3,960
42340071@N05,2711,8,1349666611,1349667451,2,3,840
42340071@N05,2711,17,1349671128,1349673828,1,3,2700
42354918@N00,2712,2,1431521463,1431521703,1,1,240
42398872@N03,2713,11,1325482024,1325482984,2,2,960
42398872@N03,2713,1,1325502866,1325503106,1,2,240
42399173@N05,2714,15,1345364240,1345365440,1,1,1200
42399173@N05,2715,16,1345871177,1345873277,5,2,2100
42399173@N05,2715,11,1345885894,1345886854,3,2,960
42416044@N04,2716,9,1291941800,1291942700,1,1,900
42486569@N00,2717,16,1299976366,1299978466,2,3,2100
42486569@N00,2717,8,1299978931,1299979771,3,3,840
42486569@N00,2717,16,1299987887,1299989987,5,3,2100
42486569@N00,2718,11,1300046011,1300046971,4,4,960
42486569@N00,2718,8,1300047159,1300047999,25,4,840
42486569@N00,2718,15,1300059914,1300060195,3,4,281
42486569@N00,2718,13,1300060195,1300061275,8,4,1080
42491975@N04,2719,16,1469109601,1469111701,1,1,2100
42493559@N07,2720,11,1282141874,1282142834,1,1,960
42533701@N00,2721,2,1215146000,1215146240,13,2,240
42533701@N00,2721,8,1215155249,1215156089,3,2,840
42533701@N00,2722,11,1221637529,1221638489,1,1,960
42580834@N08,2723,3,1256509456,1256509786,2,12,330
42580834@N08,2723,2,1256511723,1256511963,3,12,240
42580834@N08,2723,12,1256513948,1256514137,3,12,189
42580834@N08,2723,2,1256514137,1256514377,2,12,240
42580834@N08,2723,9,1256515342,1256516242,4,12,900
42580834@N08,2723,16,1256520309,1256522409,2,12,2100
42580834@N08,2723,3,1256522929,1256523259,14,12,330
42580834@N08,2723,4,1256523750,1256523795,3,12,45
42580834@N08,2723,3,1256523795,1256523861,2,12,66
42580834@N08,2723,4,1256523861,1256524221,7,12,360
42580834@N08,2723,8,1256529398,1256530238,4,12,840
42580834@N08,2723,13,1256530494,1256531574,1,12,1080
42580834@N08,2724,3,1256775673,1256776003,7,5,330
42580834@N08,2724,11,1256779113,1256780073,2,5,960
42580834@N08,2724,13,1256794511,1256795591,2,5,1080
42580834@N08,2724,10,1256796642,1256797542,2,5,900
42580834@N08,2724,9,1256802238,1256803138,1,5,900
42580834@N08,2725,7,1350260442,1350261282,3,7,840
42580834@N08,2725,16,1350271270,1350271736,2,7,466
42580834@N08,2725,11,1350271736,1350272696,3,7,960
42580834@N08,2725,17,1350287918,1350288116,2,7,198
42580834@N08,2725,13,1350288116,1350289196,2,7,1080
42580834@N08,2725,6,1350296187,1350296907,3,7,720
42580834@N08,2725,11,1350297624,1350298584,1,7,960
42580834@N08,2726,7,1350528920,1350529760,3,6,840
42580834@N08,2726,4,1350531262,1350531622,2,6,360
42580834@N08,2726,9,1350533403,1350534303,2,6,900
42580834@N08,2726,8,1350535509,1350536349,4,6,840
42580834@N08,2726,16,1350547158,1350547393,2,6,235
42580834@N08,2726,11,1350547393,1350548353,2,6,960
42605688@N02,2727,3,1339148753,1339149083,1,1,330
42688661@N06,2728,11,1442138469,1442139429,2,2,960
42688661@N06,2728,5,1442142790,1442143210,8,2,420
42688661@N06,2729,8,1442194665,1442195505,2,4,840
42688661@N06,2729,13,1442200295,1442201375,2,4,1080
42688661@N06,2729,2,1442220486,1442220726,3,4,240
42688661@N06,2729,4,1442224848,1442225208,1,4,360
42688661@N06,2730,5,1442401374,1442401794,9,1,420
42688661@N06,2731,5,1442488444,1442488864,7,1,420
42695644@N04,2732,4,1261967052,1261967412,3,2,360
42695644@N04,2732,17,1261970571,1261973271,2,2,2700
42695644@N04,2733,2,1262218817,1262219057,2,1,240
42695644@N04,2734,17,1263607850,1263610550,1,1,2700
42695644@N04,2735,17,1263796799,1263799499,1,1,2700
42695644@N04,2736,17,1267865739,1267868439,1,1,2700
42723893@N00,2737,11,1426033826,1426034786,2,1,960
42786185@N06,2738,11,1283041615,1283042575,2,10,960
42786185@N06,2738,14,1283045581,1283046781,7,10,1200
42786185@N06,2738,1,1283053704,1283053944,7,10,240
42786185@N06,2738,5,1283055824,1283056244,4,10,420
42786185@N06,2738,13,1283063733,1283063842,3,10,109
42786185@N06,2738,15,1283063842,1283065042,4,10,1200
42786185@N06,2738,10,1283065414,1283066314,6,10,900
42786185@N06,2738,5,1283067933,1283068070,2,10,137
42786185@N06,2738,8,1283068070,1283068910,13,10,840
42786185@N06,2738,11,1283080852,1283081812,1,10,960
42786185@N06,2739,11,1337037353,1337038313,5,9,960
42786185@N06,2739,2,1337038905,1337039145,4,9,240
42786185@N06,2739,4,1337055696,1337056056,3,9,360
42786185@N06,2739,17,1337058809,1337059252,2,9,443
42786185@N06,2739,15,1337059252,1337059554,2,9,302
42786185@N06,2739,10,1337059554,1337060114,2,9,560
42786185@N06,2739,2,1337060114,1337060354,2,9,240
42786185@N06,2739,8,1337065386,1337066226,2,9,840
42786185@N06,2739,17,1337075104,1337077804,2,9,2700
42786185@N06,2740,2,1367129193,1367129433,1,1,240
42786185@N06,2741,11,1367192687,1367193647,2,6,960
42786185@N06,2741,2,1367197012,1367197252,2,6,240
42786185@N06,2741,15,1367197749,1367198616,3,6,867
42786185@N06,2741,17,1367198616,1367198757,2,6,141
42786185@N06,2741,13,1367198757,1367199837,5,6,1080
42786185@N06,2741,10,1367222866,1367223766,3,6,900
42786185@N06,2742,11,1383172220,1383173120,3,10,900
42786185@N06,2742,10,1383173120,1383173462,2,10,342
42786185@N06,2742,15,1383173462,1383173696,2,10,234
42786185@N06,2742,13,1383173696,1383174453,2,10,757
42786185@N06,2742,15,1383174453,1383174626,2,10,173
42786185@N06,2742,10,1383174626,1383175526,5,10,900
42786185@N06,2742,5,1383175954,1383176374,2,10,420
42786185@N06,2742,15,1383182930,1383184130,4,10,1200
42786185@N06,2742,6,1383204009,1383204729,7,10,720
42786185@N06,2742,8,1383210458,1383211298,1,10,840
42786185@N06,2743,13,1399111616,1399112696,1,1,1080
42786185@N06,2744,10,1414799937,1414800764,2,9,827
42786185@N06,2744,15,1414800764,1414801964,2,9,1200
42786185@N06,2744,13,1414802065,1414803145,2,9,1080
42786185@N06,2744,5,1414805449,1414805869,2,9,420
42786185@N06,2744,15,1414808811,1414810011,2,9,1200
42786185@N06,2744,6,1414827930,1414828650,3,9,720
42786185@N06,2744,8,1414831839,1414832679,3,9,840
42786185@N06,2744,11,1414833740,1414834381,2,9,641
42786185@N06,2744,5,1414834381,1414834801,1,9,420
42786185@N06,2745,11,1431734649,1431735609,2,4,960
42786185@N06,2745,10,1431736024,1431736924,2,4,900
42786185@N06,2745,13,1431736977,1431738057,3,4,1080
42786185@N06,2745,6,1431764568,1431765288,5,4,720
42786185@N06,2746,10,1446249933,1446250478,2,3,545
42786185@N06,2746,15,1446250478,1446251678,3,3,1200
42786185@N06,2746,8,1446253242,1446254082,1,3,840
42786185@N06,2747,11,1458341902,1458342862,1,1,960
42815122@N02,2748,16,1347069184,1347071138,2,2,1954
42815122@N02,2748,11,1347071138,1347072098,1,2,960
42848911@N05,2749,11,1297555771,1297556731,2,3,960
42848911@N05,2749,8,1297580919,1297581759,2,3,840
42848911@N05,2749,11,1297591034,1297591994,2,3,960
42848911@N05,2750,11,1298176539,1298177499,1,1,960
42848911@N05,2751,7,1298494852,1298495692,1,1,840
42848911@N05,2752,12,1299150330,1299151350,1,1,1020
42852007@N07,2753,1,1295940640,1295940880,1,1,240
42853203@N00,2754,11,1443437656,1443438616,2,1,960
42863397@N05,2755,11,1358552438,1358553398,2,2,960
42863397@N05,2755,8,1358577111,1358577951,1,2,840
42912463@N02,2756,11,1298696401,1298697361,3,7,960
42912463@N02,2756,7,1298697742,1298698582,2,7,840
42912463@N02,2756,8,1298700656,1298701496,3,7,840
42912463@N02,2756,16,1298703140,1298703739,11,7,599
42912463@N02,2756,17,1298703739,1298703900,2,7,161
42912463@N02,2756,8,1298703900,1298704740,2,7,840
42912463@N02,2756,11,1298706257,1298707217,1,7,960
42912996@N00,2757,11,1379716043,1379717003,3,4,960
42912996@N00,2757,4,1379722959,1379723319,3,4,360
42912996@N00,2757,13,1379736023,1379737103,2,4,1080
42912996@N00,2757,11,1379753553,1379754513,1,4,960
42912996@N00,2758,11,1379825330,1379826290,1,1,960
42912996@N00,2759,13,1380005859,1380006939,2,1,1080
42987207@N03,2760,11,1352635351,1352636311,1,1,960
43074401@N07,2761,4,1386385702,1386386062,1,1,360
43082306@N00,2762,11,1189839671,1189840631,1,1,960
43082306@N00,2763,11,1199090582,1199091164,2,2,582
43082306@N00,2763,16,1199091164,1199093264,1,2,2100
43082306@N00,2764,11,1206082670,1206083630,1,1,960
43082306@N00,2765,10,1224923605,1224924505,1,1,900
43082306@N00,2766,1,1230687336,1230687576,2,1,240
43082306@N00,2767,8,1233988456,1233989296,1,1,840
43082306@N00,2768,3,1234590294,1234590624,2,2,330
43082306@N00,2768,10,1234592389,1234593289,1,2,900
43082306@N00,2769,10,1238815035,1238815935,1,1,900
43082306@N00,2770,8,1241239187,1241240027,2,2,840
43082306@N00,2770,15,1241242414,1241243614,1,2,1200
43082306@N00,2771,11,1249020013,1249020973,3,1,960
43082306@N00,2772,11,1249625424,1249626384,4,1,960
43082306@N00,2773,11,1251611888,1251612848,1,1,960
43082306@N00,2774,16,1254530391,1254532491,2,3,2100
43082306@N00,2774,17,1254544796,1254547496,2,3,2700
43082306@N00,2774,11,1254563779,1254564739,1,3,960
43082306@N00,2775,16,1256346112,1256348212,2,3,2100
43082306@N00,2775,4,1256348518,1256348878,2,3,360
43082306@N00,2775,9,1256360140,1256361040,1,3,900
43082306@N00,2776,11,1256986736,1256987696,1,1,960
43082306@N00,2777,17,1259991217,1259991456,2,2,239
43082306@N00,2777,15,1259991456,1259992656,1,2,1200
43082306@N00,2778,16,1267331230,1267333330,1,1,2100
43082306@N00,2779,2,1267746861,1267747101,1,1,240
43082306@N00,2780,15,1267783477,1267784677,1,1,1200
43082306@N00,2781,10,1267921232,1267922132,1,1,900
43082306@N00,2782,15,1273230562,1273231762,3,1,1200
43082306@N00,2783,11,1276989888,1276990848,1,1,960
43082306@N00,2784,10,1280551930,1280552270,2,2,340
43082306@N00,2784,15,1280552270,1280553470,1,2,1200
43082306@N00,2785,11,1282976853,1282977813,2,2,960
43082306@N00,2785,8,1282985396,1282986236,1,2,840
43082306@N00,2786,9,1283563005,1283563905,1,1,900
43082306@N00,2787,3,1289629519,1289629849,1,1,330
43082306@N00,2788,4,1291340335,1291340695,2,2,360
43082306@N00,2788,15,1291344385,1291345585,1,2,1200
43082306@N00,2789,15,1291631906,1291633106,1,1,1200
43082306@N00,2790,4,1292064364,1292064724,1,1,360
43082306@N00,2791,9,1296363788,1296364688,1,1,900
43082306@N00,2792,11,1298698922,1298699882,2,1,960
43082306@N00,2793,9,1299905107,1299906007,1,1,900
43082306@N00,2794,9,1313748330,1313749230,1,1,900
43082306@N00,2795,8,1314955934,1314956774,1,1,840
43082306@N00,2796,8,1317363599,1317364439,1,1,840
43082306@N00,2797,17,1322289060,1322289312,2,2,252
43082306@N00,2797,15,1322289312,1322290512,1,2,1200
43082306@N00,2798,11,1333097907,1333098867,1,1,960
43082306@N00,2799,16,1333687671,1333689771,1,1,2100
43082306@N00,2800,11,1337242872,1337243832,1,1,960
43082306@N00,2801,13,1343477412,1343478492,1,1,1080
43082306@N00,2802,9,1351326028,1351326928,1,1,900
43082306@N00,2803,11,1356936266,1356937226,1,1,960
43082306@N00,2804,11,1364618440,1364619400,1,1,960
43082306@N00,2805,11,1365226022,1365226982,1,1,960
43082306@N00,2806,8,1377861916,1377862756,1,1,840
43082306@N00,2807,11,1414737562,1414738522,1,1,960
43082306@N00,2808,13,1418988752,1418989832,1,1,1080
43082306@N00,2809,8,1421406041,1421406881,1,1,840
43082306@N00,2810,15,1434124277,1434125477,1,1,1200
43122711@N02,2811,10,1253685219,1253686115,16,3,896
43122711@N02,2811,5,1253686115,1253686484,7,3,369
43122711@N02,2811,8,1253686484,1253687324,4,3,840
43122711@N02,2812,17,1253787992,1253788136,5,5,144
43122711@N02,2812,10,1253788136,1253788549,3,5,413
43122711@N02,2812,5,1253788549,1253788793,4,5,244
43122711@N02,2812,8,1253788793,1253789633,6,5,840
43122711@N02,2812,13,1253789719,1253790799,8,5,1080
43122711@N02,2813,8,1307241318,1307242158,2,2,840
43122711@N02,2813,17,1307257156,1307259856,7,2,2700
43186161@N04,2814,10,1254470777,1254471512,2,2,735
43186161@N04,2814,13,1254471512,1254472592,4,2,1080
43198257@N03,2815,11,1362710033,1362710993,3,1,960
43244835@N00,2816,9,1354234999,1354235899,2,1,900
43245053@N00,2817,11,1332757961,1332757977,2,4,16
43245053@N00,2817,14,1332757977,1332757987,2,4,10
43245053@N00,2817,11,1332757987,1332758031,2,4,44
43245053@N00,2817,5,1332758031,1332758451,1,4,420
43245053@N00,2818,11,1338551840,1338552800,1,1,960
43245053@N00,2819,13,1346851615,1346852695,1,1,1080
43245053@N00,2820,14,1348668295,1348669495,1,1,1200
43287199@N08,2821,13,1269606759,1269607839,1,1,1080
43293904@N00,2822,11,1276009769,1276010729,1,1,960
43297700@N00,2823,11,1321660526,1321661486,1,1,960
43362679@N00,2824,11,1357256890,1357257850,1,1,960
43364045@N04,2825,11,1298109662,1298110622,1,1,960
43365284@N00,2826,11,1246754462,1246755422,115,1,960
43391619@N06,2827,6,1265061172,1265061892,1,1,720
43391619@N06,2828,5,1266204417,1266204837,2,1,420
43391619@N06,2829,11,1271717372,1271718332,1,1,960
43391619@N06,2830,11,1272780580,1272781540,2,1,960
43391619@N06,2831,11,1272848811,1272849771,1,1,960
43391619@N06,2832,11,1273013138,1273014098,1,1,960
43391619@N06,2833,6,1289090585,1289091305,2,1,720
43451359@N00,2834,10,1387692568,1387693468,2,1,900
43511960@N08,2835,5,1334560356,1334560776,1,1,420
43535605@N00,2836,11,1360539703,1360540663,2,2,960
43535605@N00,2836,1,1360557815,1360558055,1,2,240
43549138@N00,2837,8,1257064102,1257064942,1,1,840
43558449@N04,2838,11,1219537835,1219538795,3,2,960
43558449@N04,2838,13,1219559870,1219560950,1,2,1080
43592222@N04,2839,2,1349763381,1349763621,1,1,240
43608757@N08,2840,11,1420283804,1420284764,1,1,960
43612819@N03,2841,8,1256350434,1256351274,1,1,840
43612819@N03,2842,10,1270873805,1270874705,2,2,900
43612819@N03,2842,8,1270884453,1270885293,1,2,840
43612819@N03,2843,1,1282354405,1282354645,1,1,240
43612819@N03,2844,14,1287710221,1287711421,1,1,1200
43612819@N03,2845,5,1325733947,1325734367,1,1,420
43612819@N03,2846,9,1332577989,1332578889,2,2,900
43612819@N03,2846,2,1332581713,1332581953,1,2,240
43612819@N03,2847,9,1335312451,1335313351,2,1,900
43612819@N03,2848,13,1335585316,1335586396,1,1,1080
43636216@N00,2849,14,1228867242,1228868442,2,3,1200
43636216@N00,2849,11,1228868886,1228869846,2,3,960
43636216@N00,2849,6,1228896437,1228897157,1,3,720
43642153@N04,2850,11,1412141850,1412142810,1,1,960
43642153@N04,2851,1,1412384350,1412384590,2,3,240
43642153@N04,2851,15,1412405837,1412407037,2,3,1200
43642153@N04,2851,13,1412407519,1412408599,1,3,1080
43643415@N07,2852,13,1293073858,1293074938,2,1,1080
43652558@N00,2853,8,1463720137,1463720977,2,1,840
43652558@N00,2854,5,1470186561,1470186647,2,3,86
43652558@N00,2854,8,1470186647,1470186761,2,3,114
43652558@N00,2854,5,1470186761,1470187181,6,3,420
43667163@N00,2855,11,1256434221,1256435181,3,4,960
43667163@N00,2855,16,1256446021,1256448121,2,4,2100
43667163@N00,2855,13,1256450715,1256451795,2,4,1080
43667163@N00,2855,14,1256459168,1256460368,1,4,1200
43667163@N00,2856,10,1256807863,1256808763,2,3,900
43667163@N00,2856,1,1256809318,1256809558,2,3,240
43667163@N00,2856,11,1256815921,1256816881,3,3,960
43676934@N06,2857,11,1253359803,1253360763,1,1,960
43681824@N00,2858,16,1212895632,1212897732,7,2,2100
43681824@N00,2858,11,1212907694,1212908654,4,2,960
43681824@N00,2859,8,1213411727,1213411728,2,2,1
43681824@N00,2859,11,1213411728,1213412688,4,2,960
43681824@N00,2860,11,1228461085,1228462045,3,1,960
43700437@N06,2861,11,1362996461,1362996653,2,2,192
43700437@N06,2861,13,1362996653,1362997733,1,2,1080
43700437@N06,2862,13,1363034222,1363035030,6,2,808
43700437@N06,2862,11,1363035030,1363035990,1,2,960
43700437@N06,2863,15,1363083587,1363084787,1,1,1200
43700437@N06,2864,13,1365802979,1365804059,1,1,1080
43700437@N06,2865,1,1374885861,1374886101,1,1,240
43700437@N06,2866,11,1394403132,1394404092,1,1,960
43700437@N06,2867,11,1406796745,1406797705,1,1,960
43700437@N06,2868,11,1420962372,1420963332,2,2,960
43700437@N06,2868,13,1420963724,1420964804,1,2,1080
43700437@N06,2869,5,1438935896,1438936316,2,1,420
43730464@N07,2870,11,1341098884,1341099844,52,1,960
43749215@N03,2871,11,1368326486,1368327446,1,1,960
43808803@N00,2872,11,1461997070,1461997891,2,3,821
43808803@N00,2872,2,1461997891,1461998131,4,3,240
43808803@N00,2872,11,1462010406,1462011366,2,3,960
43808803@N00,2873,11,1462060965,1462061925,2,6,960
43808803@N00,2873,1,1462062535,1462062775,3,6,240
43808803@N00,2873,11,1462063081,1462064041,2,6,960
43808803@N00,2873,16,1462085783,1462086008,2,6,225
43808803@N00,2873,4,1462086008,1462086368,6,6,360
43808803@N00,2873,8,1462094733,1462095573,1,6,840
43808803@N00,2874,16,1462666134,1462668234,2,3,2100
43808803@N00,2874,3,1462691225,1462691555,3,3,330
43808803@N00,2874,4,1462694904,1462695264,3,3,360
43808803@N00,2875,1,1463035305,1463035545,1,1,240
43843206@N06,2876,13,1256114531,1256115611,1,1,1080
43854580@N03,2877,11,1330477258,1330478218,2,1,960
43906182@N04,2878,11,1267913220,1267914180,1,1,960
43906182@N04,2879,15,1268517334,1268518534,1,1,1200
43906182@N04,2880,15,1268604810,1268606010,1,1,1200
43906182@N04,2881,15,1273203915,1273205115,1,1,1200
43906182@N04,2882,13,1273284847,1273285927,1,1,1080
43906182@N04,2883,4,1275099286,1275099646,2,1,360
43906182@N04,2884,4,1275178999,1275179359,1,1,360
43906182@N04,2885,4,1277352859,1277353219,2,1,360
43920951@N08,2886,11,1255766837,1255767797,1,1,960
43920951@N08,2887,13,1265928218,1265929298,1,1,1080
44022769@N00,2888,11,1344732813,1344733175,2,2,362
44022769@N00,2888,5,1344733175,1344733595,1,2,420
44051675@N05,2889,11,1457152830,1457153790,1,1,960
44082489@N00,2890,11,1230505030,1230505990,3,6,960
44082489@N00,2890,13,1230528248,1230528895,5,6,647
44082489@N00,2890,17,1230528895,1230529111,2,6,216
44082489@N00,2890,15,1230529111,1230529405,2,6,294
44082489@N00,2890,17,1230529405,1230532105,4,6,2700
44082489@N00,2890,10,1230537016,1230537916,2,6,900
44082489@N00,2891,1,1230862468,1230862708,2,3,240
44082489@N00,2891,13,1230875854,1230876934,3,3,1080
44082489@N00,2891,17,1230877030,1230879730,3,3,2700
44082489@N00,2892,8,1261099541,1261100381,2,5,840
44082489@N00,2892,6,1261118867,1261119587,3,5,720
44082489@N00,2892,2,1261123223,1261123234,2,5,11
44082489@N00,2892,11,1261123234,1261124194,2,5,960
44082489@N00,2892,12,1261124500,1261125520,3,5,1020
44082489@N00,2893,17,1332721563,1332724263,1,1,2700
44082489@N00,2894,15,1332792644,1332792697,2,5,53
44082489@N00,2894,17,1332792697,1332792965,5,5,268
44082489@N00,2894,10,1332792965,1332793865,3,5,900
44082489@N00,2894,1,1332797346,1332797586,4,5,240
44082489@N00,2894,17,1332798457,1332801157,1,5,2700
44082489@N00,2895,1,1332884482,1332884722,1,1,240
44082489@N00,2896,15,1333077415,1333078615,1,1,1200
44082489@N00,2897,17,1395616532,1395616889,3,5,357
44082489@N00,2897,10,1395616889,1395617789,3,5,900
44082489@N00,2897,6,1395627211,1395627847,2,5,636
44082489@N00,2897,13,1395627847,1395628650,2,5,803
44082489@N00,2897,15,1395628650,1395629850,1,5,1200
44114304@N07,2898,3,1199931337,1199931667,1,1,330
44124305550@N01,2899,11,1189466631,1189467591,2,1,960
44124341154@N01,2900,11,1353557274,1353558234,5,1,960
44124364198@N01,2901,13,1420775060,1420776140,1,1,1080
44124367235@N01,2902,2,1364808202,1364808442,3,1,240
44124372331@N01,2903,4,1217279838,1217280198,2,1,360
44124395373@N01,2904,11,1238116524,1238117484,3,8,960
44124395373@N01,2904,9,1238118784,1238119684,2,8,900
44124395373@N01,2904,16,1238120579,1238120905,2,8,326
44124395373@N01,2904,2,1238120905,1238121145,3,8,240
44124395373@N01,2904,13,1238125161,1238126241,3,8,1080
44124395373@N01,2904,8,1238132187,1238133027,4,8,840
44124395373@N01,2904,5,1238137143,1238137563,5,8,420
44124395373@N01,2904,11,1238143727,1238144687,1,8,960
44124401501@N01,2905,5,1362382499,1362382919,2,1,420
44124401501@N01,2906,14,1383465921,1383467121,1,1,1200
44124401501@N01,2907,11,1394698202,1394699162,1,1,960
44124414397@N01,2908,13,1317960745,1317961825,1,1,1080
44124415797@N01,2909,11,1334718171,1334719131,1,1,960
44124426205@N01,2910,11,1317438131,1317439091,2,2,960
44124426205@N01,2910,17,1317448651,1317451351,1,2,2700
44124426205@N01,2911,6,1352512052,1352512772,1,1,720
44124426205@N01,2912,8,1354670706,1354671546,1,1,840
44124426205@N01,2913,9,1385947851,1385948751,2,1,900
44124426205@N01,2914,8,1411628454,1411629294,1,1,840
44124427374@N01,2915,1,1202259725,1202259965,1,1,240
44124427374@N01,2916,3,1349074674,1349075004,2,3,330
44124427374@N01,2916,12,1349076898,1349077918,2,3,1020
44124427374@N01,2916,11,1349078373,1349079333,2,3,960
44124427374@N01,2917,5,1415341373,1415341793,8,2,420
44124427374@N01,2917,11,1415351778,1415352738,1,2,960
44124427374@N01,2918,10,1415443771,1415444215,2,2,444
44124427374@N01,2918,17,1415444215,1415446915,1,2,2700
44124427374@N01,2919,5,1415499890,1415500310,3,1,420
44124461706@N01,2920,11,1413506444,1413507404,4,1,960
44275181@N00,2921,11,1316753273,1316754233,1,1,960
44275181@N00,2922,1,1354512187,1354512427,1,1,240
44275181@N00,2923,11,1368586527,1368587487,2,4,960
44275181@N00,2923,5,1368587754,1368588174,2,4,420
44275181@N00,2923,9,1368594823,1368595723,2,4,900
44275181@N00,2923,16,1368596147,1368598247,1,4,2100
44275181@N00,2924,17,1368665337,1368665848,2,4,511
44275181@N00,2924,13,1368665848,1368666928,3,4,1080
44275181@N00,2924,5,1368681441,1368681861,2,4,420
44275181@N00,2924,15,1368685894,1368687094,1,4,1200
44275181@N00,2925,3,1451015017,1451015347,1,1,330
44314064@N06,2926,11,1261902881,1261903841,1,1,960
44318907@N08,2927,2,1286186723,1286186963,2,3,240
44318907@N08,2927,11,1286191184,1286192144,4,3,960
44318907@N08,2927,5,1286212852,1286213272,1,3,420
44318907@N08,2928,11,1296856281,1296857241,3,8,960
44318907@N08,2928,6,1296860283,1296860981,2,8,698
44318907@N08,2928,17,1296860981,1296861917,3,8,936
44318907@N08,2928,13,1296861917,1296862997,2,8,1080
44318907@N08,2928,5,1296867647,1296868067,2,8,420
44318907@N08,2928,6,1296886165,1296886822,2,8,657
44318907@N08,2928,8,1296886822,1296887662,2,8,840
44318907@N08,2928,17,1296888244,1296890944,2,8,2700
44318907@N08,2929,15,1306067507,1306068707,2,1,1200
44318907@N08,2930,8,1310942063,1310942903,1,1,840
44318907@N08,2931,10,1317250916,1317251816,3,2,900
44318907@N08,2931,11,1317261698,1317262658,2,2,960
44318907@N08,2932,11,1317374144,1317375104,2,1,960
44318907@N08,2933,8,1329043135,1329043975,1,1,840
44318907@N08,2934,13,1329106700,1329107780,2,7,1080
44318907@N08,2934,8,1329109403,1329110243,5,7,840
44318907@N08,2934,5,1329111857,1329112277,2,7,420
44318907@N08,2934,11,1329112944,1329113904,3,7,960
44318907@N08,2934,13,1329127830,1329128910,4,7,1080
44318907@N08,2934,15,1329129650,1329129956,2,7,306
44318907@N08,2934,17,1329129956,1329132656,1,7,2700
44318907@N08,2935,13,1361703542,1361704593,2,3,1051
44318907@N08,2935,17,1361704593,1361706324,2,3,1731
44318907@N08,2935,11,1361706324,1361707284,1,3,960
44318907@N08,2936,13,1371949237,1371950317,2,2,1080
44318907@N08,2936,8,1371952597,1371953437,1,2,840
44337661@N07,2937,11,1337899749,1337900709,4,3,960
44337661@N07,2937,3,1337906774,1337907104,3,3,330
44337661@N07,2937,2,1337912976,1337913216,3,3,240
44375167@N00,2938,1,1324860210,1324860450,2,3,240
44375167@N00,2938,13,1324861984,1324863064,2,3,1080
44375167@N00,2938,8,1324868176,1324869016,1,3,840
44407852@N06,2939,11,1364805007,1364805967,1,1,960
44412893@N02,2940,5,1360665204,1360665624,2,8,420
44412893@N02,2940,16,1360667982,1360670082,2,8,2100
44412893@N02,2940,1,1360670107,1360670347,4,8,240
44412893@N02,2940,5,1360675935,1360676355,3,8,420
44412893@N02,2940,13,1360684079,1360684109,2,8,30
44412893@N02,2940,15,1360684109,1360684735,2,8,626
44412893@N02,2940,10,1360684735,1360685635,3,8,900
44412893@N02,2940,3,1360688443,1360688773,2,8,330
44432534@N07,2941,8,1298777359,1298778199,1,1,840
44432534@N07,2942,13,1298946703,1298947783,1,1,1080
44452722@N03,2943,3,1376709426,1376709756,2,5,330
44452722@N03,2943,2,1376713380,1376713620,4,5,240
44452722@N03,2943,9,1376713900,1376714800,3,5,900
44452722@N03,2943,8,1376727104,1376727726,3,5,622
44452722@N03,2943,5,1376727726,1376728146,2,5,420
44452722@N03,2944,9,1376789627,1376790527,1,1,900
44458225@N00,2945,11,1451572592,1451573552,1,1,960
44490358@N04,2946,13,1200296761,1200297841,2,1,1080
44490358@N04,2947,8,1218528464,1218529304,6,1,840
44490358@N04,2948,13,1318574857,1318574885,6,3,28
44490358@N04,2948,8,1318574885,1318574904,5,3,19
44490358@N04,2948,13,1318574904,1318575984,1,3,1080
44490358@N04,2949,11,1324277336,1324278296,1,1,960
44510773@N08,2950,11,1313815016,1313815976,1,1,960
44510773@N08,2951,4,1355173008,1355173368,2,2,360
44510773@N08,2951,11,1355182014,1355182974,2,2,960
44510773@N08,2952,8,1355604579,1355605419,2,1,840
44510773@N08,2953,16,1440763839,1440765939,1,1,2100
44536766@N00,2954,5,1267762693,1267763113,1,1,420
44543461@N00,2955,6,1438213337,1438214057,14,1,720
44559103@N02,2956,11,1387419602,1387420562,1,1,960
44599500@N06,2957,11,1284698988,1284699948,2,3,960
44599500@N06,2957,10,1284701561,1284702461,3,3,900
44599500@N06,2957,15,1284709636,1284710836,1,3,1200
44599500@N06,2958,9,1284777477,1284778377,1,1,900
44599500@N06,2959,11,1320460900,1320461860,1,1,960
44599500@N06,2960,14,1320632817,1320634017,1,1,1200
44603553@N03,2961,11,1352355304,1352356264,1,1,960
44606137@N00,2962,9,1414561731,1414562631,1,1,900
44621966@N00,2963,11,1429407350,1429408310,1,1,960
44633742@N02,2964,6,1279451214,1279451934,1,1,720
44756479@N00,2965,17,1197453360,1197456060,1,1,2700
44813763@N07,2966,11,1425451046,1425452006,5,1,960
44816688@N00,2967,2,1430109505,1430109745,4,1,240
44816688@N00,2968,11,1446961960,1446962920,1,1,960
44861310@N03,2969,13,1337429448,1337430528,1,1,1080
44948268@N02,2970,11,1327970425,1327971385,5,1,960
44948268@N02,2971,11,1359085306,1359086266,1,1,960
44948268@N02,2972,11,1398562520,1398563480,1,1,960
44948268@N02,2973,13,1398773243,1398774323,1,1,1080
44948268@N02,2974,8,1399180213,1399181053,1,1,840
44948268@N02,2975,11,1400290564,1400291524,2,1,960
44948268@N02,2976,13,1422960006,1422961086,1,1,1080
44957651@N00,2977,3,1281258284,1281258614,2,2,330
44957651@N00,2977,1,1281265023,1281265263,1,2,240
44957651@N00,2978,11,1281362008,1281362968,1,1,960
44957651@N00,2979,16,1281746376,1281748476,1,1,2100
44957651@N00,2980,4,1320393827,1320394187,2,3,360
44957651@N00,2980,11,1320395698,1320396658,2,3,960
44957651@N00,2980,2,1320404602,1320404842,1,3,240
44957651@N00,2981,13,1320687809,1320688889,2,2,1080
44957651@N00,2981,5,1320692982,1320693402,1,2,420
44978333@N06,2982,6,1293781677,1293782397,1,1,720
45032460@N06,2983,11,1380928716,1380929676,14,3,960
45032460@N06,2983,1,1380930823,1380931063,3,3,240
45032460@N06,2983,16,1380950499,1380952599,2,3,2100
45033503@N06,2984,8,1285567236,1285568076,1,1,840
45033503@N06,2985,11,1285804858,1285805818,1,1,960
45033503@N06,2986,11,1290030296,1290031256,2,1,960
45033503@N06,2987,3,1290164778,1290165108,1,1,330
45033503@N06,2988,11,1290247648,1290248608,1,1,960
45033503@N06,2989,10,1306989110,1306990010,1,1,900
45033503@N06,2990,2,1307159912,1307160152,2,2,240
45033503@N06,2990,11,1307166954,1307167914,1,2,960
45067258@N00,2991,13,1318928502,1318929582,2,4,1080
45067258@N00,2991,17,1318929760,1318930882,2,4,1122
45067258@N00,2991,13,1318930882,1318931105,2,4,223
45067258@N00,2991,17,1318931105,1318933805,1,4,2700
45067258@N00,2992,10,1318983203,1318984103,2,3,900
45067258@N00,2992,6,1318985005,1318985725,2,3,720
45067258@N00,2992,9,1318993873,1318994773,1,3,900
45067258@N00,2993,2,1339505559,1339505799,2,1,240
45067258@N00,2994,17,1339903671,1339906371,1,1,2700
45067258@N00,2995,13,1355490185,1355491265,3,1,1080
45067258@N00,2996,11,1370387176,1370388136,2,4,960
45067258@N00,2996,10,1370389766,1370390666,9,4,900
45067258@N00,2996,13,1370390725,1370391805,8,4,1080
45067258@N00,2996,15,1370407247,1370408447,1,4,1200
45067258@N00,2997,10,1372782232,1372783132,1,1,900
45067258@N00,2998,11,1383724183,1383725143,2,3,960
45067258@N00,2998,5,1383725954,1383726374,3,3,420
45067258@N00,2998,3,1383737100,1383737430,1,3,330
45067258@N00,2999,11,1383783608,1383784568,2,5,960
45067258@N00,2999,10,1383786143,1383786888,6,5,745
45067258@N00,2999,17,1383786888,1383789052,5,5,2164
45067258@N00,2999,5,1383789052,1383789472,12,5,420
45067258@N00,2999,9,1383799314,1383800214,27,5,900
45067258@N00,3000,8,1383887169,1383888009,7,1,840
45067258@N00,3001,5,1391100506,1391100926,1,1,420
45067258@N00,3002,17,1432515170,1432517870,4,6,2700
45067258@N00,3002,15,1432520042,1432520065,2,6,23
45067258@N00,3002,17,1432520065,1432522765,2,6,2700
45067258@N00,3002,6,1432527816,1432528536,7,6,720
45067258@N00,3002,5,1432529858,1432530278,3,6,420
45067258@N00,3002,11,1432532936,1432533896,1,6,960
45072542@N00,3003,11,1317286343,1317287303,3,4,960
45072542@N00,3003,17,1317288495,1317288759,7,4,264
45072542@N00,3003,10,1317288759,1317289659,22,4,900
45072542@N00,3003,2,1317294986,1317295226,5,4,240
45072542@N00,3004,6,1317442498,1317443218,13,2,720
45072542@N00,3004,4,1317446769,1317447129,4,2,360
45083310@N06,3005,10,1353818967,1353819220,2,4,253
45083310@N06,3005,15,1353819220,1353819224,2,4,4
45083310@N06,3005,10,1353819224,1353819272,2,4,48
45083310@N06,3005,15,1353819272,1353820472,6,4,1200
45083310@N06,3006,15,1357893977,1357895177,2,1,1200
45083310@N06,3007,1,1369604921,1369605041,2,2,120
45083310@N06,3007,11,1369605041,1369606001,2,2,960
45130440@N03,3008,15,1368076151,1368077351,1,1,1200
45217757@N03,3009,8,1330315344,1330316184,3,1,840
45226076@N07,3010,16,1261214063,1261216163,3,1,2100
45226076@N07,3011,16,1339132674,1339134774,1,1,2100
45226076@N07,3012,16,1341987918,1341990018,1,1,2100
45228416@N03,3013,11,1298288374,1298289334,3,1,960
45228416@N03,3014,11,1299124479,1299125439,1,1,960
45444404@N04,3015,2,1425279218,1425279458,5,1,240
45444404@N04,3016,10,1425447655,1425448555,4,1,900
45463314@N06,3017,11,1369535058,1369536018,2,1,960
45463314@N06,3018,11,1370085162,1370086122,1,1,960
45491779@N04,3019,9,1397520442,1397521342,2,2,900
45491779@N04,3019,17,1397527645,1397530345,2,2,2700
45491779@N04,3020,17,1397599572,1397602272,1,1,2700
45491779@N04,3021,17,1397629834,1397632534,1,1,2700
45491779@N04,3022,2,1397691203,1397691443,2,2,240
45491779@N04,3022,11,1397713258,1397714218,1,2,960
45561435@N00,3023,17,1295148436,1295151136,3,4,2700
45561435@N00,3023,2,1295154205,1295154445,2,4,240
45561435@N00,3023,13,1295162433,1295163513,2,4,1080
45561435@N00,3023,8,1295164986,1295165826,1,4,840
45561435@N00,3024,11,1426473120,1426474080,3,3,960
45561435@N00,3024,17,1426480748,1426480889,2,3,141
45561435@N00,3024,13,1426480889,1426481969,6,3,1080
45561435@N00,3025,11,1426743379,1426743992,2,5,613
45561435@N00,3025,1,1426743992,1426744232,4,5,240
45561435@N00,3025,8,1426748915,1426749755,3,5,840
45561435@N00,3025,10,1426751480,1426752380,2,5,900
45561435@N00,3025,11,1426753116,1426754076,4,5,960
45571875@N06,3026,11,1267071374,1267072334,3,1,960
45571875@N06,3027,11,1279253770,1279254730,1,1,960
45571875@N06,3028,11,1280492276,1280493236,3,1,960
45571875@N06,3029,11,1282283399,1282284301,3,3,902
45571875@N06,3029,2,1282284301,1282284541,4,3,240
45571875@N06,3029,11,1282299058,1282300018,2,3,960
45571875@N06,3030,1,1332917681,1332917921,1,1,240
45571875@N06,3031,11,1337224644,1337225604,3,3,960
45571875@N06,3031,16,1337227016,1337229116,2,3,2100
45571875@N06,3031,9,1337230109,1337231009,2,3,900
45571875@N06,3032,6,1348914818,1348915538,1,1,720
45571875@N06,3033,15,1360043234,1360044434,1,1,1200
45571875@N06,3034,1,1362564231,1362564471,1,1,240
45571875@N06,3035,2,1364551488,1364551728,2,3,240
45571875@N06,3035,12,1364551823,1364552843,2,3,1020
45571875@N06,3035,11,1364556950,1364557910,1,3,960
45571875@N06,3036,8,1365242800,1365243640,1,1,840
45571875@N06,3037,6,1383033830,1383034550,3,1,720
45571875@N06,3038,11,1399527786,1399528746,1,1,960
45571875@N06,3039,6,1412674426,1412675146,2,2,720
45571875@N06,3039,11,1412680832,1412681792,2,2,960
45571875@N06,3040,6,1413968548,1413969268,2,1,720
45571875@N06,3041,11,1425528368,1425529328,1,1,960
45583433@N00,3042,8,1287366942,1287367782,2,4,840
45583433@N00,3042,13,1287372678,1287372725,2,4,47
45583433@N00,3042,15,1287372725,1287373925,2,4,1200
45583433@N00,3042,4,1287375944,1287376304,2,4,360
45614589@N02,3043,11,1226457908,1226458868,11,1,960
45614589@N02,3044,11,1289611072,1289612032,4,1,960
45614589@N02,3045,11,1320556058,1320557018,1,1,960
45614589@N02,3046,11,1320802992,1320803952,2,1,960
45629924@N03,3047,11,1277177520,1277178480,2,2,960
45629924@N03,3047,9,1277180619,1277181519,4,2,900
45652530@N08,3048,15,1266037423,1266037696,2,6,273
45652530@N08,3048,17,1266037696,1266038986,2,6,1290
45652530@N08,3048,4,1266038986,1266039346,3,6,360
45652530@N08,3048,11,1266042349,1266043309,6,6,960
45652530@N08,3048,1,1266044933,1266045173,9,6,240
45652530@N08,3048,5,1266045409,1266045829,11,6,420
45676151@N08,3049,11,1225695521,1225696481,1,1,960
45681479@N04,3050,11,1298665176,1298665461,4,12,285
45681479@N04,3050,1,1298665461,1298665579,3,12,118
45681479@N04,3050,9,1298665579,1298666479,8,12,900
45681479@N04,3050,1,1298666855,1298666901,2,12,46
45681479@N04,3050,5,1298666901,1298667321,5,12,420
45681479@N04,3050,8,1298667334,1298668174,5,12,840
45681479@N04,3050,13,1298668714,1298668957,7,12,243
45681479@N04,3050,17,1298668957,1298669038,3,12,81
45681479@N04,3050,15,1298669038,1298669141,3,12,103
45681479@N04,3050,17,1298669141,1298669191,2,12,50
45681479@N04,3050,10,1298669191,1298669644,3,12,453
45681479@N04,3050,4,1298669644,1298670004,4,12,360
45716980@N00,3051,11,1327265946,1327266072,2,13,126
45716980@N00,3051,2,1327266072,1327266312,2,13,240
45716980@N00,3051,11,1327270144,1327271104,3,13,960
45716980@N00,3051,2,1327272683,1327272923,2,13,240
45716980@N00,3051,11,1327273172,1327273330,2,13,158
45716980@N00,3051,2,1327273330,1327273570,2,13,240
45716980@N00,3051,17,1327279441,1327282141,15,13,2700
45716980@N00,3051,11,1327287197,1327288157,5,13,960
45716980@N00,3051,17,1327292617,1327295317,2,13,2700
45716980@N00,3051,11,1327297494,1327298454,2,13,960
45716980@N00,3051,10,1327301021,1327301921,4,13,900
45716980@N00,3051,3,1327304747,1327304754,2,13,7
45716980@N00,3051,11,1327304754,1327305714,6,13,960
45716980@N00,3052,8,1327531081,1327531921,4,5,840
45716980@N00,3052,9,1327534328,1327535228,2,5,900
45716980@N00,3052,8,1327539658,1327540498,3,5,840
45716980@N00,3052,13,1327545835,1327546915,5,5,1080
45716980@N00,3052,10,1327547401,1327548301,11,5,900
45716980@N00,3053,10,1327601114,1327602014,4,1,900
45716980@N00,3054,11,1361911219,1361912179,10,19,960
45716980@N00,3054,1,1361921026,1361921261,3,19,235
45716980@N00,3054,9,1361921261,1361921268,2,19,7
45716980@N00,3054,1,1361921268,1361921273,2,19,5
45716980@N00,3054,9,1361921273,1361921618,12,19,345
45716980@N00,3054,1,1361921618,1361921858,8,19,240
45716980@N00,3054,5,1361923156,1361923576,5,19,420
45716980@N00,3054,10,1361923613,1361923675,2,19,62
45716980@N00,3054,17,1361923675,1361924120,25,19,445
45716980@N00,3054,13,1361924120,1361925200,15,19,1080
45716980@N00,3054,6,1361926880,1361927600,2,19,720
45716980@N00,3054,11,1361928439,1361929399,2,19,960
45716980@N00,3054,8,1361929672,1361930512,7,19,840
45716980@N00,3054,5,1361931664,1361932084,2,19,420
45716980@N00,3054,11,1361933063,1361934023,4,19,960
45716980@N00,3054,10,1361945851,1361946751,14,19,900
45716980@N00,3054,17,1361947029,1361949729,3,19,2700
45716980@N00,3054,15,1361951959,1361952363,2,19,404
45716980@N00,3054,11,1361952363,1361953323,3,19,960
45716980@N00,3055,11,1362036164,1362037124,3,2,960
45716980@N00,3055,7,1362037243,1362038083,2,2,840
45716980@N00,3056,11,1362190825,1362191785,1,1,960
45749280@N00,3057,11,1303976185,1303976808,2,4,623
45749280@N00,3057,9,1303976808,1303977708,3,4,900
45749280@N00,3057,16,1303978327,1303980427,3,4,2100
45749280@N00,3057,11,1303992686,1303993646,1,4,960
45749280@N00,3058,11,1304061757,1304062717,4,3,960
45749280@N00,3058,8,1304064436,1304065276,3,3,840
45749280@N00,3058,11,1304073163,1304074123,2,3,960
45749280@N00,3059,11,1413514937,1413515897,3,4,960
45749280@N00,3059,8,1413526219,1413527059,2,4,840
45749280@N00,3059,12,1413547797,1413548817,4,4,1020
45749280@N00,3059,11,1413563512,1413564472,1,4,960
45756179@N03,3060,8,1315893369,1315894209,2,3,840
45756179@N03,3060,11,1315910473,1315911433,2,3,960
45756179@N03,3060,5,1315930852,1315931272,1,3,420
45769608@N00,3061,11,1194162952,1194163912,1,1,960
45842774@N00,3062,8,1190610955,1190611795,1,1,840
45842774@N00,3063,8,1237942291,1237943131,2,1,840
45842774@N00,3064,5,1249457526,1249457946,1,1,420
45842803@N00,3065,4,1254613542,1254613902,8,3,360
45842803@N00,3065,2,1254613934,1254614174,7,3,240
45842803@N00,3065,12,1254630505,1254631525,3,3,1020
45898619@N08,3066,17,1423291739,1423294439,1,1,2700
45906008@N00,3067,16,1340492914,1340495014,10,1,2100
45959609@N00,3068,5,1369616540,1369616960,1,1,420
45959609@N00,3069,4,1463179739,1463180099,1,1,360
46009332@N07,3070,11,1263570034,1263570994,1,1,960
46023761@N08,3071,17,1307791440,1307794140,9,1,2700
46023761@N08,3072,17,1307962550,1307965250,127,1,2700
46023761@N08,3073,17,1308199681,1308202381,12,1,2700
46023761@N08,3074,17,1308365500,1308366863,9,5,1363
46023761@N08,3074,14,1308366863,1308368063,18,5,1200
46023761@N08,3074,11,1308368622,1308369171,2,5,549
46023761@N08,3074,17,1308369171,1308371871,3,5,2700
46023761@N08,3074,15,1308387848,1308389048,1,5,1200
46027550@N00,3075,11,1236821967,1236822927,2,6,960
46027550@N00,3075,7,1236826110,1236826950,2,6,840
46027550@N00,3075,3,1236827867,1236828197,2,6,330
46027550@N00,3075,16,1236829976,1236832076,2,6,2100
46027550@N00,3075,11,1236842461,1236843421,2,6,960
46027550@N00,3075,1,1236847390,1236847630,1,6,240
46050386@N03,3076,11,1242716462,1242717422,8,2,960
46050386@N03,3076,8,1242723276,1242724116,6,2,840
46050386@N03,3077,14,1242797229,1242798006,2,5,777
46050386@N03,3077,2,1242798006,1242798246,4,5,240
46050386@N03,3077,12,1242798970,1242799990,5,5,1020
46050386@N03,3077,2,1242800436,1242800676,3,5,240
46050386@N03,3077,9,1242801031,1242801931,2,5,900
46050386@N03,3078,13,1242870076,1242871156,2,6,1080
46050386@N03,3078,1,1242872821,1242873061,2,6,240
46050386@N03,3078,9,1242873730,1242873823,2,6,93
46050386@N03,3078,1,1242873823,1242874063,3,6,240
46050386@N03,3078,16,1242874278,1242874974,2,6,696
46050386@N03,3078,11,1242874974,1242875934,1,6,960
46072084@N07,3079,12,1341466701,1341467721,2,2,1020
46072084@N07,3079,8,1341479861,1341480701,1,2,840
46097191@N00,3080,8,1197273760,1197274600,2,1,840
46097191@N00,3081,10,1197331964,1197332864,2,5,900
46097191@N00,3081,8,1197337931,1197338771,4,5,840
46097191@N00,3081,13,1197349437,1197350517,3,5,1080
46097191@N00,3081,15,1197358681,1197359881,6,5,1200
46097191@N00,3081,6,1197364480,1197365200,8,5,720
46108419@N00,3082,11,1362358368,1362359328,3,8,960
46108419@N00,3082,5,1362359360,1362359780,5,8,420
46108419@N00,3082,8,1362362065,1362362905,6,8,840
46108419@N00,3082,6,1362378864,1362379584,2,8,720
46108419@N00,3082,13,1362379730,1362380810,7,8,1080
46108419@N00,3082,17,1362383058,1362385758,3,8,2700
46108419@N00,3082,10,1362385876,1362386776,9,8,900
46108419@N00,3082,11,1362391758,1362392718,2,8,960
46108419@N00,3083,13,1363255236,1363256316,1,1,1080
46109335@N06,3084,11,1318512917,1318513877,1,1,960
46115074@N04,3085,11,1349070908,1349071868,1,1,960
46115074@N04,3086,11,1393976702,1393977662,1,1,960
46115074@N04,3087,11,1394251973,1394252933,1,1,960
46115074@N04,3088,11,1457042862,1457043822,1,1,960
46117104@N06,3089,5,1327387316,1327387736,3,3,420
46117104@N06,3089,13,1327387813,1327388893,2,3,1080
46117104@N06,3089,11,1327394662,1327395622,2,3,960
46117613@N08,3090,5,1320890613,1320891033,1,1,420
46117613@N08,3091,8,1321160934,1321161774,1,1,840
46144142@N08,3092,8,1189597162,1189598002,1,1,840
46193283@N00,3093,1,1234564277,1234564517,2,3,240
46193283@N00,3093,11,1234576532,1234577492,2,3,960
46193283@N00,3093,8,1234583284,1234584124,1,3,840
46216518@N05,3094,10,1240391030,1240391930,1,1,900
46229761@N02,3095,11,1307452561,1307453521,2,2,960
46229761@N02,3095,8,1307479432,1307480272,1,2,840
46272979@N08,3096,5,1292898359,1292898779,5,1,420
46296638@N04,3097,7,1256733536,1256734376,2,2,840
46296638@N04,3097,14,1256739466,1256740666,6,2,1200
46304772@N02,3098,11,1375005940,1375006900,1,1,960
46328592@N00,3099,3,1268036433,1268036763,8,1,330
46339232@N07,3100,11,1396941815,1396942583,2,2,768
46339232@N07,3100,16,1396942583,1396944683,1,2,2100
46339232@N07,3101,11,1396972431,1396973391,1,1,960
46364076@N02,3102,6,1204211619,1204212339,12,1,720
46364076@N02,3103,6,1204501875,1204502595,31,1,720
46364076@N02,3104,6,1258745782,1258746502,3,1,720
46401409@N00,3105,2,1467245190,1467245430,2,1,240
46401409@N00,3106,11,1467289562,1467290522,1,1,960
46401409@N00,3107,11,1467459150,1467460110,1,1,960
46418486@N04,3108,11,1425981829,1425982789,2,1,960
46453719@N00,3109,5,1205981233,1205981653,2,4,420
46453719@N00,3109,8,1205985697,1205986537,2,4,840
46453719@N00,3109,13,1205996377,1205997457,3,4,1080
46453719@N00,3109,10,1205999724,1206000624,1,4,900
46514221@N03,3110,3,1393035521,1393035851,3,2,330
46514221@N03,3110,6,1393048880,1393049600,1,2,720
46602694@N00,3111,11,1354939248,1354940208,1,1,960
46602694@N00,3112,13,1355200261,1355201341,1,1,1080
46602694@N00,3113,7,1355298700,1355299540,1,1,840
46602694@N00,3114,11,1358063523,1358064483,2,1,960
46602694@N00,3115,11,1372414535,1372415495,1,1,960
46602694@N00,3116,17,1389177329,1389180029,1,1,2700
46602694@N00,3117,15,1415253691,1415254891,1,1,1200
46621193@N08,3118,11,1302388695,1302389655,2,2,960
46621193@N08,3118,13,1302402641,1302403721,6,2,1080
46671006@N00,3119,11,1253404520,1253404570,3,4,50
46671006@N00,3119,4,1253404570,1253404578,2,4,8
46671006@N00,3119,7,1253404578,1253404639,2,4,61
46671006@N00,3119,11,1253404639,1253405599,1,4,960
46724048@N00,3120,4,1295685247,1295685607,2,3,360
46724048@N00,3120,6,1295691090,1295691810,5,3,720
46724048@N00,3120,11,1295692374,1295693334,1,3,960
46775639@N00,3121,11,1192605559,1192606519,4,1,960
46837385@N03,3122,11,1354316384,1354317344,1,1,960
46859740@N03,3123,11,1404038579,1404039539,1,1,960
46859740@N03,3124,11,1412069241,1412070201,1,1,960
46866350@N00,3125,11,1293861777,1293862737,2,1,960
46866350@N00,3126,5,1294036440,1294036860,2,3,420
46866350@N00,3126,15,1294049757,1294050957,2,3,1200
46866350@N00,3126,11,1294051541,1294052501,1,3,960
46914481@N07,3127,13,1420802692,1420803772,1,1,1080
47064447@N00,3128,9,1351419769,1351420669,1,1,900
47087576@N00,3129,10,1213165251,1213166151,3,1,900
47125846@N08,3130,8,1232781679,1232782519,1,1,840
47125846@N08,3131,11,1242456785,1242457745,1,1,960
47125846@N08,3132,11,1266226449,1266227409,1,1,960
47125846@N08,3133,4,1272765678,1272766038,2,4,360
47125846@N08,3133,5,1272774555,1272774975,3,4,420
47125846@N08,3133,13,1272784978,1272786058,2,4,1080
47125846@N08,3133,11,1272799826,1272800786,1,4,960
47125846@N08,3134,11,1286438362,1286439322,2,5,960
47125846@N08,3134,4,1286439550,1286439910,2,5,360
47125846@N08,3134,10,1286441143,1286442043,3,5,900
47125846@N08,3134,17,1286445749,1286448449,4,5,2700
47125846@N08,3134,15,1286448742,1286449942,1,5,1200
47125846@N08,3135,8,1288771702,1288772542,8,1,840
47125846@N08,3136,8,1289556190,1289557030,7,2,840
47125846@N08,3136,4,1289560211,1289560571,2,2,360
47125846@N08,3137,8,1291251358,1291252198,1,1,840
47125846@N08,3138,3,1291854583,1291854913,1,1,330
47125846@N08,3139,8,1291894370,1291895210,3,1,840
47125846@N08,3140,9,1295166414,1295167314,3,1,900
47125846@N08,3141,2,1296285328,1296285568,1,1,240
47125846@N08,3142,10,1299062558,1299063458,2,2,900
47125846@N08,3142,11,1299063887,1299064847,2,2,960
47125846@N08,3143,15,1299114311,1299115159,4,8,848
47125846@N08,3143,13,1299115159,1299116239,2,8,1080
47125846@N08,3143,9,1299124952,1299125852,2,8,900
47125846@N08,3143,2,1299127882,1299128122,2,8,240
47125846@N08,3143,4,1299130768,1299131128,3,8,360
47125846@N08,3143,1,1299132882,1299133122,4,8,240
47125846@N08,3143,16,1299134490,1299136116,2,8,1626
47125846@N08,3143,11,1299136116,1299137076,1,8,960
47125846@N08,3144,11,1299898662,1299899622,2,3,960
47125846@N08,3144,1,1299924727,1299924967,2,3,240
47125846@N08,3144,11,1299925968,1299926928,1,3,960
47125846@N08,3145,11,1301037013,1301037973,2,2,960
47125846@N08,3145,10,1301040491,1301041391,1,2,900
47125846@N08,3146,10,1302527515,1302528415,1,1,900
47125846@N08,3147,11,1302768558,1302769518,4,3,960
47125846@N08,3147,5,1302773604,1302774024,3,3,420
47125846@N08,3147,11,1302780864,1302781824,2,3,960
47125846@N08,3148,17,1304075242,1304077942,3,2,2700
47125846@N08,3148,11,1304083148,1304084108,1,2,960
47125846@N08,3149,3,1305791564,1305791705,2,4,141
47125846@N08,3149,14,1305791705,1305792905,2,4,1200
47125846@N08,3149,8,1305794642,1305795482,4,4,840
47125846@N08,3149,15,1305801675,1305802875,1,4,1200
47125846@N08,3150,11,1306658100,1306658797,2,3,697
47125846@N08,3150,9,1306658797,1306659697,3,3,900
47125846@N08,3150,8,1306663707,1306664547,3,3,840
47125846@N08,3151,11,1307002602,1307003562,3,2,960
47125846@N08,3151,13,1307009483,1307010563,1,2,1080
47125846@N08,3152,5,1309427775,1309428195,3,1,420
47125846@N08,3153,3,1309768570,1309768900,1,1,330
47125846@N08,3154,1,1310292073,1310292313,3,1,240
47125846@N08,3155,11,1311487421,1311488381,4,3,960
47125846@N08,3155,2,1311498351,1311498591,2,3,240
47125846@N08,3155,11,1311499254,1311500214,3,3,960
47125846@N08,3156,13,1314357488,1314358568,1,1,1080
47125846@N08,3157,11,1314954427,1314955387,2,3,960
47125846@N08,3157,8,1314955900,1314956740,2,3,840
47125846@N08,3157,15,1314967934,1314969134,1,3,1200
47125846@N08,3158,11,1317201038,1317201998,2,2,960
47125846@N08,3158,15,1317203249,1317204449,1,2,1200
47125846@N08,3159,5,1319101891,1319102311,2,2,420
47125846@N08,3159,13,1319109333,1319110413,1,2,1080
47125846@N08,3160,1,1321166861,1321167101,2,2,240
47125846@N08,3160,16,1321174930,1321177030,1,2,2100
47125846@N08,3161,8,1323515304,1323516144,4,2,840
47125846@N08,3161,11,1323518243,1323519203,1,2,960
47125846@N08,3162,15,1323945914,1323947114,4,1,1200
47125846@N08,3163,4,1325061347,1325061707,1,1,360
47125846@N08,3164,13,1327564804,1327565884,2,2,1080
47125846@N08,3164,4,1327566974,1327567334,1,2,360
47125846@N08,3165,11,1331958900,1331959860,4,3,960
47125846@N08,3165,10,1331962677,1331963167,2,3,490
47125846@N08,3165,5,1331963167,1331963587,3,3,420
47125846@N08,3166,15,1332494360,1332495560,3,2,1200
47125846@N08,3166,13,1332501550,1332502630,1,2,1080
47125846@N08,3167,11,1333095767,1333096727,1,1,960
47125846@N08,3168,8,1335085847,1335086687,2,1,840
47125846@N08,3169,5,1341399411,1341399831,2,1,420
47125846@N08,3170,8,1342864168,1342865008,1,1,840
47125846@N08,3171,11,1345269198,1345270158,2,3,960
47125846@N08,3171,9,1345272581,1345273481,3,3,900
47125846@N08,3171,4,1345282276,1345282636,2,3,360
47125846@N08,3172,8,1345895137,1345895977,1,1,840
47125846@N08,3173,4,1348397300,1348397660,2,1,360
47125846@N08,3174,11,1348819675,1348820635,2,3,960
47125846@N08,3174,10,1348824351,1348825251,2,3,900
47125846@N08,3174,9,1348826795,1348827695,1,3,900
47125846@N08,3175,11,1351920525,1351921485,5,1,960
47125846@N08,3176,11,1354092486,1354093446,1,1,960
47125846@N08,3177,1,1354871497,1354871737,2,1,240
47125846@N08,3178,9,1356603231,1356604131,1,1,900
47125846@N08,3179,11,1356936639,1356937599,1,1,960
47125846@N08,3180,13,1357986610,1357987690,1,1,1080
47125846@N08,3181,8,1360321832,1360322672,2,2,840
47125846@N08,3181,11,1360325199,1360326159,1,2,960
47125846@N08,3182,5,1362902887,1362903307,1,1,420
47125846@N08,3183,12,1364027175,1364028094,2,2,919
47125846@N08,3183,2,1364028094,1364028334,1,2,240
47125846@N08,3184,17,1371986021,1371988721,1,1,2700
47125846@N08,3185,8,1374916467,1374917307,1,1,840
47125846@N08,3186,10,1377344390,1377345290,3,2,900
47125846@N08,3186,11,1377347137,1377348097,1,2,960
47125846@N08,3187,8,1377861180,1377862020,1,1,840
47125846@N08,3188,5,1379761970,1379762390,2,2,420
47125846@N08,3188,15,1379763359,1379764559,1,2,1200
47125846@N08,3189,2,1380353274,1380353514,3,2,240
47125846@N08,3189,16,1380361971,1380364071,1,2,2100
47125846@N08,3190,17,1382523100,1382525800,1,1,2700
47125846@N08,3191,5,1384595020,1384595440,2,1,420
47125846@N08,3192,4,1390546493,1390546853,2,2,360
47125846@N08,3192,1,1390560970,1390561210,1,2,240
47125846@N08,3193,1,1394258386,1394258626,1,1,240
47125846@N08,3194,9,1397375230,1397376130,1,1,900
47136771@N03,3195,13,1347185037,1347186117,1,1,1080
47223527@N05,3196,2,1412238854,1412239094,2,2,240
47223527@N05,3196,11,1412244988,1412245948,2,2,960
47266119@N00,3197,11,1413188228,1413189188,1,1,960
47343648@N04,3198,13,1271128422,1271129502,1,1,1080
47363316@N08,3199,11,1361550278,1361551238,3,1,960
47363316@N08,3200,11,1361673446,1361674406,1,1,960
47423151@N06,3201,5,1317988677,1317989097,1,1,420
47423151@N06,3202,11,1318150313,1318151273,2,2,960
47423151@N06,3202,5,1318169620,1318170040,1,2,420
47423151@N06,3203,11,1368620029,1368620989,1,1,960
47423151@N06,3204,11,1389395066,1389396026,1,1,960
47423151@N06,3205,3,1399595671,1399596001,1,1,330
47423151@N06,3206,11,1415686209,1415687169,1,1,960
47473683@N06,3207,15,1265774561,1265775761,1,1,1200
47473683@N06,3208,6,1266142088,1266142808,3,1,720
47567986@N00,3209,3,1303436117,1303436447,4,3,330
47567986@N00,3209,8,1303446431,1303447271,3,3,840
47567986@N00,3209,13,1303456234,1303457314,1,3,1080
47573122@N05,3210,11,1289601193,1289602153,23,17,960
47573122@N05,3210,2,1289603265,1289603505,28,17,240
47573122@N05,3210,7,1289605193,1289606033,10,17,840
47573122@N05,3210,14,1289606966,1289607094,2,17,128
47573122@N05,3210,3,1289607094,1289607424,6,17,330
47573122@N05,3210,5,1289608671,1289609091,22,17,420
47573122@N05,3210,8,1289610330,1289611170,42,17,840
47573122@N05,3210,7,1289622201,1289623041,12,17,840
47573122@N05,3210,4,1289624433,1289624793,18,17,360
47573122@N05,3210,16,1289628166,1289628176,2,17,10
47573122@N05,3210,9,1289628176,1289629076,25,17,900
47573122@N05,3210,1,1289629959,1289630199,4,17,240
47573122@N05,3210,13,1289634009,1289635089,47,17,1080
47573122@N05,3210,15,1289636992,1289637078,4,17,86
47573122@N05,3210,17,1289637078,1289637768,23,17,690
47573122@N05,3210,10,1289637768,1289638668,23,17,900
47573122@N05,3210,11,1289643907,1289644867,12,17,960
47580197@N07,3211,14,1279000015,1279001215,126,1,1200
47580197@N07,3212,14,1279139550,1279140750,1,1,1200
47597914@N00,3213,11,1299109075,1299110035,3,2,960
47597914@N00,3213,15,1299123290,1299124490,3,2,1200
47615165@N04,3214,1,1358220885,1358221125,1,1,240
47694179@N06,3215,10,1444092139,1444093039,3,3,900
47694179@N06,3215,15,1444094899,1444096099,4,3,1200
47694179@N06,3215,8,1444101574,1444102414,1,3,840
47705525@N06,3216,11,1307169877,1307169993,2,2,116
47705525@N06,3216,12,1307169993,1307171013,1,2,1020
47705525@N06,3217,2,1308216401,1308216641,1,1,240
47716066@N05,3218,13,1306839544,1306840624,4,1,1080
47716066@N05,3219,13,1306918707,1306919787,1,1,1080
47785122@N06,3220,5,1367722325,1367722745,1,1,420
47785122@N06,3221,11,1379847345,1379848305,1,1,960
47826387@N03,3222,11,1339420244,1339421204,1,1,960
47826387@N03,3223,5,1339678065,1339678485,1,1,420
47861479@N02,3224,11,1355778810,1355779770,1,1,960
47861479@N02,3225,11,1381378526,1381379486,2,3,960
47861479@N02,3225,3,1381390478,1381390808,2,3,330
47861479@N02,3225,11,1381401021,1381401981,2,3,960
47861479@N02,3226,11,1403476819,1403477779,1,1,960
47861479@N02,3227,11,1403776143,1403777103,1,1,960
47861479@N02,3228,11,1418454982,1418455942,1,1,960
47861479@N02,3229,11,1418759603,1418760563,3,1,960
47861479@N02,3230,2,1433117585,1433117825,1,1,240
47943464@N06,3231,11,1318236267,1318237227,1,1,960
47953780@N07,3232,8,1400062039,1400062879,2,1,840
48105777@N00,3233,11,1275286329,1275287289,2,6,960
48105777@N00,3233,15,1275288092,1275288701,5,6,609
48105777@N00,3233,13,1275288701,1275289781,3,6,1080
48105777@N00,3233,8,1275291829,1275292669,2,6,840
48105777@N00,3233,13,1275298956,1275300036,2,6,1080
48105777@N00,3233,11,1275305083,1275306043,1,6,960
48105777@N00,3234,12,1275610026,1275611046,1,1,1020
48257423@N02,3235,3,1300485913,1300486243,1,1,330
48271781@N00,3236,10,1347870648,1347871548,1,1,900
48275668@N02,3237,1,1346973983,1346974223,1,1,240
48275668@N02,3238,16,1347211985,1347214085,2,3,2100
48275668@N02,3238,13,1347219563,1347220643,2,3,1080
48275668@N02,3238,14,1347228076,1347229276,1,3,1200
48275668@N02,3239,17,1348811955,1348813236,2,9,1281
48275668@N02,3239,13,1348813236,1348814316,5,9,1080
48275668@N02,3239,17,1348814402,1348815564,7,9,1162
48275668@N02,3239,8,1348815564,1348815767,3,9,203
48275668@N02,3239,10,1348815767,1348816256,2,9,489
48275668@N02,3239,5,1348816256,1348816676,2,9,420
48275668@N02,3239,8,1348827576,1348827967,4,9,391
48275668@N02,3239,5,1348827967,1348828387,6,9,420
48275668@N02,3239,11,1348828981,1348829941,1,9,960
48275668@N02,3240,13,1350307431,1350308511,2,2,1080
48275668@N02,3240,6,1350309549,1350310269,1,2,720
48275668@N02,3241,4,1350627308,1350627668,2,3,360
48275668@N02,3241,17,1350633978,1350634819,4,3,841
48275668@N02,3241,6,1350634819,1350635539,1,3,720
48275668@N02,3242,5,1357197845,1357198265,1,1,420
48275668@N02,3243,10,1357434061,1357434961,7,2,900
48275668@N02,3243,5,1357438143,1357438563,3,2,420
48275668@N02,3244,6,1359367117,1359367837,8,2,720
48275668@N02,3244,8,1359368797,1359369637,1,2,840
48275668@N02,3245,6,1363338190,1363338910,3,1,720
48275668@N02,3246,6,1363425019,1363425739,2,1,720
48275668@N02,3247,13,1395571528,1395572608,1,1,1080
48275668@N02,3248,5,1395800250,1395800670,1,1,420
48275668@N02,3249,8,1426036233,1426037073,2,3,840
48275668@N02,3249,2,1426044908,1426045148,3,3,240
48275668@N02,3249,11,1426046214,1426047174,2,3,960
48275668@N02,3250,13,1450268086,1450269166,1,1,1080
48275668@N02,3251,16,1457575525,1457577625,1,1,2100
48275668@N02,3252,13,1457663603,1457664683,2,1,1080
48311919@N00,3253,17,1362707734,1362710434,71,1,2700
48311919@N00,3254,11,1412380416,1412381376,5,7,960
48311919@N00,3254,16,1412382150,1412383377,4,7,1227
48311919@N00,3254,9,1412383377,1412384003,6,7,626
48311919@N00,3254,11,1412384003,1412384103,2,7,100
48311919@N00,3254,10,1412384103,1412385003,6,7,900
48311919@N00,3254,5,1412387670,1412388090,12,7,420
48311919@N00,3254,13,1412390365,1412391445,12,7,1080
48311919@N00,3255,11,1418434861,1418435463,5,6,602
48311919@N00,3255,4,1418435463,1418435787,4,6,324
48311919@N00,3255,10,1418435787,1418436687,21,6,900
48311919@N00,3255,5,1418439083,1418439503,4,6,420
48311919@N00,3255,10,1418446976,1418447106,2,6,130
48311919@N00,3255,13,1418447106,1418448186,3,6,1080
48311919@N00,3256,2,1423356996,1423357236,20,2,240
48311919@N00,3256,8,1423360790,1423361630,12,2,840
48311919@N00,3257,11,1426302693,1426303653,3,1,960
48311919@N00,3258,10,1433571679,1433572579,28,4,900
48311919@N00,3258,15,1433574025,1433574036,3,4,11
48311919@N00,3258,10,1433574036,1433574090,2,4,54
48311919@N00,3258,15,1433574090,1433575290,8,4,1200
48311919@N00,3259,15,1443230767,1443231967,326,1,1200
48311919@N00,3260,2,1456102673,1456102913,49,1,240
48311919@N00,3261,5,1468384216,1468384636,15,1,420
48355351@N07,3262,8,1312782416,1312783256,7,2,840
48355351@N07,3262,13,1312803439,1312804519,3,2,1080
48378226@N02,3263,11,1312200473,1312201433,1,1,960
48391953@N02,3264,8,1285837851,1285838256,3,3,405
48391953@N02,3264,5,1285838256,1285838676,2,3,420
48391953@N02,3264,12,1285840590,1285841610,1,3,1020
48391953@N02,3265,4,1286361648,1286362008,2,3,360
48391953@N02,3265,8,1286366928,1286367768,3,3,840
48391953@N02,3265,11,1286375480,1286376440,2,3,960
48427787@N00,3266,11,1320381888,1320382848,2,3,960
48427787@N00,3266,1,1320384070,1320384310,3,3,240
48427787@N00,3266,5,1320394530,1320394950,1,3,420
48427787@N00,3267,17,1320565677,1320568377,3,1,2700
48481127@N08,3268,11,1356710499,1356711459,3,3,960
48481127@N08,3268,17,1356719435,1356722135,2,3,2700
48481127@N08,3268,5,1356725271,1356725691,1,3,420
48494440@N04,3269,11,1222837839,1222838799,1,1,960
48494440@N04,3270,11,1253584422,1253585382,1,1,960
48494440@N04,3271,13,1253714852,1253715932,1,1,1080
48513718@N02,3272,1,1222128003,1222128243,1,1,240
48553408@N00,3273,11,1326428681,1326429641,1,1,960
48566562@N06,3274,11,1391272884,1391273844,1,1,960
48592227@N08,3275,10,1327813022,1327813922,2,1,900
48592227@N08,3276,17,1330138218,1330140918,1,1,2700
48592227@N08,3277,11,1330254395,1330255355,1,1,960
48603464@N05,3278,11,1457659695,1457660655,2,3,960
48603464@N05,3278,17,1457662430,1457664379,2,3,1949
48603464@N05,3278,5,1457664379,1457664799,1,3,420
48623792@N00,3279,14,1369197242,1369198442,11,2,1200
48623792@N00,3279,13,1369199541,1369200621,4,2,1080
48624550@N00,3280,11,1328241245,1328242205,6,5,960
48624550@N00,3280,12,1328242401,1328242965,4,5,564
48624550@N00,3280,2,1328242965,1328243205,10,5,240
48624550@N00,3280,4,1328252184,1328252544,3,5,360
48624550@N00,3280,11,1328256808,1328257768,4,5,960
48658532@N06,3281,12,1311157573,1311158593,8,4,1020
48658532@N06,3281,17,1311159099,1311159427,2,4,328
48658532@N06,3281,15,1311159427,1311160627,2,4,1200
48658532@N06,3281,8,1311162314,1311163154,1,4,840
48658532@N06,3282,4,1320143226,1320143586,1,1,360
48658532@N06,3283,1,1330996702,1330996942,2,1,240
48658532@N06,3284,5,1331083457,1331083877,2,2,420
48658532@N06,3284,11,1331099793,1331100753,1,2,960
48658532@N06,3285,13,1346282178,1346283258,2,2,1080
48658532@N06,3285,15,1346286519,1346287719,1,2,1200
48658532@N06,3286,8,1352592728,1352593568,1,1,840
48658532@N06,3287,5,1362464930,1362465350,2,4,420
48658532@N06,3287,13,1362468061,1362469141,2,4,1080
48658532@N06,3287,8,1362474170,1362475010,2,4,840
48658532@N06,3287,1,1362477080,1362477320,1,4,240
48699368@N08,3288,15,1304408297,1304408621,3,2,324
48699368@N08,3288,17,1304408621,1304411321,2,2,2700
48763139@N00,3289,11,1199744480,1199745440,1,1,960
48763139@N00,3290,15,1231126988,1231128188,2,3,1200
48763139@N00,3290,5,1231137574,1231137599,2,3,25
48763139@N00,3290,10,1231137599,1231138499,1,3,900
48763139@N00,3291,10,1231397085,1231397985,2,2,900
48763139@N00,3291,3,1231406674,1231407004,1,2,330
48763139@N00,3292,3,1231461375,1231461705,2,2,330
48763139@N00,3292,7,1231461898,1231462738,1,2,840
48763139@N00,3293,17,1263193067,1263195767,1,1,2700
48763139@N00,3294,11,1294093849,1294094809,2,2,960
48763139@N00,3294,3,1294117191,1294117521,2,2,330
48763139@N00,3295,16,1294793735,1294795835,1,1,2100
48763139@N00,3296,16,1357172761,1357174861,1,1,2100
48763139@N00,3297,17,1357466938,1357469638,1,1,2700
48816143@N00,3298,6,1198651067,1198651787,1,1,720
48826873@N08,3299,9,1332404074,1332404974,1,1,900
48826873@N08,3300,11,1391931839,1391932799,1,1,960
48826873@N08,3301,11,1432617640,1432618600,1,1,960
48826873@N08,3302,11,1436855450,1436856410,2,2,960
48826873@N08,3302,13,1436862067,1436863147,1,2,1080
48849941@N07,3303,11,1269910606,1269911566,1,1,960
48861861@N08,3304,9,1422923367,1422924267,1,1,900
48861861@N08,3305,2,1423442258,1423442498,1,1,240
48861861@N08,3306,11,1423781671,1423782631,1,1,960
48861861@N08,3307,11,1424244158,1424245118,1,1,960
48861861@N08,3308,1,1427160647,1427160887,1,1,240
48861861@N08,3309,16,1427770392,1427772492,1,1,2100
48861861@N08,3310,14,1429416999,1429418199,1,1,1200
48861861@N08,3311,17,1431329364,1431332064,1,1,2700
48861861@N08,3312,11,1431481880,1431482840,2,2,960
48861861@N08,3312,4,1431485401,1431485761,1,2,360
48861861@N08,3313,11,1432860048,1432861008,1,1,960
48861861@N08,3314,4,1438576220,1438576580,1,1,360
48861861@N08,3315,3,1439003534,1439003864,1,1,330
48861861@N08,3316,3,1445387535,1445387865,1,1,330
48861861@N08,3317,2,1446063890,1446064130,1,1,240
48861861@N08,3318,4,1447998090,1447998450,1,1,360
48861861@N08,3319,5,1448766765,1448767185,1,1,420
48861861@N08,3320,11,1448843799,1448844759,1,1,960
48861861@N08,3321,1,1449821574,1449821814,1,1,240
48861861@N08,3322,9,1451452313,1451453213,1,1,900
48861861@N08,3323,1,1451791159,1451791399,1,1,240
48861861@N08,3324,2,1454355894,1454356134,1,1,240
48861861@N08,3325,1,1454541309,1454541549,1,1,240
48861861@N08,3326,7,1460889752,1460890592,1,1,840
48861861@N08,3327,11,1462348657,1462349617,1,1,960
48861861@N08,3328,16,1463790529,1463792629,1,1,2100
48861861@N08,3329,10,1463978296,1463979196,1,1,900
48861861@N08,3330,13,1464833365,1464834445,1,1,1080
48886342@N00,3331,17,1293795239,1293797939,2,1,2700
48886342@N00,3332,17,1294059773,1294060205,2,2,432
48886342@N00,3332,6,1294060205,1294060925,1,2,720
48886342@N00,3333,13,1295788501,1295789581,1,1,1080
48889042674@N01,3334,11,1222385685,1222386645,1,1,960
48889052497@N01,3335,11,1311816769,1311817729,7,2,960
48889052497@N01,3335,2,1311824021,1311824261,8,2,240
48889071072@N01,3336,11,1305714528,1305715488,1,1,960
48889119704@N01,3337,11,1273382279,1273383239,2,1,960
48889119704@N01,3338,17,1273489250,1273491950,9,1,2700
48891180@N00,3339,11,1229771131,1229772091,2,7,960
48891180@N00,3339,12,1229776047,1229777067,2,7,1020
48891180@N00,3339,17,1229790573,1229793273,2,7,2700
48891180@N00,3339,5,1229794709,1229795129,2,7,420
48891180@N00,3339,8,1229800571,1229801411,6,7,840
48891180@N00,3339,5,1229806619,1229807039,2,7,420
48891180@N00,3339,10,1229813301,1229814201,1,7,900
48938973@N07,3340,11,1379336413,1379337373,1,1,960
48938973@N07,3341,11,1379571120,1379572080,1,1,960
48973233@N05,3342,10,1295927353,1295928253,1,1,900
48980448@N05,3343,2,1263880415,1263880655,2,2,240
48980448@N05,3343,11,1263883615,1263884575,1,2,960
49008511@N04,3344,11,1265210808,1265211768,1,1,960
49014295@N06,3345,9,1396827296,1396828196,2,5,900
49014295@N06,3345,13,1396828831,1396829911,2,5,1080
49014295@N06,3345,9,1396841346,1396842246,2,5,900
49014295@N06,3345,4,1396844692,1396845052,2,5,360
49014295@N06,3345,11,1396859729,1396860689,2,5,960
49029406@N00,3346,11,1361662396,1361663356,1,1,960
49032331@N05,3347,11,1340104033,1340104993,1,1,960
49039096@N04,3348,11,1388433769,1388434729,111,1,960
49052221@N00,3349,5,1366976825,1366977245,2,1,420
49075539@N06,3350,16,1298504594,1298506694,2,7,2100
49075539@N06,3350,9,1298508051,1298508726,2,7,675
49075539@N06,3350,16,1298508726,1298510826,2,7,2100
49075539@N06,3350,7,1298512209,1298512726,2,7,517
49075539@N06,3350,2,1298512726,1298512966,2,7,240
49075539@N06,3350,4,1298513356,1298513716,2,7,360
49075539@N06,3350,8,1298527151,1298527991,1,7,840
49092364@N04,3351,16,1306218863,1306220963,1,1,2100
49098167@N07,3352,11,1455010519,1455011479,1,1,960
49098167@N07,3353,11,1455975806,1455976766,1,1,960
49098167@N07,3354,11,1458726292,1458727252,1,1,960
49098167@N07,3355,11,1462022152,1462023112,1,1,960
49103297@N04,3356,11,1408146116,1408147076,27,5,960
49103297@N04,3356,2,1408149924,1408150164,35,5,240
49103297@N04,3356,1,1408153861,1408154101,7,5,240
49103297@N04,3356,5,1408157560,1408157980,35,5,420
49103297@N04,3356,11,1408188928,1408189888,4,5,960
49109678@N04,3357,11,1251538993,1251539953,1,1,960
49109678@N04,3358,11,1277711835,1277712500,2,4,665
49109678@N04,3358,10,1277712500,1277712767,3,4,267
49109678@N04,3358,13,1277712767,1277713847,2,4,1080
49109678@N04,3358,11,1277726782,1277727742,1,4,960
49109678@N04,3359,3,1309395724,1309396054,2,7,330
49109678@N04,3359,7,1309396520,1309396609,2,7,89
49109678@N04,3359,3,1309396609,1309396736,2,7,127
49109678@N04,3359,4,1309396736,1309397096,4,7,360
49109678@N04,3359,2,1309410435,1309410675,3,7,240
49109678@N04,3359,12,1309411247,1309412267,2,7,1020
49109678@N04,3359,4,1309413565,1309413925,1,7,360
49109678@N04,3360,11,1343864965,1343865925,3,5,960
49109678@N04,3360,9,1343869985,1343870885,2,5,900
49109678@N04,3360,2,1343884221,1343884461,2,5,240
49109678@N04,3360,4,1343885751,1343886111,2,5,360
49109678@N04,3360,16,1343888582,1343890682,2,5,2100
49109678@N04,3361,12,1364957949,1364958685,2,3,736
49109678@N04,3361,2,1364958685,1364958925,2,3,240
49109678@N04,3361,4,1364961730,1364962090,1,3,360
49109678@N04,3362,11,1365028697,1365029657,4,2,960
49109678@N04,3362,16,1365031227,1365033327,1,2,2100
49109678@N04,3363,17,1365066819,1365067928,3,5,1109
49109678@N04,3363,13,1365067928,1365069008,2,5,1080
49109678@N04,3363,1,1365070526,1365070766,2,5,240
49109678@N04,3363,16,1365071081,1365072676,2,5,1595
49109678@N04,3363,11,1365072676,1365073636,1,5,960
49109678@N04,3364,16,1365135797,1365137897,2,2,2100
49109678@N04,3364,10,1365152477,1365153377,1,2,900
49109678@N04,3365,11,1405564313,1405565273,1,1,960
49109678@N04,3366,10,1426899310,1426900210,1,1,900
49150220@N03,3367,4,1342864168,1342864528,1,1,360
49165041@N00,3368,11,1281257663,1281258623,3,15,960
49165041@N00,3368,8,1281278312,1281279152,3,15,840
49165041@N00,3368,13,1281289592,1281290672,2,15,1080
49165041@N00,3368,10,1281292593,1281293493,2,15,900
49165041@N00,3368,11,1281295931,1281296891,11,15,960
49165041@N00,3368,1,1281298004,1281298244,12,15,240
49165041@N00,3368,9,1281301126,1281302026,3,15,900
49165041@N00,3368,16,1281303720,1281305820,4,15,2100
49165041@N00,3368,2,1281307605,1281307845,8,15,240
49165041@N00,3368,14,1281311445,1281312021,3,15,576
49165041@N00,3368,7,1281312021,1281312861,2,15,840
49165041@N00,3368,8,1281317757,1281318597,9,15,840
49165041@N00,3368,13,1281328851,1281329931,3,15,1080
49165041@N00,3368,15,1281330948,1281332046,2,15,1098
49165041@N00,3368,10,1281332046,1281332946,1,15,900
49169223@N00,3369,5,1230987606,1230987617,2,4,11
49169223@N00,3369,8,1230987617,1230987625,7,4,8
49169223@N00,3369,5,1230987625,1230987628,3,4,3
49169223@N00,3369,11,1230987628,1230988588,1,4,960
49169223@N00,3370,13,1231419600,1231419601,2,5,1
49169223@N00,3370,17,1231419601,1231419602,2,5,1
49169223@N00,3370,11,1231419602,1231419603,2,5,1
49169223@N00,3370,10,1231419603,1231419606,4,5,3
49169223@N00,3370,4,1231419606,1231419966,1,5,360
49275237@N00,3371,17,1206596170,1206596500,2,2,330
49275237@N00,3371,15,1206596500,1206597700,2,2,1200
49275237@N00,3372,8,1301465387,1301466227,1,1,840
49275237@N00,3373,10,1301528213,1301529113,1,1,900
49275237@N00,3374,11,1329259787,1329260747,8,10,960
49275237@N00,3374,5,1329263126,1329263546,3,10,420
49275237@N00,3374,13,1329272492,1329273572,8,10,1080
49275237@N00,3374,15,1329274484,1329274694,2,10,210
49275237@N00,3374,17,1329274694,1329277075,5,10,2381
49275237@N00,3374,10,1329277075,1329277975,4,10,900
49275237@N00,3374,14,1329279052,1329280252,21,10,1200
49275237@N00,3374,11,1329290096,1329291056,2,10,960
49275237@N00,3374,13,1329295104,1329295645,5,10,541
49275237@N00,3374,17,1329295645,1329298345,1,10,2700
49275237@N00,3375,11,1329704125,1329705085,6,7,960
49275237@N00,3375,5,1329706519,1329706939,5,7,420
49275237@N00,3375,8,1329709747,1329710587,13,7,840
49275237@N00,3375,13,1329715614,1329716694,12,7,1080
49275237@N00,3375,17,1329717237,1329719092,11,7,1855
49275237@N00,3375,10,1329719092,1329719992,3,7,900
49275237@N00,3375,5,1329722257,1329722677,6,7,420
49299827@N06,3376,11,1467239400,1467240360,2,3,960
49299827@N06,3376,2,1467246333,1467246573,6,3,240
49299827@N06,3376,11,1467249223,1467250183,1,3,960
49305593@N05,3377,11,1389697976,1389698936,2,1,960
49305593@N05,3378,11,1429531745,1429532705,2,1,960
49347514@N04,3379,1,1243040766,1243041006,1,1,240
49355124@N04,3380,2,1357730807,1357731047,1,1,240
49355124@N04,3381,2,1357810559,1357810799,1,1,240
49375330@N02,3382,11,1322758066,1322759026,1,1,960
49395260@N00,3383,11,1333530539,1333531499,1,1,960
49395260@N00,3384,11,1333961910,1333962870,1,1,960
49465515@N00,3385,15,1241323327,1241323487,2,4,160
49465515@N00,3385,10,1241323487,1241324387,5,4,900
49465515@N00,3385,2,1241324691,1241324931,5,4,240
49465515@N00,3385,11,1241325220,1241326180,3,4,960
49465515@N00,3386,10,1241506546,1241507446,2,2,900
49465515@N00,3386,8,1241507806,1241508646,5,2,840
49472870@N04,3387,11,1394520748,1394521708,1,1,960
49473802@N05,3388,5,1457915144,1457915564,1,1,420
49502978053@N01,3389,17,1316067811,1316070511,1,1,2700
49502978053@N01,3390,10,1317467112,1317467194,5,12,82
49502978053@N01,3390,2,1317467194,1317467235,2,12,41
49502978053@N01,3390,17,1317467235,1317467390,3,12,155
49502978053@N01,3390,8,1317467390,1317467443,2,12,53
49502978053@N01,3390,13,1317467443,1317467479,2,12,36
49502978053@N01,3390,15,1317467479,1317468679,4,12,1200
49502978053@N01,3390,17,1317469673,1317470297,9,12,624
49502978053@N01,3390,1,1317470297,1317470537,3,12,240
49502978053@N01,3390,17,1317470722,1317470738,2,12,16
49502978053@N01,3390,1,1317470738,1317470821,5,12,83
49502978053@N01,3390,9,1317470821,1317470849,3,12,28
49502978053@N01,3390,11,1317470849,1317471809,11,12,960
49502987176@N01,3391,12,1275176015,1275177035,2,5,1020
49502987176@N01,3391,4,1275178698,1275179058,2,5,360
49502987176@N01,3391,5,1275183936,1275184356,2,5,420
49502987176@N01,3391,2,1275202759,1275202999,2,5,240
49502987176@N01,3391,1,1275210315,1275210555,2,5,240
49502987176@N01,3392,13,1275546964,1275548044,1,1,1080
49502987176@N01,3393,8,1314350761,1314351601,1,1,840
49503002894@N01,3394,11,1445896472,1445897432,1,1,960
49503033361@N01,3395,12,1285977699,1285978719,1,1,1020
49503033361@N01,3396,2,1431074400,1431074405,6,3,5
49503033361@N01,3396,12,1431074405,1431074406,2,3,1
49503033361@N01,3396,2,1431074406,1431074646,1,3,240
49503053139@N01,3397,7,1381711185,1381712025,1,1,840
49503068447@N01,3398,11,1203926262,1203927222,2,2,960
49503068447@N01,3398,5,1203934843,1203935263,1,2,420
49503068447@N01,3399,5,1204076629,1204077049,2,6,420
49503068447@N01,3399,8,1204079617,1204080457,2,6,840
49503068447@N01,3399,13,1204088951,1204090031,3,6,1080
49503068447@N01,3399,15,1204090433,1204090938,2,6,505
49503068447@N01,3399,10,1204090938,1204091838,2,6,900
49503068447@N01,3399,11,1204092931,1204093891,4,6,960
49503068447@N01,3400,11,1267429622,1267430582,1,1,960
49503114584@N01,3401,11,1218119593,1218120553,3,1,960
49503114584@N01,3402,8,1281081235,1281082075,2,1,840
49503114584@N01,3403,11,1343696094,1343697054,2,3,960
49503114584@N01,3403,5,1343699626,1343700046,2,3,420
49503114584@N01,3403,8,1343702249,1343703089,4,3,840
49503114584@N01,3404,11,1343961779,1343962739,4,2,960
49503114584@N01,3404,10,1343966749,1343967649,1,2,900
49503114584@N01,3405,11,1344309486,1344310446,2,2,960
49503114584@N01,3405,8,1344310668,1344311508,3,2,840
49503114584@N01,3406,11,1344507688,1344508648,1,1,960
49503114584@N01,3407,10,1344823592,1344823696,2,5,104
49503114584@N01,3407,17,1344823696,1344825562,2,5,1866
49503114584@N01,3407,15,1344825562,1344826762,2,5,1200
49503114584@N01,3407,5,1344829965,1344830385,2,5,420
49503114584@N01,3407,11,1344831555,1344832515,3,5,960
49503114584@N01,3408,8,1406518020,1406518860,2,1,840
49503114584@N01,3409,13,1406789601,1406790681,1,1,1080
49503114584@N01,3410,11,1406963406,1406964366,3,2,960
49503114584@N01,3410,14,1406966173,1406967373,2,2,1200
49503114584@N01,3411,10,1407122408,1407123308,1,1,900
49645702@N00,3412,11,1363339491,1363340451,17,1,960
49675952@N07,3413,3,1268469946,1268470276,1,1,330
49675952@N07,3414,17,1304118755,1304121455,2,3,2700
49675952@N07,3414,8,1304127460,1304128300,2,3,840
49675952@N07,3414,11,1304132167,1304133127,1,3,960
49675952@N07,3415,9,1305420264,1305421164,1,1,900
49677598@N00,3416,11,1220929200,1220930160,2,1,960
49677598@N00,3417,9,1221220740,1221221640,2,1,900
49691404@N04,3418,11,1413333457,1413334417,2,2,960
49691404@N04,3418,4,1413353779,1413354139,1,2,360
49692767@N07,3419,11,1451529512,1451530472,1,1,960
49738389@N00,3420,2,1287566746,1287566986,1,1,240
49738389@N00,3421,5,1295784914,1295785334,1,1,420
49786625@N07,3422,5,1416545126,1416545546,2,2,420
49786625@N07,3422,11,1416558872,1416559832,1,2,960
49814544@N00,3423,11,1455758457,1455759417,3,4,960
49814544@N00,3423,17,1455764353,1455765622,3,4,1269
49814544@N00,3423,13,1455765622,1455766702,2,4,1080
49814544@N00,3423,11,1455782029,1455782989,1,4,960
49836029@N06,3424,15,1329042583,1329043783,1,1,1200
49855440@N00,3425,8,1229835931,1229836771,7,3,840
49855440@N00,3425,1,1229839408,1229839648,2,3,240
49855440@N00,3425,4,1229839705,1229840065,1,3,360
49855440@N00,3426,11,1230096251,1230097211,2,2,960
49855440@N00,3426,17,1230101308,1230104008,1,2,2700
49855440@N00,3427,7,1316908551,1316909391,2,2,840
49855440@N00,3427,15,1316912613,1316913813,1,2,1200
49858381@N04,3428,10,1358052818,1358053718,1,1,900
49887039@N04,3429,11,1283389806,1283390766,2,6,960
49887039@N04,3429,2,1283392405,1283392645,2,6,240
49887039@N04,3429,1,1283394416,1283394656,2,6,240
49887039@N04,3429,9,1283396048,1283396948,2,6,900
49887039@N04,3429,4,1283421479,1283421839,2,6,360
49887039@N04,3429,17,1283424765,1283427465,11,6,2700
49887039@N04,3430,11,1346688521,1346688669,3,5,148
49887039@N04,3430,2,1346688669,1346688731,2,5,62
49887039@N04,3430,4,1346688731,1346688774,2,5,43
49887039@N04,3430,2,1346688774,1346688831,2,5,57
49887039@N04,3430,11,1346688831,1346689791,1,5,960
49887039@N04,3431,3,1347172672,1347173002,2,2,330
49887039@N04,3431,9,1347181603,1347182503,1,2,900
49887039@N04,3432,11,1347520720,1347521680,2,4,960
49887039@N04,3432,5,1347523479,1347523899,2,4,420
49887039@N04,3432,1,1347526633,1347526873,2,4,240
49887039@N04,3432,8,1347530392,1347531232,2,4,840
49887039@N04,3433,11,1347807975,1347808935,2,1,960
49887039@N04,3434,13,1361364681,1361365761,1,1,1080
49934509@N00,3435,2,1291689016,1291689256,2,3,240
49934509@N00,3435,8,1291691412,1291692252,2,3,840
49934509@N00,3435,17,1291703867,1291706567,3,3,2700
49934509@N00,3436,11,1292051426,1292052386,1,1,960
49934509@N00,3437,3,1327039701,1327040031,1,1,330
49934509@N00,3438,12,1351317053,1351318073,1,1,1020
49934509@N00,3439,3,1351476194,1351476524,2,8,330
49934509@N00,3439,9,1351477904,1351478804,2,8,900
49934509@N00,3439,5,1351479849,1351480269,3,8,420
49934509@N00,3439,8,1351481541,1351482381,3,8,840
49934509@N00,3439,13,1351499471,1351500551,5,8,1080
49934509@N00,3439,7,1351506277,1351506397,5,8,120
49934509@N00,3439,3,1351506397,1351506405,2,8,8
49934509@N00,3439,7,1351506405,1351507245,2,8,840
49934509@N00,3440,13,1351827176,1351828256,8,5,1080
49934509@N00,3440,6,1351829744,1351830464,2,5,720
49934509@N00,3440,10,1351847230,1351848130,6,5,900
49934509@N00,3440,15,1351849618,1351849900,6,5,282
49934509@N00,3440,10,1351849900,1351850800,7,5,900
49934509@N00,3441,3,1351930849,1351931179,5,1,330
50023219@N05,3442,6,1271399971,1271400691,1,1,720
50023219@N05,3443,6,1272250052,1272250070,7,2,18
50023219@N05,3443,11,1272250070,1272251030,1,2,960
50178943@N03,3444,11,1412383347,1412384307,2,2,960
50178943@N03,3444,2,1412387057,1412387297,1,2,240
50196916@N00,3445,10,1311305512,1311306412,1,1,900
50207065@N00,3446,10,1203208620,1203209520,2,2,900
50207065@N00,3446,8,1203215810,1203216650,2,2,840
50223961@N03,3447,16,1320484145,1320486245,2,1,2100
50267281@N07,3448,11,1354438557,1354439517,8,1,960
50267281@N07,3449,11,1354491915,1354492875,8,1,960
50267281@N07,3450,11,1354745930,1354746890,27,1,960
50267281@N07,3451,11,1415174710,1415175670,15,1,960
50267281@N07,3452,11,1415409599,1415410559,26,5,960
50267281@N07,3452,13,1415417090,1415417960,2,5,870
50267281@N07,3452,11,1415417960,1415418381,2,5,421
50267281@N07,3452,13,1415418381,1415418536,2,5,155
50267281@N07,3452,11,1415418536,1415419496,11,5,960
50267281@N07,3453,11,1415575709,1415576669,63,1,960
50276147@N05,3454,11,1305017254,1305018214,1,1,960
50428026@N00,3455,11,1431562741,1431563701,3,4,960
50428026@N00,3455,4,1431569802,1431570162,2,4,360
50428026@N00,3455,17,1431572085,1431574785,2,4,2700
50428026@N00,3455,1,1431582243,1431582483,1,4,240
50514859@N00,3456,8,1248654201,1248655041,3,1,840
50559670@N04,3457,8,1369810780,1369811620,1,1,840
50565671@N00,3458,11,1398214547,1398215507,1,1,960
50584538@N07,3459,10,1271320741,1271321641,9,1,900
50584538@N07,3460,10,1272184951,1272185851,5,1,900
50584538@N07,3461,10,1272357553,1272358453,3,1,900
50584538@N07,3462,10,1272526788,1272527688,8,1,900
50584538@N07,3463,17,1304761729,1304764429,6,1,2700
50584538@N07,3464,17,1304848174,1304850874,2,1,2700
50584538@N07,3465,17,1305448908,1305451608,4,1,2700
50584538@N07,3466,17,1308213740,1308216440,3,1,2700
50639889@N00,3467,8,1222979028,1222979868,1,1,840
50728212@N00,3468,12,1212558813,1212559833,2,1,1020
50753203@N02,3469,1,1295148842,1295149082,2,2,240
50753203@N02,3469,8,1295158207,1295159047,1,2,840
50753203@N02,3470,8,1425809022,1425809862,2,1,840
50764296@N03,3471,11,1305780223,1305781183,5,1,960
50968580@N00,3472,17,1317547588,1317550288,1,1,2700
50968580@N00,3473,11,1319369696,1319370656,1,1,960
50968580@N00,3474,9,1352002677,1352003577,2,2,900
50968580@N00,3474,11,1352030187,1352031147,1,2,960
50968580@N00,3475,5,1356834875,1356835295,7,2,420
50968580@N00,3475,13,1356851405,1356852485,1,2,1080
50968580@N00,3476,11,1362801233,1362802193,2,3,960
50968580@N00,3476,5,1362807256,1362807676,2,3,420
50968580@N00,3476,11,1362824200,1362825160,3,3,960
50968580@N00,3477,7,1378001057,1378001897,3,5,840
50968580@N00,3477,3,1378006777,1378007107,5,5,330
50968580@N00,3477,5,1378017367,1378017787,4,5,420
50968580@N00,3477,16,1378025763,1378027863,2,5,2100
50968580@N00,3477,11,1378050308,1378051268,1,5,960
50968580@N00,3478,11,1387243246,1387244206,2,5,960
50968580@N00,3478,5,1387251217,1387251637,3,5,420
50968580@N00,3478,4,1387257744,1387258104,3,5,360
50968580@N00,3478,2,1387264159,1387264399,3,5,240
50968580@N00,3478,15,1387268436,1387269636,1,5,1200
51011933@N00,3479,11,1366154802,1366155762,2,5,960
51011933@N00,3479,2,1366157991,1366158231,4,5,240
51011933@N00,3479,9,1366165879,1366166779,2,5,900
51011933@N00,3479,3,1366168550,1366168880,2,5,330
51011933@N00,3479,10,1366186750,1366187650,2,5,900
51011933@N00,3480,11,1366234000,1366234960,2,2,960
51011933@N00,3480,2,1366235012,1366235252,1,2,240
51011933@N00,3481,9,1366276168,1366277068,2,2,900
51011933@N00,3481,4,1366278666,1366279026,1,2,360
51035587259@N01,3482,11,1354082023,1354082983,1,1,960
51035641205@N01,3483,4,1271979081,1271979441,1,1,360
51035647214@N01,3484,16,1273981543,1273983643,2,2,2100
51035647214@N01,3484,2,1273992224,1273992464,2,2,240
51035650382@N01,3485,11,1350103335,1350104295,2,1,960
51035650382@N01,3486,11,1350271928,1350272888,1,1,960
51035650382@N01,3487,11,1445127101,1445128061,1,1,960
51035650382@N01,3488,11,1445566134,1445567094,2,1,960
51035650382@N01,3489,11,1445747635,1445748595,1,1,960
51035760029@N01,3490,2,1383712654,1383712894,2,1,240
51035771246@N01,3491,11,1254453794,1254454754,2,3,960
51035771246@N01,3491,17,1254461833,1254464533,6,3,2700
51035771246@N01,3491,5,1254467608,1254468028,1,3,420
51037533@N00,3492,8,1359189532,1359190372,1,1,840
51038094@N04,3493,15,1360567047,1360568138,2,3,1091
51038094@N04,3493,13,1360568138,1360569218,2,3,1080
51038094@N04,3493,11,1360579077,1360580037,2,3,960
51052219@N00,3494,10,1290913524,1290914424,1,1,900
51052219@N00,3495,13,1317222420,1317223500,1,1,1080
51065161@N00,3496,11,1386766490,1386767450,2,4,960
51065161@N00,3496,8,1386775642,1386775959,4,4,317
51065161@N00,3496,11,1386775959,1386776919,2,4,960
51065161@N00,3496,2,1386784369,1386784609,1,4,240
51116425@N06,3497,1,1330335080,1330335320,1,1,240
51141147@N02,3498,11,1335136887,1335137847,2,11,960
51141147@N02,3498,7,1335145010,1335145318,3,11,308
51141147@N02,3498,10,1335145318,1335146073,4,11,755
51141147@N02,3498,17,1335146073,1335146779,5,11,706
51141147@N02,3498,15,1335146779,1335147746,2,11,967
51141147@N02,3498,13,1335147746,1335148826,9,11,1080
51141147@N02,3498,8,1335156578,1335157418,14,11,840
51141147@N02,3498,5,1335163179,1335163599,2,11,420
51141147@N02,3498,9,1335166145,1335167045,5,11,900
51141147@N02,3498,16,1335167599,1335168535,5,11,936
51141147@N02,3498,11,1335168535,1335169495,2,11,960
51159953@N00,3499,17,1304378708,1304381408,3,8,2700
51159953@N00,3499,11,1304382565,1304383525,2,8,960
51159953@N00,3499,1,1304384063,1304384303,3,8,240
51159953@N00,3499,2,1304385923,1304386163,6,8,240
51159953@N00,3499,11,1304389678,1304389706,2,8,28
51159953@N00,3499,2,1304389706,1304389875,3,8,169
51159953@N00,3499,7,1304389875,1304390715,4,8,840
51159953@N00,3499,11,1304394633,1304395593,6,8,960
51159953@N00,3500,2,1304646227,1304646467,2,3,240
51159953@N00,3500,12,1304651971,1304652991,4,3,1020
51159953@N00,3500,11,1304678155,1304679115,3,3,960
51166785@N06,3501,11,1351898298,1351899258,2,5,960
51166785@N06,3501,9,1351911741,1351912304,3,5,563
51166785@N06,3501,16,1351912304,1351914343,2,5,2039
51166785@N06,3501,5,1351914343,1351914763,3,5,420
51166785@N06,3501,3,1351927320,1351927650,1,5,330
51238318@N07,3502,8,1311734577,1311735417,2,1,840
51267780@N00,3503,11,1224104372,1224105332,5,10,960
51267780@N00,3503,9,1224107419,1224107671,5,10,252
51267780@N00,3503,16,1224107671,1224109286,6,10,1615
51267780@N00,3503,10,1224109286,1224110186,4,10,900
51267780@N00,3503,17,1224111874,1224112121,4,10,247
51267780@N00,3503,15,1224112121,1224112197,2,10,76
51267780@N00,3503,13,1224112197,1224113277,16,10,1080
51267780@N00,3503,8,1224124972,1224125345,5,10,373
51267780@N00,3503,5,1224125345,1224125765,6,10,420
51267780@N00,3503,8,1224126945,1224127785,2,10,840
51267780@N00,3504,1,1224276155,1224276395,2,4,240
51267780@N00,3504,5,1224276458,1224276878,3,4,420
51267780@N00,3504,15,1224285453,1224285534,2,4,81
51267780@N00,3504,17,1224285534,1224288234,6,4,2700
51313971@N08,3505,11,1443408912,1443409872,2,1,960
51437422@N03,3506,8,1427884826,1427885666,1,1,840
51437422@N03,3507,11,1465789348,1465790308,1,1,960
51446559@N06,3508,11,1322045614,1322046574,2,1,960
51460585@N03,3509,11,1375664897,1375665857,1,1,960
51501947@N05,3510,13,1319795618,1319796698,1,1,1080
51501947@N05,3511,15,1319859785,1319860985,1,1,1200
51501947@N05,3512,8,1320286175,1320287015,1,1,840
51531384@N00,3513,11,1415503835,1415504795,3,1,960
51547237@N00,3514,17,1291795680,1291798380,1,1,2700
51547237@N00,3515,11,1412462731,1412463691,2,1,960
51547237@N00,3516,6,1449038484,1449039204,1,1,720
51579577@N00,3517,5,1388025449,1388025869,2,2,420
51579577@N00,3517,8,1388028042,1388028882,1,2,840
51636307@N00,3518,11,1323214035,1323214995,10,13,960
51636307@N00,3518,17,1323216576,1323217237,7,13,661
51636307@N00,3518,15,1323217237,1323217347,4,13,110
51636307@N00,3518,17,1323217347,1323217513,3,13,166
51636307@N00,3518,15,1323217513,1323217609,2,13,96
51636307@N00,3518,13,1323217609,1323218689,5,13,1080
51636307@N00,3518,8,1323231007,1323231847,11,13,840
51636307@N00,3518,5,1323234491,1323234911,2,13,420
51636307@N00,3518,1,1323235014,1323235254,2,13,240
51636307@N00,3518,9,1323236120,1323237020,3,13,900
51636307@N00,3518,3,1323240052,1323240382,4,13,330
51636307@N00,3518,4,1323245657,1323246017,2,13,360
51636307@N00,3518,11,1323247792,1323248752,2,13,960
51662658@N05,3519,15,1266644851,1266646051,1,1,1200
51692964@N05,3520,4,1236817604,1236817964,1,1,360
51746064@N07,3521,11,1362720872,1362721832,2,4,960
51746064@N07,3521,1,1362722718,1362722958,2,4,240
51746064@N07,3521,2,1362723418,1362723658,3,4,240
51746064@N07,3521,11,1362728725,1362729685,10,4,960
51746586@N06,3522,11,1281371619,1281372579,1,1,960
51746586@N06,3523,11,1282304571,1282305531,1,1,960
51746586@N06,3524,17,1312331406,1312331541,4,7,135
51746586@N06,3524,13,1312331541,1312332213,2,7,672
51746586@N06,3524,10,1312332213,1312332458,2,7,245
51746586@N06,3524,2,1312332458,1312332698,2,7,240
51746586@N06,3524,7,1312332866,1312333706,2,7,840
51746586@N06,3524,17,1312346947,1312347933,2,7,986
51746586@N06,3524,15,1312347933,1312349133,5,7,1200
51746586@N06,3525,13,1313053805,1313054885,4,1,1080
51746586@N06,3526,8,1313462233,1313463073,1,1,840
51746586@N06,3527,7,1344068151,1344068839,3,3,688
51746586@N06,3527,15,1344068839,1344070039,3,3,1200
51746586@N06,3527,6,1344075913,1344076633,5,3,720
51746586@N06,3528,17,1344387524,1344388323,3,7,799
51746586@N06,3528,13,1344388323,1344389403,6,7,1080
51746586@N06,3528,8,1344403221,1344404061,5,7,840
51746586@N06,3528,15,1344407782,1344408781,2,7,999
51746586@N06,3528,5,1344408781,1344409201,4,7,420
51746586@N06,3528,6,1344409498,1344410218,3,7,720
51746586@N06,3528,17,1344415048,1344417748,1,7,2700
51746586@N06,3529,6,1344856269,1344856989,3,1,720
51746586@N06,3530,15,1345000539,1345001739,8,1,1200
51746586@N06,3531,5,1406802511,1406802931,1,1,420
51773303@N00,3532,9,1350400140,1350401040,1,1,900
51791370@N03,3533,13,1300319987,1300321067,4,2,1080
51791370@N03,3533,1,1300337189,1300337429,2,2,240
51821103@N07,3534,11,1340271227,1340272187,9,1,960
51931244@N02,3535,5,1266679502,1266679922,1,1,420
51931244@N02,3536,13,1269745479,1269746559,2,3,1080
51931244@N02,3536,5,1269762535,1269762955,2,3,420
51931244@N02,3536,11,1269773614,1269774574,1,3,960
51965232@N06,3537,11,1408238205,1408239165,1,1,960
52066610@N03,3538,8,1394516619,1394517459,2,2,840
52066610@N03,3538,11,1394521531,1394522491,1,2,960
52082189@N03,3539,11,1328014800,1328015760,2,1,960
52135752@N07,3540,11,1392966038,1392966998,1,1,960
52168854@N00,3541,17,1348392829,1348395529,3,1,2700
52168854@N00,3542,8,1348817698,1348818538,1,1,840
52192784@N08,3543,11,1389757391,1389758351,5,3,960
52192784@N08,3543,1,1389763845,1389764085,4,3,240
52192784@N08,3543,8,1389773698,1389774538,1,3,840
52195956@N03,3544,1,1314412775,1314413015,17,1,240
52226961@N04,3545,7,1376804196,1376804696,3,2,500
52226961@N04,3545,5,1376804696,1376805116,2,2,420
52226961@N04,3546,11,1401494590,1401495550,2,2,960
52226961@N04,3546,3,1401503939,1401504269,1,2,330
52242069@N04,3547,1,1331275753,1331275993,1,1,240
52254014@N00,3548,10,1278229800,1278230700,1,1,900
52254014@N00,3549,13,1293863873,1293864953,2,2,1080
52254014@N00,3549,8,1293865309,1293866149,1,2,840
52254014@N00,3550,8,1304851447,1304852287,1,1,840
52254014@N00,3551,11,1317507671,1317508631,1,1,960
52254014@N00,3552,15,1326352070,1326353270,3,4,1200
52254014@N00,3552,13,1326356189,1326357269,2,4,1080
52254014@N00,3552,9,1326359682,1326360582,2,4,900
52254014@N00,3552,11,1326360649,1326361609,1,4,960
52254014@N00,3553,8,1349856097,1349856937,2,2,840
52254014@N00,3553,11,1349857571,1349858531,1,2,960
52254014@N00,3554,15,1362211573,1362212773,1,1,1200
52364637@N00,3555,11,1378524527,1378525487,2,3,960
52364637@N00,3555,9,1378526682,1378527219,2,3,537
52364637@N00,3555,10,1378527219,1378528119,1,3,900
52378595@N06,3556,10,1297134392,1297135292,1,1,900
52378595@N06,3557,11,1311834850,1311835810,1,1,960
52407821@N00,3558,11,1354917922,1354918882,1,1,960
52458519@N07,3559,4,1250899776,1250900136,2,3,360
52458519@N07,3559,15,1250902905,1250904105,2,3,1200
52458519@N07,3559,6,1250917097,1250917817,1,3,720
52465495@N06,3560,13,1378540397,1378541477,2,2,1080
52465495@N06,3560,2,1378543007,1378543247,1,2,240
52495257@N02,3561,6,1247328741,1247329461,1,1,720
52495497@N08,3562,6,1328410559,1328411279,1,1,720
52495497@N08,3563,17,1394711090,1394713790,1,1,2700
52504278@N00,3564,11,1254142421,1254143381,1,1,960
52504278@N00,3565,6,1333481667,1333482387,2,2,720
52504278@N00,3565,13,1333490574,1333491654,1,2,1080
52504278@N00,3566,11,1333535381,1333536341,1,1,960
52574631@N00,3567,11,1455410078,1455411038,3,7,960
52574631@N00,3567,3,1455414546,1455414876,2,7,330
52574631@N00,3567,2,1455415175,1455415415,8,7,240
52574631@N00,3567,16,1455423988,1455426088,7,7,2100
52574631@N00,3567,1,1455426563,1455426803,2,7,240
52574631@N00,3567,8,1455438989,1455439829,3,7,840
52574631@N00,3567,11,1455443134,1455444094,3,7,960
52574631@N00,3568,11,1455768469,1455769389,2,5,920
52574631@N00,3568,14,1455769389,1455770408,2,5,1019
52574631@N00,3568,4,1455770408,1455770768,7,5,360
52574631@N00,3568,5,1455784121,1455784541,3,5,420
52574631@N00,3568,11,1455786604,1455787564,1,5,960
52574631@N00,3569,11,1455901429,1455902389,2,1,960
52574631@N00,3570,11,1456910619,1456911579,1,1,960
52608533@N04,3571,2,1411258935,1411259175,1,1,240
52636686@N07,3572,11,1390342280,1390343240,28,13,960
52636686@N07,3572,2,1390348133,1390348373,28,13,240
52636686@N07,3572,7,1390351174,1390352014,18,13,840
52636686@N07,3572,4,1390353794,1390354154,15,13,360
52636686@N07,3572,1,1390357086,1390357326,11,13,240
52636686@N07,3572,9,1390359807,1390360707,7,13,900
52636686@N07,3572,16,1390360958,1390362014,20,13,1056
52636686@N07,3572,1,1390362014,1390362029,3,13,15
52636686@N07,3572,16,1390362029,1390364129,6,13,2100
52636686@N07,3572,11,1390366746,1390367706,7,13,960
52636686@N07,3572,5,1390368019,1390368439,21,13,420
52636686@N07,3572,8,1390369535,1390370375,50,13,840
52636686@N07,3572,11,1390383939,1390384899,2,13,960
52636686@N07,3573,15,1390434331,1390435531,5,9,1200
52636686@N07,3573,7,1390437163,1390438003,3,9,840
52636686@N07,3573,10,1390439473,1390440373,27,9,900
52636686@N07,3573,15,1390441845,1390442851,21,9,1006
52636686@N07,3573,17,1390442851,1390443928,4,9,1077
52636686@N07,3573,15,1390443928,1390444485,3,9,557
52636686@N07,3573,13,1390444485,1390445565,16,9,1080
52636686@N07,3573,8,1390457143,1390457983,26,9,840
52636686@N07,3573,5,1390460042,1390460462,4,9,420
52645917@N08,3574,5,1424593678,1424594098,3,2,420
52645917@N08,3574,8,1424596795,1424597635,2,2,840
52666614@N06,3575,11,1407912866,1407913826,3,3,960
52666614@N06,3575,9,1407924982,1407925882,3,3,900
52666614@N06,3575,1,1407927233,1407927473,1,3,240
52666614@N06,3576,11,1408265096,1408266056,2,4,960
52666614@N06,3576,5,1408270118,1408270538,2,4,420
52666614@N06,3576,8,1408273363,1408274203,2,4,840
52666614@N06,3576,5,1408274351,1408274771,1,4,420
52666614@N06,3577,13,1408419004,1408419989,2,3,985
52666614@N06,3577,10,1408419989,1408420889,5,3,900
52666614@N06,3577,16,1408422532,1408424632,1,3,2100
52683535@N00,3578,11,1322822966,1322823926,1,1,960
52752881@N03,3579,11,1302055423,1302056383,2,3,960
52752881@N03,3579,16,1302056724,1302058824,2,3,2100
52752881@N03,3579,10,1302078159,1302079059,1,3,900
52758053@N07,3580,8,1335059747,1335060587,2,1,840
52758053@N07,3581,13,1335427732,1335428812,2,2,1080
52758053@N07,3581,11,1335437857,1335438817,2,2,960
52758053@N07,3582,2,1375515259,1375515499,2,2,240
52758053@N07,3582,4,1375522722,1375523082,1,2,360
52758053@N07,3583,11,1375758554,1375759514,2,10,960
52758053@N07,3583,1,1375779342,1375779582,2,10,240
52758053@N07,3583,10,1375787382,1375787425,2,10,43
52758053@N07,3583,4,1375787425,1375787470,3,10,45
52758053@N07,3583,3,1375787470,1375787611,2,10,141
52758053@N07,3583,4,1375787611,1375787971,2,10,360
52758053@N07,3583,10,1375789367,1375790267,2,10,900
52758053@N07,3583,13,1375791214,1375792294,3,10,1080
52758053@N07,3583,8,1375794961,1375795801,4,10,840
52758053@N07,3583,11,1375796611,1375797571,1,10,960
52758053@N07,3584,8,1376041002,1376041842,1,1,840
52758053@N07,3585,17,1400298439,1400301139,1,1,2700
52758053@N07,3586,8,1465297783,1465298623,2,1,840
52774491@N00,3587,11,1305192486,1305193446,1,1,960
52793155@N07,3588,11,1190886675,1190887635,1,1,960
52793155@N07,3589,13,1283075022,1283076102,1,1,1080
52793155@N07,3590,8,1285044709,1285045549,2,4,840
52793155@N07,3590,5,1285047857,1285048277,2,4,420
52793155@N07,3590,11,1285049272,1285050232,2,4,960
52793155@N07,3590,5,1285059261,1285059681,1,4,420
52793155@N07,3591,11,1286885389,1286886349,1,1,960
52793155@N07,3592,2,1291813961,1291814201,1,1,240
52793155@N07,3593,2,1292250372,1292250612,1,1,240
52793155@N07,3594,11,1295686879,1295687839,1,1,960
52793155@N07,3595,13,1316241876,1316242956,1,1,1080
52793155@N07,3596,8,1316334892,1316335732,1,1,840
52793155@N07,3597,13,1316415350,1316416430,1,1,1080
52793155@N07,3598,13,1316760449,1316761529,1,1,1080
52793155@N07,3599,15,1329025205,1329025555,2,2,350
52793155@N07,3599,13,1329025555,1329026635,1,2,1080
52793155@N07,3600,9,1332204358,1332205258,4,2,900
52793155@N07,3600,8,1332210122,1332210962,3,2,840
52793155@N07,3601,8,1334448296,1334449136,1,1,840
52793155@N07,3602,11,1337671173,1337672133,1,1,960
52793155@N07,3603,10,1345363277,1345364177,1,1,900
52793155@N07,3604,3,1358754398,1358754728,1,1,330
52793155@N07,3605,8,1363492334,1363493174,3,1,840
52793155@N07,3606,3,1381300796,1381301126,1,1,330
52793155@N07,3607,11,1382843242,1382844051,2,4,809
52793155@N07,3607,16,1382844051,1382844627,2,4,576
52793155@N07,3607,9,1382844627,1382845527,3,4,900
52793155@N07,3607,5,1382846591,1382847011,1,4,420
52793155@N07,3608,9,1385181079,1385181979,16,4,900
52793155@N07,3608,3,1385182893,1385183170,2,4,277
52793155@N07,3608,4,1385183170,1385183530,8,4,360
52793155@N07,3608,8,1385190885,1385191725,1,4,840
52793155@N07,3609,5,1386115496,1386115916,1,1,420
52793155@N07,3610,8,1386284125,1386284965,1,1,840
52793155@N07,3611,8,1389500319,1389501159,2,1,840
52793155@N07,3612,3,1390721184,1390721514,1,1,330
52793155@N07,3613,8,1399095177,1399096017,1,1,840
52793155@N07,3614,11,1400796563,1400797523,4,3,960
52793155@N07,3614,15,1400802358,1400803558,2,3,1200
52793155@N07,3614,13,1400803679,1400804759,1,3,1080
52793155@N07,3615,8,1409991407,1409992247,1,1,840
52793155@N07,3616,8,1410478786,1410479626,1,1,840
52793155@N07,3617,5,1416017852,1416018272,1,1,420
52793155@N07,3618,8,1421627422,1421628262,1,1,840
52793155@N07,3619,8,1425171964,1425172804,1,1,840
52793155@N07,3620,8,1456557229,1456558069,1,1,840
52812594@N00,3621,15,1274089719,1274090919,1,1,1200
52828533@N00,3622,11,1220920092,1220921052,3,2,960
52828533@N00,3622,4,1220927638,1220927998,1,2,360
52842822@N04,3623,4,1358938945,1358939305,1,1,360
52842822@N04,3624,11,1359029812,1359030772,1,1,960
52842822@N04,3625,4,1360216708,1360217068,1,1,360
52842822@N04,3626,13,1362652881,1362653961,1,1,1080
52842822@N04,3627,11,1373112768,1373113728,1,1,960
52842822@N04,3628,16,1373972723,1373974823,1,1,2100
52842822@N04,3629,1,1391854668,1391854908,1,1,240
52842822@N04,3630,10,1401878797,1401879697,1,1,900
52842822@N04,3631,13,1409221503,1409222583,1,1,1080
52842822@N04,3632,8,1411790092,1411790932,1,1,840
52842822@N04,3633,10,1415563784,1415564684,1,1,900
52842822@N04,3634,15,1425537626,1425538826,1,1,1200
52842822@N04,3635,8,1434363457,1434364297,1,1,840
52855156@N00,3636,11,1217159999,1217160959,3,1,960
52862869@N07,3637,11,1300078469,1300079429,4,6,960
52862869@N07,3637,9,1300085108,1300085184,2,6,76
52862869@N07,3637,1,1300085184,1300085424,2,6,240
52862869@N07,3637,13,1300091208,1300091786,2,6,578
52862869@N07,3637,15,1300091786,1300092986,3,6,1200
52862869@N07,3637,4,1300094429,1300094789,2,6,360
52872213@N04,3638,8,1294414495,1294415335,1,1,840
52892088@N02,3639,11,1346536293,1346537253,2,1,960
52892088@N02,3640,11,1367752517,1367753477,2,2,960
52892088@N02,3640,17,1367754400,1367757100,1,2,2700
52906672@N00,3641,11,1408068382,1408069342,3,2,960
52906672@N00,3641,8,1408073118,1408073958,2,2,840
52976240@N00,3642,11,1354854289,1354855249,1,1,960
52976240@N00,3643,8,1354896055,1354896895,2,2,840
52976240@N00,3643,11,1354901314,1354902274,1,2,960
52976240@N00,3644,11,1355058085,1355059045,2,1,960
52976240@N00,3645,17,1365837427,1365840127,1,1,2700
52976240@N00,3646,11,1365948494,1365949454,1,1,960
52976240@N00,3647,11,1424592928,1424593888,1,1,960
52982457@N00,3648,11,1278195803,1278196763,30,1,960
52989928@N07,3649,11,1280288560,1280289520,1,1,960
53024970@N07,3650,2,1273523116,1273523356,2,2,240
53024970@N07,3650,6,1273523589,1273524309,1,2,720
53024970@N07,3651,4,1273577624,1273577984,3,3,360
53024970@N07,3651,2,1273582099,1273582339,3,3,240
53024970@N07,3651,13,1273591906,1273592986,1,3,1080
53024970@N07,3652,2,1282299072,1282299312,2,1,240
53024970@N07,3653,13,1283519875,1283520955,3,1,1080
53024970@N07,3654,17,1334465027,1334467727,1,1,2700
53034361@N00,3655,6,1463117295,1463118015,4,1,720
53034361@N00,3656,5,1463386574,1463386994,2,2,420
53034361@N00,3656,8,1463387170,1463388010,1,2,840
53055319@N00,3657,16,1188721732,1188723832,1,1,2100
53093866@N00,3658,2,1361784259,1361784499,1,1,240
53127166@N04,3659,11,1390429741,1390430701,1,1,960
53157520@N07,3660,5,1285994070,1285994490,2,2,420
53157520@N07,3660,8,1285995816,1285996656,1,2,840
53179863@N07,3661,15,1426292389,1426293589,1,1,1200
53199533@N07,3662,11,1268917200,1268917205,6,19,5
53199533@N07,3662,15,1268917205,1268917208,4,19,3
53199533@N07,3662,17,1268917208,1268917209,2,19,1
53199533@N07,3662,15,1268917209,1268917211,3,19,2
53199533@N07,3662,17,1268917211,1268917212,2,19,1
53199533@N07,3662,10,1268917212,1268917224,10,19,12
53199533@N07,3662,8,1268917224,1268917259,13,19,35
53199533@N07,3662,13,1268917259,1268917325,26,19,66
53199533@N07,3662,1,1268917325,1268917326,2,19,1
53199533@N07,3662,8,1268917326,1268917328,2,19,2
53199533@N07,3662,5,1268917328,1268917334,7,19,6
53199533@N07,3662,12,1268917334,1268917347,14,19,13
53199533@N07,3662,2,1268917347,1268917350,4,19,3
53199533@N07,3662,12,1268917350,1268917351,2,19,1
53199533@N07,3662,2,1268917351,1268917353,2,19,2
53199533@N07,3662,3,1268917353,1268917354,2,19,1
53199533@N07,3662,7,1268917354,1268917356,3,19,2
53199533@N07,3662,2,1268917356,1268917358,2,19,2
53199533@N07,3662,11,1268917358,1268918318,3,19,960
53199533@N07,3663,10,1269003600,1269004500,7,1,900
53228494@N00,3664,1,1270941900,1270942140,3,5,240
53228494@N00,3664,10,1270952160,1270953060,2,5,900
53228494@N00,3664,16,1270967257,1270969357,4,5,2100
53228494@N00,3664,15,1270971492,1270972183,10,5,691
53228494@N00,3664,13,1270972183,1270973263,6,5,1080
53325263@N07,3665,11,1301034108,1301035068,2,1,960
53353745@N00,3666,11,1399936848,1399937808,3,6,960
53353745@N00,3666,10,1399944831,1399944946,2,6,115
53353745@N00,3666,17,1399944946,1399945027,3,6,81
53353745@N00,3666,15,1399945027,1399946227,2,6,1200
53353745@N00,3666,8,1399946591,1399947431,2,6,840
53353745@N00,3666,5,1399947962,1399948382,1,6,420
53407359@N00,3667,11,1417472602,1417473562,2,1,960
53450473@N06,3668,8,1308344704,1308345544,2,1,840
53516741@N04,3669,2,1319096580,1319096820,2,2,240
53516741@N04,3669,8,1319101678,1319102518,1,2,840
53516741@N04,3670,8,1354527800,1354528640,1,1,840
53516741@N04,3671,17,1354844929,1354847629,1,1,2700
53566822@N00,3672,11,1364006290,1364007250,1,1,960
53574480@N03,3673,11,1281681259,1281682219,1,1,960
53602988@N02,3674,2,1324191688,1324191928,2,1,240
53613159@N04,3675,11,1319666424,1319667384,1,1,960
53670581@N02,3676,11,1326010428,1326011388,1,1,960
53770108@N03,3677,1,1323482927,1323483167,1,1,240
53770108@N03,3678,11,1364869904,1364870864,1,1,960
53797701@N07,3679,11,1406343616,1406344576,1,1,960
53848863@N02,3680,8,1357427888,1357428728,1,1,840
53848863@N02,3681,11,1357685451,1357686411,2,3,960
53848863@N02,3681,9,1357691119,1357692019,2,3,900
53848863@N02,3681,8,1357707639,1357708479,1,3,840
54066480@N04,3682,11,1398372849,1398373809,1,1,960
54193979@N06,3683,11,1251727200,1251728160,1,1,960
54250081@N05,3684,5,1370142584,1370143004,5,6,420
54250081@N05,3684,8,1370145713,1370146553,25,6,840
54250081@N05,3684,13,1370162746,1370163424,8,6,678
54250081@N05,3684,17,1370163424,1370164982,7,6,1558
54250081@N05,3684,10,1370164982,1370165882,2,6,900
54250081@N05,3684,17,1370173500,1370176200,1,6,2700
54276855@N07,3685,9,1351265311,1351266211,1,1,900
54364530@N08,3686,16,1354511232,1354511303,3,7,71
54364530@N08,3686,2,1354511303,1354511543,3,7,240
54364530@N08,3686,11,1354511898,1354512858,4,7,960
54364530@N08,3686,9,1354512878,1354513266,2,7,388
54364530@N08,3686,5,1354513266,1354513549,4,7,283
54364530@N08,3686,8,1354513549,1354514389,53,7,840
54364530@N08,3686,13,1354516801,1354517881,1,7,1080
54364530@N08,3687,13,1354572180,1354573260,1,1,1080
54364530@N08,3688,1,1386727283,1386727523,5,1,240
54399332@N02,3689,11,1280586009,1280586969,2,3,960
54399332@N02,3689,5,1280602047,1280602467,2,3,420
54399332@N02,3689,11,1280606628,1280607588,1,3,960
54432460@N08,3690,17,1295495213,1295495476,3,2,263
54432460@N08,3690,16,1295495476,1295497576,1,2,2100
54491498@N00,3691,11,1254693853,1254694813,5,5,960
54491498@N00,3691,5,1254701181,1254701601,6,5,420
54491498@N00,3691,8,1254703748,1254704588,12,5,840
54491498@N00,3691,15,1254718038,1254718541,4,5,503
54491498@N00,3691,17,1254718541,1254721241,2,5,2700
54497431@N05,3692,15,1318146152,1318147352,1,1,1200
54589898@N00,3693,11,1415613676,1415614636,1,1,960
54612194@N05,3694,13,1364709073,1364710153,1,1,1080
54679799@N03,3695,11,1370511811,1370512771,1,1,960
54679799@N03,3696,11,1370640330,1370641290,2,1,960
54679799@N03,3697,1,1464055521,1464055620,2,4,99
54679799@N03,3697,9,1464055620,1464056520,2,4,900
54679799@N03,3697,11,1464065584,1464066205,2,4,621
54679799@N03,3697,13,1464066205,1464067285,1,4,1080
54845704@N05,3698,11,1298507245,1298508205,2,7,960
54845704@N05,3698,2,1298510008,1298510248,2,7,240
54845704@N05,3698,12,1298511316,1298512336,6,7,1020
54845704@N05,3698,14,1298517516,1298518716,2,7,1200
54845704@N05,3698,1,1298523139,1298523379,2,7,240
54845704@N05,3698,9,1298524835,1298525735,4,7,900
54845704@N05,3698,8,1298534642,1298535482,2,7,840
54855264@N00,3699,4,1192833843,1192834203,3,13,360
54855264@N00,3699,7,1192836135,1192836745,4,13,610
54855264@N00,3699,3,1192836745,1192837075,2,13,330
54855264@N00,3699,8,1192837725,1192838565,16,13,840
54855264@N00,3699,7,1192847620,1192848460,2,13,840
54855264@N00,3699,1,1192851450,1192851690,3,13,240
54855264@N00,3699,3,1192852607,1192852667,2,13,60
54855264@N00,3699,7,1192852667,1192853507,2,13,840
54855264@N00,3699,11,1192856680,1192857640,5,13,960
54855264@N00,3699,6,1192875113,1192875833,5,13,720
54855264@N00,3699,8,1192890488,1192890600,2,13,112
54855264@N00,3699,1,1192890600,1192890718,2,13,118
54855264@N00,3699,11,1192890718,1192891678,1,13,960
54855264@N00,3700,11,1371199396,1371200356,1,1,960
54855264@N00,3701,11,1376121457,1376122417,1,1,960
54902025@N00,3702,11,1286599592,1286600552,2,1,960
54902025@N00,3703,9,1328855221,1328856121,2,3,900
54902025@N00,3703,5,1328881948,1328882368,3,3,420
54902025@N00,3703,11,1328883802,1328884762,2,3,960
54902025@N00,3704,5,1329190345,1329190765,2,3,420
54902025@N00,3704,4,1329196635,1329196995,2,3,360
54902025@N00,3704,11,1329197670,1329198630,3,3,960
54902025@N00,3705,1,1354785211,1354785451,2,3,240
54902025@N00,3705,16,1354786376,1354788476,3,3,2100
54902025@N00,3705,8,1354795222,1354796062,3,3,840
54902025@N00,3706,1,1358064564,1358064804,1,1,240
54905383@N07,3707,8,1238922517,1238923357,1,1,840
55041396@N00,3708,4,1398411253,1398411613,2,4,360
55041396@N00,3708,13,1398420554,1398421101,4,4,547
55041396@N00,3708,17,1398421101,1398421962,3,4,861
55041396@N00,3708,11,1398421962,1398422922,3,4,960
55052349@N00,3709,11,1342932611,1342933571,2,3,960
55052349@N00,3709,15,1342953748,1342954948,2,3,1200
55052349@N00,3709,11,1342974638,1342975598,5,3,960
55114802@N00,3710,11,1251539976,1251540936,1,1,960
55143107@N00,3711,11,1224116212,1224117172,3,1,960
55171970@N00,3712,8,1440048924,1440049764,2,3,840
55171970@N00,3712,15,1440056179,1440056251,2,3,72
55171970@N00,3712,17,1440056251,1440058951,1,3,2700
55217458@N00,3713,9,1352864201,1352865101,2,1,900
55217458@N00,3714,10,1389158108,1389159008,2,2,900
55217458@N00,3714,15,1389164026,1389165226,1,2,1200
55217458@N00,3715,8,1389289101,1389289941,2,6,840
55217458@N00,3715,1,1389301908,1389302148,2,6,240
55217458@N00,3715,9,1389306172,1389306332,2,6,160
55217458@N00,3715,17,1389306332,1389309032,2,6,2700
55217458@N00,3715,2,1389323956,1389324196,2,6,240
55217458@N00,3715,11,1389324408,1389325368,1,6,960
55217458@N00,3716,11,1389487396,1389488356,1,1,960
55266776@N00,3717,4,1266575083,1266575443,1,1,360
55287129@N04,3718,9,1296632254,1296633154,1,1,900
55332987@N00,3719,17,1265364746,1265367446,1,1,2700
55362088@N06,3720,13,1342062636,1342063716,1,1,1080
55404083@N08,3721,11,1303207367,1303208327,2,1,960
55404083@N08,3722,15,1303729920,1303731120,1,1,1200
55455788@N00,3723,4,1194158733,1194159093,1,1,360
55455788@N00,3724,8,1222420658,1222421498,11,3,840
55455788@N00,3724,10,1222427245,1222428145,10,3,900
55455788@N00,3724,11,1222428556,1222429516,1,3,960
55455788@N00,3725,11,1225957464,1225958072,11,11,608
55455788@N00,3725,9,1225958072,1225958972,8,11,900
55455788@N00,3725,7,1225959471,1225960036,8,11,565
55455788@N00,3725,4,1225960036,1225960396,9,11,360
55455788@N00,3725,10,1225961545,1225961731,7,11,186
55455788@N00,3725,17,1225961731,1225961871,2,11,140
55455788@N00,3725,15,1225961871,1225962709,9,11,838
55455788@N00,3725,5,1225962709,1225963129,2,11,420
55455788@N00,3725,8,1225963297,1225963886,15,11,589
55455788@N00,3725,5,1225963886,1225964306,7,11,420
55455788@N00,3725,11,1225967141,1225968101,3,11,960
55455788@N00,3726,5,1232777616,1232778036,4,7,420
55455788@N00,3726,8,1232778053,1232778893,36,7,840
55455788@N00,3726,15,1232786298,1232787380,6,7,1082
55455788@N00,3726,13,1232787380,1232788460,5,7,1080
55455788@N00,3726,5,1232798721,1232799141,2,7,420
55455788@N00,3726,8,1232799159,1232799999,3,7,840
55455788@N00,3726,15,1232801420,1232802620,1,7,1200
55455788@N00,3727,11,1239344805,1239345765,8,7,960
55455788@N00,3727,2,1239346105,1239346345,4,7,240
55455788@N00,3727,12,1239347485,1239348505,8,7,1020
55455788@N00,3727,1,1239351867,1239352107,5,7,240
55455788@N00,3727,8,1239353339,1239354179,3,7,840
55455788@N00,3727,1,1239356447,1239356687,2,7,240
55455788@N00,3727,11,1239357979,1239358939,4,7,960
55455788@N00,3728,11,1239512427,1239513387,5,4,960
55455788@N00,3728,10,1239513768,1239514668,14,4,900
55455788@N00,3728,13,1239514900,1239515980,7,4,1080
55455788@N00,3728,11,1239519833,1239520793,3,4,960
55455788@N00,3729,11,1242456786,1242457746,11,1,960
55455788@N00,3730,8,1255163999,1255164839,1,1,840
55455788@N00,3731,10,1263698361,1263699261,3,10,900
55455788@N00,3731,17,1263699928,1263702628,3,10,2700
55455788@N00,3731,7,1263704417,1263705257,3,10,840
55455788@N00,3731,4,1263709650,1263710010,3,10,360
55455788@N00,3731,11,1263713553,1263714513,11,10,960
55455788@N00,3731,5,1263718432,1263718852,18,10,420
55455788@N00,3731,13,1263727990,1263728743,31,10,753
55455788@N00,3731,17,1263728743,1263729010,9,10,267
55455788@N00,3731,10,1263729010,1263729910,2,10,900
55455788@N00,3731,11,1263729911,1263730871,11,10,960
55455788@N00,3732,11,1271569890,1271570850,1,1,960
55455788@N00,3733,12,1283745790,1283746455,5,2,665
55455788@N00,3733,4,1283746455,1283746815,2,2,360
55455788@N00,3734,17,1307864231,1307866931,1,1,2700
55455788@N00,3735,10,1310265832,1310266732,1,1,900
55455788@N00,3736,4,1325058642,1325059002,2,1,360
55455788@N00,3737,11,1429412423,1429413383,1,1,960
55488870@N08,3738,11,1451006742,1451007702,1,1,960
55569174@N00,3739,11,1349568975,1349569935,13,2,960
55569174@N00,3739,13,1349577284,1349578364,11,2,1080
55569174@N00,3740,11,1358932539,1358933499,1,1,960
55570231@N03,3741,11,1284432680,1284433640,1,1,960
55615740@N00,3742,5,1404444023,1404444443,3,3,420
55615740@N00,3742,8,1404445190,1404446030,2,3,840
55615740@N00,3742,5,1404452297,1404452717,1,3,420
55615740@N00,3743,17,1405754179,1405754845,4,2,666
55615740@N00,3743,10,1405754845,1405755745,5,2,900
55615740@N00,3744,1,1405825011,1405825251,2,2,240
55615740@N00,3744,8,1405825600,1405826440,8,2,840
55615740@N00,3745,8,1410058503,1410059343,1,1,840
55615740@N00,3746,11,1413534700,1413535660,1,1,960
55615740@N00,3747,11,1445642067,1445643027,2,5,960
55615740@N00,3747,17,1445644894,1445645472,2,5,578
55615740@N00,3747,13,1445645472,1445646552,3,5,1080
55615740@N00,3747,17,1445646986,1445649686,2,5,2700
55615740@N00,3747,10,1445654304,1445655204,2,5,900
55629006@N02,3748,8,1297230134,1297230974,1,1,840
55629006@N02,3749,10,1299543901,1299544801,1,1,900
55639632@N03,3750,11,1343134575,1343135535,1,1,960
55639632@N03,3751,11,1343290443,1343291403,1,1,960
55664248@N04,3752,11,1288183309,1288184269,1,1,960
55762226@N00,3753,4,1423970671,1423971031,1,1,360
55762226@N00,3754,11,1446859218,1446860178,1,1,960
55818814@N04,3755,5,1313687616,1313688036,1,1,420
55822383@N02,3756,9,1345158263,1345159163,1,1,900
55894487@N00,3757,6,1333797170,1333797890,1,1,720
55991777@N00,3758,9,1433375624,1433376524,2,2,900
55991777@N00,3758,5,1433397699,1433398119,2,2,420
55991777@N00,3759,17,1433650559,1433653259,10,1,2700
56027706@N00,3760,5,1266203243,1266203663,3,5,420
56027706@N00,3760,8,1266203879,1266204719,6,5,840
56027706@N00,3760,13,1266207175,1266207270,2,5,95
56027706@N00,3760,17,1266207270,1266207561,5,5,291
56027706@N00,3760,15,1266207561,1266208761,2,5,1200
56027706@N00,3761,11,1267929376,1267930336,2,3,960
56027706@N00,3761,13,1267933806,1267933817,2,3,11
56027706@N00,3761,10,1267933817,1267934717,5,3,900
56027706@N00,3762,1,1272015287,1272015527,2,2,240
56027706@N00,3762,10,1272016082,1272016982,1,2,900
56027706@N00,3763,13,1274522097,1274523177,2,1,1080
56068273@N06,3764,1,1359671309,1359671549,1,1,240
56074800@N00,3765,11,1378786401,1378786665,4,8,264
56074800@N00,3765,9,1378786665,1378787565,3,8,900
56074800@N00,3765,3,1378792141,1378792471,6,8,330
56074800@N00,3765,7,1378795690,1378796518,2,8,828
56074800@N00,3765,13,1378796518,1378797598,5,8,1080
56074800@N00,3765,12,1378804424,1378805444,10,8,1020
56074800@N00,3765,7,1378806437,1378807277,4,8,840
56074800@N00,3765,11,1378808152,1378809112,4,8,960
56119942@N00,3766,5,1238474586,1238475006,1,1,420
56223610@N07,3767,2,1336024678,1336024918,2,4,240
56223610@N07,3767,12,1336026509,1336027529,2,4,1020
56223610@N07,3767,13,1336033868,1336034611,2,4,743
56223610@N07,3767,10,1336034611,1336035511,3,4,900
56279017@N03,3768,5,1373961192,1373961612,3,2,420
56279017@N03,3768,11,1373967907,1373968867,1,2,960
56279017@N03,3769,4,1374369371,1374369731,1,1,360
56279017@N03,3770,16,1384059997,1384062097,1,1,2100
56414555@N03,3771,11,1311727506,1311728466,3,4,960
56414555@N03,3771,9,1311730749,1311731649,3,4,900
56414555@N03,3771,17,1311736769,1311739469,2,4,2700
56414555@N03,3771,6,1311744734,1311745454,1,4,720
56416261@N00,3772,11,1304048156,1304049116,3,1,960
56525958@N00,3773,4,1214274268,1214274628,3,3,360
56525958@N00,3773,15,1214285116,1214285426,6,3,310
56525958@N00,3773,13,1214285426,1214286506,3,3,1080
56641055@N07,3774,11,1401937983,1401938943,2,1,960
56642201@N00,3775,12,1308463521,1308464541,3,2,1020
56642201@N00,3775,3,1308465105,1308465435,5,2,330
56694207@N02,3776,1,1328585082,1328585322,1,1,240
56726532@N06,3777,10,1419820340,1419821240,1,1,900
56795655@N00,3778,10,1296478800,1296479700,1,1,900
56841131@N00,3779,11,1370219222,1370220182,1,1,960
56909601@N00,3780,12,1271916414,1271916547,9,3,133
56909601@N00,3780,13,1271916547,1271916560,2,3,13
56909601@N00,3780,17,1271916560,1271919260,4,3,2700
56922122@N03,3781,8,1247986452,1247987292,1,1,840
56922122@N03,3782,8,1249102644,1249103484,2,1,840
56922122@N03,3783,8,1277539748,1277540588,1,1,840
56922122@N03,3784,8,1292051625,1292052465,5,1,840
56922122@N03,3785,8,1292564199,1292565039,4,1,840
56922122@N03,3786,1,1299300446,1299300686,3,3,240
56922122@N03,3786,5,1299301260,1299301680,2,3,420
56922122@N03,3786,8,1299303322,1299304162,4,3,840
56922122@N03,3787,8,1301204329,1301205169,2,1,840
56924970@N00,3788,2,1307359282,1307359522,2,2,240
56924970@N00,3788,11,1307371764,1307372724,2,2,960
56972276@N06,3789,6,1246706583,1246707303,1,1,720
57027437@N06,3790,11,1344808557,1344809517,3,7,960
57027437@N06,3790,9,1344811940,1344812840,2,7,900
57027437@N06,3790,14,1344816339,1344817539,2,7,1200
57027437@N06,3790,5,1344821186,1344821606,2,7,420
57027437@N06,3790,8,1344823954,1344824794,3,7,840
57027437@N06,3790,6,1344848849,1344849569,2,7,720
57027437@N06,3790,11,1344851500,1344852460,1,7,960
57099981@N05,3791,11,1314511466,1314512426,1,1,960
57169261@N06,3792,11,1449787401,1449788361,1,1,960
57268629@N00,3793,5,1388458797,1388459217,9,4,420
57268629@N00,3793,8,1388465276,1388466116,5,4,840
57268629@N00,3793,9,1388480273,1388481173,6,4,900
57268629@N00,3793,13,1388486121,1388487201,1,4,1080
57283880@N03,3794,13,1332560100,1332561180,1,1,1080
57284186@N00,3795,11,1285456751,1285457711,1,1,960
57311596@N05,3796,8,1259561988,1259562828,1,1,840
57382802@N04,3797,11,1335745256,1335746216,1,1,960
57487324@N07,3798,11,1352285368,1352286328,1,1,960
57487324@N07,3799,11,1401072570,1401073530,1,1,960
57507580@N00,3800,11,1336352817,1336353777,2,2,960
57507580@N00,3800,9,1336368107,1336369007,1,2,900
57516324@N03,3801,13,1428228594,1428229674,3,1,1080
57518849@N03,3802,11,1335351255,1335352215,1,1,960
57657053@N00,3803,6,1222498374,1222499094,5,1,720
57657053@N00,3804,13,1222997105,1222998185,2,1,1080
57657053@N00,3805,8,1241309982,1241310822,4,2,840
57657053@N00,3805,11,1241325872,1241326832,2,2,960
57657053@N00,3806,5,1243231462,1243231882,1,1,420
57669645@N03,3807,8,1408611940,1408612780,1,1,840
57669645@N03,3808,11,1409065463,1409066423,1,1,960
57736374@N06,3809,11,1444560155,1444561115,1,1,960
57794654@N02,3810,11,1357946399,1357947359,4,1,960
57794654@N02,3811,11,1358041253,1358042213,1,1,960
57799803@N02,3812,3,1393498276,1393498606,1,1,330
57799803@N02,3813,11,1446150657,1446151617,1,1,960
57812277@N05,3814,1,1298619245,1298619485,1,1,240
57812277@N05,3815,4,1374564490,1374564850,1,1,360
57835821@N00,3816,11,1256343988,1256344948,2,3,960
57835821@N00,3816,15,1256360128,1256361328,6,3,1200
57835821@N00,3816,11,1256362547,1256363507,1,3,960
57835821@N00,3817,8,1315731616,1315732456,10,2,840
57835821@N00,3817,13,1315737434,1315738514,4,2,1080
57835821@N00,3818,11,1333172528,1333173488,4,9,960
57835821@N00,3818,7,1333175622,1333175646,2,9,24
57835821@N00,3818,3,1333175646,1333175976,3,9,330
57835821@N00,3818,14,1333176624,1333176789,2,9,165
57835821@N00,3818,3,1333176789,1333177119,3,9,330
57835821@N00,3818,12,1333179137,1333180157,7,9,1020
57835821@N00,3818,16,1333181005,1333183105,4,9,2100
57835821@N00,3818,5,1333184088,1333184508,3,9,420
57835821@N00,3818,8,1333185458,1333186298,11,9,840
57835821@N00,3819,1,1362359787,1362360027,2,2,240
57835821@N00,3819,5,1362360529,1362360949,3,2,420
57835821@N00,3820,11,1394324374,1394325334,2,10,960
57835821@N00,3820,7,1394327408,1394328248,3,10,840
57835821@N00,3820,14,1394328395,1394328548,3,10,153
57835821@N00,3820,3,1394328548,1394328878,3,10,330
57835821@N00,3820,13,1394343466,1394344546,5,10,1080
57835821@N00,3820,17,1394346364,1394348382,2,10,2018
57835821@N00,3820,5,1394348382,1394348802,2,10,420
57835821@N00,3820,16,1394351396,1394353496,4,10,2100
57835821@N00,3820,2,1394355790,1394356030,2,10,240
57835821@N00,3820,11,1394357559,1394358519,3,10,960
57881215@N00,3821,4,1246266273,1246266633,8,1,360
57881215@N00,3822,4,1247712836,1247713196,1,1,360
57915028@N00,3823,11,1357522506,1357523466,3,1,960
57915028@N00,3824,1,1357681803,1357682043,1,1,240
57915028@N00,3825,11,1357938486,1357939446,1,1,960
57959349@N00,3826,11,1349068272,1349069232,1,1,960
58013444@N04,3827,8,1285651224,1285652064,1,1,840
58072194@N08,3828,11,1381443689,1381444649,2,3,960
58072194@N08,3828,10,1381462856,1381463756,2,3,900
58072194@N08,3828,8,1381470790,1381471630,5,3,840
58165404@N05,3829,11,1361265534,1361266494,1,1,960
58210261@N05,3830,5,1316408056,1316408476,1,1,420
58228008@N00,3831,11,1385244581,1385245541,3,7,960
58228008@N00,3831,2,1385250589,1385250829,9,7,240
58228008@N00,3831,13,1385263420,1385264304,5,7,884
58228008@N00,3831,17,1385264304,1385264563,4,7,259
58228008@N00,3831,10,1385264563,1385265463,3,7,900
58228008@N00,3831,17,1385278900,1385281600,3,7,2700
58228008@N00,3831,8,1385282301,1385283141,1,7,840
58289459@N00,3832,8,1226107809,1226108649,1,1,840
58391963@N02,3833,2,1405988438,1405988678,2,2,240
58391963@N02,3833,9,1406006940,1406007840,1,2,900
58428496@N08,3834,11,1288434786,1288435746,1,1,960
58479263@N00,3835,6,1350990093,1350990813,1,1,720
58512585@N00,3836,3,1415747743,1415748073,3,4,330
58512585@N00,3836,2,1415753699,1415753939,2,4,240
58512585@N00,3836,5,1415760479,1415760899,4,4,420
58512585@N00,3836,17,1415780345,1415783045,4,4,2700
58556078@N00,3837,11,1322205320,1322206280,1,1,960
58588822@N00,3838,11,1460659316,1460660276,1,1,960
58597001@N08,3839,8,1334991367,1334992207,2,1,840
58755999@N05,3840,11,1400547028,1400547988,2,1,960
58755999@N05,3841,17,1400743772,1400746472,4,1,2700
58773023@N00,3842,11,1369640939,1369641899,1,1,960
58887120@N00,3843,17,1330144470,1330147170,1,1,2700
58953549@N05,3844,11,1332731009,1332731969,2,5,960
58953549@N05,3844,4,1332744873,1332745233,2,5,360
58953549@N05,3844,14,1332766893,1332768093,4,5,1200
58953549@N05,3844,3,1332769426,1332769438,2,5,12
58953549@N05,3844,14,1332769438,1332770638,2,5,1200
59045021@N06,3845,13,1288404975,1288406055,1,1,1080
59071486@N00,3846,11,1338269734,1338270694,1,1,960
59071486@N00,3847,11,1358660694,1358661156,2,3,462
59071486@N00,3847,1,1358661156,1358661396,2,3,240
59071486@N00,3847,11,1358663027,1358663987,2,3,960
59071486@N00,3848,11,1363397396,1363398356,2,1,960
59071486@N00,3849,11,1366703383,1366704343,1,1,960
59071486@N00,3850,11,1382766893,1382767853,1,1,960
59071486@N00,3851,15,1383554826,1383556026,1,1,1200
59071486@N00,3852,13,1419404041,1419405121,3,1,1080
59288549@N02,3853,2,1347179454,1347179694,2,4,240
59288549@N02,3853,5,1347186666,1347187086,2,4,420
59288549@N02,3853,8,1347187618,1347188458,2,4,840
59288549@N02,3853,17,1347191026,1347193726,1,4,2700
59288549@N02,3854,11,1347512013,1347512973,3,3,960
59288549@N02,3854,5,1347518796,1347519216,2,3,420
59288549@N02,3854,8,1347519274,1347520114,3,3,840
59288549@N02,3855,8,1368084840,1368085680,2,4,840
59288549@N02,3855,10,1368095698,1368096151,2,4,453
59288549@N02,3855,17,1368096151,1368096455,2,4,304
59288549@N02,3855,15,1368096455,1368097655,1,4,1200
59364175@N00,3856,1,1330146438,1330146678,2,1,240
59390981@N04,3857,11,1309660532,1309660969,3,7,437
59390981@N04,3857,7,1309660969,1309661587,3,7,618
59390981@N04,3857,14,1309661587,1309662787,3,7,1200
59390981@N04,3857,2,1309663265,1309663505,3,7,240
59390981@N04,3857,4,1309663674,1309664034,3,7,360
59390981@N04,3857,11,1309666198,1309667158,3,7,960
59390981@N04,3857,1,1309672863,1309673103,1,7,240
59390981@N04,3858,11,1309738289,1309739249,2,7,960
59390981@N04,3858,1,1309741059,1309741299,2,7,240
59390981@N04,3858,6,1309747397,1309748117,6,7,720
59390981@N04,3858,10,1309754105,1309755005,3,7,900
59390981@N04,3858,5,1309756796,1309757046,2,7,250
59390981@N04,3858,8,1309757046,1309757886,2,7,840
59390981@N04,3858,17,1309771958,1309774658,1,7,2700
59390981@N04,3859,5,1309840289,1309840709,3,2,420
59390981@N04,3859,8,1309842227,1309843067,1,2,840
59390981@N04,3860,9,1310115856,1310116756,3,2,900
59390981@N04,3860,1,1310117301,1310117541,5,2,240
59390981@N04,3861,8,1310207693,1310208533,20,1,840
59471679@N04,3862,11,1404436704,1404437664,2,1,960
59471679@N04,3863,10,1406193065,1406193965,1,1,900
59471679@N04,3864,16,1419063873,1419065973,2,2,2100
59471679@N04,3864,13,1419073830,1419074910,1,2,1080
59471679@N04,3865,11,1425357271,1425358231,2,1,960
59471679@N04,3866,8,1426295769,1426296609,3,3,840
59471679@N04,3866,13,1426296951,1426298031,2,3,1080
59471679@N04,3866,11,1426302586,1426303546,1,3,960
59471679@N04,3867,5,1428039798,1428040218,1,1,420
59471679@N04,3868,13,1431821011,1431822091,1,1,1080
59471679@N04,3869,2,1432709169,1432709409,1,1,240
59513859@N00,3870,10,1316826768,1316827668,2,2,900
59513859@N00,3870,13,1316829105,1316830185,1,2,1080
59566971@N00,3871,11,1339795335,1339796295,1,1,960
59662848@N00,3872,11,1444951476,1444952277,2,2,801
59662848@N00,3872,1,1444952277,1444952517,4,2,240
59662848@N00,3873,11,1444988416,1444989376,3,1,960
59669438@N05,3874,11,1311387853,1311388813,5,1,960
59669438@N05,3875,11,1311827304,1311828055,2,2,751
59669438@N05,3875,9,1311828055,1311828955,1,2,900
59669438@N05,3876,11,1353379776,1353380736,1,1,960
59679150@N00,3877,11,1330748802,1330749762,1,1,960
59682384@N03,3878,2,1378771511,1378771751,1,1,240
59733720@N00,3879,11,1352005390,1352006350,1,1,960
59782551@N00,3880,11,1206768834,1206769794,1,1,960
59794429@N07,3881,11,1369133839,1369134799,1,1,960
59805227@N03,3882,11,1300422733,1300423693,1,1,960
59823861@N06,3883,5,1287048312,1287048732,2,2,420
59823861@N06,3883,8,1287050372,1287051212,1,2,840
59887649@N03,3884,11,1376938889,1376939849,1,1,960
59888795@N03,3885,11,1253056464,1253057424,1,1,960
59888795@N03,3886,14,1253147922,1253149122,2,2,1200
59888795@N03,3886,3,1253158722,1253159052,1,2,330
59888795@N03,3887,6,1309749348,1309750068,2,1,720
59888795@N03,3888,4,1309816218,1309816578,2,4,360
59888795@N03,3888,17,1309817321,1309818106,2,4,785
59888795@N03,3888,15,1309818106,1309818196,3,4,90
59888795@N03,3888,13,1309818196,1309819276,3,4,1080
59888795@N03,3889,11,1309847989,1309848949,1,1,960
59888795@N03,3890,5,1310005029,1310005449,1,1,420
59888795@N03,3891,15,1379373639,1379373956,2,6,317
59888795@N03,3891,10,1379373956,1379374856,2,6,900
59888795@N03,3891,5,1379381657,1379381790,2,6,133
59888795@N03,3891,11,1379381790,1379382750,2,6,960
59888795@N03,3891,17,1379385227,1379385733,2,6,506
59888795@N03,3891,13,1379385733,1379386813,1,6,1080
59888795@N03,3892,8,1379487541,1379488381,1,1,840
59888795@N03,3893,8,1379632501,1379632720,2,2,219
59888795@N03,3893,17,1379632720,1379635420,1,2,2700
59888795@N03,3894,13,1379716000,1379716503,2,6,503
59888795@N03,3894,15,1379716503,1379716708,3,6,205
59888795@N03,3894,17,1379716708,1379717164,2,6,456
59888795@N03,3894,4,1379717164,1379717524,2,6,360
59888795@N03,3894,17,1379718397,1379719223,2,6,826
59888795@N03,3894,13,1379719223,1379720303,1,6,1080
59888795@N03,3895,5,1379895014,1379895434,2,1,420
59888795@N03,3896,5,1431749892,1431750312,2,2,420
59888795@N03,3896,13,1431772566,1431773646,4,2,1080
59888795@N03,3897,17,1431814907,1431815134,3,3,227
59888795@N03,3897,15,1431815134,1431815398,2,3,264
59888795@N03,3897,10,1431815398,1431816298,1,3,900
59888795@N03,3898,14,1432003035,1432004235,1,1,1200
59888795@N03,3899,13,1432117883,1432118963,1,1,1080
59888795@N03,3900,13,1432164197,1432165277,3,2,1080
59888795@N03,3900,15,1432165732,1432166932,1,2,1200
59888866@N00,3901,11,1216948033,1216948993,25,1,960
59888866@N00,3902,11,1286413456,1286413997,2,6,541
59888866@N00,3902,16,1286413997,1286414326,2,6,329
59888866@N00,3902,9,1286414326,1286415052,5,6,726
59888866@N00,3902,10,1286415052,1286415952,5,6,900
59888866@N00,3902,13,1286416004,1286417084,4,6,1080
59888866@N00,3902,5,1286437708,1286438128,4,6,420
59888866@N00,3903,11,1317341548,1317342508,2,5,960
59888866@N00,3903,16,1317343135,1317345235,2,5,2100
59888866@N00,3903,9,1317346722,1317347357,2,5,635
59888866@N00,3903,10,1317347357,1317348257,2,5,900
59888866@N00,3903,17,1317359505,1317362205,1,5,2700
59888866@N00,3904,11,1358060807,1358061767,2,2,960
59888866@N00,3904,1,1358069314,1358069554,1,2,240
59888866@N00,3905,15,1363586092,1363587292,2,2,1200
59888866@N00,3905,11,1363591579,1363592539,1,2,960
59888866@N00,3906,11,1369970387,1369971347,1,1,960
59888866@N00,3907,11,1377399343,1377400303,1,1,960
59888866@N00,3908,11,1380356379,1380357339,2,1,960
59888866@N00,3909,3,1383964601,1383964931,1,1,330
59888866@N00,3910,8,1386380287,1386381127,1,1,840
59888866@N00,3911,11,1388394215,1388395175,1,1,960
59983818@N06,3912,16,1366431011,1366431202,2,7,191
59983818@N06,3912,9,1366431202,1366432102,2,7,900
59983818@N06,3912,17,1366432811,1366434343,2,7,1532
59983818@N06,3912,13,1366434343,1366435423,3,7,1080
59983818@N06,3912,11,1366448300,1366449260,2,7,960
59983818@N06,3912,1,1366450069,1366450309,2,7,240
59983818@N06,3912,2,1366451259,1366451499,1,7,240
59983818@N06,3913,1,1366532528,1366532768,4,2,240
59983818@N06,3913,11,1366542012,1366542972,1,2,960
60016896@N06,3914,11,1321091565,1321092525,1,1,960
60054626@N00,3915,4,1196331846,1196331855,2,3,9
60054626@N00,3915,3,1196331855,1196331859,2,3,4
60054626@N00,3915,9,1196331859,1196332759,2,3,900
60054626@N00,3916,11,1201911849,1201912809,12,8,960
60054626@N00,3916,9,1201921419,1201922319,7,8,900
60054626@N00,3916,5,1201924905,1201925325,4,8,420
60054626@N00,3916,1,1201927229,1201927469,8,8,240
60054626@N00,3916,4,1201932340,1201932700,2,8,360
60054626@N00,3916,2,1201932775,1201933015,3,8,240
60054626@N00,3916,3,1201933997,1201934327,3,8,330
60054626@N00,3916,2,1201939342,1201939582,3,8,240
60054626@N00,3917,11,1245830678,1245831638,4,1,960
60054626@N00,3918,11,1245929505,1245930465,2,1,960
60054626@N00,3919,11,1246182000,1246182960,2,1,960
60054626@N00,3920,13,1246239597,1246240677,6,6,1080
60054626@N00,3920,5,1246249465,1246249885,2,6,420
60054626@N00,3920,11,1246256863,1246257823,6,6,960
60054626@N00,3920,17,1246259057,1246261757,3,6,2700
60054626@N00,3920,15,1246266484,1246267684,4,6,1200
60054626@N00,3920,13,1246267837,1246268917,1,6,1080
60054626@N00,3921,11,1431938997,1431939957,4,5,960
60054626@N00,3921,1,1431940423,1431940663,10,5,240
60054626@N00,3921,2,1431943445,1431943685,3,5,240
60054626@N00,3921,12,1431944740,1431945760,2,5,1020
60054626@N00,3921,7,1431946651,1431947491,4,5,840
60054626@N00,3922,11,1432169792,1432170752,20,11,960
60054626@N00,3922,16,1432173417,1432174997,3,11,1580
60054626@N00,3922,9,1432174997,1432175206,2,11,209
60054626@N00,3922,16,1432175206,1432175673,2,11,467
60054626@N00,3922,9,1432175673,1432176573,5,11,900
60054626@N00,3922,4,1432180153,1432180513,13,11,360
60054626@N00,3922,1,1432184286,1432184526,6,11,240
60054626@N00,3922,14,1432187555,1432188755,2,11,1200
60054626@N00,3922,17,1432190917,1432191121,2,11,204
60054626@N00,3922,15,1432191121,1432192321,2,11,1200
60054626@N00,3922,5,1432194679,1432195099,11,11,420
60054626@N00,3923,6,1432256408,1432257128,3,3,720
60054626@N00,3923,4,1432268408,1432268768,2,3,360
60054626@N00,3923,7,1432271214,1432272054,1,3,840
60082453@N05,3924,11,1429051769,1429052729,4,7,960
60082453@N05,3924,9,1429054096,1429054996,2,7,900
60082453@N05,3924,13,1429056110,1429057190,2,7,1080
60082453@N05,3924,8,1429065402,1429066242,2,7,840
60082453@N05,3924,5,1429066436,1429066856,2,7,420
60082453@N05,3924,15,1429077440,1429078640,4,7,1200
60082453@N05,3924,11,1429092938,1429093898,2,7,960
60220094@N07,3925,10,1388197317,1388198121,2,4,804
60220094@N07,3925,15,1388198121,1388199321,2,4,1200
60220094@N07,3925,13,1388200461,1388201541,4,4,1080
60220094@N07,3925,5,1388224989,1388225409,1,4,420
60259592@N03,3926,4,1275314400,1275314760,1,1,360
60272404@N06,3927,8,1409562152,1409562992,1,1,840
60296398@N02,3928,11,1317034809,1317035769,1,1,960
60309882@N00,3929,7,1244374617,1244375457,4,1,840
60385541@N00,3930,11,1380881581,1380882541,2,1,960
60385541@N00,3931,4,1381022957,1381023317,2,2,360
60385541@N00,3931,9,1381027407,1381028307,2,2,900
60385541@N00,3932,11,1412319942,1412320902,2,1,960
60401103@N04,3933,8,1262909714,1262910554,3,4,840
60401103@N04,3933,15,1262924799,1262924805,2,4,6
60401103@N04,3933,17,1262924805,1262924898,2,4,93
60401103@N04,3933,15,1262924898,1262926098,1,4,1200
60474597@N06,3934,11,1340298074,1340299034,1,1,960
60481456@N00,3935,11,1387487412,1387488372,3,2,960
60481456@N00,3935,3,1387489137,1387489467,1,2,330
60504322@N04,3936,11,1372471200,1372472160,19,1,960
60567550@N07,3937,11,1445678572,1445679532,1,1,960
60576452@N08,3938,11,1362520633,1362521593,2,1,960
60628701@N00,3939,11,1417126883,1417127843,1,1,960
60657104@N00,3940,1,1421221711,1421221951,1,1,240
60657104@N00,3941,5,1421291258,1421291678,2,2,420
60657104@N00,3941,11,1421292884,1421293844,1,2,960
60804222@N05,3942,11,1355779675,1355780635,2,13,960
60804222@N05,3942,5,1355781406,1355781826,2,13,420
60804222@N05,3942,8,1355784306,1355785146,17,13,840
60804222@N05,3942,13,1355795954,1355796775,6,13,821
60804222@N05,3942,17,1355796775,1355796789,2,13,14
60804222@N05,3942,15,1355796789,1355796868,4,13,79
60804222@N05,3942,17,1355796868,1355797256,13,13,388
60804222@N05,3942,10,1355797256,1355798156,4,13,900
60804222@N05,3942,11,1355798176,1355799136,6,13,960
60804222@N05,3942,9,1355819234,1355820134,4,13,900
60804222@N05,3942,2,1355821879,1355822119,7,13,240
60804222@N05,3942,15,1355824990,1355826190,2,13,1200
60804222@N05,3942,17,1355826713,1355829413,3,13,2700
60883477@N00,3943,10,1364720680,1364721580,1,1,900
60897658@N00,3944,5,1211001281,1211001701,2,2,420
60897658@N00,3944,12,1211013121,1211014141,2,2,1020
60956197@N08,3945,8,1451788657,1451789497,2,1,840
60981140@N03,3946,10,1386298131,1386299031,1,1,900
61083754@N04,3947,11,1199403584,1199404544,3,2,960
61083754@N04,3947,5,1199406113,1199406533,2,2,420
61083754@N04,3948,11,1252971685,1252972645,7,6,960
61083754@N04,3948,2,1252975620,1252975860,30,6,240
61083754@N04,3948,9,1252990108,1252991008,3,6,900
61083754@N04,3948,4,1252998422,1252998782,8,6,360
61083754@N04,3948,5,1253002681,1253003101,4,6,420
61083754@N04,3948,15,1253008302,1253009502,2,6,1200
61083754@N04,3949,5,1253084472,1253084892,6,1,420
61083754@N04,3950,11,1254617593,1254617827,6,2,234
61083754@N04,3950,5,1254617827,1254618247,1,2,420
61083754@N04,3951,16,1301999168,1302001268,1,1,2100
61102903@N02,3952,11,1347020722,1347021682,1,1,960
61102903@N02,3953,4,1362452480,1362452840,1,1,360
61102903@N02,3954,11,1454628981,1454629254,2,2,273
61102903@N02,3954,4,1454629254,1454629614,1,2,360
61102903@N02,3955,15,1458891998,1458893198,2,2,1200
61102903@N02,3955,11,1458899634,1458900594,1,2,960
61102903@N02,3956,11,1458947437,1458948397,1,1,960
61102903@N02,3957,11,1466215249,1466216209,1,1,960
61104413@N00,3958,11,1344280006,1344280966,2,3,960
61104413@N00,3958,5,1344292594,1344293014,4,3,420
61104413@N00,3958,8,1344296640,1344297480,2,3,840
61149901@N06,3959,11,1386470829,1386471789,1,1,960
61176951@N00,3960,11,1344062853,1344063813,1,1,960
61198674@N00,3961,15,1311284389,1311285589,2,8,1200
61198674@N00,3961,9,1311287600,1311288500,3,8,900
61198674@N00,3961,1,1311290285,1311290525,4,8,240
61198674@N00,3961,16,1311292359,1311294459,2,8,2100
61198674@N00,3961,9,1311296607,1311297507,2,8,900
61198674@N00,3961,17,1311304091,1311304870,3,8,779
61198674@N00,3961,15,1311304870,1311306070,2,8,1200
61198674@N00,3961,8,1311316951,1311317791,1,8,840
61207928@N04,3962,11,1436148958,1436149918,1,1,960
61261095@N02,3963,17,1298172186,1298174886,1,1,2700
61261095@N02,3964,11,1302675962,1302676922,1,1,960
61261095@N02,3965,9,1334136357,1334137257,1,1,900
61261095@N02,3966,6,1336734673,1336735393,3,1,720
61261095@N02,3967,5,1341396127,1341396547,1,1,420
61285553@N00,3968,5,1196823736,1196824156,9,3,420
61285553@N00,3968,8,1196831768,1196832608,7,3,840
61285553@N00,3968,13,1196855030,1196856110,20,3,1080
61285553@N00,3969,3,1197005076,1197005406,21,7,330
61285553@N00,3969,2,1197005931,1197006171,4,7,240
61285553@N00,3969,12,1197007149,1197008169,29,7,1020
61285553@N00,3969,2,1197011355,1197011595,2,7,240
61285553@N00,3969,4,1197012794,1197013154,4,7,360
61285553@N00,3969,16,1197016279,1197018379,2,7,2100
61285553@N00,3969,11,1197034986,1197035946,2,7,960
61388024@N08,3970,1,1376368773,1376369013,2,1,240
61415829@N08,3971,13,1430379125,1430380205,1,1,1080
61525316@N06,3972,11,1356548145,1356549105,1,1,960
61554297@N00,3973,10,1188876962,1188877862,1,1,900
61581248@N04,3974,11,1388439543,1388440503,1,1,960
61644290@N00,3975,9,1286668859,1286669759,3,1,900
61644290@N00,3976,5,1326671058,1326671478,1,1,420
61644290@N00,3977,11,1358232714,1358233674,1,1,960
61658419@N00,3978,11,1335189602,1335190562,18,1,960
61658419@N00,3979,11,1335233301,1335233301,8,3,0
61658419@N00,3979,17,1335233301,1335233356,13,3,55
61658419@N00,3979,11,1335233356,1335234316,9,3,960
61658419@N00,3980,17,1349914796,1349917496,31,4,2700
61658419@N00,3980,11,1349924852,1349924885,2,4,33
61658419@N00,3980,17,1349924885,1349926572,6,4,1687
61658419@N00,3980,11,1349926572,1349927532,1,4,960
61658419@N00,3981,17,1350392400,1350395100,17,1,2700
61756292@N00,3982,11,1358464848,1358465808,1,1,960
61802935@N08,3983,2,1345086817,1345087057,1,1,240
61826063@N00,3984,11,1316209856,1316210360,4,10,504
61826063@N00,3984,1,1316210360,1316210600,5,10,240
61826063@N00,3984,9,1316212104,1316213004,4,10,900
61826063@N00,3984,5,1316214568,1316214988,6,10,420
61826063@N00,3984,8,1316215942,1316216782,15,10,840
61826063@N00,3984,13,1316223062,1316224142,6,10,1080
61826063@N00,3984,17,1316224994,1316226132,10,10,1138
61826063@N00,3984,10,1316226132,1316226820,3,10,688
61826063@N00,3984,7,1316226820,1316227660,4,10,840
61826063@N00,3984,17,1316230632,1316233332,3,10,2700
61897832@N00,3985,11,1260382120,1260383080,16,1,960
61897832@N00,3986,11,1260704480,1260705440,58,1,960
61897832@N00,3987,11,1266068405,1266069365,1,1,960
61897832@N00,3988,11,1292109369,1292110329,59,1,960
61897832@N00,3989,11,1294091156,1294092116,3,1,960
61905010@N03,3990,11,1411187782,1411188742,2,3,960
61905010@N03,3990,8,1411196887,1411197727,2,3,840
61905010@N03,3990,17,1411203062,1411205762,1,3,2700
61938758@N08,3991,1,1357526960,1357527200,1,1,240
61990140@N04,3992,11,1353763162,1353764122,7,1,960
62065836@N00,3993,4,1301036735,1301036988,2,2,253
62065836@N00,3993,11,1301036988,1301037948,4,2,960
62082433@N05,3994,5,1320636865,1320637285,1,1,420
62102776@N02,3995,11,1376002616,1376003576,1,1,960
62102776@N02,3996,11,1376092392,1376093352,1,1,960
62102776@N02,3997,11,1376350573,1376351533,1,1,960
62102776@N02,3998,1,1376550202,1376550442,1,1,240
62102776@N02,3999,11,1376877238,1376878198,1,1,960
62102776@N02,4000,11,1378096065,1378097025,1,1,960
62102776@N02,4001,11,1378466950,1378467910,1,1,960
62121361@N03,4002,11,1308055823,1308056783,2,3,960
62121361@N03,4002,2,1308078261,1308078501,3,3,240
62121361@N03,4002,4,1308079694,1308080054,1,3,360
62121361@N03,4003,11,1309112956,1309113916,1,1,960
62121361@N03,4004,2,1407818026,1407818266,2,3,240
62121361@N03,4004,4,1407818560,1407818920,2,3,360
62121361@N03,4004,11,1407836789,1407837749,1,3,960
62205900@N00,4005,3,1268425551,1268425881,2,16,330
62205900@N00,4005,1,1268426541,1268426629,2,16,88
62205900@N00,4005,9,1268426629,1268427529,3,16,900
62205900@N00,4005,16,1268428195,1268429900,8,16,1705
62205900@N00,4005,11,1268429900,1268430860,3,16,960
62205900@N00,4005,4,1268432971,1268433331,2,16,360
62205900@N00,4005,10,1268433501,1268433644,3,16,143
62205900@N00,4005,17,1268433644,1268434323,6,16,679
62205900@N00,4005,13,1268434323,1268435403,26,16,1080
62205900@N00,4005,8,1268443771,1268444611,6,16,840
62205900@N00,4005,5,1268444874,1268445294,3,16,420
62205900@N00,4005,16,1268446231,1268446949,2,16,718
62205900@N00,4005,11,1268446949,1268447909,7,16,960
62205900@N00,4005,7,1268462455,1268463295,2,16,840
62205900@N00,4005,2,1268463591,1268463791,2,16,200
62205900@N00,4005,4,1268463791,1268464151,1,16,360
62205900@N00,4006,2,1269033410,1269033650,8,4,240
62205900@N00,4006,16,1269038492,1269040592,4,4,2100
62205900@N00,4006,8,1269043648,1269044488,8,4,840
62205900@N00,4006,1,1269049233,1269049473,2,4,240
62208823@N00,4007,11,1286579880,1286580840,1,1,960
62208823@N00,4008,3,1332570447,1332570777,1,1,330
62213164@N00,4009,11,1188772683,1188773643,2,6,960
62213164@N00,4009,14,1188777792,1188778992,6,6,1200
62213164@N00,4009,2,1188780164,1188780404,9,6,240
62213164@N00,4009,16,1188787266,1188789366,2,6,2100
62213164@N00,4009,1,1188790800,1188791040,7,6,240
62213164@N00,4009,11,1188794328,1188795288,3,6,960
62213164@N00,4010,11,1222552462,1222553422,3,5,960
62213164@N00,4010,13,1222572700,1222573780,5,5,1080
62213164@N00,4010,10,1222578974,1222579874,2,5,900
62213164@N00,4010,11,1222582020,1222582980,4,5,960
62213164@N00,4010,17,1222596067,1222598767,13,5,2700
62221880@N00,4011,17,1307482433,1307485133,5,1,2700
62221880@N00,4012,11,1307519421,1307520381,2,1,960
62236593@N04,4013,2,1366955250,1366955490,2,2,240
62236593@N04,4013,15,1366965921,1366967121,1,2,1200
62236593@N04,4014,13,1385605298,1385606378,1,1,1080
62236593@N04,4015,11,1416901734,1416902694,1,1,960
62236593@N04,4016,9,1417081032,1417081932,1,1,900
62236593@N04,4017,5,1417160387,1417160807,1,1,420
62242291@N04,4018,8,1358157255,1358158095,1,1,840
62256889@N05,4019,8,1358736761,1358737601,1,1,840
62307685@N02,4020,17,1437457638,1437460338,2,2,2700
62307685@N02,4020,5,1437472407,1437472827,1,2,420
62340971@N04,4021,13,1372572401,1372573481,1,1,1080
62372928@N03,4022,11,1256187318,1256188278,1,1,960
62372928@N03,4023,11,1368829675,1368830635,3,1,960
62372928@N03,4024,11,1368912843,1368913803,1,1,960
62372928@N03,4025,11,1369025627,1369026587,2,2,960
62372928@N03,4025,17,1369044251,1369046951,1,2,2700
62396405@N03,4026,17,1350044773,1350047473,1,1,2700
62460908@N07,4027,11,1351054355,1351055315,1,1,960
62540752@N06,4028,2,1322185010,1322185250,1,1,240
62595633@N06,4029,11,1370387319,1370388183,2,12,864
62595633@N06,4029,9,1370388183,1370389083,4,12,900
62595633@N06,4029,16,1370391331,1370393431,4,12,2100
62595633@N06,4029,4,1370396058,1370396418,3,12,360
62595633@N06,4029,2,1370400344,1370400584,6,12,240
62595633@N06,4029,3,1370405614,1370405944,2,12,330
62595633@N06,4029,5,1370409277,1370409546,3,12,269
62595633@N06,4029,8,1370409546,1370410386,3,12,840
62595633@N06,4029,13,1370418049,1370418600,7,12,551
62595633@N06,4029,17,1370418600,1370418993,6,12,393
62595633@N06,4029,10,1370418993,1370419893,6,12,900
62595633@N06,4029,11,1370424187,1370425147,3,12,960
62598671@N04,4030,11,1210746924,1210747884,1,1,960
62623118@N03,4031,11,1372158650,1372159610,1,1,960
62624768@N02,4032,11,1257552660,1257553620,1,1,960
62624768@N02,4033,16,1352588548,1352590648,1,1,2100
62624768@N02,4034,11,1352672917,1352673877,2,2,960
62624768@N02,4034,4,1352675108,1352675468,1,2,360
62704710@N03,4035,4,1348461533,1348461893,1,1,360
62704710@N03,4036,13,1350362495,1350363575,1,1,1080
62704710@N03,4037,8,1350991846,1350992686,1,1,840
62704710@N03,4038,1,1362740263,1362740503,1,1,240
62704710@N03,4039,17,1363247765,1363250465,1,1,2700
62704710@N03,4040,8,1363324615,1363325455,1,1,840
62705831@N05,4041,5,1259026850,1259027270,3,4,420
62705831@N05,4041,8,1259028260,1259029100,2,4,840
62705831@N05,4041,13,1259037055,1259038135,2,4,1080
62705831@N05,4041,17,1259038166,1259040866,1,4,2700
62731305@N00,4042,3,1233257956,1233258286,1,1,330
62783804@N05,4043,8,1290070476,1290071316,2,2,840
62783804@N05,4043,11,1290073382,1290074342,1,2,960
62783804@N05,4044,8,1319763468,1319764308,1,1,840
62783804@N05,4045,14,1357462013,1357463213,1,1,1200
62823285@N00,4046,11,1311241214,1311242174,1,1,960
62864067@N00,4047,5,1389772740,1389773160,1,1,420
62950363@N05,4048,11,1386319363,1386320323,2,1,960
62950363@N05,4049,11,1386349247,1386350207,1,1,960
62975060@N07,4050,11,1382539096,1382540056,1,1,960
62975060@N07,4051,11,1382871949,1382872909,1,1,960
62975060@N07,4052,13,1382965465,1382966545,1,1,1080
62975889@N00,4053,8,1358044954,1358045794,1,1,840
63051331@N00,4054,11,1225397448,1225398408,1,1,960
63084736@N00,4055,11,1438471882,1438472842,2,4,960
63084736@N00,4055,1,1438477189,1438477429,3,4,240
63084736@N00,4055,9,1438491767,1438492667,2,4,900
63084736@N00,4055,1,1438493321,1438493561,4,4,240
63084736@N00,4056,1,1438564678,1438564918,3,2,240
63084736@N00,4056,11,1438567796,1438568756,1,2,960
63193209@N04,4057,10,1305066103,1305067003,1,1,900
63202442@N00,4058,17,1201254388,1201257088,1,1,2700
63202442@N00,4059,11,1220598195,1220599155,2,1,960
63202442@N00,4060,2,1220686117,1220686357,5,2,240
63202442@N00,4060,7,1220689760,1220690600,1,2,840
63202442@N00,4061,11,1221095354,1221096314,1,1,960
63202442@N00,4062,4,1221198853,1221199213,3,2,360
63202442@N00,4062,8,1221212987,1221213827,1,2,840
63202442@N00,4063,11,1221278669,1221279629,2,1,960
63202442@N00,4064,3,1264833470,1264833800,2,6,330
63202442@N00,4064,4,1264834507,1264834867,2,6,360
63202442@N00,4064,10,1264835084,1264835984,2,6,900
63202442@N00,4064,8,1264845579,1264846223,2,6,644
63202442@N00,4064,5,1264846223,1264846643,2,6,420
63202442@N00,4064,11,1264848415,1264849375,3,6,960
63202442@N00,4065,1,1264976584,1264976824,2,3,240
63202442@N00,4065,3,1264987531,1264987861,3,3,330
63202442@N00,4065,2,1264991654,1264991894,2,3,240
63202442@N00,4066,1,1265239330,1265239570,2,4,240
63202442@N00,4066,5,1265241391,1265241811,2,4,420
63202442@N00,4066,8,1265243354,1265244194,2,4,840
63202442@N00,4066,9,1265246700,1265247600,1,4,900
63202442@N00,4067,15,1291627550,1291628750,2,1,1200
63202442@N00,4068,7,1291756145,1291756985,2,2,840
63202442@N00,4068,12,1291757251,1291758271,1,2,1020
63257911@N00,4069,11,1212813780,1212814740,9,6,960
63257911@N00,4069,9,1212816323,1212816633,2,6,310
63257911@N00,4069,11,1212816633,1212817593,2,6,960
63257911@N00,4069,4,1212825839,1212826199,7,6,360
63257911@N00,4069,5,1212835709,1212835980,2,6,271
63257911@N00,4069,11,1212835980,1212836940,1,6,960
63257911@N00,4070,11,1229054450,1229055410,22,5,960
63257911@N00,4070,5,1229057425,1229057845,17,5,420
63257911@N00,4070,6,1229068849,1229069569,9,5,720
63257911@N00,4070,9,1229073164,1229074064,5,5,900
63257911@N00,4070,11,1229075723,1229076683,5,5,960
63257911@N00,4071,4,1229241568,1229241928,15,4,360
63257911@N00,4071,5,1229243239,1229243659,2,4,420
63257911@N00,4071,8,1229247588,1229248428,2,4,840
63257911@N00,4071,11,1229248609,1229249569,11,4,960
63257911@N00,4072,2,1277536703,1277536943,9,3,240
63257911@N00,4072,5,1277542287,1277542707,3,3,420
63257911@N00,4072,8,1277547038,1277547878,2,3,840
63257911@N00,4073,11,1277637139,1277638099,2,1,960
63257911@N00,4074,9,1277868545,1277869445,1,1,900
63257911@N00,4075,9,1308909762,1308910662,1,1,900
63287267@N00,4076,11,1332635152,1332636112,2,1,960
63287267@N00,4077,16,1332996149,1332998249,1,1,2100
63287402@N00,4078,1,1257549517,1257549757,3,4,240
63287402@N00,4078,11,1257552474,1257553434,3,4,960
63287402@N00,4078,6,1257560349,1257561069,2,4,720
63287402@N00,4078,5,1257564781,1257565201,1,4,420
63287402@N00,4079,1,1272238100,1272238340,3,4,240
63287402@N00,4079,5,1272240193,1272240613,2,4,420
63287402@N00,4079,8,1272244082,1272244922,2,4,840
63287402@N00,4079,12,1272247086,1272248106,1,4,1020
63287402@N00,4080,14,1272336715,1272337031,2,3,316
63287402@N00,4080,3,1272337031,1272337361,2,3,330
63287402@N00,4080,13,1272359655,1272360735,1,3,1080
63287402@N00,4081,7,1272437256,1272438096,2,2,840
63287402@N00,4081,5,1272440133,1272440553,1,2,420
63287402@N00,4082,5,1272522762,1272523182,2,3,420
63287402@N00,4082,1,1272523219,1272523459,2,3,240
63287402@N00,4082,11,1272530707,1272531667,1,3,960
63287402@N00,4083,12,1289175561,1289176581,3,2,1020
63287402@N00,4083,8,1289182875,1289183715,1,2,840
63287402@N00,4084,10,1289286371,1289286671,2,2,300
63287402@N00,4084,17,1289286671,1289289371,1,2,2700
63287402@N00,4085,5,1289526014,1289526434,2,2,420
63287402@N00,4085,15,1289531709,1289532909,1,2,1200
63287402@N00,4086,14,1291934953,1291935599,2,4,646
63287402@N00,4086,3,1291935599,1291935865,2,4,266
63287402@N00,4086,2,1291935865,1291936105,2,4,240
63287402@N00,4086,12,1291936702,1291937722,1,4,1020
63287402@N00,4087,11,1301629511,1301630471,2,5,960
63287402@N00,4087,14,1301631489,1301632689,2,5,1200
63287402@N00,4087,3,1301635306,1301635636,2,5,330
63287402@N00,4087,5,1301637542,1301637962,2,5,420
63287402@N00,4087,1,1301641405,1301641645,1,5,240
63287402@N00,4088,11,1303983002,1303983962,1,1,960
63287402@N00,4089,8,1306976109,1306976109,2,2,0
63287402@N00,4089,10,1306976109,1306977009,1,2,900
63287402@N00,4090,11,1312452226,1312453186,1,1,960
63311968@N07,4091,12,1373612876,1373613896,1,1,1020
63330642@N06,4092,1,1370159121,1370159361,1,1,240
63330642@N06,4093,9,1372837470,1372838370,1,1,900
63330642@N06,4094,11,1373169919,1373170879,4,4,960
63330642@N06,4094,1,1373172931,1373173171,2,4,240
63330642@N06,4094,9,1373173505,1373174405,2,4,900
63330642@N06,4094,3,1373175829,1373176159,9,4,330
63330642@N06,4095,1,1374301223,1374301463,2,2,240
63330642@N06,4095,3,1374305197,1374305527,1,2,330
63330642@N06,4096,11,1376798307,1376799267,8,4,960
63330642@N06,4096,9,1376799517,1376800417,2,4,900
63330642@N06,4096,1,1376801313,1376801553,5,4,240
63330642@N06,4096,4,1376803407,1376803767,6,4,360
63330642@N06,4097,9,1378015957,1378016857,2,2,900
63330642@N06,4097,3,1378019485,1378019815,2,2,330
63330642@N06,4098,3,1379228682,1379229012,1,1,330
63330642@N06,4099,1,1379293589,1379293829,1,1,240
63330642@N06,4100,11,1381039065,1381040025,1,1,960
63330642@N06,4101,11,1383373273,1383374233,3,2,960
63330642@N06,4101,9,1383374854,1383375754,1,2,900
63330642@N06,4102,11,1386389185,1386390145,1,1,960
63330642@N06,4103,9,1386999898,1387000798,1,1,900
63330642@N06,4104,8,1388469394,1388470234,2,2,840
63330642@N06,4104,13,1388477848,1388478928,1,2,1080
63330642@N06,4105,1,1392614660,1392614900,1,1,240
63330642@N06,4106,11,1393043176,1393044136,7,1,960
63330642@N06,4107,11,1393650361,1393650910,2,2,549
63330642@N06,4107,9,1393650910,1393651810,1,2,900
63330642@N06,4108,11,1394340787,1394341747,2,2,960
63330642@N06,4108,1,1394342920,1394343160,1,2,240
63330642@N06,4109,9,1396158459,1396159359,2,2,900
63330642@N06,4109,1,1396160572,1396160812,1,2,240
63419140@N00,4110,10,1240648720,1240649620,1,1,900
63513545@N00,4111,11,1380100489,1380101449,3,3,960
63513545@N00,4111,5,1380101468,1380101888,14,3,420
63513545@N00,4111,11,1380107995,1380108955,1,3,960
63513545@N00,4112,1,1380243553,1380243793,2,7,240
63513545@N00,4112,2,1380249111,1380249351,2,7,240
63513545@N00,4112,12,1380249763,1380249887,4,7,124
63513545@N00,4112,2,1380249887,1380250127,6,7,240
63513545@N00,4112,17,1380251428,1380254128,2,7,2700
63513545@N00,4112,8,1380258032,1380258872,3,7,840
63513545@N00,4112,5,1380260076,1380260496,1,7,420
63513545@N00,4113,13,1380612191,1380613271,1,1,1080
63574114@N00,4114,3,1205121115,1205121445,9,1,330
63618933@N00,4115,11,1359601204,1359602164,2,2,960
63618933@N00,4115,10,1359609384,1359610284,1,2,900
63637045@N07,4116,17,1362187201,1362189901,4,8,2700
63637045@N07,4116,8,1362205645,1362206485,2,8,840
63637045@N07,4116,5,1362207915,1362208335,3,8,420
63637045@N07,4116,7,1362209840,1362210680,2,8,840
63637045@N07,4116,3,1362210727,1362211057,4,8,330
63637045@N07,4116,2,1362217573,1362217813,2,8,240
63637045@N07,4116,15,1362218436,1362219636,2,8,1200
63637045@N07,4116,11,1362219995,1362220955,3,8,960
63637045@N07,4117,17,1406978497,1406981197,3,2,2700
63637045@N07,4117,11,1406985778,1406986738,2,2,960
63657240@N00,4118,11,1203189721,1203190681,5,1,960
63657240@N00,4119,10,1203255880,1203256780,3,2,900
63657240@N00,4119,11,1203257863,1203258823,2,2,960
63705158@N02,4120,17,1345374448,1345377148,1,1,2700
63786834@N00,4121,11,1298877290,1298878250,1,1,960
63786834@N00,4122,4,1299047693,1299048053,1,1,360
63786834@N00,4123,7,1299112843,1299113683,1,1,840
63812709@N02,4124,11,1306380762,1306381722,70,8,960
63812709@N02,4124,2,1306392209,1306392449,2,8,240
63812709@N02,4124,11,1306393010,1306393161,3,8,151
63812709@N02,4124,7,1306393161,1306394001,2,8,840
63812709@N02,4124,11,1306395056,1306395142,6,8,86
63812709@N02,4124,7,1306395142,1306395702,2,8,560
63812709@N02,4124,11,1306395702,1306395799,2,8,97
63812709@N02,4124,7,1306395799,1306396639,9,8,840
63812709@N02,4125,11,1306546995,1306547955,11,10,960
63812709@N02,4125,1,1306549340,1306549450,3,10,110
63812709@N02,4125,11,1306549450,1306550410,6,10,960
63812709@N02,4125,5,1306550637,1306550791,5,10,154
63812709@N02,4125,11,1306550791,1306551751,6,10,960
63812709@N02,4125,8,1306552727,1306553109,2,10,382
63812709@N02,4125,5,1306553109,1306553406,2,10,297
63812709@N02,4125,11,1306553406,1306554366,19,10,960
63812709@N02,4125,10,1306559039,1306559646,2,10,607
63812709@N02,4125,11,1306559646,1306560606,1,10,960
63812709@N02,4126,11,1306645589,1306646549,16,5,960
63812709@N02,4126,10,1306651254,1306651501,2,5,247
63812709@N02,4126,11,1306651501,1306652461,20,5,960
63812709@N02,4126,10,1306655847,1306656635,2,5,788
63812709@N02,4126,11,1306656635,1306657595,1,5,960
63812709@N02,4127,11,1306807815,1306808775,1,1,960
63818228@N03,4128,11,1312927872,1312928832,1,1,960
63846795@N06,4129,4,1194938057,1194938417,1,1,360
63859127@N00,4130,3,1375604885,1375605215,2,2,330
63859127@N00,4130,8,1375613031,1375613871,2,2,840
64111638@N00,4131,11,1382021040,1382022000,1,1,960
64171510@N00,4132,8,1247133874,1247134714,2,5,840
64171510@N00,4132,1,1247139609,1247139849,4,5,240
64171510@N00,4132,3,1247143386,1247143716,2,5,330
64171510@N00,4132,2,1247145729,1247145969,3,5,240
64171510@N00,4132,11,1247148725,1247149685,1,5,960
64220937@N02,4133,11,1323225731,1323226691,1,1,960
64318110@N00,4134,11,1363842940,1363843900,1,1,960
64440833@N05,4135,11,1303801577,1303802537,3,2,960
64440833@N05,4135,10,1303806471,1303807371,2,2,900
64440833@N05,4136,11,1374908660,1374909620,8,1,960
64440833@N05,4137,1,1386494056,1386494296,3,1,240
64465885@N03,4138,11,1421103356,1421104316,7,4,960
64465885@N03,4138,13,1421116756,1421117836,8,4,1080
64465885@N03,4138,8,1421130987,1421131827,5,4,840
64465885@N03,4138,11,1421133635,1421134595,1,4,960
64466278@N03,4139,3,1327719350,1327719421,2,4,71
64466278@N03,4139,1,1327719421,1327719566,3,4,145
64466278@N03,4139,2,1327719566,1327719584,2,4,18
64466278@N03,4139,3,1327719584,1327719914,3,4,330
64466278@N03,4140,11,1343511446,1343511521,2,6,75
64466278@N03,4140,2,1343511521,1343511531,2,6,10
64466278@N03,4140,12,1343511531,1343511544,2,6,13
64466278@N03,4140,2,1343511544,1343511621,3,6,77
64466278@N03,4140,10,1343511621,1343511671,2,6,50
64466278@N03,4140,11,1343511671,1343512631,2,6,960
64478148@N07,4141,16,1334904354,1334904589,15,3,235
64478148@N07,4141,1,1334904589,1334904829,7,3,240
64478148@N07,4141,5,1334906281,1334906701,1,3,420
64478148@N07,4142,15,1336469015,1336470215,4,1,1200
64478148@N07,4143,6,1336724437,1336725157,5,1,720
64478148@N07,4144,10,1345003824,1345004724,4,1,900
64478148@N07,4145,6,1349070404,1349071124,1,1,720
64478148@N07,4146,10,1349767434,1349768217,3,3,783
64478148@N07,4146,17,1349768217,1349769041,4,3,824
64478148@N07,4146,13,1349769041,1349770121,2,3,1080
64478148@N07,4147,11,1362704658,1362705069,2,14,411
64478148@N07,4147,1,1362705069,1362705210,2,14,141
64478148@N07,4147,16,1362705210,1362705739,5,14,529
64478148@N07,4147,9,1362705739,1362705868,6,14,129
64478148@N07,4147,16,1362705868,1362705907,2,14,39
64478148@N07,4147,9,1362705907,1362706807,30,14,900
64478148@N07,4147,16,1362706901,1362707219,2,14,318
64478148@N07,4147,1,1362707219,1362707459,8,14,240
64478148@N07,4147,17,1362709924,1362711101,10,14,1177
64478148@N07,4147,15,1362711101,1362711204,2,14,103
64478148@N07,4147,13,1362711204,1362712284,12,14,1080
64478148@N07,4147,15,1362712473,1362713673,2,14,1200
64478148@N07,4147,8,1362719219,1362720059,4,14,840
64478148@N07,4147,5,1362720100,1362720520,5,14,420
64478148@N07,4148,1,1364006015,1364006255,21,1,240
64478148@N07,4149,17,1364431935,1364432005,4,6,70
64478148@N07,4149,15,1364432005,1364432119,2,6,114
64478148@N07,4149,17,1364432119,1364434819,10,6,2700
64478148@N07,4149,15,1364438349,1364439539,7,6,1190
64478148@N07,4149,13,1364439539,1364439974,2,6,435
64478148@N07,4149,17,1364439974,1364442674,1,6,2700
64478148@N07,4150,15,1365121358,1365122558,2,4,1200
64478148@N07,4150,13,1365122608,1365123688,2,4,1080
64478148@N07,4150,17,1365123731,1365126185,2,4,2454
64478148@N07,4150,13,1365126185,1365127265,4,4,1080
64478148@N07,4151,3,1365228699,1365229029,4,1,330
64478148@N07,4152,13,1369803304,1369804384,8,1,1080
64478148@N07,4153,17,1374399064,1374401764,1,1,2700
64478148@N07,4154,1,1378604262,1378604502,6,10,240
64478148@N07,4154,8,1378605834,1378606674,4,10,840
64478148@N07,4154,13,1378606992,1378607222,5,10,230
64478148@N07,4154,15,1378607222,1378607401,4,10,179
64478148@N07,4154,13,1378607401,1378607500,2,10,99
64478148@N07,4154,15,1378607500,1378607999,4,10,499
64478148@N07,4154,17,1378607999,1378608139,2,10,140
64478148@N07,4154,10,1378608139,1378608477,3,10,338
64478148@N07,4154,5,1378608477,1378608897,2,10,420
64478148@N07,4154,11,1378620177,1378621137,1,10,960
64478148@N07,4155,11,1380279639,1380280599,1,1,960
64478148@N07,4156,17,1380590199,1380592899,2,3,2700
64478148@N07,4156,8,1380596333,1380597173,3,3,840
64478148@N07,4156,13,1380598772,1380599852,3,3,1080
64478148@N07,4157,11,1385863346,1385864306,6,7,960
64478148@N07,4157,5,1385869591,1385870011,2,7,420
64478148@N07,4157,8,1385870047,1385870887,6,7,840
64478148@N07,4157,13,1385877612,1385878692,7,7,1080
64478148@N07,4157,10,1385879443,1385880343,2,7,900
64478148@N07,4157,5,1385889267,1385889687,2,7,420
64478148@N07,4157,11,1385898130,1385899090,2,7,960
64478148@N07,4158,5,1392698289,1392698556,2,4,267
64478148@N07,4158,8,1392698556,1392699396,2,4,840
64478148@N07,4158,17,1392705459,1392706061,2,4,602
64478148@N07,4158,11,1392706061,1392707021,1,4,960
64478148@N07,4159,11,1393983015,1393983975,3,12,960
64478148@N07,4159,10,1393984729,1393985230,4,12,501
64478148@N07,4159,17,1393985230,1393985406,8,12,176
64478148@N07,4159,15,1393985406,1393985419,3,12,13
64478148@N07,4159,17,1393985419,1393985571,2,12,152
64478148@N07,4159,13,1393985571,1393986651,10,12,1080
64478148@N07,4159,8,1393987068,1393987300,3,12,232
64478148@N07,4159,5,1393987300,1393987652,9,12,352
64478148@N07,4159,1,1393987652,1393987755,4,12,103
64478148@N07,4159,9,1393987755,1393987802,2,12,47
64478148@N07,4159,16,1393987802,1393987889,4,12,87
64478148@N07,4159,9,1393987889,1393988789,2,12,900
64478148@N07,4160,11,1452574005,1452574965,4,15,960
64478148@N07,4160,2,1452577262,1452577389,2,15,127
64478148@N07,4160,7,1452577389,1452577467,2,15,78
64478148@N07,4160,3,1452577467,1452577774,6,15,307
64478148@N07,4160,4,1452577774,1452578134,4,15,360
64478148@N07,4160,16,1452579952,1452580039,2,15,87
64478148@N07,4160,9,1452580039,1452580148,3,15,109
64478148@N07,4160,1,1452580148,1452580388,2,15,240
64478148@N07,4160,5,1452582128,1452582548,12,15,420
64478148@N07,4160,8,1452582818,1452583658,9,15,840
64478148@N07,4160,13,1452584688,1452585027,11,15,339
64478148@N07,4160,17,1452585027,1452585092,4,15,65
64478148@N07,4160,15,1452585092,1452585224,4,15,132
64478148@N07,4160,17,1452585224,1452585342,6,15,118
64478148@N07,4160,10,1452585342,1452586242,4,15,900
64478148@N07,4161,5,1466125054,1466125474,5,2,420
64478148@N07,4161,8,1466135021,1466135861,11,2,840
64483093@N04,4162,17,1315438163,1315440863,1,1,2700
64542402@N07,4163,11,1355380539,1355381499,5,3,960
64542402@N07,4163,1,1355384388,1355384542,2,3,154
64542402@N07,4163,9,1355384542,1355385442,1,3,900
64542402@N07,4164,5,1355626033,1355626453,2,4,420
64542402@N07,4164,13,1355641797,1355642877,2,4,1080
64542402@N07,4164,10,1355648376,1355649276,2,4,900
64542402@N07,4164,11,1355650487,1355651447,1,4,960
64574649@N00,4165,2,1308387943,1308388183,1,1,240
64654599@N00,4166,15,1327037159,1327038359,3,7,1200
64654599@N00,4166,13,1327039357,1327040437,4,7,1080
64654599@N00,4166,8,1327046969,1327047385,3,7,416
64654599@N00,4166,5,1327047385,1327047805,2,7,420
64654599@N00,4166,15,1327050680,1327051880,2,7,1200
64654599@N00,4166,17,1327051917,1327054617,2,7,2700
64654599@N00,4166,11,1327057339,1327058299,3,7,960
64669762@N02,4167,15,1351064754,1351065954,1,1,1200
64728178@N00,4168,8,1439888757,1439889597,1,1,840
64759149@N05,4169,11,1360485016,1360485976,2,1,960
64779594@N00,4170,1,1188779298,1188779538,3,1,240
64779594@N00,4171,5,1195210596,1195211016,1,1,420
64779594@N00,4172,16,1204938849,1204940949,3,3,2100
64779594@N00,4172,5,1204943610,1204944030,2,3,420
64779594@N00,4172,1,1204972216,1204972456,4,3,240
64779594@N00,4173,11,1390625113,1390626073,1,1,960
64779594@N00,4174,11,1394840574,1394841534,3,1,960
64779594@N00,4175,3,1454115227,1454115557,2,4,330
64779594@N00,4175,17,1454120016,1454121499,3,4,1483
64779594@N00,4175,13,1454121499,1454122579,2,4,1080
64779594@N00,4175,5,1454123054,1454123474,2,4,420
64779594@N00,4176,11,1461021524,1461022484,2,4,960
64779594@N00,4176,13,1461025527,1461025783,4,4,256
64779594@N00,4176,15,1461025783,1461026045,4,4,262
64779594@N00,4176,17,1461026045,1461028745,2,4,2700
64807684@N07,4177,5,1387163563,1387163983,1,1,420
64834051@N00,4178,11,1421883104,1421884064,4,4,960
64834051@N00,4178,1,1421901618,1421901858,2,4,240
64834051@N00,4178,8,1421905077,1421905917,2,4,840
64834051@N00,4178,1,1421921469,1421921709,2,4,240
64834051@N00,4179,11,1439512309,1439513269,5,4,960
64834051@N00,4179,1,1439521593,1439521833,2,4,240
64834051@N00,4179,11,1439531070,1439531917,2,4,847
64834051@N00,4179,8,1439531917,1439532757,1,4,840
64854604@N07,4180,11,1429106508,1429107468,1,1,960
64907932@N00,4181,11,1443582613,1443583573,2,1,960
64907932@N00,4182,11,1443681665,1443682625,1,1,960
65013125@N06,4183,11,1372380375,1372381335,2,2,960
65013125@N06,4183,8,1372397299,1372398139,2,2,840
65051383@N05,4184,11,1356830647,1356831607,1,1,960
65061709@N00,4185,11,1468717798,1468718758,2,1,960
65098523@N02,4186,9,1312528317,1312529217,1,1,900
65103228@N02,4187,6,1387140761,1387141481,1,1,720
65103228@N02,4188,6,1387280693,1387281413,1,1,720
65103228@N02,4189,6,1430884883,1430885603,2,1,720
65105672@N00,4190,11,1379055936,1379056896,1,1,960
65105672@N00,4191,12,1379415995,1379416282,2,2,287
65105672@N00,4191,2,1379416282,1379416522,1,2,240
65105672@N00,4192,14,1379485824,1379487024,7,3,1200
65105672@N00,4192,13,1379489657,1379490737,2,3,1080
65105672@N00,4192,11,1379504839,1379505799,2,3,960
65105672@N00,4193,11,1443079294,1443080254,1,1,960
65105672@N00,4194,14,1443501803,1443503003,1,1,1200
65105672@N00,4195,4,1443746699,1443747059,3,1,360
65105672@N00,4196,14,1460956377,1460957577,1,1,1200
65159120@N05,4197,5,1230346207,1230346627,1,1,420
65184867@N04,4198,11,1393645942,1393646902,1,1,960
65363681@N00,4199,12,1203291335,1203292355,13,2,1020
65363681@N00,4199,16,1203305001,1203307101,2,2,2100
65367128@N00,4200,11,1198380824,1198381784,8,1,960
65367128@N00,4201,11,1270511460,1270512420,6,6,960
65367128@N00,4201,9,1270513211,1270514111,3,6,900
65367128@N00,4201,2,1270520219,1270520459,2,6,240
65367128@N00,4201,10,1270527051,1270527856,5,6,805
65367128@N00,4201,15,1270527856,1270528683,2,6,827
65367128@N00,4201,13,1270528683,1270529763,2,6,1080
65367128@N00,4202,3,1456188130,1456188460,4,2,330
65367128@N00,4202,8,1456208058,1456208898,2,2,840
65423059@N07,4203,11,1322695659,1322696619,1,1,960
65435894@N02,4204,4,1339468925,1339469285,2,2,360
65435894@N02,4204,15,1339472919,1339474119,1,2,1200
65435894@N02,4205,11,1339628392,1339629352,1,1,960
65435894@N02,4206,4,1339807084,1339807444,3,1,360
65516313@N06,4207,13,1357712509,1357713081,2,2,572
65516313@N06,4207,17,1357713081,1357715781,1,2,2700
65516313@N06,4208,13,1374048885,1374049965,1,1,1080
65519746@N05,4209,11,1398928583,1398929543,1,1,960
65547015@N00,4210,11,1389141188,1389142148,4,4,960
65547015@N00,4210,13,1389154197,1389155277,3,4,1080
65547015@N00,4210,9,1389157137,1389158037,2,4,900
65547015@N00,4210,15,1389158081,1389159281,1,4,1200
65547015@N00,4211,11,1392563452,1392564412,1,1,960
65547015@N00,4212,11,1437835777,1437836737,1,1,960
65660483@N06,4213,11,1344878468,1344879428,1,1,960
65778609@N03,4214,4,1408329294,1408329654,2,2,360
65778609@N03,4214,8,1408337835,1408338675,1,2,840
65778609@N03,4215,17,1408421868,1408424568,3,1,2700
65783577@N00,4216,11,1229219181,1229220141,1,1,960
65784570@N00,4217,11,1382405038,1382405998,1,1,960
65825924@N03,4218,11,1363485943,1363486903,1,1,960
65825924@N03,4219,1,1363668804,1363669044,1,1,240
65825924@N03,4220,1,1395383056,1395383296,2,3,240
65825924@N03,4220,6,1395389377,1395390097,2,3,720
65825924@N03,4220,13,1395390488,1395391568,1,3,1080
65825924@N03,4221,11,1395740625,1395741585,1,1,960
65825924@N03,4222,6,1418985790,1418986510,4,2,720
65825924@N03,4222,13,1418987231,1418988311,1,2,1080
65825924@N03,4223,10,1426028988,1426029888,2,3,900
65825924@N03,4223,13,1426055939,1426057019,3,3,1080
65825924@N03,4223,4,1426059159,1426059519,1,3,360
65825924@N03,4224,15,1426226870,1426228070,2,2,1200
65825924@N03,4224,13,1426242538,1426243618,2,2,1080
65825924@N03,4225,11,1440762063,1440763023,1,1,960
65825924@N03,4226,13,1458199405,1458200485,3,1,1080
65825924@N03,4227,10,1458295772,1458296672,2,2,900
65825924@N03,4227,11,1458297088,1458298048,1,2,960
65987396@N00,4228,13,1308372936,1308374016,2,2,1080
65987396@N00,4228,8,1308384563,1308385403,1,2,840
66139507@N05,4229,17,1316153380,1316153828,2,5,448
66139507@N05,4229,4,1316153828,1316154188,4,5,360
66139507@N05,4229,3,1316156455,1316156785,6,5,330
66139507@N05,4229,2,1316157358,1316157598,7,5,240
66139507@N05,4229,9,1316161147,1316162047,1,5,900
66147934@N04,4230,4,1370137036,1370137396,2,1,360
66378762@N04,4231,1,1443936258,1443936498,3,2,240
66378762@N04,4231,11,1443957080,1443958040,1,2,960
66408130@N07,4232,11,1305163372,1305164332,1,1,960
66408130@N07,4233,11,1305203350,1305204310,1,1,960
66408130@N07,4234,15,1418613627,1418614827,1,1,1200
66408130@N07,4235,11,1419382579,1419383539,2,3,960
66408130@N07,4235,15,1419406735,1419407804,2,3,1069
66408130@N07,4235,10,1419407804,1419408704,1,3,900
66506437@N08,4236,17,1193010599,1193010738,4,3,139
66506437@N08,4236,15,1193010738,1193011938,3,3,1200
66506437@N08,4236,10,1193022979,1193023879,1,3,900
66718423@N03,4237,3,1229921244,1229921574,14,3,330
66718423@N03,4237,1,1229927951,1229928191,7,3,240
66718423@N03,4237,11,1229936798,1229937758,3,3,960
66718423@N03,4238,5,1287312373,1287312793,7,5,420
66718423@N03,4238,13,1287318048,1287318383,3,5,335
66718423@N03,4238,6,1287318383,1287318490,2,5,107
66718423@N03,4238,13,1287318490,1287318777,3,5,287
66718423@N03,4238,6,1287318777,1287319497,1,5,720
66718423@N03,4239,17,1287585081,1287587781,5,1,2700
66718423@N03,4240,11,1287886482,1287887442,8,1,960
66718423@N03,4241,13,1288195515,1288196595,8,1,1080
66718423@N03,4242,17,1288331369,1288332992,3,2,1623
66718423@N03,4242,6,1288332992,1288333712,1,2,720
66736603@N00,4243,11,1458627364,1458628324,1,1,960
66749627@N00,4244,1,1462689919,1462690159,2,2,240
66749627@N00,4244,5,1462695071,1462695491,1,2,420
66749627@N00,4245,11,1462756387,1462757347,1,1,960
66755680@N06,4246,8,1319910504,1319911344,7,7,840
66755680@N06,4246,5,1319913854,1319913868,2,7,14
66755680@N06,4246,8,1319913868,1319913874,2,7,6
66755680@N06,4246,15,1319913874,1319915074,3,7,1200
66755680@N06,4246,11,1319936789,1319936809,3,7,20
66755680@N06,4246,1,1319936809,1319936824,3,7,15
66755680@N06,4246,9,1319936824,1319937724,1,7,900
66825505@N00,4247,13,1279094936,1279096016,1,1,1080
66884161@N05,4248,5,1347171168,1347171588,1,1,420
66898369@N04,4249,11,1319895881,1319896841,1,1,960
66898369@N04,4250,11,1320407836,1320408796,2,1,960
66898369@N04,4251,11,1333072985,1333073945,1,1,960
66985846@N08,4252,11,1470876815,1470877775,1,1,960
67038581@N00,4253,7,1315870791,1315871631,3,2,840
67038581@N00,4253,4,1315874762,1315875122,1,2,360
67043514@N00,4254,15,1353968334,1353969534,1,1,1200
67056982@N00,4255,11,1277077636,1277078596,1,1,960
67062087@N04,4256,11,1337758983,1337759943,3,1,960
67132721@N03,4257,11,1327111801,1327112761,1,1,960
67157140@N00,4258,15,1360051730,1360052930,1,1,1200
67237167@N03,4259,11,1388031283,1388032243,2,6,960
67237167@N03,4259,2,1388040559,1388040799,4,6,240
67237167@N03,4259,10,1388043895,1388044284,2,6,389
67237167@N03,4259,17,1388044284,1388046984,5,6,2700
67237167@N03,4259,8,1388052528,1388053368,4,6,840
67237167@N03,4259,11,1388060895,1388061855,1,6,960
67246822@N00,4260,11,1323718863,1323719823,2,4,960
67246822@N00,4260,9,1323720170,1323721070,2,4,900
67246822@N00,4260,11,1323723387,1323724347,2,4,960
67246822@N00,4260,12,1323725171,1323726191,1,4,1020
67298936@N05,4261,11,1346740832,1346741792,1,1,960
67298936@N05,4262,11,1377833215,1377834175,11,1,960
67299437@N06,4263,8,1433058613,1433059453,1,1,840
67299437@N06,4264,11,1433165314,1433166274,9,1,960
67369636@N00,4265,6,1381992708,1381993428,3,2,720
67369636@N00,4265,5,1381994675,1381995095,2,2,420
67424733@N02,4266,11,1363060686,1363061646,2,1,960
67489881@N07,4267,5,1318414041,1318414461,1,1,420
67489881@N07,4268,13,1318832318,1318833398,1,1,1080
67523854@N07,4269,6,1288013438,1288014158,1,1,720
67527549@N00,4270,7,1294281743,1294282583,4,1,840
67547148@N02,4271,8,1197780519,1197781359,2,1,840
67547148@N02,4272,9,1256672832,1256673732,1,1,900
67547148@N02,4273,15,1256772993,1256774193,1,1,1200
67621043@N00,4274,17,1326683251,1326685951,1,1,2700
67621043@N00,4275,13,1359937292,1359938372,1,1,1080
67621043@N00,4276,17,1444771904,1444774604,1,1,2700
67622575@N00,4277,11,1359243439,1359244399,2,2,960
67622575@N00,4277,15,1359250227,1359251427,1,2,1200
67700845@N07,4278,5,1340434129,1340434549,3,2,420
67700845@N07,4278,8,1340436680,1340437520,1,2,840
67733160@N06,4279,8,1354785853,1354786693,1,1,840
67737010@N08,4280,3,1471049128,1471049458,1,1,330
67774977@N00,4281,11,1299738134,1299739094,2,7,960
67774977@N00,4281,10,1299739230,1299739286,3,7,56
67774977@N00,4281,17,1299739286,1299740241,5,7,955
67774977@N00,4281,13,1299740241,1299741321,4,7,1080
67774977@N00,4281,8,1299742594,1299743434,11,7,840
67774977@N00,4281,5,1299743489,1299743909,8,7,420
67774977@N00,4281,11,1299749366,1299750326,3,7,960
67861517@N00,4282,13,1293592604,1293593684,2,1,1080
67949678@N00,4283,8,1419931156,1419931996,2,1,840
67949678@N00,4284,10,1419995101,1419996001,2,5,900
67949678@N00,4284,17,1420010942,1420013085,5,5,2143
67949678@N00,4284,15,1420013085,1420014285,2,5,1200
67949678@N00,4284,13,1420014535,1420015615,2,5,1080
67949678@N00,4284,5,1420020370,1420020790,3,5,420
67993063@N03,4285,11,1360877888,1360878848,1,1,960
67993371@N05,4286,17,1356907834,1356910534,2,2,2700
67993371@N05,4286,5,1356922240,1356922660,1,2,420
68010648@N07,4287,11,1343477779,1343478739,1,1,960
68010648@N07,4288,11,1343605084,1343606044,2,1,960
68071381@N07,4289,5,1381380753,1381381173,2,1,420
68174416@N00,4290,11,1304492839,1304493799,2,1,960
68235353@N00,4291,17,1328425521,1328425768,2,3,247
68235353@N00,4291,4,1328425768,1328425907,2,3,139
68235353@N00,4291,11,1328425907,1328426867,1,3,960
68311601@N00,4292,11,1245242297,1245243257,8,6,960
68311601@N00,4292,4,1245244915,1245245275,2,6,360
68311601@N00,4292,7,1245247717,1245247815,2,6,98
68311601@N00,4292,4,1245247815,1245248175,4,6,360
68311601@N00,4292,8,1245275565,1245276405,2,6,840
68311601@N00,4292,11,1245277234,1245278194,1,6,960
68350381@N03,4293,5,1369880096,1369880516,1,1,420
68362583@N00,4294,11,1289967357,1289968317,3,1,960
68362583@N00,4295,11,1290051555,1290052515,4,1,960
68384069@N05,4296,8,1414208925,1414209765,1,1,840
68549731@N00,4297,17,1260791400,1260794100,1,1,2700
68559301@N00,4298,11,1335964350,1335965310,1,1,960
68559301@N00,4299,11,1374480390,1374481350,2,3,960
68559301@N00,4299,13,1374482532,1374483612,2,3,1080
68559301@N00,4299,11,1374492387,1374493347,1,3,960
68574102@N00,4300,11,1376966723,1376967683,5,6,960
68574102@N00,4300,5,1376969250,1376969670,5,6,420
68574102@N00,4300,8,1376981557,1376982397,3,6,840
68574102@N00,4300,13,1376990642,1376991722,2,6,1080
68574102@N00,4300,17,1376992397,1376995097,6,6,2700
68574102@N00,4300,11,1376995572,1376996532,3,6,960
68607740@N00,4301,11,1264512938,1264513898,1,1,960
68655192@N08,4302,11,1468709987,1468710947,2,4,960
68655192@N08,4302,2,1468715025,1468715265,2,4,240
68655192@N08,4302,17,1468717918,1468718189,2,4,271
68655192@N08,4302,13,1468718189,1468719269,1,4,1080
68655192@N08,4303,11,1469281271,1469282231,1,1,960
68731864@N04,4304,11,1394912748,1394913708,1,1,960
68731864@N04,4305,8,1394944772,1394945612,2,3,840
68731864@N04,4305,15,1394951868,1394953068,4,3,1200
68731864@N04,4305,10,1394953198,1394954098,2,3,900
68821991@N03,4306,17,1438833169,1438835869,1,1,2700
68846374@N00,4307,4,1281842616,1281842976,3,3,360
68846374@N00,4307,13,1281843716,1281844796,2,3,1080
68846374@N00,4307,8,1281844825,1281845665,1,3,840
68941862@N00,4308,11,1383998671,1383999631,20,1,960
68941862@N00,4309,11,1384202628,1384203588,1,1,960
68945713@N04,4310,14,1328926463,1328927663,1,1,1200
68947259@N00,4311,13,1314176579,1314177659,8,1,1080
68997488@N00,4312,11,1379719437,1379720397,1,1,960
68997488@N00,4313,11,1389787421,1389788381,1,1,960
68998347@N00,4314,3,1222993066,1222993396,1,1,330
68998347@N00,4315,2,1290477349,1290477589,2,3,240
68998347@N00,4315,4,1290478569,1290478929,2,3,360
68998347@N00,4315,8,1290483574,1290484414,2,3,840
68998347@N00,4316,11,1324437758,1324438718,2,1,960
68998347@N00,4317,9,1365208402,1365209302,2,2,900
68998347@N00,4317,3,1365213672,1365214002,1,2,330
68998347@N00,4318,11,1397186671,1397187631,3,3,960
68998347@N00,4318,7,1397191795,1397192635,2,3,840
68998347@N00,4318,5,1397207842,1397208262,1,3,420
68999127@N07,4319,11,1208575133,1208576093,1,1,960
68999275@N00,4320,11,1209518364,1209519324,20,1,960
69058391@N00,4321,11,1201430555,1201431515,1,1,960
69108709@N07,4322,11,1321095056,1321096016,1,1,960
69108709@N07,4323,11,1321137776,1321138736,1,1,960
69108709@N07,4324,8,1324351137,1324351977,3,2,840
69108709@N07,4324,13,1324362489,1324363569,2,2,1080
69108709@N07,4325,11,1334819154,1334819529,3,4,375
69108709@N07,4325,10,1334819529,1334820429,6,4,900
69108709@N07,4325,15,1334822861,1334822919,2,4,58
69108709@N07,4325,10,1334822919,1334823819,2,4,900
69116795@N00,4326,11,1285725453,1285726413,26,1,960
69121654@N00,4327,13,1265254192,1265255272,1,1,1080
69121654@N00,4328,5,1265629842,1265629857,2,2,15
69121654@N00,4328,3,1265629857,1265630187,1,2,330
69161765@N08,4329,13,1352172730,1352173810,4,3,1080
69161765@N08,4329,16,1352182810,1352182844,2,3,34
69161765@N08,4329,9,1352182844,1352183744,2,3,900
69206063@N00,4330,3,1307740238,1307740568,2,2,330
69206063@N00,4330,8,1307751021,1307751861,1,2,840
69206063@N00,4331,11,1307927659,1307928619,2,1,960
69226193@N08,4332,15,1328581668,1328582868,2,2,1200
69226193@N08,4332,7,1328588399,1328589239,1,2,840
69271250@N00,4333,13,1448705544,1448706624,1,1,1080
69277332@N06,4334,11,1437770775,1437771735,1,1,960
69302803@N06,4335,11,1363253755,1363254715,1,1,960
69323198@N00,4336,2,1259634117,1259634357,30,9,240
69323198@N00,4336,7,1259637480,1259637493,2,9,13
69323198@N00,4336,2,1259637493,1259637733,2,9,240
69323198@N00,4336,7,1259639212,1259640052,31,9,840
69323198@N00,4336,9,1259642326,1259642557,23,9,231
69323198@N00,4336,11,1259642557,1259642613,4,9,56
69323198@N00,4336,16,1259642613,1259642804,19,9,191
69323198@N00,4336,11,1259642804,1259642830,4,9,26
69323198@N00,4336,16,1259642830,1259644930,2,9,2100
69323198@N00,4337,5,1260251296,1260251716,2,1,420
69328928@N00,4338,8,1194599890,1194600730,2,1,840
69343619@N08,4339,11,1371162325,1371163285,1,1,960
69343619@N08,4340,5,1371196376,1371196796,1,1,420
69343619@N08,4341,8,1371552767,1371553607,2,2,840
69343619@N08,4341,4,1371557788,1371558148,1,2,360
69377536@N00,4342,2,1339131832,1339132072,1,1,240
69416229@N00,4343,15,1248056616,1248057360,2,4,744
69416229@N00,4343,13,1248057360,1248058440,2,4,1080
69416229@N00,4343,8,1248064803,1248065643,2,4,840
69416229@N00,4343,11,1248074499,1248075459,1,4,960
69574134@N00,4344,5,1214834400,1214834820,1,1,420
69574134@N00,4345,2,1216274625,1216274865,2,9,240
69574134@N00,4345,12,1216275595,1216276615,9,9,1020
69574134@N00,4345,14,1216283342,1216284542,5,9,1200
69574134@N00,4345,3,1216287886,1216288216,12,9,330
69574134@N00,4345,9,1216289204,1216289785,2,9,581
69574134@N00,4345,1,1216289785,1216290025,15,9,240
69574134@N00,4345,11,1216295139,1216296099,2,9,960
69574134@N00,4345,5,1216297339,1216297759,13,9,420
69574134@N00,4345,9,1216306244,1216307144,3,9,900
69574134@N00,4346,11,1234439696,1234440656,1,1,960
69574134@N00,4347,11,1346553208,1346554168,2,4,960
69574134@N00,4347,16,1346555615,1346557715,2,4,2100
69574134@N00,4347,1,1346563002,1346563242,6,4,240
69574134@N00,4347,8,1346578498,1346579338,1,4,840
69591415@N02,4348,2,1330147370,1330147603,2,5,233
69591415@N02,4348,4,1330147603,1330147963,2,5,360
69591415@N02,4348,9,1330151778,1330152136,2,5,358
69591415@N02,4348,16,1330152136,1330154236,3,5,2100
69591415@N02,4348,11,1330154257,1330155217,1,5,960
69689125@N02,4349,5,1395967759,1395968076,2,2,317
69689125@N02,4349,11,1395968076,1395969036,1,2,960
69735433@N02,4350,11,1376886328,1376887288,1,1,960
69738583@N05,4351,17,1337817451,1337819166,2,3,1715
69738583@N05,4351,11,1337819166,1337820126,2,3,960
69738583@N05,4351,9,1337824805,1337825705,1,3,900
69781071@N00,4352,11,1299463571,1299464531,15,1,960
69784270@N00,4353,16,1193173289,1193175389,3,4,2100
69784270@N00,4353,17,1193179148,1193181848,2,4,2700
69784270@N00,4353,8,1193188110,1193188950,6,4,840
69784270@N00,4353,11,1193204284,1193205244,1,4,960
69811005@N00,4354,8,1433375656,1433376496,5,5,840
69811005@N00,4354,4,1433378216,1433378576,5,5,360
69811005@N00,4354,13,1433384682,1433385762,6,5,1080
69811005@N00,4354,5,1433389786,1433390206,3,5,420
69811005@N00,4354,11,1433395417,1433396377,1,5,960
69861074@N00,4355,11,1450855696,1450856656,1,1,960
69872692@N07,4356,11,1324713305,1324714265,1,1,960
69872692@N07,4357,5,1348297778,1348298198,1,1,420
69872692@N07,4358,5,1380341321,1380341741,3,2,420
69872692@N07,4358,13,1380349007,1380350087,2,2,1080
69876167@N05,4359,8,1299301140,1299301980,1,1,840
69880349@N08,4360,11,1449001741,1449002701,1,1,960
69882141@N06,4361,9,1294706631,1294707531,1,1,900
69882141@N06,4362,8,1294741074,1294741914,1,1,840
69882141@N06,4363,13,1294968547,1294969627,1,1,1080
69882141@N06,4364,8,1375992929,1375993769,2,1,840
69883003@N00,4365,15,1348902196,1348903396,1,1,1200
69883003@N00,4366,11,1348954948,1348955908,2,1,960
69883003@N00,4367,10,1431646119,1431646748,2,3,629
69883003@N00,4367,11,1431646748,1431647708,3,3,960
69883003@N00,4367,9,1431650187,1431651087,1,3,900
69899432@N00,4368,5,1223043639,1223043659,3,6,20
69899432@N00,4368,8,1223043659,1223043677,2,6,18
69899432@N00,4368,9,1223043677,1223043685,5,6,8
69899432@N00,4368,15,1223043685,1223043690,3,6,5
69899432@N00,4368,13,1223043690,1223043690,2,6,0
69899432@N00,4368,15,1223043690,1223044890,1,6,1200
69904569@N00,4369,11,1219018918,1219019878,1,1,960
69987114@N00,4370,11,1191193417,1191194377,3,4,960
69987114@N00,4370,16,1191206276,1191208376,2,4,2100
69987114@N00,4370,4,1191210582,1191210633,2,4,51
69987114@N00,4370,3,1191210633,1191210963,1,4,330
69987114@N00,4371,11,1191239625,1191240585,2,1,960
69987114@N00,4372,16,1222491830,1222493930,1,1,2100
69995382@N04,4373,17,1314515126,1314517826,1,1,2700
70025073@N00,4374,11,1212656509,1212657469,4,2,960
70025073@N00,4374,6,1212664303,1212665023,3,2,720
70084804@N00,4375,11,1450256978,1450257938,1,1,960
70265065@N05,4376,6,1219482207,1219482927,2,1,720
70378830@N08,4377,15,1434107344,1434108544,1,1,1200
70378830@N08,4378,10,1446274434,1446275334,1,1,900
70378830@N08,4379,13,1447488056,1447489136,1,1,1080
70378830@N08,4380,13,1449207684,1449208764,1,1,1080
70378830@N08,4381,10,1460186236,1460187136,1,1,900
70378830@N08,4382,10,1469175915,1469176815,1,1,900
70548123@N00,4383,11,1406897528,1406898488,1,1,960
70626136@N00,4384,15,1348396892,1348398092,1,1,1200
70626136@N00,4385,11,1348805787,1348806747,1,1,960
70626136@N00,4386,8,1411289684,1411290524,2,1,840
70832171@N07,4387,16,1324781154,1324783254,2,2,2100
70832171@N07,4387,8,1324792689,1324793529,2,2,840
70862502@N00,4388,11,1330698461,1330699421,2,2,960
70862502@N00,4388,17,1330699473,1330702173,1,2,2700
70862502@N00,4389,5,1331015493,1331015913,2,2,420
70862502@N00,4389,8,1331018450,1331019290,1,2,840
70862502@N00,4390,13,1331103955,1331105035,2,4,1080
70862502@N00,4390,10,1331108480,1331109380,3,4,900
70862502@N00,4390,17,1331111673,1331114373,4,4,2700
70862502@N00,4390,4,1331115905,1331116265,2,4,360
70862502@N00,4391,11,1331298945,1331299905,1,1,960
70862502@N00,4392,11,1357882626,1357883586,1,1,960
70862502@N00,4393,15,1358237414,1358238614,1,1,1200
70862502@N00,4394,11,1384051203,1384052163,1,1,960
70862502@N00,4395,15,1384236564,1384237764,1,1,1200
70862502@N00,4396,5,1384579550,1384579970,2,3,420
70862502@N00,4396,8,1384580178,1384581018,2,3,840
70862502@N00,4396,15,1384584703,1384585903,1,3,1200
70862502@N00,4397,11,1455774626,1455775586,1,1,960
70926999@N00,4398,10,1406789832,1406790732,1,1,900
70928085@N00,4399,11,1240446262,1240447222,5,3,960
70928085@N00,4399,3,1240454766,1240455096,3,3,330
70928085@N00,4399,4,1240456338,1240456698,1,3,360
70928085@N00,4400,5,1240485826,1240486246,2,2,420
70928085@N00,4400,11,1240486456,1240487416,2,2,960
70944869@N00,4401,8,1429942755,1429943595,2,3,840
70944869@N00,4401,9,1429946068,1429946415,2,3,347
70944869@N00,4401,1,1429946415,1429946655,1,3,240
71022830@N00,4402,11,1292972963,1292973923,2,12,960
71022830@N00,4402,14,1292979050,1292980250,6,12,1200
71022830@N00,4402,10,1292982723,1292982975,2,12,252
71022830@N00,4402,15,1292982975,1292983446,2,12,471
71022830@N00,4402,13,1292983446,1292984526,9,12,1080
71022830@N00,4402,8,1292997285,1292998125,4,12,840
71022830@N00,4402,5,1292999255,1292999675,3,12,420
71022830@N00,4402,1,1293003184,1293003424,2,12,240
71022830@N00,4402,13,1293009034,1293010114,2,12,1080
71022830@N00,4402,2,1293012534,1293012774,4,12,240
71022830@N00,4402,11,1293013636,1293014596,6,12,960
71022830@N00,4402,17,1293016764,1293019464,1,12,2700
71128153@N00,4403,11,1369528275,1369529235,1,1,960
71214537@N00,4404,10,1382235256,1382236156,2,2,900
71214537@N00,4404,11,1382257242,1382258202,1,2,960
71460985@N05,4405,11,1424846525,1424847485,1,1,960
7151738@N03,4406,17,1393142788,1393144189,2,4,1401
7151738@N03,4406,15,1393144189,1393144843,2,4,654
7151738@N03,4406,13,1393144843,1393145923,3,4,1080
7151738@N03,4406,17,1393150106,1393152806,4,4,2700
7151738@N03,4407,17,1396573750,1396576450,1,1,2700
7151738@N03,4408,15,1396681807,1396681854,4,4,47
7151738@N03,4408,17,1396681854,1396681862,2,4,8
7151738@N03,4408,15,1396681862,1396681868,2,4,6
7151738@N03,4408,17,1396681868,1396684568,6,4,2700
7151738@N03,4409,15,1412899919,1412901119,10,3,1200
7151738@N03,4409,8,1412901740,1412902116,2,3,376
7151738@N03,4409,5,1412902116,1412902536,2,3,420
71665812@N00,4410,11,1365458091,1365459051,9,5,960
71665812@N00,4410,5,1365477781,1365478201,2,5,420
71665812@N00,4410,4,1365483849,1365484209,2,5,360
71665812@N00,4410,13,1365490407,1365491487,2,5,1080
71665812@N00,4410,5,1365493942,1365494362,1,5,420
71778096@N00,4411,10,1240285700,1240285880,2,8,180
71778096@N00,4411,17,1240285880,1240286149,2,8,269
71778096@N00,4411,13,1240286149,1240287229,2,8,1080
71778096@N00,4411,16,1240292065,1240294165,2,8,2100
71778096@N00,4411,5,1240294699,1240295119,4,8,420
71778096@N00,4411,1,1240298486,1240298726,9,8,240
71778096@N00,4411,9,1240298963,1240299863,3,8,900
71778096@N00,4411,16,1240301602,1240303702,5,8,2100
71778096@N00,4412,11,1240564727,1240565687,5,2,960
71778096@N00,4412,4,1240567191,1240567551,3,2,360
71814567@N02,4413,5,1297833903,1297834323,7,1,420
71814567@N02,4414,5,1298022339,1298022759,1,1,420
71814567@N02,4415,8,1298101111,1298101951,2,1,840
71854985@N00,4416,8,1332645227,1332646067,1,1,840
71854985@N00,4417,8,1332718020,1332718860,1,1,840
71854985@N00,4418,11,1332808976,1332809936,2,2,960
71854985@N00,4418,13,1332816357,1332817437,4,2,1080
71917576@N04,4419,11,1352683344,1352684304,3,1,960
71922377@N00,4420,8,1288837756,1288838596,1,1,840
71922377@N00,4421,8,1383717546,1383718386,1,1,840
71922377@N00,4422,13,1425703817,1425704897,1,1,1080
71956836@N00,4423,11,1443740741,1443741701,108,1,960
71965292@N00,4424,14,1213139035,1213140235,43,1,1200
7197250@N06,4425,11,1368452538,1368453498,3,1,960
7197250@N06,4426,11,1368804759,1368805719,2,2,960
7197250@N06,4426,17,1368810093,1368812793,1,2,2700
7197250@N06,4427,15,1369043177,1369044377,1,1,1200
71991688@N00,4428,17,1238993646,1238996346,1,1,2700
71991688@N00,4429,11,1239317932,1239318892,1,1,960
72043907@N00,4430,6,1266993120,1266993840,1,1,720
72048386@N00,4431,11,1221553929,1221554889,1,1,960
7206981@N03,4432,9,1244601567,1244602467,2,4,900
7206981@N03,4432,3,1244608134,1244608222,5,4,88
7206981@N03,4432,7,1244608222,1244609062,2,4,840
7206981@N03,4432,11,1244614687,1244615647,1,4,960
72092856@N00,4433,1,1288248256,1288248496,1,1,240
72126458@N00,4434,13,1311071085,1311072165,5,3,1080
72126458@N00,4434,15,1311072719,1311073919,56,3,1200
72126458@N00,4434,4,1311075081,1311075441,4,3,360
72134509@N00,4435,13,1386312020,1386313100,2,2,1080
72134509@N00,4435,11,1386318331,1386319291,1,2,960
72174877@N00,4436,9,1262473678,1262474578,2,3,900
72174877@N00,4436,14,1262481806,1262483006,3,3,1200
72174877@N00,4436,17,1262492250,1262494950,4,3,2700
72174877@N00,4437,11,1262735324,1262736284,2,3,960
72174877@N00,4437,8,1262749387,1262750227,2,3,840
72174877@N00,4437,11,1262762056,1262763016,1,3,960
72196320@N00,4438,11,1468454337,1468455297,1,1,960
72303203@N07,4439,16,1293242797,1293243457,2,2,660
72303203@N07,4439,11,1293243457,1293244417,1,2,960
72303203@N07,4440,5,1293486653,1293487073,1,1,420
72303203@N07,4441,11,1293525649,1293526609,1,1,960
72324747@N00,4442,1,1288052690,1288052930,1,1,240
72408746@N08,4443,13,1384048811,1384049891,1,1,1080
72449450@N00,4444,17,1194071351,1194074051,1,1,2700
72463966@N00,4445,11,1242244971,1242245931,3,6,960
72463966@N00,4445,1,1242246852,1242247092,2,6,240
72463966@N00,4445,8,1242252531,1242253371,4,6,840
72463966@N00,4445,13,1242258398,1242258534,2,6,136
72463966@N00,4445,17,1242258534,1242261162,2,6,2628
72463966@N00,4445,4,1242261162,1242261522,3,6,360
7256454@N05,4446,11,1214168198,1214169158,2,3,960
7256454@N05,4446,2,1214170088,1214170328,2,3,240
7256454@N05,4446,14,1214171366,1214172566,11,3,1200
7256454@N05,4447,15,1214534453,1214535653,1,1,1200
7256454@N05,4448,3,1214877998,1214878328,26,1,330
7256454@N05,4449,14,1239491811,1239493011,2,3,1200
7256454@N05,4449,2,1239494938,1239495178,3,3,240
7256454@N05,4449,1,1239507573,1239507813,7,3,240
7256454@N05,4450,13,1245116910,1245117990,1,1,1080
7256454@N05,4451,14,1279763844,1279765044,5,3,1200
7256454@N05,4451,17,1279767473,1279770173,4,3,2700
7256454@N05,4451,5,1279771615,1279772035,2,3,420
7256454@N05,4452,11,1310421481,1310422441,6,3,960
7256454@N05,4452,4,1310427456,1310427816,3,3,360
7256454@N05,4452,3,1310435829,1310436159,32,3,330
7256454@N05,4453,2,1310939092,1310939332,18,7,240
7256454@N05,4453,11,1310959180,1310959274,2,7,94
7256454@N05,4453,6,1310959274,1310959287,2,7,13
7256454@N05,4453,5,1310959287,1310959342,2,7,55
7256454@N05,4453,8,1310959342,1310959408,3,7,66
7256454@N05,4453,5,1310959408,1310959448,5,7,40
7256454@N05,4453,6,1310959448,1310960168,1,7,720
7256454@N05,4454,14,1352609086,1352610286,13,2,1200
7256454@N05,4454,3,1352610912,1352611242,1,2,330
7256454@N05,4455,1,1420268857,1420269097,1,1,240
72589879@N00,4456,11,1291500178,1291501138,3,7,960
72589879@N00,4456,12,1291506086,1291507106,2,7,1020
72589879@N00,4456,8,1291521816,1291522656,6,7,840
72589879@N00,4456,13,1291531466,1291532546,3,7,1080
72589879@N00,4456,15,1291534849,1291536049,2,7,1200
72589879@N00,4456,8,1291543643,1291543856,2,7,213
72589879@N00,4456,5,1291543856,1291544276,1,7,420
72589879@N00,4457,8,1348580462,1348581302,2,1,840
72670227@N06,4458,11,1429840593,1429841553,21,7,960
72670227@N06,4458,7,1429842460,1429843300,5,7,840
72670227@N06,4458,10,1429854743,1429855643,15,7,900
72670227@N06,4458,2,1429857001,1429857241,9,7,240
72670227@N06,4458,8,1429862942,1429863172,2,7,230
72670227@N06,4458,5,1429863172,1429863592,3,7,420
72670227@N06,4458,11,1429863976,1429864936,2,7,960
72685908@N00,4459,11,1380268057,1380269017,1,1,960
72685908@N00,4460,11,1380545161,1380546121,2,1,960
72844756@N00,4461,4,1249941307,1249941667,2,2,360
72844756@N00,4461,13,1249943774,1249944854,1,2,1080
72844756@N00,4462,11,1249984888,1249985848,1,1,960
7286287@N03,4463,2,1341911768,1341911854,2,4,86
7286287@N03,4463,7,1341911854,1341912694,2,4,840
7286287@N03,4463,17,1341913028,1341913312,2,4,284
7286287@N03,4463,13,1341913312,1341914392,1,4,1080
7287512@N02,4464,1,1270631987,1270632227,4,2,240
7287512@N02,4464,8,1270637557,1270638397,2,2,840
7287512@N02,4465,2,1270686797,1270687037,2,2,240
7287512@N02,4465,8,1270691830,1270692670,1,2,840
72895281@N03,4466,5,1359788670,1359789090,13,2,420
72895281@N03,4466,8,1359790816,1359791656,8,2,840
72949871@N00,4467,11,1302214921,1302215881,5,1,960
72977144@N00,4468,1,1210472799,1210473039,1,1,240
7307868@N02,4469,11,1384900388,1384901348,2,5,960
7307868@N02,4469,7,1384905955,1384906795,2,5,840
7307868@N02,4469,17,1384906832,1384908809,2,5,1977
7307868@N02,4469,8,1384908809,1384909649,8,5,840
7307868@N02,4469,9,1384915056,1384915956,2,5,900
73105116@N00,4470,11,1242433165,1242434125,1,1,960
73105116@N00,4471,5,1242462541,1242462961,1,1,420
73105116@N00,4472,11,1242779871,1242780831,2,2,960
73105116@N00,4472,12,1242780861,1242781881,1,2,1020
73105116@N00,4473,15,1273827397,1273828597,2,2,1200
73105116@N00,4473,9,1273829597,1273830497,1,2,900
73114641@N00,4474,2,1330852666,1330852906,1,1,240
73114641@N00,4475,11,1424503493,1424504453,2,5,960
73114641@N00,4475,3,1424504997,1424505327,18,5,330
73114641@N00,4475,9,1424506934,1424507834,3,5,900
73114641@N00,4475,10,1424509615,1424510515,8,5,900
73114641@N00,4475,15,1424510817,1424512017,5,5,1200
73114641@N00,4476,3,1427598478,1427598808,20,4,330
73114641@N00,4476,2,1427602251,1427602491,7,4,240
73114641@N00,4476,15,1427609878,1427610315,2,4,437
73114641@N00,4476,13,1427610315,1427611395,2,4,1080
73114641@N00,4477,11,1447552903,1447553863,2,1,960
73122205@N07,4478,10,1363745305,1363746205,2,3,900
73122205@N07,4478,2,1363750281,1363750521,2,3,240
73122205@N07,4478,3,1363750804,1363751134,1,3,330
73265016@N00,4479,1,1207519620,1207519860,1,1,240
7327560@N06,4480,8,1231837586,1231838426,1,1,840
7327560@N06,4481,9,1231911450,1231912350,2,3,900
7327560@N06,4481,11,1231918676,1231919636,2,3,960
7327560@N06,4481,8,1231922764,1231923604,1,3,840
7327560@N06,4482,11,1232018257,1232019217,2,1,960
73281647@N03,4483,17,1348911228,1348913928,1,1,2700
73281647@N03,4484,11,1447373636,1447374332,4,6,696
73281647@N03,4484,7,1447374332,1447375172,2,6,840
73281647@N03,4484,2,1447379853,1447380093,2,6,240
73281647@N03,4484,13,1447395129,1447396209,11,6,1080
73281647@N03,4484,15,1447400304,1447401504,3,6,1200
73281647@N03,4484,11,1447415864,1447416824,2,6,960
73287343@N03,4485,13,1360128811,1360129891,3,1,1080
73302443@N05,4486,6,1320089740,1320090460,8,1,720
73376948@N00,4487,11,1423253891,1423254851,2,1,960
73397033@N02,4488,17,1350973767,1350976467,1,1,2700
73427821@N00,4489,7,1317568277,1317569117,2,2,840
73427821@N00,4489,2,1317571335,1317571575,9,2,240
73427821@N00,4490,7,1332693873,1332694713,2,1,840
73427821@N00,4491,7,1345776657,1345777497,3,5,840
73427821@N00,4491,2,1345778905,1345779145,2,5,240
73427821@N00,4491,17,1345784287,1345784797,3,5,510
73427821@N00,4491,13,1345784797,1345785877,5,5,1080
73427821@N00,4491,6,1345793523,1345794243,1,5,720
73427821@N00,4492,10,1351674798,1351675698,3,1,900
73427821@N00,4493,10,1352432557,1352433457,18,2,900
73427821@N00,4493,5,1352440360,1352440780,2,2,420
73427821@N00,4494,2,1369458385,1369458625,3,1,240
73451901@N00,4495,5,1300872533,1300872953,3,1,420
73451901@N00,4496,11,1351146649,1351146653,2,4,4
73451901@N00,4496,5,1351146653,1351146657,3,4,4
73451901@N00,4496,9,1351146657,1351146661,2,4,4
73451901@N00,4496,11,1351146661,1351147621,1,4,960
73451901@N00,4497,13,1369561791,1369562871,1,1,1080
7349370@N04,4498,14,1196812834,1196812881,2,3,47
7349370@N04,4498,3,1196812881,1196813211,3,3,330
7349370@N04,4498,10,1196840647,1196841547,1,3,900
7349370@N04,4499,11,1241912720,1241913680,2,7,960
7349370@N04,4499,2,1241916257,1241916497,2,7,240
7349370@N04,4499,16,1241921455,1241921872,2,7,417
7349370@N04,4499,9,1241921872,1241922772,3,7,900
7349370@N04,4499,1,1241924895,1241925135,2,7,240
7349370@N04,4499,13,1241930691,1241931771,2,7,1080
7349370@N04,4499,15,1241950741,1241951941,2,7,1200
7349370@N04,4500,8,1242176945,1242177785,3,4,840
7349370@N04,4500,13,1242180506,1242181586,3,4,1080
7349370@N04,4500,17,1242186479,1242189179,4,4,2700
7349370@N04,4500,10,1242189815,1242190715,4,4,900
7349370@N04,4501,6,1242371585,1242372305,10,2,720
7349370@N04,4501,2,1242381000,1242381240,1,2,240
7349370@N04,4502,11,1289181345,1289182305,2,10,960
7349370@N04,4502,10,1289191006,1289191030,2,10,24
7349370@N04,4502,17,1289191030,1289191248,3,10,218
7349370@N04,4502,15,1289191248,1289191269,2,10,21
7349370@N04,4502,17,1289191269,1289191308,2,10,39
7349370@N04,4502,13,1289191308,1289191355,2,10,47
7349370@N04,4502,15,1289191355,1289191381,2,10,26
7349370@N04,4502,13,1289191381,1289192461,6,10,1080
7349370@N04,4502,5,1289192500,1289192727,2,10,227
7349370@N04,4502,10,1289192727,1289193627,3,10,900
7356139@N05,4503,11,1361943370,1361944330,1,1,960
7357708@N03,4504,11,1319687719,1319688679,1,1,960
73596184@N00,4505,17,1299409346,1299412046,1,1,2700
73596184@N00,4506,10,1299632257,1299633157,1,1,900
73596184@N00,4507,11,1307839421,1307840381,4,1,960
73626640@N00,4508,8,1200671217,1200672057,5,3,840
73626640@N00,4508,5,1200680942,1200681362,2,3,420
73626640@N00,4508,11,1200683476,1200684436,1,3,960
7366969@N02,4509,15,1336000499,1336001699,3,2,1200
7366969@N02,4509,11,1336003935,1336004895,13,2,960
7366969@N02,4510,17,1391470309,1391470319,2,12,10
7366969@N02,4510,15,1391470319,1391470749,2,12,430
7366969@N02,4510,4,1391470749,1391471109,9,12,360
7366969@N02,4510,11,1391472906,1391473866,4,12,960
7366969@N02,4510,12,1391474345,1391475365,6,12,1020
7366969@N02,4510,2,1391476333,1391476573,4,12,240
7366969@N02,4510,4,1391476714,1391477074,5,12,360
7366969@N02,4510,8,1391489353,1391489527,2,12,174
7366969@N02,4510,5,1391489527,1391489947,2,12,420
7366969@N02,4510,11,1391490553,1391491513,7,12,960
7366969@N02,4510,4,1391493630,1391493659,2,12,29
7366969@N02,4510,11,1391493659,1391494619,1,12,960
7366969@N02,4511,2,1391591315,1391591555,6,5,240
7366969@N02,4511,4,1391596630,1391596762,2,5,132
7366969@N02,4511,11,1391596762,1391596805,2,5,43
7366969@N02,4511,4,1391596805,1391597165,2,5,360
7366969@N02,4511,15,1391597186,1391598386,1,5,1200
7366969@N02,4512,1,1391815115,1391815355,5,3,240
7366969@N02,4512,5,1391815530,1391815950,6,3,420
7366969@N02,4512,4,1391820724,1391821084,1,3,360
7366969@N02,4513,8,1392439386,1392440226,30,7,840
7366969@N02,4513,5,1392442092,1392442512,9,7,420
7366969@N02,4513,11,1392442838,1392443798,3,7,960
7366969@N02,4513,4,1392453131,1392453491,12,7,360
7366969@N02,4513,11,1392454234,1392454392,2,7,158
7366969@N02,4513,2,1392454392,1392454632,4,7,240
7366969@N02,4513,14,1392457774,1392458974,3,7,1200
7366969@N02,4514,11,1392547402,1392548362,1,1,960
7367216@N05,4515,4,1348727926,1348728286,1,1,360
7367216@N05,4516,11,1348794967,1348795927,1,1,960
73719225@N00,4517,11,1448691570,1448692530,1,1,960
73783753@N00,4518,6,1299902745,1299903465,8,1,720
73799316@N00,4519,1,1203201252,1203201492,12,6,240
73799316@N00,4519,9,1203203815,1203204715,3,6,900
73799316@N00,4519,3,1203207617,1203207947,3,6,330
73799316@N00,4519,12,1203210853,1203211873,12,6,1020
73799316@N00,4519,8,1203215682,1203216522,4,6,840
73799316@N00,4519,11,1203230769,1203231729,8,6,960
73799444@N00,4520,4,1197892512,1197892872,3,3,360
73799444@N00,4520,8,1197909846,1197910686,2,3,840
73799444@N00,4520,11,1197914899,1197915859,1,3,960
7383636@N06,4521,11,1389486450,1389487410,2,1,960
7383636@N06,4522,8,1396145247,1396146087,2,3,840
7383636@N06,4522,2,1396156419,1396156659,2,3,240
7383636@N06,4522,11,1396157181,1396158141,3,3,960
7383636@N06,4523,17,1428543925,1428546625,1,1,2700
7383636@N06,4524,11,1446849446,1446850406,3,1,960
7385506@N05,4525,11,1458796207,1458797167,1,1,960
7389358@N06,4526,11,1346973139,1346974099,1,1,960
7389358@N06,4527,11,1347166203,1347167163,1,1,960
74089168@N00,4528,11,1447899949,1447900909,1,1,960
74111533@N00,4529,11,1286267842,1286268802,1,1,960
74285955@N00,4530,11,1320433856,1320434816,2,1,960
74285955@N00,4531,8,1320552960,1320553800,1,1,840
74289372@N00,4532,11,1318916330,1318917290,3,3,960
74289372@N00,4532,8,1318929091,1318929170,2,3,79
74289372@N00,4532,5,1318929170,1318929590,1,3,420
74289372@N00,4533,4,1319005098,1319005458,2,3,360
74289372@N00,4533,2,1319006098,1319006338,2,3,240
74289372@N00,4533,11,1319017237,1319018197,1,3,960
74366817@N06,4534,11,1387683013,1387683973,1,1,960
74366817@N06,4535,11,1391237529,1391238489,2,1,960
74366817@N06,4536,11,1401077030,1401077990,2,2,960
74366817@N06,4536,8,1401080148,1401080988,1,2,840
74372164@N04,4537,14,1352257687,1352258887,4,6,1200
74372164@N04,4537,11,1352262908,1352263868,2,6,960
74372164@N04,4537,14,1352265006,1352266206,2,6,1200
74372164@N04,4537,11,1352271099,1352272059,2,6,960
74372164@N04,4537,14,1352276452,1352277652,2,6,1200
74372164@N04,4537,11,1352278178,1352279138,1,6,960
74372164@N04,4538,11,1352345423,1352345423,2,4,0
74372164@N04,4538,14,1352345423,1352345534,4,4,111
74372164@N04,4538,11,1352345534,1352345548,2,4,14
74372164@N04,4538,14,1352345548,1352346748,1,4,1200
74372164@N04,4539,11,1386566292,1386567252,1,1,960
74434146@N04,4540,12,1329439166,1329440186,2,2,1020
74434146@N04,4540,4,1329444943,1329445303,1,2,360
74434146@N04,4541,5,1329706183,1329706603,2,2,420
74434146@N04,4541,13,1329711858,1329712938,2,2,1080
74453626@N00,4542,15,1449641881,1449643081,2,3,1200
74453626@N00,4542,17,1449648046,1449650746,2,3,2700
74453626@N00,4542,15,1449652600,1449653800,2,3,1200
74461555@N05,4543,11,1336084742,1336085702,5,1,960
74461555@N05,4544,11,1360381480,1360382440,3,2,960
74461555@N05,4544,8,1360410080,1360410920,2,2,840
74461555@N05,4545,11,1362553022,1362553982,4,2,960
74461555@N05,4545,17,1362557781,1362560481,1,2,2700
74461555@N05,4546,13,1380854661,1380855741,3,1,1080
74476774@N00,4547,11,1382419253,1382420213,1,1,960
7450381@N05,4548,2,1414727463,1414727703,1,1,240
7451382@N03,4549,2,1393648897,1393649137,30,1,240
7451382@N03,4550,6,1393816823,1393817543,2,2,720
7451382@N03,4550,17,1393837229,1393839929,8,2,2700
7451382@N03,4551,7,1393917926,1393918766,67,1,840
74594191@N07,4552,11,1424203075,1424204035,1,1,960
74689807@N03,4553,11,1392945610,1392946570,1,1,960
74754977@N03,4554,11,1468761240,1468762200,1,1,960
74762998@N08,4555,11,1346352529,1346353489,26,1,960
74865359@N00,4556,11,1386827726,1386828596,2,3,870
74865359@N00,4556,9,1386828596,1386829176,2,3,580
74865359@N00,4556,7,1386829176,1386830016,2,3,840
74865359@N00,4557,16,1391663504,1391665604,3,3,2100
74865359@N00,4557,17,1391667652,1391670352,2,3,2700
74865359@N00,4557,11,1391679075,1391680035,1,3,960
74865359@N00,4558,17,1412052355,1412055055,1,1,2700
74865359@N00,4559,11,1425273586,1425274546,2,3,960
74865359@N00,4559,8,1425288301,1425289045,2,3,744
74865359@N00,4559,11,1425289045,1425290005,1,3,960
7486728@N03,4560,11,1188073781,1188074741,2,6,960
7486728@N03,4560,10,1188080849,1188081160,5,6,311
7486728@N03,4560,15,1188081160,1188081695,7,6,535
7486728@N03,4560,13,1188081695,1188081829,2,6,134
7486728@N03,4560,15,1188081829,1188081953,2,6,124
7486728@N03,4560,13,1188081953,1188083033,2,6,1080
7486728@N03,4561,11,1188201388,1188202348,1,1,960
7490466@N08,4562,5,1192767919,1192768339,1,1,420
74939715@N05,4563,11,1246138902,1246139862,1,1,960
74939715@N05,4564,11,1364797596,1364798556,1,1,960
74939715@N05,4565,15,1395731925,1395733125,1,1,1200
74953875@N00,4566,6,1291962803,1291963523,3,3,720
74953875@N00,4566,11,1291963917,1291964877,3,3,960
74953875@N00,4566,1,1291970343,1291970583,1,3,240
7515797@N06,4567,11,1276407970,1276408930,3,3,960
7515797@N06,4567,13,1276412199,1276413279,6,3,1080
7515797@N06,4567,8,1276415039,1276415879,1,3,840
7526168@N06,4568,11,1361145019,1361145979,3,3,960
7526168@N06,4568,5,1361147379,1361147799,3,3,420
7526168@N06,4568,11,1361165128,1361166088,1,3,960
7527751@N05,4569,11,1290156111,1290157071,4,1,960
75296851@N06,4570,11,1326456376,1326457336,1,1,960
75338025@N07,4571,11,1383536194,1383537154,3,7,960
75338025@N07,4571,6,1383539947,1383540454,2,7,507
75338025@N07,4571,8,1383540454,1383540620,2,7,166
75338025@N07,4571,5,1383540620,1383541040,2,7,420
75338025@N07,4571,2,1383553431,1383553671,4,7,240
75338025@N07,4571,1,1383554127,1383554367,6,7,240
75338025@N07,4571,11,1383559446,1383560406,1,7,960
75421381@N00,4572,11,1223528422,1223529382,1,1,960
7552795@N03,4573,11,1373078424,1373079384,2,3,960
7552795@N03,4573,5,1373081957,1373082377,7,3,420
7552795@N03,4573,8,1373089098,1373089938,1,3,840
7552795@N03,4574,11,1373370006,1373370966,1,1,960
7552795@N03,4575,11,1373433933,1373434893,1,1,960
7552795@N03,4576,8,1373789132,1373789972,1,1,840
75601845@N06,4577,15,1283514413,1283515613,21,1,1200
75601845@N06,4578,9,1284292690,1284293590,19,2,900
75601845@N06,4578,4,1284294371,1284294731,69,2,360
75601845@N06,4579,1,1284384172,1284384412,18,2,240
75601845@N06,4579,9,1284385361,1284386261,7,2,900
75601845@N06,4580,9,1327716205,1327717105,130,1,900
75663005@N03,4581,16,1356148162,1356150262,1,1,2100
75678739@N00,4582,3,1354318748,1354319078,2,2,330
75678739@N00,4582,8,1354326151,1354326991,1,2,840
75678739@N00,4583,17,1358568922,1358571622,1,1,2700
75742976@N05,4584,11,1353681007,1353681967,2,3,960
75742976@N05,4584,2,1353688459,1353688699,2,3,240
75742976@N05,4584,9,1353696660,1353697560,1,3,900
75742976@N05,4585,11,1365845234,1365846194,1,1,960
75745610@N00,4586,11,1359280439,1359281399,1,1,960
75806696@N00,4587,13,1383099515,1383100595,1,1,1080
75837785@N00,4588,1,1366939980,1366940220,2,2,240
75837785@N00,4588,5,1366944600,1366945020,1,2,420
75837785@N00,4589,11,1366988221,1366989181,1,1,960
75837785@N00,4590,10,1367055769,1367056154,2,3,385
75837785@N00,4590,8,1367056154,1367056994,2,3,840
75837785@N00,4590,5,1367058074,1367058494,1,3,420
75990687@N05,4591,16,1437780509,1437782609,6,5,2100
75990687@N05,4591,2,1437787717,1437787957,3,5,240
75990687@N05,4591,3,1437796341,1437796671,11,5,330
75990687@N05,4591,14,1437798859,1437800059,3,5,1200
75990687@N05,4591,8,1437806114,1437806954,3,5,840
75992475@N02,4592,17,1372470033,1372472733,1,1,2700
76024515@N07,4593,8,1347529380,1347530220,1,1,840
76024515@N07,4594,2,1347663218,1347663458,1,1,240
76024515@N07,4595,11,1347859094,1347860054,1,1,960
76024515@N07,4596,10,1369454251,1369455151,1,1,900
76059924@N03,4597,11,1296634685,1296635645,1,1,960
76072437@N02,4598,17,1454634522,1454637222,1,1,2700
76101503@N00,4599,1,1414983231,1414983471,1,1,240
7612058@N04,4600,8,1254238136,1254238976,1,1,840
76151808@N00,4601,13,1234667032,1234668112,2,2,1080
76151808@N00,4601,5,1234678539,1234678959,1,2,420
76151808@N00,4602,11,1235001870,1235002830,2,4,960
76151808@N00,4602,2,1235011696,1235011936,2,4,240
76151808@N00,4602,14,1235015570,1235016770,6,4,1200
76151808@N00,4602,8,1235022555,1235023395,1,4,840
76151808@N00,4603,4,1265945814,1265946174,3,4,360
76151808@N00,4603,16,1265953233,1265955333,3,4,2100
76151808@N00,4603,9,1265958226,1265959126,2,4,900
76151808@N00,4603,15,1265962758,1265963958,2,4,1200
76151808@N00,4604,1,1266105414,1266105483,2,4,69
76151808@N00,4604,2,1266105483,1266105723,2,4,240
76151808@N00,4604,11,1266106363,1266107323,2,4,960
76151808@N00,4604,9,1266107399,1266108299,1,4,900
76151808@N00,4605,11,1266469962,1266470922,3,1,960
76151808@N00,4606,13,1298013018,1298014098,2,1,1080
76151808@N00,4607,8,1298345402,1298346242,3,2,840
76151808@N00,4607,11,1298362324,1298363284,1,2,960
76151808@N00,4608,17,1361593264,1361595964,1,1,2700
76151808@N00,4609,11,1424164902,1424165862,1,1,960
76151808@N00,4610,6,1451289395,1451290115,1,1,720
76192008@N07,4611,17,1350391119,1350393819,1,1,2700
76193525@N05,4612,8,1328660121,1328660961,1,1,840
76193525@N05,4613,13,1328692721,1328692728,3,2,7
76193525@N05,4613,15,1328692728,1328693928,1,2,1200
76193525@N05,4614,17,1329115550,1329118250,1,1,2700
76270281@N05,4615,11,1375316242,1375317202,2,2,960
76270281@N05,4615,6,1375323500,1375324220,1,2,720
76343652@N04,4616,11,1462231776,1462232736,2,1,960
76356046@N05,4617,1,1272606106,1272606346,3,3,240
76356046@N05,4617,2,1272606949,1272607189,4,3,240
76356046@N05,4617,11,1272614956,1272615916,1,3,960
7649501@N05,4618,6,1337685054,1337685774,3,1,720
76665138@N00,4619,7,1263170511,1263171351,1,1,840
76665138@N00,4620,15,1263364691,1263365891,2,2,1200
76665138@N00,4620,5,1263369081,1263369501,1,2,420
76665138@N00,4621,11,1325834647,1325835607,1,1,960
76665138@N00,4622,11,1325886616,1325887576,1,1,960
76665138@N00,4623,11,1326100505,1326101465,1,1,960
76665138@N00,4624,11,1326276069,1326277029,2,1,960
76665138@N00,4625,11,1326323780,1326324740,2,8,960
76665138@N00,4625,3,1326324841,1326325171,3,8,330
76665138@N00,4625,9,1326327709,1326328609,2,8,900
76665138@N00,4625,4,1326330037,1326330397,3,8,360
76665138@N00,4625,5,1326334461,1326334881,6,8,420
76665138@N00,4625,13,1326341100,1326342180,6,8,1080
76665138@N00,4625,17,1326344483,1326345068,4,8,585
76665138@N00,4625,15,1326345068,1326346268,2,8,1200
76702422@N05,4626,11,1335061404,1335062364,2,1,960
76704164@N00,4627,9,1371523132,1371524032,2,1,900
76730958@N07,4628,11,1365126529,1365127489,1,1,960
7675784@N04,4629,11,1376197762,1376198722,1,1,960
76765378@N00,4630,4,1388876736,1388877096,1,1,360
76766156@N06,4631,11,1391215679,1391216639,2,10,960
76766156@N06,4631,2,1391220048,1391220288,2,10,240
76766156@N06,4631,11,1391237549,1391238509,3,10,960
76766156@N06,4631,9,1391238683,1391239583,2,10,900
76766156@N06,4631,2,1391245714,1391245954,6,10,240
76766156@N06,4631,4,1391246030,1391246390,4,10,360
76766156@N06,4631,17,1391249685,1391250514,4,10,829
76766156@N06,4631,15,1391250514,1391251714,3,10,1200
76766156@N06,4631,8,1391267683,1391268523,11,10,840
76766156@N06,4631,11,1391272619,1391273579,1,10,960
76795008@N04,4632,13,1267695610,1267696690,1,1,1080
76795008@N04,4633,5,1268967589,1268968009,1,1,420
76795008@N04,4634,15,1273761515,1273762715,3,1,1200
7682911@N05,4635,15,1303309005,1303310205,2,1,1200
76830337@N07,4636,8,1333180992,1333181832,1,1,840
76830337@N07,4637,10,1408741200,1408741202,2,3,2
76830337@N07,4637,4,1408741202,1408741204,2,3,2
76830337@N07,4637,11,1408741204,1408742164,4,3,960
76860021@N05,4638,11,1345169604,1345170564,3,1,960
76860021@N05,4639,11,1345496636,1345497596,1,1,960
76954449@N08,4640,11,1354328429,1354329389,1,1,960
76954449@N08,4641,11,1355225239,1355226199,1,1,960
76985374@N00,4642,11,1300578648,1300579608,27,1,960
76991932@N00,4643,2,1433839250,1433839490,1,1,240
76991932@N00,4644,11,1461297748,1461298708,1,1,960
77000749@N08,4645,11,1389231248,1389232208,1,1,960
7704455@N02,4646,11,1254204772,1254205732,2,4,960
7704455@N02,4646,6,1254214737,1254215457,9,4,720
7704455@N02,4646,11,1254217355,1254217697,2,4,342
7704455@N02,4646,6,1254217697,1254218417,6,4,720
77099055@N08,4647,3,1298073596,1298073926,1,1,330
77105859@N02,4648,9,1336441275,1336442175,2,4,900
77105859@N02,4648,5,1336445171,1336445591,2,4,420
77105859@N02,4648,1,1336448818,1336449058,2,4,240
77105859@N02,4648,2,1336451043,1336451283,1,4,240
77179348@N00,4649,13,1342000684,1342001213,3,7,529
77179348@N00,4649,8,1342001213,1342001369,2,7,156
77179348@N00,4649,5,1342001369,1342001650,2,7,281
77179348@N00,4649,11,1342001650,1342002610,26,7,960
77179348@N00,4649,1,1342003291,1342003402,3,7,111
77179348@N00,4649,5,1342003402,1342003822,7,7,420
77179348@N00,4649,11,1342005711,1342006671,1,7,960
77179348@N00,4650,11,1342255729,1342256123,3,17,394
77179348@N00,4650,2,1342256123,1342256363,16,17,240
77179348@N00,4650,12,1342256858,1342257016,2,17,158
77179348@N00,4650,7,1342257016,1342257056,3,17,40
77179348@N00,4650,3,1342257056,1342257310,9,17,254
77179348@N00,4650,14,1342257310,1342257653,13,17,343
77179348@N00,4650,3,1342257653,1342257983,20,17,330
77179348@N00,4650,1,1342258557,1342258607,2,17,50
77179348@N00,4650,9,1342258607,1342259507,10,17,900
77179348@N00,4650,1,1342259825,1342260059,4,17,234
77179348@N00,4650,16,1342260059,1342260172,5,17,113
77179348@N00,4650,1,1342260172,1342260412,7,17,240
77179348@N00,4650,5,1342260585,1342260883,5,17,298
77179348@N00,4650,8,1342260883,1342261723,2,17,840
77179348@N00,4650,13,1342266657,1342266846,2,17,189
77179348@N00,4650,17,1342266846,1342266963,4,17,117
77179348@N00,4650,10,1342266963,1342267863,3,17,900
77179348@N00,4651,11,1442461346,1442461854,8,26,508
77179348@N00,4651,5,1442461854,1442462274,47,26,420
77179348@N00,4651,11,1442467019,1442467222,7,26,203
77179348@N00,4651,12,1442467222,1442467425,3,26,203
77179348@N00,4651,17,1442467425,1442467552,2,26,127
77179348@N00,4651,13,1442467552,1442468632,2,26,1080
77179348@N00,4651,7,1442469554,1442469578,3,26,24
77179348@N00,4651,3,1442469578,1442469655,5,26,77
77179348@N00,4651,7,1442469655,1442470495,3,26,840
77179348@N00,4651,2,1442472410,1442472650,13,26,240
77179348@N00,4651,1,1442474279,1442474467,2,26,188
77179348@N00,4651,9,1442474467,1442475367,12,26,900
77179348@N00,4651,16,1442475637,1442477737,63,26,2100
77179348@N00,4651,4,1442478778,1442479098,12,26,320
77179348@N00,4651,3,1442479098,1442479101,2,26,3
77179348@N00,4651,4,1442479101,1442479182,5,26,81
77179348@N00,4651,3,1442479182,1442479238,4,26,56
77179348@N00,4651,4,1442479238,1442479281,3,26,43
77179348@N00,4651,10,1442479281,1442479283,2,26,2
77179348@N00,4651,4,1442479283,1442479643,21,26,360
77179348@N00,4651,1,1442482000,1442482240,14,26,240
77179348@N00,4651,13,1442486351,1442486926,9,26,575
77179348@N00,4651,17,1442486926,1442486996,2,26,70
77179348@N00,4651,15,1442486996,1442487063,2,26,67
77179348@N00,4651,17,1442487063,1442487115,2,26,52
77179348@N00,4651,10,1442487115,1442488015,30,26,900
77219100@N03,4652,4,1375322893,1375323253,1,1,360
77219100@N03,4653,4,1375353471,1375353831,1,1,360
77260531@N03,4654,6,1199364744,1199365464,2,1,720
77260531@N03,4655,11,1364545300,1364546260,1,1,960
77265242@N00,4656,17,1356406847,1356409547,1,1,2700
7732814@N08,4657,9,1346297125,1346298025,1,1,900
77382220@N08,4658,11,1365298898,1365299858,1,1,960
77395664@N00,4659,8,1412499718,1412500558,3,1,840
77395664@N00,4660,13,1412574275,1412575355,1,1,1080
77437178@N00,4661,17,1248661452,1248663490,2,5,2038
77437178@N00,4661,1,1248663490,1248663730,2,5,240
77437178@N00,4661,11,1248666453,1248667413,3,5,960
77437178@N00,4661,5,1248668939,1248669359,2,5,420
77437178@N00,4661,17,1248679149,1248681849,1,5,2700
77437178@N00,4662,15,1273226941,1273228141,2,2,1200
77437178@N00,4662,11,1273239893,1273240853,1,2,960
77437178@N00,4663,9,1316839292,1316840192,2,2,900
77437178@N00,4663,11,1316851396,1316852356,1,2,960
77437178@N00,4664,8,1332565248,1332566088,2,2,840
77437178@N00,4664,4,1332580164,1332580524,1,2,360
77463997@N03,4665,8,1359108714,1359109554,1,1,840
77463997@N03,4666,17,1427060774,1427063474,1,1,2700
77463997@N03,4667,4,1427351860,1427352220,1,1,360
77503031@N00,4668,11,1261512523,1261513483,1,1,960
77512391@N02,4669,11,1391105553,1391106513,2,1,960
77545914@N00,4670,4,1268096015,1268096375,2,5,360
77545914@N00,4670,9,1268101503,1268102068,3,5,565
77545914@N00,4670,2,1268102068,1268102104,3,5,36
77545914@N00,4670,11,1268102104,1268103064,2,5,960
77545914@N00,4670,15,1268119859,1268121059,2,5,1200
77545914@N00,4671,11,1268271766,1268272726,1,1,960
77692940@N00,4672,2,1367207030,1367207270,2,1,240
77744839@N00,4673,11,1389414278,1389415238,2,3,960
77744839@N00,4673,9,1389417412,1389418140,2,3,728
77744839@N00,4673,16,1389418140,1389420240,1,3,2100
77744839@N00,4674,11,1389464031,1389464991,1,1,960
77744839@N00,4675,16,1389502858,1389504958,2,3,2100
77744839@N00,4675,1,1389505920,1389506160,3,3,240
77744839@N00,4675,5,1389508440,1389508860,1,3,420
77890545@N08,4676,11,1360158611,1360159571,44,1,960
77932199@N07,4677,11,1333945921,1333946881,2,2,960
77932199@N07,4677,10,1333951198,1333952098,6,2,900
77932199@N07,4678,16,1334029274,1334031374,1,1,2100
77932199@N07,4679,5,1340783008,1340783428,6,3,420
77932199@N07,4679,16,1340784098,1340786198,4,3,2100
77932199@N07,4679,11,1340798636,1340799596,2,3,960
77932199@N07,4680,11,1341200540,1341201500,2,4,960
77932199@N07,4680,10,1341209977,1341210877,14,4,900
77932199@N07,4680,17,1341211812,1341212159,2,4,347
77932199@N07,4680,13,1341212159,1341213239,2,4,1080
77979716@N02,4681,11,1455973200,1455974160,2,1,960
77979716@N02,4682,6,1456040009,1456040729,5,1,720
7804123@N08,4683,4,1410188254,1410188614,1,1,360
78046504@N07,4684,11,1336387618,1336388578,1,1,960
7807827@N04,4685,11,1271241212,1271242172,1,1,960
78079154@N08,4686,11,1351054869,1351055829,1,1,960
78089576@N06,4687,11,1333097677,1333098637,2,1,960
78132024@N00,4688,8,1389147789,1389148629,1,1,840
78147513@N00,4689,1,1271139761,1271140001,1,1,240
78166585@N05,4690,8,1414642528,1414643368,1,1,840
78299922@N08,4691,11,1282176359,1282177319,1,1,960
78299922@N08,4692,11,1282217684,1282218644,1,1,960
7830943@N03,4693,1,1381741507,1381741747,1,1,240
78319592@N00,4694,16,1281760974,1281763074,4,3,2100
78319592@N00,4694,3,1281773901,1281774231,2,3,330
78319592@N00,4694,8,1281780061,1281780901,2,3,840
78345092@N07,4695,11,1372562117,1372563077,2,5,960
78345092@N07,4695,16,1372569513,1372571613,2,5,2100
78345092@N07,4695,4,1372580950,1372581310,2,5,360
78345092@N07,4695,5,1372585418,1372585838,2,5,420
78345092@N07,4695,11,1372588165,1372589125,1,5,960
78364960@N04,4696,16,1333770057,1333772157,2,3,2100
78364960@N04,4696,2,1333773025,1333773265,2,3,240
78364960@N04,4696,15,1333776447,1333777647,1,3,1200
78364960@N04,4697,11,1339932181,1339933141,1,1,960
78364960@N04,4698,11,1342166073,1342167033,2,2,960
78364960@N04,4698,8,1342176401,1342177241,1,2,840
78364960@N04,4699,11,1344667809,1344668769,2,4,960
78364960@N04,4699,8,1344678774,1344679614,3,4,840
78364960@N04,4699,5,1344683213,1344683633,4,4,420
78364960@N04,4699,11,1344684690,1344685650,1,4,960
78364960@N04,4700,11,1348219566,1348220526,1,1,960
78364960@N04,4701,8,1350795767,1350796607,2,3,840
78364960@N04,4701,4,1350803440,1350803800,2,3,360
78364960@N04,4701,11,1350807117,1350808077,1,3,960
78364960@N04,4702,11,1354871330,1354872290,2,2,960
78364960@N04,4702,17,1354874392,1354877092,1,2,2700
78364960@N04,4703,13,1356000085,1356001165,1,1,1080
78364960@N04,4704,8,1356941277,1356942117,3,2,840
78364960@N04,4704,1,1356951096,1356951336,2,2,240
78364960@N04,4705,17,1358650725,1358651691,2,4,966
78364960@N04,4705,16,1358651691,1358653791,3,4,2100
78364960@N04,4705,2,1358658558,1358658798,4,4,240
78364960@N04,4705,14,1358663212,1358664412,1,4,1200
78364960@N04,4706,11,1362797444,1362798404,2,8,960
78364960@N04,4706,17,1362803550,1362804118,2,8,568
78364960@N04,4706,13,1362804118,1362804302,2,8,184
78364960@N04,4706,15,1362804302,1362805502,2,8,1200
78364960@N04,4706,11,1362809134,1362810094,2,8,960
78364960@N04,4706,17,1362816806,1362819506,2,8,2700
78364960@N04,4706,5,1362819994,1362820414,2,8,420
78364960@N04,4706,8,1362822396,1362823236,1,8,840
78364960@N04,4707,5,1363918636,1363919056,2,2,420
78364960@N04,4707,11,1363925233,1363926193,1,2,960
78364960@N04,4708,4,1365313703,1365314063,2,3,360
78364960@N04,4708,8,1365321462,1365322302,2,3,840
78364960@N04,4708,17,1365327502,1365330202,1,3,2700
78364960@N04,4709,5,1372502234,1372502654,2,2,420
78364960@N04,4709,8,1372503981,1372504821,2,2,840
78364960@N04,4710,17,1380888382,1380890796,3,2,2414
78364960@N04,4710,11,1380890796,1380891756,1,2,960
78364960@N04,4711,16,1382485942,1382488042,2,6,2100
78364960@N04,4711,11,1382488596,1382489556,3,6,960
78364960@N04,4711,1,1382503013,1382503253,2,6,240
78364960@N04,4711,17,1382521843,1382524543,4,6,2700
78364960@N04,4711,15,1382526062,1382527262,2,6,1200
78364960@N04,4711,11,1382532482,1382533442,1,6,960
78364960@N04,4712,4,1386244387,1386244747,1,1,360
78364960@N04,4713,11,1396154675,1396155635,1,1,960
78364960@N04,4714,17,1411812428,1411815128,1,1,2700
78364960@N04,4715,11,1441540027,1441540987,1,1,960
78364960@N04,4716,10,1445081378,1445082278,2,2,900
78364960@N04,4716,11,1445085356,1445086316,2,2,960
78364960@N04,4717,11,1449123718,1449124678,1,1,960
78364960@N04,4718,8,1451560068,1451560908,2,2,840
78364960@N04,4718,5,1451561662,1451562082,1,2,420
78364960@N04,4719,5,1455866455,1455866875,1,1,420
78364960@N04,4720,8,1466569611,1466570451,7,1,840
78364960@N04,4721,16,1467621967,1467624067,1,1,2100
7838453@N07,4722,11,1337790676,1337791636,1,1,960
78493611@N00,4723,11,1383728473,1383729433,1,1,960
7849988@N04,4724,1,1429235441,1429235681,2,5,240
7849988@N04,4724,10,1429245518,1429246418,5,5,900
7849988@N04,4724,17,1429248133,1429250833,3,5,2700
7849988@N04,4724,5,1429269510,1429269930,4,5,420
7849988@N04,4724,11,1429272734,1429273694,8,5,960
7849988@N04,4725,2,1466381970,1466382210,3,2,240
7849988@N04,4725,13,1466400907,1466401987,2,2,1080
7849988@N04,4726,17,1466565130,1466567830,4,4,2700
7849988@N04,4726,13,1466571746,1466572826,2,4,1080
7849988@N04,4726,8,1466579438,1466580278,20,4,840
7849988@N04,4726,5,1466587375,1466587795,3,4,420
78562800@N05,4727,10,1355274086,1355274986,5,3,900
78562800@N05,4727,15,1355275417,1355275655,2,3,238
78562800@N05,4727,17,1355275655,1355278355,1,3,2700
78562800@N05,4728,11,1362634787,1362635747,1,1,960
7856853@N02,4729,11,1311811721,1311812681,1,1,960
78569471@N00,4730,8,1202953947,1202954787,4,1,840
78569471@N00,4731,11,1209174893,1209175853,13,1,960
78569471@N00,4732,2,1214481469,1214481709,13,1,240
78672040@N00,4733,4,1357433047,1357433407,1,1,360
78743109@N00,4734,11,1325722372,1325723309,2,7,937
78743109@N00,4734,8,1325723309,1325724149,5,7,840
78743109@N00,4734,13,1325734755,1325735835,2,7,1080
78743109@N00,4734,15,1325736558,1325737758,3,7,1200
78743109@N00,4734,5,1325741621,1325742041,4,7,420
78743109@N00,4734,4,1325746990,1325747350,2,7,360
78743109@N00,4734,12,1325753995,1325755015,2,7,1020
78779574@N00,4735,11,1336002315,1336003275,2,22,960
78779574@N00,4735,2,1336004887,1336005127,9,22,240
78779574@N00,4735,5,1336009409,1336009749,3,22,340
78779574@N00,4735,8,1336009749,1336010589,10,22,840
78779574@N00,4735,15,1336014503,1336014564,2,22,61
78779574@N00,4735,17,1336014564,1336014917,6,22,353
78779574@N00,4735,15,1336014917,1336015964,5,22,1047
78779574@N00,4735,13,1336015964,1336017044,6,22,1080
78779574@N00,4735,15,1336017666,1336017956,2,22,290
78779574@N00,4735,10,1336017956,1336018587,2,22,631
78779574@N00,4735,5,1336018587,1336019007,4,22,420
78779574@N00,4735,8,1336020847,1336021687,2,22,840
78779574@N00,4735,4,1336026565,1336026925,2,22,360
78779574@N00,4735,7,1336028720,1336029560,2,22,840
78779574@N00,4735,14,1336029853,1336029990,3,22,137
78779574@N00,4735,3,1336029990,1336030320,8,22,330
78779574@N00,4735,7,1336030831,1336030843,2,22,12
78779574@N00,4735,2,1336030843,1336031083,2,22,240
78779574@N00,4735,17,1336034472,1336034566,3,22,94
78779574@N00,4735,15,1336034566,1336034697,2,22,131
78779574@N00,4735,13,1336034697,1336035777,5,22,1080
78779574@N00,4735,11,1336044645,1336045605,4,22,960
7883384@N04,4736,11,1189030912,1189031872,1,1,960
7886635@N06,4737,11,1424476066,1424477026,3,4,960
7886635@N06,4737,17,1424489121,1424489255,2,4,134
7886635@N06,4737,8,1424489255,1424490095,2,4,840
7886635@N06,4737,11,1424510334,1424511294,6,4,960
7886635@N06,4738,11,1424935412,1424936372,1,1,960
7886635@N06,4739,17,1425282211,1425284911,2,2,2700
7886635@N06,4739,11,1425287402,1425288362,5,2,960
7886635@N06,4740,10,1425513536,1425514436,4,3,900
7886635@N06,4740,11,1425521835,1425522795,3,3,960
7886635@N06,4740,13,1425536056,1425537136,4,3,1080
79023626@N00,4741,8,1314352495,1314353335,1,1,840
79023626@N00,4742,11,1327568209,1327569169,1,1,960
79023626@N00,4743,17,1336662672,1336665372,1,1,2700
79023626@N00,4744,11,1336811002,1336811619,2,3,617
79023626@N00,4744,17,1336811619,1336814319,3,3,2700
79023626@N00,4744,11,1336817532,1336818492,1,3,960
79023626@N00,4745,11,1345715020,1345715980,1,1,960
79023626@N00,4746,15,1348820679,1348821879,1,1,1200
79023626@N00,4747,15,1354012171,1354013371,1,1,1200
79023626@N00,4748,17,1354066697,1354069397,1,1,2700
79023626@N00,4749,1,1354776829,1354777069,1,1,240
79023626@N00,4750,1,1368944255,1368944495,1,1,240
79024147@N00,4751,6,1385251370,1385252090,4,1,720
79092915@N00,4752,15,1280401618,1280402818,1,1,1200
79092915@N00,4753,11,1289000135,1289001095,1,1,960
7911596@N06,4754,5,1324625593,1324626013,2,1,420
79121533@N00,4755,3,1333255876,1333256206,2,3,330
79121533@N00,4755,7,1333257276,1333258116,2,3,840
79121533@N00,4755,4,1333262611,1333262971,2,3,360
7915108@N06,4756,8,1286609530,1286610370,1,1,840
79172203@N00,4757,9,1291496697,1291497597,2,11,900
79172203@N00,4757,2,1291502871,1291503111,2,11,240
79172203@N00,4757,12,1291503948,1291504638,3,11,690
79172203@N00,4757,2,1291504638,1291504878,2,11,240
79172203@N00,4757,10,1291505160,1291506060,11,11,900
79172203@N00,4757,15,1291506086,1291507286,4,11,1200
79172203@N00,4757,13,1291508718,1291509798,3,11,1080
79172203@N00,4757,8,1291520916,1291521756,8,11,840
79172203@N00,4757,5,1291522640,1291523060,5,11,420
79172203@N00,4757,11,1291523481,1291524441,4,11,960
79172203@N00,4757,13,1291538652,1291539732,5,11,1080
79172203@N00,4758,11,1291873209,1291874169,5,3,960
79172203@N00,4758,5,1291875250,1291875670,3,3,420
79172203@N00,4758,17,1291883509,1291886209,25,3,2700
79172203@N00,4759,12,1291969792,1291970812,7,1,1020
79172203@N00,4760,11,1292027279,1292028239,2,5,960
79172203@N00,4760,10,1292029803,1292030272,9,5,469
79172203@N00,4760,15,1292030272,1292031472,9,5,1200
79172203@N00,4760,13,1292036519,1292037599,2,5,1080
79172203@N00,4760,11,1292038035,1292038995,1,5,960
79172203@N00,4761,11,1399157980,1399158940,2,3,960
79172203@N00,4761,8,1399168178,1399169018,4,3,840
79172203@N00,4761,13,1399182087,1399183167,1,3,1080
79172203@N00,4762,11,1399502851,1399503568,11,11,717
79172203@N00,4762,9,1399503568,1399503666,4,11,98
79172203@N00,4762,1,1399503666,1399503906,2,11,240
79172203@N00,4762,10,1399504537,1399505296,25,11,759
79172203@N00,4762,15,1399505296,1399506496,38,11,1200
79172203@N00,4762,13,1399506973,1399508053,40,11,1080
79172203@N00,4762,8,1399510533,1399511373,13,11,840
79172203@N00,4762,5,1399511626,1399512046,8,11,420
79172203@N00,4762,15,1399515297,1399516497,2,11,1200
79172203@N00,4762,13,1399517720,1399518800,3,11,1080
79172203@N00,4762,8,1399520907,1399521747,2,11,840
79344793@N02,4763,11,1330744398,1330745358,1,1,960
79433444@N07,4764,10,1355065851,1355066751,1,1,900
7945368@N05,4765,11,1341641193,1341642153,1,1,960
7945637@N07,4766,3,1205551378,1205551708,1,1,330
7945637@N07,4767,8,1217123505,1217124345,2,2,840
7945637@N07,4767,11,1217132938,1217133898,2,2,960
7945637@N07,4768,8,1231642560,1231643400,3,2,840
7945637@N07,4768,13,1231649039,1231650119,1,2,1080
7945637@N07,4769,4,1234435278,1234435638,1,1,360
7945637@N07,4770,13,1243160793,1243161873,1,1,1080
7945637@N07,4771,15,1246696580,1246697780,1,1,1200
7945637@N07,4772,11,1253781797,1253782757,1,1,960
7945637@N07,4773,16,1254469256,1254471356,1,1,2100
7945637@N07,4774,11,1266565647,1266566607,2,4,960
7945637@N07,4774,9,1266567209,1266568109,2,4,900
7945637@N07,4774,3,1266575284,1266575614,2,4,330
7945637@N07,4774,11,1266578335,1266579295,1,4,960
7945637@N07,4775,10,1268540812,1268541712,1,1,900
7945637@N07,4776,10,1269674227,1269675127,2,2,900
7945637@N07,4776,11,1269675245,1269676205,1,2,960
7945637@N07,4777,13,1279966255,1279967335,1,1,1080
7945637@N07,4778,9,1284717040,1284717940,4,2,900
7945637@N07,4778,10,1284722079,1284722979,1,2,900
7945637@N07,4779,9,1298785626,1298786526,1,1,900
7945637@N07,4780,10,1300589918,1300590818,2,2,900
7945637@N07,4780,5,1300594004,1300594424,1,2,420
7945637@N07,4781,8,1313890742,1313891582,1,1,840
79498503@N03,4782,13,1315630779,1315631859,1,1,1080
79535868@N00,4783,8,1282599652,1282600492,2,4,840
79535868@N00,4783,10,1282608673,1282609016,2,4,343
79535868@N00,4783,17,1282609016,1282609204,2,4,188
79535868@N00,4783,13,1282609204,1282610284,1,4,1080
79551604@N00,4784,9,1251020074,1251020974,1,1,900
79551604@N00,4785,17,1293954259,1293956959,1,1,2700
7955606@N05,4786,13,1215419092,1215420172,3,2,1080
7955606@N05,4786,11,1215426383,1215427343,2,2,960
79577915@N00,4787,15,1290058572,1290059772,1,1,1200
79577915@N00,4788,1,1290398938,1290399178,2,3,240
79577915@N00,4788,9,1290403179,1290404079,2,3,900
79577915@N00,4788,14,1290405590,1290406790,2,3,1200
79665856@N08,4789,11,1429624800,1429625760,1,1,960
7973770@N05,4790,2,1217906338,1217906578,3,5,240
7973770@N05,4790,15,1217910173,1217911373,2,5,1200
7973770@N05,4790,13,1217922032,1217923112,3,5,1080
7973770@N05,4790,5,1217923386,1217923806,3,5,420
7973770@N05,4790,8,1217924122,1217924962,2,5,840
79743365@N00,4791,11,1292102719,1292103679,5,10,960
79743365@N00,4791,12,1292104536,1292105556,4,10,1020
79743365@N00,4791,2,1292107276,1292107516,3,10,240
79743365@N00,4791,3,1292108584,1292108914,2,10,330
79743365@N00,4791,2,1292113635,1292113875,4,10,240
79743365@N00,4791,4,1292122529,1292122889,2,10,360
79743365@N00,4791,17,1292123644,1292123921,2,10,277
79743365@N00,4791,15,1292123921,1292125121,2,10,1200
79743365@N00,4791,17,1292131302,1292132081,3,10,779
79743365@N00,4791,15,1292132081,1292133281,1,10,1200
79743365@N00,4792,11,1292535396,1292536356,4,1,960
79761301@N00,4793,17,1188219791,1188222491,1,1,2700
79761301@N00,4794,11,1287733602,1287734562,6,5,960
79761301@N00,4794,4,1287735130,1287735490,6,5,360
79761301@N00,4794,7,1287736848,1287737688,5,5,840
79761301@N00,4794,8,1287743559,1287744399,7,5,840
79761301@N00,4794,17,1287755111,1287757811,3,5,2700
79761301@N00,4795,8,1287939262,1287940102,2,3,840
79761301@N00,4795,5,1287940418,1287940838,4,3,420
79761301@N00,4795,11,1287943881,1287944841,3,3,960
79761301@N00,4796,2,1288176473,1288176713,6,7,240
79761301@N00,4796,11,1288178209,1288179169,7,7,960
79761301@N00,4796,9,1288181487,1288182387,4,7,900
79761301@N00,4796,5,1288183528,1288183948,8,7,420
79761301@N00,4796,8,1288186078,1288186918,6,7,840
79761301@N00,4796,13,1288191920,1288193000,3,7,1080
79761301@N00,4796,17,1288193995,1288196695,7,7,2700
79761301@N00,4797,5,1402192424,1402192844,5,10,420
79761301@N00,4797,8,1402194975,1402195815,6,10,840
79761301@N00,4797,13,1402199393,1402200473,2,10,1080
79761301@N00,4797,17,1402205346,1402205624,2,10,278
79761301@N00,4797,13,1402205624,1402206704,5,10,1080
79761301@N00,4797,17,1402215113,1402215493,2,10,380
79761301@N00,4797,15,1402215493,1402215724,3,10,231
79761301@N00,4797,17,1402215724,1402215903,4,10,179
79761301@N00,4797,10,1402215903,1402216803,2,10,900
79761301@N00,4797,11,1402219537,1402220497,1,10,960
79761301@N00,4798,5,1402304364,1402304784,2,3,420
79761301@N00,4798,13,1402308809,1402309889,2,3,1080
79761301@N00,4798,11,1402310724,1402311684,1,3,960
79761301@N00,4799,3,1402367889,1402368219,2,4,330
79761301@N00,4799,8,1402374508,1402374678,2,4,170
79761301@N00,4799,5,1402374678,1402375098,2,4,420
79761301@N00,4799,3,1402376304,1402376634,2,4,330
79767616@N02,4800,11,1373516527,1373517487,1,1,960
79871648@N04,4801,11,1379302807,1379303767,1,1,960
7988769@N08,4802,11,1425693914,1425694874,1,1,960
79939076@N02,4803,4,1342318008,1342318368,2,4,360
79939076@N02,4803,5,1342333634,1342334054,2,4,420
79939076@N02,4803,17,1342342552,1342342681,2,4,129
79939076@N02,4803,13,1342342681,1342343761,2,4,1080
79959485@N00,4804,11,1219294638,1219295598,5,2,960
79959485@N00,4804,2,1219306458,1219306698,1,2,240
79959485@N00,4805,11,1219553062,1219554022,2,7,960
79959485@N00,4805,9,1219554710,1219555610,2,7,900
79959485@N00,4805,7,1219561027,1219561053,2,7,26
79959485@N00,4805,4,1219561053,1219561413,2,7,360
79959485@N00,4805,5,1219561911,1219562331,5,7,420
79959485@N00,4805,11,1219569560,1219570520,2,7,960
79959485@N00,4805,8,1219575222,1219576062,79,7,840
79959485@N00,4806,8,1225973626,1225973633,2,3,7
79959485@N00,4806,11,1225973633,1225973641,2,3,8
79959485@N00,4806,5,1225973641,1225974061,1,3,420
79959485@N00,4807,8,1230552808,1230553648,3,1,840
79959485@N00,4808,11,1331676611,1331677571,18,11,960
79959485@N00,4808,3,1331682114,1331682444,7,11,330
79959485@N00,4808,11,1331684313,1331684670,3,11,357
79959485@N00,4808,3,1331684670,1331685000,2,11,330
79959485@N00,4808,4,1331689236,1331689596,2,11,360
79959485@N00,4808,3,1331691472,1331691802,5,11,330
79959485@N00,4808,12,1331695487,1331696507,8,11,1020
79959485@N00,4808,3,1331699050,1331699380,3,11,330
79959485@N00,4808,8,1331706916,1331707756,4,11,840
79959485@N00,4808,5,1331708474,1331708894,4,11,420
79959485@N00,4808,11,1331714182,1331715142,18,11,960
79959485@N00,4809,5,1331869065,1331869485,2,4,420
79959485@N00,4809,9,1331872819,1331873719,2,4,900
79959485@N00,4809,16,1331875760,1331876574,4,4,814
79959485@N00,4809,11,1331876574,1331877534,7,4,960
79959485@N00,4810,11,1331935701,1331936661,4,3,960
79959485@N00,4810,17,1331939628,1331942328,12,3,2700
79959485@N00,4810,5,1331948625,1331949045,2,3,420
79959485@N00,4811,11,1332120684,1332121644,3,4,960
79959485@N00,4811,16,1332122642,1332124293,7,4,1651
79959485@N00,4811,2,1332124293,1332124533,3,4,240
79959485@N00,4811,11,1332125639,1332126599,1,4,960
80050541@N06,4812,13,1298360007,1298361087,1,1,1080
80081080@N00,4813,11,1445492070,1445493030,1,1,960
80081080@N00,4814,11,1445764175,1445765135,9,1,960
80081080@N00,4815,11,1445824757,1445825717,6,1,960
80084904@N00,4816,4,1200866051,1200866411,1,1,360
80172766@N04,4817,9,1338018724,1338019624,1,1,900
8021465@N08,4818,11,1288785450,1288786410,1,1,960
8021465@N08,4819,5,1288856041,1288856461,1,1,420
8021465@N08,4820,8,1317364220,1317365060,1,1,840
8028661@N05,4821,11,1208787819,1208788779,1,1,960
80304458@N00,4822,15,1419479330,1419480530,1,1,1200
80446452@N00,4823,15,1302322404,1302322469,2,2,65
80446452@N00,4823,17,1302322469,1302325169,7,2,2700
80446452@N00,4824,11,1367025257,1367026217,6,5,960
80446452@N00,4824,14,1367033398,1367033450,6,5,52
80446452@N00,4824,3,1367033450,1367033780,15,5,330
80446452@N00,4824,13,1367043090,1367044170,12,5,1080
80446452@N00,4824,8,1367048996,1367049836,4,5,840
80446452@N00,4825,12,1457049100,1457050120,1,1,1020
80521687@N00,4826,11,1349406814,1349407774,2,6,960
80521687@N00,4826,14,1349407954,1349409154,2,6,1200
80521687@N00,4826,15,1349409350,1349410550,12,6,1200
80521687@N00,4826,13,1349411248,1349412328,5,6,1080
80521687@N00,4826,8,1349419181,1349420021,8,6,840
80521687@N00,4826,5,1349421249,1349421669,2,6,420
8054352@N06,4827,11,1354943541,1354944501,1,1,960
8054352@N06,4828,9,1355648360,1355649260,1,1,900
8054352@N06,4829,11,1363302003,1363302963,1,1,960
8054352@N06,4830,11,1373601351,1373602311,1,1,960
80558292@N00,4831,1,1379029213,1379029453,1,1,240
80558292@N00,4832,15,1380254561,1380255761,1,1,1200
80558292@N00,4833,15,1382685771,1382686971,1,1,1200
80558292@N00,4834,5,1382767556,1382767976,1,1,420
80580684@N06,4835,11,1317819600,1317820560,1,1,960
8066628@N02,4836,11,1189579589,1189580549,36,1,960
8066628@N02,4837,11,1190278356,1190279316,7,1,960
8066628@N02,4838,11,1230695917,1230696877,8,1,960
8066628@N02,4839,11,1231233005,1231233965,4,1,960
8066628@N02,4840,11,1287035491,1287036451,12,3,960
8066628@N02,4840,2,1287044044,1287044284,3,3,240
8066628@N02,4840,11,1287045140,1287046100,21,3,960
8066628@N02,4841,11,1343078741,1343079701,5,1,960
8068421@N07,4842,10,1192258847,1192259747,3,2,900
8068421@N07,4842,5,1192263880,1192264300,1,2,420
8068421@N07,4843,11,1200791164,1200792124,2,2,960
8068421@N07,4843,13,1200813091,1200814171,1,2,1080
8068421@N07,4844,17,1200986812,1200989512,4,1,2700
8068421@N07,4845,11,1209684860,1209685820,1,1,960
8068421@N07,4846,10,1210309442,1210310342,1,1,900
8068421@N07,4847,11,1222503681,1222504641,2,1,960
8068421@N07,4848,8,1267088224,1267089064,1,1,840
8068421@N07,4849,5,1295787647,1295788067,2,1,420
8068421@N07,4850,13,1296198651,1296199731,2,2,1080
8068421@N07,4850,10,1296211802,1296212702,1,2,900
8068421@N07,4851,16,1337322749,1337324849,2,2,2100
8068421@N07,4851,15,1337332990,1337334190,1,2,1200
8068421@N07,4852,17,1349149267,1349149472,2,9,205
8068421@N07,4852,10,1349149472,1349150089,2,9,617
8068421@N07,4852,5,1349150089,1349150304,2,9,215
8068421@N07,4852,8,1349150304,1349150874,2,9,570
8068421@N07,4852,5,1349150874,1349151294,2,9,420
8068421@N07,4852,17,1349153058,1349153267,2,9,209
8068421@N07,4852,15,1349153267,1349154182,3,9,915
8068421@N07,4852,13,1349154182,1349155262,2,9,1080
8068421@N07,4852,8,1349155636,1349156476,1,9,840
8068835@N04,4853,3,1333062221,1333062551,6,10,330
8068835@N04,4853,2,1333062656,1333062896,47,10,240
8068835@N04,4853,16,1333066596,1333068696,8,10,2100
8068835@N04,4853,9,1333069191,1333069276,7,10,85
8068835@N04,4853,1,1333069276,1333069516,21,10,240
8068835@N04,4853,5,1333069885,1333070305,27,10,420
8068835@N04,4853,8,1333071492,1333072332,52,10,840
8068835@N04,4853,13,1333074615,1333075003,6,10,388
8068835@N04,4853,10,1333075003,1333075571,6,10,568
8068835@N04,4853,11,1333075571,1333076531,17,10,960
8068835@N04,4854,11,1333597032,1333597965,30,7,933
8068835@N04,4854,4,1333597965,1333598325,7,7,360
8068835@N04,4854,10,1333599892,1333600792,7,7,900
8068835@N04,4854,15,1333601806,1333603006,27,7,1200
8068835@N04,4854,13,1333608519,1333609200,32,7,681
8068835@N04,4854,15,1333609200,1333610197,22,7,997
8068835@N04,4854,11,1333610197,1333611157,43,7,960
8068835@N04,4855,13,1333859568,1333860648,19,2,1080
8068835@N04,4855,15,1333864397,1333865597,6,2,1200
8068835@N04,4856,11,1409883845,1409884805,18,5,960
8068835@N04,4856,13,1409891771,1409892851,40,5,1080
8068835@N04,4856,5,1409898252,1409898648,7,5,396
8068835@N04,4856,9,1409898648,1409899126,4,5,478
8068835@N04,4856,11,1409899126,1409900086,12,5,960
8074702@N06,4857,11,1371601791,1371602751,1,1,960
80775532@N06,4858,11,1442709680,1442710640,8,10,960
80775532@N06,4858,1,1442714425,1442714665,5,10,240
80775532@N06,4858,11,1442738929,1442739723,3,10,794
80775532@N06,4858,8,1442739723,1442740563,8,10,840
80775532@N06,4858,13,1442740980,1442741197,4,10,217
80775532@N06,4858,15,1442741197,1442741444,2,10,247
80775532@N06,4858,10,1442741444,1442742344,5,10,900
80775532@N06,4858,4,1442743202,1442743562,2,10,360
80775532@N06,4858,9,1442744272,1442745172,5,10,900
80775532@N06,4858,11,1442747205,1442748165,2,10,960
80777965@N00,4859,11,1338279172,1338280132,1,1,960
80777965@N00,4860,11,1338564724,1338565684,1,1,960
80784859@N00,4861,11,1308043027,1308043987,1,1,960
8078549@N07,4862,11,1255561659,1255562619,1,1,960
8078549@N07,4863,11,1402112759,1402113719,10,1,960
8078549@N07,4864,11,1402275191,1402276151,34,1,960
80848604@N02,4865,11,1329962654,1329963614,1,1,960
80848604@N02,4866,11,1340686192,1340687152,7,1,960
80848604@N02,4867,11,1340773151,1340774111,15,1,960
80852176@N00,4868,5,1430900861,1430901281,1,1,420
80874876@N07,4869,11,1471746628,1471747588,28,1,960
80874876@N07,4870,11,1471838144,1471839104,1,1,960
8095506@N07,4871,1,1285471130,1285471370,61,1,240
8095506@N07,4872,1,1285993904,1285994144,17,1,240
8095506@N07,4873,11,1381449941,1381450901,47,1,960
8095506@N07,4874,11,1382064002,1382064962,34,1,960
80987905@N00,4875,4,1210503139,1210503499,1,1,360
8100133@N05,4876,11,1413425642,1413426602,2,3,960
8100133@N05,4876,8,1413432942,1413433782,2,3,840
8100133@N05,4876,9,1413441184,1413442084,1,3,900
81066829@N00,4877,11,1300244614,1300245574,4,1,960
81077186@N00,4878,11,1335592968,1335593928,2,1,960
8109191@N05,4879,11,1393486136,1393487096,1,1,960
8110876@N06,4880,12,1414887363,1414888383,11,1,1020
81118280@N00,4881,5,1317981331,1317981751,1,1,420
81167176@N00,4882,11,1342712578,1342713538,1,1,960
8116972@N07,4883,4,1417832199,1417832559,1,1,360
8116972@N07,4884,5,1417937759,1417938179,1,1,420
8124939@N07,4885,4,1200178724,1200179084,2,4,360
8124939@N07,4885,13,1200180196,1200181276,3,4,1080
8124939@N07,4885,6,1200193769,1200193842,2,4,73
8124939@N07,4885,5,1200193842,1200194262,4,4,420
8128484@N02,4886,6,1423283617,1423284337,5,1,720
8128484@N02,4887,8,1423946960,1423947800,2,1,840
8128484@N02,4888,8,1428394544,1428395384,1,1,840
81291546@N02,4889,8,1357879287,1357880127,3,2,840
81291546@N02,4889,4,1357886415,1357886775,1,2,360
81291546@N02,4890,8,1358067003,1358067843,2,2,840
81291546@N02,4890,11,1358077657,1358078617,1,2,960
81291546@N02,4891,16,1382156047,1382158147,2,2,2100
81291546@N02,4891,13,1382182828,1382183908,1,2,1080
81291546@N02,4892,2,1382484208,1382484448,1,1,240
81291546@N02,4893,13,1423436447,1423437527,1,1,1080
81292745@N00,4894,9,1305245953,1305246853,1,1,900
81322238@N00,4895,1,1273963352,1273963358,2,19,6
81322238@N00,4895,9,1273963358,1273964258,15,19,900
81322238@N00,4895,1,1273966047,1273966287,3,19,240
81322238@N00,4895,11,1273968422,1273969382,3,19,960
81322238@N00,4895,5,1273969788,1273970204,3,19,416
81322238@N00,4895,8,1273970204,1273971044,9,19,840
81322238@N00,4895,5,1273971203,1273971572,2,19,369
81322238@N00,4895,8,1273971572,1273972412,24,19,840
81322238@N00,4895,13,1273976262,1273976847,4,19,585
81322238@N00,4895,17,1273976847,1273977623,4,19,776
81322238@N00,4895,13,1273977623,1273978214,8,19,591
81322238@N00,4895,17,1273978214,1273979224,4,19,1010
81322238@N00,4895,10,1273979224,1273980124,8,19,900
81322238@N00,4895,4,1273981220,1273981580,2,19,360
81322238@N00,4895,16,1273983242,1273985342,11,19,2100
81322238@N00,4895,1,1273986350,1273986590,2,19,240
81322238@N00,4895,9,1273987784,1273988441,13,19,657
81322238@N00,4895,2,1273988441,1273988681,5,19,240
81322238@N00,4895,17,1274006811,1274009511,1,19,2700
81383122@N05,4896,15,1298421455,1298421816,3,3,361
81383122@N05,4896,13,1298421816,1298422896,3,3,1080
81383122@N05,4896,11,1298446889,1298447849,1,3,960
81483739@N00,4897,11,1398424568,1398425528,1,1,960
81546947@N00,4898,13,1193290859,1193291939,1,1,1080
81713706@N05,4899,2,1399084188,1399084428,5,3,240
81713706@N05,4899,11,1399091274,1399092234,2,3,960
81713706@N05,4899,3,1399094315,1399094645,2,3,330
81713706@N05,4900,2,1399617036,1399617276,3,1,240
81713774@N03,4901,8,1445835653,1445836493,1,1,840
81714212@N05,4902,9,1386995444,1386996344,1,1,900
81723626@N00,4903,11,1451263503,1451264463,2,1,960
81734534@N05,4904,10,1420280126,1420281026,1,1,900
81810968@N02,4905,15,1342849278,1342850478,3,4,1200
81810968@N02,4905,5,1342855278,1342855481,3,4,203
81810968@N02,4905,13,1342855481,1342856561,8,4,1080
81810968@N02,4905,8,1342858305,1342859145,3,4,840
81834077@N00,4906,11,1213938142,1213939102,1,1,960
81834077@N00,4907,11,1214190624,1214191584,2,9,960
81834077@N00,4907,7,1214192159,1214192999,2,9,840
81834077@N00,4907,11,1214197173,1214197510,3,9,337
81834077@N00,4907,2,1214197510,1214197750,3,9,240
81834077@N00,4907,4,1214211741,1214212101,4,9,360
81834077@N00,4907,11,1214214932,1214215892,2,9,960
81834077@N00,4907,8,1214218295,1214219135,4,9,840
81834077@N00,4907,17,1214225245,1214226369,2,9,1124
81834077@N00,4907,11,1214226369,1214227329,3,9,960
81834077@N00,4908,11,1214540421,1214541381,4,3,960
81834077@N00,4908,8,1214553823,1214554663,2,3,840
81834077@N00,4908,11,1214574014,1214574974,3,3,960
81855582@N00,4909,7,1255150234,1255151074,1,1,840
81855582@N00,4910,1,1255217175,1255217415,4,2,240
81855582@N00,4910,5,1255227732,1255228152,1,2,420
82031849@N00,4911,10,1357272522,1357273422,1,1,900
82031849@N00,4912,5,1357639244,1357639664,36,1,420
82031849@N00,4913,1,1363575705,1363575945,3,2,240
82031849@N00,4913,16,1363576029,1363578129,1,2,2100
82109786@N06,4914,11,1430694923,1430695883,1,1,960
82109786@N06,4915,8,1430874300,1430875140,2,2,840
82109786@N06,4915,17,1430878939,1430881639,2,2,2700
82109786@N06,4916,6,1445056732,1445057452,1,1,720
82109786@N06,4917,2,1461978142,1461978382,2,1,240
82211889@N00,4918,3,1326360712,1326361042,1,1,330
82211889@N00,4919,2,1326530348,1326530588,5,1,240
82211889@N00,4920,3,1458963336,1458963666,12,2,330
82211889@N00,4920,17,1458986435,1458989135,15,2,2700
82211889@N00,4921,13,1459060814,1459061894,2,1,1080
82211889@N00,4922,3,1459287207,1459287537,12,3,330
82211889@N00,4922,14,1459290113,1459290279,3,3,166
82211889@N00,4922,3,1459290279,1459290609,2,3,330
82211889@N00,4923,17,1459376489,1459379189,1,1,2700
82211889@N00,4924,15,1459421056,1459422256,2,1,1200
82211889@N00,4925,10,1459509366,1459510266,1,1,900
82335642@N00,4926,11,1258795560,1258796520,2,3,960
82335642@N00,4926,5,1258797446,1258797866,4,3,420
82335642@N00,4926,8,1258798325,1258799165,1,3,840
82335642@N00,4927,13,1258959588,1258960668,2,2,1080
82335642@N00,4927,6,1258963234,1258963954,9,2,720
82418556@N00,4928,11,1357913340,1357914300,4,7,960
82418556@N00,4928,12,1357941218,1357941609,2,7,391
82418556@N00,4928,11,1357941609,1357942569,4,7,960
82418556@N00,4928,4,1357947088,1357947448,3,7,360
82418556@N00,4928,9,1357957719,1357958132,4,7,413
82418556@N00,4928,5,1357958132,1357958552,5,7,420
82418556@N00,4928,11,1357964732,1357965692,1,7,960
82418556@N00,4929,11,1358000843,1358001803,2,2,960
82418556@N00,4929,13,1358024957,1358026037,1,2,1080
82418556@N00,4930,11,1380871165,1380872125,2,1,960
82432080@N00,4931,14,1269646250,1269646820,3,4,570
82432080@N00,4931,3,1269646820,1269647150,2,4,330
82432080@N00,4931,4,1269647552,1269647912,2,4,360
82432080@N00,4931,11,1269650419,1269651379,1,4,960
82432080@N00,4932,17,1272484360,1272487060,1,1,2700
8245538@N06,4933,11,1405731731,1405732691,5,9,960
8245538@N06,4933,5,1405738330,1405738750,2,9,420
8245538@N06,4933,8,1405743199,1405744039,2,9,840
8245538@N06,4933,17,1405755471,1405755649,3,9,178
8245538@N06,4933,15,1405755649,1405755652,2,9,3
8245538@N06,4933,17,1405755652,1405755673,2,9,21
8245538@N06,4933,15,1405755673,1405756381,2,9,708
8245538@N06,4933,10,1405756381,1405757281,3,9,900
8245538@N06,4933,11,1405765466,1405766426,2,9,960
82484061@N00,4934,4,1224375170,1224375530,2,6,360
82484061@N00,4934,9,1224375817,1224376717,2,6,900
82484061@N00,4934,11,1224378049,1224379009,2,6,960
82484061@N00,4934,15,1224382437,1224383637,2,6,1200
82484061@N00,4934,8,1224390600,1224391440,2,6,840
82484061@N00,4934,11,1224403615,1224404575,1,6,960
82507219@N08,4935,2,1377504261,1377504501,1,1,240
82541612@N00,4936,11,1395210879,1395211839,1,1,960
82590976@N06,4937,17,1379164410,1379167110,1,1,2700
82619708@N00,4938,11,1364598678,1364599638,1,1,960
82651370@N03,4939,2,1381811999,1381812239,1,1,240
82651989@N00,4940,11,1321495834,1321496794,2,2,960
82651989@N00,4940,9,1321502370,1321503270,1,2,900
82651989@N00,4941,11,1321550882,1321551842,1,1,960
8270001@N04,4942,11,1269531667,1269532627,5,1,960
82746306@N00,4943,11,1247716053,1247717013,2,3,960
82746306@N00,4943,15,1247729498,1247730698,2,3,1200
82746306@N00,4943,11,1247743747,1247744707,5,3,960
8274992@N02,4944,11,1204692745,1204693705,34,1,960
8280384@N03,4945,17,1300070178,1300072878,2,2,2700
8280384@N03,4945,15,1300077327,1300078527,1,2,1200
8280384@N03,4946,15,1300160313,1300160558,2,4,245
8280384@N03,4946,17,1300160558,1300163258,2,4,2700
8280384@N03,4946,13,1300178741,1300179821,2,4,1080
8280384@N03,4946,11,1300183557,1300184517,1,4,960
82841979@N04,4947,9,1344134858,1344135758,1,1,900
82898228@N00,4948,1,1471653293,1471653533,1,1,240
82939271@N00,4949,11,1279686091,1279687051,1,1,960
83028497@N00,4950,5,1415331156,1415331576,1,1,420
83035350@N06,4951,13,1362797576,1362798656,2,2,1080
83035350@N06,4951,11,1362815740,1362816700,1,2,960
83038235@N08,4952,11,1444729639,1444730599,2,1,960
83055639@N00,4953,11,1293828327,1293829287,2,1,960
83106697@N00,4954,13,1354931180,1354932260,1,1,1080
8311873@N03,4955,11,1350422171,1350423131,2,1,960
8311873@N03,4956,14,1351480990,1351481145,2,3,155
8311873@N03,4956,4,1351481145,1351481265,2,3,120
8311873@N03,4956,11,1351481265,1351482225,1,3,960
8311873@N03,4957,5,1363726926,1363727346,1,1,420
8311873@N03,4958,17,1423284204,1423286904,1,1,2700
83133472@N05,4959,11,1372415716,1372416676,1,1,960
83133472@N05,4960,8,1374989277,1374990117,1,1,840
83133472@N05,4961,8,1376821034,1376821874,1,1,840
83133472@N05,4962,11,1394189445,1394190405,1,1,960
8313989@N05,4963,11,1194523581,1194524541,1,1,960
83167112@N06,4964,11,1389239226,1389240186,1,1,960
83167112@N06,4965,11,1416209331,1416210291,1,1,960
83167112@N06,4966,11,1462874575,1462875535,1,1,960
83206670@N05,4967,11,1314744342,1314745302,3,2,960
83206670@N05,4967,16,1314749414,1314751514,2,2,2100
8327824@N05,4968,1,1354781795,1354782035,11,1,240
8327824@N05,4969,1,1356667726,1356667966,1,1,240
83286805@N00,4970,5,1320732752,1320733172,1,1,420
83286805@N00,4971,11,1321750051,1321751011,1,1,960
83302510@N05,4972,13,1356419127,1356420207,3,1,1080
83400109@N08,4973,4,1464137151,1464137511,2,7,360
83400109@N08,4973,3,1464142453,1464142783,2,7,330
83400109@N08,4973,9,1464143902,1464144802,3,7,900
83400109@N08,4973,5,1464152398,1464152818,2,7,420
83400109@N08,4973,1,1464159937,1464160177,2,7,240
83400109@N08,4973,12,1464161433,1464162453,3,7,1020
83400109@N08,4973,2,1464164513,1464164753,2,7,240
8348059@N02,4974,11,1300744439,1300744860,4,16,421
8348059@N02,4974,14,1300744860,1300746060,2,16,1200
8348059@N02,4974,3,1300747370,1300747700,6,16,330
8348059@N02,4974,14,1300749072,1300749612,2,16,540
8348059@N02,4974,7,1300749612,1300750452,2,16,840
8348059@N02,4974,2,1300750756,1300750996,4,16,240
8348059@N02,4974,4,1300751975,1300752335,3,16,360
8348059@N02,4974,17,1300753416,1300753744,2,16,328
8348059@N02,4974,10,1300753744,1300753938,3,16,194
8348059@N02,4974,17,1300753938,1300754962,4,16,1024
8348059@N02,4974,15,1300754962,1300754996,2,16,34
8348059@N02,4974,17,1300754996,1300755206,3,16,210
8348059@N02,4974,13,1300755206,1300756286,11,16,1080
8348059@N02,4974,8,1300762957,1300763797,7,16,840
8348059@N02,4974,5,1300764400,1300764820,4,16,420
8348059@N02,4974,11,1300767454,1300768414,7,16,960
83657528@N00,4975,11,1299967156,1299968116,2,2,960
83657528@N00,4975,3,1299973864,1299974194,1,2,330
8373144@N05,4976,11,1201911082,1201912042,4,2,960
8373144@N05,4976,13,1201917043,1201918123,2,2,1080
83794242@N07,4977,2,1435736250,1435736490,2,2,240
83794242@N07,4977,9,1435739932,1435740832,1,2,900
83794242@N07,4978,11,1449359678,1449360638,1,1,960
83794242@N07,4979,11,1449408887,1449409847,2,1,960
83806278@N00,4980,9,1316664557,1316665457,1,1,900
83825280@N06,4981,8,1348561796,1348562636,1,1,840
83825280@N06,4982,1,1354484386,1354484626,2,1,240
83825280@N06,4983,17,1363247373,1363250073,1,1,2700
83825280@N06,4984,6,1365243331,1365244051,1,1,720
8384026@N07,4985,6,1288938600,1288939320,1,1,720
83848625@N00,4986,5,1456044091,1456044511,2,2,420
83848625@N00,4986,17,1456049069,1456051769,1,2,2700
83848625@N00,4987,1,1456181168,1456181408,2,3,240
83848625@N00,4987,2,1456187696,1456187936,2,3,240
83848625@N00,4987,17,1456193650,1456196350,3,3,2700
84013956@N00,4988,11,1325074549,1325075509,1,1,960
84013956@N00,4989,17,1358059967,1358060311,3,2,344
84013956@N00,4989,13,1358060311,1358061391,1,2,1080
8404074@N04,4990,11,1215214604,1215215564,1,1,960
84087186@N00,4991,11,1361998342,1361999302,1,1,960
84108876@N00,4992,5,1193972104,1193972524,2,3,420
84108876@N00,4992,17,1193978006,1193980706,2,3,2700
84108876@N00,4992,11,1193985738,1193986698,4,3,960
84108876@N00,4993,1,1209368062,1209368302,2,2,240
84108876@N00,4993,11,1209370896,1209371856,2,2,960
84108876@N00,4994,16,1255468606,1255470706,1,1,2100
84108876@N00,4995,16,1255518590,1255520690,2,1,2100
84169004@N00,4996,1,1228439040,1228439280,1,1,240
84169004@N00,4997,1,1228700940,1228701180,1,1,240
84169004@N00,4998,16,1228870980,1228873080,4,1,2100
84169004@N00,4999,5,1386068694,1386069114,1,1,420
84221632@N00,5000,5,1381916036,1381916456,1,1,420
84221632@N00,5001,11,1382006174,1382007134,2,3,960
84221632@N00,5001,5,1382008888,1382009308,2,3,420
84221632@N00,5001,8,1382010375,1382011215,2,3,840
84221632@N00,5002,11,1382286527,1382287487,2,1,960
84221632@N00,5003,11,1423021545,1423022505,1,1,960
84221632@N00,5004,17,1423489008,1423491708,1,1,2700
84227486@N02,5005,16,1354831410,1354831644,2,3,234
84227486@N02,5005,1,1354831644,1354831884,15,3,240
84227486@N02,5005,5,1354839968,1354840388,1,3,420
84227486@N02,5006,13,1354926753,1354927833,1,1,1080
84227486@N02,5007,2,1365982597,1365982837,2,5,240
84227486@N02,5007,17,1365987350,1365987940,2,5,590
84227486@N02,5007,1,1365987940,1365988022,3,5,82
84227486@N02,5007,5,1365988022,1365988442,2,5,420
84227486@N02,5007,8,1365990865,1365991705,1,5,840
84227486@N02,5008,13,1366371525,1366372605,2,1,1080
84227486@N02,5009,8,1374482418,1374483258,2,1,840
84227486@N02,5010,1,1428911728,1428911968,1,1,240
84531937@N00,5011,5,1309411054,1309411474,1,1,420
8459320@N03,5012,2,1246434511,1246434751,1,1,240
8459320@N03,5013,2,1246495037,1246495277,3,3,240
8459320@N03,5013,5,1246508185,1246508605,3,3,420
8459320@N03,5013,11,1246535060,1246536020,2,3,960
8459320@N03,5014,13,1246872537,1246873617,2,1,1080
84697271@N00,5015,11,1294359622,1294360582,2,5,960
84697271@N00,5015,10,1294362841,1294363161,2,5,320
84697271@N00,5015,17,1294363161,1294363483,3,5,322
84697271@N00,5015,13,1294363483,1294364563,4,5,1080
84697271@N00,5015,11,1294364979,1294365939,1,5,960
84697271@N00,5016,11,1389509276,1389510236,1,1,960
8472024@N08,5017,11,1230535161,1230536121,1,1,960
84765974@N00,5018,11,1464588641,1464589601,1,1,960
84861343@N00,5019,11,1370512077,1370513037,2,1,960
84861343@N00,5020,8,1423472166,1423473006,1,1,840
84861343@N00,5021,15,1423546600,1423547800,1,1,1200
84861343@N00,5022,11,1423717433,1423718393,1,1,960
84897223@N00,5023,5,1434016152,1434016572,2,1,420
84968958@N00,5024,3,1298410462,1298410792,1,1,330
84987970@N00,5025,11,1226638881,1226639841,10,5,960
84987970@N00,5025,14,1226645781,1226646981,2,5,1200
84987970@N00,5025,4,1226650414,1226650774,6,5,360
84987970@N00,5025,8,1226651783,1226652623,3,5,840
84987970@N00,5025,11,1226661718,1226662678,14,5,960
8502118@N08,5026,10,1419986594,1419987494,2,2,900
8502118@N08,5026,13,1419988648,1419989728,1,2,1080
85095974@N05,5027,2,1374659976,1374660216,8,1,240
85095974@N05,5028,11,1402669095,1402670055,2,1,960
85095974@N05,5029,11,1470482069,1470483029,1,1,960
85095974@N05,5030,7,1470524127,1470524255,3,5,128
85095974@N05,5030,3,1470524255,1470524585,2,5,330
85095974@N05,5030,11,1470527307,1470528267,30,5,960
85095974@N05,5030,5,1470533302,1470533722,21,5,420
85095974@N05,5030,13,1470538786,1470539866,3,5,1080
85095974@N05,5031,3,1470697320,1470697650,18,4,330
85095974@N05,5031,1,1470705259,1470705499,2,4,240
85095974@N05,5031,17,1470710138,1470711424,2,4,1286
85095974@N05,5031,13,1470711424,1470712504,3,4,1080
85095974@N05,5032,11,1470898780,1470899740,3,5,960
85095974@N05,5032,2,1470900644,1470900884,5,5,240
85095974@N05,5032,4,1470901548,1470901762,10,5,214
85095974@N05,5032,10,1470901762,1470901781,3,5,19
85095974@N05,5032,4,1470901781,1470902141,5,5,360
85121305@N08,5033,11,1355975441,1355976401,2,3,960
85121305@N08,5033,13,1355986499,1355987579,3,3,1080
85121305@N08,5033,5,1355988825,1355989245,1,3,420
85121305@N08,5034,10,1356056453,1356057353,2,3,900
85121305@N08,5034,11,1356076307,1356077267,3,3,960
85121305@N08,5034,4,1356077332,1356077692,1,3,360
85121305@N08,5035,15,1358163800,1358165000,1,1,1200
85121305@N08,5036,2,1359370078,1359370318,1,1,240
8526081@N08,5037,11,1278028585,1278029507,2,3,922
8526081@N08,5037,7,1278029507,1278030347,2,3,840
8526081@N08,5037,2,1278050763,1278051003,1,3,240
8526919@N08,5038,11,1461757127,1461758087,1,1,960
85288320@N00,5039,17,1312181207,1312181297,3,6,90
85288320@N00,5039,15,1312181297,1312182478,2,6,1181
85288320@N00,5039,4,1312182478,1312182838,4,6,360
85288320@N00,5039,3,1312186347,1312186677,5,6,330
85288320@N00,5039,2,1312187186,1312187426,2,6,240
85288320@N00,5039,9,1312191500,1312192400,3,6,900
8530749@N08,5040,11,1349273702,1349274662,1,1,960
85433978@N00,5041,11,1449989500,1449990460,1,1,960
85485667@N00,5042,8,1242300986,1242301826,1,1,840
85509341@N00,5043,11,1392773304,1392774264,2,3,960
85509341@N00,5043,4,1392779321,1392779681,2,3,360
85509341@N00,5043,11,1392781955,1392782915,4,3,960
85509341@N00,5044,11,1435715044,1435716004,2,7,960
85509341@N00,5044,2,1435729519,1435729759,3,7,240
85509341@N00,5044,9,1435736801,1435737701,2,7,900
85509341@N00,5044,1,1435741307,1435741355,2,7,48
85509341@N00,5044,11,1435741355,1435742315,2,7,960
85509341@N00,5044,5,1435750012,1435750432,3,7,420
85509341@N00,5044,11,1435753968,1435754928,1,7,960
85509341@N00,5045,9,1435916147,1435917047,1,1,900
85543411@N08,5046,1,1426473347,1426473587,1,1,240
8556323@N05,5047,11,1471836125,1471837085,4,1,960
8562768@N07,5048,2,1351239036,1351239276,3,1,240
85631149@N00,5049,13,1393291019,1393291211,2,4,192
85631149@N00,5049,17,1393291211,1393293911,3,4,2700
85631149@N00,5049,1,1393299726,1393299966,3,4,240
85631149@N00,5049,11,1393307954,1393308914,5,4,960
85632208@N03,5050,1,1329229050,1329229290,3,2,240
85632208@N03,5050,13,1329237564,1329238644,1,2,1080
85639028@N02,5051,8,1386132411,1386133251,2,2,840
85639028@N02,5051,11,1386158557,1386159517,2,2,960
85639028@N02,5052,11,1414191141,1414192101,1,1,960
85644119@N00,5053,11,1198963981,1198964941,3,5,960
85644119@N00,5053,16,1198966112,1198968212,3,5,2100
85644119@N00,5053,11,1198969420,1198970380,3,5,960
85644119@N00,5053,8,1198988495,1198989335,2,5,840
85644119@N00,5053,11,1199008627,1199009587,1,5,960
85644119@N00,5054,11,1213135651,1213136611,2,13,960
85644119@N00,5054,5,1213150855,1213151275,2,13,420
85644119@N00,5054,11,1213152015,1213152975,2,13,960
85644119@N00,5054,4,1213153560,1213153920,2,13,360
85644119@N00,5054,2,1213155283,1213155523,2,13,240
85644119@N00,5054,11,1213158238,1213159198,2,13,960
85644119@N00,5054,8,1213162260,1213162364,3,13,104
85644119@N00,5054,11,1213162364,1213163324,2,13,960
85644119@N00,5054,8,1213163697,1213164537,3,13,840
85644119@N00,5054,11,1213165746,1213166706,2,13,960
85644119@N00,5054,13,1213173709,1213174789,3,13,1080
85644119@N00,5054,10,1213174857,1213175757,2,13,900
85644119@N00,5054,11,1213180507,1213181467,1,13,960
85644119@N00,5055,11,1228272654,1228273614,1,1,960
85644119@N00,5056,11,1228800581,1228801541,1,1,960
85644119@N00,5057,11,1242341670,1242342630,1,1,960
85644119@N00,5058,2,1261865414,1261865654,2,10,240
85644119@N00,5058,7,1261866195,1261867035,2,10,840
85644119@N00,5058,2,1261869455,1261869695,2,10,240
85644119@N00,5058,15,1261875648,1261876112,2,10,464
85644119@N00,5058,13,1261876112,1261877192,3,10,1080
85644119@N00,5058,16,1261891948,1261893706,2,10,1758
85644119@N00,5058,4,1261893706,1261894066,2,10,360
85644119@N00,5058,5,1261897992,1261898412,2,10,420
85644119@N00,5058,10,1261906917,1261907817,2,10,900
85644119@N00,5058,11,1261912542,1261913502,1,10,960
85644119@N00,5059,3,1270076700,1270077030,1,1,330
85644119@N00,5060,11,1307574529,1307575489,5,6,960
85644119@N00,5060,4,1307579997,1307580357,2,6,360
85644119@N00,5060,16,1307592834,1307594934,3,6,2100
85644119@N00,5060,13,1307599120,1307600200,3,6,1080
85644119@N00,5060,8,1307611785,1307612625,3,6,840
85644119@N00,5060,17,1307617591,1307620291,2,6,2700
85644119@N00,5061,11,1324243333,1324244293,2,13,960
85644119@N00,5061,1,1324244780,1324245020,2,13,240
85644119@N00,5061,9,1324245131,1324246031,2,13,900
85644119@N00,5061,16,1324249842,1324251942,2,13,2100
85644119@N00,5061,4,1324255237,1324255597,3,13,360
85644119@N00,5061,3,1324258094,1324258424,2,13,330
85644119@N00,5061,11,1324258879,1324259839,3,13,960
85644119@N00,5061,5,1324262617,1324263037,3,13,420
85644119@N00,5061,8,1324264680,1324265520,4,13,840
85644119@N00,5061,5,1324269233,1324269653,3,13,420
85644119@N00,5061,10,1324276494,1324277394,2,13,900
85644119@N00,5061,13,1324278349,1324279429,3,13,1080
85644119@N00,5061,11,1324285990,1324286950,2,13,960
85644119@N00,5062,9,1337039014,1337039914,1,1,900
85644119@N00,5063,8,1465442507,1465443347,1,1,840
8567104@N05,5064,11,1271379925,1271380885,3,1,960
85722662@N00,5065,2,1298883866,1298884106,1,1,240
85744958@N00,5066,6,1235911320,1235912040,1,1,720
85744958@N00,5067,6,1236067114,1236067834,3,1,720
85744958@N00,5068,6,1236137714,1236138434,3,1,720
85744958@N00,5069,6,1236230437,1236231157,4,1,720
85744958@N00,5070,6,1286011731,1286012451,6,2,720
85744958@N00,5070,8,1286031606,1286032446,2,2,840
85744958@N00,5071,6,1305527310,1305528030,5,1,720
85744958@N00,5072,6,1305795277,1305795997,8,1,720
85744958@N00,5073,6,1319268856,1319269576,8,2,720
85744958@N00,5073,15,1319276157,1319277357,3,2,1200
85744958@N00,5074,8,1328089636,1328090476,1,1,840
85744958@N00,5075,15,1328136634,1328137834,4,1,1200
85744958@N00,5076,9,1328172037,1328172937,2,2,900
85744958@N00,5076,1,1328175083,1328175323,1,2,240
85744958@N00,5077,4,1359337895,1359338255,1,1,360
8576764@N02,5078,11,1409711453,1409712413,2,4,960
8576764@N02,5078,5,1409723419,1409723839,14,4,420
8576764@N02,5078,2,1409731281,1409731521,4,4,240
8576764@N02,5078,3,1409734416,1409734746,29,4,330
85813749@N00,5079,11,1418860783,1418861743,4,6,960
85813749@N00,5079,15,1418874371,1418875571,2,6,1200
85813749@N00,5079,8,1418879886,1418880726,3,6,840
85813749@N00,5079,13,1418884109,1418885189,2,6,1080
85813749@N00,5079,11,1418899214,1418900174,2,6,960
85813749@N00,5079,10,1418902080,1418902980,6,6,900
85843151@N00,5080,11,1360276723,1360277683,2,8,960
85843151@N00,5080,5,1360278363,1360278783,2,8,420
85843151@N00,5080,11,1360292795,1360293755,2,8,960
85843151@N00,5080,16,1360298176,1360300276,2,8,2100
85843151@N00,5080,6,1360318178,1360318898,2,8,720
85843151@N00,5080,17,1360319437,1360320151,2,8,714
85843151@N00,5080,8,1360320151,1360320991,2,8,840
85843151@N00,5080,13,1360322208,1360323288,1,8,1080
85855667@N00,5081,2,1309393945,1309394185,2,2,240
85855667@N00,5081,10,1309401902,1309402802,1,2,900
85856616@N05,5082,11,1354175562,1354176522,8,9,960
85856616@N05,5082,12,1354185758,1354185769,2,9,11
85856616@N05,5082,2,1354185769,1354185780,2,9,11
85856616@N05,5082,12,1354185780,1354186800,15,9,1020
85856616@N05,5082,2,1354188651,1354188728,3,9,77
85856616@N05,5082,7,1354188728,1354188827,2,9,99
85856616@N05,5082,2,1354188827,1354189067,2,9,240
85856616@N05,5082,17,1354191832,1354192035,2,9,203
85856616@N05,5082,13,1354192035,1354193115,2,9,1080
85859494@N02,5083,13,1369478127,1369479207,3,1,1080
85859494@N02,5084,7,1369702659,1369703499,4,1,840
85864407@N08,5085,13,1384514631,1384515711,4,2,1080
85864407@N08,5085,15,1384517646,1384518846,1,2,1200
85864407@N08,5086,7,1384904939,1384905779,2,3,840
85864407@N08,5086,4,1384911976,1384912336,2,3,360
85864407@N08,5086,8,1384917398,1384918238,3,3,840
85879323@N08,5087,8,1450432472,1450433312,2,1,840
85882671@N00,5088,15,1225609203,1225610403,1,1,1200
85882671@N00,5089,2,1308028884,1308029124,1,1,240
85882671@N00,5090,15,1317113202,1317114402,1,1,1200
85882671@N00,5091,15,1356299016,1356300216,1,1,1200
85882671@N00,5092,13,1356683145,1356684225,2,1,1080
85882671@N00,5093,13,1356839717,1356840797,6,6,1080
85882671@N00,5093,17,1356841334,1356841884,6,6,550
85882671@N00,5093,15,1356841884,1356842182,8,6,298
85882671@N00,5093,13,1356842182,1356843262,3,6,1080
85882671@N00,5093,17,1356844685,1356847385,2,6,2700
85882671@N00,5093,13,1356852943,1356854023,4,6,1080
85882671@N00,5094,13,1356936766,1356937846,6,1,1080
85882671@N00,5095,13,1388817310,1388818390,2,1,1080
85893846@N06,5096,5,1345880854,1345881274,1,1,420
85912588@N00,5097,7,1353482617,1353483457,1,1,840
8592217@N08,5098,11,1237861529,1237862489,2,4,960
8592217@N08,5098,2,1237866099,1237866339,2,4,240
8592217@N08,5098,3,1237872590,1237872920,2,4,330
8592217@N08,5098,11,1237884470,1237885430,1,4,960
85977134@N00,5099,11,1356766898,1356767858,1,1,960
85979850@N00,5100,11,1243458899,1243459758,6,6,859
85979850@N00,5100,1,1243459758,1243459998,6,6,240
85979850@N00,5100,17,1243461088,1243461306,4,6,218
85979850@N00,5100,15,1243461306,1243462506,4,6,1200
85979850@N00,5100,8,1243471292,1243472059,5,6,767
85979850@N00,5100,5,1243472059,1243472479,1,6,420
86001309@N00,5101,11,1335787366,1335788326,26,1,960
86001309@N00,5102,11,1359193036,1359193996,2,2,960
86001309@N00,5102,9,1359195664,1359196564,1,2,900
86061580@N00,5103,13,1290767775,1290768855,12,1,1080
86061580@N00,5104,11,1290820071,1290821031,1,1,960
86111910@N03,5105,11,1348217443,1348218403,2,1,960
86275327@N00,5106,12,1209534525,1209535545,1,1,1020
86275327@N00,5107,11,1209798231,1209799191,1,1,960
86285103@N00,5108,12,1260587058,1260588078,7,3,1020
86285103@N00,5108,11,1260595711,1260596597,5,3,886
86285103@N00,5108,13,1260596597,1260597677,8,3,1080
86285103@N00,5109,17,1260931631,1260931829,3,3,198
86285103@N00,5109,5,1260931829,1260932249,7,3,420
86285103@N00,5109,8,1260935749,1260936589,12,3,840
8638605@N02,5110,6,1188456206,1188456926,1,1,720
8638605@N02,5111,15,1275722622,1275722865,2,7,243
8638605@N02,5111,13,1275722865,1275723945,2,7,1080
8638605@N02,5111,5,1275724262,1275724682,18,7,420
8638605@N02,5111,4,1275725570,1275725930,16,7,360
8638605@N02,5111,2,1275726638,1275726878,6,7,240
8638605@N02,5111,14,1275727684,1275728884,23,7,1200
8638605@N02,5111,11,1275729521,1275730481,8,7,960
8638605@N02,5112,11,1275805994,1275806954,3,5,960
8638605@N02,5112,15,1275806958,1275808158,11,5,1200
8638605@N02,5112,8,1275815412,1275816252,2,5,840
8638605@N02,5112,1,1275819140,1275819380,22,5,240
8638605@N02,5112,11,1275820916,1275821876,4,5,960
8638605@N02,5113,11,1275887023,1275887611,3,5,588
8638605@N02,5113,16,1275887611,1275889711,12,5,2100
8638605@N02,5113,13,1275892730,1275893810,4,5,1080
8638605@N02,5113,5,1275897094,1275897514,2,5,420
8638605@N02,5113,11,1275897884,1275898844,1,5,960
8638605@N02,5114,11,1275961639,1275962599,3,2,960
8638605@N02,5114,15,1275962991,1275964191,2,2,1200
86434226@N00,5115,5,1360635062,1360635482,1,1,420
86434226@N00,5116,1,1458968253,1458968493,1,1,240
86459399@N00,5117,2,1255485456,1255485696,2,1,240
86459399@N00,5118,2,1275209641,1275209881,3,1,240
86459399@N00,5119,4,1275285465,1275285825,2,1,360
86459399@N00,5120,2,1291599670,1291599910,10,1,240
86459399@N00,5121,1,1296366780,1296367020,4,1,240
86459399@N00,5122,1,1318734603,1318734843,3,4,240
86459399@N00,5122,2,1318742771,1318743011,3,4,240
86459399@N00,5122,5,1318756054,1318756474,2,4,420
86459399@N00,5122,13,1318758683,1318759763,2,4,1080
86459399@N00,5123,1,1318833358,1318833598,1,1,240
86459399@N00,5124,11,1319093036,1319093996,4,3,960
86459399@N00,5124,17,1319096575,1319097719,3,3,1144
86459399@N00,5124,15,1319097719,1319098919,2,3,1200
86459399@N00,5125,13,1350281697,1350282777,2,1,1080
86459399@N00,5126,1,1350464327,1350464567,1,1,240
86459399@N00,5127,1,1367026023,1367026263,2,1,240
86459399@N00,5128,13,1367145892,1367146972,4,1,1080
86476099@N00,5129,13,1261305123,1261306203,1,1,1080
86476099@N00,5130,13,1261338972,1261340052,2,4,1080
86476099@N00,5130,14,1261348461,1261349661,2,4,1200
86476099@N00,5130,12,1261352310,1261353330,2,4,1020
86476099@N00,5130,11,1261356279,1261357239,2,4,960
86482004@N00,5131,11,1337582781,1337583741,8,2,960
86482004@N00,5131,2,1337589148,1337589388,1,2,240
86482004@N00,5132,10,1337737595,1337737701,3,4,106
86482004@N00,5132,17,1337737701,1337740355,7,4,2654
86482004@N00,5132,13,1337740355,1337741435,7,4,1080
86482004@N00,5132,6,1337742118,1337742838,1,4,720
86493735@N00,5133,11,1298466001,1298466961,1,1,960
8657772@N03,5134,8,1353060077,1353060917,1,1,840
86660260@N03,5135,2,1406085649,1406085889,1,1,240
86684413@N00,5136,2,1450999038,1450999278,6,17,240
86684413@N00,5136,3,1451002254,1451002526,2,17,272
86684413@N00,5136,14,1451002526,1451002720,3,17,194
86684413@N00,5136,3,1451002720,1451003050,7,17,330
86684413@N00,5136,11,1451007120,1451008080,2,17,960
86684413@N00,5136,1,1451009164,1451009404,5,17,240
86684413@N00,5136,9,1451009848,1451010550,2,17,702
86684413@N00,5136,1,1451010550,1451010790,5,17,240
86684413@N00,5136,5,1451014199,1451014619,3,17,420
86684413@N00,5136,8,1451014678,1451015518,3,17,840
86684413@N00,5136,6,1451018088,1451018808,2,17,720
86684413@N00,5136,13,1451020937,1451021322,3,17,385
86684413@N00,5136,17,1451021322,1451021849,3,17,527
86684413@N00,5136,15,1451021849,1451022529,2,17,680
86684413@N00,5136,10,1451022529,1451023429,5,17,900
86684413@N00,5136,4,1451034926,1451035286,5,17,360
86684413@N00,5136,3,1451037929,1451038259,1,17,330
86694404@N00,5137,11,1244675570,1244676530,2,4,960
86694404@N00,5137,1,1244677216,1244677456,2,4,240
86694404@N00,5137,11,1244680219,1244681179,2,4,960
86694404@N00,5137,17,1244688381,1244691081,1,4,2700
86719158@N00,5138,11,1298699903,1298700863,2,7,960
86719158@N00,5138,17,1298701073,1298701329,2,7,256
86719158@N00,5138,15,1298701329,1298701704,5,7,375
86719158@N00,5138,17,1298701704,1298701799,6,7,95
86719158@N00,5138,15,1298701799,1298701868,2,7,69
86719158@N00,5138,13,1298701868,1298702948,5,7,1080
86719158@N00,5138,17,1298708236,1298710936,1,7,2700
86719158@N00,5139,11,1299123651,1299124611,2,2,960
86719158@N00,5139,5,1299134326,1299134746,4,2,420
86787360@N00,5140,11,1412896577,1412897537,5,5,960
86787360@N00,5140,2,1412897716,1412897956,8,5,240
86787360@N00,5140,17,1412902873,1412905573,10,5,2700
86787360@N00,5140,4,1412907052,1412907412,5,5,360
86787360@N00,5140,5,1412909053,1412909473,4,5,420
86864767@N00,5141,1,1210789412,1210789652,1,1,240
86881825@N00,5142,12,1212046148,1212047168,1,1,1020
86881825@N00,5143,8,1227067135,1227067738,2,2,603
86881825@N00,5143,5,1227067738,1227068158,1,2,420
86932086@N00,5144,11,1450936258,1450937218,3,1,960
86965856@N00,5145,3,1190987724,1190988054,3,1,330
86965856@N00,5146,3,1191039524,1191039854,4,1,330
86965856@N00,5147,3,1207453066,1207453396,10,1,330
86965856@N00,5148,3,1217749015,1217749345,1,1,330
86965856@N00,5149,3,1273328730,1273329060,2,1,330
86965856@N00,5150,3,1304685970,1304686300,5,1,330
86965856@N00,5151,3,1305014004,1305014334,2,1,330
8713148@N03,5152,11,1190956999,1190957959,1,1,960
87167216@N00,5153,9,1210065238,1210066138,5,1,900
87167216@N00,5154,16,1210312826,1210313287,2,2,461
87167216@N00,5154,9,1210313287,1210314187,1,2,900
87173471@N00,5155,12,1323218855,1323218863,2,5,8
87173471@N00,5155,3,1323218863,1323218913,2,5,50
87173471@N00,5155,16,1323218913,1323219033,2,5,120
87173471@N00,5155,11,1323219033,1323219060,2,5,27
87173471@N00,5155,17,1323219060,1323221760,3,5,2700
8721758@N06,5156,11,1273882788,1273883748,1,1,960
8721758@N06,5157,1,1274016815,1274017055,1,1,240
87261736@N00,5158,10,1443583820,1443584720,1,1,900
87266192@N00,5159,7,1228277658,1228278498,5,2,840
87266192@N00,5159,3,1228288303,1228288633,2,2,330
87267387@N00,5160,15,1230716335,1230717535,1,1,1200
8729032@N06,5161,11,1258326786,1258327746,4,7,960
8729032@N06,5161,3,1258327824,1258328154,27,7,330
8729032@N06,5161,7,1258330072,1258330912,4,7,840
8729032@N06,5161,2,1258331658,1258331898,6,7,240
8729032@N06,5161,17,1258334067,1258334524,9,7,457
8729032@N06,5161,13,1258334524,1258335604,2,7,1080
8729032@N06,5161,8,1258346997,1258347837,4,7,840
8729032@N06,5162,3,1258587155,1258587485,3,4,330
8729032@N06,5162,7,1258590716,1258591556,8,4,840
8729032@N06,5162,13,1258595274,1258596354,11,4,1080
8729032@N06,5162,11,1258608011,1258608971,1,4,960
8729032@N06,5163,3,1287959300,1287959318,3,3,18
8729032@N06,5163,7,1287959318,1287960158,23,3,840
8729032@N06,5163,4,1287960352,1287960712,1,3,360
8729032@N06,5164,11,1288216568,1288217528,7,5,960
8729032@N06,5164,1,1288220800,1288221040,7,5,240
8729032@N06,5164,4,1288224752,1288225112,4,5,360
8729032@N06,5164,5,1288226916,1288227336,20,5,420
8729032@N06,5164,8,1288227737,1288228577,29,5,840
8729032@N06,5165,1,1363884941,1363885181,5,1,240
8729032@N06,5166,11,1373238527,1373239487,3,16,960
8729032@N06,5166,7,1373241907,1373242025,2,16,118
8729032@N06,5166,3,1373242025,1373242032,2,16,7
8729032@N06,5166,7,1373242032,1373242048,3,16,16
8729032@N06,5166,3,1373242048,1373242054,2,16,6
8729032@N06,5166,7,1373242054,1373242063,2,16,9
8729032@N06,5166,14,1373242063,1373242280,3,16,217
8729032@N06,5166,7,1373242280,1373242347,2,16,67
8729032@N06,5166,3,1373242347,1373242385,2,16,38
8729032@N06,5166,7,1373242385,1373242398,2,16,13
8729032@N06,5166,3,1373242398,1373242457,6,16,59
8729032@N06,5166,7,1373242457,1373242521,2,16,64
8729032@N06,5166,3,1373242521,1373242531,2,16,10
8729032@N06,5166,7,1373242531,1373242542,2,16,11
8729032@N06,5166,3,1373242542,1373242579,6,16,37
8729032@N06,5166,7,1373242579,1373243419,3,16,840
8729032@N06,5167,11,1387145271,1387146231,6,11,960
8729032@N06,5167,3,1387148422,1387148752,3,11,330
8729032@N06,5167,4,1387152597,1387152957,3,11,360
8729032@N06,5167,15,1387157961,1387158260,4,11,299
8729032@N06,5167,13,1387158260,1387158278,2,11,18
8729032@N06,5167,15,1387158278,1387158280,2,11,2
8729032@N06,5167,13,1387158280,1387158292,4,11,12
8729032@N06,5167,17,1387158292,1387158410,5,11,118
8729032@N06,5167,15,1387158410,1387158483,2,11,73
8729032@N06,5167,13,1387158483,1387159563,31,11,1080
8729032@N06,5167,6,1387180633,1387181353,21,11,720
8729032@N06,5168,3,1387406813,1387407143,2,12,330
8729032@N06,5168,14,1387408699,1387409213,17,12,514
8729032@N06,5168,3,1387409213,1387409361,22,12,148
8729032@N06,5168,14,1387409361,1387409392,8,12,31
8729032@N06,5168,3,1387409392,1387409395,2,12,3
8729032@N06,5168,14,1387409395,1387409434,6,12,39
8729032@N06,5168,3,1387409434,1387409441,3,12,7
8729032@N06,5168,14,1387409441,1387410465,5,12,1024
8729032@N06,5168,3,1387410465,1387410795,2,12,330
8729032@N06,5168,8,1387414340,1387415180,67,12,840
8729032@N06,5168,17,1387427190,1387429325,11,12,2135
8729032@N06,5168,11,1387429325,1387430285,3,12,960
8729032@N06,5169,3,1418163306,1418163636,24,16,330
8729032@N06,5169,2,1418168530,1418168729,9,16,199
8729032@N06,5169,16,1418168729,1418168882,3,16,153
8729032@N06,5169,1,1418168882,1418169078,4,16,196
8729032@N06,5169,9,1418169078,1418169978,28,16,900
8729032@N06,5169,16,1418172458,1418174558,22,16,2100
8729032@N06,5169,17,1418177335,1418177462,13,16,127
8729032@N06,5169,15,1418177462,1418177472,3,16,10
8729032@N06,5169,17,1418177472,1418178664,3,16,1192
8729032@N06,5169,13,1418178664,1418178676,3,16,12
8729032@N06,5169,15,1418178676,1418179010,2,16,334
8729032@N06,5169,17,1418179010,1418181181,18,16,2171
8729032@N06,5169,15,1418181181,1418181236,2,16,55
8729032@N06,5169,17,1418181236,1418181517,2,16,281
8729032@N06,5169,13,1418181517,1418182597,12,16,1080
8729032@N06,5169,6,1418203564,1418204284,9,16,720
8729032@N06,5170,1,1418251887,1418251897,4,16,10
8729032@N06,5170,11,1418251897,1418251903,2,16,6
8729032@N06,5170,1,1418251903,1418251919,2,16,16
8729032@N06,5170,11,1418251919,1418252455,7,16,536
8729032@N06,5170,1,1418252455,1418252695,14,16,240
8729032@N06,5170,9,1418253929,1418254829,7,16,900
8729032@N06,5170,1,1418258454,1418258694,13,16,240
8729032@N06,5170,5,1418258859,1418259279,3,16,420
8729032@N06,5170,8,1418260428,1418261268,5,16,840
8729032@N06,5170,5,1418262574,1418262994,40,16,420
8729032@N06,5170,8,1418263315,1418263425,3,16,110
8729032@N06,5170,5,1418263425,1418263845,16,16,420
8729032@N06,5170,8,1418263929,1418264769,45,16,840
8729032@N06,5170,5,1418265271,1418265691,17,16,420
8729032@N06,5170,8,1418265788,1418266628,20,16,840
8729032@N06,5170,14,1418272378,1418273578,36,16,1200
8729032@N06,5171,1,1430021141,1430021381,3,2,240
8729032@N06,5171,13,1430021545,1430022625,2,2,1080
87415005@N02,5172,11,1417477738,1417478698,3,5,960
87415005@N02,5172,2,1417482643,1417482883,2,5,240
87415005@N02,5172,15,1417500518,1417500885,3,5,367
87415005@N02,5172,17,1417500885,1417501402,10,5,517
87415005@N02,5172,10,1417501402,1417502302,3,5,900
87506761@N00,5173,11,1336200776,1336201736,2,6,960
87506761@N00,5173,9,1336202457,1336203357,2,6,900
87506761@N00,5173,5,1336204280,1336204700,2,6,420
87506761@N00,5173,8,1336205685,1336206525,4,6,840
87506761@N00,5173,13,1336212286,1336212741,2,6,455
87506761@N00,5173,11,1336212741,1336213701,2,6,960
87507703@N04,5174,11,1356576545,1356577505,7,7,960
87507703@N04,5174,9,1356579707,1356580607,2,7,900
87507703@N04,5174,5,1356582646,1356583066,3,7,420
87507703@N04,5174,8,1356584361,1356585201,16,7,840
87507703@N04,5174,13,1356591197,1356592277,7,7,1080
87507703@N04,5174,17,1356592286,1356592393,3,7,107
87507703@N04,5174,15,1356592393,1356593593,1,7,1200
87521042@N00,5175,4,1363133302,1363133662,1,1,360
87549191@N00,5176,11,1339114990,1339115950,1,1,960
8756721@N06,5177,16,1301723552,1301725652,1,1,2100
8760137@N08,5178,14,1189555714,1189556914,6,1,1200
8760137@N08,5179,14,1190892372,1190893572,1,1,1200
87635169@N02,5180,11,1330125144,1330126104,1,1,960
87635169@N02,5181,11,1457757013,1457757973,1,1,960
87652302@N00,5182,16,1255462978,1255465078,1,1,2100
8769311@N02,5183,2,1304555300,1304555540,1,1,240
8769311@N02,5184,2,1379896824,1379897064,1,1,240
87725544@N08,5185,8,1347851846,1347852686,2,2,840
87725544@N08,5185,13,1347853324,1347854404,1,2,1080
8773866@N07,5186,15,1232847985,1232849185,1,1,1200
87782851@N05,5187,16,1353724647,1353726747,1,1,2100
87822393@N03,5188,2,1371044195,1371044435,1,1,240
87854506@N04,5189,13,1355483157,1355484237,4,1,1080
87895332@N08,5190,11,1407961151,1407962111,1,1,960
87895332@N08,5191,17,1413961806,1413964506,2,2,2700
87895332@N08,5191,6,1413964532,1413965252,1,2,720
87953089@N04,5192,10,1390562508,1390562520,3,2,12
87953089@N04,5192,15,1390562520,1390563720,1,2,1200
87962106@N00,5193,8,1322030400,1322031240,1,1,840
8803306@N02,5194,11,1235861965,1235862925,2,5,960
8803306@N02,5194,2,1235868308,1235868548,2,5,240
8803306@N02,5194,15,1235877304,1235878504,2,5,1200
8803306@N02,5194,13,1235881329,1235882409,2,5,1080
8803306@N02,5194,8,1235890646,1235891486,1,5,840
8803306@N02,5195,12,1265504821,1265505841,1,1,1020
8803306@N02,5196,1,1331084109,1331084349,2,2,240
8803306@N02,5196,11,1331095166,1331096126,1,2,960
88095899@N05,5197,10,1335223894,1335224794,2,2,900
88095899@N05,5197,9,1335228768,1335229668,1,2,900
88095899@N05,5198,11,1363388170,1363389130,5,2,960
88095899@N05,5198,9,1363389937,1363390837,2,2,900
88095899@N05,5199,13,1366171422,1366172502,1,1,1080
88095899@N05,5200,10,1392773516,1392774416,3,2,900
88095899@N05,5200,8,1392783685,1392784525,1,2,840
88095899@N05,5201,13,1394763326,1394764406,1,1,1080
88097009@N07,5202,11,1418383055,1418384015,1,1,960
88097009@N07,5203,8,1418604499,1418605339,4,2,840
88097009@N07,5203,17,1418607374,1418610074,1,2,2700
88158593@N00,5204,11,1305689962,1305690922,2,9,960
88158593@N00,5204,1,1305695335,1305695575,2,9,240
88158593@N00,5204,2,1305699843,1305700083,2,9,240
88158593@N00,5204,11,1305702968,1305703928,3,9,960
88158593@N00,5204,9,1305706395,1305706627,3,9,232
88158593@N00,5204,11,1305706627,1305707587,2,9,960
88158593@N00,5204,5,1305718778,1305719198,2,9,420
88158593@N00,5204,11,1305721349,1305722309,2,9,960
88158593@N00,5204,1,1305723542,1305723782,1,9,240
88158593@N00,5205,11,1334548105,1334549065,2,4,960
88158593@N00,5205,4,1334558424,1334558784,2,4,360
88158593@N00,5205,15,1334564718,1334565918,2,4,1200
88158593@N00,5205,11,1334571588,1334572548,2,4,960
88172175@N00,5206,11,1219375704,1219376664,94,1,960
88172175@N00,5207,11,1219544950,1219545910,1,1,960
88201963@N00,5208,11,1444964350,1444965310,3,4,960
88201963@N00,5208,8,1444970286,1444971126,3,4,840
88201963@N00,5208,17,1444984173,1444986873,5,4,2700
88201963@N00,5208,11,1444990777,1444991737,1,4,960
88264442@N00,5209,11,1321436665,1321437625,1,1,960
88322185@N00,5210,4,1195719641,1195720001,2,1,360
8838492@N05,5211,17,1198132382,1198132901,6,6,519
8838492@N05,5211,15,1198132901,1198133238,2,6,337
8838492@N05,5211,13,1198133238,1198134318,2,6,1080
8838492@N05,5211,8,1198135587,1198136427,6,6,840
8838492@N05,5211,5,1198136543,1198136963,2,6,420
8838492@N05,5211,8,1198138105,1198138945,3,6,840
88504071@N00,5212,15,1211428681,1211429039,2,2,358
88504071@N00,5212,10,1211429039,1211429939,1,2,900
88504071@N00,5213,11,1222327531,1222328491,1,1,960
88504071@N00,5214,16,1222392593,1222394693,2,3,2100
88504071@N00,5214,8,1222395523,1222396363,3,3,840
88504071@N00,5214,15,1222407619,1222408819,1,3,1200
88521516@N05,5215,2,1465429946,1465430186,1,1,240
8854930@N07,5216,11,1449459241,1449460201,2,1,960
88564171@N02,5217,8,1411020174,1411020188,2,2,14
88564171@N02,5217,11,1411020188,1411021148,1,2,960
88653431@N00,5218,11,1338070939,1338071899,2,2,960
88653431@N00,5218,1,1338081639,1338081879,1,2,240
88669269@N06,5219,9,1446168153,1446169053,1,1,900
88669269@N06,5220,16,1446259590,1446260668,2,2,1078
88669269@N06,5220,9,1446260668,1446261568,1,2,900
88669269@N06,5221,9,1446354285,1446355185,1,1,900
88711965@N00,5222,11,1380458695,1380459655,1,1,960
88740729@N02,5223,11,1470537228,1470538188,2,3,960
88740729@N02,5223,13,1470551882,1470552962,2,3,1080
88740729@N02,5223,11,1470553049,1470554009,1,3,960
88785574@N00,5224,2,1340109600,1340109840,1,1,240
88859710@N03,5225,6,1361245944,1361246241,2,3,297
88859710@N03,5225,4,1361246241,1361246601,3,3,360
88859710@N03,5225,6,1361247486,1361248206,1,3,720
88859710@N03,5226,1,1365579556,1365579796,1,1,240
88859710@N03,5227,10,1366349209,1366349797,2,3,588
88859710@N03,5227,17,1366349797,1366350735,3,3,938
88859710@N03,5227,13,1366350735,1366351815,1,3,1080
88859710@N03,5228,6,1367808649,1367809369,1,1,720
88859710@N03,5229,11,1371534968,1371535928,1,1,960
88859710@N03,5230,11,1381896447,1381897407,1,1,960
88859710@N03,5231,11,1382000047,1382001007,1,1,960
88859710@N03,5232,11,1384732785,1384733745,1,1,960
88959316@N00,5233,16,1193371765,1193373865,3,4,2100
88959316@N00,5233,2,1193379815,1193380055,2,4,240
88959316@N00,5233,3,1193384525,1193384855,5,4,330
88959316@N00,5233,11,1193388771,1193389731,2,4,960
88959316@N00,5234,3,1193470729,1193471059,1,1,330
88971823@N06,5235,17,1363135809,1363138509,3,1,2700
88984016@N00,5236,2,1349017216,1349017219,2,2,3
88984016@N00,5236,12,1349017219,1349018239,1,2,1020
88984016@N00,5237,13,1349111028,1349112108,2,3,1080
88984016@N00,5237,15,1349124206,1349125406,2,3,1200
88984016@N00,5237,11,1349129279,1349130239,3,3,960
88987422@N07,5238,11,1300598904,1300599588,3,2,684
88987422@N07,5238,15,1300599588,1300600788,27,2,1200
88994581@N00,5239,13,1351232217,1351233297,1,1,1080
88996132@N00,5240,11,1198781571,1198782531,1,1,960
89099232@N03,5241,16,1204604850,1204606950,1,1,2100
89117836@N08,5242,11,1387452145,1387453105,1,1,960
89138020@N00,5243,11,1241222903,1241223863,16,8,960
89138020@N00,5243,16,1241233311,1241234104,5,8,793
89138020@N00,5243,9,1241234104,1241235004,3,8,900
89138020@N00,5243,2,1241240572,1241240812,9,8,240
89138020@N00,5243,4,1241246578,1241246938,2,8,360
89138020@N00,5243,1,1241249576,1241249816,2,8,240
89138020@N00,5243,3,1241254236,1241254566,3,8,330
89138020@N00,5243,10,1241257150,1241258050,1,8,900
89138020@N00,5244,11,1241743722,1241744071,3,6,349
89138020@N00,5244,2,1241744071,1241744311,3,6,240
89138020@N00,5244,16,1241748610,1241750710,4,6,2100
89138020@N00,5244,5,1241752298,1241752718,6,6,420
89138020@N00,5244,8,1241755310,1241756150,5,6,840
89138020@N00,5244,13,1241763232,1241764312,3,6,1080
89241972@N00,5245,1,1268184024,1268184098,2,7,74
89241972@N00,5245,16,1268184098,1268185563,3,7,1465
89241972@N00,5245,2,1268185563,1268185803,3,7,240
89241972@N00,5245,13,1268189282,1268190362,2,7,1080
89241972@N00,5245,3,1268196501,1268196831,4,7,330
89241972@N00,5245,5,1268204734,1268205154,3,7,420
89241972@N00,5245,11,1268222343,1268223303,1,7,960
89334444@N08,5246,13,1392351447,1392352527,1,1,1080
8938418@N03,5247,17,1389404224,1389406924,2,2,2700
8938418@N03,5247,11,1389416925,1389417885,1,2,960
89388234@N00,5248,5,1371895577,1371895997,1,1,420
89388234@N00,5249,10,1371960291,1371960478,2,3,187
89388234@N00,5249,15,1371960478,1371960715,2,3,237
89388234@N00,5249,13,1371960715,1371961795,1,3,1080
89403129@N08,5250,11,1450984830,1450985790,3,1,960
8944312@N05,5251,5,1330204598,1330205018,1,1,420
89451823@N08,5252,15,1379064253,1379065453,2,3,1200
89451823@N08,5252,8,1379066475,1379066912,3,3,437
89451823@N08,5252,5,1379066912,1379067332,1,3,420
89451823@N08,5253,17,1379122099,1379124799,4,2,2700
89451823@N08,5253,13,1379127120,1379128200,1,2,1080
8949620@N08,5254,8,1209477600,1209477606,6,9,6
8949620@N08,5254,11,1209477606,1209477607,2,9,1
8949620@N08,5254,8,1209477607,1209477640,2,9,33
8949620@N08,5254,9,1209477640,1209477823,3,9,183
8949620@N08,5254,8,1209477823,1209478663,2,9,840
8949620@N08,5254,13,1209484391,1209484430,2,9,39
8949620@N08,5254,11,1209484430,1209484575,2,9,145
8949620@N08,5254,9,1209484575,1209484614,2,9,39
8949620@N08,5254,7,1209484614,1209485454,1,9,840
8949620@N08,5255,11,1209524251,1209525211,4,4,960
8949620@N08,5255,8,1209563384,1209563455,3,4,71
8949620@N08,5255,11,1209563455,1209563719,2,4,264
8949620@N08,5255,5,1209563719,1209564139,1,4,420
8949620@N08,5256,8,1209631807,1209632647,10,1,840
8949620@N08,5257,11,1209822880,1209823840,2,1,960
8949620@N08,5258,12,1209893907,1209893944,2,6,37
8949620@N08,5258,2,1209893944,1209893983,2,6,39
8949620@N08,5258,12,1209893983,1209894240,5,6,257
8949620@N08,5258,10,1209894240,1209895140,2,6,900
8949620@N08,5258,15,1209898730,1209898767,2,6,37
8949620@N08,5258,17,1209898767,1209901467,1,6,2700
8949620@N08,5259,12,1243692000,1243693020,3,1,1020
89522530@N00,5260,11,1332106389,1332107349,6,12,960
89522530@N00,5260,1,1332111388,1332111628,5,12,240
89522530@N00,5260,2,1332115053,1332115293,4,12,240
89522530@N00,5260,4,1332115614,1332115974,4,12,360
89522530@N00,5260,17,1332118465,1332119128,2,12,663
89522530@N00,5260,13,1332119128,1332120208,2,12,1080
89522530@N00,5260,8,1332133019,1332133859,4,12,840
89522530@N00,5260,5,1332134933,1332135353,2,12,420
89522530@N00,5260,17,1332137119,1332139819,7,12,2700
89522530@N00,5260,11,1332144056,1332144080,2,12,24
89522530@N00,5260,17,1332144080,1332144343,2,12,263
89522530@N00,5260,11,1332144343,1332145303,1,12,960
89634087@N00,5261,8,1298880803,1298880872,2,4,69
89634087@N00,5261,11,1298880872,1298881832,3,4,960
89634087@N00,5261,4,1298882976,1298882991,2,4,15
89634087@N00,5261,11,1298882991,1298883951,2,4,960
89658123@N07,5262,11,1359946648,1359947608,1,1,960
8980678@N03,5263,11,1191057095,1191058055,1,1,960
8980678@N03,5264,11,1242433596,1242434556,1,1,960
8980678@N03,5265,2,1251601512,1251601752,3,2,240
8980678@N03,5265,5,1251609616,1251610036,3,2,420
8980678@N03,5266,5,1268284622,1268285042,2,1,420
8980678@N03,5267,11,1296083015,1296083975,2,2,960
8980678@N03,5267,4,1296087553,1296087913,2,2,360
8980678@N03,5268,4,1299206609,1299206969,5,1,360
8980678@N03,5269,2,1308724522,1308724762,4,1,240
8980678@N03,5270,11,1323677160,1323678120,1,1,960
8980678@N03,5271,11,1335325666,1335326626,3,1,960
8980678@N03,5272,11,1350117867,1350118827,1,1,960
8980678@N03,5273,8,1353904833,1353905673,9,1,840
8980678@N03,5274,1,1368237331,1368237571,1,1,240
8980678@N03,5275,4,1424492482,1424492842,1,1,360
8980678@N03,5276,11,1425507675,1425508369,2,2,694
8980678@N03,5276,9,1425508369,1425509269,1,2,900
89938050@N07,5277,5,1350209549,1350209969,2,1,420
89938050@N07,5278,9,1350270293,1350271193,4,1,900
89939063@N03,5279,10,1369290190,1369291090,3,1,900
8996989@N02,5280,13,1238113790,1238114870,1,1,1080
89975165@N07,5281,13,1368559439,1368560519,1,1,1080
90008840@N00,5282,13,1397877035,1397878115,1,1,1080
90008840@N00,5283,5,1440472572,1440472992,1,1,420
90067442@N03,5284,11,1376879952,1376880912,1,1,960
90067442@N03,5285,11,1400459642,1400460602,1,1,960
90067442@N03,5286,13,1400579606,1400580686,1,1,1080
90067442@N03,5287,8,1400923336,1400924176,1,1,840
90081836@N00,5288,8,1312086346,1312087186,1,1,840
90123960@N00,5289,11,1266885732,1266886692,2,1,960
90226138@N02,5290,11,1437133028,1437133988,1,1,960
9027452@N07,5291,4,1201302613,1201302973,3,1,360
90279255@N08,5292,9,1435047814,1435048714,1,1,900
90311139@N00,5293,11,1229242468,1229243428,1,1,960
90315279@N00,5294,15,1368955389,1368955952,3,3,563
90315279@N00,5294,10,1368955952,1368956852,3,3,900
90315279@N00,5294,11,1368964498,1368965458,2,3,960
90315279@N00,5295,2,1369279037,1369279277,2,4,240
90315279@N00,5295,7,1369280270,1369281110,2,4,840
90315279@N00,5295,3,1369281567,1369281897,3,4,330
90315279@N00,5295,13,1369297396,1369298476,6,4,1080
90347114@N05,5296,11,1397524344,1397525304,19,5,960
90347114@N05,5296,9,1397525585,1397526485,12,5,900
90347114@N05,5296,16,1397528375,1397530475,2,5,2100
90347114@N05,5296,5,1397530896,1397531316,3,5,420
90347114@N05,5296,13,1397534480,1397535560,3,5,1080
90351516@N00,5297,5,1452385966,1452386386,2,1,420
9036688@N06,5298,5,1317379340,1317379760,2,1,420
9036688@N06,5299,11,1317434332,1317434422,3,4,90
9036688@N06,5299,10,1317434422,1317434478,2,4,56
9036688@N06,5299,11,1317434478,1317435438,2,4,960
9036688@N06,5299,2,1317440018,1317440258,1,4,240
90367727@N00,5300,4,1366254938,1366255298,1,1,360
9036889@N06,5301,1,1385086658,1385086898,3,2,240
9036889@N06,5301,10,1385092790,1385093690,1,2,900
9036889@N06,5302,1,1417833214,1417833454,1,1,240
90370508@N02,5303,11,1436229693,1436230653,2,1,960
90474234@N08,5304,17,1396679784,1396682484,1,1,2700
90496636@N05,5305,7,1425526975,1425527815,1,1,840
9051885@N06,5306,17,1278320069,1278322769,4,1,2700
90533800@N00,5307,11,1329730744,1329731704,1,1,960
90562571@N00,5308,11,1406588017,1406588977,2,1,960
90562571@N00,5309,5,1406624079,1406624499,3,1,420
90603065@N06,5310,10,1452323660,1452324560,2,2,900
90603065@N06,5310,11,1452324569,1452325529,1,2,960
90642923@N00,5311,11,1205497034,1205497994,1,1,960
90642923@N00,5312,4,1213592069,1213592429,1,1,360
90642923@N00,5313,11,1262221095,1262222055,2,10,960
90642923@N00,5313,4,1262223602,1262223962,5,10,360
90642923@N00,5313,7,1262224476,1262225316,2,10,840
90642923@N00,5313,8,1262231267,1262232107,2,10,840
90642923@N00,5313,10,1262233902,1262234443,2,10,541
90642923@N00,5313,17,1262234443,1262237143,2,10,2700
90642923@N00,5313,10,1262245897,1262246797,2,10,900
90642923@N00,5313,8,1262247658,1262248498,5,10,840
90642923@N00,5313,6,1262255799,1262256519,2,10,720
90642923@N00,5313,8,1262258978,1262259818,5,10,840
9070451@N03,5314,9,1400790870,1400791770,2,4,900
9070451@N03,5314,5,1400793872,1400794292,2,4,420
9070451@N03,5314,8,1400797083,1400797923,2,4,840
9070451@N03,5314,11,1400802353,1400803313,1,4,960
90728477@N00,5315,13,1369461462,1369462542,2,4,1080
90728477@N00,5315,5,1369468329,1369468749,2,4,420
90728477@N00,5315,4,1369471545,1369471905,2,4,360
90728477@N00,5315,11,1369472652,1369473612,1,4,960
90728477@N00,5316,3,1369525171,1369525501,1,1,330
90728477@N00,5317,13,1371955568,1371956648,2,3,1080
90728477@N00,5317,2,1371967284,1371967524,3,3,240
90728477@N00,5317,11,1371976083,1371977043,11,3,960
90755543@N00,5318,8,1396582793,1396583633,1,1,840
91032493@N00,5319,17,1438320385,1438323085,1,1,2700
91033481@N00,5320,3,1349816945,1349817275,1,1,330
91092205@N07,5321,10,1367984691,1367985591,17,4,900
91092205@N07,5321,17,1368009111,1368009791,13,4,680
91092205@N07,5321,10,1368009791,1368009915,3,4,124
91092205@N07,5321,17,1368009915,1368012615,41,4,2700
91110029@N02,5322,11,1414619178,1414619277,2,5,99
91110029@N02,5322,5,1414619277,1414619283,2,5,6
91110029@N02,5322,11,1414619283,1414619296,3,5,13
91110029@N02,5322,8,1414619296,1414619304,2,5,8
91110029@N02,5322,11,1414619304,1414620264,1,5,960
91129684@N00,5323,8,1364629143,1364629983,1,1,840
91132397@N08,5324,11,1417909687,1417910647,2,3,960
91132397@N08,5324,15,1417921560,1417922760,2,3,1200
91132397@N08,5324,3,1417941149,1417941479,6,3,330
91132397@N08,5325,11,1424758122,1424759082,1,1,960
91144647@N06,5326,9,1333844635,1333845535,2,4,900
91144647@N06,5326,1,1333854770,1333855010,3,4,240
91144647@N06,5326,17,1333855863,1333855929,3,4,66
91144647@N06,5326,15,1333855929,1333857129,1,4,1200
91207697@N08,5327,11,1413499324,1413500284,2,1,960
91220827@N02,5328,11,1376864880,1376865840,2,4,960
91220827@N02,5328,9,1376889252,1376890152,2,4,900
91220827@N02,5328,10,1376898193,1376899093,2,4,900
91220827@N02,5328,11,1376907537,1376908497,1,4,960
91227166@N06,5329,11,1399157765,1399158725,2,2,960
91227166@N06,5329,15,1399161677,1399162877,1,2,1200
91227690@N08,5330,7,1459745787,1459746627,7,4,840
91227690@N08,5330,9,1459748557,1459749457,15,4,900
91227690@N08,5330,1,1459750946,1459750990,2,4,44
91227690@N08,5330,16,1459750990,1459753090,7,4,2100
91227690@N08,5331,1,1460091726,1460091966,6,5,240
91227690@N08,5331,2,1460093807,1460094047,11,5,240
91227690@N08,5331,12,1460094695,1460094929,15,5,234
91227690@N08,5331,2,1460094929,1460095169,6,5,240
91227690@N08,5331,4,1460095405,1460095765,4,5,360
91227690@N08,5332,16,1460610283,1460610961,2,2,678
91227690@N08,5332,4,1460610961,1460611321,2,2,360
91227690@N08,5333,1,1460870775,1460870995,3,4,220
91227690@N08,5333,9,1460870995,1460871106,3,4,111
91227690@N08,5333,16,1460871106,1460871870,4,4,764
91227690@N08,5333,11,1460871870,1460872830,3,4,960
91227690@N08,5334,2,1461389830,1461390070,5,3,240
91227690@N08,5334,12,1461390087,1461390407,6,3,320
91227690@N08,5334,2,1461390407,1461390647,5,3,240
91256618@N07,5335,2,1383461082,1383461322,2,2,240
91256618@N07,5335,13,1383468747,1383469827,1,2,1080
91256618@N07,5336,11,1383626869,1383627829,2,2,960
91256618@N07,5336,3,1383629624,1383629954,1,2,330
91256618@N07,5337,8,1383799315,1383800155,4,1,840
91258390@N05,5338,5,1365235616,1365236036,1,1,420
91259577@N07,5339,17,1372219384,1372222084,1,1,2700
91315857@N02,5340,9,1377412542,1377413442,1,1,900
91315857@N02,5341,3,1377896790,1377897120,2,2,330
91315857@N02,5341,4,1377899945,1377900305,1,2,360
91315857@N02,5342,5,1377933409,1377933829,1,1,420
91315857@N02,5343,11,1382411443,1382411482,2,3,39
91315857@N02,5343,1,1382411482,1382411722,2,3,240
91315857@N02,5343,13,1382415649,1382416729,1,3,1080
91315857@N02,5344,11,1443990519,1443991479,1,1,960
91363409@N07,5345,11,1415739454,1415740414,2,3,960
91363409@N07,5345,1,1415743512,1415743752,3,3,240
91363409@N07,5345,10,1415749037,1415749937,1,3,900
91372718@N04,5346,16,1374368043,1374370143,2,8,2100
91372718@N04,5346,4,1374371669,1374372029,4,8,360
91372718@N04,5346,9,1374378735,1374379635,2,8,900
91372718@N04,5346,8,1374383787,1374384627,11,8,840
91372718@N04,5346,15,1374400083,1374400267,2,8,184
91372718@N04,5346,17,1374400267,1374400642,8,8,375
91372718@N04,5346,10,1374400642,1374401542,3,8,900
91372718@N04,5346,11,1374401712,1374402672,3,8,960
91407288@N07,5347,17,1352244408,1352247108,3,1,2700
91409399@N07,5348,9,1379398219,1379399119,2,2,900
91409399@N07,5348,10,1379410236,1379411136,3,2,900
91409399@N07,5349,16,1379555863,1379557963,5,5,2100
91409399@N07,5349,3,1379560097,1379560427,5,5,330
91409399@N07,5349,1,1379562765,1379563005,2,5,240
91409399@N07,5349,5,1379564707,1379565127,2,5,420
91409399@N07,5349,11,1379584083,1379585043,1,5,960
91409399@N07,5350,13,1379992239,1379993319,8,1,1080
91435349@N03,5351,11,1381294207,1381295167,1,1,960
91446813@N03,5352,11,1368491421,1368492381,29,1,960
91446813@N03,5353,11,1368710483,1368711443,1,1,960
91456744@N00,5354,11,1322548973,1322549933,2,2,960
91456744@N00,5354,5,1322552294,1322552714,1,2,420
91496554@N04,5355,11,1469749840,1469750800,5,8,960
91496554@N04,5355,4,1469757645,1469758005,2,8,360
91496554@N04,5355,13,1469763595,1469764675,2,8,1080
91496554@N04,5355,8,1469774305,1469775145,6,8,840
91496554@N04,5355,15,1469781234,1469782434,3,8,1200
91496554@N04,5355,9,1469785753,1469786653,2,8,900
91496554@N04,5355,16,1469787560,1469787897,6,8,337
91496554@N04,5355,11,1469787897,1469788857,4,8,960
91501015@N07,5356,11,1357614800,1357615760,1,1,960
91501015@N07,5357,11,1357683023,1357683983,29,5,960
91501015@N07,5357,8,1357699170,1357699632,3,5,462
91501015@N07,5357,17,1357699632,1357701591,2,5,1959
91501015@N07,5357,5,1357701591,1357702011,3,5,420
91501015@N07,5357,11,1357703953,1357704913,1,5,960
91534967@N00,5358,5,1364639280,1364639700,1,1,420
91569514@N05,5359,11,1432855449,1432856409,16,3,960
91569514@N05,5359,3,1432872903,1432873233,11,3,330
91569514@N05,5359,11,1432902340,1432903300,4,3,960
91621746@N00,5360,11,1330306371,1330307331,3,3,960
91621746@N00,5360,13,1330313537,1330314234,4,3,697
91621746@N00,5360,17,1330314234,1330316934,2,3,2700
91634060@N02,5361,11,1356230021,1356230981,1,1,960
91703770@N00,5362,11,1225585723,1225586683,22,10,960
91703770@N00,5362,9,1225588501,1225589401,39,10,900
91703770@N00,5362,16,1225591866,1225593966,7,10,2100
91703770@N00,5362,1,1225595456,1225595696,11,10,240
91703770@N00,5362,5,1225599637,1225600057,15,10,420
91703770@N00,5362,8,1225609198,1225610038,2,10,840
91703770@N00,5362,15,1225615038,1225615503,9,10,465
91703770@N00,5362,17,1225615503,1225617215,8,10,1712
91703770@N00,5362,14,1225617215,1225618415,3,10,1200
91703770@N00,5362,11,1225619688,1225620648,10,10,960
91723305@N00,5363,16,1337077740,1337079840,1,1,2100
91761857@N00,5364,2,1396518123,1396518363,10,2,240
91761857@N00,5364,11,1396524667,1396525627,11,2,960
91761857@N00,5365,1,1419667374,1419667614,1,1,240
9176927@N08,5366,16,1239265370,1239266055,2,5,685
9176927@N08,5366,11,1239266055,1239267015,2,5,960
9176927@N08,5366,1,1239267326,1239267566,3,5,240
9176927@N08,5366,5,1239270311,1239270731,3,5,420
9176927@N08,5366,11,1239272584,1239273544,2,5,960
91831221@N00,5367,5,1325487529,1325487949,2,2,420
91831221@N00,5367,11,1325493091,1325494051,2,2,960
91847136@N03,5368,9,1388188861,1388189761,2,4,900
91847136@N03,5368,1,1388191561,1388191801,3,4,240
91847136@N03,5368,10,1388211452,1388212352,3,4,900
91847136@N03,5368,15,1388212508,1388213708,1,4,1200
91859523@N00,5369,11,1303699543,1303700503,4,3,960
91859523@N00,5369,15,1303718633,1303719833,2,3,1200
91859523@N00,5369,10,1303725633,1303726533,1,3,900
9191162@N05,5370,10,1225592982,1225593882,1,1,900
9197147@N03,5371,11,1400327887,1400328847,1,1,960
92005509@N02,5372,2,1463992087,1463992327,3,1,240
92009229@N05,5373,9,1365496170,1365497070,3,2,900
92009229@N05,5373,10,1365505587,1365506487,4,2,900
9201618@N02,5374,6,1403003543,1403004263,1,1,720
92026547@N05,5375,11,1410493591,1410494551,2,3,960
92026547@N05,5375,5,1410498063,1410498483,2,3,420
92026547@N05,5375,11,1410510600,1410511560,1,3,960
92026547@N05,5376,11,1410861724,1410862684,1,1,960
92026547@N05,5377,11,1414276923,1414277883,2,3,960
92026547@N05,5377,1,1414280402,1414280642,2,3,240
92026547@N05,5377,11,1414289674,1414290634,1,3,960
92114370@N02,5378,1,1397274242,1397274482,1,1,240
92114370@N02,5379,1,1397545047,1397545287,1,1,240
92144729@N07,5380,2,1398169906,1398170146,1,1,240
92155161@N00,5381,17,1414731699,1414734399,1,1,2700
92174097@N02,5382,16,1268583837,1268585937,1,1,2100
9228491@N06,5383,11,1267338160,1267339120,5,4,960
9228491@N06,5383,16,1267339722,1267341822,3,4,2100
9228491@N06,5383,10,1267346293,1267347193,2,4,900
9228491@N06,5383,11,1267352675,1267353635,1,4,960
9228491@N06,5384,11,1267413048,1267414008,2,5,960
9228491@N06,5384,12,1267415417,1267416437,7,5,1020
9228491@N06,5384,2,1267416724,1267416964,2,5,240
9228491@N06,5384,13,1267420227,1267421307,4,5,1080
9228491@N06,5384,3,1267427793,1267428123,1,5,330
9228491@N06,5385,8,1267490859,1267491699,3,1,840
9228491@N06,5386,3,1267792358,1267792688,1,1,330
9228491@N06,5387,17,1267827038,1267829738,2,6,2700
9228491@N06,5387,5,1267847908,1267848328,8,6,420
9228491@N06,5387,1,1267852128,1267852349,2,6,221
9228491@N06,5387,16,1267852349,1267852604,2,6,255
9228491@N06,5387,9,1267852604,1267853028,2,6,424
9228491@N06,5387,11,1267853028,1267853988,5,6,960
9228491@N06,5388,16,1267929181,1267931281,3,3,2100
9228491@N06,5388,5,1267936817,1267937237,3,3,420
9228491@N06,5388,11,1267946579,1267947539,1,3,960
9228491@N06,5389,15,1268018676,1268019876,3,2,1200
9228491@N06,5389,8,1268022776,1268023616,1,2,840
9228491@N06,5390,11,1323170951,1323171911,1,1,960
92286879@N00,5391,11,1445476833,1445477793,1,1,960
9230719@N05,5392,17,1292653636,1292656336,1,1,2700
9230719@N05,5393,11,1295049266,1295050226,2,2,960
9230719@N05,5393,4,1295052102,1295052462,1,2,360
9230719@N05,5394,13,1306707448,1306708528,1,1,1080
9233146@N03,5395,8,1208691477,1208692317,6,1,840
9233146@N03,5396,4,1208962806,1208963166,4,1,360
92496162@N08,5397,11,1446085493,1446086453,2,3,960
92496162@N08,5397,17,1446096382,1446099082,2,3,2700
92496162@N08,5397,11,1446113188,1446114148,1,3,960
92533979@N00,5398,9,1359933512,1359934412,3,8,900
92533979@N00,5398,1,1359934810,1359935050,3,8,240
92533979@N00,5398,13,1359937590,1359938670,3,8,1080
92533979@N00,5398,2,1359946702,1359946780,2,8,78
92533979@N00,5398,12,1359946780,1359947800,2,8,1020
92533979@N00,5398,8,1359960316,1359961156,3,8,840
92533979@N00,5398,13,1359969456,1359970245,2,8,789
92533979@N00,5398,17,1359970245,1359972945,2,8,2700
92577424@N06,5399,8,1208760444,1208761284,1,1,840
92595189@N00,5400,14,1223250396,1223251596,7,1,1200
92617440@N08,5401,4,1413348767,1413349127,1,1,360
92622262@N08,5402,11,1369553682,1369554642,2,1,960
92622262@N08,5403,5,1370648828,1370649248,12,3,420
92622262@N08,5403,1,1370656056,1370656296,2,3,240
92622262@N08,5403,11,1370658081,1370659041,2,3,960
92622262@N08,5404,10,1400898939,1400899839,4,2,900
92622262@N08,5404,2,1400906144,1400906384,4,2,240
92622262@N08,5405,1,1402739706,1402739946,1,1,240
92712863@N03,5406,11,1361145908,1361146868,11,1,960
9274852@N08,5407,17,1349510224,1349512924,1,1,2700
92859253@N04,5408,3,1379732884,1379733214,1,1,330
92877887@N00,5409,1,1443937326,1443937566,1,1,240
9292159@N06,5410,5,1449562944,1449563364,2,1,420
9292159@N06,5411,15,1449648333,1449649533,7,1,1200
92931591@N05,5412,14,1377328270,1377329470,1,1,1200
92931591@N05,5413,8,1441102698,1441103538,2,1,840
93003498@N05,5414,11,1335505504,1335506464,1,1,960
93003498@N05,5415,6,1354914519,1354915239,1,1,720
93003498@N05,5416,11,1360629802,1360630762,1,1,960
93003498@N05,5417,11,1363229761,1363230721,1,1,960
93003498@N05,5418,11,1364773964,1364774924,1,1,960
93003498@N05,5419,5,1365308998,1365309418,3,1,420
93003498@N05,5420,11,1365562847,1365563807,1,1,960
93074386@N00,5421,11,1444696678,1444697638,1,1,960
93081598@N05,5422,8,1365753335,1365754175,2,2,840
93081598@N05,5422,5,1365756898,1365757318,1,2,420
93086051@N00,5423,4,1357446233,1357446593,1,1,360
93086051@N00,5424,10,1397901146,1397902046,1,1,900
93086051@N00,5425,4,1399185469,1399185829,1,1,360
93086051@N00,5426,3,1399698316,1399698646,1,1,330
93086051@N00,5427,8,1441526686,1441527526,1,1,840
93086051@N00,5428,11,1443311048,1443312008,1,1,960
93105948@N06,5429,11,1263861496,1263862456,27,1,960
93105948@N06,5430,11,1280308526,1280309486,1,1,960
93105948@N06,5431,11,1360485106,1360486066,2,1,960
93117900@N03,5432,11,1383118469,1383119429,1,1,960
93126204@N00,5433,11,1368489148,1368489940,2,3,792
93126204@N00,5433,2,1368489940,1368490180,2,3,240
93126204@N00,5433,8,1368496656,1368497496,1,3,840
93150071@N06,5434,11,1363816490,1363817450,1,1,960
93182963@N00,5435,16,1285030404,1285032504,1,1,2100
93260943@N08,5436,11,1360910149,1360911109,1,1,960
93260943@N08,5437,8,1377935654,1377936494,1,1,840
93283041@N00,5438,11,1229401852,1229402812,3,6,960
93283041@N00,5438,1,1229403586,1229403826,2,6,240
93283041@N00,5438,16,1229404814,1229406914,2,6,2100
93283041@N00,5438,5,1229408615,1229409035,8,6,420
93283041@N00,5438,1,1229412385,1229412625,3,6,240
93283041@N00,5438,11,1229415108,1229416068,1,6,960
93283041@N00,5439,11,1229547342,1229548302,2,8,960
93283041@N00,5439,7,1229548475,1229549315,16,8,840
93283041@N00,5439,2,1229551515,1229551755,5,8,240
93283041@N00,5439,7,1229552289,1229553129,2,8,840
93283041@N00,5439,4,1229554047,1229554217,2,8,170
93283041@N00,5439,17,1229554217,1229554440,3,8,223
93283041@N00,5439,15,1229554440,1229555640,12,8,1200
93283041@N00,5439,4,1229561805,1229562165,1,8,360
93283041@N00,5440,11,1229652868,1229653685,2,8,817
93283041@N00,5440,5,1229653685,1229654105,5,8,420
93283041@N00,5440,8,1229655233,1229656073,11,8,840
93283041@N00,5440,6,1229664614,1229665334,2,8,720
93283041@N00,5440,13,1229666000,1229667080,3,8,1080
93283041@N00,5440,17,1229670349,1229672231,3,8,1882
93283041@N00,5440,4,1229672231,1229672591,2,8,360
93283041@N00,5440,5,1229679289,1229679709,2,8,420
93283041@N00,5441,9,1229822157,1229822471,4,4,314
93283041@N00,5441,1,1229822471,1229822711,2,4,240
93283041@N00,5441,4,1229825916,1229826276,5,4,360
93283041@N00,5441,2,1229835372,1229835612,8,4,240
93283041@N00,5442,11,1272676336,1272677296,2,11,960
93283041@N00,5442,16,1272680571,1272682671,18,11,2100
93283041@N00,5442,9,1272682763,1272683663,2,11,900
93283041@N00,5442,17,1272690756,1272691177,6,11,421
93283041@N00,5442,15,1272691177,1272691342,4,11,165
93283041@N00,5442,17,1272691342,1272691461,5,11,119
93283041@N00,5442,15,1272691461,1272691554,3,11,93
93283041@N00,5442,13,1272691554,1272692634,6,11,1080
93283041@N00,5442,8,1272694180,1272695020,5,11,840
93283041@N00,5442,1,1272696386,1272696626,8,11,240
93283041@N00,5442,11,1272700438,1272701398,2,11,960
93283041@N00,5443,6,1282285524,1282286244,3,2,720
93283041@N00,5443,8,1282286988,1282287828,2,2,840
93283041@N00,5444,16,1287181217,1287183317,4,2,2100
93283041@N00,5444,8,1287183400,1287184240,1,2,840
93283041@N00,5445,11,1301777792,1301778752,3,7,960
93283041@N00,5445,16,1301786796,1301787158,3,7,362
93283041@N00,5445,1,1301787158,1301787398,3,7,240
93283041@N00,5445,5,1301790373,1301790793,2,7,420
93283041@N00,5445,8,1301791329,1301792169,10,7,840
93283041@N00,5445,15,1301801918,1301803118,2,7,1200
93283041@N00,5445,11,1301805595,1301806555,1,7,960
93283041@N00,5446,5,1332028526,1332028946,3,4,420
93283041@N00,5446,16,1332029097,1332031197,3,4,2100
93283041@N00,5446,1,1332033923,1332034163,4,4,240
93283041@N00,5446,11,1332045630,1332046590,1,4,960
93284303@N04,5447,13,1361764575,1361765655,1,1,1080
93294943@N08,5448,8,1363145505,1363146345,5,2,840
93294943@N08,5448,17,1363154796,1363157496,2,2,2700
93294943@N08,5449,4,1404220285,1404220645,1,1,360
9329633@N04,5450,11,1353803528,1353804488,3,2,960
9329633@N04,5450,5,1353822186,1353822606,1,2,420
9329633@N04,5451,11,1354152577,1354153537,1,1,960
93334382@N02,5452,4,1376008635,1376008995,1,1,360
93334382@N02,5453,13,1384827865,1384828945,2,1,1080
93334382@N02,5454,5,1405416427,1405416847,1,1,420
93347972@N00,5455,17,1200636443,1200639143,3,2,2700
93347972@N00,5455,10,1200640031,1200640931,1,2,900
93371661@N08,5456,11,1360273094,1360273966,2,8,872
93371661@N08,5456,1,1360273966,1360274206,4,8,240
93371661@N08,5456,11,1360278423,1360279383,2,8,960
93371661@N08,5456,3,1360288543,1360288598,2,8,55
93371661@N08,5456,7,1360288598,1360288779,4,8,181
93371661@N08,5456,4,1360288779,1360289139,3,8,360
93371661@N08,5456,15,1360291569,1360292769,2,8,1200
93371661@N08,5456,1,1360294192,1360294432,1,8,240
9349788@N07,5457,4,1364039099,1364039459,2,1,360
93538524@N06,5458,11,1375063843,1375064803,2,9,960
93538524@N06,5458,9,1375065299,1375066199,9,9,900
93538524@N06,5458,5,1375068069,1375068489,18,9,420
93538524@N06,5458,8,1375069673,1375070513,4,9,840
93538524@N06,5458,13,1375075837,1375075974,2,9,137
93538524@N06,5458,15,1375075974,1375076445,2,9,471
93538524@N06,5458,17,1375076445,1375077733,6,9,1288
93538524@N06,5458,10,1375077733,1375078633,5,9,900
93538524@N06,5458,4,1375079736,1375080096,3,9,360
93629101@N05,5459,11,1430528164,1430529124,39,20,960
93629101@N05,5459,4,1430532929,1430533289,27,20,360
93629101@N05,5459,10,1430533934,1430533940,2,20,6
93629101@N05,5459,4,1430533940,1430533950,2,20,10
93629101@N05,5459,10,1430533950,1430533956,2,20,6
93629101@N05,5459,4,1430533956,1430534316,17,20,360
93629101@N05,5459,13,1430545219,1430546299,3,20,1080
93629101@N05,5459,1,1430552354,1430552528,5,20,174
93629101@N05,5459,9,1430552528,1430552814,4,20,286
93629101@N05,5459,1,1430552814,1430553054,4,20,240
93629101@N05,5459,17,1430553514,1430553881,4,20,367
93629101@N05,5459,15,1430553881,1430553977,3,20,96
93629101@N05,5459,17,1430553977,1430554115,4,20,138
93629101@N05,5459,10,1430554115,1430554754,5,20,639
93629101@N05,5459,8,1430554754,1430555117,3,20,363
93629101@N05,5459,5,1430555117,1430555537,27,20,420
93629101@N05,5459,2,1430558918,1430559158,26,20,240
93629101@N05,5459,3,1430561005,1430561018,2,20,13
93629101@N05,5459,7,1430561018,1430561858,2,20,840
93629101@N05,5459,11,1430565876,1430566836,1,20,960
93629101@N05,5460,13,1430603115,1430604195,2,1,1080
93645801@N07,5461,11,1313045426,1313046386,2,1,960
93678083@N08,5462,1,1336708704,1336708944,3,3,240
93678083@N08,5462,16,1336709031,1336711131,2,3,2100
93678083@N08,5462,15,1336726205,1336727405,5,3,1200
93728052@N05,5463,11,1359615276,1359616236,1,1,960
93851844@N00,5464,11,1218757198,1218758158,4,2,960
93851844@N00,5464,5,1218773470,1218773890,1,2,420
93897867@N00,5465,11,1295514152,1295515112,1,1,960
94083192@N00,5466,11,1394152869,1394153829,16,1,960
94126498@N00,5467,13,1445824467,1445825547,2,3,1080
94126498@N00,5467,11,1445828400,1445829360,2,3,960
94126498@N00,5467,17,1445835600,1445838300,1,3,2700
94128388@N07,5468,15,1322288440,1322289640,1,1,1200
94128388@N07,5469,15,1322781324,1322782524,1,1,1200
94128388@N07,5470,1,1414277752,1414277992,1,1,240
94155755@N00,5471,5,1385440245,1385440665,1,1,420
94155755@N00,5472,11,1460728236,1460729196,1,1,960
94199138@N00,5473,11,1366889304,1366890264,1,1,960
94322044@N04,5474,11,1368149336,1368150296,1,1,960
94386117@N07,5475,11,1370016816,1370017776,1,1,960
94436430@N00,5476,10,1360306677,1360307577,1,1,900
9449875@N03,5477,11,1361146987,1361147947,3,5,960
9449875@N03,5477,4,1361150927,1361151287,6,5,360
9449875@N03,5477,12,1361157051,1361158071,15,5,1020
9449875@N03,5477,8,1361161395,1361162235,2,5,840
9449875@N03,5477,5,1361169420,1361169840,1,5,420
94511303@N04,5478,1,1414199071,1414199311,2,2,240
94511303@N04,5478,5,1414202737,1414203157,1,2,420
94512378@N00,5479,11,1336523948,1336524908,1,1,960
9456601@N03,5480,14,1308274559,1308274773,4,7,214
9456601@N03,5480,3,1308274773,1308275103,3,7,330
9456601@N03,5480,8,1308280520,1308281360,4,7,840
9456601@N03,5480,5,1308283306,1308283726,3,7,420
9456601@N03,5480,1,1308285383,1308285623,4,7,240
9456601@N03,5480,12,1308299510,1308300232,6,7,722
9456601@N03,5480,2,1308300232,1308300472,1,7,240
94571531@N00,5481,17,1304568400,1304571100,2,3,2700
94571531@N00,5481,13,1304571688,1304572768,2,3,1080
94571531@N00,5481,17,1304576771,1304579471,1,3,2700
9459256@N05,5482,5,1202867907,1202868327,1,1,420
9461342@N03,5483,11,1397084073,1397085033,1,1,960
9461342@N03,5484,11,1459939896,1459940856,1,1,960
94681905@N04,5485,11,1417861302,1417862262,1,1,960
94697173@N00,5486,13,1443426358,1443427438,12,2,1080
94697173@N00,5486,11,1443434605,1443435565,1,2,960
94697173@N00,5487,15,1443508893,1443510093,4,3,1200
94697173@N00,5487,6,1443512754,1443513474,3,3,720
94697173@N00,5487,8,1443519663,1443520503,3,3,840
94697173@N00,5488,8,1443588760,1443589600,1,1,840
94697173@N00,5489,13,1443830429,1443831051,2,2,622
94697173@N00,5489,8,1443831051,1443831891,1,2,840
94697173@N00,5490,11,1454636790,1454637669,2,7,879
94697173@N00,5490,5,1454637669,1454638089,5,7,420
94697173@N00,5490,1,1454638168,1454638186,3,7,18
94697173@N00,5490,5,1454638186,1454638606,3,7,420
94697173@N00,5490,13,1454644892,1454645009,5,7,117
94697173@N00,5490,15,1454645009,1454646209,3,7,1200
94697173@N00,5490,11,1454666111,1454667071,2,7,960
94738051@N05,5491,12,1375578065,1375579085,1,1,1020
94749819@N03,5492,11,1465461749,1465462709,1,1,960
94817984@N02,5493,11,1391502935,1391503895,1,1,960
94817984@N02,5494,5,1406080162,1406080582,1,1,420
94817984@N02,5495,15,1414801022,1414802222,2,2,1200
94817984@N02,5495,8,1414803148,1414803988,1,2,840
94938844@N06,5496,17,1356079385,1356080797,2,2,1412
94938844@N06,5496,13,1356080797,1356081877,1,2,1080
95095552@N02,5497,11,1400980464,1400981424,1,1,960
95145503@N04,5498,2,1364348690,1364348930,1,1,240
95198134@N00,5499,11,1191194178,1191195076,2,17,898
95198134@N00,5499,7,1191195076,1191195134,2,17,58
95198134@N00,5499,3,1191195134,1191195464,3,17,330
95198134@N00,5499,4,1191197590,1191197950,5,17,360
95198134@N00,5499,10,1191202490,1191202743,5,17,253
95198134@N00,5499,17,1191202743,1191203618,6,17,875
95198134@N00,5499,13,1191203618,1191204698,3,17,1080
95198134@N00,5499,11,1191210427,1191211077,2,17,650
95198134@N00,5499,2,1191211077,1191211317,5,17,240
95198134@N00,5499,12,1191212223,1191213243,3,17,1020
95198134@N00,5499,9,1191216102,1191217002,5,17,900
95198134@N00,5499,1,1191217518,1191217758,4,17,240
95198134@N00,5499,16,1191219639,1191221739,3,17,2100
95198134@N00,5499,1,1191223077,1191223317,3,17,240
95198134@N00,5499,8,1191227298,1191228138,4,17,840
95198134@N00,5499,5,1191228264,1191228684,6,17,420
95198134@N00,5499,8,1191232306,1191233146,4,17,840
95258067@N00,5500,11,1386717934,1386718894,2,6,960
95258067@N00,5500,3,1386720653,1386720983,2,6,330
95258067@N00,5500,2,1386724191,1386724431,3,6,240
95258067@N00,5500,10,1386732954,1386733854,2,6,900
95258067@N00,5500,8,1386746514,1386747354,2,6,840
95258067@N00,5500,13,1386758173,1386759253,3,6,1080
95258067@N00,5501,5,1386895995,1386896415,2,3,420
95258067@N00,5501,8,1386905487,1386906327,2,3,840
95258067@N00,5501,11,1386912742,1386913702,3,3,960
95341382@N05,5502,11,1443402254,1443403214,2,1,960
95356654@N00,5503,8,1223238540,1223239380,2,1,840
95356654@N00,5504,11,1223505351,1223506311,1,1,960
95356654@N00,5505,11,1223569699,1223570659,1,1,960
95356654@N00,5506,11,1327899787,1327900747,1,1,960
95356654@N00,5507,11,1390542113,1390543073,4,3,960
95356654@N00,5507,5,1390545856,1390546276,5,3,420
95356654@N00,5507,1,1390558428,1390558668,1,3,240
95356654@N00,5508,11,1431510507,1431511467,6,1,960
95356654@N00,5509,11,1431750690,1431751650,2,1,960
95356654@N00,5510,1,1432285085,1432285325,4,1,240
9540001@N06,5511,6,1201423794,1201424514,1,1,720
95400328@N03,5512,1,1371684146,1371684386,1,1,240
95400328@N03,5513,11,1371811531,1371812491,1,1,960
95413039@N00,5514,3,1201992932,1201993262,31,1,330
95415594@N00,5515,10,1267657701,1267658601,1,1,900
95454502@N06,5516,11,1433126884,1433127844,1,1,960
9549670@N05,5517,11,1467850184,1467850573,3,15,389
9549670@N05,5517,7,1467850573,1467850984,7,15,411
9549670@N05,5517,4,1467850984,1467851344,2,15,360
9549670@N05,5517,17,1467851387,1467852092,7,15,705
9549670@N05,5517,15,1467852092,1467852727,14,15,635
9549670@N05,5517,6,1467852727,1467852764,2,15,37
9549670@N05,5517,13,1467852764,1467853844,3,15,1080
9549670@N05,5517,8,1467857785,1467858625,2,15,840
9549670@N05,5517,5,1467859135,1467859555,5,15,420
9549670@N05,5517,8,1467859783,1467860623,2,15,840
9549670@N05,5517,17,1467862865,1467865565,3,15,2700
9549670@N05,5517,10,1467865664,1467865758,2,15,94
9549670@N05,5517,15,1467865758,1467865832,2,15,74
9549670@N05,5517,13,1467865832,1467866912,4,15,1080
9549670@N05,5517,11,1467873824,1467874784,1,15,960
95555783@N05,5518,7,1365498724,1365499564,1,1,840
95559818@N00,5519,11,1190507723,1190508683,3,2,960
95559818@N00,5519,2,1190511443,1190511683,1,2,240
95559818@N00,5520,11,1304667339,1304668299,2,2,960
95559818@N00,5520,2,1304669761,1304670001,1,2,240
95559818@N00,5521,11,1333358895,1333359855,1,1,960
95559818@N00,5522,5,1333675405,1333675825,1,1,420
95608654@N04,5523,4,1363857058,1363857061,2,3,3
95608654@N04,5523,11,1363857061,1363858021,5,3,960
95608654@N04,5523,8,1363859054,1363859894,2,3,840
95611942@N00,5524,2,1382059638,1382059878,14,2,240
95611942@N00,5524,11,1382075607,1382076567,1,2,960
95611942@N00,5525,11,1468271690,1468272600,2,11,910
95611942@N00,5525,5,1468272600,1468273020,7,11,420
95611942@N00,5525,8,1468277810,1468278650,6,11,840
95611942@N00,5525,13,1468290185,1468291265,2,11,1080
95611942@N00,5525,12,1468293318,1468294338,5,11,1020
95611942@N00,5525,2,1468296189,1468296429,2,11,240
95611942@N00,5525,10,1468299628,1468300007,2,11,379
95611942@N00,5525,15,1468300007,1468301207,2,11,1200
95611942@N00,5525,13,1468301846,1468302926,2,11,1080
95611942@N00,5525,9,1468307668,1468308568,2,11,900
95611942@N00,5525,11,1468318460,1468319420,1,11,960
95646877@N00,5526,11,1273889310,1273890270,1,1,960
95653839@N03,5527,11,1416122089,1416123049,1,1,960
95653839@N03,5528,1,1416301289,1416301529,2,2,240
95653839@N03,5528,13,1416306506,1416307586,1,2,1080
95653839@N03,5529,8,1416480318,1416480752,2,2,434
95653839@N03,5529,5,1416480752,1416481172,1,2,420
95694198@N00,5530,11,1362969568,1362970528,7,4,960
95694198@N00,5530,10,1362992138,1362992934,5,4,796
95694198@N00,5530,4,1362992934,1362993294,4,4,360
95694198@N00,5530,11,1362999231,1363000191,1,4,960
95694198@N00,5531,1,1363212478,1363212718,2,4,240
95694198@N00,5531,17,1363213183,1363215883,3,4,2700
95694198@N00,5531,9,1363216414,1363217314,7,4,900
95694198@N00,5531,11,1363240559,1363241519,9,4,960
95694198@N00,5532,4,1363495725,1363496085,1,1,360
95736828@N07,5533,2,1370394555,1370394795,6,1,240
95769700@N00,5534,11,1380939605,1380940565,4,3,960
95769700@N00,5534,10,1380958155,1380958579,2,3,424
95769700@N00,5534,15,1380958579,1380959779,1,3,1200
95773887@N00,5535,16,1254045763,1254047863,2,2,2100
95773887@N00,5535,11,1254073539,1254074499,1,2,960
95778894@N00,5536,13,1457150701,1457151781,4,5,1080
95778894@N00,5536,17,1457152270,1457154970,5,5,2700
95778894@N00,5536,8,1457173733,1457174573,2,5,840
95778894@N00,5536,5,1457178597,1457179017,2,5,420
95778894@N00,5536,10,1457186013,1457186913,1,5,900
95782054@N05,5537,11,1382801771,1382802731,9,4,960
95782054@N05,5537,10,1382803215,1382804069,9,4,854
95782054@N05,5537,17,1382804069,1382806769,6,4,2700
95782054@N05,5537,15,1382806990,1382808190,4,4,1200
95821525@N08,5538,11,1382122193,1382123153,2,2,960
95821525@N08,5538,2,1382139421,1382139661,1,2,240
95911107@N02,5539,11,1442966588,1442967548,2,5,960
95911107@N02,5539,2,1442973794,1442974034,4,5,240
95911107@N02,5539,3,1442978546,1442978876,2,5,330
95911107@N02,5539,17,1442986044,1442986061,2,5,17
95911107@N02,5539,10,1442986061,1442986961,1,5,900
95928504@N03,5540,4,1428373492,1428373852,1,1,360
95999793@N00,5541,4,1369209619,1369209979,1,1,360
96023438@N05,5542,11,1378688758,1378689718,3,1,960
96062950@N02,5543,11,1385941333,1385942035,3,6,702
96062950@N02,5543,3,1385942035,1385942365,5,6,330
96062950@N02,5543,8,1385947513,1385948353,10,6,840
96062950@N02,5543,17,1385969174,1385969720,2,6,546
96062950@N02,5543,10,1385969720,1385970620,2,6,900
96062950@N02,5543,1,1385970785,1385971025,6,6,240
96062950@N02,5544,11,1386048746,1386049706,2,3,960
96062950@N02,5544,13,1386053879,1386054959,2,3,1080
96062950@N02,5544,5,1386061689,1386062109,1,3,420
96062950@N02,5545,11,1386475140,1386476100,3,5,960
96062950@N02,5545,3,1386480216,1386480546,2,5,330
96062950@N02,5545,2,1386482005,1386482245,5,5,240
96062950@N02,5545,10,1386485160,1386486060,2,5,900
96062950@N02,5545,1,1386493148,1386493388,2,5,240
96074685@N04,5546,17,1374113661,1374116361,6,1,2700
96077153@N00,5547,4,1291983042,1291983402,2,2,360
96077153@N00,5547,11,1291987629,1291988589,2,2,960
96077153@N00,5548,5,1295086120,1295086540,1,1,420
96077153@N00,5549,1,1303430126,1303430366,2,5,240
96077153@N00,5549,11,1303451019,1303451979,2,5,960
96077153@N00,5549,4,1303453488,1303453848,2,5,360
96077153@N00,5549,11,1303461770,1303462597,2,5,827
96077153@N00,5549,10,1303462597,1303463497,1,5,900
96077153@N00,5550,16,1305264629,1305266729,1,1,2100
96084178@N00,5551,8,1257903090,1257903930,9,3,840
96084178@N00,5551,15,1257913803,1257914862,5,3,1059
96084178@N00,5551,17,1257914862,1257917562,1,3,2700
96084178@N00,5552,11,1368332812,1368333772,6,4,960
96084178@N00,5552,8,1368336305,1368337145,8,4,840
96084178@N00,5552,5,1368341368,1368341788,2,4,420
96084178@N00,5552,11,1368343332,1368344292,1,4,960
96084178@N00,5553,10,1395381397,1395382297,2,2,900
96084178@N00,5553,15,1395382507,1395383707,1,2,1200
96088830@N07,5554,17,1298767508,1298770208,2,4,2700
96088830@N07,5554,2,1298770276,1298770516,2,4,240
96088830@N07,5554,17,1298776881,1298777567,2,4,686
96088830@N07,5554,4,1298777567,1298777927,4,4,360
9611843@N04,5555,11,1193860840,1193861800,1,1,960
9611843@N04,5556,5,1229444674,1229445094,1,1,420
9611843@N04,5557,8,1266034579,1266035419,1,1,840
9611843@N04,5558,5,1295428257,1295428677,1,1,420
9611843@N04,5559,17,1295474552,1295477252,2,4,2700
9611843@N04,5559,11,1295480864,1295481824,2,4,960
9611843@N04,5559,8,1295487671,1295488511,2,4,840
9611843@N04,5559,3,1295488554,1295488884,1,4,330
9611843@N04,5560,1,1317366669,1317366909,2,2,240
9611843@N04,5560,2,1317369085,1317369325,1,2,240
9611843@N04,5561,9,1319030488,1319031388,1,1,900
9611843@N04,5562,13,1328332615,1328333695,2,2,1080
9611843@N04,5562,17,1328346441,1328349141,1,2,2700
9611843@N04,5563,1,1328506474,1328506714,1,1,240
9611843@N04,5564,7,1328577216,1328578056,1,1,840
9611843@N04,5565,4,1330864197,1330864557,1,1,360
9611843@N04,5566,11,1350110274,1350111234,1,1,960
9611843@N04,5567,3,1350513172,1350513502,1,1,330
96128002@N00,5568,15,1225151292,1225151373,2,2,81
96128002@N00,5568,13,1225151373,1225152453,1,2,1080
96129398@N05,5569,11,1456038483,1456039443,1,1,960
96196973@N02,5570,11,1363919096,1363920056,2,3,960
96196973@N02,5570,17,1363921945,1363922250,2,3,305
96196973@N02,5570,15,1363922250,1363923450,1,3,1200
9621505@N08,5571,10,1411111433,1411112333,2,2,900
9621505@N08,5571,11,1411119730,1411120690,3,2,960
96258832@N08,5572,10,1457676852,1457677148,2,4,296
96258832@N08,5572,17,1457677148,1457677554,3,4,406
96258832@N08,5572,13,1457677554,1457678634,3,4,1080
96258832@N08,5572,5,1457680769,1457681189,1,4,420
96274088@N05,5573,10,1356145860,1356146760,2,1,900
96274088@N05,5574,1,1356414616,1356414856,2,3,240
96274088@N05,5574,13,1356424524,1356425604,2,3,1080
96274088@N05,5574,17,1356426101,1356428801,7,3,2700
96274088@N05,5575,6,1356480719,1356481439,2,3,720
96274088@N05,5575,11,1356509467,1356510427,3,3,960
96274088@N05,5575,13,1356514904,1356515984,2,3,1080
96312503@N08,5576,11,1369738278,1369739238,1,1,960
96312503@N08,5577,17,1382523014,1382525714,1,1,2700
96312503@N08,5578,4,1382861609,1382861969,2,2,360
96312503@N08,5578,11,1382873657,1382874617,1,2,960
96312503@N08,5579,10,1401107331,1401108231,1,1,900
96331620@N03,5580,10,1328332753,1328333653,2,1,900
96331620@N03,5581,17,1328517252,1328519952,2,1,2700
96333180@N05,5582,11,1269650208,1269651168,1,1,960
9639902@N04,5583,5,1240448293,1240448713,1,1,420
9639902@N04,5584,11,1240626496,1240627456,3,3,960
9639902@N04,5584,13,1240629924,1240631004,2,3,1080
9639902@N04,5584,10,1240635224,1240636124,1,3,900
96402848@N00,5585,11,1301562471,1301563431,1,1,960
96430093@N05,5586,15,1370158967,1370160167,1,1,1200
96430093@N05,5587,15,1370258866,1370260066,1,1,1200
96430093@N05,5588,15,1370342027,1370343227,1,1,1200
96430093@N05,5589,13,1372559027,1372560107,1,1,1080
96430093@N05,5590,8,1380170289,1380171129,1,1,840
96430093@N05,5591,8,1380239720,1380240560,1,1,840
96430093@N05,5592,17,1382484945,1382487645,3,2,2700
96430093@N05,5592,13,1382488629,1382489709,2,2,1080
96430093@N05,5593,13,1382566020,1382567100,2,2,1080
96430093@N05,5593,1,1382589958,1382590198,1,2,240
96430093@N05,5594,7,1382762139,1382762979,3,1,840
96430093@N05,5595,15,1390011570,1390012770,1,1,1200
96430093@N05,5596,8,1391639654,1391640494,1,1,840
96430093@N05,5597,9,1395005761,1395006661,4,2,900
96430093@N05,5597,2,1395020479,1395020719,2,2,240
96430093@N05,5598,13,1395104693,1395105773,2,2,1080
96430093@N05,5598,5,1395128688,1395129108,1,2,420
96430093@N05,5599,3,1395278403,1395278733,2,1,330
96430093@N05,5600,5,1395359722,1395360142,3,2,420
96430093@N05,5600,9,1395365401,1395366301,2,2,900
96430093@N05,5601,5,1395615869,1395616289,2,2,420
96430093@N05,5601,13,1395620222,1395621302,1,2,1080
96430093@N05,5602,3,1401332950,1401333280,2,1,330
96430093@N05,5603,5,1401773616,1401774036,1,1,420
96430093@N05,5604,13,1405745534,1405746614,1,1,1080
96430093@N05,5605,13,1411001200,1411002280,2,1,1080
96430093@N05,5606,9,1411100203,1411101103,1,1,900
96430093@N05,5607,5,1411338777,1411339197,2,2,420
96430093@N05,5607,13,1411354015,1411355095,1,2,1080
96430093@N05,5608,13,1412223771,1412224851,1,1,1080
96430093@N05,5609,9,1412645104,1412646004,2,1,900
96430093@N05,5610,9,1413253813,1413254713,1,1,900
96430093@N05,5611,3,1414452701,1414453031,3,2,330
96430093@N05,5611,13,1414481922,1414483002,1,2,1080
96430093@N05,5612,9,1414535354,1414536254,2,4,900
96430093@N05,5612,5,1414538611,1414539031,3,4,420
96430093@N05,5612,16,1414552632,1414554732,3,4,2100
96430093@N05,5612,5,1414557154,1414557574,2,4,420
96430093@N05,5613,5,1415059325,1415059745,2,1,420
96430093@N05,5614,1,1425593582,1425593822,2,2,240
96430093@N05,5614,13,1425597901,1425598981,3,2,1080
96430093@N05,5615,5,1429160739,1429161159,2,1,420
96430093@N05,5616,17,1430001240,1430003940,4,1,2700
96430093@N05,5617,13,1430357387,1430358467,2,2,1080
96430093@N05,5617,5,1430363494,1430363914,2,2,420
96430093@N05,5618,17,1433466929,1433469629,2,1,2700
96430093@N05,5619,17,1437534509,1437537209,1,1,2700
96430093@N05,5620,3,1453874063,1453874393,2,1,330
96430093@N05,5621,11,1456434403,1456435363,3,1,960
96430093@N05,5622,11,1456793426,1456794386,3,1,960
96430093@N05,5623,11,1457386584,1457387544,1,1,960
96430093@N05,5624,13,1459207615,1459208695,2,1,1080
96430093@N05,5625,13,1459758710,1459759790,1,1,1080
96430093@N05,5626,17,1460160997,1460163697,1,1,2700
96430093@N05,5627,13,1460764378,1460765458,5,1,1080
96430093@N05,5628,3,1461448055,1461448385,1,1,330
96430093@N05,5629,4,1463955488,1463955848,2,3,360
96430093@N05,5629,8,1463965735,1463966575,2,3,840
96430093@N05,5629,13,1463974886,1463975966,2,3,1080
9644199@N02,5630,16,1214924154,1214924778,4,3,624
9644199@N02,5630,10,1214924778,1214925162,2,3,384
9644199@N02,5630,8,1214925162,1214926002,3,3,840
9644199@N02,5631,13,1227710369,1227711449,3,2,1080
9644199@N02,5631,1,1227715786,1227716026,1,2,240
9644199@N02,5632,13,1227789329,1227790409,2,2,1080
9644199@N02,5632,10,1227808706,1227809606,3,2,900
9644199@N02,5633,11,1230058829,1230059789,5,1,960
9644199@N02,5634,6,1310001705,1310002425,1,1,720
9644199@N02,5635,17,1337571628,1337571629,2,3,1
9644199@N02,5635,13,1337571629,1337571629,2,3,0
9644199@N02,5635,17,1337571629,1337574329,1,3,2700
9644199@N02,5636,8,1339800323,1339800759,2,3,436
9644199@N02,5636,5,1339800759,1339801179,2,3,420
9644199@N02,5636,11,1339801570,1339802530,1,3,960
9644199@N02,5637,11,1389768727,1389768837,3,2,110
9644199@N02,5637,8,1389768837,1389769677,2,2,840
9644199@N02,5638,11,1392448279,1392449239,1,1,960
96466494@N00,5639,9,1470652204,1470653104,1,1,900
96525092@N00,5640,16,1191188753,1191190853,4,1,2100
96525092@N00,5641,1,1191247875,1191248115,2,2,240
96525092@N00,5641,16,1191250318,1191252418,11,2,2100
96525092@N00,5642,16,1195178683,1195180783,1,1,2100
96525092@N00,5643,16,1195985922,1195988022,1,1,2100
96525092@N00,5644,8,1197681725,1197682565,1,1,840
96525092@N00,5645,16,1205496675,1205498775,1,1,2100
96525092@N00,5646,6,1220010784,1220011504,1,1,720
96525092@N00,5647,4,1222554571,1222554931,1,1,360
96525092@N00,5648,11,1236595404,1236596364,1,1,960
96525092@N00,5649,16,1254437966,1254440066,2,2,2100
96525092@N00,5649,8,1254446756,1254447596,1,2,840
96525092@N00,5650,16,1254527093,1254529193,3,4,2100
96525092@N00,5650,13,1254534184,1254535264,2,4,1080
96525092@N00,5650,17,1254547344,1254550044,2,4,2700
96525092@N00,5650,11,1254570477,1254571437,3,4,960
96525092@N00,5651,8,1255702530,1255703370,1,1,840
96525092@N00,5652,8,1255812751,1255813591,1,1,840
96525092@N00,5653,11,1257398746,1257399706,1,1,960
96525092@N00,5654,4,1257548503,1257548863,2,2,360
96525092@N00,5654,11,1257567483,1257568443,1,2,960
96525092@N00,5655,13,1258451931,1258453011,1,1,1080
96525092@N00,5656,4,1263217671,1263218031,1,1,360
96525092@N00,5657,9,1263989040,1263989940,1,1,900
96525092@N00,5658,8,1267757845,1267758685,4,2,840
96525092@N00,5658,17,1267774029,1267776729,1,2,2700
96525092@N00,5659,15,1289130423,1289131623,1,1,1200
96525092@N00,5660,11,1320705590,1320706550,2,3,960
96525092@N00,5660,7,1320708093,1320708902,2,3,809
96525092@N00,5660,3,1320708902,1320709232,1,3,330
96525092@N00,5661,11,1352155016,1352155976,1,1,960
9653109@N04,5662,11,1252495810,1252496770,1,1,960
9653109@N04,5663,4,1277368239,1277368599,1,1,360
9653109@N04,5664,16,1285128019,1285130119,1,1,2100
9653109@N04,5665,1,1285748190,1285748430,2,3,240
9653109@N04,5665,5,1285750014,1285750434,2,3,420
9653109@N04,5665,8,1285752409,1285753249,2,3,840
96548081@N07,5666,11,1460572407,1460573367,2,1,960
96548081@N07,5667,8,1460603487,1460604327,1,1,840
96559463@N00,5668,8,1268885191,1268886031,2,2,840
96559463@N00,5668,11,1268905021,1268905981,1,2,960
96618039@N00,5669,10,1329308795,1329309695,1,1,900
96628420@N00,5670,11,1194992755,1194993715,9,3,960
96628420@N00,5670,10,1195005969,1195006869,8,3,900
96628420@N00,5670,11,1195017963,1195018923,11,3,960
9663436@N03,5671,8,1396129658,1396129929,4,10,271
9663436@N03,5671,5,1396129929,1396130349,2,10,420
9663436@N03,5671,10,1396141789,1396142220,5,10,431
9663436@N03,5671,17,1396142220,1396142821,5,10,601
9663436@N03,5671,15,1396142821,1396142853,2,10,32
9663436@N03,5671,17,1396142853,1396142945,7,10,92
9663436@N03,5671,15,1396142945,1396142959,2,10,14
9663436@N03,5671,17,1396142959,1396142968,2,10,9
9663436@N03,5671,15,1396142968,1396143164,4,10,196
9663436@N03,5671,13,1396143164,1396144244,5,10,1080
9664341@N05,5672,8,1215156744,1215157584,2,1,840
96678288@N02,5673,11,1370496182,1370497142,2,1,960
96678288@N02,5674,11,1377678702,1377678745,2,4,43
96678288@N02,5674,9,1377678745,1377679645,3,4,900
96678288@N02,5674,1,1377681438,1377681678,14,4,240
96678288@N02,5674,5,1377683894,1377684314,3,4,420
96678288@N02,5675,13,1380970357,1380970733,7,4,376
96678288@N02,5675,17,1380970733,1380971261,14,4,528
96678288@N02,5675,10,1380971261,1380972161,2,4,900
96678288@N02,5675,11,1380974638,1380975598,13,4,960
96678288@N02,5676,11,1382511445,1382512405,8,5,960
96678288@N02,5676,1,1382513921,1382514161,14,5,240
96678288@N02,5676,3,1382515627,1382515957,3,5,330
96678288@N02,5676,1,1382516194,1382516434,4,5,240
96678288@N02,5676,6,1382518144,1382518864,17,5,720
96678288@N02,5677,11,1386745802,1386746762,2,3,960
96678288@N02,5677,7,1386755677,1386756517,6,3,840
96678288@N02,5677,11,1386760274,1386761234,1,3,960
96678288@N02,5678,6,1386828518,1386829238,3,2,720
96678288@N02,5678,11,1386835837,1386836797,3,2,960
96678288@N02,5679,6,1388210889,1388211609,14,7,720
96678288@N02,5679,8,1388217664,1388218504,2,7,840
96678288@N02,5679,16,1388219430,1388220357,2,7,927
96678288@N02,5679,11,1388220357,1388221317,2,7,960
96678288@N02,5679,1,1388228329,1388228569,5,7,240
96678288@N02,5679,5,1388230961,1388231381,3,7,420
96678288@N02,5679,11,1388232215,1388233175,3,7,960
96678288@N02,5680,15,1392796190,1392796970,4,6,780
96678288@N02,5680,17,1392796970,1392797081,2,6,111
96678288@N02,5680,15,1392797081,1392797326,6,6,245
96678288@N02,5680,13,1392797326,1392798406,23,6,1080
96678288@N02,5680,3,1392802680,1392803010,6,6,330
96678288@N02,5680,11,1392805757,1392806717,1,6,960
96678288@N02,5681,11,1395386508,1395387468,10,4,960
96678288@N02,5681,13,1395396129,1395397209,9,4,1080
96678288@N02,5681,17,1395397617,1395397634,2,4,17
96678288@N02,5681,10,1395397634,1395398534,2,4,900
96678288@N02,5682,1,1397292049,1397292289,2,3,240
96678288@N02,5682,15,1397294869,1397295384,2,3,515
96678288@N02,5682,13,1397295384,1397296464,1,3,1080
96678288@N02,5683,8,1410944075,1410944915,5,1,840
96678288@N02,5684,1,1419749865,1419750105,2,2,240
96678288@N02,5684,4,1419763788,1419764148,1,2,360
96678288@N02,5685,13,1425459159,1425460239,2,2,1080
96678288@N02,5685,8,1425466177,1425467017,1,2,840
96678288@N02,5686,11,1429692248,1429693208,1,1,960
96678288@N02,5687,2,1441970632,1441970872,1,1,240
96678288@N02,5688,11,1450430310,1450431270,1,1,960
96678288@N02,5689,4,1454302823,1454303183,3,2,360
96678288@N02,5689,11,1454307248,1454308208,3,2,960
96678288@N02,5690,11,1456114500,1456114609,2,6,109
96678288@N02,5690,1,1456114609,1456114849,3,6,240
96678288@N02,5690,5,1456127177,1456127597,2,6,420
96678288@N02,5690,11,1456128020,1456128980,2,6,960
96678288@N02,5690,1,1456135711,1456135951,2,6,240
96678288@N02,5690,11,1456136001,1456136961,2,6,960
96678288@N02,5691,11,1458532591,1458533551,2,3,960
96678288@N02,5691,8,1458543976,1458544816,2,3,840
96678288@N02,5691,11,1458554583,1458555543,1,3,960
96678288@N02,5692,11,1461042464,1461043424,4,1,960
96678288@N02,5693,2,1464069343,1464069583,2,2,240
96678288@N02,5693,11,1464070755,1464071715,1,2,960
96678288@N02,5694,11,1465880359,1465880972,2,3,613
96678288@N02,5694,3,1465880972,1465881302,2,3,330
96678288@N02,5694,11,1465882780,1465883740,2,3,960
96678288@N02,5695,3,1466484662,1466484992,3,2,330
96678288@N02,5695,11,1466492134,1466493094,1,2,960
96678288@N02,5696,11,1467597639,1467598599,4,1,960
96678288@N02,5697,1,1468902486,1468902726,2,3,240
96678288@N02,5697,11,1468909265,1468910225,7,3,960
96678288@N02,5697,1,1468930566,1468930806,2,3,240
96801778@N00,5698,16,1382670008,1382670414,2,6,406
96801778@N00,5698,11,1382670414,1382671374,2,6,960
96801778@N00,5698,5,1382676099,1382676519,2,6,420
96801778@N00,5698,15,1382688304,1382689504,2,6,1200
96801778@N00,5698,2,1382690711,1382690951,2,6,240
96801778@N00,5698,11,1382697775,1382698735,1,6,960
96882800@N08,5699,10,1275026576,1275027476,1,1,900
96889906@N00,5700,11,1270639544,1270640504,2,3,960
96889906@N00,5700,8,1270640822,1270641617,2,3,795
96889906@N00,5700,11,1270641617,1270642577,1,3,960
96899238@N00,5701,8,1451524732,1451525572,16,1,840
96913191@N00,5702,11,1299747499,1299748459,3,1,960
96913191@N00,5703,8,1329900891,1329901731,1,1,840
96926231@N00,5704,11,1341210973,1341211933,2,1,960
96991828@N07,5705,17,1324614627,1324617327,2,1,2700
97019381@N00,5706,5,1217839504,1217839924,8,3,420
97019381@N00,5706,8,1217846979,1217847819,2,3,840
97019381@N00,5706,11,1217866354,1217867314,1,3,960
97023479@N08,5707,11,1444082687,1444083647,2,7,960
97023479@N08,5707,2,1444086867,1444087107,3,7,240
97023479@N08,5707,9,1444100755,1444101655,2,7,900
97023479@N08,5707,10,1444107121,1444107729,2,7,608
97023479@N08,5707,17,1444107729,1444110429,2,7,2700
97023479@N08,5707,8,1444117895,1444118735,2,7,840
97023479@N08,5707,11,1444127187,1444128147,1,7,960
97064780@N06,5708,8,1426653780,1426654620,9,1,840
9708101@N02,5709,2,1219303603,1219303843,3,1,240
9708101@N02,5710,11,1219391168,1219392128,1,1,960
97108343@N06,5711,17,1433469748,1433470540,6,2,792
97108343@N06,5711,15,1433470540,1433471740,4,2,1200
97137858@N00,5712,11,1261553214,1261554174,4,10,960
97137858@N00,5712,3,1261554772,1261555102,2,10,330
97137858@N00,5712,12,1261557749,1261558769,4,10,1020
97137858@N00,5712,10,1261563310,1261563477,2,10,167
97137858@N00,5712,17,1261563477,1261564037,5,10,560
97137858@N00,5712,15,1261564037,1261564214,3,10,177
97137858@N00,5712,13,1261564214,1261565294,5,10,1080
97137858@N00,5712,8,1261571009,1261571849,4,10,840
97137858@N00,5712,5,1261573498,1261573918,3,10,420
97137858@N00,5712,13,1261578437,1261579517,1,10,1080
97174119@N07,5713,3,1405824276,1405824606,2,5,330
97174119@N07,5713,16,1405825326,1405827366,2,5,2040
97174119@N07,5713,9,1405827366,1405827677,2,5,311
97174119@N07,5713,1,1405827677,1405827917,3,5,240
97174119@N07,5713,11,1405847472,1405848432,1,5,960
97316061@N05,5714,11,1426722141,1426723101,3,5,960
97316061@N05,5714,10,1426724052,1426724952,2,5,900
97316061@N05,5714,17,1426726417,1426727295,2,5,878
97316061@N05,5714,13,1426727295,1426728375,2,5,1080
97316061@N05,5714,8,1426736647,1426737487,1,5,840
97321472@N00,5715,11,1308308019,1308308979,1,1,960
97408089@N00,5716,11,1362863222,1362864182,3,2,960
97408089@N00,5716,1,1362864879,1362865119,6,2,240
97413516@N00,5717,17,1286939893,1286942593,1,1,2700
97477255@N00,5718,13,1359784708,1359785788,3,1,1080
97477255@N00,5719,9,1423020107,1423021007,2,6,900
97477255@N00,5719,3,1423023714,1423024044,2,6,330
97477255@N00,5719,17,1423035270,1423036491,3,6,1221
97477255@N00,5719,8,1423036491,1423037331,7,6,840
97477255@N00,5719,5,1423046899,1423047319,15,6,420
97477255@N00,5719,11,1423053364,1423054324,3,6,960
97477255@N00,5720,4,1423610044,1423610404,4,4,360
97477255@N00,5720,2,1423615288,1423615528,3,4,240
97477255@N00,5720,9,1423621262,1423622162,3,4,900
97477255@N00,5720,10,1423640904,1423641804,2,4,900
97486802@N08,5721,15,1310708197,1310709397,1,1,1200
97489023@N00,5722,11,1323073963,1323074923,1,1,960
97543060@N07,5723,11,1357851600,1357852560,5,1,960
97543060@N07,5724,11,1357945200,1357946160,11,1,960
97543060@N07,5725,11,1358042400,1358043360,9,1,960
97550352@N08,5726,11,1381612312,1381613272,1,1,960
97550352@N08,5727,11,1387582675,1387583635,1,1,960
97580930@N04,5728,11,1469375642,1469376602,1,1,960
97721343@N08,5729,16,1420156699,1420158799,2,2,2100
97721343@N08,5729,15,1420164737,1420165937,4,2,1200
97721343@N08,5730,11,1439103350,1439104310,1,1,960
9774336@N08,5731,11,1286680631,1286681591,1,1,960
97790328@N02,5732,11,1469438920,1469439880,1,1,960
97838235@N00,5733,3,1381182855,1381183185,2,5,330
97838235@N00,5733,6,1381184580,1381185300,2,5,720
97838235@N00,5733,8,1381194649,1381195489,2,5,840
97838235@N00,5733,17,1381216999,1381219699,2,5,2700
97838235@N00,5733,11,1381224525,1381225485,2,5,960
97838235@N00,5734,4,1381274250,1381274610,7,2,360
97838235@N00,5734,13,1381284094,1381285174,3,2,1080
9790304@N07,5735,11,1363817196,1363818156,3,6,960
9790304@N07,5735,12,1363820190,1363821210,2,6,1020
9790304@N07,5735,1,1363827023,1363827132,2,6,109
9790304@N07,5735,9,1363827132,1363828032,3,6,900
9790304@N07,5735,8,1363852780,1363853620,2,6,840
9790304@N07,5735,5,1363854613,1363855033,2,6,420
97964364@N00,5736,11,1191710591,1191711551,2,2,960
97964364@N00,5736,15,1191730248,1191731448,2,2,1200
98052801@N03,5737,11,1418030446,1418031406,1,1,960
98066314@N07,5738,11,1361754431,1361755391,3,1,960
98109106@N00,5739,11,1246327515,1246328066,3,6,551
98109106@N00,5739,5,1246328066,1246328486,4,6,420
98109106@N00,5739,16,1246336940,1246338969,2,6,2029
98109106@N00,5739,11,1246338969,1246339392,2,6,423
98109106@N00,5739,2,1246339392,1246339632,2,6,240
98109106@N00,5739,5,1246346242,1246346662,2,6,420
98109106@N00,5740,8,1247065208,1247066048,13,1,840
98109106@N00,5741,11,1247115912,1247116872,2,9,960
98109106@N00,5741,7,1247117168,1247118008,2,9,840
98109106@N00,5741,14,1247120120,1247120513,2,9,393
98109106@N00,5741,7,1247120513,1247121348,2,9,835
98109106@N00,5741,2,1247121348,1247121588,6,9,240
98109106@N00,5741,11,1247127521,1247128481,2,9,960
98109106@N00,5741,8,1247132865,1247133705,8,9,840
98109106@N00,5741,4,1247141887,1247142247,3,9,360
98109106@N00,5741,17,1247152682,1247155382,4,9,2700
9813050@N08,5742,15,1257065841,1257067041,11,1,1200
9813050@N08,5743,11,1257149464,1257150424,12,2,960
9813050@N08,5743,8,1257152087,1257152927,25,2,840
9813050@N08,5744,11,1257221249,1257221589,10,5,340
9813050@N08,5744,7,1257221589,1257222429,69,5,840
9813050@N08,5744,12,1257225211,1257226231,28,5,1020
9813050@N08,5744,4,1257227319,1257227679,10,5,360
9813050@N08,5744,9,1257228965,1257229865,5,5,900
9813050@N08,5745,11,1257329736,1257330139,3,5,403
9813050@N08,5745,1,1257330139,1257330379,19,5,240
9813050@N08,5745,10,1257333328,1257334228,5,5,900
9813050@N08,5745,13,1257334916,1257335996,3,5,1080
9813050@N08,5745,8,1257336000,1257336840,11,5,840
9813050@N08,5746,8,1257390923,1257391436,2,7,513
9813050@N08,5746,16,1257391436,1257393536,4,7,2100
9813050@N08,5746,11,1257398823,1257398835,2,7,12
9813050@N08,5746,7,1257398835,1257399675,11,7,840
9813050@N08,5746,12,1257400655,1257401165,3,7,510
9813050@N08,5746,8,1257401165,1257402005,47,7,840
9813050@N08,5746,13,1257404445,1257405525,13,7,1080
98153629@N00,5747,11,1321653035,1321653995,2,14,960
98153629@N00,5747,1,1321654040,1321654280,3,14,240
98153629@N00,5747,9,1321654577,1321655477,2,14,900
98153629@N00,5747,14,1321656449,1321657649,6,14,1200
98153629@N00,5747,12,1321657953,1321658973,3,14,1020
98153629@N00,5747,11,1321667303,1321668263,3,14,960
98153629@N00,5747,5,1321673010,1321673430,5,14,420
98153629@N00,5747,8,1321674771,1321675611,4,14,840
98153629@N00,5747,10,1321687300,1321688200,3,14,900
98153629@N00,5747,11,1321688606,1321689566,2,14,960
98153629@N00,5747,5,1321692666,1321692931,2,14,265
98153629@N00,5747,8,1321692931,1321693771,2,14,840
98153629@N00,5747,13,1321694396,1321695241,3,14,845
98153629@N00,5747,17,1321695241,1321697941,15,14,2700
9820882@N06,5748,4,1347062262,1347062622,1,1,360
98223232@N00,5749,6,1255420767,1255421487,7,1,720
98223232@N00,5750,11,1255511940,1255512900,2,1,960
98223232@N00,5751,15,1255653403,1255654603,6,1,1200
98224622@N00,5752,5,1348546118,1348546538,2,2,420
98224622@N00,5752,10,1348561265,1348562165,1,2,900
98278617@N06,5753,11,1397877973,1397878933,6,1,960
98297562@N04,5754,11,1395299404,1395300364,1,1,960
98305332@N00,5755,11,1189403150,1189404110,2,1,960
98326469@N00,5756,11,1428570523,1428571483,1,1,960
9838181@N04,5757,8,1439628066,1439628906,1,1,840
98387918@N07,5758,11,1417068339,1417069299,2,1,960
98388332@N00,5759,4,1338076486,1338076846,24,11,360
98388332@N00,5759,5,1338094463,1338094883,3,11,420
98388332@N00,5759,8,1338097135,1338097975,5,11,840
98388332@N00,5759,13,1338109238,1338110318,7,11,1080
98388332@N00,5759,17,1338112463,1338112906,5,11,443
98388332@N00,5759,10,1338112906,1338113806,3,11,900
98388332@N00,5759,17,1338116504,1338117777,26,11,1273
98388332@N00,5759,10,1338117777,1338118677,3,11,900
98388332@N00,5759,11,1338118707,1338119093,2,11,386
98388332@N00,5759,2,1338119093,1338119168,2,11,75
98388332@N00,5759,11,1338119168,1338120128,1,11,960
98438392@N04,5760,11,1337058187,1337059147,1,1,960
98474523@N00,5761,11,1322707088,1322708048,6,2,960
98474523@N00,5761,5,1322711407,1322711827,3,2,420
98474523@N00,5762,11,1322863187,1322864147,4,7,960
98474523@N00,5762,3,1322864312,1322864642,6,7,330
98474523@N00,5762,2,1322868969,1322869209,2,7,240
98474523@N00,5762,3,1322869403,1322869733,6,7,330
98474523@N00,5762,5,1322875833,1322876253,2,7,420
98474523@N00,5762,11,1322889184,1322890144,6,7,960
98474523@N00,5762,8,1322899208,1322900048,2,7,840
98474523@N00,5763,11,1323129963,1323130923,2,3,960
98474523@N00,5763,4,1323133315,1323133675,2,3,360
98474523@N00,5763,9,1323142329,1323143229,1,3,900
98474523@N00,5764,3,1323209037,1323209367,5,4,330
98474523@N00,5764,9,1323212112,1323213012,6,4,900
98474523@N00,5764,2,1323214018,1323214258,5,4,240
98474523@N00,5764,11,1323223518,1323224478,2,4,960
98497282@N00,5765,12,1370217869,1370218889,2,2,1020
98497282@N00,5765,17,1370227667,1370230367,1,2,2700
9858951@N03,5766,11,1274255312,1274256272,9,1,960
9860213@N08,5767,4,1342919236,1342919596,1,1,360
9860213@N08,5768,8,1343273253,1343274093,1,1,840
9860213@N08,5769,5,1441592426,1441592846,4,4,420
9860213@N08,5769,17,1441604523,1441607223,4,4,2700
9860213@N08,5769,16,1441609488,1441611588,2,4,2100
9860213@N08,5769,11,1441618352,1441619312,4,4,960
98657360@N02,5770,2,1375139600,1375139840,1,1,240
98676873@N07,5771,17,1388472991,1388475691,2,1,2700
98676873@N07,5772,13,1388567682,1388568762,1,1,1080
98767429@N00,5773,11,1197319802,1197320762,3,6,960
98767429@N00,5773,2,1197321336,1197321576,17,6,240
98767429@N00,5773,1,1197340858,1197341098,5,6,240
98767429@N00,5773,8,1197341505,1197342345,5,6,840
98767429@N00,5773,17,1197354585,1197357285,3,6,2700
98767429@N00,5773,11,1197360574,1197361534,6,6,960
98801696@N02,5774,11,1423003988,1423004948,1,1,960
98801696@N02,5775,8,1423362724,1423363564,1,1,840
98801696@N02,5776,10,1458529366,1458530266,2,1,900
98840716@N08,5777,8,1426231416,1426232256,1,1,840
98847194@N02,5778,15,1377073994,1377075194,2,2,1200
98847194@N02,5778,1,1377078449,1377078689,1,2,240
98870304@N08,5779,5,1374919716,1374920136,3,1,420
98870304@N08,5780,11,1401337733,1401338693,1,1,960
98876406@N00,5781,11,1356667503,1356668463,1,1,960
98889314@N02,5782,7,1403742830,1403743670,4,15,840
98889314@N02,5782,2,1403745628,1403745868,2,15,240
98889314@N02,5782,10,1403745893,1403746016,7,15,123
98889314@N02,5782,17,1403746016,1403746246,6,15,230
98889314@N02,5782,15,1403746246,1403746404,5,15,158
98889314@N02,5782,13,1403746404,1403747484,3,15,1080
98889314@N02,5782,8,1403752437,1403752689,3,15,252
98889314@N02,5782,5,1403752689,1403753109,6,15,420
98889314@N02,5782,1,1403753501,1403753741,12,15,240
98889314@N02,5782,16,1403756616,1403758716,6,15,2100
98889314@N02,5782,13,1403758810,1403759620,7,15,810
98889314@N02,5782,17,1403759620,1403759731,5,15,111
98889314@N02,5782,10,1403759731,1403760002,3,15,271
98889314@N02,5782,5,1403760002,1403760422,6,15,420
98889314@N02,5782,11,1403761010,1403761970,2,15,960
99015631@N00,5783,11,1370840439,1370841399,1,1,960
9907136@N02,5784,9,1333768710,1333769610,1,1,900
99119735@N06,5785,11,1382743474,1382744434,2,7,960
99119735@N06,5785,2,1382745077,1382745317,4,7,240
99119735@N06,5785,5,1382749456,1382749876,3,7,420
99119735@N06,5785,8,1382755024,1382755864,2,7,840
99119735@N06,5785,15,1382775625,1382776825,2,7,1200
99119735@N06,5785,11,1382777149,1382778109,2,7,960
99119735@N06,5785,5,1382782693,1382783113,1,7,420
99119735@N06,5786,11,1383293741,1383294701,1,1,960
99129452@N08,5787,11,1421826445,1421827405,1,1,960
99146615@N07,5788,11,1384166507,1384167467,1,1,960
99183660@N06,5789,10,1417631722,1417632622,1,1,900
99199321@N07,5790,15,1420934422,1420935622,1,1,1200
99219204@N00,5791,10,1359083088,1359083988,2,3,900
99219204@N00,5791,11,1359097232,1359098192,2,3,960
99219204@N00,5791,7,1359100565,1359101405,1,3,840
9926279@N03,5792,17,1460677080,1460677323,4,6,243
9926279@N03,5792,15,1460677323,1460677838,3,6,515
9926279@N03,5792,13,1460677838,1460678704,2,6,866
9926279@N03,5792,5,1460678704,1460679124,2,6,420
9926279@N03,5792,17,1460683118,1460685818,2,6,2700
9926279@N03,5792,8,1460687862,1460688702,3,6,840
99385068@N00,5793,5,1258968376,1258968796,1,1,420
99385068@N00,5794,5,1259040313,1259040733,1,1,420
99385068@N00,5795,8,1259211060,1259211900,2,1,840
99385068@N00,5796,2,1383455309,1383455549,4,1,240
99385068@N00,5797,2,1383608201,1383608441,8,4,240
99385068@N00,5797,3,1383611193,1383611523,2,4,330
99385068@N00,5797,5,1383628863,1383629283,5,4,420
99385068@N00,5797,17,1383643503,1383646203,1,4,2700
99385068@N00,5798,5,1383816656,1383817076,20,1,420
99422834@N05,5799,13,1331703527,1331704607,7,1,1080
99467063@N06,5800,6,1376103445,1376104165,3,3,720
99467063@N06,5800,17,1376105608,1376108308,2,3,2700
99467063@N06,5800,1,1376125062,1376125302,1,3,240
99471343@N00,5801,17,1365980535,1365983235,3,5,2700
99471343@N00,5801,14,1365983852,1365985052,2,5,1200
99471343@N00,5801,2,1365986968,1365987208,4,5,240
99471343@N00,5801,5,1365998493,1365998913,2,5,420
99471343@N00,5801,13,1366014310,1366015390,1,5,1080
99471343@N00,5802,17,1366326216,1366326336,2,5,120
99471343@N00,5802,10,1366326336,1366327236,2,5,900
99471343@N00,5802,11,1366327571,1366328531,2,5,960
99471343@N00,5802,13,1366338417,1366339497,5,5,1080
99471343@N00,5802,11,1366349894,1366350854,1,5,960
99502551@N08,5803,5,1406010482,1406010902,3,3,420
99502551@N08,5803,1,1406014190,1406014430,2,3,240
99502551@N08,5803,11,1406015076,1406016036,1,3,960
99502551@N08,5804,13,1406187013,1406188093,2,6,1080
99502551@N08,5804,17,1406189174,1406189317,2,6,143
99502551@N08,5804,10,1406189317,1406190217,3,6,900
99502551@N08,5804,3,1406191849,1406192179,4,6,330
99502551@N08,5804,2,1406194028,1406194268,2,6,240
99502551@N08,5804,17,1406221676,1406224376,1,6,2700
99502551@N08,5805,11,1406939554,1406940514,1,1,960
99519033@N04,5806,14,1291934953,1291936153,1,1,1200
99519033@N04,5807,11,1301563304,1301564264,1,1,960
99544917@N00,5808,3,1406494650,1406494980,3,5,330
99544917@N00,5808,10,1406502152,1406503052,2,5,900
99544917@N00,5808,5,1406506249,1406506669,2,5,420
99544917@N00,5808,8,1406507194,1406508034,3,5,840
99544917@N00,5808,13,1406514229,1406515309,1,5,1080
99555157@N07,5809,11,1452808629,1452809589,1,1,960
99698221@N00,5810,8,1352043843,1352044683,2,1,840
9977376@N05,5811,17,1382164538,1382167238,2,2,2700
9977376@N05,5811,10,1382178834,1382179734,1,2,900
9979792@N04,5812,13,1318205054,1318206134,4,2,1080
9979792@N04,5812,16,1318218769,1318220869,3,2,2100
99829373@N00,5813,2,1254007310,1254007550,3,1,240
9984610@N02,5814,4,1437130407,1437130767,3,1,360
9984610@N02,5815,4,1437955936,1437956296,1,1,360
99929871@N00,5816,9,1294702257,1294703157,2,2,900
99929871@N00,5816,11,1294708234,1294709194,2,2,960
