userID,trajID,poiID,startTime,endTime,#photo,trajLen,poiDuration
10004778@N07,1,6,1308262550,1308262670,2,2,120
10004778@N07,1,26,1308270702,1308271602,1,2,900
10004778@N07,2,6,1308631356,1308631476,1,1,120
10004778@N07,3,26,1355568624,1355569524,1,1,900
10004778@N07,4,29,1373030964,1373031864,1,1,900
10024109@N08,5,26,1283735402,1283736302,4,1,900
100373287@N02,6,28,1407459897,1407460054,5,11,157
100373287@N02,6,18,1407460054,1407460504,3,11,450
100373287@N02,6,20,1407460984,1407461026,2,11,42
100373287@N02,6,18,1407461026,1407461302,2,11,276
100373287@N02,6,26,1407461302,1407461671,2,11,369
100373287@N02,6,6,1407461671,1407461791,2,11,120
100373287@N02,6,3,1407461827,1407461917,3,11,90
100373287@N02,6,21,1407462056,1407462626,4,11,570
100373287@N02,6,30,1407463402,1407464482,3,11,1080
100373287@N02,6,24,1407472411,1407473191,4,11,780
100373287@N02,6,26,1407477601,1407478501,2,11,900
100432722@N02,7,30,1379584100,1379585180,4,1,1080
100432722@N02,8,26,1431822642,1431823542,1,1,900
100432722@N02,9,21,1440162999,1440163569,1,1,570
100432722@N02,10,26,1447828035,1447828935,2,1,900
100448554@N06,11,26,1356054155,1356055055,2,6,900
100448554@N06,11,13,1356057534,1356057774,3,6,240
100448554@N06,11,3,1356058289,1356058379,2,6,90
100448554@N06,11,29,1356064526,1356064531,2,6,5
100448554@N06,11,19,1356064531,1356065071,5,6,540
100448554@N06,11,20,1356066458,1356066998,2,6,540
100448554@N06,12,1,1356148029,1356148089,2,2,60
100448554@N06,12,20,1356176141,1356176681,1,2,540
10055157@N02,13,25,1357818322,1357819162,2,3,840
10055157@N02,13,29,1357819349,1357819661,2,3,312
10055157@N02,13,26,1357819661,1357820561,1,3,900
10055157@N02,14,26,1389172537,1389173437,1,1,900
10055157@N02,15,7,1400213093,1400213273,1,1,180
10055157@N02,16,3,1462847579,1462847669,2,2,90
10055157@N02,16,5,1462857781,1462857901,1,2,120
10055157@N02,17,5,1462947575,1462947695,1,1,120
10062483@N05,18,15,1219741081,1219741351,1,1,270
10062483@N05,19,25,1260255084,1260255924,2,2,840
10062483@N05,19,28,1260257114,1260258014,1,2,900
10062483@N05,20,12,1336354341,1336354581,2,1,240
10062483@N05,21,15,1348450174,1348450175,2,2,1
10062483@N05,21,28,1348450175,1348451075,1,2,900
100632664@N02,22,26,1466604771,1466605671,1,1,900
100822654@N07,23,27,1389213865,1389213878,2,13,13
100822654@N07,23,20,1389213878,1389213887,2,13,9
100822654@N07,23,14,1389213887,1389213960,2,13,73
100822654@N07,23,29,1389213960,1389213977,2,13,17
100822654@N07,23,18,1389213977,1389213987,2,13,10
100822654@N07,23,20,1389213987,1389214021,2,13,34
100822654@N07,23,14,1389214021,1389214031,2,13,10
100822654@N07,23,29,1389214031,1389214040,2,13,9
100822654@N07,23,30,1389214040,1389214080,2,13,40
100822654@N07,23,17,1389214080,1389214140,2,13,60
100822654@N07,23,14,1389214140,1389214380,2,13,240
100822654@N07,23,28,1389218195,1389218207,2,13,12
100822654@N07,23,1,1389218207,1389218267,1,13,60
10084893@N02,24,28,1207728112,1207729012,5,2,900
10084893@N02,24,27,1207731367,1207732267,1,2,900
10084893@N02,25,28,1208051831,1208052731,2,1,900
100939753@N04,26,27,1392960174,1392961074,1,1,900
101006095@N07,27,29,1379392716,1379393616,1,1,900
10104403@N00,28,10,1252651318,1252651558,44,1,240
10104403@N00,29,10,1252749467,1252749707,43,2,240
10104403@N00,29,29,1252758364,1252759264,10,2,900
10104403@N00,30,18,1446047022,1446047472,1,1,450
10104914@N07,31,28,1191396957,1191397107,2,2,150
10104914@N07,31,23,1191397107,1191397707,1,2,600
101055171@N03,32,1,1401576129,1401576189,5,17,60
101055171@N03,32,27,1401578962,1401579862,3,17,900
101055171@N03,32,21,1401580251,1401580821,2,17,570
101055171@N03,32,5,1401581109,1401581229,2,17,120
101055171@N03,32,8,1401581573,1401581753,2,17,180
101055171@N03,32,26,1401581906,1401582343,2,17,437
101055171@N03,32,1,1401582343,1401582403,2,17,60
101055171@N03,32,13,1401586727,1401586967,2,17,240
101055171@N03,32,21,1401590219,1401590789,7,17,570
101055171@N03,32,7,1401593786,1401593966,2,17,180
101055171@N03,32,29,1401596876,1401597658,3,17,782
101055171@N03,32,20,1401597658,1401598198,2,17,540
101055171@N03,32,14,1401601114,1401601354,2,17,240
101055171@N03,32,28,1401621266,1401622166,4,17,900
101055171@N03,32,16,1401622216,1401622222,8,17,6
101055171@N03,32,26,1401622222,1401622318,5,17,96
101055171@N03,32,16,1401622318,1401622588,12,17,270
101055171@N03,33,22,1403674849,1403674930,2,8,81
101055171@N03,33,25,1403674930,1403674943,2,8,13
101055171@N03,33,13,1403674943,1403674995,4,8,52
101055171@N03,33,5,1403674995,1403675015,2,8,20
101055171@N03,33,27,1403675015,1403675021,2,8,6
101055171@N03,33,26,1403675021,1403675040,3,8,19
101055171@N03,33,28,1403675040,1403675076,5,8,36
101055171@N03,33,1,1403675076,1403675136,3,8,60
10106605@N07,34,28,1338536422,1338537322,27,1,900
10106605@N07,35,15,1347419486,1347419756,2,4,270
10106605@N07,35,18,1347423143,1347423593,3,4,450
10106605@N07,35,28,1347425519,1347426419,3,4,900
10106605@N07,35,1,1347435538,1347435598,1,4,60
10106605@N07,36,20,1351653488,1351654028,3,5,540
10106605@N07,36,12,1351658756,1351658783,2,5,27
10106605@N07,36,15,1351658783,1351659053,5,5,270
10106605@N07,36,12,1351659875,1351660115,2,5,240
10106605@N07,36,13,1351660496,1351660736,10,5,240
10106605@N07,37,27,1358122555,1358123455,2,7,900
10106605@N07,37,30,1358124403,1358125483,14,7,1080
10106605@N07,37,31,1358129217,1358129461,2,7,244
10106605@N07,37,30,1358129461,1358130242,6,7,781
10106605@N07,37,29,1358130242,1358130569,2,7,327
10106605@N07,37,31,1358130569,1358131027,7,7,458
10106605@N07,37,30,1358131027,1358132107,2,7,1080
101075959@N06,38,28,1376178140,1376179040,3,35,900
101075959@N06,38,18,1376179097,1376179170,2,35,73
101075959@N06,38,19,1376179170,1376179204,2,35,34
101075959@N06,38,29,1376179204,1376179245,2,35,41
101075959@N06,38,19,1376179245,1376179274,2,35,29
101075959@N06,38,18,1376179274,1376179333,2,35,59
101075959@N06,38,19,1376179333,1376179516,3,35,183
101075959@N06,38,28,1376179516,1376179703,2,35,187
101075959@N06,38,23,1376179703,1376179771,2,35,68
101075959@N06,38,19,1376179771,1376179898,2,35,127
101075959@N06,38,23,1376179898,1376179995,3,35,97
101075959@N06,38,18,1376179995,1376180061,2,35,66
101075959@N06,38,19,1376180061,1376180203,2,35,142
101075959@N06,38,29,1376180203,1376181103,2,35,900
101075959@N06,38,28,1376181588,1376182488,3,35,900
101075959@N06,38,29,1376184390,1376184507,2,35,117
101075959@N06,38,20,1376184507,1376185047,2,35,540
101075959@N06,38,22,1376185320,1376185497,2,35,177
101075959@N06,38,14,1376185497,1376185737,2,35,240
101075959@N06,38,22,1376185929,1376186155,2,35,226
101075959@N06,38,29,1376186155,1376186526,5,35,371
101075959@N06,38,18,1376186526,1376186641,2,35,115
101075959@N06,38,28,1376186641,1376186988,2,35,347
101075959@N06,38,30,1376186988,1376187082,2,35,94
101075959@N06,38,29,1376187082,1376187184,3,35,102
101075959@N06,38,31,1376187184,1376188684,4,35,1500
101075959@N06,38,26,1376190729,1376190902,4,35,173
101075959@N06,38,16,1376190902,1376191172,2,35,270
101075959@N06,38,17,1376191557,1376191857,4,35,300
101075959@N06,38,12,1376196041,1376196281,2,35,240
101075959@N06,38,13,1376197129,1376197369,12,35,240
101075959@N06,38,15,1376198979,1376199249,3,35,270
101075959@N06,38,24,1376199686,1376200466,2,35,780
101075959@N06,38,21,1376201625,1376202195,17,35,570
101075959@N06,38,24,1376203546,1376204326,1,35,780
101200606@N03,39,1,1402019649,1402019709,1,1,60
101208631@N08,40,1,1381456540,1381456600,2,3,60
101208631@N08,40,28,1381456799,1381457699,2,3,900
101208631@N08,40,26,1381459199,1381460099,1,3,900
10129939@N08,41,1,1335659579,1335659639,2,3,60
10129939@N08,41,7,1335661871,1335662051,6,3,180
10129939@N08,41,13,1335670164,1335670404,3,3,240
10129939@N08,42,1,1335746882,1335746942,2,6,60
10129939@N08,42,15,1335747832,1335748102,6,6,270
10129939@N08,42,30,1335760009,1335761089,2,6,1080
10129939@N08,42,29,1335761924,1335762810,3,6,886
10129939@N08,42,16,1335762810,1335763080,2,6,270
10129939@N08,42,23,1335764441,1335765041,1,6,600
10129939@N08,43,31,1336109171,1336110665,2,5,1494
10129939@N08,43,1,1336110665,1336110725,6,5,60
10129939@N08,43,10,1336121219,1336121459,2,5,240
10129939@N08,43,14,1336122615,1336122855,3,5,240
10129939@N08,43,26,1336128680,1336129580,1,5,900
10129939@N08,44,8,1336367190,1336367370,1,1,180
101316071@N05,45,26,1396830761,1396831661,5,5,900
101316071@N05,45,17,1396833995,1396834295,3,5,300
101316071@N05,45,26,1396834490,1396835390,2,5,900
101316071@N05,45,14,1396843805,1396844045,2,5,240
101316071@N05,45,23,1396849660,1396850260,2,5,600
101334634@N07,46,1,1383998200,1383998260,1,1,60
101355699@N08,47,26,1407761349,1407762249,1,1,900
10136713@N00,48,27,1202716036,1202716936,2,3,900
10136713@N00,48,24,1202718639,1202719419,2,3,780
10136713@N00,48,23,1202725765,1202726365,2,3,600
10136713@N00,49,26,1202769754,1202770126,2,4,372
10136713@N00,49,9,1202770126,1202770306,2,4,180
10136713@N00,49,22,1202788480,1202789080,2,4,600
10136713@N00,49,29,1202795017,1202795917,1,4,900
10136713@N00,50,21,1202889498,1202890068,2,3,570
10136713@N00,50,28,1202892551,1202893005,2,3,454
10136713@N00,50,1,1202893005,1202893065,1,3,60
10136713@N00,51,26,1202941800,1202942700,1,1,900
10136713@N00,52,24,1202979369,1202980149,1,1,780
10136713@N00,53,12,1203037972,1203038212,1,1,240
101434518@N03,54,19,1369739428,1369739968,1,1,540
10143946@N07,55,26,1205975722,1205976622,1,1,900
101445497@N05,56,28,1419805836,1419806489,3,14,653
101445497@N05,56,26,1419806489,1419807389,4,14,900
101445497@N05,56,12,1419811749,1419811989,3,14,240
101445497@N05,56,24,1419812356,1419813136,4,14,780
101445497@N05,56,17,1419813737,1419813903,2,14,166
101445497@N05,56,27,1419813903,1419814137,2,14,234
101445497@N05,56,26,1419814137,1419814280,2,14,143
101445497@N05,56,28,1419814280,1419815180,4,14,900
101445497@N05,56,13,1419821166,1419821406,6,14,240
101445497@N05,56,11,1419822563,1419822803,3,14,240
101445497@N05,56,9,1419827215,1419827395,2,14,180
101445497@N05,56,16,1419827983,1419828253,3,14,270
101445497@N05,56,28,1419830248,1419831148,2,14,900
101445497@N05,56,26,1419834918,1419835818,2,14,900
10152427@N08,57,24,1250499503,1250500283,1,1,780
10152427@N08,58,31,1250610898,1250612398,1,1,1500
10152427@N08,59,21,1250901566,1250902136,1,1,570
101538895@N08,60,1,1423367428,1423367488,2,17,60
101538895@N08,60,28,1423367557,1423368404,2,17,847
101538895@N08,60,18,1423368404,1423368854,3,17,450
101538895@N08,60,29,1423369156,1423369751,4,17,595
101538895@N08,60,19,1423369751,1423370291,7,17,540
101538895@N08,60,20,1423372295,1423372814,5,17,519
101538895@N08,60,29,1423372814,1423373714,10,17,900
101538895@N08,60,17,1423378858,1423379158,2,17,300
101538895@N08,60,27,1423379321,1423380221,2,17,900
101538895@N08,60,8,1423380893,1423380898,2,17,5
101538895@N08,60,3,1423380898,1423380988,3,17,90
101538895@N08,60,16,1423382203,1423382473,6,17,270
101538895@N08,60,21,1423382799,1423383369,2,17,570
101538895@N08,60,19,1423385844,1423386384,3,17,540
101538895@N08,60,17,1423390023,1423390323,2,17,300
101538895@N08,60,28,1423391701,1423391994,3,17,293
101538895@N08,60,1,1423391994,1423392054,3,17,60
101538895@N08,61,27,1423547925,1423548825,4,4,900
101538895@N08,61,17,1423549460,1423549760,6,4,300
101538895@N08,61,24,1423553956,1423554736,3,4,780
101538895@N08,61,28,1423558155,1423559055,1,4,900
101577379@N06,62,28,1384513173,1384514073,1,1,900
101577901@N07,63,28,1332451811,1332452122,5,3,311
101577901@N07,63,1,1332452122,1332452122,2,3,0
101577901@N07,63,28,1332452122,1332453022,1,3,900
101593101@N02,64,29,1465252676,1465253576,2,7,900
101593101@N02,64,17,1465254621,1465254921,2,7,300
101593101@N02,64,7,1465255794,1465255974,4,7,180
101593101@N02,64,15,1465265066,1465265336,2,7,270
101593101@N02,64,17,1465271971,1465272271,2,7,300
101593101@N02,64,29,1465280226,1465281126,2,7,900
101593101@N02,64,12,1465287435,1465287675,1,7,240
101599161@N06,65,30,1418288798,1418289878,1,1,1080
10167516@N04,66,21,1198852618,1198853188,25,3,570
10167516@N04,66,26,1198853840,1198854008,8,3,168
10167516@N04,66,28,1198854008,1198854908,6,3,900
10182231@N00,67,20,1196368683,1196369223,2,7,540
10182231@N00,67,15,1196373851,1196374121,5,7,270
10182231@N00,67,26,1196374661,1196374737,2,7,76
10182231@N00,67,6,1196374737,1196374857,4,7,120
10182231@N00,67,3,1196382109,1196382199,2,7,90
10182231@N00,67,24,1196385976,1196386756,8,7,780
10182231@N00,67,25,1196388315,1196389155,4,7,840
10182842@N08,68,26,1308354024,1308354452,4,17,428
10182842@N08,68,6,1308354452,1308354572,4,17,120
10182842@N08,68,9,1308355448,1308355545,4,17,97
10182842@N08,68,6,1308355545,1308355665,3,17,120
10182842@N08,68,3,1308356270,1308356360,5,17,90
10182842@N08,68,13,1308356729,1308356969,11,17,240
10182842@N08,68,21,1308358404,1308358467,2,17,63
10182842@N08,68,3,1308358467,1308358557,2,17,90
10182842@N08,68,21,1308359015,1308359141,3,17,126
10182842@N08,68,15,1308359141,1308359411,2,17,270
10182842@N08,68,1,1308359596,1308359656,3,17,60
10182842@N08,68,29,1308360454,1308361354,13,17,900
10182842@N08,68,26,1308365141,1308365223,3,17,82
10182842@N08,68,28,1308365223,1308365419,2,17,196
10182842@N08,68,26,1308365419,1308366319,7,17,900
10182842@N08,68,28,1308366516,1308367416,6,17,900
10182842@N08,68,1,1308369957,1308370017,1,17,60
10182842@N08,69,20,1308958238,1308958778,4,18,540
10182842@N08,69,25,1308958815,1308959655,2,18,840
10182842@N08,69,28,1308959771,1308959786,2,18,15
10182842@N08,69,26,1308959786,1308959954,2,18,168
10182842@N08,69,16,1308959954,1308960224,2,18,270
10182842@N08,69,24,1308961988,1308962455,2,18,467
10182842@N08,69,17,1308962455,1308962755,2,18,300
10182842@N08,69,26,1308968842,1308969742,16,18,900
10182842@N08,69,23,1308972501,1308973101,2,18,600
10182842@N08,69,24,1308973259,1308974039,2,18,780
10182842@N08,69,30,1308974592,1308974792,3,18,200
10182842@N08,69,18,1308974792,1308975242,4,18,450
10182842@N08,69,29,1308975686,1308976441,3,18,755
10182842@N08,69,20,1308976441,1308976981,2,18,540
10182842@N08,69,29,1308977287,1308978187,5,18,900
10182842@N08,69,28,1308980171,1308981071,38,18,900
10182842@N08,69,29,1308995463,1308996363,10,18,900
10182842@N08,69,28,1308998714,1308999614,6,18,900
10182842@N08,70,12,1309562292,1309562532,5,23,240
10182842@N08,70,21,1309565777,1309566347,5,23,570
10182842@N08,70,8,1309566850,1309567025,3,23,175
10182842@N08,70,12,1309567025,1309567152,3,23,127
10182842@N08,70,26,1309567152,1309567670,11,23,518
10182842@N08,70,28,1309567670,1309568570,22,23,900
10182842@N08,70,26,1309571363,1309571711,2,23,348
10182842@N08,70,28,1309571711,1309572611,4,23,900
10182842@N08,70,18,1309573067,1309573124,3,23,57
10182842@N08,70,23,1309573124,1309573158,2,23,34
10182842@N08,70,29,1309573158,1309574058,12,23,900
10182842@N08,70,18,1309576003,1309576453,12,23,450
10182842@N08,70,28,1309578156,1309579056,6,23,900
10182842@N08,70,1,1309591761,1309591821,3,23,60
10182842@N08,70,23,1309593022,1309593622,4,23,600
10182842@N08,70,30,1309594594,1309594799,3,23,205
10182842@N08,70,23,1309594799,1309595167,2,23,368
10182842@N08,70,27,1309595167,1309596067,2,23,900
10182842@N08,70,24,1309598041,1309598821,6,23,780
10182842@N08,70,21,1309600029,1309600080,2,23,51
10182842@N08,70,26,1309600080,1309600515,5,23,435
10182842@N08,70,31,1309600515,1309600695,2,23,180
10182842@N08,70,29,1309600695,1309601595,3,23,900
10182842@N08,71,28,1309769771,1309770671,3,1,900
10182842@N08,72,12,1310081866,1310082071,2,21,205
10182842@N08,72,3,1310082071,1310082161,2,21,90
10182842@N08,72,21,1310082174,1310082744,3,21,570
10182842@N08,72,3,1310083765,1310083855,2,21,90
10182842@N08,72,21,1310084588,1310084760,2,21,172
10182842@N08,72,25,1310084760,1310084788,2,21,28
10182842@N08,72,21,1310084788,1310084902,3,21,114
10182842@N08,72,4,1310084902,1310085003,4,21,101
10182842@N08,72,11,1310085073,1310085313,3,21,240
10182842@N08,72,29,1310086457,1310086560,3,21,103
10182842@N08,72,30,1310086560,1310086873,2,21,313
10182842@N08,72,22,1310086873,1310087170,2,21,297
10182842@N08,72,29,1310087170,1310087189,2,21,19
10182842@N08,72,30,1310087189,1310087361,3,21,172
10182842@N08,72,29,1310087361,1310088056,3,21,695
10182842@N08,72,18,1310088056,1310088506,6,21,450
10182842@N08,72,29,1310088910,1310089810,6,21,900
10182842@N08,72,20,1310092561,1310093101,4,21,540
10182842@N08,72,29,1310095946,1310096215,4,21,269
10182842@N08,72,18,1310096215,1310096500,2,21,285
10182842@N08,72,28,1310096500,1310097400,3,21,900
10182842@N08,73,28,1310768743,1310769114,2,15,371
10182842@N08,73,24,1310769114,1310769894,20,15,780
10182842@N08,73,15,1310770533,1310770566,2,15,33
10182842@N08,73,24,1310770566,1310770679,4,15,113
10182842@N08,73,12,1310770679,1310770919,3,15,240
10182842@N08,73,26,1310773235,1310773496,6,15,261
10182842@N08,73,9,1310773496,1310773676,2,15,180
10182842@N08,73,30,1310774222,1310774729,3,15,507
10182842@N08,73,22,1310774729,1310775329,28,15,600
10182842@N08,73,20,1310776928,1310777115,2,15,187
10182842@N08,73,29,1310777115,1310778015,7,15,900
10182842@N08,73,27,1310782573,1310783473,5,15,900
10182842@N08,73,20,1310790220,1310790760,2,15,540
10182842@N08,73,29,1310791841,1310791969,2,15,128
10182842@N08,73,30,1310791969,1310793049,1,15,1080
10182842@N08,74,13,1310889377,1310889440,2,3,63
10182842@N08,74,25,1310889440,1310890280,3,3,840
10182842@N08,74,24,1310893355,1310894135,9,3,780
10182842@N08,75,25,1311808940,1311809780,27,7,840
10182842@N08,75,1,1311813310,1311813370,4,7,60
10182842@N08,75,20,1311813790,1311814330,2,7,540
10182842@N08,75,23,1311814430,1311814544,2,7,114
10182842@N08,75,29,1311814544,1311815444,3,7,900
10182842@N08,75,18,1311818227,1311818385,2,7,158
10182842@N08,75,23,1311818385,1311818985,1,7,600
10182842@N08,76,24,1312586197,1312586977,4,10,780
10182842@N08,76,27,1312588387,1312589287,4,10,900
10182842@N08,76,30,1312591045,1312591427,3,10,382
10182842@N08,76,22,1312591427,1312592027,11,10,600
10182842@N08,76,29,1312592615,1312592884,2,10,269
10182842@N08,76,30,1312592884,1312593964,5,10,1080
10182842@N08,76,18,1312595499,1312595949,2,10,450
10182842@N08,76,28,1312604783,1312604917,3,10,134
10182842@N08,76,16,1312604917,1312605187,7,10,270
10182842@N08,76,27,1312606028,1312606928,1,10,900
10182842@N08,77,12,1313302849,1313303083,3,4,234
10182842@N08,77,11,1313303083,1313303252,2,4,169
10182842@N08,77,30,1313303252,1313303928,2,4,676
10182842@N08,77,29,1313303928,1313304828,5,4,900
10182842@N08,78,27,1314400405,1314400905,4,18,500
10182842@N08,78,24,1314400905,1314401065,2,18,160
10182842@N08,78,17,1314401065,1314401365,2,18,300
10182842@N08,78,21,1314402564,1314402581,2,18,17
10182842@N08,78,13,1314402581,1314402679,2,18,98
10182842@N08,78,25,1314402679,1314403519,4,18,840
10182842@N08,78,13,1314404130,1314404370,10,18,240
10182842@N08,78,21,1314404789,1314405359,2,18,570
10182842@N08,78,11,1314405500,1314405740,3,18,240
10182842@N08,78,23,1314407355,1314407504,2,18,149
10182842@N08,78,29,1314407504,1314408404,4,18,900
10182842@N08,78,11,1314408594,1314408648,2,18,54
10182842@N08,78,29,1314408648,1314408741,2,18,93
10182842@N08,78,11,1314408741,1314408981,2,18,240
10182842@N08,78,29,1314409057,1314409957,3,18,900
10182842@N08,78,26,1314411576,1314411771,5,18,195
10182842@N08,78,27,1314411771,1314412671,5,18,900
10182842@N08,78,28,1314414127,1314415027,1,18,900
10182842@N08,79,20,1315642839,1315643379,5,10,540
10182842@N08,79,22,1315645425,1315645509,2,10,84
10182842@N08,79,20,1315645509,1315645921,2,10,412
10182842@N08,79,22,1315645921,1315646200,2,10,279
10182842@N08,79,30,1315646200,1315647048,2,10,848
10182842@N08,79,9,1315647048,1315647228,8,10,180
10182842@N08,79,4,1315648516,1315648609,2,10,93
10182842@N08,79,3,1315648609,1315648699,4,10,90
10182842@N08,79,24,1315649502,1315650282,4,10,780
10182842@N08,79,16,1315650500,1315650770,1,10,270
10182842@N08,80,1,1316485287,1316485347,2,8,60
10182842@N08,80,28,1316485598,1316485818,3,8,220
10182842@N08,80,26,1316485818,1316486718,2,8,900
10182842@N08,80,13,1316487333,1316487573,7,8,240
10182842@N08,80,15,1316491040,1316491310,10,8,270
10182842@N08,80,26,1316495936,1316496621,12,8,685
10182842@N08,80,28,1316496621,1316497521,3,8,900
10182842@N08,80,1,1316497671,1316497731,1,8,60
10182842@N08,81,24,1317412532,1317413312,5,1,780
10182842@N08,82,24,1317456778,1317457558,34,2,780
10182842@N08,82,28,1317467743,1317468643,1,2,900
10182842@N08,83,1,1318054192,1318054252,3,9,60
10182842@N08,83,31,1318058429,1318058468,2,9,39
10182842@N08,83,20,1318058468,1318058812,2,9,344
10182842@N08,83,22,1318058812,1318059412,5,9,600
10182842@N08,83,30,1318059804,1318060884,2,9,1080
10182842@N08,83,4,1318060963,1318061064,7,9,101
10182842@N08,83,21,1318062290,1318062860,2,9,570
10182842@N08,83,24,1318063973,1318064576,3,9,603
10182842@N08,83,28,1318064576,1318065476,4,9,900
10182842@N08,84,20,1318544079,1318544619,5,9,540
10182842@N08,84,22,1318545690,1318546290,5,9,600
10182842@N08,84,31,1318546610,1318548110,4,9,1500
10182842@N08,84,26,1318549290,1318549555,7,9,265
10182842@N08,84,4,1318549555,1318549656,5,9,101
10182842@N08,84,11,1318550156,1318550396,3,9,240
10182842@N08,84,30,1318550867,1318551947,2,9,1080
10182842@N08,84,31,1318552418,1318553918,6,9,1500
10182842@N08,84,1,1318555089,1318555149,1,9,60
10182842@N08,85,24,1320106083,1320106693,2,7,610
10182842@N08,85,26,1320106693,1320107395,2,7,702
10182842@N08,85,23,1320107395,1320107995,2,7,600
10182842@N08,85,27,1320110160,1320111060,3,7,900
10182842@N08,85,26,1320111758,1320112658,2,7,900
10182842@N08,85,28,1320114882,1320115136,3,7,254
10182842@N08,85,1,1320115136,1320115196,1,7,60
10182842@N08,86,1,1321074694,1321074754,2,8,60
10182842@N08,86,28,1321074845,1321075466,2,8,621
10182842@N08,86,26,1321075466,1321075660,2,8,194
10182842@N08,86,30,1321075660,1321075909,2,8,249
10182842@N08,86,29,1321075909,1321076401,5,8,492
10182842@N08,86,20,1321076401,1321076941,6,8,540
10182842@N08,86,13,1321078955,1321079195,2,8,240
10182842@N08,86,24,1321079571,1321080351,2,8,780
10182842@N08,87,1,1324097435,1324097495,2,6,60
10182842@N08,87,25,1324098903,1324099743,15,6,840
10182842@N08,87,20,1324103347,1324103887,2,6,540
10182842@N08,87,29,1324105102,1324105309,2,6,207
10182842@N08,87,26,1324105309,1324105870,4,6,561
10182842@N08,87,21,1324105870,1324106440,3,6,570
10182842@N08,88,28,1326515755,1326515769,2,21,14
10182842@N08,88,26,1326515769,1326515796,2,21,27
10182842@N08,88,4,1326515796,1326515848,2,21,52
10182842@N08,88,26,1326515848,1326516035,2,21,187
10182842@N08,88,29,1326516035,1326516051,2,21,16
10182842@N08,88,23,1326516051,1326516254,2,21,203
10182842@N08,88,29,1326516254,1326517154,8,21,900
10182842@N08,88,22,1326518938,1326519313,2,21,375
10182842@N08,88,29,1326519313,1326520167,2,21,854
10182842@N08,88,11,1326520167,1326520407,2,21,240
10182842@N08,88,9,1326520407,1326520421,2,21,14
10182842@N08,88,11,1326520421,1326520661,2,21,240
10182842@N08,88,13,1326520868,1326521108,2,21,240
10182842@N08,88,21,1326522550,1326522732,2,21,182
10182842@N08,88,26,1326522732,1326522855,2,21,123
10182842@N08,88,29,1326522855,1326523022,2,21,167
10182842@N08,88,28,1326523022,1326523922,4,21,900
10182842@N08,88,26,1326526027,1326526927,2,21,900
10182842@N08,88,25,1326529478,1326530318,3,21,840
10182842@N08,88,24,1326530856,1326531636,24,21,780
10182842@N08,88,15,1326534736,1326535006,1,21,270
10182842@N08,89,29,1327132849,1327133749,3,2,900
10182842@N08,89,28,1327135804,1327136704,8,2,900
10182842@N08,90,20,1330708780,1330709320,2,18,540
10182842@N08,90,30,1330709521,1330709609,2,18,88
10182842@N08,90,22,1330709609,1330710081,4,18,472
10182842@N08,90,29,1330710081,1330710498,2,18,417
10182842@N08,90,30,1330710498,1330711047,2,18,549
10182842@N08,90,11,1330711047,1330711238,4,18,191
10182842@N08,90,4,1330711238,1330711339,7,18,101
10182842@N08,90,3,1330711799,1330711889,7,18,90
10182842@N08,90,25,1330712381,1330713012,2,18,631
10182842@N08,90,13,1330713012,1330713252,5,18,240
10182842@N08,90,12,1330713681,1330713872,3,18,191
10182842@N08,90,24,1330713872,1330713975,2,18,103
10182842@N08,90,15,1330713975,1330714215,2,18,240
10182842@N08,90,26,1330714215,1330714440,3,18,225
10182842@N08,90,28,1330714440,1330714511,2,18,71
10182842@N08,90,26,1330714511,1330714600,2,18,89
10182842@N08,90,28,1330714600,1330715500,4,18,900
10182842@N08,90,24,1330722012,1330722792,6,18,780
10182842@N08,91,26,1331465041,1331465941,2,12,900
10182842@N08,91,30,1331465982,1331466677,3,12,695
10182842@N08,91,15,1331466677,1331466947,3,12,270
10182842@N08,91,24,1331467209,1331467916,2,12,707
10182842@N08,91,17,1331467916,1331468216,2,12,300
10182842@N08,91,15,1331469751,1331469824,2,12,73
10182842@N08,91,17,1331469824,1331470124,2,12,300
10182842@N08,91,26,1331470160,1331471060,2,12,900
10182842@N08,91,28,1331483064,1331483964,3,12,900
10182842@N08,91,26,1331485221,1331485687,2,12,466
10182842@N08,91,29,1331485687,1331486587,7,12,900
10182842@N08,91,1,1331495919,1331495979,1,12,60
10182842@N08,92,27,1333242900,1333243800,3,13,900
10182842@N08,92,26,1333244470,1333244792,4,13,322
10182842@N08,92,23,1333244792,1333245392,5,13,600
10182842@N08,92,30,1333247369,1333248449,10,13,1080
10182842@N08,92,27,1333248744,1333249644,2,13,900
10182842@N08,92,17,1333250330,1333250630,4,13,300
10182842@N08,92,26,1333252976,1333253030,2,13,54
10182842@N08,92,16,1333253030,1333253300,2,13,270
10182842@N08,92,26,1333253944,1333254029,2,13,85
10182842@N08,92,29,1333254029,1333254929,4,13,900
10182842@N08,92,26,1333256820,1333257720,4,13,900
10182842@N08,92,28,1333273470,1333274370,2,13,900
10182842@N08,92,27,1333275717,1333276617,2,13,900
10182842@N08,93,26,1333307068,1333307968,3,10,900
10182842@N08,93,28,1333311161,1333311208,2,10,47
10182842@N08,93,26,1333311208,1333311690,2,10,482
10182842@N08,93,24,1333311690,1333312470,25,10,780
10182842@N08,93,26,1333332363,1333333263,2,10,900
10182842@N08,93,29,1333333385,1333333869,2,10,484
10182842@N08,93,20,1333333869,1333334409,4,10,540
10182842@N08,93,28,1333338096,1333338996,6,10,900
10182842@N08,93,26,1333339522,1333340036,4,10,514
10182842@N08,93,12,1333340036,1333340276,3,10,240
10182842@N08,94,27,1334404627,1334404721,2,23,94
10182842@N08,94,16,1334404721,1334404834,2,23,113
10182842@N08,94,26,1334404834,1334405243,5,23,409
10182842@N08,94,29,1334405243,1334405565,2,23,322
10182842@N08,94,26,1334405565,1334405710,2,23,145
10182842@N08,94,3,1334405710,1334405779,3,23,69
10182842@N08,94,21,1334405779,1334405822,3,23,43
10182842@N08,94,3,1334405822,1334405912,2,23,90
10182842@N08,94,11,1334406111,1334406351,3,23,240
10182842@N08,94,7,1334406515,1334406695,2,23,180
10182842@N08,94,30,1334406850,1334407053,4,23,203
10182842@N08,94,11,1334407053,1334407149,4,23,96
10182842@N08,94,29,1334407149,1334407261,2,23,112
10182842@N08,94,30,1334407261,1334407306,2,23,45
10182842@N08,94,29,1334407306,1334408206,6,23,900
10182842@N08,94,31,1334408304,1334408378,2,23,74
10182842@N08,94,22,1334408378,1334408905,5,23,527
10182842@N08,94,29,1334408905,1334409158,3,23,253
10182842@N08,94,22,1334409158,1334409433,2,23,275
10182842@N08,94,29,1334409433,1334410333,5,23,900
10182842@N08,94,30,1334411676,1334411982,3,23,306
10182842@N08,94,26,1334411982,1334412150,4,23,168
10182842@N08,94,28,1334412150,1334413050,2,23,900
10182842@N08,95,24,1335480668,1335481448,2,9,780
10182842@N08,95,1,1335507982,1335508042,2,9,60
10182842@N08,95,24,1335508104,1335508682,2,9,578
10182842@N08,95,12,1335508682,1335508922,3,9,240
10182842@N08,95,3,1335509009,1335509099,5,9,90
10182842@N08,95,11,1335509591,1335509831,4,9,240
10182842@N08,95,9,1335510101,1335510281,4,9,180
10182842@N08,95,26,1335510313,1335511213,13,9,900
10182842@N08,95,24,1335518345,1335519125,23,9,780
10182842@N08,96,28,1336291051,1336291361,2,5,310
10182842@N08,96,29,1336291361,1336292261,2,5,900
10182842@N08,96,22,1336293280,1336293880,7,5,600
10182842@N08,96,31,1336295094,1336295124,2,5,30
10182842@N08,96,29,1336295124,1336296024,1,5,900
10182842@N08,97,26,1336688983,1336689883,2,10,900
10182842@N08,97,1,1336710324,1336710384,2,10,60
10182842@N08,97,24,1336710618,1336710919,2,10,301
10182842@N08,97,13,1336710919,1336711159,3,10,240
10182842@N08,97,21,1336711539,1336712109,3,10,570
10182842@N08,97,9,1336712501,1336712560,3,10,59
10182842@N08,97,26,1336712560,1336712883,7,10,323
10182842@N08,97,30,1336712883,1336712933,2,10,50
10182842@N08,97,29,1336712933,1336713833,4,10,900
10182842@N08,97,24,1336731116,1336731896,4,10,780
10182842@N08,98,28,1338157677,1338158085,2,13,408
10182842@N08,98,17,1338158085,1338158385,2,13,300
10182842@N08,98,16,1338160061,1338160221,3,13,160
10182842@N08,98,26,1338160221,1338160306,2,13,85
10182842@N08,98,23,1338160306,1338160560,2,13,254
10182842@N08,98,29,1338160560,1338160786,4,13,226
10182842@N08,98,23,1338160786,1338160961,2,13,175
10182842@N08,98,29,1338160961,1338161485,2,13,524
10182842@N08,98,22,1338161485,1338162085,16,13,600
10182842@N08,98,30,1338162801,1338163702,4,13,901
10182842@N08,98,26,1338163702,1338163821,3,13,119
10182842@N08,98,28,1338163821,1338163993,3,13,172
10182842@N08,98,1,1338163993,1338164053,1,13,60
10182842@N08,99,28,1339085138,1339085770,4,11,632
10182842@N08,99,26,1339085770,1339085903,2,11,133
10182842@N08,99,28,1339085903,1339086074,2,11,171
10182842@N08,99,16,1339086074,1339086344,2,11,270
10182842@N08,99,4,1339087650,1339087751,3,11,101
10182842@N08,99,11,1339087902,1339088142,2,11,240
10182842@N08,99,12,1339088416,1339088656,3,11,240
10182842@N08,99,15,1339089107,1339089377,2,11,270
10182842@N08,99,28,1339090340,1339090627,4,11,287
10182842@N08,99,26,1339090627,1339090739,2,11,112
10182842@N08,99,28,1339090739,1339091639,1,11,900
10182842@N08,100,28,1339911456,1339911703,2,3,247
10182842@N08,100,26,1339911703,1339911921,2,3,218
10182842@N08,100,3,1339911921,1339912011,2,3,90
10182842@N08,101,26,1341361444,1341361743,2,13,299
10182842@N08,101,1,1341361743,1341361803,2,13,60
10182842@N08,101,26,1341363022,1341363522,9,13,500
10182842@N08,101,3,1341363522,1341363612,3,13,90
10182842@N08,101,12,1341365155,1341365395,3,13,240
10182842@N08,101,25,1341365465,1341365875,3,13,410
10182842@N08,101,13,1341365875,1341366115,6,13,240
10182842@N08,101,25,1341366688,1341366765,2,13,77
10182842@N08,101,3,1341366765,1341366855,2,13,90
10182842@N08,101,30,1341367106,1341367633,4,13,527
10182842@N08,101,23,1341367633,1341368233,4,13,600
10182842@N08,101,29,1341369668,1341370227,5,13,559
10182842@N08,101,28,1341370227,1341371127,3,13,900
10182842@N08,102,30,1343463667,1343464747,8,3,1080
10182842@N08,102,16,1343465020,1343465290,2,3,270
10182842@N08,102,23,1343465508,1343466108,2,3,600
10182842@N08,103,13,1346059498,1346059738,6,3,240
10182842@N08,103,21,1346060347,1346060598,3,3,251
10182842@N08,103,12,1346060598,1346060838,1,3,240
10182842@N08,104,28,1348114674,1348115520,2,4,846
10182842@N08,104,29,1348115520,1348116420,4,4,900
10182842@N08,104,26,1348120907,1348121807,3,4,900
10182842@N08,104,28,1348122703,1348123603,1,4,900
10182842@N08,105,24,1348909917,1348910697,10,1,780
10182842@N08,106,16,1351405640,1351405910,2,2,270
10182842@N08,106,3,1351406403,1351406493,1,2,90
10182842@N08,107,24,1352019807,1352020587,5,1,780
10182842@N08,108,26,1352593043,1352593943,3,1,900
10182842@N08,109,28,1355882347,1355883247,3,5,900
10182842@N08,109,26,1355883487,1355883921,2,5,434
10182842@N08,109,4,1355883921,1355884022,2,5,101
10182842@N08,109,29,1355884866,1355885766,3,5,900
10182842@N08,109,28,1355905572,1355906472,1,5,900
10182842@N08,110,26,1357344528,1357345064,3,3,536
10182842@N08,110,4,1357345064,1357345165,2,3,101
10182842@N08,110,28,1357348022,1357348922,1,3,900
10182842@N08,111,26,1359874884,1359875784,2,1,900
10182842@N08,112,24,1364419604,1364419874,2,12,270
10182842@N08,112,12,1364419874,1364419956,2,12,82
10182842@N08,112,21,1364419956,1364420526,3,12,570
10182842@N08,112,13,1364421470,1364421710,3,12,240
10182842@N08,112,21,1364421788,1364422358,2,12,570
10182842@N08,112,4,1364422424,1364422525,2,12,101
10182842@N08,112,26,1364422724,1364423263,4,12,539
10182842@N08,112,30,1364423263,1364424343,2,12,1080
10182842@N08,112,29,1364427176,1364428076,3,12,900
10182842@N08,112,26,1364429959,1364430689,3,12,730
10182842@N08,112,28,1364430689,1364431401,2,12,712
10182842@N08,112,1,1364431401,1364431461,1,12,60
10182842@N08,113,12,1365112791,1365113031,1,1,240
10182842@N08,114,17,1365198284,1365198584,2,3,300
10182842@N08,114,29,1365199244,1365200144,2,3,900
10182842@N08,114,22,1365200868,1365201468,1,3,600
10182842@N08,115,28,1368254140,1368255040,5,3,900
10182842@N08,115,5,1368257310,1368257430,2,3,120
10182842@N08,115,1,1368259202,1368259262,1,3,60
10182842@N08,116,24,1370686363,1370687143,6,2,780
10182842@N08,116,28,1370697053,1370697953,1,2,900
10182842@N08,117,13,1386486029,1386486269,3,3,240
10182842@N08,117,4,1386487865,1386487966,2,3,101
10182842@N08,117,3,1386487996,1386488086,2,3,90
10182842@N08,118,16,1391163928,1391164198,2,2,270
10182842@N08,118,26,1391164282,1391165182,1,2,900
10182842@N08,119,26,1391920395,1391921295,4,6,900
10182842@N08,119,9,1391922892,1391922904,2,6,12
10182842@N08,119,26,1391922904,1391922999,2,6,95
10182842@N08,119,4,1391922999,1391923100,2,6,101
10182842@N08,119,30,1391923641,1391924721,2,6,1080
10182842@N08,119,28,1391924927,1391925827,1,6,900
10182842@N08,120,1,1396158041,1396158101,2,9,60
10182842@N08,120,20,1396158582,1396158932,3,9,350
10182842@N08,120,13,1396158932,1396159172,3,9,240
10182842@N08,120,29,1396160197,1396161097,2,9,900
10182842@N08,120,30,1396161377,1396162180,3,9,803
10182842@N08,120,3,1396162180,1396162200,3,9,20
10182842@N08,120,12,1396162200,1396162440,2,9,240
10182842@N08,120,26,1396162440,1396162652,3,9,212
10182842@N08,120,3,1396162652,1396162742,1,9,90
10182842@N08,121,24,1401613631,1401614411,1,1,780
10182842@N08,122,24,1402048291,1402049071,7,1,780
10182842@N08,123,25,1405171216,1405172056,1,1,840
10182842@N08,124,1,1406998695,1406998755,10,1,60
10182842@N08,125,30,1409069333,1409070413,1,1,1080
10182842@N08,126,1,1410561649,1410561709,2,11,60
10182842@N08,126,26,1410561901,1410562801,4,11,900
10182842@N08,126,23,1410563007,1410563221,2,11,214
10182842@N08,126,29,1410563221,1410563547,5,11,326
10182842@N08,126,31,1410563547,1410563902,2,11,355
10182842@N08,126,22,1410563902,1410564329,3,11,427
10182842@N08,126,31,1410564329,1410564694,2,11,365
10182842@N08,126,30,1410564694,1410565560,3,11,866
10182842@N08,126,3,1410565560,1410565650,2,11,90
10182842@N08,126,24,1410566791,1410567028,3,11,237
10182842@N08,126,12,1410567028,1410567268,1,11,240
10182842@N08,127,1,1417664364,1417664424,2,8,60
10182842@N08,127,28,1417664569,1417665469,2,8,900
10182842@N08,127,23,1417667220,1417667820,2,8,600
10182842@N08,127,31,1417667830,1417669330,2,8,1500
10182842@N08,127,24,1417674134,1417674914,3,8,780
10182842@N08,127,28,1417680675,1417680959,2,8,284
10182842@N08,127,26,1417680959,1417681859,3,8,900
10182842@N08,127,28,1417686453,1417687353,2,8,900
10182842@N08,128,26,1422167166,1422168066,1,1,900
10182842@N08,129,26,1424340775,1424341675,1,1,900
10182842@N08,130,28,1425013435,1425014335,3,1,900
10185356@N05,131,27,1377224819,1377225719,1,1,900
10185356@N05,132,13,1377295783,1377296023,1,1,240
10196023@N00,133,1,1188080222,1188080282,2,2,60
10196023@N00,133,28,1188087629,1188088529,1,2,900
10196023@N00,134,8,1188899133,1188899313,1,1,180
10196023@N00,135,28,1191026782,1191027682,2,1,900
10196023@N00,136,16,1194039905,1194040175,2,3,270
10196023@N00,136,26,1194040265,1194041165,3,3,900
10196023@N00,136,29,1194048205,1194049105,1,3,900
10196023@N00,137,29,1196296088,1196296988,2,2,900
10196023@N00,137,26,1196298262,1196299162,1,2,900
10196023@N00,138,26,1199231284,1199232184,1,1,900
10196023@N00,139,29,1200185798,1200186698,1,1,900
10196023@N00,140,15,1203131096,1203131366,1,1,270
10196023@N00,141,28,1203719350,1203719569,3,3,219
10196023@N00,141,26,1203719569,1203720469,2,3,900
10196023@N00,141,21,1203722435,1203723005,1,3,570
10196023@N00,142,1,1204769348,1204769408,1,1,60
10196023@N00,143,11,1205565211,1205565451,1,1,240
10196023@N00,144,26,1209178338,1209179238,1,1,900
10196023@N00,145,28,1215811965,1215812840,2,3,875
10196023@N00,145,24,1215812840,1215813620,3,3,780
10196023@N00,145,13,1215821586,1215821826,2,3,240
10196023@N00,146,28,1215898955,1215899855,2,2,900
10196023@N00,146,30,1215906481,1215907561,2,2,1080
10196023@N00,147,28,1215938963,1215939863,2,8,900
10196023@N00,147,16,1215954569,1215954839,3,8,270
10196023@N00,147,26,1215955969,1215956869,2,8,900
10196023@N00,147,30,1215957180,1215957462,2,8,282
10196023@N00,147,29,1215957462,1215958362,2,8,900
10196023@N00,147,26,1215958509,1215959032,2,8,523
10196023@N00,147,16,1215959032,1215959302,2,8,270
10196023@N00,147,28,1215959687,1215960587,4,8,900
10196023@N00,148,30,1219451666,1219452746,1,1,1080
10196023@N00,149,26,1225491774,1225492674,3,3,900
10196023@N00,149,17,1225505561,1225505861,2,3,300
10196023@N00,149,31,1225507133,1225508633,1,3,1500
10196023@N00,150,29,1225931264,1225932164,2,3,900
10196023@N00,150,14,1225932922,1225933162,2,3,240
10196023@N00,150,24,1225936035,1225936815,1,3,780
10196023@N00,151,11,1227315315,1227315555,1,1,240
10196023@N00,152,26,1229811944,1229812844,2,1,900
10196023@N00,153,16,1232159453,1232159723,2,1,270
10196023@N00,154,26,1233367924,1233368824,1,1,900
10196023@N00,155,25,1235172549,1235173389,10,2,840
10196023@N00,155,18,1235180236,1235180686,1,2,450
10196023@N00,156,23,1245461496,1245462096,3,1,600
10196023@N00,157,1,1247410386,1247410446,1,1,60
10196023@N00,158,24,1256946444,1256947224,1,1,780
10196023@N00,159,26,1257027579,1257028479,1,1,900
10196023@N00,160,26,1259398996,1259399896,1,1,900
10196023@N00,161,16,1259557306,1259557576,1,1,270
10196023@N00,162,29,1261451475,1261452375,1,1,900
10196023@N00,163,24,1278212958,1278213738,1,1,780
10196023@N00,164,30,1341141625,1341142705,1,1,1080
10196023@N00,165,16,1356303917,1356304187,1,1,270
10196023@N00,166,3,1371860913,1371861003,2,2,90
10196023@N00,166,15,1371864669,1371864939,1,2,270
10196023@N00,167,20,1380935918,1380936458,1,1,540
10196023@N00,168,13,1409057115,1409057355,1,1,240
10196023@N00,169,28,1436656797,1436657697,1,1,900
10204545@N02,170,26,1350937837,1350938737,2,1,900
10206042@N07,171,12,1366697316,1366697556,2,4,240
10206042@N07,171,6,1366703496,1366703616,2,4,120
10206042@N07,171,7,1366705634,1366705814,2,4,180
10206042@N07,171,26,1366709995,1366710895,1,4,900
102237062@N02,172,6,1451333472,1451333592,4,13,120
102237062@N02,172,8,1451335241,1451335421,5,13,180
102237062@N02,172,23,1451336477,1451337077,9,13,600
102237062@N02,172,20,1451340255,1451340389,4,13,134
102237062@N02,172,29,1451340389,1451340403,2,13,14
102237062@N02,172,20,1451340403,1451340943,8,13,540
102237062@N02,172,12,1451343205,1451343445,3,13,240
102237062@N02,172,24,1451345543,1451346323,3,13,780
102237062@N02,172,30,1451350290,1451351370,6,13,1080
102237062@N02,172,12,1451353210,1451353450,15,13,240
102237062@N02,172,17,1451358366,1451358666,7,13,300
102237062@N02,172,22,1451361339,1451361939,4,13,600
102237062@N02,172,29,1451363456,1451364356,1,13,900
102237062@N02,173,25,1451510942,1451511782,15,11,840
102237062@N02,173,13,1451512598,1451512838,15,11,240
102237062@N02,173,25,1451515483,1451515992,3,11,509
102237062@N02,173,15,1451515992,1451516192,3,11,200
102237062@N02,173,1,1451516192,1451516252,4,11,60
102237062@N02,173,25,1451517505,1451518345,2,11,840
102237062@N02,173,17,1451519240,1451519540,5,11,300
102237062@N02,173,21,1451520836,1451521406,5,11,570
102237062@N02,173,6,1451522657,1451522777,5,11,120
102237062@N02,173,26,1451522914,1451523643,8,11,729
102237062@N02,173,28,1451523643,1451524543,1,11,900
102249118@N03,174,26,1368598280,1368599180,1,1,900
10245245@N07,175,29,1330695205,1330696105,1,1,900
10259824@N06,176,29,1224410819,1224411719,1,1,900
10259875@N03,177,1,1342746605,1342746665,2,21,60
10259875@N03,177,26,1342754326,1342754408,2,21,82
10259875@N03,177,7,1342754408,1342754588,2,21,180
10259875@N03,177,31,1342756676,1342758176,2,21,1500
10259875@N03,177,12,1342760017,1342760257,2,21,240
10259875@N03,177,23,1342761565,1342761912,2,21,347
10259875@N03,177,11,1342761912,1342762152,2,21,240
10259875@N03,177,23,1342764765,1342765365,2,21,600
10259875@N03,177,28,1342781284,1342781409,3,21,125
10259875@N03,177,1,1342781409,1342781469,3,21,60
10259875@N03,177,23,1342785985,1342786585,3,21,600
10259875@N03,177,26,1342787722,1342788622,2,21,900
10259875@N03,177,16,1342788790,1342789060,3,21,270
10259875@N03,177,26,1342789213,1342790113,2,21,900
10259875@N03,177,27,1342792625,1342792884,2,21,259
10259875@N03,177,28,1342792884,1342793784,2,21,900
10259875@N03,177,16,1342795283,1342795553,2,21,270
10259875@N03,177,26,1342795996,1342796178,2,21,182
10259875@N03,177,5,1342796178,1342796298,2,21,120
10259875@N03,177,26,1342796385,1342797285,2,21,900
10259875@N03,177,28,1342798842,1342799742,1,21,900
10259875@N03,178,1,1455758458,1455758518,2,18,60
10259875@N03,178,28,1455758586,1455758878,4,18,292
10259875@N03,178,26,1455758878,1455759778,3,18,900
10259875@N03,178,1,1455773082,1455773142,4,18,60
10259875@N03,178,28,1455774100,1455775000,2,18,900
10259875@N03,178,24,1455778030,1455778810,2,18,780
10259875@N03,178,11,1455780678,1455780918,2,18,240
10259875@N03,178,21,1455782265,1455782835,6,18,570
10259875@N03,178,4,1455790019,1455790120,2,18,101
10259875@N03,178,21,1455790243,1455790813,2,18,570
10259875@N03,178,13,1455790912,1455791152,4,18,240
10259875@N03,178,25,1455791999,1455792452,2,18,453
10259875@N03,178,26,1455792452,1455792949,4,18,497
10259875@N03,178,29,1455792949,1455793849,2,18,900
10259875@N03,178,21,1455801274,1455801844,5,18,570
10259875@N03,178,26,1455805049,1455805949,2,18,900
10259875@N03,178,23,1455807642,1455808242,2,18,600
10259875@N03,178,28,1455808332,1455809232,1,18,900
102667810@N03,179,1,1366417527,1366417565,5,12,38
102667810@N03,179,29,1366417565,1366418465,3,12,900
102667810@N03,179,31,1366419826,1366421326,2,12,1500
102667810@N03,179,29,1366424080,1366424980,5,12,900
102667810@N03,179,31,1366425987,1366427487,3,12,1500
102667810@N03,179,1,1366428346,1366428406,2,12,60
102667810@N03,179,17,1366435751,1366435865,4,12,114
102667810@N03,179,27,1366435865,1366436167,2,12,302
102667810@N03,179,17,1366436167,1366436467,4,12,300
102667810@N03,179,30,1366439359,1366440439,3,12,1080
102667810@N03,179,1,1366442301,1366442361,4,12,60
102667810@N03,179,17,1366442452,1366442752,1,12,300
102667810@N03,180,17,1366511088,1366511388,1,1,300
10274899@N06,181,5,1248758614,1248758734,2,5,120
10274899@N06,181,12,1248771739,1248771979,3,5,240
10274899@N06,181,24,1248772343,1248773123,4,5,780
10274899@N06,181,16,1248775960,1248776230,2,5,270
10274899@N06,181,27,1248777611,1248778511,2,5,900
10274899@N06,182,1,1248833586,1248833646,2,1,60
10274899@N06,183,21,1248922880,1248923450,1,1,570
10285746@N06,184,1,1374627124,1374627184,1,1,60
10290887@N03,185,6,1289039670,1289039790,1,1,120
10295241@N02,186,28,1353135926,1353136826,2,3,900
10295241@N02,186,26,1353153883,1353154783,2,3,900
10295241@N02,186,25,1353156103,1353156943,2,3,840
10295241@N02,187,28,1366421041,1366421503,2,16,462
10295241@N02,187,29,1366421503,1366422403,2,16,900
10295241@N02,187,31,1366422564,1366424064,2,16,1500
10295241@N02,187,11,1366426815,1366427055,2,16,240
10295241@N02,187,16,1366428736,1366429006,2,16,270
10295241@N02,187,26,1366429684,1366430584,5,16,900
10295241@N02,187,31,1366431476,1366431872,2,16,396
10295241@N02,187,19,1366431872,1366432412,3,16,540
10295241@N02,187,1,1366438652,1366438712,2,16,60
10295241@N02,187,11,1366438968,1366439152,3,16,184
10295241@N02,187,27,1366439152,1366440052,3,16,900
10295241@N02,187,23,1366457446,1366458046,6,16,600
10295241@N02,187,31,1366459008,1366460101,4,16,1093
10295241@N02,187,29,1366460101,1366461001,3,16,900
10295241@N02,187,19,1366461429,1366461969,4,16,540
10295241@N02,187,28,1366463769,1366464669,1,16,900
10295241@N02,188,31,1366507644,1366508122,3,2,478
10295241@N02,188,20,1366508122,1366508662,1,2,540
10295241@N02,189,9,1425033266,1425033446,1,1,180
10295241@N02,190,1,1425095052,1425095112,2,2,60
10295241@N02,190,15,1425098564,1425098834,1,2,270
10295241@N02,191,26,1431053415,1431054315,1,1,900
10295241@N02,192,20,1431153312,1431153852,1,1,540
10295241@N02,193,19,1441510103,1441510643,1,1,540
10295241@N02,194,26,1441601877,1441602777,2,1,900
102953813@N07,195,29,1270260878,1270261778,1,1,900
102953813@N07,196,16,1284273748,1284274018,2,1,270
102953813@N07,197,26,1288330919,1288331819,2,1,900
102953813@N07,198,16,1296963800,1296964070,1,1,270
102953813@N07,199,1,1365749473,1365749533,4,16,60
102953813@N07,199,12,1365749991,1365750231,2,16,240
102953813@N07,199,1,1365750988,1365751048,3,16,60
102953813@N07,199,22,1365751351,1365751665,2,16,314
102953813@N07,199,1,1365751665,1365751665,2,16,0
102953813@N07,199,14,1365751665,1365751774,2,16,109
102953813@N07,199,1,1365751774,1365751774,2,16,0
102953813@N07,199,14,1365751774,1365752014,3,16,240
102953813@N07,199,29,1365753203,1365753630,2,16,427
102953813@N07,199,1,1365753630,1365753690,3,16,60
102953813@N07,199,29,1365754013,1365754913,4,16,900
102953813@N07,199,1,1365755471,1365755531,2,16,60
102953813@N07,199,21,1365756693,1365756884,2,16,191
102953813@N07,199,1,1365756884,1365756944,2,16,60
102953813@N07,199,25,1365758041,1365758427,3,16,386
102953813@N07,199,1,1365758427,1365758487,1,16,60
102953813@N07,200,28,1365942301,1365943201,2,1,900
102953813@N07,201,29,1367555152,1367556036,2,6,884
102953813@N07,201,25,1367556036,1367556876,2,6,840
102953813@N07,201,31,1367558188,1367559688,3,6,1500
102953813@N07,201,23,1367560821,1367561170,2,6,349
102953813@N07,201,18,1367561170,1367561620,4,6,450
102953813@N07,201,16,1367573015,1367573285,1,6,270
102953813@N07,202,24,1371357845,1371358533,2,3,688
102953813@N07,202,15,1371358533,1371358803,2,3,270
102953813@N07,202,29,1371359752,1371360652,1,3,900
102953813@N07,203,1,1371969480,1371969540,2,4,60
102953813@N07,203,29,1371971004,1371971904,3,4,900
102953813@N07,203,22,1371975016,1371975616,2,4,600
102953813@N07,203,30,1371979301,1371980381,2,4,1080
102953813@N07,204,28,1374036421,1374037321,2,3,900
102953813@N07,204,26,1374037664,1374038564,3,3,900
102953813@N07,204,5,1374038739,1374038859,1,3,120
102953813@N07,205,28,1374883200,1374884100,3,17,900
102953813@N07,205,18,1374894967,1374895417,8,17,450
102953813@N07,205,22,1374902757,1374903357,2,17,600
102953813@N07,205,29,1374904304,1374905204,3,17,900
102953813@N07,205,1,1374905828,1374905888,2,17,60
102953813@N07,205,11,1374909509,1374909674,3,17,165
102953813@N07,205,4,1374909674,1374909775,2,17,101
102953813@N07,205,3,1374909868,1374909958,2,17,90
102953813@N07,205,24,1374910165,1374910277,2,17,112
102953813@N07,205,12,1374910277,1374910505,2,17,228
102953813@N07,205,17,1374910505,1374910805,2,17,300
102953813@N07,205,16,1374912946,1374913216,3,17,270
102953813@N07,205,27,1374914563,1374915463,3,17,900
102953813@N07,205,16,1374917287,1374917557,2,17,270
102953813@N07,205,28,1374917708,1374917788,3,17,80
102953813@N07,205,1,1374917788,1374917848,2,17,60
102953813@N07,205,28,1374929227,1374930127,2,17,900
102953813@N07,206,28,1378806549,1378807449,1,1,900
102953813@N07,207,1,1379055558,1379055618,3,9,60
102953813@N07,207,17,1379056395,1379056695,3,9,300
102953813@N07,207,15,1379059138,1379059364,3,9,226
102953813@N07,207,24,1379059364,1379060042,3,9,678
102953813@N07,207,15,1379060042,1379060116,2,9,74
102953813@N07,207,24,1379060116,1379060896,2,9,780
102953813@N07,207,11,1379061424,1379061664,5,9,240
102953813@N07,207,3,1379064440,1379064530,3,9,90
102953813@N07,207,13,1379065768,1379066008,1,9,240
102953813@N07,208,22,1379221294,1379221894,2,3,600
102953813@N07,208,11,1379223052,1379223292,2,3,240
102953813@N07,208,13,1379223892,1379224132,1,3,240
102953813@N07,209,28,1379923034,1379923934,2,4,900
102953813@N07,209,12,1379927786,1379927968,2,4,182
102953813@N07,209,21,1379927968,1379928538,2,4,570
102953813@N07,209,26,1379929087,1379929987,2,4,900
102953813@N07,210,25,1382689538,1382690378,1,1,840
102953813@N07,211,1,1385882397,1385882457,2,7,60
102953813@N07,211,27,1385884805,1385885417,2,7,612
102953813@N07,211,16,1385885417,1385885687,2,7,270
102953813@N07,211,26,1385886035,1385886218,2,7,183
102953813@N07,211,7,1385886218,1385886398,2,7,180
102953813@N07,211,25,1385886967,1385887807,3,7,840
102953813@N07,211,28,1385889430,1385890330,3,7,900
102953813@N07,212,1,1386748574,1386748634,1,1,60
102953813@N07,213,1,1387262392,1387262452,2,6,60
102953813@N07,213,28,1387263241,1387264141,3,6,900
102953813@N07,213,13,1387271616,1387271856,2,6,240
102953813@N07,213,8,1387274626,1387274806,2,6,180
102953813@N07,213,26,1387274844,1387275538,3,6,694
102953813@N07,213,28,1387275538,1387276438,1,6,900
10299767@N08,214,6,1224456217,1224456337,1,1,120
10299767@N08,215,12,1224544197,1224544437,1,1,240
10299767@N08,216,23,1258857215,1258857815,1,1,600
10299767@N08,217,16,1258932130,1258932400,4,1,270
10299767@N08,218,30,1259022238,1259023318,2,2,1080
10299767@N08,218,16,1259031962,1259032232,1,2,270
10299767@N08,219,1,1303026695,1303026755,1,1,60
10299767@N08,220,30,1400141069,1400142149,1,1,1080
10299767@N08,221,15,1400227239,1400227509,2,2,270
10299767@N08,221,16,1400241654,1400241924,1,2,270
10299767@N08,222,30,1400284781,1400285861,1,1,1080
10302113@N02,223,28,1258076127,1258077027,2,10,900
10302113@N02,223,16,1258077602,1258077872,4,10,270
10302113@N02,223,28,1258078278,1258079178,3,10,900
10302113@N02,223,1,1258079350,1258079410,4,10,60
10302113@N02,223,16,1258086694,1258086726,3,10,32
10302113@N02,223,27,1258086726,1258087626,4,10,900
10302113@N02,223,16,1258088599,1258088869,7,10,270
10302113@N02,223,21,1258090168,1258090738,14,10,570
10302113@N02,223,13,1258098861,1258099101,3,10,240
10302113@N02,223,21,1258102254,1258102824,3,10,570
10304915@N00,224,10,1335688736,1335688976,1,1,240
10304915@N00,225,26,1426840464,1426841364,1,1,900
10304915@N00,226,18,1435621852,1435622302,1,1,450
103109013@N07,227,18,1395024508,1395024958,3,3,450
103109013@N07,227,14,1395027761,1395028001,2,3,240
103109013@N07,227,26,1395028512,1395029412,2,3,900
10317486@N06,228,12,1230863169,1230863409,1,1,240
103297030@N03,229,13,1388294070,1388294310,2,1,240
10339790@N07,230,7,1371297905,1371298085,2,1,180
103400918@N03,231,17,1375573219,1375573519,1,1,300
10352809@N08,232,25,1329787052,1329787892,5,3,840
10352809@N08,232,1,1329808682,1329808742,5,3,60
10352809@N08,232,26,1329809156,1329810056,9,3,900
103564614@N04,233,18,1452271104,1452271554,2,1,450
10358880@N05,234,26,1205812949,1205813849,1,1,900
10358880@N05,235,12,1223787704,1223787944,1,1,240
10358880@N05,236,1,1224048674,1224048734,2,3,60
10358880@N05,236,26,1224049901,1224050801,2,3,900
10358880@N05,236,6,1224051061,1224051181,1,3,120
10358880@N05,237,26,1241425118,1241426018,1,1,900
10358880@N05,238,13,1242085080,1242085320,2,1,240
10358880@N05,239,29,1245802593,1245803216,2,5,623
10358880@N05,239,23,1245803216,1245803816,2,5,600
10358880@N05,239,3,1245811469,1245811559,2,5,90
10358880@N05,239,28,1245811827,1245812727,2,5,900
10358880@N05,239,7,1245830400,1245830580,1,5,180
103708587@N06,240,26,1388447532,1388448432,1,1,900
10382366@N03,241,4,1348853586,1348853687,1,1,101
10414404@N08,242,29,1374140646,1374141546,2,1,900
10414404@N08,243,29,1374204805,1374205705,1,1,900
10420619@N06,244,26,1355650808,1355651708,6,1,900
10420619@N06,245,29,1365923380,1365924280,2,1,900
10448821@N00,246,6,1196896847,1196896967,18,1,120
10448821@N00,247,6,1196992665,1196992785,6,1,120
10448821@N00,248,6,1197065344,1197065464,8,3,120
10448821@N00,248,26,1197073462,1197074362,2,3,900
10448821@N00,248,6,1197081734,1197081854,6,3,120
10448821@N00,249,28,1327993888,1327993900,2,2,12
10448821@N00,249,1,1327993900,1327993960,1,2,60
10450800@N03,250,29,1302662318,1302663218,12,1,900
10450800@N03,251,29,1306059593,1306060493,3,2,900
10450800@N03,251,31,1306068552,1306070052,2,2,1500
10450800@N03,252,20,1318124858,1318125398,5,1,540
10450800@N03,253,23,1321172705,1321173305,2,3,600
10450800@N03,253,17,1321176408,1321176708,2,3,300
10450800@N03,253,24,1321177894,1321178674,1,3,780
10450800@N03,254,6,1323567477,1323567597,1,1,120
10450800@N03,255,17,1359887620,1359887920,1,1,300
10450800@N03,256,26,1370176323,1370176842,3,5,519
10450800@N03,256,24,1370176842,1370177134,2,5,292
10450800@N03,256,17,1370177134,1370177434,2,5,300
10450800@N03,256,18,1370180184,1370180322,2,5,138
10450800@N03,256,23,1370180322,1370180922,3,5,600
10450800@N03,257,29,1383962549,1383963449,2,2,900
10450800@N03,257,23,1383965106,1383965706,1,2,600
10450800@N03,258,1,1389494627,1389494687,2,2,60
10450800@N03,258,26,1389494946,1389495846,4,2,900
10450800@N03,259,17,1389525694,1389525994,1,1,300
10450800@N03,260,26,1395983389,1395984289,1,1,900
10450800@N03,261,18,1400387407,1400387857,2,2,450
10450800@N03,261,14,1400390505,1400390745,1,2,240
10450800@N03,262,19,1408856303,1408856843,2,3,540
10450800@N03,262,30,1408874111,1408875191,4,3,1080
10450800@N03,262,27,1408877260,1408878160,2,3,900
10450858@N02,263,26,1262993560,1262994460,1,1,900
10463848@N00,264,26,1295701912,1295702812,1,1,900
10463848@N00,265,26,1296207996,1296208896,1,1,900
104708298@N06,266,4,1458781587,1458781688,3,4,101
104708298@N06,266,26,1458790440,1458791340,5,4,900
104708298@N06,266,30,1458807567,1458808647,4,4,1080
104708298@N06,266,28,1458812250,1458813150,4,4,900
104708298@N06,267,26,1458882548,1458883448,1,1,900
104785013@N07,268,1,1362607377,1362607437,2,2,60
104785013@N07,268,21,1362609506,1362610076,1,2,570
104785013@N07,269,30,1453032102,1453033182,2,2,1080
104785013@N07,269,21,1453033266,1453033836,2,2,570
104785013@N07,270,19,1453165015,1453165555,3,2,540
104785013@N07,270,29,1453167647,1453168547,1,2,900
10485586@N05,271,18,1435896054,1435896504,1,1,450
10495641@N00,272,25,1368781062,1368781299,2,4,237
10495641@N00,272,12,1368781299,1368781539,2,4,240
10495641@N00,272,3,1368793481,1368793565,2,4,84
10495641@N00,272,13,1368793565,1368793805,1,4,240
10504927@N08,273,1,1372216425,1372216485,1,1,60
10528164@N08,274,28,1245390993,1245391893,8,2,900
10528164@N08,274,26,1245414973,1245415873,1,2,900
10528164@N08,275,23,1245460399,1245460999,4,1,600
10528164@N08,276,31,1245501119,1245502619,8,1,1500
10528164@N08,277,28,1245587000,1245587582,2,2,582
10528164@N08,277,29,1245587582,1245588482,3,2,900
105291794@N04,278,18,1440858445,1440858895,1,1,450
105307408@N06,279,1,1394579384,1394579444,1,1,60
105307408@N06,280,19,1403134086,1403134626,1,1,540
105307408@N06,281,18,1423945029,1423945479,1,1,450
10569110@N08,282,28,1337437437,1337438337,1,1,900
10572043@N03,283,26,1289565922,1289566822,1,1,900
10572043@N03,284,21,1299243454,1299244024,1,1,570
10572043@N03,285,29,1359181514,1359182414,1,1,900
105745254@N04,286,12,1198157182,1198157422,2,1,240
105745254@N04,287,26,1235759814,1235760714,1,1,900
105745254@N04,288,18,1350698125,1350698575,1,1,450
105745254@N04,289,9,1360372706,1360372886,2,2,180
105745254@N04,289,22,1360374840,1360375440,1,2,600
105745254@N04,290,19,1363405898,1363406438,2,1,540
105745254@N04,291,19,1382830383,1382830399,2,3,16
105745254@N04,291,29,1382830399,1382830459,2,3,60
105745254@N04,291,18,1382830459,1382830909,1,3,450
105745254@N04,292,12,1398483772,1398484012,1,1,240
105745254@N04,293,18,1405744131,1405744581,1,1,450
105745254@N04,294,5,1410506474,1410506594,1,1,120
105745254@N04,295,16,1459499632,1459499643,2,7,11
105745254@N04,295,27,1459499643,1459500543,2,7,900
105745254@N04,295,9,1459501887,1459502067,3,7,180
105745254@N04,295,6,1459502168,1459502288,3,7,120
105745254@N04,295,16,1459503668,1459503938,2,7,270
105745254@N04,295,15,1459506218,1459506488,3,7,270
105745254@N04,295,3,1459507373,1459507463,1,7,90
105745254@N04,296,26,1459543519,1459544419,3,1,900
105745254@N04,297,4,1459588279,1459588380,10,2,101
105745254@N04,297,25,1459588804,1459589644,1,2,840
10577654@N00,298,18,1447731325,1447731775,1,1,450
10577654@N00,299,18,1447762238,1447762688,1,1,450
105959704@N07,300,18,1444008089,1444008539,1,1,450
105959704@N07,301,26,1466676843,1466677743,1,1,900
105986324@N04,302,17,1400290921,1400291221,1,1,300
105986324@N04,303,27,1401507893,1401508793,1,1,900
106153498@N08,304,16,1295820573,1295820843,2,2,270
106153498@N08,304,26,1295825967,1295826867,12,2,900
106187463@N02,305,26,1380925718,1380926618,2,2,900
106187463@N02,305,30,1380939923,1380941003,1,2,1080
106228936@N07,306,1,1301181428,1301181488,5,3,60
106228936@N07,306,28,1301181934,1301182834,18,3,900
106228936@N07,306,1,1301191327,1301191387,38,3,60
106228936@N07,307,13,1301707782,1301707792,5,3,10
106228936@N07,307,21,1301707792,1301707795,3,3,3
106228936@N07,307,11,1301707795,1301708035,4,3,240
106228936@N07,308,13,1311738105,1311738345,5,1,240
106228936@N07,309,13,1313829008,1313829248,1,1,240
106228936@N07,310,31,1318034652,1318034716,6,3,64
106228936@N07,310,22,1318034716,1318035316,4,3,600
106228936@N07,310,29,1318052291,1318053191,2,3,900
10632018@N00,311,25,1275114357,1275115197,1,1,840
10635134@N00,312,10,1187925966,1187926206,2,3,240
10635134@N00,312,26,1187931271,1187932171,2,3,900
10635134@N00,312,28,1187940196,1187941096,1,3,900
10635134@N00,313,31,1338354047,1338355547,1,1,1500
10635276@N00,314,27,1348194223,1348195123,1,1,900
10635276@N00,315,31,1348227515,1348229015,1,1,1500
10651907@N02,316,1,1191484711,1191484771,10,1,60
10651907@N02,317,30,1191546864,1191547244,11,2,380
10651907@N02,317,14,1191547244,1191547484,56,2,240
10651907@N02,318,12,1191657856,1191658096,5,3,240
10651907@N02,318,26,1191663286,1191663359,3,3,73
10651907@N02,318,16,1191663359,1191663629,1,3,270
106602685@N05,319,1,1451134823,1451134883,81,5,60
106602685@N05,319,15,1451145262,1451145532,9,5,270
106602685@N05,319,3,1451147216,1451147306,2,5,90
106602685@N05,319,13,1451147664,1451147904,11,5,240
106602685@N05,319,26,1451152343,1451153243,5,5,900
106809490@N03,320,21,1261118720,1261119290,1,1,570
10681948@N00,321,13,1295814342,1295814582,1,1,240
10720724@N06,322,19,1416732837,1416733377,1,1,540
10725686@N00,323,22,1208240876,1208241476,1,1,600
10725686@N00,324,17,1208906575,1208906875,1,1,300
107339849@N03,325,1,1384384157,1384384217,6,2,60
107339849@N03,325,28,1384412716,1384413616,1,2,900
107339849@N03,326,1,1384477573,1384477633,14,1,60
107339849@N03,327,1,1384557318,1384557378,1,1,60
107339849@N03,328,1,1384662642,1384662702,1,1,60
107379654@N04,329,1,1437528373,1437528433,2,6,60
107379654@N04,329,16,1437535047,1437535317,5,6,270
107379654@N04,329,3,1437537017,1437537107,3,6,90
107379654@N04,329,7,1437540507,1437540687,4,6,180
107379654@N04,329,25,1437549433,1437550273,3,6,840
107379654@N04,329,19,1437558887,1437559427,1,6,540
107470608@N03,330,14,1227482019,1227482259,1,1,240
107470608@N03,331,15,1273409239,1273409509,2,2,270
107470608@N03,331,16,1273412726,1273412996,3,2,270
107470608@N03,332,18,1290551940,1290552390,2,10,450
107470608@N03,332,29,1290554076,1290554570,2,10,494
107470608@N03,332,31,1290554570,1290555066,2,10,496
107470608@N03,332,14,1290555066,1290555306,2,10,240
107470608@N03,332,16,1290555578,1290555848,2,10,270
107470608@N03,332,20,1290556182,1290556722,2,10,540
107470608@N03,332,16,1290558102,1290558372,2,10,270
107470608@N03,332,17,1290561799,1290562099,4,10,300
107470608@N03,332,16,1290563812,1290564082,2,10,270
107470608@N03,332,15,1290564319,1290564589,1,10,270
107470608@N03,333,1,1290641687,1290641747,2,36,60
107470608@N03,333,19,1290643007,1290643046,3,36,39
107470608@N03,333,18,1290643046,1290643077,2,36,31
107470608@N03,333,19,1290643077,1290643126,5,36,49
107470608@N03,333,20,1290643126,1290643158,2,36,32
107470608@N03,333,19,1290643158,1290643186,2,36,28
107470608@N03,333,20,1290643186,1290643726,4,36,540
107470608@N03,333,18,1290643900,1290644350,3,36,450
107470608@N03,333,29,1290645832,1290646732,4,36,900
107470608@N03,333,30,1290646849,1290647467,9,36,618
107470608@N03,333,18,1290647467,1290647860,2,36,393
107470608@N03,333,10,1290647860,1290647930,3,36,70
107470608@N03,333,30,1290647930,1290649010,3,36,1080
107470608@N03,333,16,1290649116,1290649367,2,36,251
107470608@N03,333,6,1290649367,1290649487,4,36,120
107470608@N03,333,26,1290650490,1290650642,2,36,152
107470608@N03,333,8,1290650642,1290650822,3,36,180
107470608@N03,333,26,1290650887,1290651105,6,36,218
107470608@N03,333,1,1290651105,1290651165,2,36,60
107470608@N03,333,28,1290651238,1290652138,3,36,900
107470608@N03,333,16,1290658703,1290658775,4,36,72
107470608@N03,333,26,1290658775,1290659571,2,36,796
107470608@N03,333,12,1290659571,1290659619,4,36,48
107470608@N03,333,16,1290659619,1290659630,2,36,11
107470608@N03,333,12,1290659630,1290659807,5,36,177
107470608@N03,333,16,1290659807,1290659828,2,36,21
107470608@N03,333,12,1290659828,1290660068,5,36,240
107470608@N03,333,8,1290661323,1290661503,3,36,180
107470608@N03,333,11,1290663534,1290663774,2,36,240
107470608@N03,333,16,1290664561,1290664831,2,36,270
107470608@N03,333,19,1290667417,1290667957,2,36,540
107470608@N03,333,30,1290670550,1290671630,5,36,1080
107470608@N03,333,18,1290671859,1290672178,2,36,319
107470608@N03,333,16,1290672178,1290672448,4,36,270
107470608@N03,333,27,1290682006,1290682906,2,36,900
107470608@N03,333,16,1290683344,1290683614,1,36,270
107470608@N03,334,1,1319151107,1319151167,2,12,60
107470608@N03,334,3,1319158730,1319158820,2,12,90
107470608@N03,334,26,1319159681,1319159962,2,12,281
107470608@N03,334,3,1319159962,1319159966,2,12,4
107470608@N03,334,15,1319159966,1319160236,2,12,270
107470608@N03,334,3,1319160789,1319160879,2,12,90
107470608@N03,334,26,1319161945,1319162845,2,12,900
107470608@N03,334,18,1319166464,1319166914,2,12,450
107470608@N03,334,26,1319167188,1319168088,2,12,900
107470608@N03,334,3,1319174916,1319175006,2,12,90
107470608@N03,334,1,1319183067,1319183127,2,12,60
107470608@N03,334,28,1319186286,1319187186,1,12,900
107470608@N03,335,26,1319260804,1319261704,2,4,900
107470608@N03,335,14,1319267785,1319268025,3,4,240
107470608@N03,335,3,1319268785,1319268875,5,4,90
107470608@N03,335,9,1319282347,1319282527,3,4,180
107470608@N03,336,16,1319324216,1319324486,2,4,270
107470608@N03,336,15,1319328473,1319328743,3,4,270
107470608@N03,336,26,1319330188,1319330299,2,4,111
107470608@N03,336,7,1319330299,1319330479,1,4,180
10752753@N05,337,1,1406202592,1406202652,2,5,60
10752753@N05,337,28,1406202786,1406203099,2,5,313
10752753@N05,337,17,1406203099,1406203399,2,5,300
10752753@N05,337,26,1406204038,1406204938,2,5,900
10752753@N05,337,24,1406206053,1406206833,1,5,780
107585607@N06,338,1,1383469162,1383469222,5,1,60
10782040@N07,339,13,1324688596,1324688836,1,1,240
107987296@N07,340,28,1400900729,1400901629,4,3,900
107987296@N07,340,26,1400902863,1400903763,5,3,900
107987296@N07,340,15,1400920317,1400920587,1,3,270
10805559@N02,341,26,1291707391,1291708291,1,1,900
108118224@N04,342,28,1408272133,1408273006,2,9,873
108118224@N04,342,25,1408273006,1408273261,3,9,255
108118224@N04,342,21,1408273261,1408273525,2,9,264
108118224@N04,342,4,1408273525,1408273626,4,9,101
108118224@N04,342,11,1408274577,1408274817,2,9,240
108118224@N04,342,20,1408276953,1408277138,3,9,185
108118224@N04,342,19,1408277138,1408277459,2,9,321
108118224@N04,342,26,1408277459,1408277745,2,9,286
108118224@N04,342,16,1408277745,1408278015,1,9,270
108118224@N04,343,26,1408615622,1408616522,2,2,900
108118224@N04,343,29,1408620466,1408621366,3,2,900
108118224@N04,344,4,1408797243,1408797344,1,1,101
10834229@N03,345,26,1238154052,1238154952,1,1,900
10837440@N03,346,27,1316332916,1316333816,3,1,900
108376534@N04,347,17,1385627810,1385627929,3,2,119
108376534@N04,347,16,1385627929,1385628199,1,2,270
108403902@N02,348,16,1424105517,1424105787,2,6,270
108403902@N02,348,27,1424109162,1424110062,6,6,900
108403902@N02,348,25,1424115632,1424115927,2,6,295
108403902@N02,348,3,1424115927,1424116017,2,6,90
108403902@N02,348,26,1424121044,1424121944,2,6,900
108403902@N02,348,29,1424126469,1424127369,3,6,900
108403902@N02,349,29,1424174411,1424175311,1,1,900
108411475@N04,350,17,1445734478,1445734778,1,1,300
10858077@N00,351,31,1205039087,1205040587,5,2,1500
10858077@N00,351,21,1205042651,1205043221,1,2,570
10858077@N00,352,18,1207619771,1207620221,1,1,450
10858077@N00,353,15,1218939240,1218939510,2,3,270
10858077@N00,353,24,1218939519,1218940299,2,3,780
10858077@N00,353,16,1218951555,1218951825,1,3,270
10858077@N00,354,21,1237966050,1237966620,2,2,570
10858077@N00,354,25,1237967237,1237968077,1,2,840
10858077@N00,355,21,1327226297,1327226867,5,1,570
10858077@N00,356,28,1328359396,1328360296,1,1,900
10858077@N00,357,29,1328961071,1328961971,2,1,900
10858077@N00,358,1,1333266556,1333266616,1,1,60
10858077@N00,359,29,1355540134,1355541034,1,1,900
108599313@N07,360,6,1394685409,1394685529,1,1,120
108599313@N07,361,26,1394765098,1394765998,1,1,900
10874966@N06,362,28,1253422158,1253423058,1,1,900
10910455@N04,363,28,1307411406,1307412306,2,2,900
10910455@N04,363,18,1307413137,1307413587,1,2,450
10925918@N03,364,22,1229224168,1229224768,1,1,600
10925918@N03,365,27,1243296321,1243297221,2,15,900
10925918@N03,365,31,1243316299,1243317799,2,15,1500
10925918@N03,365,27,1243321308,1243322208,2,15,900
10925918@N03,365,12,1243323645,1243323885,3,15,240
10925918@N03,365,26,1243325848,1243326748,3,15,900
10925918@N03,365,1,1243341093,1243341153,2,15,60
10925918@N03,365,30,1243341485,1243342565,2,15,1080
10925918@N03,365,14,1243350534,1243350774,2,15,240
10925918@N03,365,18,1243356681,1243357131,2,15,450
10925918@N03,365,12,1243385367,1243385607,2,15,240
10925918@N03,365,27,1243412021,1243412588,2,15,567
10925918@N03,365,24,1243412588,1243413368,2,15,780
10925918@N03,365,29,1243434420,1243435320,2,15,900
10925918@N03,365,13,1243443895,1243444135,4,15,240
10925918@N03,365,28,1243447241,1243448141,2,15,900
10925918@N03,366,22,1436327045,1436327645,1,1,600
10925918@N03,367,17,1436537481,1436537781,1,1,300
10947824@N07,368,13,1379482203,1379482443,1,1,240
109478840@N03,369,18,1427495657,1427496107,2,1,450
109478840@N03,370,20,1434528250,1434528790,1,1,540
109524982@N04,371,26,1393740714,1393741614,1,1,900
109524982@N04,372,26,1393824431,1393825331,1,1,900
109524982@N04,373,13,1395297674,1395297914,2,2,240
109524982@N04,373,29,1395298435,1395299335,1,2,900
109582237@N03,374,13,1372600800,1372601040,2,1,240
109641355@N04,375,3,1425804414,1425804504,1,1,90
10967865@N04,376,28,1272117936,1272118836,3,2,900
10967865@N04,376,26,1272119334,1272120234,1,2,900
10967865@N04,377,28,1327819535,1327820435,4,5,900
10967865@N04,377,20,1327825055,1327825595,3,5,540
10967865@N04,377,28,1327827688,1327828588,2,5,900
10967865@N04,377,26,1327828794,1327829694,2,5,900
10967865@N04,377,28,1327830646,1327831546,2,5,900
10967865@N04,378,26,1347585313,1347586213,1,1,900
10967865@N04,379,27,1382964919,1382965819,1,1,900
10967865@N04,380,28,1436193009,1436193909,1,1,900
10970592@N04,381,1,1388874807,1388874867,2,7,60
10970592@N04,381,27,1388875276,1388876176,2,7,900
10970592@N04,381,17,1388877924,1388878224,2,7,300
10970592@N04,381,29,1388887720,1388888620,2,7,900
10970592@N04,381,15,1388905035,1388905305,2,7,270
10970592@N04,381,14,1388915007,1388915130,2,7,123
10970592@N04,381,15,1388915130,1388915400,1,7,270
10974344@N00,382,30,1436609838,1436610918,4,1,1080
10989907@N07,383,1,1337557006,1337557066,2,14,60
10989907@N07,383,28,1337557166,1337557734,2,14,568
10989907@N07,383,26,1337557734,1337558101,2,14,367
10989907@N07,383,16,1337558101,1337558258,2,14,157
10989907@N07,383,27,1337558258,1337558410,2,14,152
10989907@N07,383,17,1337558410,1337558710,3,14,300
10989907@N07,383,15,1337559267,1337559537,5,14,270
10989907@N07,383,27,1337561969,1337562869,3,14,900
10989907@N07,383,25,1337563799,1337564639,6,14,840
10989907@N07,383,21,1337565440,1337566010,2,14,570
10989907@N07,383,13,1337567807,1337568047,3,14,240
10989907@N07,383,20,1337568190,1337568730,2,14,540
10989907@N07,383,13,1337570381,1337570621,4,14,240
10989907@N07,383,23,1337582136,1337582736,4,14,600
10990739@N05,384,22,1259021168,1259021768,2,1,600
10990739@N05,385,26,1259050777,1259051677,2,2,900
10990739@N05,385,28,1259064001,1259064901,3,2,900
110010883@N02,386,26,1405215331,1405216231,5,1,900
11013574@N07,387,17,1349493197,1349493497,1,1,300
11025175@N06,388,1,1385676742,1385676802,1,1,60
110286494@N07,389,28,1396718220,1396719120,2,7,900
110286494@N07,389,26,1396721899,1396722799,2,7,900
110286494@N07,389,13,1396740690,1396740930,5,7,240
110286494@N07,389,25,1396741841,1396742152,2,7,311
110286494@N07,389,13,1396742152,1396742392,2,7,240
110286494@N07,389,30,1396745977,1396747057,2,7,1080
110286494@N07,389,28,1396756050,1396756950,3,7,900
110286494@N07,390,28,1396800404,1396801304,4,1,900
11033661@N08,391,26,1363322105,1363323005,4,1,900
11033661@N08,392,27,1409354494,1409355394,1,1,900
11033661@N08,393,18,1454814392,1454814842,1,1,450
11042293@N04,394,1,1282270122,1282270182,13,1,60
110424783@N05,395,26,1389088679,1389089579,1,1,900
110565084@N04,396,26,1386074452,1386074459,2,3,7
110565084@N04,396,20,1386074459,1386074466,2,3,7
110565084@N04,396,26,1386074466,1386075366,2,3,900
110565084@N04,397,28,1391497855,1391497869,2,4,14
110565084@N04,397,12,1391497869,1391497930,4,4,61
110565084@N04,397,15,1391497930,1391498200,3,4,270
110565084@N04,397,24,1391498230,1391499010,1,4,780
11058168@N04,398,28,1338383502,1338384402,1,1,900
11058168@N04,399,28,1338716437,1338717337,1,1,900
110647128@N03,400,1,1387799215,1387799275,1,1,60
11071376@N07,401,18,1243983362,1243983812,7,5,450
11071376@N07,401,7,1243985804,1243985984,2,5,180
11071376@N07,401,13,1243999217,1243999457,7,5,240
11071376@N07,401,26,1244004976,1244005876,2,5,900
11071376@N07,401,7,1244026011,1244026191,3,5,180
11085764@N05,402,29,1343320452,1343321352,1,1,900
110888119@N08,403,28,1388659666,1388660566,1,1,900
110888119@N08,404,26,1392695904,1392696804,1,1,900
110968252@N02,405,15,1431238503,1431238773,1,1,270
11126361@N06,406,30,1262308223,1262309303,88,1,1080
11126361@N06,407,30,1293848955,1293850035,1,1,1080
11126361@N06,408,30,1293895186,1293896266,10,1,1080
11130549@N08,409,26,1243822199,1243823099,16,1,900
11130549@N08,410,26,1243929668,1243930568,19,1,900
111329164@N07,411,25,1416037394,1416038234,1,1,840
11136593@N05,412,26,1195685670,1195686570,1,1,900
11166803@N05,413,26,1296989629,1296990529,1,1,900
111750816@N06,414,18,1432514622,1432515072,1,1,450
111750816@N06,415,3,1432894469,1432894559,1,1,90
111750816@N06,416,25,1434501978,1434502818,1,1,840
111750816@N06,417,26,1436577290,1436578190,1,1,900
111750816@N06,418,26,1437732547,1437733447,2,2,900
111750816@N06,418,29,1437742612,1437743512,1,2,900
111750816@N06,419,25,1440448583,1440449423,1,1,840
111750816@N06,420,18,1441149017,1441149467,1,1,450
111750816@N06,421,28,1441414547,1441415447,1,1,900
111750816@N06,422,18,1441547087,1441547537,1,1,450
111750816@N06,423,18,1441719730,1441720180,1,1,450
111750816@N06,424,25,1441966452,1441967292,1,1,840
111750816@N06,425,18,1442018401,1442018851,2,2,450
111750816@N06,425,1,1442022306,1442022366,1,2,60
111750816@N06,426,25,1443175697,1443176537,1,1,840
111750816@N06,427,26,1445324188,1445325088,1,1,900
111750816@N06,428,4,1445755925,1445756026,1,1,101
111750816@N06,429,18,1445924120,1445924570,1,1,450
111750816@N06,430,21,1446527201,1446527771,1,1,570
111750816@N06,431,25,1447744302,1447745142,2,1,840
111750816@N06,432,18,1448955585,1448956035,1,1,450
111750816@N06,433,25,1450913197,1450914037,1,1,840
111750816@N06,434,12,1455863283,1455863523,1,1,240
111750816@N06,435,28,1457498825,1457499725,1,1,900
111750816@N06,436,25,1457572909,1457573749,1,1,840
111750816@N06,437,27,1458644351,1458645251,2,1,900
111750816@N06,438,7,1459055363,1459055543,1,1,180
111750816@N06,439,26,1459847299,1459848199,1,1,900
111750816@N06,440,4,1460187783,1460187884,2,2,101
111750816@N06,440,25,1460198316,1460199156,1,2,840
111750816@N06,441,25,1463294201,1463295041,1,1,840
111750816@N06,442,26,1463467437,1463468337,1,1,900
111750816@N06,443,25,1463896914,1463897754,1,1,840
111750816@N06,444,30,1464763944,1464765024,2,2,1080
111750816@N06,444,22,1464767593,1464768193,1,2,600
111750816@N06,445,28,1465538881,1465539578,2,2,697
111750816@N06,445,26,1465539578,1465540478,1,2,900
111750816@N06,446,26,1467098213,1467099113,1,1,900
111750816@N06,447,1,1467618018,1467618078,1,1,60
11216630@N00,448,25,1259658590,1259659430,2,1,840
112167218@N08,449,1,1419927880,1419927940,5,6,60
112167218@N08,449,28,1419928139,1419929039,5,6,900
112167218@N08,449,27,1419930019,1419930919,3,6,900
112167218@N08,449,24,1419933816,1419933821,2,6,5
112167218@N08,449,26,1419933821,1419934250,11,6,429
112167218@N08,449,28,1419934250,1419935150,3,6,900
112298613@N07,450,28,1409100276,1409101176,2,4,900
112298613@N07,450,19,1409101362,1409101902,2,4,540
112298613@N07,450,22,1409102858,1409103458,6,4,600
112298613@N07,450,14,1409105223,1409105463,6,4,240
11260538@N06,451,17,1360624615,1360624915,2,3,300
11260538@N06,451,5,1360625932,1360626052,2,3,120
11260538@N06,451,7,1360627179,1360627359,1,3,180
11260538@N06,452,29,1361436121,1361437021,1,1,900
11260538@N06,453,28,1361539500,1361540400,1,1,900
112627165@N06,454,19,1408805773,1408806313,1,1,540
112659844@N02,455,16,1407897737,1407898007,1,1,270
112711747@N06,456,26,1398815980,1398816880,2,3,900
112711747@N06,456,19,1398821545,1398822085,2,3,540
112711747@N06,456,29,1398828340,1398829240,1,3,900
112721782@N02,457,1,1464776851,1464776911,1,1,60
11276497@N00,458,26,1296801189,1296802089,1,1,900
112828108@N08,459,23,1409316172,1409316770,2,4,598
112828108@N08,459,18,1409316770,1409317220,3,4,450
112828108@N08,459,29,1409319685,1409320585,5,4,900
112828108@N08,459,18,1409321524,1409321974,1,4,450
112828108@N08,460,30,1410486116,1410486685,2,5,569
112828108@N08,460,3,1410486685,1410486775,2,5,90
112828108@N08,460,12,1410487581,1410487821,2,5,240
112828108@N08,460,25,1410488994,1410489834,4,5,840
112828108@N08,460,18,1410512466,1410512916,1,5,450
112828108@N08,461,30,1428402245,1428403325,3,1,1080
112828108@N08,462,16,1442996213,1442996483,3,1,270
112828108@N08,463,20,1443915780,1443916320,4,2,540
112828108@N08,463,16,1443919613,1443919883,1,2,270
112828108@N08,464,17,1444178425,1444178725,2,3,300
112828108@N08,464,22,1444183530,1444183914,2,3,384
112828108@N08,464,25,1444183914,1444184754,1,3,840
112828108@N08,465,16,1451890356,1451890626,2,3,270
112828108@N08,465,21,1451893922,1451894492,8,3,570
112828108@N08,465,13,1451904249,1451904489,1,3,240
112828108@N08,466,28,1452034978,1452035878,2,3,900
112828108@N08,466,24,1452040878,1452041658,2,3,780
112828108@N08,466,30,1452044563,1452045643,1,3,1080
112828108@N08,467,16,1452077821,1452078091,1,1,270
112828108@N08,468,26,1458011665,1458012565,3,2,900
112828108@N08,468,16,1458027933,1458028203,2,2,270
112920986@N06,469,16,1384751593,1384751863,3,2,270
112920986@N06,469,28,1384754618,1384755518,2,2,900
11312146@N04,470,18,1441481479,1441481929,1,1,450
113144149@N03,471,1,1388919064,1388919124,1,1,60
113224973@N02,472,1,1452921098,1452921158,1,1,60
113224973@N02,473,26,1453344675,1453345575,1,1,900
11331418@N00,474,16,1360407446,1360407716,2,1,270
11331418@N00,475,7,1362473496,1362473676,1,1,180
11331418@N00,476,12,1365411686,1365411926,1,1,240
11331418@N00,477,7,1370381129,1370381309,1,1,180
11331418@N00,478,27,1370780934,1370781834,1,1,900
11351590@N00,479,1,1229169818,1229169878,1,1,60
11351590@N00,480,1,1229822644,1229822704,64,1,60
11355999@N08,481,10,1206591891,1206592131,41,1,240
11355999@N08,482,15,1279599738,1279600008,1,1,270
11355999@N08,483,24,1318412552,1318413332,1,1,780
11355999@N08,484,26,1321260444,1321261344,1,1,900
11355999@N08,485,1,1374018101,1374018161,1,1,60
11374644@N06,486,1,1226105540,1226105600,5,15,60
11374644@N06,486,28,1226105914,1226106814,3,15,900
11374644@N06,486,24,1226109563,1226110343,9,15,780
11374644@N06,486,13,1226111715,1226111955,37,15,240
11374644@N06,486,6,1226114658,1226114778,2,15,120
11374644@N06,486,31,1226114937,1226115307,3,15,370
11374644@N06,486,29,1226115307,1226116207,2,15,900
11374644@N06,486,22,1226118132,1226118543,12,15,411
11374644@N06,486,14,1226118543,1226118783,29,15,240
11374644@N06,486,22,1226120349,1226120563,2,15,214
11374644@N06,486,29,1226120563,1226120760,2,15,197
11374644@N06,486,26,1226120760,1226121660,32,15,900
11374644@N06,486,28,1226121853,1226122753,12,15,900
11374644@N06,486,26,1226139951,1226140851,9,15,900
11374644@N06,486,28,1226158722,1226159622,1,15,900
11374644@N06,487,28,1226196477,1226196807,6,10,330
11374644@N06,487,26,1226196807,1226197290,25,10,483
11374644@N06,487,6,1226197290,1226197410,2,10,120
11374644@N06,487,22,1226199926,1226200526,2,10,600
11374644@N06,487,30,1226201647,1226201699,2,10,52
11374644@N06,487,22,1226201699,1226202299,2,10,600
11374644@N06,487,1,1226203000,1226203060,7,10,60
11374644@N06,487,28,1226203371,1226203771,6,10,400
11374644@N06,487,26,1226203771,1226204671,8,10,900
11374644@N06,487,28,1226204807,1226205707,6,10,900
11374644@N06,488,1,1226964998,1226965058,2,7,60
11374644@N06,488,28,1226965082,1226965689,2,7,607
11374644@N06,488,26,1226965689,1226966589,17,7,900
11374644@N06,488,14,1226973048,1226973288,23,7,240
11374644@N06,488,22,1226974043,1226974643,2,7,600
11374644@N06,488,26,1226979103,1226980003,2,7,900
11374644@N06,488,28,1226981449,1226982349,3,7,900
11374644@N06,489,26,1228256800,1228257125,2,4,325
11374644@N06,489,13,1228257125,1228257365,4,4,240
11374644@N06,489,22,1228257609,1228257751,2,4,142
11374644@N06,489,14,1228257751,1228257991,3,4,240
11374644@N06,490,1,1383698241,1383698301,2,27,60
11374644@N06,490,28,1383698446,1383698939,6,27,493
11374644@N06,490,26,1383698939,1383699766,9,27,827
11374644@N06,490,6,1383699766,1383699829,2,27,63
11374644@N06,490,26,1383699829,1383700363,3,27,534
11374644@N06,490,3,1383700363,1383700453,2,27,90
11374644@N06,490,21,1383700527,1383701097,6,27,570
11374644@N06,490,4,1383701647,1383701679,2,27,32
11374644@N06,490,11,1383701679,1383701825,4,27,146
11374644@N06,490,4,1383701825,1383701926,2,27,101
11374644@N06,490,3,1383702094,1383702184,2,27,90
11374644@N06,490,21,1383702315,1383702871,3,27,556
11374644@N06,490,13,1383702871,1383703111,18,27,240
11374644@N06,490,21,1383706383,1383706390,2,27,7
11374644@N06,490,13,1383706390,1383706435,2,27,45
11374644@N06,490,21,1383706435,1383707005,4,27,570
11374644@N06,490,30,1383708204,1383709284,4,27,1080
11374644@N06,490,31,1383710222,1383710288,2,27,66
11374644@N06,490,29,1383710288,1383710292,2,27,4
11374644@N06,490,20,1383710292,1383710832,2,27,540
11374644@N06,490,14,1383711233,1383711473,16,27,240
11374644@N06,490,22,1383711954,1383712061,2,27,107
11374644@N06,490,14,1383712061,1383712301,4,27,240
11374644@N06,490,22,1383712830,1383713017,2,27,187
11374644@N06,490,29,1383713017,1383713917,2,27,900
11374644@N06,490,28,1383714804,1383715487,11,27,683
11374644@N06,490,1,1383715487,1383715547,1,27,60
11374644@N06,491,1,1383778902,1383778962,2,14,60
11374644@N06,491,28,1383779462,1383780056,9,14,594
11374644@N06,491,26,1383780056,1383780263,4,14,207
11374644@N06,491,18,1383780263,1383780713,6,14,450
11374644@N06,491,19,1383781515,1383781540,2,14,25
11374644@N06,491,29,1383781540,1383781580,2,14,40
11374644@N06,491,19,1383781580,1383782120,3,14,540
11374644@N06,491,23,1383782263,1383782813,2,14,550
11374644@N06,491,26,1383782813,1383783713,3,14,900
11374644@N06,491,11,1383784453,1383784693,2,14,240
11374644@N06,491,13,1383785202,1383785442,11,14,240
11374644@N06,491,6,1383786916,1383787036,2,14,120
11374644@N06,491,26,1383787089,1383787989,5,14,900
11374644@N06,491,28,1383790161,1383791061,2,14,900
11374644@N06,492,28,1383890746,1383891646,2,2,900
11374644@N06,492,1,1383892272,1383892332,27,2,60
11387250@N02,493,29,1215922947,1215923847,1,1,900
11393022@N00,494,27,1319411280,1319412180,1,1,900
11401724@N05,495,18,1434238738,1434239188,1,1,450
11401724@N05,496,18,1434595280,1434595730,1,1,450
11401724@N05,497,18,1446350613,1446351063,3,1,450
11401724@N05,498,27,1462852681,1462853581,1,1,900
11405513@N06,499,17,1419302615,1419302915,1,1,300
11429691@N03,500,29,1299925599,1299925726,3,3,127
11429691@N03,500,24,1299925726,1299925732,2,3,6
11429691@N03,500,30,1299925732,1299926812,1,3,1080
114343416@N06,501,26,1364159644,1364160544,1,1,900
11434691@N07,502,1,1366704844,1366704904,2,6,60
11434691@N07,502,28,1366724192,1366725092,6,6,900
11434691@N07,502,18,1366725128,1366725130,2,6,2
11434691@N07,502,1,1366725130,1366725190,3,6,60
11434691@N07,502,27,1366732289,1366733189,3,6,900
11434691@N07,502,17,1366735478,1366735778,1,6,300
11438926@N00,503,28,1275794651,1275795551,1,1,900
11438926@N00,504,1,1292239826,1292239886,2,10,60
11438926@N00,504,28,1292240122,1292241022,6,10,900
11438926@N00,504,20,1292243113,1292243301,2,10,188
11438926@N00,504,19,1292243301,1292243447,2,10,146
11438926@N00,504,30,1292243447,1292244033,2,10,586
11438926@N00,504,21,1292244033,1292244410,3,10,377
11438926@N00,504,12,1292244410,1292244650,3,10,240
11438926@N00,504,21,1292244684,1292245226,6,10,542
11438926@N00,504,7,1292245226,1292245406,3,10,180
11438926@N00,504,28,1292245785,1292246685,2,10,900
11438926@N00,505,17,1317429382,1317429682,4,1,300
11438926@N00,506,29,1319176697,1319177597,1,1,900
11438926@N00,507,28,1323765705,1323766605,4,5,900
11438926@N00,507,23,1323767005,1323767605,2,5,600
11438926@N00,507,30,1323767732,1323768812,2,5,1080
11438926@N00,507,29,1323771007,1323771903,2,5,896
11438926@N00,507,13,1323771903,1323772143,6,5,240
11438926@N00,508,31,1331544345,1331545845,1,1,1500
11438926@N00,509,14,1370430016,1370430256,12,2,240
11438926@N00,509,20,1370432693,1370433233,2,2,540
11441631@N00,510,28,1349487234,1349488134,3,4,900
11441631@N00,510,20,1349494359,1349494386,2,4,27
11441631@N00,510,29,1349494386,1349494783,2,4,397
11441631@N00,510,20,1349494783,1349495323,1,4,540
11441631@N00,511,28,1351290290,1351291190,2,2,900
11441631@N00,511,29,1351307359,1351308259,1,2,900
11441631@N00,512,28,1352524144,1352525044,1,1,900
11441631@N00,513,1,1355985604,1355985664,1,1,60
11441631@N00,514,1,1358059417,1358059477,2,2,60
11441631@N00,514,28,1358060577,1358061477,1,2,900
11441631@N00,515,1,1389486807,1389486867,2,3,60
11441631@N00,515,25,1389498194,1389499034,2,3,840
11441631@N00,515,18,1389502155,1389502605,1,3,450
11441631@N00,516,1,1391899377,1391899437,2,1,60
114698947@N03,517,1,1467698216,1467698276,3,6,60
114698947@N03,517,28,1467698477,1467698598,2,6,121
114698947@N03,517,26,1467698598,1467699498,3,6,900
114698947@N03,517,27,1467712609,1467713509,2,6,900
114698947@N03,517,26,1467718225,1467719063,3,6,838
114698947@N03,517,23,1467719063,1467719663,4,6,600
114818743@N02,518,29,1393026813,1393026916,2,4,103
114818743@N02,518,18,1393026916,1393027366,11,4,450
114818743@N02,518,29,1393037359,1393037401,2,4,42
114818743@N02,518,18,1393037401,1393037851,14,4,450
11495990@N00,519,6,1321241606,1321241726,1,1,120
11504096@N08,520,22,1310873293,1310873531,4,32,238
11504096@N08,520,16,1310873531,1310873801,5,32,270
11504096@N08,520,26,1310875313,1310875692,2,32,379
11504096@N08,520,14,1310875692,1310875932,12,32,240
11504096@N08,520,20,1310877318,1310877858,6,32,540
11504096@N08,520,27,1310882305,1310883205,4,32,900
11504096@N08,520,28,1310883745,1310884645,2,32,900
11504096@N08,520,16,1310886977,1310887189,2,32,212
11504096@N08,520,28,1310887189,1310887782,3,32,593
11504096@N08,520,21,1310887782,1310887821,2,32,39
11504096@N08,520,28,1310887821,1310888065,2,32,244
11504096@N08,520,21,1310888065,1310888531,3,32,466
11504096@N08,520,28,1310888531,1310889431,2,32,900
11504096@N08,520,7,1310889563,1310889743,3,32,180
11504096@N08,520,11,1310890063,1310890303,5,32,240
11504096@N08,520,13,1310891832,1310892072,5,32,240
11504096@N08,520,21,1310892547,1310893117,14,32,570
11504096@N08,520,13,1310894591,1310894596,2,32,5
11504096@N08,520,22,1310894596,1310895015,5,32,419
11504096@N08,520,13,1310895015,1310895022,2,32,7
11504096@N08,520,10,1310895022,1310895262,2,32,240
11504096@N08,520,13,1310895456,1310895696,4,32,240
11504096@N08,520,30,1310896504,1310896614,2,32,110
11504096@N08,520,10,1310896614,1310896854,2,32,240
11504096@N08,520,22,1310896873,1310897049,2,32,176
11504096@N08,520,30,1310897049,1310898129,7,32,1080
11504096@N08,520,12,1310901703,1310901943,5,32,240
11504096@N08,520,8,1310904002,1310904107,3,32,105
11504096@N08,520,28,1310904107,1310904976,2,32,869
11504096@N08,520,20,1310904976,1310905124,3,32,148
11504096@N08,520,22,1310905124,1310905724,3,32,600
11504096@N08,520,28,1310909045,1310909945,4,32,900
115142813@N02,521,1,1403431818,1403431878,2,2,60
115142813@N02,521,26,1403432559,1403433459,1,2,900
115142813@N02,522,26,1405844555,1405845455,3,1,900
115142813@N02,523,26,1413702372,1413703272,3,1,900
115142813@N02,524,26,1421620925,1421621825,5,2,900
115142813@N02,524,25,1421624767,1421625607,1,2,840
115142813@N02,525,6,1421653988,1421654108,1,1,120
11518890@N00,526,26,1458412294,1458413194,1,1,900
11518890@N00,527,26,1467340728,1467341628,1,1,900
11520748@N06,528,4,1313277268,1313277369,2,2,101
11520748@N06,528,7,1313277452,1313277632,1,2,180
115291928@N03,529,21,1389252410,1389252980,3,5,570
115291928@N03,529,13,1389256093,1389256333,2,5,240
115291928@N03,529,6,1389258366,1389258486,2,5,120
115291928@N03,529,1,1389260350,1389260367,2,5,17
115291928@N03,529,28,1389260367,1389261267,4,5,900
11531429@N07,530,26,1297988053,1297988953,1,1,900
11531429@N07,531,29,1298071772,1298072672,1,1,900
115394627@N08,532,1,1393116995,1393117055,2,4,60
115394627@N08,532,3,1393118469,1393118559,2,4,90
115394627@N08,532,7,1393122518,1393122698,2,4,180
115394627@N08,532,13,1393123894,1393124134,1,4,240
11541209@N06,533,28,1189327098,1189327998,1,1,900
11541209@N06,534,26,1190215013,1190215100,6,2,87
11541209@N06,534,20,1190215100,1190215640,1,2,540
11541209@N06,535,26,1190794021,1190794027,2,2,6
11541209@N06,535,28,1190794027,1190794927,1,2,900
11541209@N06,536,26,1194644715,1194645615,6,1,900
11541209@N06,537,26,1195238164,1195239064,6,1,900
11541209@N06,538,26,1221223649,1221224549,4,2,900
11541209@N06,538,28,1221226291,1221227191,1,2,900
11541209@N06,539,22,1221826755,1221827355,1,1,600
11541209@N06,540,26,1222947652,1222948552,1,1,900
11541209@N06,541,3,1226244838,1226244928,1,1,90
11541209@N06,542,28,1226705773,1226706673,1,1,900
11541209@N06,543,25,1227170269,1227171109,1,1,840
11541209@N06,544,26,1227304875,1227305775,1,1,900
11541209@N06,545,25,1228139115,1228139955,1,1,840
11541209@N06,546,25,1233828676,1233829516,4,1,840
11541209@N06,547,30,1236680090,1236680184,2,2,94
11541209@N06,547,23,1236680184,1236680784,1,2,600
11541209@N06,548,31,1243640076,1243641177,3,3,1101
11541209@N06,548,30,1243641177,1243642253,2,3,1076
11541209@N06,548,29,1243642253,1243643153,1,3,900
11541209@N06,549,26,1243826281,1243827181,1,1,900
11541209@N06,550,30,1244204059,1244205139,2,1,1080
11541209@N06,551,30,1244616826,1244617906,1,1,1080
11541209@N06,552,26,1244808592,1244809214,2,2,622
11541209@N06,552,16,1244809214,1244809484,4,2,270
11541209@N06,553,20,1249042619,1249043159,1,1,540
11541209@N06,554,30,1251873187,1251874267,1,1,1080
11541209@N06,555,1,1261390290,1261390350,1,1,60
11541209@N06,556,28,1263875940,1263876821,2,2,881
11541209@N06,556,26,1263876821,1263877721,1,2,900
11541209@N06,557,13,1265703310,1265703550,4,1,240
11541209@N06,558,26,1304921140,1304922040,4,2,900
11541209@N06,558,1,1304927047,1304927107,1,2,60
11541209@N06,559,26,1309230118,1309231018,1,1,900
11541209@N06,560,26,1309530380,1309531280,1,1,900
11541209@N06,561,26,1322474588,1322475488,2,1,900
11541209@N06,562,25,1322560699,1322561516,2,2,817
11541209@N06,562,29,1322561516,1322562416,1,2,900
11541209@N06,563,8,1329291852,1329292032,2,3,180
11541209@N06,563,3,1329292310,1329292400,2,3,90
11541209@N06,563,22,1329294334,1329294934,1,3,600
11541209@N06,564,25,1353679251,1353680091,2,4,840
11541209@N06,564,20,1353680629,1353681169,2,4,540
11541209@N06,564,26,1353682275,1353682655,2,4,380
11541209@N06,564,28,1353682655,1353683555,1,4,900
11541209@N06,565,29,1353755876,1353756776,1,1,900
11543886@N00,566,18,1450823229,1450823679,3,2,450
11543886@N00,566,22,1450832669,1450833269,1,2,600
11566207@N08,567,31,1419913089,1419914589,2,2,1500
11566207@N08,567,29,1419934404,1419935304,2,2,900
11566207@N08,568,29,1434860122,1434861022,3,3,900
11566207@N08,568,4,1434879815,1434879823,2,3,8
11566207@N08,568,11,1434879823,1434880063,2,3,240
11566207@N08,569,17,1449284299,1449284599,2,3,300
11566207@N08,569,14,1449290691,1449290931,2,3,240
11566207@N08,569,29,1449301023,1449301923,1,3,900
11566207@N08,570,17,1451088970,1451089270,1,1,300
11566207@N08,571,29,1455419076,1455419976,2,1,900
11566531@N05,572,26,1336131078,1336131978,1,1,900
11613283@N00,573,30,1212539972,1212541052,1,1,1080
11613408@N05,574,17,1281916771,1281917071,1,1,300
116142246@N08,575,1,1388880102,1388880162,1,1,60
11631833@N00,576,24,1369546480,1369547260,1,1,780
11640161@N03,577,20,1365028013,1365028553,1,1,540
11640161@N03,578,12,1365057563,1365057803,2,1,240
116696583@N07,579,13,1402639576,1402639816,4,1,240
116696583@N07,580,25,1415403153,1415403993,4,2,840
116696583@N07,580,20,1415408631,1415409171,2,2,540
116915458@N03,581,7,1401190179,1401190359,1,1,180
116915458@N03,582,1,1402310108,1402310168,1,1,60
116915458@N03,583,1,1402364507,1402364567,1,1,60
11712374@N03,584,24,1234313366,1234314146,2,1,780
11712374@N03,585,6,1238668363,1238668483,1,1,120
11712374@N03,586,17,1240537350,1240537526,2,3,176
11712374@N03,586,22,1240537526,1240538126,2,3,600
11712374@N03,586,12,1240538265,1240538505,1,3,240
11734370@N06,587,26,1276311126,1276311367,2,3,241
11734370@N06,587,16,1276311367,1276311637,3,3,270
11734370@N06,587,23,1276317565,1276318165,1,3,600
117406028@N08,588,17,1329713425,1329713725,1,1,300
11769292@N00,589,16,1387781057,1387781327,1,1,270
117714299@N03,590,7,1395035010,1395035190,1,1,180
117714299@N03,591,16,1395354523,1395354793,2,2,270
117714299@N03,591,30,1395356847,1395357927,1,2,1080
117714299@N03,592,30,1396999875,1397000955,2,2,1080
117714299@N03,592,27,1397002936,1397003836,1,2,900
117714299@N03,593,26,1398121361,1398122261,1,1,900
117714299@N03,594,17,1413006868,1413007168,2,2,300
117714299@N03,594,27,1413011507,1413012407,1,2,900
117931874@N07,595,21,1357779054,1357779624,1,1,570
118043454@N05,596,1,1395408026,1395408086,1,1,60
118043454@N05,597,4,1403582498,1403582599,1,1,101
118043454@N05,598,1,1406470913,1406470973,1,1,60
118043454@N05,599,1,1408073926,1408073986,1,1,60
118043454@N05,600,1,1413628698,1413628758,1,1,60
11805483@N00,601,29,1355662623,1355663523,1,1,900
11806003@N05,602,18,1445050925,1445051375,2,4,450
11806003@N05,602,22,1445055084,1445055684,2,4,600
11806003@N05,602,18,1445055992,1445056442,4,4,450
11806003@N05,602,23,1445092133,1445092733,1,4,600
118143585@N05,603,27,1316737145,1316738045,2,2,900
118143585@N05,603,16,1316739219,1316739489,1,2,270
11825945@N00,604,29,1391911793,1391912693,1,1,900
11836258@N05,605,27,1293439649,1293440549,8,3,900
11836258@N05,605,26,1293455129,1293456029,6,3,900
11836258@N05,605,25,1293459783,1293460623,1,3,840
11840939@N06,606,27,1380434467,1380434483,2,4,16
11840939@N06,606,16,1380434483,1380434503,2,4,20
11840939@N06,606,28,1380434503,1380434538,3,4,35
11840939@N06,606,16,1380434538,1380434808,1,4,270
11840939@N06,607,27,1382926951,1382927036,2,4,85
11840939@N06,607,16,1382927036,1382927193,2,4,157
11840939@N06,607,28,1382927193,1382928093,2,4,900
11840939@N06,607,16,1382929653,1382929923,1,4,270
118425217@N03,608,17,1388704503,1388704803,2,1,300
11844862@N00,609,17,1359437241,1359437541,1,1,300
11844862@N00,610,12,1359591242,1359591482,2,2,240
11844862@N00,610,15,1359595074,1359595344,1,2,270
118478058@N08,611,16,1374370116,1374370386,3,2,270
118478058@N08,611,13,1374388665,1374388905,2,2,240
11849171@N00,612,15,1214978098,1214978368,2,2,270
11849171@N00,612,26,1215001246,1215002146,3,2,900
11849171@N00,613,15,1216643724,1216643756,2,2,32
11849171@N00,613,28,1216643756,1216644656,1,2,900
11855439@N00,614,3,1227351109,1227351199,1,1,90
11855439@N00,615,3,1227833790,1227833880,1,1,90
11855439@N00,616,14,1239931666,1239931906,2,3,240
11855439@N00,616,1,1239932525,1239932585,2,3,60
11855439@N00,616,28,1239932786,1239933686,3,3,900
11855439@N00,617,10,1245415330,1245415570,1,1,240
11855439@N00,618,1,1306283379,1306283439,2,6,60
11855439@N00,618,28,1306283613,1306283736,2,6,123
11855439@N00,618,26,1306283736,1306284636,2,6,900
11855439@N00,618,30,1306286669,1306287749,2,6,1080
11855439@N00,618,19,1306292058,1306292598,2,6,540
11855439@N00,618,26,1306298914,1306299814,1,6,900
118814458@N03,619,29,1392959569,1392960469,1,1,900
11901577@N03,620,29,1360385046,1360385946,2,3,900
11901577@N03,620,17,1360392473,1360392773,2,3,300
11901577@N03,620,28,1360394075,1360394975,1,3,900
11901577@N03,621,28,1366093033,1366093933,2,3,900
11901577@N03,621,15,1366095805,1366096075,2,3,270
11901577@N03,621,27,1366096996,1366097896,1,3,900
11901577@N03,622,1,1370816125,1370816185,1,1,60
11901577@N03,623,27,1399191443,1399192343,3,2,900
11901577@N03,623,16,1399200418,1399200688,1,2,270
11901577@N03,624,26,1399860176,1399861076,1,1,900
11901577@N03,625,24,1401693364,1401694144,1,1,780
11901577@N03,626,19,1402834898,1402835438,2,2,540
11901577@N03,626,1,1402842465,1402842525,1,2,60
11901577@N03,627,19,1413529270,1413529810,1,1,540
11901577@N03,628,19,1413594843,1413595383,3,4,540
11901577@N03,628,30,1413621908,1413622988,2,4,1080
11901577@N03,628,19,1413631907,1413632447,2,4,540
11901577@N03,628,17,1413637363,1413637663,1,4,300
11901577@N03,629,30,1414028512,1414029592,1,1,1080
11901577@N03,630,19,1414660672,1414661212,1,1,540
11901577@N03,631,19,1415254345,1415254885,2,1,540
11901577@N03,632,19,1417676110,1417676650,1,1,540
11901577@N03,633,30,1424607196,1424607557,2,2,361
11901577@N03,633,20,1424607557,1424608097,1,2,540
11901577@N03,634,27,1426159783,1426160683,1,1,900
11901577@N03,635,30,1427722448,1427723528,1,1,1080
11901577@N03,636,1,1428241567,1428241627,1,1,60
11901577@N03,637,18,1429076803,1429077253,2,2,450
11901577@N03,637,17,1429084129,1429084429,1,2,300
11901577@N03,638,18,1431871003,1431871453,1,1,450
11901577@N03,639,30,1434977605,1434978685,1,1,1080
11901577@N03,640,18,1436177169,1436177619,1,1,450
11901577@N03,641,18,1438179911,1438180361,1,1,450
11901577@N03,642,18,1442753352,1442753802,1,1,450
11909642@N05,643,22,1208551327,1208551927,2,21,600
11909642@N05,643,1,1208559119,1208559179,2,21,60
11909642@N05,643,28,1208559225,1208559436,2,21,211
11909642@N05,643,18,1208559436,1208559481,2,21,45
11909642@N05,643,23,1208559481,1208559574,3,21,93
11909642@N05,643,18,1208559574,1208560024,3,21,450
11909642@N05,643,19,1208560216,1208560756,7,21,540
11909642@N05,643,29,1208561896,1208562796,13,21,900
11909642@N05,643,20,1208563694,1208564234,3,21,540
11909642@N05,643,31,1208565115,1208565331,6,21,216
11909642@N05,643,23,1208565331,1208565398,2,21,67
11909642@N05,643,30,1208565398,1208565820,3,21,422
11909642@N05,643,26,1208565820,1208566369,8,21,549
11909642@N05,643,21,1208566369,1208566382,2,21,13
11909642@N05,643,4,1208566382,1208566483,2,21,101
11909642@N05,643,16,1208566725,1208566756,2,21,31
11909642@N05,643,26,1208566756,1208566949,2,21,193
11909642@N05,643,19,1208566949,1208567489,2,21,540
11909642@N05,643,16,1208569712,1208569982,2,21,270
11909642@N05,643,17,1208572614,1208572914,2,21,300
11909642@N05,643,12,1208573347,1208573587,1,21,240
11930160@N07,644,28,1196470071,1196470971,1,1,900
11949829@N04,645,28,1187967270,1187968170,1,1,900
11949829@N04,646,28,1188304780,1188305680,1,1,900
11949829@N04,647,26,1191545470,1191546370,2,2,900
11949829@N04,647,13,1191552703,1191552943,1,2,240
11949829@N04,648,30,1194241824,1194242055,3,3,231
11949829@N04,648,26,1194242055,1194242193,2,3,138
11949829@N04,648,30,1194242193,1194243273,2,3,1080
11949829@N04,649,26,1195734875,1195735775,2,1,900
11949829@N04,650,26,1197066253,1197067153,8,2,900
11949829@N04,650,18,1197090318,1197090768,1,2,450
11949829@N04,651,28,1198243759,1198244659,1,1,900
11949829@N04,652,25,1200820243,1200821083,1,1,840
11949829@N04,653,16,1201931455,1201931725,3,1,270
11949829@N04,654,28,1204872052,1204872952,3,1,900
11949829@N04,655,17,1214111513,1214111813,3,1,300
11949829@N04,656,13,1216263625,1216263865,3,1,240
11949829@N04,657,13,1216307715,1216307955,4,4,240
11949829@N04,657,1,1216308125,1216308142,3,4,17
11949829@N04,657,29,1216308142,1216308180,3,4,38
11949829@N04,657,24,1216308180,1216308960,4,4,780
11949829@N04,658,28,1224930356,1224931256,2,3,900
11949829@N04,658,30,1224932599,1224933679,2,3,1080
11949829@N04,658,24,1224938946,1224939726,1,3,780
11949829@N04,659,13,1227265129,1227265369,1,1,240
11949829@N04,660,26,1227940210,1227941110,5,5,900
11949829@N04,660,1,1227952630,1227952690,3,5,60
11949829@N04,660,25,1227960504,1227961344,3,5,840
11949829@N04,660,26,1227964911,1227965811,3,5,900
11949829@N04,660,28,1227966039,1227966939,3,5,900
11949829@N04,661,16,1229772861,1229773131,2,1,270
11949829@N04,662,29,1230030487,1230031387,1,1,900
11949829@N04,663,1,1230381354,1230381355,2,4,1
11949829@N04,663,15,1230381355,1230381625,2,4,270
11949829@N04,663,31,1230385674,1230385691,2,4,17
11949829@N04,663,29,1230385691,1230386591,1,4,900
11949829@N04,664,26,1230730983,1230731883,2,2,900
11949829@N04,664,16,1230740733,1230741003,1,2,270
11949829@N04,665,14,1249304531,1249304771,1,1,240
11949829@N04,666,21,1262254605,1262255175,2,3,570
11949829@N04,666,11,1262256413,1262256653,2,3,240
11949829@N04,666,28,1262261891,1262262791,3,3,900
11985480@N04,667,17,1319805430,1319805564,2,2,134
11985480@N04,667,28,1319805564,1319806464,1,2,900
11985480@N04,668,4,1326768620,1326768721,1,1,101
11985480@N04,669,27,1330514288,1330515188,1,1,900
11985480@N04,670,27,1330634782,1330635682,1,1,900
11985480@N04,671,16,1334319474,1334319744,1,1,270
119864842@N02,672,28,1313295691,1313296591,2,1,900
11996697@N00,673,18,1252795880,1252796330,2,5,450
11996697@N00,673,31,1252799832,1252799850,2,5,18
11996697@N00,673,14,1252799850,1252800090,2,5,240
11996697@N00,673,31,1252808380,1252809880,7,5,1500
11996697@N00,673,13,1252817020,1252817260,5,5,240
120024993@N07,674,25,1388475072,1388475912,2,1,840
120040317@N03,675,1,1403323989,1403324049,3,4,60
120040317@N03,675,22,1403334623,1403335223,3,4,600
120040317@N03,675,21,1403343854,1403344424,2,4,570
120040317@N03,675,12,1403344560,1403344800,1,4,240
120236135@N07,676,19,1432683723,1432684263,1,1,540
12027145@N00,677,26,1218672083,1218672983,8,3,900
12027145@N00,677,22,1218688144,1218688744,2,3,600
12027145@N00,677,26,1218692647,1218693547,1,3,900
12027145@N00,678,31,1219728404,1219729613,2,2,1209
12027145@N00,678,26,1219729613,1219730513,2,2,900
12037949644@N01,679,28,1236210514,1236211414,1,1,900
12037949644@N01,680,3,1264564092,1264564182,1,1,90
12037949644@N01,681,30,1321139713,1321140793,2,2,1080
12037949644@N01,681,12,1321140802,1321141042,1,2,240
120533378@N03,682,26,1295389744,1295390644,1,1,900
120533378@N03,683,26,1413271937,1413272837,10,1,900
120533378@N03,684,26,1413325275,1413326175,81,1,900
120533378@N03,685,26,1413446399,1413447299,36,1,900
12083014@N05,686,21,1209564000,1209564570,1,1,570
12083014@N05,687,22,1211736998,1211737598,1,1,600
12083014@N05,688,26,1220191200,1220192100,1,1,900
12083014@N05,689,28,1277800013,1277800913,2,2,900
12083014@N05,689,31,1277807280,1277808780,1,2,1500
121145663@N04,690,18,1441255883,1441256333,1,1,450
121145663@N04,691,18,1441315483,1441315933,1,1,450
12119240@N07,692,28,1391582035,1391582935,1,1,900
12119240@N07,693,28,1391945965,1391946865,1,1,900
12119240@N07,694,20,1393146059,1393146599,1,1,540
12119240@N07,695,19,1410483511,1410484051,3,2,540
12119240@N07,695,28,1410487314,1410488214,1,2,900
121202058@N03,696,1,1349448731,1349448791,1,1,60
12143630@N05,697,28,1291161901,1291162801,2,1,900
121577955@N05,698,6,1366686506,1366686626,2,2,120
121577955@N05,698,20,1366690643,1366691183,1,2,540
121634217@N06,699,29,1419722516,1419723416,2,5,900
121634217@N06,699,26,1419727868,1419728768,2,5,900
121634217@N06,699,28,1419740663,1419741563,7,5,900
121634217@N06,699,18,1419742547,1419742997,2,5,450
121634217@N06,699,28,1419743261,1419744161,2,5,900
121634217@N06,700,20,1419897552,1419898092,2,4,540
121634217@N06,700,16,1419901654,1419901924,2,4,270
121634217@N06,700,25,1419909878,1419910718,3,4,840
121634217@N06,700,13,1419910794,1419911034,1,4,240
12172123@N00,701,27,1319834482,1319835382,1,1,900
12172123@N00,702,28,1320542024,1320542924,1,1,900
12189282@N00,703,28,1323559955,1323560855,1,1,900
12189282@N00,704,1,1368222111,1368222171,1,1,60
12197663@N02,705,17,1428112736,1428113036,1,1,300
122315583@N05,706,18,1440493531,1440493981,1,1,450
122360115@N05,707,1,1396625399,1396625459,1,1,60
122360115@N05,708,1,1396674771,1396674831,2,1,60
122360115@N05,709,27,1396769520,1396770420,1,1,900
122360115@N05,710,1,1396861857,1396861917,4,1,60
122360115@N05,711,1,1396937309,1396937369,6,1,60
122360115@N05,712,16,1397025400,1397025670,3,1,270
122360115@N05,713,25,1397097110,1397097950,1,1,840
122360115@N05,714,1,1397519212,1397519272,1,1,60
122360115@N05,715,16,1397708532,1397708802,2,2,270
122360115@N05,715,30,1397725547,1397726627,1,2,1080
122360115@N05,716,7,1397804925,1397805105,1,1,180
122360115@N05,717,5,1397870825,1397870945,4,1,120
122360115@N05,718,5,1397953244,1397953364,1,1,120
122360115@N05,719,22,1398421821,1398422421,1,1,600
122360115@N05,720,30,1398640774,1398641854,2,2,1080
122360115@N05,720,7,1398655713,1398655893,1,2,180
122360115@N05,721,30,1398814790,1398815870,2,2,1080
122360115@N05,721,9,1398839468,1398839648,1,2,180
122360115@N05,722,9,1398913722,1398913902,1,1,180
122360115@N05,723,26,1399007290,1399008190,2,3,900
122360115@N05,723,29,1399011709,1399012609,2,3,900
122360115@N05,723,26,1399018903,1399019803,1,3,900
122360115@N05,724,20,1399109891,1399110431,1,1,540
122360115@N05,725,1,1399428511,1399428571,1,1,60
122360115@N05,726,24,1400023769,1400024549,1,1,780
122360115@N05,727,28,1400145933,1400146833,1,1,900
122360115@N05,728,1,1400384678,1400384738,1,1,60
122360115@N05,729,17,1400469292,1400469592,7,1,300
122360115@N05,730,17,1400552159,1400552459,4,1,300
122360115@N05,731,1,1400638726,1400638786,4,1,60
122360115@N05,732,1,1400724738,1400724798,5,3,60
122360115@N05,732,20,1400725198,1400725738,2,3,540
122360115@N05,732,1,1400740132,1400740192,1,3,60
122360115@N05,733,1,1400817363,1400817423,1,1,60
122360115@N05,734,17,1400937576,1400937783,2,2,207
122360115@N05,734,26,1400937783,1400938683,2,2,900
122360115@N05,735,30,1400987638,1400988718,1,1,1080
122360115@N05,736,26,1401017165,1401018065,1,1,900
122360115@N05,737,1,1401171898,1401171958,1,1,60
122360115@N05,738,7,1401343834,1401344014,1,1,180
122360115@N05,739,26,1401411815,1401412715,2,1,900
122360115@N05,740,16,1401781144,1401781414,1,1,270
122360115@N05,741,1,1401966540,1401966600,1,1,60
122360115@N05,742,16,1402563626,1402563896,1,1,270
122360115@N05,743,19,1402732077,1402732617,2,1,540
122360115@N05,744,19,1402786873,1402787413,1,1,540
122360115@N05,745,19,1403060288,1403060828,3,3,540
122360115@N05,745,18,1403072768,1403072808,2,3,40
122360115@N05,745,19,1403072808,1403073348,2,3,540
122360115@N05,746,19,1403139403,1403139943,2,1,540
122360115@N05,747,19,1403321348,1403321524,2,2,176
122360115@N05,747,21,1403321524,1403322094,1,2,570
122360115@N05,748,26,1403417859,1403418759,1,1,900
122360115@N05,749,19,1403513183,1403513723,1,1,540
122360115@N05,750,19,1403674093,1403674633,1,1,540
122360115@N05,751,23,1403833913,1403833953,2,2,40
122360115@N05,751,19,1403833953,1403834493,1,2,540
122360115@N05,752,26,1403867167,1403868067,1,1,900
122360115@N05,753,19,1403949506,1403949548,2,3,42
122360115@N05,753,28,1403949548,1403949607,2,3,59
122360115@N05,753,19,1403949607,1403950147,1,3,540
122360115@N05,754,30,1404118486,1404119566,1,1,1080
122360115@N05,755,19,1404205103,1404205643,1,1,540
122360115@N05,756,20,1404290383,1404290923,1,1,540
122360115@N05,757,28,1404463167,1404464067,2,2,900
122360115@N05,757,19,1404467259,1404467799,1,2,540
122360115@N05,758,19,1404714639,1404715179,1,1,540
122360115@N05,759,19,1404896180,1404896720,1,1,540
122360115@N05,760,17,1405410930,1405411230,1,1,300
122360115@N05,761,30,1405657256,1405658336,2,2,1080
122360115@N05,761,19,1405667242,1405667782,1,2,540
122360115@N05,762,23,1405755166,1405755766,1,1,600
122360115@N05,763,19,1405905715,1405906255,1,1,540
122360115@N05,764,29,1406711096,1406711996,1,1,900
122360115@N05,765,19,1406796479,1406797019,1,1,540
122360115@N05,766,19,1406865033,1406865573,2,2,540
122360115@N05,766,20,1406877858,1406878398,1,2,540
122360115@N05,767,19,1406956625,1406957165,1,1,540
122360115@N05,768,23,1407143209,1407143809,1,1,600
122360115@N05,769,19,1407470813,1407471353,1,1,540
122360115@N05,770,19,1407546373,1407546467,2,2,94
122360115@N05,770,17,1407546467,1407546767,1,2,300
122360115@N05,771,26,1407923370,1407924270,1,1,900
122360115@N05,772,19,1408686119,1408686659,4,1,540
122360115@N05,773,19,1408751324,1408751864,1,1,540
122360115@N05,774,19,1408934663,1408935203,2,3,540
122360115@N05,774,30,1408957378,1408957542,3,3,164
122360115@N05,774,19,1408957542,1408958082,1,3,540
122360115@N05,775,19,1409019261,1409019801,1,1,540
122360115@N05,776,30,1409183721,1409184801,1,1,1080
122360115@N05,777,19,1409217802,1409218342,1,1,540
122360115@N05,778,14,1409280295,1409280535,1,1,240
122360115@N05,779,19,1409361452,1409361992,9,2,540
122360115@N05,779,30,1409402199,1409403279,1,2,1080
122360115@N05,780,19,1409472215,1409472755,1,1,540
122360115@N05,781,19,1409535617,1409536157,1,1,540
122360115@N05,782,19,1409575686,1409576226,1,1,540
122360115@N05,783,19,1409617099,1409617639,2,1,540
122360115@N05,784,16,1409762189,1409762459,1,1,270
122360115@N05,785,19,1409799325,1409799865,1,1,540
122360115@N05,786,25,1409848755,1409849595,1,1,840
122360115@N05,787,30,1409901418,1409902498,1,1,1080
122360115@N05,788,19,1409978526,1409979066,1,1,540
122360115@N05,789,26,1410052684,1410053584,2,3,900
122360115@N05,789,19,1410078972,1410079512,2,3,540
122360115@N05,789,16,1410102430,1410102700,1,3,270
122360115@N05,790,3,1410145266,1410145356,1,1,90
122360115@N05,791,19,1410280642,1410281182,1,1,540
122360115@N05,792,19,1410314393,1410314933,1,1,540
122360115@N05,793,19,1410425827,1410426367,1,1,540
122360115@N05,794,19,1410509603,1410510143,1,1,540
122360115@N05,795,19,1410577903,1410578443,1,1,540
122360115@N05,796,19,1410659866,1410660406,3,1,540
122360115@N05,797,30,1410756091,1410757171,1,1,1080
122360115@N05,798,19,1410826350,1410826890,2,1,540
122360115@N05,799,19,1410931332,1410931872,1,1,540
122360115@N05,800,22,1410964562,1410965162,1,1,600
122360115@N05,801,28,1411029513,1411030413,1,1,900
122360115@N05,802,19,1411084680,1411085220,4,2,540
122360115@N05,802,13,1411146024,1411146264,1,2,240
122360115@N05,803,19,1411233958,1411234498,1,1,540
122360115@N05,804,19,1411400075,1411400615,1,1,540
122360115@N05,805,26,1411430454,1411431354,1,1,900
122360115@N05,806,19,1411485941,1411486481,1,1,540
122360115@N05,807,26,1411519122,1411520022,1,1,900
122360115@N05,808,13,1411614132,1411614372,2,2,240
122360115@N05,808,26,1411636006,1411636906,1,2,900
122360115@N05,809,19,1411696786,1411697326,2,1,540
122360115@N05,810,19,1411784275,1411784815,1,1,540
122360115@N05,811,14,1411866767,1411867007,2,2,240
122360115@N05,811,19,1411887664,1411888204,1,2,540
122360115@N05,812,19,1411951694,1411952234,2,1,540
122360115@N05,813,19,1412045227,1412045767,2,1,540
122360115@N05,814,19,1412126855,1412127395,1,1,540
122360115@N05,815,19,1412155694,1412156234,1,1,540
122360115@N05,816,19,1412216849,1412217389,2,1,540
122360115@N05,817,19,1412312373,1412312913,1,1,540
122360115@N05,818,30,1412346704,1412347784,1,1,1080
122360115@N05,819,19,1412382258,1412382798,2,1,540
122360115@N05,820,19,1412469489,1412470029,3,1,540
122360115@N05,821,19,1412551262,1412551802,2,1,540
122360115@N05,822,19,1412906215,1412906755,1,1,540
122360115@N05,823,19,1412990595,1412991135,7,2,540
122360115@N05,823,4,1413032611,1413032712,1,2,101
122360115@N05,824,26,1413066514,1413067414,2,2,900
122360115@N05,824,19,1413094061,1413094601,5,2,540
122360115@N05,825,19,1413166508,1413167048,1,1,540
122360115@N05,826,20,1413200780,1413201320,1,1,540
122360115@N05,827,19,1413263204,1413263744,4,1,540
122360115@N05,828,19,1413357718,1413358258,3,1,540
122360115@N05,829,19,1413417039,1413417579,3,1,540
122360115@N05,830,19,1413505100,1413505640,2,3,540
122360115@N05,830,18,1413531984,1413532434,2,3,450
122360115@N05,830,19,1413550759,1413551299,1,3,540
122360115@N05,831,19,1413583175,1413583715,1,1,540
122360115@N05,832,19,1413613711,1413614251,1,1,540
122360115@N05,833,19,1413677276,1413677816,2,1,540
122360115@N05,834,19,1413764752,1413765292,2,1,540
122360115@N05,835,19,1413851199,1413851739,2,1,540
122360115@N05,836,11,1413936515,1413936755,2,2,240
122360115@N05,836,19,1413964514,1413965054,1,2,540
122360115@N05,837,20,1414025812,1414026352,2,2,540
122360115@N05,837,19,1414051888,1414052428,1,2,540
122360115@N05,838,19,1414144236,1414144776,1,1,540
122360115@N05,839,19,1414232219,1414232759,1,1,540
122360115@N05,840,19,1414310074,1414310614,1,1,540
122360115@N05,841,19,1414364757,1414365297,2,1,540
122360115@N05,842,29,1414457431,1414458331,2,2,900
122360115@N05,842,19,1414482593,1414483133,1,2,540
122360115@N05,843,13,1414518399,1414518639,1,1,240
122360115@N05,844,24,1414591047,1414591827,1,1,780
122360115@N05,845,19,1414630068,1414630608,1,1,540
122361912@N02,846,26,1385116965,1385117865,1,1,900
122381618@N08,847,1,1393395522,1393395582,7,2,60
122381618@N08,847,28,1393395689,1393396589,2,2,900
12241674@N03,848,5,1417642480,1417642600,6,7,120
12241674@N03,848,9,1417644563,1417644743,3,7,180
12241674@N03,848,7,1417645490,1417645670,2,7,180
12241674@N03,848,22,1417654309,1417654909,3,7,600
12241674@N03,848,13,1417661302,1417661542,10,7,240
12241674@N03,848,26,1417682655,1417683555,2,7,900
12241674@N03,848,28,1417683678,1417684578,1,7,900
12241674@N03,849,4,1417820497,1417820598,4,4,101
12241674@N03,849,13,1417822784,1417823024,14,4,240
12241674@N03,849,6,1417832994,1417833114,3,4,120
12241674@N03,849,26,1417834007,1417834907,1,4,900
12241674@N03,850,1,1417989183,1417989243,2,8,60
12241674@N03,850,15,1417997648,1417997918,5,8,270
12241674@N03,850,26,1418000210,1418001110,2,8,900
12241674@N03,850,24,1418011607,1418012387,2,8,780
12241674@N03,850,16,1418016966,1418017236,4,8,270
12241674@N03,850,25,1418019793,1418020633,3,8,840
12241674@N03,850,22,1418022963,1418023563,3,8,600
12241674@N03,850,26,1418029300,1418030200,1,8,900
12247055@N00,851,1,1417015342,1417015402,2,5,60
12247055@N00,851,28,1417015432,1417015994,4,5,562
12247055@N00,851,26,1417015994,1417016894,3,5,900
12247055@N00,851,20,1417030151,1417030691,2,5,540
12247055@N00,851,28,1417034073,1417034973,1,5,900
12252801@N00,852,26,1415955385,1415956285,1,1,900
122536755@N07,853,1,1376943498,1376943558,3,1,60
122815638@N08,854,16,1401588580,1401588850,1,1,270
122833646@N08,855,28,1281159555,1281160455,1,1,900
122833646@N08,856,28,1281264695,1281265595,1,1,900
122911104@N07,857,26,1399156399,1399156840,2,5,441
122911104@N07,857,27,1399156840,1399157740,2,5,900
122911104@N07,857,26,1399160581,1399161481,2,5,900
122911104@N07,857,17,1399161811,1399162111,2,5,300
122911104@N07,857,15,1399165650,1399165920,1,5,270
122911104@N07,858,26,1399202974,1399203874,2,1,900
122911104@N07,859,26,1418529399,1418530299,10,1,900
122911104@N07,860,26,1422411921,1422412821,1,1,900
122911104@N07,861,26,1422687822,1422688722,4,1,900
122911104@N07,862,26,1424251156,1424252056,1,1,900
122911104@N07,863,26,1428120197,1428121097,1,1,900
122911104@N07,864,26,1428830695,1428831595,9,1,900
122911104@N07,865,26,1431124876,1431125776,2,1,900
122911104@N07,866,26,1432249744,1432250644,1,1,900
122911104@N07,867,26,1432375022,1432375922,9,1,900
122911104@N07,868,26,1433844907,1433845807,3,1,900
122911104@N07,869,26,1434629150,1434630050,3,1,900
122911104@N07,870,26,1439464051,1439464951,1,1,900
122911104@N07,871,26,1439591504,1439592404,1,1,900
122911104@N07,872,26,1439895009,1439895909,1,1,900
122911104@N07,873,26,1440674076,1440674976,1,1,900
122911104@N07,874,26,1442490468,1442491368,1,1,900
122911104@N07,875,26,1442579463,1442580363,1,1,900
122911104@N07,876,26,1443842208,1443843108,3,1,900
122911104@N07,877,26,1444371134,1444372034,4,1,900
122911104@N07,878,26,1445496423,1445497323,2,1,900
122911104@N07,879,26,1446722014,1446722914,1,1,900
122911104@N07,880,26,1446796862,1446797762,3,1,900
122911104@N07,881,26,1448673499,1448674399,4,1,900
122911104@N07,882,26,1449890845,1449891745,2,1,900
123072326@N08,883,26,1401438240,1401439140,1,1,900
123177436@N08,884,1,1387591867,1387591927,2,5,60
123177436@N08,884,28,1387596152,1387597052,5,5,900
123177436@N08,884,26,1387599564,1387600464,5,5,900
123177436@N08,884,13,1387608556,1387608796,2,5,240
123177436@N08,884,28,1387632952,1387633852,1,5,900
12326995@N03,885,1,1203573013,1203573073,1,1,60
12326995@N03,886,1,1203743812,1203743817,3,9,5
12326995@N03,886,22,1203743817,1203743825,4,9,8
12326995@N03,886,20,1203743825,1203743827,2,9,2
12326995@N03,886,26,1203743827,1203743832,2,9,5
12326995@N03,886,28,1203743832,1203743836,3,9,4
12326995@N03,886,26,1203743836,1203743838,2,9,2
12326995@N03,886,20,1203743838,1203743841,3,9,3
12326995@N03,886,28,1203743841,1203743845,2,9,4
12326995@N03,886,20,1203743845,1203744385,3,9,540
12326995@N03,887,1,1203936647,1203936654,5,2,7
12326995@N03,887,29,1203936654,1203937554,1,2,900
12326995@N03,888,29,1274591700,1274592600,5,1,900
12326995@N03,889,1,1274677603,1274677663,2,4,60
12326995@N03,889,27,1274679834,1274680233,2,4,399
12326995@N03,889,26,1274680233,1274681133,3,4,900
12326995@N03,889,29,1274690202,1274691102,1,4,900
12326995@N03,890,24,1274781524,1274782261,2,5,737
12326995@N03,890,17,1274782261,1274782561,2,5,300
12326995@N03,890,25,1274784543,1274785383,5,5,840
12326995@N03,890,16,1274786807,1274787077,6,5,270
12326995@N03,890,28,1274787655,1274788555,1,5,900
12326995@N03,891,22,1274851097,1274851697,1,1,600
12329513@N06,892,10,1295440188,1295440428,8,1,240
123393307@N03,893,13,1313284505,1313284745,2,2,240
123393307@N03,893,26,1313286863,1313287763,1,2,900
123425229@N07,894,1,1386979123,1386979183,2,4,60
123425229@N07,894,26,1386985270,1386986170,4,4,900
123425229@N07,894,17,1386991554,1386991854,4,4,300
123425229@N07,894,16,1386992607,1386992877,1,4,270
123425229@N07,895,1,1449876097,1449876157,7,4,60
123425229@N07,895,23,1449883098,1449883698,2,4,600
123425229@N07,895,17,1449892179,1449892479,2,4,300
123425229@N07,895,28,1449918063,1449918963,1,4,900
123463941@N02,896,28,1319194062,1319194962,2,1,900
123756580@N03,897,26,1455140903,1455141803,2,9,900
123756580@N03,897,3,1455141909,1455141999,2,9,90
123756580@N03,897,4,1455143274,1455143375,3,9,101
123756580@N03,897,26,1455146054,1455146954,2,9,900
123756580@N03,897,6,1455148944,1455149064,6,9,120
123756580@N03,897,27,1455151277,1455152177,2,9,900
123756580@N03,897,25,1455155984,1455156824,2,9,840
123756580@N03,897,3,1455164659,1455164749,2,9,90
123756580@N03,897,16,1455171238,1455171508,2,9,270
123891828@N06,898,24,1307996788,1307997568,18,1,780
123891828@N06,899,24,1308072592,1308073372,8,1,780
123891828@N06,900,24,1308242508,1308243288,3,1,780
123899237@N03,901,21,1416016173,1416016182,2,5,9
123899237@N03,901,4,1416016182,1416016283,2,5,101
123899237@N03,901,25,1416017283,1416018123,9,5,840
123899237@N03,901,13,1416021387,1416021627,5,5,240
123899237@N03,901,28,1416031548,1416032448,5,5,900
123908048@N03,902,1,1435570297,1435570357,2,1,60
123908048@N03,903,26,1435626111,1435626616,3,31,505
123908048@N03,903,30,1435626616,1435627696,7,31,1080
123908048@N03,903,19,1435627866,1435628406,3,31,540
123908048@N03,903,29,1435629011,1435629368,2,31,357
123908048@N03,903,23,1435629368,1435629968,7,31,600
123908048@N03,903,29,1435630639,1435631345,2,31,706
123908048@N03,903,20,1435631345,1435631885,9,31,540
123908048@N03,903,23,1435632405,1435633005,2,31,600
123908048@N03,903,27,1435633087,1435633987,5,31,900
123908048@N03,903,29,1435634849,1435635749,8,31,900
123908048@N03,903,22,1435642510,1435643110,3,31,600
123908048@N03,903,31,1435643402,1435644112,2,31,710
123908048@N03,903,26,1435644112,1435644692,2,31,580
123908048@N03,903,17,1435644692,1435644992,2,31,300
123908048@N03,903,21,1435645086,1435645656,2,31,570
123908048@N03,903,16,1435646596,1435646821,3,31,225
123908048@N03,903,26,1435646821,1435647721,4,31,900
123908048@N03,903,16,1435650449,1435650468,2,31,19
123908048@N03,903,26,1435650468,1435650497,2,31,29
123908048@N03,903,16,1435650497,1435650767,4,31,270
123908048@N03,903,27,1435650861,1435650919,2,31,58
123908048@N03,903,16,1435650919,1435651152,3,31,233
123908048@N03,903,12,1435651152,1435651235,3,31,83
123908048@N03,903,21,1435651235,1435651805,2,31,570
123908048@N03,903,12,1435651832,1435652072,2,31,240
123908048@N03,903,3,1435654471,1435654561,3,31,90
123908048@N03,903,28,1435663125,1435663916,3,31,791
123908048@N03,903,26,1435663916,1435664794,9,31,878
123908048@N03,903,30,1435664794,1435664998,3,31,204
123908048@N03,903,16,1435664998,1435665268,4,31,270
123908048@N03,903,28,1435669571,1435670471,1,31,900
12395214@N08,904,6,1432989189,1432989309,23,1,120
124015959@N07,905,17,1410823841,1410823973,2,2,132
124015959@N07,905,26,1410823973,1410824873,1,2,900
124116382@N06,906,28,1402211230,1402212130,1,1,900
124116382@N06,907,26,1408096523,1408097423,2,1,900
124116382@N06,908,19,1416132916,1416133456,1,1,540
124116382@N06,909,28,1416918645,1416919545,1,1,900
124116382@N06,910,18,1430363592,1430364042,1,1,450
12423353@N02,911,1,1306378680,1306378740,2,5,60
12423353@N02,911,28,1306378885,1306379785,2,5,900
12423353@N02,911,27,1306380236,1306380545,3,5,309
12423353@N02,911,17,1306380545,1306380845,4,5,300
12423353@N02,911,15,1306381011,1306381281,11,5,270
12423353@N02,912,1,1306879752,1306879812,4,6,60
12423353@N02,912,28,1306881393,1306882293,17,6,900
12423353@N02,912,23,1306889135,1306889735,4,6,600
12423353@N02,912,27,1306890003,1306890903,16,6,900
12423353@N02,912,15,1306904036,1306904306,4,6,270
12423353@N02,912,26,1306928108,1306929008,33,6,900
12423353@N02,913,27,1306970578,1306971478,2,5,900
12423353@N02,913,15,1306972792,1306973062,3,5,270
12423353@N02,913,25,1306975691,1306976531,2,5,840
12423353@N02,913,30,1306976566,1306976960,2,5,394
12423353@N02,913,23,1306976960,1306977560,3,5,600
12429838@N07,914,11,1298772826,1298773066,37,1,240
12431650@N06,915,20,1290737732,1290738272,1,1,540
12431650@N06,916,12,1307856640,1307856880,1,1,240
12438054@N08,917,28,1352539939,1352540839,1,1,900
12445726@N06,918,28,1351052815,1351053715,2,2,900
12445726@N06,918,26,1351054286,1351055186,2,2,900
12445726@N06,919,30,1353558049,1353559129,2,3,1080
12445726@N06,919,27,1353561497,1353562397,2,3,900
12445726@N06,919,1,1353563668,1353563728,2,3,60
124495835@N08,920,1,1393225627,1393225687,1,1,60
124495835@N08,921,26,1399461527,1399462427,1,1,900
124495835@N08,922,25,1420541455,1420542295,1,1,840
124495835@N08,923,28,1425548111,1425549011,1,1,900
124495835@N08,924,1,1426663762,1426663822,1,1,60
124495835@N08,925,28,1433038406,1433039306,2,2,900
124495835@N08,925,26,1433053790,1433054690,1,2,900
124495835@N08,926,16,1436794068,1436794338,2,3,270
124495835@N08,926,26,1436794792,1436795316,2,3,524
124495835@N08,926,1,1436795316,1436795376,1,3,60
124495835@N08,927,26,1440913637,1440914537,3,1,900
124495835@N08,928,28,1441195311,1441196211,2,1,900
124495835@N08,929,1,1443619814,1443619874,1,1,60
124495835@N08,930,29,1448969178,1448970078,2,3,900
124495835@N08,930,26,1448971573,1448972473,2,3,900
124495835@N08,930,28,1448974425,1448975325,2,3,900
124495835@N08,931,6,1454495066,1454495186,1,1,120
124495835@N08,932,1,1460461940,1460462000,2,2,60
124495835@N08,932,28,1460462647,1460463547,1,2,900
124545141@N08,933,1,1438136084,1438136144,4,13,60
124545141@N08,933,26,1438136485,1438137385,5,13,900
124545141@N08,933,21,1438148899,1438149469,7,13,570
124545141@N08,933,30,1438151669,1438152749,2,13,1080
124545141@N08,933,29,1438156709,1438157609,4,13,900
124545141@N08,933,17,1438161577,1438161877,3,13,300
124545141@N08,933,15,1438162046,1438162055,2,13,9
124545141@N08,933,17,1438162055,1438162355,6,13,300
124545141@N08,933,25,1438169698,1438170538,11,13,840
124545141@N08,933,3,1438171762,1438171852,5,13,90
124545141@N08,933,21,1438172264,1438172318,3,13,54
124545141@N08,933,3,1438172318,1438172408,2,13,90
124545141@N08,933,26,1438172466,1438173366,4,13,900
12457199@N04,934,26,1290231382,1290232282,1,1,900
12482362@N04,935,12,1366102661,1366102901,3,19,240
12482362@N04,935,13,1366106152,1366106392,5,19,240
12482362@N04,935,12,1366112714,1366112954,2,19,240
12482362@N04,935,4,1366113927,1366114028,4,19,101
12482362@N04,935,22,1366146769,1366147369,3,19,600
12482362@N04,935,19,1366149706,1366150246,4,19,540
12482362@N04,935,7,1366156546,1366156726,4,19,180
12482362@N04,935,6,1366164248,1366164368,4,19,120
12482362@N04,935,26,1366173801,1366174701,9,19,900
12482362@N04,935,8,1366190245,1366190425,3,19,180
12482362@N04,935,4,1366192358,1366192459,4,19,101
12482362@N04,935,24,1366196312,1366197092,5,19,780
12482362@N04,935,26,1366201184,1366202084,3,19,900
12482362@N04,935,31,1366203808,1366205308,3,19,1500
12482362@N04,935,26,1366206175,1366207075,3,19,900
12482362@N04,935,31,1366208157,1366209657,3,19,1500
12482362@N04,935,19,1366234798,1366235338,2,19,540
12482362@N04,935,31,1366236653,1366238153,2,19,1500
12482362@N04,935,1,1366240728,1366240788,1,19,60
12482362@N04,936,28,1372776315,1372777215,2,2,900
12482362@N04,936,4,1372777673,1372777774,1,2,101
12482362@N04,937,7,1372806842,1372807022,2,2,180
12482362@N04,937,20,1372808336,1372808876,1,2,540
12482362@N04,938,7,1377679975,1377680155,9,1,180
12482362@N04,939,7,1377724101,1377724281,16,1,180
12482362@N04,940,7,1377948565,1377948745,1,1,180
12482362@N04,941,23,1379851885,1379852485,3,1,600
124848726@N03,942,1,1465973411,1465973471,1,1,60
12485829@N00,943,31,1340504492,1340505992,2,2,1500
12485829@N00,943,9,1340506598,1340506778,2,2,180
125032415@N05,944,26,1370826731,1370827631,3,1,900
12505291@N08,945,24,1245920905,1245921685,1,1,780
12508217@N08,946,29,1218165022,1218165922,2,3,900
12508217@N08,946,18,1218167813,1218168263,3,3,450
12508217@N08,946,28,1218171510,1218172410,4,3,900
12508217@N08,947,29,1253184035,1253184935,4,1,900
12508217@N08,948,18,1253247683,1253248133,8,2,450
12508217@N08,948,29,1253258699,1253259599,6,2,900
12508217@N08,949,29,1278673222,1278674122,37,1,900
12508217@N08,950,18,1334993124,1334993574,74,1,450
12508217@N08,951,28,1346549444,1346550344,13,2,900
12508217@N08,951,18,1346551840,1346552290,72,2,450
12508217@N08,952,27,1369414001,1369414901,7,7,900
12508217@N08,952,26,1369415697,1369416597,9,7,900
12508217@N08,952,18,1369417213,1369417513,3,7,300
12508217@N08,952,29,1369417513,1369418413,4,7,900
12508217@N08,952,28,1369422589,1369423059,2,7,470
12508217@N08,952,29,1369423059,1369423959,2,7,900
12508217@N08,952,28,1369425550,1369426450,1,7,900
12508217@N08,953,1,1369463697,1369463757,4,5,60
12508217@N08,953,25,1369464527,1369465367,4,5,840
12508217@N08,953,4,1369467015,1369467116,11,5,101
12508217@N08,953,3,1369469365,1369469455,2,5,90
12508217@N08,953,1,1369470258,1369470318,1,5,60
125379110@N03,954,29,1402267018,1402267918,4,1,900
125379110@N03,955,29,1402396302,1402397202,1,1,900
125379110@N03,956,29,1402956823,1402957723,5,1,900
125379110@N03,957,29,1403102445,1403103345,1,1,900
125379110@N03,958,29,1403694476,1403695376,4,1,900
125379110@N03,959,29,1403874257,1403875157,1,1,900
125508504@N03,960,23,1292638331,1292638931,3,4,600
125508504@N03,960,26,1292645007,1292645907,5,4,900
125508504@N03,960,28,1292658132,1292659032,4,4,900
125508504@N03,960,30,1292679116,1292680196,2,4,1080
125508504@N03,961,14,1292738537,1292738777,1,1,240
125508504@N03,962,25,1292931656,1292932496,2,1,840
12557280@N05,963,24,1390646506,1390647286,1,1,780
12572833@N04,964,27,1295263477,1295264377,1,1,900
12572833@N04,965,18,1338172293,1338172743,70,1,450
125778589@N07,966,28,1450477954,1450478854,1,1,900
125778589@N07,967,20,1450527722,1450528262,1,1,540
12584309@N00,968,26,1237022160,1237022301,2,3,141
12584309@N00,968,18,1237022301,1237022751,2,3,450
12584309@N00,968,16,1237027917,1237028187,1,3,270
12599627@N04,969,29,1312333040,1312333940,2,2,900
12599627@N04,969,21,1312338441,1312339011,1,2,570
12619133@N07,970,24,1228782399,1228783179,17,2,780
12619133@N07,970,28,1228804787,1228805687,6,2,900
126229477@N05,971,26,1442578853,1442579753,1,1,900
126305887@N02,972,5,1454391788,1454391908,1,1,120
126305887@N02,973,28,1454478243,1454479143,4,1,900
126305887@N02,974,29,1454563646,1454564546,1,1,900
126458449@N05,975,25,1386384586,1386385426,4,1,840
126695530@N07,976,1,1441484479,1441484539,1,1,60
126704266@N03,977,26,1403692606,1403693506,9,1,900
126797303@N08,978,28,1382337595,1382338495,3,5,900
126797303@N08,978,20,1382348177,1382348717,2,5,540
126797303@N08,978,14,1382349930,1382350170,2,5,240
126797303@N08,978,16,1382352288,1382352558,2,5,270
126797303@N08,978,1,1382356518,1382356578,1,5,60
12685141@N08,979,29,1359864868,1359865768,2,1,900
12685141@N08,980,1,1366420638,1366420698,2,4,60
12685141@N08,980,12,1366424709,1366424949,2,4,240
12685141@N08,980,15,1366430280,1366430550,2,4,270
12685141@N08,980,27,1366442752,1366443652,1,4,900
12685141@N08,981,1,1379305096,1379305156,2,2,60
12685141@N08,981,28,1379328181,1379329081,1,2,900
12685141@N08,982,1,1379385402,1379385462,2,1,60
12685141@N08,983,27,1379664278,1379665178,1,1,900
12685141@N08,984,26,1381392773,1381393673,1,1,900
12689533@N05,985,1,1319782336,1319782396,2,1,60
126898848@N02,986,26,1355898912,1355899812,1,1,900
12696073@N07,987,1,1364806204,1364806264,1,1,60
12696073@N07,988,26,1370956030,1370956930,1,1,900
12696073@N07,989,1,1371108040,1371108100,1,1,60
12696073@N07,990,18,1371198227,1371198677,2,2,450
12696073@N07,990,28,1371202187,1371203087,1,2,900
12696073@N07,991,26,1376627815,1376628715,1,1,900
12696190@N05,992,14,1351571673,1351571913,1,1,240
12706502@N00,993,18,1383010693,1383011143,1,1,450
12706502@N00,994,18,1422253593,1422254043,1,1,450
127085047@N07,995,13,1409198556,1409198796,1,1,240
12726203@N07,996,19,1287996990,1287997530,1,1,540
12731599@N08,997,27,1188998550,1188999450,1,1,900
12731599@N08,998,16,1287793947,1287794217,1,1,270
12734746@N00,999,26,1270085381,1270086281,101,1,900
12734746@N00,1000,26,1270355784,1270356684,36,1,900
12734746@N00,1001,29,1313666359,1313667259,38,1,900
12742129@N00,1002,26,1355404778,1355405678,1,1,900
12742129@N00,1003,1,1372508354,1372508414,4,1,60
12742129@N00,1004,28,1378514593,1378515493,1,1,900
12742564@N00,1005,28,1381566871,1381567771,1,1,900
12742564@N00,1006,31,1388551436,1388552936,1,1,1500
12742564@N00,1007,20,1411121396,1411121936,1,1,540
12742564@N00,1008,19,1414721425,1414721965,2,2,540
12742564@N00,1008,30,1414728069,1414729149,1,2,1080
12742564@N00,1009,28,1417075748,1417076648,1,1,900
12742564@N00,1010,1,1422155206,1422155266,1,1,60
12742564@N00,1011,1,1424585937,1424585997,2,2,60
12742564@N00,1011,29,1424591581,1424592481,1,2,900
12742564@N00,1012,28,1427713115,1427714015,1,1,900
12742564@N00,1013,18,1446275556,1446276006,1,1,450
12742564@N00,1014,18,1455086142,1455086592,2,2,450
12742564@N00,1014,15,1455087126,1455087396,1,2,270
12742564@N00,1015,18,1459318681,1459319131,1,1,450
127460346@N03,1016,17,1449787172,1449787472,2,4,300
127460346@N03,1016,19,1449788957,1449789497,2,4,540
127460346@N03,1016,20,1449800062,1449800602,4,4,540
127460346@N03,1016,27,1449821960,1449822860,1,4,900
127510853@N02,1017,26,1248350782,1248351682,1,1,900
12767421@N08,1018,28,1283769763,1283770663,2,1,900
12767421@N08,1019,4,1313327903,1313327996,2,2,93
12767421@N08,1019,21,1313327996,1313328566,1,2,570
12771314@N00,1020,18,1443675250,1443675700,1,1,450
12786044@N00,1021,30,1247437388,1247438468,1,1,1080
127890209@N05,1022,27,1448349121,1448350021,2,12,900
127890209@N05,1022,15,1448358768,1448359038,7,12,270
127890209@N05,1022,24,1448361361,1448361662,2,12,301
127890209@N05,1022,17,1448361662,1448361737,3,12,75
127890209@N05,1022,15,1448361737,1448361876,2,12,139
127890209@N05,1022,17,1448361876,1448362176,3,12,300
127890209@N05,1022,15,1448362329,1448362599,2,12,270
127890209@N05,1022,17,1448369113,1448369413,3,12,300
127890209@N05,1022,21,1448370597,1448370863,2,12,266
127890209@N05,1022,25,1448370863,1448371030,2,12,167
127890209@N05,1022,21,1448371030,1448371600,3,12,570
127890209@N05,1022,30,1448371703,1448372783,1,12,1080
12793852@N00,1023,17,1320031462,1320031615,4,26,153
12793852@N00,1023,15,1320031615,1320031885,2,26,270
12793852@N00,1023,24,1320032177,1320032957,5,26,780
12793852@N00,1023,12,1320033293,1320033387,4,26,94
12793852@N00,1023,24,1320033387,1320034167,10,26,780
12793852@N00,1023,15,1320034560,1320034568,2,26,8
12793852@N00,1023,24,1320034568,1320035348,2,26,780
12793852@N00,1023,15,1320035398,1320035668,4,26,270
12793852@N00,1023,24,1320036360,1320037140,4,26,780
12793852@N00,1023,3,1320038620,1320038710,2,26,90
12793852@N00,1023,21,1320038845,1320039386,12,26,541
12793852@N00,1023,3,1320039386,1320039476,2,26,90
12793852@N00,1023,27,1320039975,1320040232,4,26,257
12793852@N00,1023,16,1320040232,1320040502,2,26,270
12793852@N00,1023,27,1320043187,1320044087,3,26,900
12793852@N00,1023,15,1320044296,1320044317,2,26,21
12793852@N00,1023,24,1320044317,1320045097,7,26,780
12793852@N00,1023,16,1320045959,1320045964,2,26,5
12793852@N00,1023,27,1320045964,1320045982,4,26,18
12793852@N00,1023,16,1320045982,1320046252,4,26,270
12793852@N00,1023,9,1320047589,1320047598,2,26,9
12793852@N00,1023,10,1320047598,1320047838,2,26,240
12793852@N00,1023,5,1320048708,1320048828,3,26,120
12793852@N00,1023,7,1320048931,1320049111,6,26,180
12793852@N00,1023,8,1320049201,1320049381,2,26,180
12793852@N00,1023,16,1320052606,1320052876,3,26,270
12793852@N00,1024,27,1320371870,1320372770,4,2,900
12793852@N00,1024,22,1320391683,1320392283,3,2,600
12793852@N00,1025,21,1323849087,1323849657,1,1,570
12793852@N00,1026,15,1341113533,1341113547,2,6,14
12793852@N00,1026,24,1341113547,1341113599,3,6,52
12793852@N00,1026,12,1341113599,1341113732,6,6,133
12793852@N00,1026,24,1341113732,1341114512,2,6,780
12793852@N00,1026,26,1341121364,1341122264,2,6,900
12793852@N00,1026,16,1341138776,1341139046,19,6,270
128287982@N02,1027,26,1439733760,1439734660,2,3,900
128287982@N02,1027,28,1439735734,1439736634,4,3,900
128287982@N02,1027,26,1439741293,1439742193,1,3,900
128287982@N02,1028,26,1439857624,1439858524,2,1,900
128287982@N02,1029,26,1439908299,1439909199,2,1,900
12846758@N06,1030,22,1190348282,1190348882,1,1,600
12846758@N06,1031,22,1192836502,1192837102,2,1,600
12846758@N06,1032,22,1192866154,1192866754,1,1,600
12846758@N06,1033,22,1195998759,1195999359,1,1,600
12846758@N06,1034,22,1205219873,1205220473,1,1,600
128509080@N04,1035,28,1424552024,1424552924,3,9,900
128509080@N04,1035,1,1424555797,1424555857,2,9,60
128509080@N04,1035,26,1424559250,1424560150,5,9,900
128509080@N04,1035,13,1424564987,1424565227,8,9,240
128509080@N04,1035,21,1424567267,1424567837,6,9,570
128509080@N04,1035,7,1424567847,1424568027,7,9,180
128509080@N04,1035,6,1424568484,1424568604,2,9,120
128509080@N04,1035,9,1424569400,1424569580,2,9,180
128509080@N04,1035,11,1424569825,1424570065,5,9,240
12857322@N03,1036,27,1370831525,1370832425,2,12,900
12857322@N03,1036,26,1370835316,1370836216,2,12,900
12857322@N03,1036,12,1370837000,1370837031,4,12,31
12857322@N03,1036,3,1370837031,1370837121,6,12,90
12857322@N03,1036,26,1370840572,1370841472,2,12,900
12857322@N03,1036,7,1370846098,1370846278,2,12,180
12857322@N03,1036,21,1370848072,1370848081,2,12,9
12857322@N03,1036,4,1370848081,1370848182,5,12,101
12857322@N03,1036,11,1370848182,1370848422,2,12,240
12857322@N03,1036,21,1370848423,1370848993,2,12,570
12857322@N03,1036,22,1370857658,1370858258,2,12,600
12857322@N03,1036,26,1370866019,1370866919,1,12,900
12861032@N00,1037,22,1350887832,1350888432,2,1,600
12861032@N00,1038,26,1350942691,1350943591,2,2,900
12861032@N00,1038,6,1350950461,1350950581,2,2,120
12861032@N00,1039,29,1351057977,1351058877,1,1,900
12861032@N00,1040,28,1398641930,1398642718,4,10,788
12861032@N00,1040,23,1398642718,1398643318,2,10,600
12861032@N00,1040,29,1398643448,1398644348,2,10,900
12861032@N00,1040,31,1398644850,1398646350,2,10,1500
12861032@N00,1040,15,1398648906,1398649176,5,10,270
12861032@N00,1040,27,1398650420,1398650426,2,10,6
12861032@N00,1040,16,1398650426,1398650696,2,10,270
12861032@N00,1040,26,1398652657,1398653557,2,10,900
12861032@N00,1040,18,1398656454,1398656904,2,10,450
12861032@N00,1040,23,1398656908,1398657508,1,10,600
12861032@N00,1041,20,1448846343,1448846883,3,3,540
12861032@N00,1041,19,1448849675,1448850215,3,3,540
12861032@N00,1041,30,1448855541,1448856621,2,3,1080
12861032@N00,1042,28,1448921776,1448922676,2,25,900
12861032@N00,1042,16,1448922885,1448922911,2,25,26
12861032@N00,1042,27,1448922911,1448923811,5,25,900
12861032@N00,1042,15,1448925560,1448925830,3,25,270
12861032@N00,1042,24,1448927087,1448927867,2,25,780
12861032@N00,1042,5,1448929241,1448929361,2,25,120
12861032@N00,1042,31,1448933108,1448933111,2,25,3
12861032@N00,1042,19,1448933111,1448933118,2,25,7
12861032@N00,1042,29,1448933118,1448933165,6,25,47
12861032@N00,1042,19,1448933165,1448933235,6,25,70
12861032@N00,1042,18,1448933235,1448933259,2,25,24
12861032@N00,1042,19,1448933259,1448933355,5,25,96
12861032@N00,1042,28,1448933355,1448933445,3,25,90
12861032@N00,1042,18,1448933445,1448933895,3,25,450
12861032@N00,1042,26,1448934195,1448935095,3,25,900
12861032@N00,1042,17,1448938531,1448938831,2,25,300
12861032@N00,1042,28,1448939002,1448939902,2,25,900
12861032@N00,1042,29,1448944081,1448944981,2,25,900
12861032@N00,1042,1,1448951769,1448951829,4,25,60
12861032@N00,1042,28,1448952930,1448953202,2,25,272
12861032@N00,1042,26,1448953202,1448954102,3,25,900
12861032@N00,1042,29,1448955476,1448956376,2,25,900
12861032@N00,1042,20,1448957770,1448958310,19,25,540
12861032@N00,1042,29,1448961755,1448962178,4,25,423
12861032@N00,1042,28,1448962178,1448963078,2,25,900
12865054@N06,1043,24,1303188144,1303188924,2,3,780
12865054@N06,1043,29,1303205634,1303206534,2,3,900
12865054@N06,1043,25,1303208861,1303209701,1,3,840
12902435@N05,1044,6,1337066334,1337066454,1,1,120
129180516@N08,1045,14,1442044868,1442045108,2,2,240
129180516@N08,1045,30,1442050727,1442051807,1,2,1080
129181069@N07,1046,30,1434408253,1434409333,2,17,1080
129181069@N07,1046,26,1434413626,1434414526,2,17,900
129181069@N07,1046,15,1434426181,1434426451,2,17,270
129181069@N07,1046,1,1434428017,1434428077,2,17,60
129181069@N07,1046,22,1434428359,1434428959,2,17,600
129181069@N07,1046,30,1434434528,1434434556,2,17,28
129181069@N07,1046,31,1434434556,1434434561,2,17,5
129181069@N07,1046,30,1434434561,1434435204,2,17,643
129181069@N07,1046,12,1434435204,1434435444,2,17,240
129181069@N07,1046,25,1434436620,1434437460,3,17,840
129181069@N07,1046,20,1434446069,1434446609,2,17,540
129181069@N07,1046,30,1434447772,1434448852,2,17,1080
129181069@N07,1046,24,1434449325,1434450105,2,17,780
129181069@N07,1046,17,1434450517,1434450817,2,17,300
129181069@N07,1046,28,1434459959,1434460859,5,17,900
129181069@N07,1046,10,1434461766,1434461975,2,17,209
129181069@N07,1046,30,1434461975,1434463055,1,17,1080
12939143@N00,1047,26,1255945786,1255946686,1,1,900
129397947@N05,1048,1,1455594294,1455594354,3,1,60
129438227@N06,1049,26,1411742039,1411742939,1,1,900
129438227@N06,1050,10,1411914024,1411914264,1,1,240
129438227@N06,1051,26,1412025885,1412026785,1,1,900
129438227@N06,1052,31,1441931590,1441933090,1,1,1500
129438227@N06,1053,26,1442007516,1442008416,1,1,900
129438227@N06,1054,20,1442067139,1442067679,1,1,540
129438227@N06,1055,16,1447495145,1447495415,1,1,270
129438227@N06,1056,21,1447589562,1447590132,1,1,570
129451096@N08,1057,8,1435023030,1435023210,9,2,180
129451096@N08,1057,26,1435026313,1435027213,1,2,900
129451096@N08,1058,26,1435118111,1435119011,18,1,900
129451096@N08,1059,26,1435300399,1435301299,2,1,900
129456803@N08,1060,29,1420869902,1420870802,1,1,900
12946812@N03,1061,12,1214951588,1214951661,2,13,73
12946812@N03,1061,24,1214951661,1214951954,2,13,293
12946812@N03,1061,17,1214951954,1214952254,2,13,300
12946812@N03,1061,27,1214952899,1214953799,2,13,900
12946812@N03,1061,16,1214954543,1214954610,2,13,67
12946812@N03,1061,23,1214954610,1214954728,2,13,118
12946812@N03,1061,30,1214954728,1214954778,2,13,50
12946812@N03,1061,29,1214954778,1214955678,6,13,900
12946812@N03,1061,22,1214958204,1214958610,2,13,406
12946812@N03,1061,23,1214958610,1214959210,2,13,600
12946812@N03,1061,7,1214963830,1214964010,3,13,180
12946812@N03,1061,24,1214981004,1214981784,2,13,780
12946812@N03,1061,7,1214989138,1214989318,2,13,180
129853099@N05,1062,28,1421472645,1421473545,2,1,900
12987527@N05,1063,14,1243574642,1243574882,2,2,240
12987527@N05,1063,1,1243576481,1243576541,1,2,60
12996122@N00,1064,25,1325465707,1325466547,7,1,840
129990301@N04,1065,24,1418618474,1418619254,2,6,780
129990301@N04,1065,12,1418619745,1418619985,2,6,240
129990301@N04,1065,26,1418622018,1418622275,3,6,257
129990301@N04,1065,28,1418622275,1418623175,3,6,900
129990301@N04,1065,1,1418623289,1418623349,3,6,60
129990301@N04,1065,26,1418634699,1418635599,1,6,900
129990301@N04,1066,15,1418684280,1418684550,9,9,270
129990301@N04,1066,25,1418685145,1418685872,4,9,727
129990301@N04,1066,13,1418685872,1418685938,2,9,66
129990301@N04,1066,25,1418685938,1418686057,2,9,119
129990301@N04,1066,13,1418686057,1418686297,3,9,240
129990301@N04,1066,3,1418688698,1418688788,4,9,90
129990301@N04,1066,5,1418689373,1418689493,2,9,120
129990301@N04,1066,26,1418689632,1418690017,3,9,385
129990301@N04,1066,30,1418690017,1418691097,3,9,1080
13042723@N00,1067,26,1238199012,1238199912,21,1,900
13042723@N00,1068,19,1238320769,1238321309,4,7,540
13042723@N00,1068,10,1238321829,1238322069,3,7,240
13042723@N00,1068,12,1238322603,1238322843,3,7,240
13042723@N00,1068,26,1238324077,1238324977,2,7,900
13042723@N00,1068,10,1238325485,1238325725,2,7,240
13042723@N00,1068,20,1238331238,1238331778,2,7,540
13042723@N00,1068,26,1238344512,1238345412,1,7,900
13044954@N06,1069,18,1191385023,1191385473,3,1,450
130507424@N08,1070,1,1421576124,1421576184,1,1,60
130777482@N08,1071,16,1422661137,1422661407,1,1,270
130777482@N08,1072,7,1422708231,1422708411,4,2,180
130777482@N08,1072,16,1422710187,1422710457,1,2,270
130777482@N08,1073,21,1422933216,1422933786,3,3,570
130777482@N08,1073,7,1422936559,1422936580,3,3,21
130777482@N08,1073,4,1422936580,1422936681,1,3,101
130912872@N04,1074,26,1427430830,1427431730,3,5,900
130912872@N04,1074,25,1427434682,1427435522,2,5,840
130912872@N04,1074,29,1427443083,1427443983,2,5,900
130912872@N04,1074,20,1427444454,1427444994,2,5,540
130912872@N04,1074,24,1427452003,1427452783,1,5,780
130912872@N04,1075,1,1427487314,1427487374,2,19,60
130912872@N04,1075,26,1427490063,1427490342,2,19,279
130912872@N04,1075,4,1427490342,1427490443,2,19,101
130912872@N04,1075,21,1427490858,1427491310,3,19,452
130912872@N04,1075,11,1427491310,1427491550,2,19,240
130912872@N04,1075,3,1427491636,1427491726,4,19,90
130912872@N04,1075,28,1427497674,1427498574,2,19,900
130912872@N04,1075,24,1427511009,1427511789,4,19,780
130912872@N04,1075,19,1427516411,1427516951,2,19,540
130912872@N04,1075,15,1427528838,1427529108,3,19,270
130912872@N04,1075,28,1427532366,1427533266,2,19,900
130912872@N04,1075,27,1427538831,1427538973,2,19,142
130912872@N04,1075,17,1427538973,1427539173,2,19,200
130912872@N04,1075,27,1427539173,1427540073,2,19,900
130912872@N04,1075,7,1427544110,1427544290,2,19,180
130912872@N04,1075,29,1427548280,1427548386,2,19,106
130912872@N04,1075,30,1427548386,1427548999,3,19,613
130912872@N04,1075,23,1427548999,1427549223,2,19,224
130912872@N04,1075,26,1427549223,1427550123,1,19,900
130912872@N04,1076,17,1427588301,1427588601,2,5,300
130912872@N04,1076,16,1427601085,1427601355,5,5,270
130912872@N04,1076,27,1427602872,1427603772,4,5,900
130912872@N04,1076,13,1427612740,1427612980,2,5,240
130912872@N04,1076,28,1427628339,1427629239,1,5,900
130912872@N04,1077,23,1427672751,1427673351,4,9,600
130912872@N04,1077,18,1427674169,1427674619,4,9,450
130912872@N04,1077,13,1427675995,1427676235,2,9,240
130912872@N04,1077,8,1427678462,1427678642,2,9,180
130912872@N04,1077,19,1427685346,1427685438,2,9,92
130912872@N04,1077,18,1427685438,1427685888,2,9,450
130912872@N04,1077,1,1427695368,1427695428,2,9,60
130912872@N04,1077,28,1427695776,1427696676,2,9,900
130912872@N04,1077,26,1427713710,1427714610,2,9,900
130912872@N04,1078,18,1441349057,1441349507,1,1,450
13093780@N04,1079,26,1242724046,1242724946,6,1,900
13093780@N04,1080,26,1247477972,1247477991,2,9,19
13093780@N04,1080,19,1247477991,1247478007,2,9,16
13093780@N04,1080,26,1247478007,1247478030,2,9,23
13093780@N04,1080,28,1247478030,1247478060,2,9,30
13093780@N04,1080,30,1247478060,1247478076,2,9,16
13093780@N04,1080,28,1247478076,1247478286,10,9,210
13093780@N04,1080,25,1247478286,1247478411,5,9,125
13093780@N04,1080,28,1247478411,1247478433,2,9,22
13093780@N04,1080,25,1247478433,1247479273,2,9,840
130979231@N04,1081,5,1362529220,1362529230,2,10,10
130979231@N04,1081,3,1362529230,1362529320,2,10,90
130979231@N04,1081,21,1362529571,1362530141,2,10,570
130979231@N04,1081,18,1362531329,1362531779,2,10,450
130979231@N04,1081,20,1362538420,1362538960,2,10,540
130979231@N04,1081,17,1362546119,1362546419,2,10,300
130979231@N04,1081,21,1362549652,1362549937,2,10,285
130979231@N04,1081,4,1362549937,1362550038,2,10,101
130979231@N04,1081,26,1362553509,1362554409,3,10,900
130979231@N04,1081,17,1362560599,1362560899,1,10,300
130979231@N04,1082,1,1366956789,1366956849,2,3,60
130979231@N04,1082,31,1366961031,1366962080,2,3,1049
130979231@N04,1082,11,1366962080,1366962320,1,3,240
13101664@N03,1083,4,1424295075,1424295176,4,18,101
13101664@N03,1083,7,1424295583,1424295763,2,18,180
13101664@N03,1083,16,1424298444,1424298714,2,18,270
13101664@N03,1083,27,1424301358,1424302258,2,18,900
13101664@N03,1083,24,1424307471,1424308251,2,18,780
13101664@N03,1083,23,1424308521,1424309121,2,18,600
13101664@N03,1083,17,1424310633,1424310933,2,18,300
13101664@N03,1083,15,1424312596,1424312866,2,18,270
13101664@N03,1083,28,1424314007,1424314907,3,18,900
13101664@N03,1083,16,1424315352,1424315424,3,18,72
13101664@N03,1083,26,1424315424,1424316120,5,18,696
13101664@N03,1083,28,1424316120,1424316902,2,18,782
13101664@N03,1083,1,1424316902,1424316962,3,18,60
13101664@N03,1083,28,1424317817,1424318717,3,18,900
13101664@N03,1083,1,1424319154,1424319214,13,18,60
13101664@N03,1083,30,1424334749,1424335829,2,18,1080
13101664@N03,1083,29,1424339584,1424340484,4,18,900
13101664@N03,1083,17,1424342478,1424342778,1,18,300
13101664@N03,1084,28,1424385362,1424386262,2,13,900
13101664@N03,1084,19,1424387729,1424388269,2,13,540
13101664@N03,1084,30,1424389523,1424390603,3,13,1080
13101664@N03,1084,23,1424391648,1424392248,2,13,600
13101664@N03,1084,27,1424394378,1424395278,3,13,900
13101664@N03,1084,26,1424396220,1424397120,2,13,900
13101664@N03,1084,13,1424397397,1424397637,2,13,240
13101664@N03,1084,24,1424400029,1424400809,3,13,780
13101664@N03,1084,13,1424402331,1424402571,2,13,240
13101664@N03,1084,26,1424407593,1424408493,3,13,900
13101664@N03,1084,3,1424410008,1424410098,2,13,90
13101664@N03,1084,21,1424411293,1424411863,3,13,570
13101664@N03,1084,3,1424412614,1424412704,1,13,90
13101664@N03,1085,28,1424918235,1424918304,2,2,69
13101664@N03,1085,26,1424918304,1424919204,1,2,900
13125640@N07,1086,1,1197628633,1197628693,5,8,60
13125640@N07,1086,15,1197631129,1197631399,5,8,270
13125640@N07,1086,16,1197634651,1197634921,3,8,270
13125640@N07,1086,26,1197635613,1197636513,20,8,900
13125640@N07,1086,31,1197636584,1197638084,12,8,1500
13125640@N07,1086,24,1197639457,1197640237,4,8,780
13125640@N07,1086,16,1197641790,1197641974,2,8,184
13125640@N07,1086,28,1197641974,1197642874,11,8,900
13125640@N07,1087,27,1200120211,1200121111,4,5,900
13125640@N07,1087,30,1200132266,1200132966,4,5,700
13125640@N07,1087,23,1200132966,1200133566,2,5,600
13125640@N07,1087,15,1200134206,1200134476,2,5,270
13125640@N07,1087,16,1200138207,1200138477,4,5,270
13125640@N07,1088,1,1202466304,1202466364,26,1,60
13125640@N07,1089,28,1204284671,1204285529,6,2,858
13125640@N07,1089,23,1204285529,1204286129,1,2,600
131378402@N06,1090,26,1420290004,1420290904,4,1,900
131401490@N02,1091,26,1361747012,1361747912,1,1,900
13158511@N00,1092,4,1356863707,1356863808,2,2,101
13158511@N00,1092,16,1356867366,1356867636,1,2,270
13158511@N00,1093,28,1356957397,1356958297,2,2,900
13158511@N00,1093,18,1356958576,1356959026,1,2,450
13158511@N00,1094,17,1359780281,1359780581,1,1,300
13158511@N00,1095,29,1370598362,1370598829,2,2,467
13158511@N00,1095,15,1370598829,1370599099,6,2,270
13158511@N00,1096,1,1378634406,1378634466,1,1,60
13158511@N00,1097,1,1382253023,1382253083,1,1,60
13158511@N00,1098,1,1383442571,1383442631,1,1,60
13158511@N00,1099,17,1385264023,1385264323,1,1,300
13158511@N00,1100,1,1386227924,1386227984,1,1,60
13168981@N04,1101,23,1335322544,1335322546,3,3,2
13168981@N04,1101,26,1335322546,1335322565,4,3,19
13168981@N04,1101,30,1335322565,1335323645,1,3,1080
13168981@N04,1102,28,1337574617,1337574626,2,4,9
13168981@N04,1102,1,1337574626,1337574637,4,4,11
13168981@N04,1102,28,1337574637,1337574644,2,4,7
13168981@N04,1102,1,1337574644,1337574704,1,4,60
13168981@N04,1103,18,1343198242,1343198692,38,1,450
13168981@N04,1104,1,1347752737,1347752797,20,1,60
13168981@N04,1105,30,1353096025,1353096072,7,3,47
13168981@N04,1105,26,1353096072,1353096223,22,3,151
13168981@N04,1105,20,1353096223,1353096763,21,3,540
13168981@N04,1106,28,1356134495,1356134607,10,3,112
13168981@N04,1106,26,1356134607,1356134679,2,3,72
13168981@N04,1106,28,1356134679,1356135579,18,3,900
13168981@N04,1107,1,1379071783,1379071843,5,5,60
13168981@N04,1107,30,1379071859,1379072007,11,5,148
13168981@N04,1107,14,1379072007,1379072015,2,5,8
13168981@N04,1107,1,1379072015,1379072029,2,5,14
13168981@N04,1107,23,1379072029,1379072629,9,5,600
13168981@N04,1108,1,1386129813,1386129838,3,6,25
13168981@N04,1108,28,1386129838,1386129885,2,6,47
13168981@N04,1108,14,1386129885,1386129890,2,6,5
13168981@N04,1108,20,1386129890,1386129943,7,6,53
13168981@N04,1108,28,1386129943,1386129955,2,6,12
13168981@N04,1108,1,1386129955,1386130015,1,6,60
13168981@N04,1109,30,1397848170,1397849250,22,1,1080
13168981@N04,1110,20,1398160998,1398161003,2,5,5
13168981@N04,1110,29,1398161003,1398161020,4,5,17
13168981@N04,1110,20,1398161020,1398161031,3,5,11
13168981@N04,1110,29,1398161031,1398161058,2,5,27
13168981@N04,1110,20,1398161058,1398161598,1,5,540
13168981@N04,1111,20,1398244313,1398244853,14,1,540
13168981@N04,1112,29,1398454363,1398455263,8,1,900
132052954@N06,1113,15,1427090975,1427091245,1,1,270
13288022@N00,1114,1,1214645196,1214645256,1,1,60
132888308@N07,1115,26,1471827512,1471828412,1,1,900
13294928@N02,1116,8,1192783971,1192784151,98,1,180
13294928@N02,1117,8,1192961103,1192961283,41,1,180
13294928@N02,1118,8,1193397380,1193397560,1,1,180
13294928@N02,1119,8,1195956980,1195957160,38,1,180
133044002@N07,1120,15,1455320412,1455320682,1,1,270
133044002@N07,1121,26,1466909156,1466910056,1,1,900
133103935@N06,1122,26,1467170310,1467171210,5,2,900
133103935@N06,1122,16,1467195364,1467195634,1,2,270
13312992@N06,1123,28,1348182550,1348182745,2,24,195
13312992@N06,1123,16,1348182745,1348182852,2,24,107
13312992@N06,1123,27,1348182852,1348183752,3,24,900
13312992@N06,1123,24,1348186993,1348187773,11,24,780
13312992@N06,1123,26,1348190913,1348191813,8,24,900
13312992@N06,1123,5,1348193827,1348193947,2,24,120
13312992@N06,1123,26,1348195141,1348196041,3,24,900
13312992@N06,1123,13,1348200920,1348201160,3,24,240
13312992@N06,1123,18,1348201891,1348202341,4,24,450
13312992@N06,1123,29,1348202783,1348202932,2,24,149
13312992@N06,1123,19,1348202932,1348203472,3,24,540
13312992@N06,1123,18,1348204701,1348205151,3,24,450
13312992@N06,1123,19,1348208288,1348208579,3,24,291
13312992@N06,1123,30,1348208579,1348209659,2,24,1080
13312992@N06,1123,29,1348213549,1348213993,7,24,444
13312992@N06,1123,31,1348213993,1348215348,3,24,1355
13312992@N06,1123,26,1348215348,1348216248,3,24,900
13312992@N06,1123,1,1348223808,1348223868,4,24,60
13312992@N06,1123,29,1348224803,1348225703,12,24,900
13312992@N06,1123,26,1348227670,1348228570,21,24,900
13312992@N06,1123,31,1348230747,1348232192,7,24,1445
13312992@N06,1123,26,1348232192,1348232495,3,24,303
13312992@N06,1123,16,1348232495,1348232765,2,24,270
13312992@N06,1123,24,1348232982,1348233762,1,24,780
13312992@N06,1124,24,1348270172,1348270952,3,14,780
13312992@N06,1124,12,1348271121,1348271361,2,14,240
13312992@N06,1124,29,1348276536,1348276780,3,14,244
13312992@N06,1124,20,1348276780,1348276797,2,14,17
13312992@N06,1124,31,1348276797,1348276801,2,14,4
13312992@N06,1124,20,1348276801,1348276910,3,14,109
13312992@N06,1124,31,1348276910,1348277310,3,14,400
13312992@N06,1124,20,1348277310,1348277850,8,14,540
13312992@N06,1124,14,1348278999,1348279039,2,14,40
13312992@N06,1124,22,1348279039,1348279168,3,14,129
13312992@N06,1124,14,1348279168,1348279408,5,14,240
13312992@N06,1124,22,1348284038,1348284638,3,14,600
13312992@N06,1124,29,1348286210,1348287110,2,14,900
13312992@N06,1124,28,1348288126,1348289026,3,14,900
13312992@N06,1125,1,1348316959,1348317019,2,3,60
13312992@N06,1125,28,1348317231,1348318131,5,3,900
13312992@N06,1125,26,1348318978,1348319878,1,3,900
13312992@N06,1126,24,1355988278,1355989058,2,4,780
13312992@N06,1126,26,1355990853,1355991753,7,4,900
13312992@N06,1126,28,1355992229,1355992572,3,4,343
13312992@N06,1126,1,1355992572,1355992632,1,4,60
13312992@N06,1127,1,1356039943,1356040003,4,36,60
13312992@N06,1127,28,1356040065,1356040322,5,36,257
13312992@N06,1127,12,1356040322,1356040562,2,36,240
13312992@N06,1127,26,1356040604,1356040986,8,36,382
13312992@N06,1127,27,1356040986,1356041089,2,36,103
13312992@N06,1127,16,1356041089,1356041359,5,36,270
13312992@N06,1127,24,1356041748,1356041804,5,36,56
13312992@N06,1127,12,1356041804,1356041836,2,36,32
13312992@N06,1127,24,1356041836,1356041838,2,36,2
13312992@N06,1127,12,1356041838,1356042078,5,36,240
13312992@N06,1127,21,1356042607,1356043177,6,36,570
13312992@N06,1127,4,1356043219,1356043266,2,36,47
13312992@N06,1127,21,1356043266,1356043407,4,36,141
13312992@N06,1127,3,1356043407,1356043423,2,36,16
13312992@N06,1127,8,1356043423,1356043596,2,36,173
13312992@N06,1127,24,1356043596,1356043644,2,36,48
13312992@N06,1127,21,1356043644,1356043825,2,36,181
13312992@N06,1127,24,1356043825,1356043919,2,36,94
13312992@N06,1127,12,1356043919,1356044139,4,36,220
13312992@N06,1127,24,1356044139,1356044919,3,36,780
13312992@N06,1127,1,1356050705,1356050765,2,36,60
13312992@N06,1127,28,1356050798,1356051086,3,36,288
13312992@N06,1127,26,1356051086,1356051342,2,36,256
13312992@N06,1127,19,1356051342,1356051882,7,36,540
13312992@N06,1127,29,1356052960,1356053860,9,36,900
13312992@N06,1127,22,1356055225,1356055438,2,36,213
13312992@N06,1127,14,1356055438,1356055678,29,36,240
13312992@N06,1127,22,1356056881,1356057008,2,36,127
13312992@N06,1127,20,1356057008,1356057548,2,36,540
13312992@N06,1127,29,1356060246,1356061146,7,36,900
13312992@N06,1127,21,1356064629,1356065199,21,36,570
13312992@N06,1127,19,1356067032,1356067132,2,36,100
13312992@N06,1127,21,1356067132,1356067702,40,36,570
13312992@N06,1127,13,1356068605,1356068845,2,36,240
13312992@N06,1127,3,1356069367,1356069457,3,36,90
13312992@N06,1127,26,1356070428,1356071328,1,36,900
13312992@N06,1128,17,1356119291,1356119591,2,7,300
13312992@N06,1128,1,1356124190,1356124250,2,7,60
13312992@N06,1128,28,1356124296,1356124663,4,7,367
13312992@N06,1128,26,1356124663,1356125344,13,7,681
13312992@N06,1128,12,1356125344,1356125558,2,7,214
13312992@N06,1128,26,1356125558,1356125769,3,7,211
13312992@N06,1128,28,1356125769,1356126669,3,7,900
13312992@N06,1129,1,1443343060,1443343120,1,1,60
13312992@N06,1130,1,1443406236,1443406296,4,2,60
13312992@N06,1130,28,1443410040,1443410940,2,2,900
13312992@N06,1131,1,1443478640,1443478700,2,4,60
13312992@N06,1131,14,1443479559,1443479799,12,4,240
13312992@N06,1131,6,1443493665,1443493785,2,4,120
13312992@N06,1131,21,1443519538,1443520108,1,4,570
13312992@N06,1132,28,1443562243,1443562277,3,4,34
13312992@N06,1132,1,1443562277,1443562337,2,4,60
13312992@N06,1132,28,1443562367,1443563267,5,4,900
13312992@N06,1132,1,1443565733,1443565793,1,4,60
13332833@N06,1133,28,1326859644,1326860544,2,1,900
13332833@N06,1134,27,1329904105,1329905005,2,3,900
13332833@N06,1134,16,1329907190,1329907460,2,3,270
13332833@N06,1134,28,1329908336,1329909236,1,3,900
133444919@N08,1135,26,1434625463,1434626363,16,1,900
133444919@N08,1136,18,1437019176,1437019626,2,2,450
133444919@N08,1136,27,1437022722,1437023622,1,2,900
133444919@N08,1137,28,1437079954,1437080854,4,7,900
133444919@N08,1137,5,1437080890,1437081010,2,7,120
133444919@N08,1137,11,1437081560,1437081644,2,7,84
133444919@N08,1137,21,1437081644,1437082214,2,7,570
133444919@N08,1137,25,1437083395,1437084235,2,7,840
133444919@N08,1137,12,1437086141,1437086381,2,7,240
133444919@N08,1137,28,1437111039,1437111939,5,7,900
13349207@N00,1138,13,1397279225,1397279465,3,2,240
13349207@N00,1138,7,1397291517,1397291697,1,2,180
13349207@N00,1139,25,1415441766,1415442606,3,3,840
13349207@N00,1139,13,1415442657,1415442679,2,3,22
13349207@N00,1139,25,1415442679,1415443519,1,3,840
13349207@N00,1140,7,1426540015,1426540195,1,1,180
13349207@N00,1141,15,1433220475,1433220745,1,1,270
13349207@N00,1142,24,1441108589,1441109369,2,4,780
13349207@N00,1142,3,1441110059,1441110149,3,4,90
13349207@N00,1142,4,1441111231,1441111332,5,4,101
13349207@N00,1142,25,1441114990,1441115830,3,4,840
13349207@N00,1143,4,1460848148,1460848249,4,3,101
13349207@N00,1143,3,1460848803,1460848893,3,3,90
13349207@N00,1143,15,1460857584,1460857854,2,3,270
13355109@N08,1144,10,1202878833,1202879073,1,1,240
13355109@N08,1145,28,1226649921,1226649927,2,2,6
13355109@N08,1145,8,1226649927,1226650107,1,2,180
13355580@N00,1146,30,1283480852,1283481932,1,1,1080
13355580@N00,1147,29,1317173001,1317173901,1,1,900
13359377@N05,1148,26,1421047485,1421048385,1,1,900
13359377@N05,1149,10,1421217868,1421218108,2,2,240
13359377@N05,1149,1,1421222449,1421222509,1,2,60
13359849@N00,1150,28,1349597476,1349598376,2,2,900
13359849@N00,1150,20,1349600980,1349601520,1,2,540
13359849@N00,1151,28,1358533388,1358534288,1,1,900
13359849@N00,1152,29,1373109884,1373110784,1,1,900
13359849@N00,1153,1,1377848973,1377849033,1,1,60
13359849@N00,1154,1,1378618552,1378618612,1,1,60
13359849@N00,1155,1,1400837245,1400837305,2,1,60
13359849@N00,1156,14,1416086221,1416086461,1,1,240
13359849@N00,1157,18,1441499401,1441499851,1,1,450
13359849@N00,1158,18,1441626356,1441626806,1,1,450
13359849@N00,1159,18,1442061788,1442062238,1,1,450
133763744@N08,1160,1,1436280983,1436281043,1,1,60
133911707@N06,1161,28,1362080848,1362081285,2,3,437
133911707@N06,1161,1,1362081285,1362081345,2,3,60
133911707@N06,1161,26,1362082019,1362082919,2,3,900
13408740@N00,1162,26,1200203558,1200204458,1,1,900
13416981@N08,1163,30,1302175225,1302176305,1,1,1080
13430916@N06,1164,1,1388455616,1388455676,1,1,60
134944545@N04,1165,26,1437092271,1437093171,1,1,900
135438961@N08,1166,26,1442061598,1442062498,1,1,900
135451172@N07,1167,1,1453585562,1453585622,3,3,60
135451172@N07,1167,26,1453591388,1453592288,4,3,900
135451172@N07,1167,12,1453593370,1453593610,1,3,240
135452001@N06,1168,26,1450309722,1450310622,1,1,900
13551979@N02,1169,15,1368756489,1368756759,1,1,270
13551979@N02,1170,1,1369121282,1369121342,1,1,60
13551979@N02,1171,1,1369458089,1369458149,2,1,60
13551979@N02,1172,27,1370932131,1370932157,2,2,26
13551979@N02,1172,17,1370932157,1370932457,1,2,300
13551979@N02,1173,1,1371631100,1371631160,2,1,60
13551979@N02,1174,30,1379053890,1379054970,2,1,1080
13551979@N02,1175,20,1379991664,1379991683,2,3,19
13551979@N02,1175,12,1379991683,1379991702,2,3,19
13551979@N02,1175,20,1379991702,1379992242,1,3,540
13551979@N02,1176,28,1380072488,1380073388,3,1,900
13551979@N02,1177,28,1384307282,1384308182,2,1,900
13551979@N02,1178,26,1386057952,1386057971,2,4,19
13551979@N02,1178,28,1386057971,1386058006,2,4,35
13551979@N02,1178,25,1386058006,1386058846,2,4,840
13551979@N02,1178,27,1386063595,1386064495,1,4,900
13551979@N02,1179,17,1391999200,1391999500,1,1,300
13551979@N02,1180,15,1393895284,1393895554,3,1,270
13551979@N02,1181,30,1394530903,1394531983,1,1,1080
13551979@N02,1182,28,1415150933,1415151833,1,1,900
13551979@N02,1183,18,1425618916,1425619366,1,1,450
13551979@N02,1184,18,1427008826,1427009276,2,1,450
13551979@N02,1185,18,1429410164,1429410614,3,1,450
13551979@N02,1186,26,1432346399,1432347299,1,1,900
13551979@N02,1187,18,1433396982,1433397432,1,1,450
13551979@N02,1188,18,1436939432,1436939882,1,1,450
13551979@N02,1189,18,1445488187,1445488637,2,1,450
13552664@N03,1190,26,1380801462,1380802362,2,1,900
13558673@N07,1191,11,1281342878,1281343118,1,1,240
13559239@N07,1192,16,1356489344,1356489614,2,2,270
13559239@N07,1192,22,1356496287,1356496887,1,2,600
13582692@N00,1193,4,1323426812,1323426913,1,1,101
13582692@N00,1194,28,1324189793,1324190693,1,1,900
13591831@N00,1195,18,1454679089,1454679539,4,1,450
13599014@N08,1196,30,1438138480,1438139560,3,1,1080
136309822@N08,1197,26,1454252080,1454252980,5,1,900
136309822@N08,1198,6,1454922440,1454922560,3,2,120
136309822@N08,1198,26,1454935053,1454935953,4,2,900
136309822@N08,1199,26,1455012931,1455013831,1,1,900
136309822@N08,1200,26,1455797530,1455798430,9,1,900
136309822@N08,1201,28,1464614892,1464615792,4,1,900
136309822@N08,1202,1,1464653862,1464653922,2,10,60
136309822@N08,1202,28,1464655682,1464656434,2,10,752
136309822@N08,1202,1,1464656434,1464656494,2,10,60
136309822@N08,1202,28,1464657592,1464658026,3,10,434
136309822@N08,1202,1,1464658026,1464658067,3,10,41
136309822@N08,1202,28,1464658067,1464658076,2,10,9
136309822@N08,1202,1,1464658076,1464658136,2,10,60
136309822@N08,1202,28,1464659217,1464660117,6,10,900
136309822@N08,1202,16,1464662851,1464663121,2,10,270
136309822@N08,1202,26,1464677144,1464678044,1,10,900
13644648@N03,1203,20,1272445029,1272445029,2,28,0
13644648@N03,1203,30,1272445029,1272445030,2,28,1
13644648@N03,1203,4,1272445030,1272445031,2,28,1
13644648@N03,1203,12,1272445031,1272445032,2,28,1
13644648@N03,1203,4,1272445032,1272445032,2,28,0
13644648@N03,1203,24,1272445032,1272445033,2,28,1
13644648@N03,1203,4,1272445033,1272445034,2,28,1
13644648@N03,1203,1,1272445034,1272445035,2,28,1
13644648@N03,1203,22,1272445035,1272445037,2,28,2
13644648@N03,1203,16,1272445037,1272445038,2,28,1
13644648@N03,1203,28,1272445038,1272445040,3,28,2
13644648@N03,1203,20,1272445040,1272445040,2,28,0
13644648@N03,1203,31,1272445040,1272445041,2,28,1
13644648@N03,1203,24,1272445041,1272445042,2,28,1
13644648@N03,1203,20,1272445042,1272445043,2,28,1
13644648@N03,1203,26,1272445043,1272445044,2,28,1
13644648@N03,1203,9,1272445044,1272445045,2,28,1
13644648@N03,1203,16,1272445045,1272445047,2,28,2
13644648@N03,1203,26,1272445047,1272445048,2,28,1
13644648@N03,1203,14,1272445048,1272445048,2,28,0
13644648@N03,1203,25,1272445048,1272445049,2,28,1
13644648@N03,1203,26,1272445049,1272445050,2,28,1
13644648@N03,1203,3,1272445050,1272445051,2,28,1
13644648@N03,1203,12,1272445051,1272445051,2,28,0
13644648@N03,1203,22,1272445051,1272445052,2,28,1
13644648@N03,1203,3,1272445052,1272445055,5,28,3
13644648@N03,1203,5,1272445055,1272445056,2,28,1
13644648@N03,1203,21,1272445056,1272445626,1,28,570
13644648@N03,1204,30,1280213834,1280213836,3,39,2
13644648@N03,1204,29,1280213836,1280213837,2,39,1
13644648@N03,1204,25,1280213837,1280213840,2,39,3
13644648@N03,1204,13,1280213840,1280213844,2,39,4
13644648@N03,1204,26,1280213844,1280213845,2,39,1
13644648@N03,1204,11,1280213845,1280213846,2,39,1
13644648@N03,1204,21,1280213846,1280213848,3,39,2
13644648@N03,1204,23,1280213848,1280213851,3,39,3
13644648@N03,1204,31,1280213851,1280213853,2,39,2
13644648@N03,1204,29,1280213853,1280213855,3,39,2
13644648@N03,1204,30,1280213855,1280213857,3,39,2
13644648@N03,1204,27,1280213857,1280213858,2,39,1
13644648@N03,1204,6,1280213858,1280213859,2,39,1
13644648@N03,1204,3,1280213859,1280213860,2,39,1
13644648@N03,1204,12,1280213860,1280213861,2,39,1
13644648@N03,1204,21,1280213861,1280213873,12,39,12
13644648@N03,1204,5,1280213873,1280213873,2,39,0
13644648@N03,1204,28,1280213873,1280213877,4,39,4
13644648@N03,1204,17,1280213877,1280213878,2,39,1
13644648@N03,1204,20,1280213878,1280213882,3,39,4
13644648@N03,1204,12,1280213882,1280213883,2,39,1
13644648@N03,1204,26,1280213883,1280213885,2,39,2
13644648@N03,1204,16,1280213885,1280213886,2,39,1
13644648@N03,1204,17,1280213886,1280213887,2,39,1
13644648@N03,1204,16,1280213887,1280213888,2,39,1
13644648@N03,1204,12,1280213888,1280213892,2,39,4
13644648@N03,1204,25,1280213892,1280213900,9,39,8
13644648@N03,1204,13,1280213900,1280213901,2,39,1
13644648@N03,1204,28,1280213901,1280213903,3,39,2
13644648@N03,1204,26,1280213903,1280213904,2,39,1
13644648@N03,1204,30,1280213904,1280213905,2,39,1
13644648@N03,1204,29,1280213905,1280213906,2,39,1
13644648@N03,1204,30,1280213906,1280213907,2,39,1
13644648@N03,1204,20,1280213907,1280213909,3,39,2
13644648@N03,1204,1,1280213909,1280213910,2,39,1
13644648@N03,1204,25,1280213910,1280213911,2,39,1
13644648@N03,1204,3,1280213911,1280213913,3,39,2
13644648@N03,1204,29,1280213913,1280214813,2,39,900
13644648@N03,1204,7,1280217194,1280217374,2,39,180
13644648@N03,1205,31,1336203617,1336205117,1,1,1500
13665830@N07,1206,26,1454371459,1454371482,3,4,23
13665830@N07,1206,16,1454371482,1454371752,3,4,270
13665830@N07,1206,26,1454371870,1454372770,5,4,900
13665830@N07,1206,30,1454373363,1454374443,4,4,1080
13667007@N07,1207,31,1237688880,1237690380,3,1,1500
136678498@N06,1208,24,1443841180,1443841960,2,9,780
136678498@N06,1208,30,1443847821,1443848901,2,9,1080
136678498@N06,1208,29,1443848991,1443849657,2,9,666
136678498@N06,1208,22,1443849657,1443850119,2,9,462
136678498@N06,1208,29,1443850119,1443851019,2,9,900
136678498@N06,1208,19,1443851615,1443852155,2,9,540
136678498@N06,1208,23,1443852354,1443852723,2,9,369
136678498@N06,1208,13,1443852723,1443852963,2,9,240
136678498@N06,1208,1,1443853172,1443853232,1,9,60
136678498@N06,1209,23,1462434322,1462434922,1,1,600
136678498@N06,1210,21,1465978946,1465979516,1,1,570
13696003@N06,1211,18,1434043860,1434044310,1,1,450
13701504@N00,1212,29,1282719550,1282720450,3,1,900
13701504@N00,1213,15,1282872404,1282872674,3,1,270
13701504@N00,1214,29,1283741572,1283741579,2,9,7
13701504@N00,1214,19,1283741579,1283741710,2,9,131
13701504@N00,1214,28,1283741710,1283741722,2,9,12
13701504@N00,1214,26,1283741722,1283741761,2,9,39
13701504@N00,1214,28,1283741761,1283741769,2,9,8
13701504@N00,1214,14,1283741769,1283741786,2,9,17
13701504@N00,1214,24,1283741786,1283741843,3,9,57
13701504@N00,1214,28,1283741843,1283741849,2,9,6
13701504@N00,1214,12,1283741849,1283742089,3,9,240
13725093@N02,1215,5,1246924853,1246924973,1,1,120
13729350@N06,1216,24,1198435514,1198436294,1,1,780
13729350@N06,1217,10,1214043922,1214043960,2,4,38
13729350@N06,1217,30,1214043960,1214044319,2,4,359
13729350@N06,1217,10,1214044319,1214044559,2,4,240
13729350@N06,1217,30,1214044608,1214045688,1,4,1080
13729350@N06,1218,10,1214122479,1214122719,2,1,240
13729350@N06,1219,10,1214726253,1214726493,1,1,240
13749494@N04,1220,26,1437280889,1437281789,1,1,900
13749494@N04,1221,26,1437353496,1437354396,12,1,900
13749494@N04,1222,26,1437429732,1437430632,29,1,900
13749494@N04,1223,26,1437531595,1437532495,9,1,900
13749494@N04,1224,26,1437619173,1437620073,5,1,900
13749494@N04,1225,26,1437689893,1437690793,5,1,900
13750887@N06,1226,10,1193957868,1193958108,73,1,240
13750887@N06,1227,10,1195169149,1195169389,86,1,240
13784458@N04,1228,13,1254532610,1254532850,1,1,240
13796428@N02,1229,30,1197934352,1197935432,14,1,1080
13796428@N02,1230,30,1198576140,1198577220,1,1,1080
13796428@N02,1231,18,1251364984,1251365434,1,1,450
13796428@N02,1232,15,1251433250,1251433520,1,1,270
13816967@N02,1233,1,1373329712,1373329772,1,1,60
13818837@N05,1234,6,1291686765,1291686885,2,3,120
13818837@N05,1234,20,1291696191,1291696731,2,3,540
13818837@N05,1234,24,1291702006,1291702786,2,3,780
13818837@N05,1235,28,1291764504,1291765404,2,5,900
13818837@N05,1235,20,1291778787,1291779327,2,5,540
13818837@N05,1235,15,1291784580,1291784850,2,5,270
13818837@N05,1235,26,1291798115,1291798382,2,5,267
13818837@N05,1235,28,1291798382,1291799282,1,5,900
13818837@N05,1236,1,1317593441,1317593501,2,11,60
13818837@N05,1236,27,1317594656,1317595556,2,11,900
13818837@N05,1236,17,1317596080,1317596380,3,11,300
13818837@N05,1236,24,1317599319,1317600099,3,11,780
13818837@N05,1236,12,1317600265,1317600505,2,11,240
13818837@N05,1236,26,1317600766,1317601666,2,11,900
13818837@N05,1236,3,1317602039,1317602129,2,11,90
13818837@N05,1236,25,1317602490,1317603330,2,11,840
13818837@N05,1236,20,1317605225,1317605765,2,11,540
13818837@N05,1236,14,1317608309,1317608549,2,11,240
13818837@N05,1236,30,1317608638,1317609718,1,11,1080
13818837@N05,1237,24,1317692160,1317692706,3,4,546
13818837@N05,1237,12,1317692706,1317692946,2,4,240
13818837@N05,1237,30,1317693883,1317694700,2,4,817
13818837@N05,1237,20,1317694700,1317695240,2,4,540
13818837@N05,1238,30,1317863475,1317864555,2,4,1080
13818837@N05,1238,26,1317870765,1317871665,3,4,900
13818837@N05,1238,24,1317877661,1317878441,2,4,780
13818837@N05,1238,12,1317899114,1317899354,1,4,240
13818837@N05,1239,26,1343004774,1343005674,4,4,900
13818837@N05,1239,17,1343013884,1343014184,2,4,300
13818837@N05,1239,29,1343017992,1343018892,2,4,900
13818837@N05,1239,20,1343019343,1343019883,1,4,540
13818837@N05,1240,24,1343267449,1343268229,2,3,780
13818837@N05,1240,12,1343268336,1343268576,2,3,240
13818837@N05,1240,24,1343281346,1343282126,2,3,780
138710409@N03,1241,26,1461712637,1461713537,1,1,900
13875847@N00,1242,26,1254606688,1254607012,2,2,324
13875847@N00,1242,17,1254607012,1254607312,2,2,300
13875847@N00,1243,26,1254689940,1254690142,2,3,202
13875847@N00,1243,16,1254690142,1254690412,2,3,270
13875847@N00,1243,30,1254690464,1254691544,1,3,1080
13875847@N00,1244,17,1254731578,1254731878,1,1,300
13875847@N00,1245,26,1254906570,1254907470,1,1,900
13875847@N00,1246,26,1276384637,1276385537,2,3,900
13875847@N00,1246,29,1276400604,1276401504,4,3,900
13875847@N00,1246,1,1276407279,1276407339,9,3,60
13875847@N00,1247,1,1285977745,1285977805,4,16,60
13875847@N00,1247,30,1285981490,1285981754,4,16,264
13875847@N00,1247,29,1285981754,1285981821,3,16,67
13875847@N00,1247,31,1285981821,1285981857,2,16,36
13875847@N00,1247,22,1285981857,1285982421,4,16,564
13875847@N00,1247,31,1285982421,1285983370,4,16,949
13875847@N00,1247,20,1285983370,1285983910,5,16,540
13875847@N00,1247,18,1285986332,1285986782,2,16,450
13875847@N00,1247,27,1285994016,1285994916,3,16,900
13875847@N00,1247,17,1285994964,1285995264,8,16,300
13875847@N00,1247,22,1286000531,1286001131,2,16,600
13875847@N00,1247,29,1286006432,1286007332,4,16,900
13875847@N00,1247,30,1286021161,1286022196,4,16,1035
13875847@N00,1247,15,1286022196,1286022466,4,16,270
13875847@N00,1247,26,1286026948,1286027848,12,16,900
13875847@N00,1247,24,1286028181,1286028961,2,16,780
13875847@N00,1248,16,1286065552,1286065822,1,1,270
13875847@N00,1249,26,1349487975,1349488875,3,6,900
13875847@N00,1249,27,1349497186,1349498086,3,6,900
13875847@N00,1249,12,1349501132,1349501372,2,6,240
13875847@N00,1249,13,1349501780,1349502020,7,6,240
13875847@N00,1249,25,1349507138,1349507706,2,6,568
13875847@N00,1249,1,1349507706,1349507766,2,6,60
13875847@N00,1250,27,1349564536,1349565436,1,1,900
13878873@N08,1251,29,1208043416,1208044316,1,1,900
13885531@N00,1252,28,1237799550,1237800450,1,1,900
13885531@N00,1253,10,1237953089,1237953329,2,2,240
13885531@N00,1253,26,1237953445,1237954345,5,2,900
13918219@N00,1254,12,1188000553,1188000793,2,9,240
13918219@N00,1254,24,1188005150,1188005930,2,9,780
13918219@N00,1254,29,1188014575,1188015475,2,9,900
13918219@N00,1254,16,1188016438,1188016708,2,9,270
13918219@N00,1254,17,1188018941,1188019241,2,9,300
13918219@N00,1254,16,1188019940,1188020210,4,9,270
13918219@N00,1254,26,1188021898,1188022798,2,9,900
13918219@N00,1254,21,1188023125,1188023695,2,9,570
13918219@N00,1254,23,1188030461,1188031061,1,9,600
13922841@N00,1255,24,1413001139,1413001919,14,11,780
13922841@N00,1255,12,1413004091,1413004331,5,11,240
13922841@N00,1255,26,1413004542,1413004828,4,11,286
13922841@N00,1255,30,1413004828,1413005190,5,11,362
13922841@N00,1255,31,1413005190,1413005827,3,11,637
13922841@N00,1255,29,1413005827,1413006105,2,11,278
13922841@N00,1255,22,1413006105,1413006362,5,11,257
13922841@N00,1255,20,1413006362,1413006709,10,11,347
13922841@N00,1255,29,1413006709,1413006847,3,11,138
13922841@N00,1255,23,1413006847,1413007447,4,11,600
13922841@N00,1255,1,1413007497,1413007557,2,11,60
13922841@N00,1256,1,1437136081,1437136141,3,2,60
13922841@N00,1256,12,1437155996,1437156236,28,2,240
13922841@N00,1257,1,1440833006,1440833066,2,3,60
13922841@N00,1257,28,1440834096,1440834996,14,3,900
13922841@N00,1257,1,1440837225,1440837285,1,3,60
13922841@N00,1258,28,1443359322,1443360222,4,2,900
13922841@N00,1258,1,1443364383,1443364443,2,2,60
13922841@N00,1259,19,1443830293,1443830833,2,12,540
13922841@N00,1259,24,1443850289,1443851069,11,12,780
13922841@N00,1259,26,1443851439,1443852339,5,12,900
13922841@N00,1259,29,1443853423,1443853952,6,12,529
13922841@N00,1259,22,1443853952,1443854552,4,12,600
13922841@N00,1259,29,1443854817,1443855236,4,12,419
13922841@N00,1259,19,1443855236,1443855498,3,12,262
13922841@N00,1259,23,1443855498,1443856000,7,12,502
13922841@N00,1259,8,1443856000,1443856180,2,12,180
13922841@N00,1259,21,1443856231,1443856694,2,12,463
13922841@N00,1259,13,1443856694,1443856934,6,12,240
13922841@N00,1259,1,1443858752,1443858812,4,12,60
13922841@N00,1260,28,1446450464,1446450889,2,3,425
13922841@N00,1260,26,1446450889,1446451789,2,3,900
13922841@N00,1260,13,1446461628,1446461868,1,3,240
13922841@N00,1261,20,1448715577,1448716117,2,16,540
13922841@N00,1261,11,1448716447,1448716687,2,16,240
13922841@N00,1261,30,1448716827,1448717725,4,16,898
13922841@N00,1261,29,1448717725,1448717786,3,16,61
13922841@N00,1261,31,1448717786,1448718005,3,16,219
13922841@N00,1261,22,1448718005,1448718605,3,16,600
13922841@N00,1261,30,1448718659,1448719238,8,16,579
13922841@N00,1261,23,1448719238,1448719822,4,16,584
13922841@N00,1261,30,1448719822,1448720006,3,16,184
13922841@N00,1261,10,1448720006,1448720246,2,16,240
13922841@N00,1261,27,1448722922,1448723442,3,16,520
13922841@N00,1261,15,1448723442,1448723712,21,16,270
13922841@N00,1261,24,1448727125,1448727905,6,16,780
13922841@N00,1261,1,1448729222,1448729282,4,16,60
13922841@N00,1261,28,1448729332,1448729835,6,16,503
13922841@N00,1261,1,1448729835,1448729895,3,16,60
13922841@N00,1262,28,1448793200,1448794100,24,3,900
13922841@N00,1262,22,1448799355,1448799955,2,3,600
13922841@N00,1262,13,1448802061,1448802301,4,3,240
13922841@N00,1263,1,1450986467,1450986485,2,20,18
13922841@N00,1263,28,1450986485,1450986626,7,20,141
13922841@N00,1263,1,1450986626,1450986686,5,20,60
13922841@N00,1263,28,1450986695,1450987031,12,20,336
13922841@N00,1263,1,1450987031,1450987040,3,20,9
13922841@N00,1263,28,1450987040,1450987305,14,20,265
13922841@N00,1263,1,1450987305,1450987319,3,20,14
13922841@N00,1263,28,1450987319,1450988219,6,20,900
13922841@N00,1263,25,1450988579,1450988857,6,20,278
13922841@N00,1263,21,1450988857,1450988902,2,20,45
13922841@N00,1263,25,1450988902,1450988976,3,20,74
13922841@N00,1263,21,1450988976,1450989540,2,20,564
13922841@N00,1263,12,1450989540,1450989780,2,20,240
13922841@N00,1263,15,1450989861,1450989967,3,20,106
13922841@N00,1263,17,1450989967,1450990267,2,20,300
13922841@N00,1263,27,1450990541,1450990794,4,20,253
13922841@N00,1263,16,1450990794,1450990959,3,20,165
13922841@N00,1263,26,1450990959,1450991859,11,20,900
13922841@N00,1263,28,1450992709,1450993181,4,20,472
13922841@N00,1263,1,1450993181,1450993241,3,20,60
13922841@N00,1264,28,1453097586,1453098486,2,3,900
13922841@N00,1264,29,1453101258,1453102158,11,3,900
13922841@N00,1264,14,1453104405,1453104645,1,3,240
13922841@N00,1265,1,1453540019,1453540079,2,4,60
13922841@N00,1265,15,1453542699,1453542969,6,4,270
13922841@N00,1265,6,1453563905,1453564025,2,4,120
13922841@N00,1265,25,1453567001,1453567841,23,4,840
13922841@N00,1266,1,1454926025,1454926085,8,5,60
13922841@N00,1266,28,1454927289,1454928189,3,5,900
13922841@N00,1266,19,1454928312,1454928474,2,5,162
13922841@N00,1266,29,1454928474,1454929374,7,5,900
13922841@N00,1266,28,1454933005,1454933905,2,5,900
13922841@N00,1267,1,1462094720,1462094780,4,2,60
13922841@N00,1267,12,1462095537,1462095777,1,2,240
13922841@N00,1268,16,1468591882,1468592009,3,11,127
13922841@N00,1268,26,1468592009,1468592200,3,11,191
13922841@N00,1268,21,1468592200,1468592321,2,11,121
13922841@N00,1268,3,1468592321,1468592411,2,11,90
13922841@N00,1268,26,1468592570,1468592720,3,11,150
13922841@N00,1268,30,1468592720,1468593129,3,11,409
13922841@N00,1268,19,1468593129,1468593268,2,11,139
13922841@N00,1268,29,1468593268,1468593287,2,11,19
13922841@N00,1268,20,1468593287,1468593827,3,11,540
13922841@N00,1268,18,1468594192,1468594642,2,11,450
13922841@N00,1268,27,1468595331,1468596231,1,11,900
13922841@N00,1269,11,1468717711,1468717951,2,11,240
13922841@N00,1269,23,1468718037,1468718637,2,11,600
13922841@N00,1269,29,1468739366,1468739573,2,11,207
13922841@N00,1269,24,1468739573,1468740066,2,11,493
13922841@N00,1269,15,1468740066,1468740336,7,11,270
13922841@N00,1269,24,1468741862,1468741919,2,11,57
13922841@N00,1269,15,1468741919,1468742189,3,11,270
13922841@N00,1269,1,1468747620,1468747680,2,11,60
13922841@N00,1269,26,1468767055,1468767955,6,11,900
13922841@N00,1269,1,1468769622,1468769682,2,11,60
13922841@N00,1269,28,1468771990,1468772890,2,11,900
13923792@N06,1270,26,1303007421,1303008321,1,1,900
13923792@N06,1271,31,1330462152,1330463652,1,1,1500
13923792@N06,1272,24,1334467647,1334468427,1,1,780
13923792@N06,1273,14,1340421285,1340421525,1,1,240
13923792@N06,1274,28,1345254644,1345255544,1,1,900
13923792@N06,1275,28,1354779119,1354780019,1,1,900
13923792@N06,1276,14,1369347670,1369347910,1,1,240
13923792@N06,1277,1,1369377646,1369377706,1,1,60
13923792@N06,1278,16,1369422918,1369423188,2,2,270
13923792@N06,1278,1,1369426903,1369426963,1,2,60
13923792@N06,1279,1,1369459931,1369459991,1,1,60
13923792@N06,1280,1,1369710356,1369710416,2,2,60
13923792@N06,1280,13,1369721500,1369721740,1,2,240
13923792@N06,1281,1,1372399283,1372399343,1,1,60
13923792@N06,1282,1,1374022077,1374022137,1,1,60
13923792@N06,1283,23,1377956991,1377957591,2,2,600
13923792@N06,1283,1,1377985635,1377985695,1,2,60
13923792@N06,1284,27,1378423023,1378423923,1,1,900
13923792@N06,1285,17,1417562403,1417562703,1,1,300
13923792@N06,1286,17,1417646818,1417647118,1,1,300
13923792@N06,1287,18,1433207571,1433208021,1,1,450
13927809@N02,1288,28,1315385178,1315386078,1,1,900
13927809@N02,1289,29,1318384804,1318385704,1,1,900
13933131@N08,1290,1,1295661993,1295662053,2,11,60
13933131@N08,1290,28,1295662071,1295662382,3,11,311
13933131@N08,1290,26,1295662382,1295662733,5,11,351
13933131@N08,1290,18,1295662733,1295662970,4,11,237
13933131@N08,1290,29,1295662970,1295663870,3,11,900
13933131@N08,1290,14,1295666364,1295666604,2,11,240
13933131@N08,1290,31,1295666641,1295666809,2,11,168
13933131@N08,1290,18,1295666809,1295667259,2,11,450
13933131@N08,1290,16,1295673294,1295673323,2,11,29
13933131@N08,1290,12,1295673323,1295673563,2,11,240
13933131@N08,1290,28,1295673583,1295674483,2,11,900
13933131@N08,1291,26,1322124610,1322125510,1,1,900
13933131@N08,1292,29,1356060282,1356061182,2,2,900
13933131@N08,1292,26,1356063103,1356064003,1,2,900
13933131@N08,1293,27,1378515511,1378516411,32,6,900
13933131@N08,1293,28,1378537663,1378538563,3,6,900
13933131@N08,1293,27,1378542019,1378542919,4,6,900
13933131@N08,1293,21,1378543222,1378543327,2,6,105
13933131@N08,1293,18,1378543327,1378543516,2,6,189
13933131@N08,1293,28,1378543516,1378544416,1,6,900
13933131@N08,1294,13,1408068650,1408068890,5,1,240
13933872@N05,1295,1,1427064149,1427064209,2,2,60
13933872@N05,1295,13,1427073767,1427074007,1,2,240
13968334@N06,1296,26,1210048175,1210049075,1,1,900
13968334@N06,1297,1,1212353967,1212354027,1,1,60
13998921@N02,1298,28,1346151236,1346152136,5,5,900
13998921@N02,1298,1,1346153046,1346153106,4,5,60
13998921@N02,1298,16,1346156732,1346157002,2,5,270
13998921@N02,1298,28,1346157694,1346157750,3,5,56
13998921@N02,1298,16,1346157750,1346158020,1,5,270
13998921@N02,1299,16,1346225265,1346225535,2,4,270
13998921@N02,1299,1,1346245013,1346245073,2,4,60
13998921@N02,1299,28,1346245075,1346245975,4,4,900
13998921@N02,1299,30,1346249091,1346250171,1,4,1080
13998921@N02,1300,28,1346296617,1346297517,1,1,900
14042144@N07,1301,1,1393465543,1393465603,2,5,60
14042144@N07,1301,28,1393468465,1393469314,3,5,849
14042144@N07,1301,1,1393469314,1393469374,2,5,60
14042144@N07,1301,28,1393469535,1393470435,4,5,900
14042144@N07,1301,26,1393470812,1393471712,1,5,900
14059381@N06,1302,26,1260055540,1260056440,1,1,900
14102022@N02,1303,8,1194948094,1194948274,1,1,180
14110651@N03,1304,26,1302652987,1302653887,2,2,900
14110651@N03,1304,5,1302661553,1302661673,2,2,120
14136614@N03,1305,16,1328228274,1328228544,3,12,270
14136614@N03,1305,31,1328232180,1328233680,2,12,1500
14136614@N03,1305,19,1328233884,1328234424,2,12,540
14136614@N03,1305,29,1328234517,1328235352,2,12,835
14136614@N03,1305,31,1328235352,1328236852,3,12,1500
14136614@N03,1305,29,1328237616,1328238516,2,12,900
14136614@N03,1305,17,1328243520,1328243820,2,12,300
14136614@N03,1305,19,1328244518,1328245058,3,12,540
14136614@N03,1305,26,1328246940,1328247840,3,12,900
14136614@N03,1305,11,1328254080,1328254320,4,12,240
14136614@N03,1305,28,1328256592,1328257101,2,12,509
14136614@N03,1305,1,1328257101,1328257161,1,12,60
14157787@N07,1306,26,1317724592,1317725492,4,4,900
14157787@N07,1306,28,1317732669,1317733569,2,4,900
14157787@N07,1306,21,1317735542,1317736112,2,4,570
14157787@N07,1306,16,1317736225,1317736495,2,4,270
14161238@N08,1307,19,1411115269,1411115809,2,4,540
14161238@N08,1307,26,1411119790,1411120690,2,4,900
14161238@N08,1307,29,1411121029,1411121929,15,4,900
14161238@N08,1307,1,1411127983,1411128043,11,4,60
14161238@N08,1308,16,1411301451,1411301721,1,1,270
14161238@N08,1309,30,1412399544,1412400624,1,1,1080
14161238@N08,1310,27,1412593075,1412593975,1,1,900
14161238@N08,1311,26,1416129468,1416130368,2,2,900
14161238@N08,1311,25,1416135339,1416136179,1,2,840
14161238@N08,1312,18,1416306172,1416306622,1,1,450
14161238@N08,1313,11,1433665631,1433665708,2,4,77
14161238@N08,1313,6,1433665708,1433665828,2,4,120
14161238@N08,1313,12,1433667460,1433667700,2,4,240
14161238@N08,1313,1,1433673099,1433673159,1,4,60
14161238@N08,1314,28,1436691039,1436691831,2,2,792
14161238@N08,1314,23,1436691831,1436692431,3,2,600
14161238@N08,1315,7,1438253717,1438253897,4,2,180
14161238@N08,1315,21,1438254586,1438255156,24,2,570
14173066@N04,1316,30,1417501956,1417503036,6,1,1080
14193413@N06,1317,3,1249381570,1249381660,1,1,90
14213266@N06,1318,28,1322534706,1322535606,3,10,900
14213266@N06,1318,27,1322536266,1322537166,7,10,900
14213266@N06,1318,3,1322544524,1322544614,2,10,90
14213266@N06,1318,11,1322546753,1322546993,5,10,240
14213266@N06,1318,21,1322547653,1322548223,2,10,570
14213266@N06,1318,9,1322550760,1322550940,5,10,180
14213266@N06,1318,26,1322553117,1322554017,8,10,900
14213266@N06,1318,30,1322554489,1322555169,2,10,680
14213266@N06,1318,23,1322555169,1322555769,3,10,600
14213266@N06,1318,21,1322564874,1322565444,3,10,570
14221499@N00,1319,18,1339416178,1339416628,1,1,450
14221499@N00,1320,29,1339486253,1339487153,2,1,900
14221499@N00,1321,12,1363316959,1363317199,2,2,240
14221499@N00,1321,17,1363319080,1363319380,1,2,300
14221499@N00,1322,15,1363350175,1363350445,2,2,270
14221499@N00,1322,18,1363350704,1363351154,1,2,450
14221499@N00,1323,26,1376538238,1376539138,2,2,900
14221499@N00,1323,14,1376557983,1376558223,1,2,240
14221499@N00,1324,13,1376665454,1376665694,1,1,240
14221499@N00,1325,19,1413194132,1413194672,1,1,540
14221499@N00,1326,1,1413237126,1413237186,1,1,60
14221499@N00,1327,1,1413288885,1413288945,1,1,60
14221499@N00,1328,1,1420976713,1420976773,1,1,60
142287241@N02,1329,1,1468552636,1468552696,2,3,60
142287241@N02,1329,11,1468554272,1468554346,2,3,74
142287241@N02,1329,9,1468554346,1468554526,1,3,180
142287241@N02,1330,22,1469085484,1469086084,1,1,600
14233893@N02,1331,26,1301049860,1301050760,1,1,900
14233893@N02,1332,3,1304506303,1304506393,1,1,90
14233893@N02,1333,3,1307794723,1307794813,2,2,90
14233893@N02,1333,27,1307801255,1307802155,1,2,900
14233893@N02,1334,7,1314938600,1314938780,1,1,180
14246866@N05,1335,1,1232251648,1232251708,3,10,60
14246866@N05,1335,28,1232251989,1232252615,3,10,626
14246866@N05,1335,27,1232252615,1232252832,2,10,217
14246866@N05,1335,17,1232252832,1232253132,2,10,300
14246866@N05,1335,16,1232253483,1232253707,2,10,224
14246866@N05,1335,26,1232253707,1232254300,2,10,593
14246866@N05,1335,8,1232254300,1232254480,3,10,180
14246866@N05,1335,4,1232259817,1232259918,6,10,101
14246866@N05,1335,29,1232262354,1232263254,2,10,900
14246866@N05,1335,28,1232265477,1232266377,3,10,900
142525331@N04,1336,29,1460618173,1460619073,1,1,900
14256823@N08,1337,18,1192506975,1192507425,1,1,450
14258173@N00,1338,30,1191101679,1191102759,1,1,1080
14272980@N03,1339,31,1192836502,1192838002,1,1,1500
14272980@N03,1340,26,1196051481,1196052381,1,1,900
14272980@N03,1341,28,1196774939,1196775839,1,1,900
14272980@N03,1342,16,1201306241,1201306511,1,1,270
14280234@N04,1343,21,1195835424,1195835994,1,1,570
14280234@N04,1344,28,1206687536,1206688436,1,1,900
14280234@N04,1345,1,1217147911,1217147971,1,1,60
14280234@N04,1346,28,1222151731,1222152631,1,1,900
14280234@N04,1347,1,1225953643,1225953703,1,1,60
14280234@N04,1348,16,1231899242,1231899512,1,1,270
14280234@N04,1349,1,1245901524,1245901584,1,1,60
14280234@N04,1350,16,1248527397,1248527667,2,1,270
14280234@N04,1351,16,1253426791,1253427061,1,1,270
14280234@N04,1352,29,1254388586,1254389486,1,1,900
14280234@N04,1353,26,1254725739,1254726639,1,1,900
14280234@N04,1354,29,1255255717,1255256617,1,1,900
14280234@N04,1355,26,1256465663,1256466563,1,1,900
14280234@N04,1356,26,1256960864,1256961764,2,2,900
14280234@N04,1356,16,1256969692,1256969962,1,2,270
14280234@N04,1357,1,1258153911,1258153971,2,4,60
14280234@N04,1357,28,1258161099,1258161999,2,4,900
14280234@N04,1357,26,1258174337,1258174364,2,4,27
14280234@N04,1357,16,1258174364,1258174634,1,4,270
14280234@N04,1358,26,1258599277,1258600177,3,1,900
14280234@N04,1359,16,1259979260,1259979279,2,2,19
14280234@N04,1359,21,1259979279,1259979849,1,2,570
14280234@N04,1360,26,1261284708,1261285608,1,1,900
14280234@N04,1361,11,1262762237,1262762477,1,1,240
14280234@N04,1362,26,1270883583,1270884483,1,1,900
14280234@N04,1363,21,1273394283,1273394853,1,1,570
14280234@N04,1364,18,1274330526,1274330526,2,2,0
14280234@N04,1364,26,1274330526,1274331426,1,2,900
14280234@N04,1365,18,1277275847,1277275864,2,2,17
14280234@N04,1365,23,1277275864,1277276464,1,2,600
14280234@N04,1366,16,1278309434,1278309704,1,1,270
14280234@N04,1367,1,1280444638,1280444698,1,1,60
14280234@N04,1368,1,1280707364,1280707424,1,1,60
14280234@N04,1369,26,1281248635,1281249535,3,1,900
14280234@N04,1370,16,1283813083,1283813353,2,2,270
14280234@N04,1370,26,1283820159,1283821059,1,2,900
14280234@N04,1371,22,1284082791,1284083391,1,1,600
14280234@N04,1372,26,1284614540,1284615440,1,1,900
14280234@N04,1373,1,1285289945,1285290005,2,2,60
14280234@N04,1373,26,1285290025,1285290925,1,2,900
14280234@N04,1374,26,1285724258,1285725158,1,1,900
14280234@N04,1375,9,1287096555,1287096735,2,3,180
14280234@N04,1375,10,1287096965,1287096970,2,3,5
14280234@N04,1375,11,1287096970,1287097210,1,3,240
14280234@N04,1376,20,1287375945,1287376485,1,1,540
14280234@N04,1377,26,1288313142,1288314042,1,1,900
14280234@N04,1378,9,1289344369,1289344549,2,1,180
14280234@N04,1379,21,1289619853,1289620423,1,1,570
14280234@N04,1380,28,1290398562,1290399462,2,2,900
14280234@N04,1380,26,1290399641,1290400541,1,2,900
14280234@N04,1381,9,1291764292,1291764472,1,1,180
14280234@N04,1382,15,1293020669,1293020939,1,1,270
14280234@N04,1383,26,1294801750,1294802650,1,1,900
14280234@N04,1384,26,1295071673,1295072573,1,1,900
14280234@N04,1385,1,1295929775,1295929835,1,1,60
14280234@N04,1386,1,1297379435,1297379495,1,1,60
14280234@N04,1387,26,1298510354,1298511254,2,1,900
14280234@N04,1388,28,1301264875,1301265775,1,1,900
14280234@N04,1389,26,1301656395,1301657295,1,1,900
14280234@N04,1390,3,1302822904,1302822994,1,1,90
14280234@N04,1391,26,1303181276,1303182176,2,2,900
14280234@N04,1391,5,1303196882,1303197002,1,2,120
14280234@N04,1392,11,1303693002,1303693242,1,1,240
14280234@N04,1393,26,1307323090,1307323990,1,1,900
14280234@N04,1394,16,1307436890,1307437160,1,1,270
14280234@N04,1395,26,1307573603,1307574503,1,1,900
14280234@N04,1396,16,1311465413,1311465683,1,1,270
14280234@N04,1397,11,1311728196,1311728436,1,1,240
14280234@N04,1398,16,1313976432,1313976702,1,1,270
14280234@N04,1399,26,1315540049,1315540949,1,1,900
14280234@N04,1400,26,1315789652,1315790552,2,2,900
14280234@N04,1400,11,1315792670,1315792910,1,2,240
14280234@N04,1401,20,1316396410,1316396950,1,1,540
14280234@N04,1402,26,1319836354,1319837254,1,1,900
14280234@N04,1403,28,1320106796,1320107696,1,1,900
14280234@N04,1404,26,1324335255,1324336155,2,1,900
14280234@N04,1405,26,1326930325,1326931225,2,2,900
14280234@N04,1405,11,1326931482,1326931722,1,2,240
14280234@N04,1406,4,1327698722,1327698823,1,1,101
14280234@N04,1407,26,1330019664,1330020564,1,1,900
14280234@N04,1408,26,1335921656,1335922556,1,1,900
14280234@N04,1409,25,1337297199,1337298039,1,1,840
14280234@N04,1410,21,1337516141,1337516711,1,1,570
14280234@N04,1411,16,1338680282,1338680552,2,2,270
14280234@N04,1411,1,1338681931,1338681991,1,2,60
14280234@N04,1412,21,1342909963,1342910533,1,1,570
14280234@N04,1413,21,1343601379,1343601949,1,1,570
14280234@N04,1414,18,1345772183,1345772633,1,1,450
14280234@N04,1415,26,1345850301,1345851201,1,1,900
14280234@N04,1416,16,1346368111,1346368381,1,1,270
14280234@N04,1417,16,1347056552,1347056822,1,1,270
14280234@N04,1418,11,1351728047,1351728287,1,1,240
14280234@N04,1419,16,1352681469,1352681739,1,1,270
14280234@N04,1420,11,1354841746,1354841986,1,1,240
14280234@N04,1421,16,1355944248,1355944518,1,1,270
14280234@N04,1422,28,1364895551,1364896451,1,1,900
14280234@N04,1423,26,1366973819,1366974719,1,1,900
14280234@N04,1424,19,1379715934,1379716474,1,1,540
14280234@N04,1425,18,1383034296,1383034746,1,1,450
14280234@N04,1426,29,1392686258,1392687158,1,1,900
14286574@N00,1427,1,1364630245,1364630305,2,3,60
14286574@N00,1427,21,1364631270,1364631679,2,3,409
14286574@N00,1427,26,1364631679,1364632579,1,3,900
14286574@N00,1428,1,1364680389,1364680449,2,4,60
14286574@N00,1428,26,1364680873,1364681773,3,4,900
14286574@N00,1428,28,1364695717,1364696617,4,4,900
14286574@N00,1428,1,1364697491,1364697551,3,4,60
14286574@N00,1429,1,1364770383,1364770443,1,1,60
14288736@N05,1430,28,1370735868,1370736768,1,1,900
14291689@N07,1431,20,1360557900,1360558440,1,1,540
14291689@N07,1432,27,1422753302,1422753305,2,4,3
14291689@N07,1432,16,1422753305,1422753575,2,4,270
14291689@N07,1432,23,1422755203,1422755803,4,4,600
14291689@N07,1432,4,1422768658,1422768759,1,4,101
143103028@N06,1433,1,1463749219,1463749279,2,1,60
14355604@N06,1434,13,1189037897,1189038137,2,2,240
14355604@N06,1434,26,1189042372,1189043272,1,2,900
14359698@N07,1435,1,1367535227,1367535287,2,4,60
14359698@N07,1435,22,1367544116,1367544716,2,4,600
14359698@N07,1435,3,1367555256,1367555346,2,4,90
14359698@N07,1435,13,1367562758,1367562998,1,4,240
14359698@N07,1436,26,1367749463,1367750363,1,1,900
14379196@N04,1437,1,1353318446,1353318506,1,1,60
14379699@N02,1438,27,1381537864,1381538228,2,3,364
14379699@N02,1438,17,1381538228,1381538528,2,3,300
14379699@N02,1438,15,1381539735,1381540005,1,3,270
14379699@N02,1439,1,1383445697,1383445757,1,1,60
14379699@N02,1440,28,1387529872,1387530772,2,2,900
14379699@N02,1440,25,1387535180,1387536020,1,2,840
14379699@N02,1441,1,1392256835,1392256895,1,1,60
14379699@N02,1442,19,1412557563,1412558103,1,1,540
14379699@N02,1443,18,1444510022,1444510472,2,1,450
14386112@N00,1444,26,1303481363,1303482263,2,2,900
14386112@N00,1444,16,1303496670,1303496940,1,2,270
14394412@N04,1445,1,1272010148,1272010208,1,1,60
14397744@N02,1446,15,1325324416,1325324686,1,1,270
14397744@N02,1447,10,1429280928,1429281168,1,1,240
14418030@N00,1448,23,1212281065,1212281665,1,1,600
14418851@N04,1449,31,1192159498,1192160998,2,1,1500
14418851@N04,1450,28,1192357040,1192357940,1,1,900
14422698@N07,1451,1,1375523782,1375523842,5,1,60
14425592@N07,1452,26,1189855913,1189856813,1,1,900
14447350@N05,1453,26,1324119553,1324120453,1,1,900
14447350@N05,1454,30,1324183393,1324184473,1,1,1080
14449931@N08,1455,19,1420590829,1420591369,2,4,540
14449931@N08,1455,15,1420605190,1420605460,2,4,270
14449931@N08,1455,20,1420618900,1420619440,2,4,540
14449931@N08,1455,19,1420622298,1420622838,1,4,540
14449931@N08,1456,19,1420672827,1420673367,4,2,540
14449931@N08,1456,5,1420679096,1420679216,1,2,120
14449931@N08,1457,18,1420842126,1420842576,3,1,450
14449931@N08,1458,16,1420978780,1420979050,1,1,270
14449931@N08,1459,7,1421493199,1421493379,1,1,180
14483469@N00,1460,1,1380942600,1380942660,2,3,60
14483469@N00,1460,17,1380945226,1380945526,2,3,300
14483469@N00,1460,30,1380951816,1380952896,1,3,1080
14487451@N00,1461,30,1352632220,1352633300,1,1,1080
14487451@N00,1462,29,1357427851,1357428751,1,1,900
14487451@N00,1463,16,1372575913,1372576183,2,5,270
14487451@N00,1463,1,1372583882,1372583942,2,5,60
14487451@N00,1463,14,1372601777,1372602017,2,5,240
14487451@N00,1463,1,1372602226,1372602286,2,5,60
14487451@N00,1463,17,1372602459,1372602759,1,5,300
14487451@N00,1464,14,1372684483,1372684723,1,1,240
14506090@N06,1465,29,1189733278,1189734178,1,1,900
14523292@N00,1466,30,1326772363,1326773443,1,1,1080
14523292@N00,1467,17,1332814330,1332814630,2,1,300
14523292@N00,1468,13,1425098843,1425099083,1,1,240
14526883@N08,1469,18,1209102818,1209103268,1,1,450
14526883@N08,1470,1,1243807973,1243808033,3,26,60
14526883@N08,1470,28,1243810256,1243811156,2,26,900
14526883@N08,1470,24,1243813970,1243814750,4,26,780
14526883@N08,1470,15,1243815809,1243815908,2,26,99
14526883@N08,1470,24,1243815908,1243816294,2,26,386
14526883@N08,1470,12,1243816294,1243816534,4,26,240
14526883@N08,1470,24,1243819395,1243819477,2,26,82
14526883@N08,1470,12,1243819477,1243819717,3,26,240
14526883@N08,1470,24,1243819857,1243820637,16,26,780
14526883@N08,1470,23,1243829817,1243829838,2,26,21
14526883@N08,1470,18,1243829838,1243830288,5,26,450
14526883@N08,1470,29,1243830554,1243830672,4,26,118
14526883@N08,1470,19,1243830672,1243830850,3,26,178
14526883@N08,1470,18,1243830850,1243831300,3,26,450
14526883@N08,1470,30,1243834460,1243834537,2,26,77
14526883@N08,1470,31,1243834537,1243836037,2,26,1500
14526883@N08,1470,22,1243837981,1243838581,2,26,600
14526883@N08,1470,13,1243842633,1243842873,5,26,240
14526883@N08,1470,21,1243843944,1243844514,2,26,570
14526883@N08,1470,3,1243844571,1243844661,2,26,90
14526883@N08,1470,30,1243849925,1243851005,6,26,1080
14526883@N08,1470,23,1243851309,1243851366,2,26,57
14526883@N08,1470,18,1243851366,1243851816,2,26,450
14526883@N08,1470,27,1243854087,1243854987,2,26,900
14526883@N08,1470,15,1243856145,1243856415,3,26,270
14526883@N08,1470,3,1243857309,1243857399,1,26,90
14545153@N05,1471,1,1357206390,1357206450,1,1,60
14576853@N00,1472,22,1337832378,1337832978,2,6,600
14576853@N00,1472,21,1337839546,1337840116,2,6,570
14576853@N00,1472,10,1337841571,1337841811,2,6,240
14576853@N00,1472,4,1337842472,1337842573,3,6,101
14576853@N00,1472,24,1337847942,1337848722,2,6,780
14576853@N00,1472,16,1337851602,1337851872,1,6,270
14638226@N02,1473,26,1197990804,1197991704,2,2,900
14638226@N02,1473,1,1198000817,1198000877,1,2,60
14648099@N05,1474,29,1309160758,1309161658,2,2,900
14648099@N05,1474,18,1309164262,1309164712,1,2,450
14648099@N05,1475,28,1309333381,1309334281,1,1,900
14674876@N04,1476,9,1316843088,1316843268,2,2,180
14674876@N04,1476,3,1316859892,1316859982,1,2,90
14674876@N04,1477,22,1317003945,1317004545,2,1,600
14691845@N00,1478,29,1371037626,1371038526,2,2,900
14691845@N00,1478,26,1371038688,1371039588,3,2,900
14759208@N05,1479,28,1408328462,1408329362,1,1,900
14792256@N00,1480,27,1339997877,1339998777,2,2,900
14792256@N00,1480,18,1340003996,1340004446,1,2,450
14792256@N00,1481,16,1358935782,1358936052,3,1,270
14831331@N07,1482,15,1343392892,1343393162,1,1,270
14831331@N07,1483,31,1347093896,1347095396,1,1,1500
14834314@N00,1484,26,1340057997,1340058897,2,3,900
14834314@N00,1484,9,1340059965,1340060145,3,3,180
14834314@N00,1484,11,1340070668,1340070908,1,3,240
14834314@N00,1485,21,1340147263,1340147833,3,4,570
14834314@N00,1485,13,1340148328,1340148568,2,4,240
14834314@N00,1485,11,1340151330,1340151570,2,4,240
14834314@N00,1485,14,1340156526,1340156766,3,4,240
14834314@N00,1486,22,1340189065,1340189665,1,1,600
14834314@N00,1487,28,1340316945,1340317845,1,1,900
14848876@N00,1488,30,1282972974,1282974054,3,3,1080
14848876@N00,1488,16,1283000808,1283001078,2,3,270
14848876@N00,1488,26,1283001676,1283002576,4,3,900
14848876@N00,1489,1,1310288780,1310288840,1,1,60
14877255@N04,1490,12,1279406039,1279406279,1,1,240
14877255@N04,1491,18,1391820997,1391821447,2,2,450
14877255@N04,1491,30,1391830447,1391831527,1,2,1080
14877255@N04,1492,1,1392438180,1392438240,1,1,60
14877255@N04,1493,28,1393147960,1393148860,1,1,900
14877255@N04,1494,19,1394256266,1394256806,1,1,540
14877255@N04,1495,28,1396682253,1396683153,1,1,900
14877255@N04,1496,1,1400890620,1400890680,1,1,60
14877255@N04,1497,19,1402726252,1402726792,1,1,540
14877255@N04,1498,19,1405553202,1405553742,3,2,540
14877255@N04,1498,28,1405570232,1405571132,2,2,900
14877255@N04,1499,17,1410566729,1410567029,2,4,300
14877255@N04,1499,19,1410579158,1410579698,2,4,540
14877255@N04,1499,11,1410579872,1410580112,2,4,240
14877255@N04,1499,13,1410585425,1410585665,1,4,240
14877255@N04,1500,26,1416637976,1416638876,1,1,900
14877255@N04,1501,29,1423288328,1423289228,2,3,900
14877255@N04,1501,17,1423296519,1423296819,2,3,300
14877255@N04,1501,26,1423302593,1423303493,1,3,900
14877255@N04,1502,18,1425783783,1425784233,1,1,450
14877255@N04,1503,28,1430549246,1430550146,1,1,900
14877255@N04,1504,18,1431024555,1431025005,1,1,450
14877255@N04,1505,26,1435397616,1435398516,1,1,900
14877255@N04,1506,18,1436064198,1436064648,2,2,450
14877255@N04,1506,21,1436068947,1436069517,1,2,570
14877255@N04,1507,24,1437106118,1437106898,1,1,780
14877255@N04,1508,28,1437291215,1437292115,1,1,900
14877255@N04,1509,18,1452908168,1452908618,1,1,450
14877255@N04,1510,18,1453537884,1453538334,1,1,450
14877255@N04,1511,18,1456873948,1456874398,2,3,450
14877255@N04,1511,26,1456880604,1456881504,2,3,900
14877255@N04,1511,18,1456889827,1456890277,1,3,450
14877255@N04,1512,23,1461401658,1461402258,1,1,600
14877255@N04,1513,26,1469947100,1469948000,1,1,900
14894152@N04,1514,7,1382259976,1382260156,1,1,180
14894152@N04,1515,1,1384493169,1384493229,1,1,60
14894152@N04,1516,26,1389509158,1389510058,1,1,900
14897087@N04,1517,29,1337606158,1337607058,1,1,900
14902480@N02,1518,26,1340279402,1340280302,1,1,900
14920533@N06,1519,7,1395876588,1395876689,2,6,101
14920533@N06,1519,29,1395876689,1395877589,2,6,900
14920533@N06,1519,27,1395879145,1395880045,2,6,900
14920533@N06,1519,24,1395882298,1395883078,2,6,780
14920533@N06,1519,28,1395890619,1395890634,2,6,15
14920533@N06,1519,23,1395890634,1395891234,1,6,600
14934218@N03,1520,30,1194135511,1194136591,7,1,1080
14934218@N03,1521,30,1219383170,1219384250,2,1,1080
14965074@N03,1522,27,1399204783,1399205683,1,1,900
14965074@N03,1523,3,1400867435,1400867525,1,1,90
14965074@N03,1524,19,1417437754,1417438294,1,1,540
14965074@N03,1525,29,1458201245,1458202145,1,1,900
15003623@N04,1526,30,1210638532,1210639612,1,1,1080
15019436@N08,1527,29,1224639712,1224640562,3,5,850
15019436@N08,1527,28,1224640562,1224640685,2,5,123
15019436@N08,1527,29,1224640685,1224641585,4,5,900
15019436@N08,1527,30,1224653834,1224653913,2,5,79
15019436@N08,1527,26,1224653913,1224654813,4,5,900
15026501@N00,1528,16,1340613660,1340613930,14,3,270
15026501@N00,1528,30,1340621659,1340622739,2,3,1080
15026501@N00,1528,31,1340624231,1340625731,1,3,1500
15026501@N00,1529,28,1340762468,1340763368,1,1,900
15037455@N08,1530,26,1340749770,1340750670,19,1,900
15037455@N08,1531,26,1340837995,1340838895,35,1,900
15037455@N08,1532,26,1340923541,1340924441,1,1,900
15037455@N08,1533,26,1343450341,1343451241,1,1,900
15074684@N07,1534,28,1230938956,1230939856,1,1,900
15074684@N07,1535,28,1232320240,1232321140,3,1,900
15074684@N07,1536,28,1234748265,1234749165,10,1,900
15074684@N07,1537,28,1235049800,1235050700,1,1,900
15074684@N07,1538,28,1235263428,1235264328,1,1,900
15074684@N07,1539,28,1235548291,1235549191,2,1,900
15074684@N07,1540,28,1236484730,1236485630,3,1,900
15074684@N07,1541,28,1237698983,1237699883,2,1,900
15079826@N00,1542,27,1313650722,1313651622,3,5,900
15079826@N00,1542,12,1313652174,1313652310,2,5,136
15079826@N00,1542,23,1313652310,1313652492,2,5,182
15079826@N00,1542,29,1313652492,1313653392,7,5,900
15079826@N00,1542,19,1313659710,1313660250,1,5,540
15079826@N00,1543,28,1313751148,1313752048,4,1,900
15079826@N00,1544,28,1313843564,1313843614,3,3,50
15079826@N00,1544,1,1313843614,1313843674,3,3,60
15079826@N00,1544,28,1313843819,1313844719,1,3,900
15079826@N00,1545,28,1313973579,1313973916,4,21,337
15079826@N00,1545,18,1313973916,1313974366,2,21,450
15079826@N00,1545,26,1313976237,1313976446,2,21,209
15079826@N00,1545,10,1313976446,1313976686,2,21,240
15079826@N00,1545,14,1313980623,1313980863,8,21,240
15079826@N00,1545,20,1313983006,1313983546,3,21,540
15079826@N00,1545,23,1313985672,1313986272,3,21,600
15079826@N00,1545,20,1313989526,1313990040,2,21,514
15079826@N00,1545,31,1313990040,1313991540,4,21,1500
15079826@N00,1545,20,1313991793,1313992333,3,21,540
15079826@N00,1545,23,1313994711,1313995311,6,21,600
15079826@N00,1545,26,1313996241,1313997141,2,21,900
15079826@N00,1545,21,1314002519,1314003089,4,21,570
15079826@N00,1545,13,1314008876,1314009116,5,21,240
15079826@N00,1545,26,1314015122,1314016022,2,21,900
15079826@N00,1545,23,1314019904,1314020009,2,21,105
15079826@N00,1545,26,1314020009,1314020156,2,21,147
15079826@N00,1545,23,1314020156,1314020756,7,21,600
15079826@N00,1545,11,1314025851,1314026091,2,21,240
15079826@N00,1545,10,1314027955,1314027962,2,21,7
15079826@N00,1545,26,1314027962,1314028862,1,21,900
15079826@N00,1546,28,1375939429,1375940329,1,1,900
15079826@N00,1547,20,1376223650,1376224190,1,1,540
15099999@N07,1548,26,1276903694,1276904594,11,1,900
15120534@N07,1549,28,1249203879,1249204779,1,1,900
15125199@N07,1550,1,1288243508,1288243568,3,3,60
15125199@N07,1550,23,1288244813,1288245413,2,3,600
15125199@N07,1550,10,1288247066,1288247306,1,3,240
15125199@N07,1551,24,1288673396,1288674176,1,1,780
15125199@N07,1552,26,1290149334,1290150234,1,1,900
15125199@N07,1553,19,1290237391,1290237931,5,1,540
15125199@N07,1554,26,1294373113,1294374013,7,4,900
15125199@N07,1554,25,1294376439,1294377279,4,4,840
15125199@N07,1554,9,1294378111,1294378251,2,4,140
15125199@N07,1554,26,1294378251,1294379151,1,4,900
15125199@N07,1555,26,1294729469,1294730369,3,2,900
15125199@N07,1555,17,1294730808,1294731108,1,2,300
15125199@N07,1556,9,1295935622,1295935802,1,1,180
15125199@N07,1557,30,1299232387,1299233467,2,1,1080
15125199@N07,1558,28,1300765909,1300766809,3,1,900
15125199@N07,1559,13,1347331509,1347331749,3,1,240
15217104@N02,1560,30,1366424236,1366425316,8,19,1080
15217104@N02,1560,12,1366426658,1366426898,6,19,240
15217104@N02,1560,21,1366428446,1366428479,2,19,33
15217104@N02,1560,25,1366428479,1366429319,10,19,840
15217104@N02,1560,13,1366429543,1366429566,2,19,23
15217104@N02,1560,25,1366429566,1366429849,13,19,283
15217104@N02,1560,13,1366429849,1366430089,4,19,240
15217104@N02,1560,26,1366430758,1366431658,10,19,900
15217104@N02,1560,28,1366433854,1366434754,7,19,900
15217104@N02,1560,1,1366442333,1366442393,7,19,60
15217104@N02,1560,17,1366444255,1366444555,5,19,300
15217104@N02,1560,1,1366444612,1366444672,10,19,60
15217104@N02,1560,28,1366448555,1366448725,2,19,170
15217104@N02,1560,23,1366448725,1366448805,3,19,80
15217104@N02,1560,26,1366448805,1366449242,5,19,437
15217104@N02,1560,30,1366449242,1366450322,4,19,1080
15217104@N02,1560,26,1366454192,1366455092,12,19,900
15217104@N02,1560,21,1366459736,1366459748,2,19,12
15217104@N02,1560,3,1366459748,1366459838,1,19,90
15217104@N02,1561,18,1366501828,1366501841,2,21,13
15217104@N02,1561,23,1366501841,1366501947,2,21,106
15217104@N02,1561,18,1366501947,1366502397,2,21,450
15217104@N02,1561,8,1366502604,1366502784,4,21,180
15217104@N02,1561,3,1366502998,1366503088,3,21,90
15217104@N02,1561,21,1366503273,1366503843,2,21,570
15217104@N02,1561,13,1366503850,1366504090,12,21,240
15217104@N02,1561,21,1366506569,1366507139,2,21,570
15217104@N02,1561,16,1366509601,1366509871,2,21,270
15217104@N02,1561,27,1366511386,1366511431,2,21,45
15217104@N02,1561,16,1366511431,1366511701,2,21,270
15217104@N02,1561,24,1366515123,1366515903,4,21,780
15217104@N02,1561,17,1366517185,1366517485,2,21,300
15217104@N02,1561,16,1366517973,1366518243,19,21,270
15217104@N02,1561,27,1366518650,1366519550,2,21,900
15217104@N02,1561,28,1366520933,1366521833,2,21,900
15217104@N02,1561,1,1366534169,1366534229,2,21,60
15217104@N02,1561,29,1366539590,1366540490,17,21,900
15217104@N02,1561,23,1366542829,1366543429,2,21,600
15217104@N02,1561,27,1366543715,1366544615,12,21,900
15217104@N02,1561,28,1366545060,1366545960,1,21,900
15217104@N02,1562,16,1367243031,1367243301,3,1,270
15218401@N04,1563,29,1428888173,1428889073,2,2,900
15218401@N04,1563,30,1428891850,1428892930,2,2,1080
15218401@N04,1564,17,1428921397,1428921697,2,1,300
15218401@N04,1565,17,1429160873,1429161173,3,1,300
15235007@N00,1566,1,1233896611,1233896671,2,3,60
15235007@N00,1566,28,1233897030,1233897930,3,3,900
15235007@N00,1566,1,1233900989,1233901049,6,3,60
15235007@N00,1567,1,1241822164,1241822224,1,1,60
15235007@N00,1568,28,1243310232,1243311132,3,1,900
15235007@N00,1569,1,1245990278,1245990338,2,2,60
15235007@N00,1569,28,1245990420,1245991320,5,2,900
15235007@N00,1570,1,1279329210,1279329270,4,1,60
15235007@N00,1571,28,1317417518,1317417757,5,14,239
15235007@N00,1571,1,1317417757,1317417817,3,14,60
15235007@N00,1571,28,1317417929,1317418321,5,14,392
15235007@N00,1571,16,1317418321,1317418591,24,14,270
15235007@N00,1571,27,1317419624,1317420016,3,14,392
15235007@N00,1571,15,1317420016,1317420286,3,14,270
15235007@N00,1571,12,1317420839,1317421079,4,14,240
15235007@N00,1571,21,1317421561,1317421972,9,14,411
15235007@N00,1571,12,1317421972,1317422144,2,14,172
15235007@N00,1571,21,1317422144,1317422365,2,14,221
15235007@N00,1571,25,1317422365,1317422795,2,14,430
15235007@N00,1571,21,1317422795,1317423365,2,14,570
15235007@N00,1571,10,1317424137,1317424377,2,14,240
15235007@N00,1571,30,1317427276,1317428356,8,14,1080
15235007@N00,1572,1,1330987000,1330987060,3,3,60
15235007@N00,1572,20,1330989978,1330990518,3,3,540
15235007@N00,1572,1,1330990942,1330991002,31,3,60
15249724@N06,1573,30,1188314446,1188315142,2,2,696
15249724@N06,1573,1,1188315142,1188315202,1,2,60
15302945@N00,1574,27,1200351063,1200351963,1,1,900
15409581@N00,1575,26,1324532433,1324533333,1,1,900
15409581@N00,1576,29,1335253231,1335254131,1,1,900
15409581@N00,1577,27,1336633892,1336634792,1,1,900
15409581@N00,1578,31,1337597718,1337597759,2,2,41
15409581@N00,1578,1,1337597759,1337597819,1,2,60
15409581@N00,1579,20,1380946912,1380947452,1,1,540
15409581@N00,1580,17,1383344789,1383345089,2,9,300
15409581@N00,1580,14,1383351409,1383351649,2,9,240
15409581@N00,1580,22,1383357593,1383358193,2,9,600
15409581@N00,1580,20,1383358789,1383359329,3,9,540
15409581@N00,1580,29,1383362856,1383363756,2,9,900
15409581@N00,1580,31,1383363936,1383365436,3,9,1500
15409581@N00,1580,23,1383368061,1383368661,2,9,600
15409581@N00,1580,27,1383369136,1383370036,3,9,900
15409581@N00,1580,29,1383385204,1383386104,2,9,900
15409581@N00,1581,1,1384123234,1384123294,4,2,60
15409581@N00,1581,30,1384142891,1384143971,1,2,1080
15434281@N00,1582,28,1313855302,1313856202,2,1,900
15441953@N00,1583,20,1330915025,1330915565,2,4,540
15441953@N00,1583,26,1330918983,1330919883,3,4,900
15441953@N00,1583,21,1330920123,1330920693,2,4,570
15441953@N00,1583,25,1330921106,1330921946,7,4,840
15463022@N02,1584,1,1193202053,1193202113,4,1,60
15463022@N02,1585,1,1368146554,1368146614,21,24,60
15463022@N02,1585,28,1368152421,1368152496,3,24,75
15463022@N02,1585,1,1368152496,1368152556,5,24,60
15463022@N02,1585,4,1368154610,1368154692,3,24,82
15463022@N02,1585,1,1368154692,1368154752,4,24,60
15463022@N02,1585,23,1368157438,1368157444,3,24,6
15463022@N02,1585,18,1368157444,1368157894,3,24,450
15463022@N02,1585,1,1368158511,1368158571,67,24,60
15463022@N02,1585,25,1368163505,1368164345,4,24,840
15463022@N02,1585,1,1368164480,1368164540,7,24,60
15463022@N02,1585,13,1368164690,1368164930,4,24,240
15463022@N02,1585,1,1368164939,1368164999,22,24,60
15463022@N02,1585,13,1368166972,1368167024,4,24,52
15463022@N02,1585,1,1368167024,1368167084,6,24,60
15463022@N02,1585,13,1368167180,1368167198,2,24,18
15463022@N02,1585,1,1368167198,1368167258,3,24,60
15463022@N02,1585,13,1368167275,1368167466,2,24,191
15463022@N02,1585,1,1368167466,1368167526,32,24,60
15463022@N02,1585,24,1368172486,1368172785,2,24,299
15463022@N02,1585,1,1368172785,1368172845,3,24,60
15463022@N02,1585,24,1368172938,1368173718,2,24,780
15463022@N02,1585,1,1368173893,1368173953,9,24,60
15463022@N02,1585,16,1368176292,1368176562,2,24,270
15463022@N02,1585,1,1368176711,1368176771,9,24,60
15463022@N02,1586,1,1368249909,1368249969,1,1,60
15463022@N02,1587,1,1368317117,1368317177,46,5,60
15463022@N02,1587,31,1368325380,1368326880,7,5,1500
15463022@N02,1587,1,1368327081,1368327141,50,5,60
15463022@N02,1587,25,1368335533,1368335552,2,5,19
15463022@N02,1587,1,1368335552,1368335612,63,5,60
15463022@N02,1588,1,1368912595,1368912655,1,1,60
15463022@N02,1589,25,1369042319,1369043159,3,1,840
15468918@N00,1590,19,1361146733,1361147273,2,2,540
15468918@N00,1590,30,1361147930,1361149010,5,2,1080
15468918@N00,1591,1,1361318296,1361318356,2,33,60
15468918@N00,1591,19,1361318431,1361318435,2,33,4
15468918@N00,1591,1,1361318435,1361318495,4,33,60
15468918@N00,1591,19,1361318573,1361318618,2,33,45
15468918@N00,1591,30,1361318618,1361319698,3,33,1080
15468918@N00,1591,28,1361320666,1361320795,2,33,129
15468918@N00,1591,26,1361320795,1361320859,2,33,64
15468918@N00,1591,16,1361320859,1361321129,2,33,270
15468918@N00,1591,23,1361321185,1361321785,4,33,600
15468918@N00,1591,29,1361323611,1361323652,2,33,41
15468918@N00,1591,19,1361323652,1361323744,2,33,92
15468918@N00,1591,30,1361323744,1361323936,2,33,192
15468918@N00,1591,29,1361323936,1361324836,2,33,900
15468918@N00,1591,20,1361325073,1361325613,3,33,540
15468918@N00,1591,27,1361326296,1361326637,2,33,341
15468918@N00,1591,30,1361326637,1361327717,3,33,1080
15468918@N00,1591,15,1361328077,1361328347,3,33,270
15468918@N00,1591,24,1361328665,1361329186,2,33,521
15468918@N00,1591,25,1361329186,1361329431,2,33,245
15468918@N00,1591,21,1361329431,1361329512,2,33,81
15468918@N00,1591,7,1361329512,1361329692,2,33,180
15468918@N00,1591,28,1361333554,1361334454,3,33,900
15468918@N00,1591,30,1361339464,1361340544,3,33,1080
15468918@N00,1591,24,1361341310,1361341772,3,33,462
15468918@N00,1591,30,1361341772,1361341826,2,33,54
15468918@N00,1591,24,1361341826,1361341863,4,33,37
15468918@N00,1591,12,1361341863,1361341942,5,33,79
15468918@N00,1591,24,1361341942,1361342023,3,33,81
15468918@N00,1591,26,1361342023,1361342923,4,33,900
15468918@N00,1591,24,1361343328,1361344108,4,33,780
15468918@N00,1591,12,1361347117,1361347357,2,33,240
15468918@N00,1591,28,1361348893,1361349793,3,33,900
15468918@N00,1591,29,1361352391,1361353291,1,33,900
15468918@N00,1592,1,1392515144,1392515204,3,6,60
15468918@N00,1592,26,1392515499,1392515754,3,6,255
15468918@N00,1592,31,1392515754,1392516946,4,6,1192
15468918@N00,1592,21,1392516946,1392517506,2,6,560
15468918@N00,1592,13,1392517506,1392517746,2,6,240
15468918@N00,1592,29,1392518536,1392519436,1,6,900
15474023@N03,1593,27,1229681736,1229682636,7,20,900
15474023@N03,1593,12,1229689900,1229689948,2,20,48
15474023@N03,1593,26,1229689948,1229690848,2,20,900
15474023@N03,1593,3,1229692117,1229692207,5,20,90
15474023@N03,1593,25,1229698893,1229699733,6,20,840
15474023@N03,1593,21,1229703047,1229703617,23,20,570
15474023@N03,1593,26,1229706328,1229706894,2,20,566
15474023@N03,1593,28,1229706894,1229707794,2,20,900
15474023@N03,1593,1,1229708000,1229708060,3,20,60
15474023@N03,1593,28,1229708543,1229709443,2,20,900
15474023@N03,1593,29,1229712711,1229713611,4,20,900
15474023@N03,1593,26,1229719362,1229719580,2,20,218
15474023@N03,1593,16,1229719580,1229719816,2,20,236
15474023@N03,1593,28,1229719816,1229720716,2,20,900
15474023@N03,1593,27,1229726118,1229727018,3,20,900
15474023@N03,1593,28,1229732832,1229732883,2,20,51
15474023@N03,1593,6,1229732883,1229733003,2,20,120
15474023@N03,1593,3,1229738329,1229738419,3,20,90
15474023@N03,1593,25,1229743387,1229744227,2,20,840
15474023@N03,1593,16,1229749205,1229749475,1,20,270
15474023@N03,1594,12,1229779673,1229779913,2,14,240
15474023@N03,1594,28,1229787581,1229788481,3,14,900
15474023@N03,1594,12,1229789049,1229789289,2,14,240
15474023@N03,1594,29,1229794490,1229795390,4,14,900
15474023@N03,1594,31,1229798393,1229799893,2,14,1500
15474023@N03,1594,24,1229807064,1229807844,2,14,780
15474023@N03,1594,3,1229818385,1229818475,3,14,90
15474023@N03,1594,16,1229820535,1229820805,2,14,270
15474023@N03,1594,12,1229822759,1229822999,4,14,240
15474023@N03,1594,28,1229831100,1229831353,2,14,253
15474023@N03,1594,26,1229831353,1229831901,2,14,548
15474023@N03,1594,29,1229831901,1229832801,3,14,900
15474023@N03,1594,26,1229858130,1229859030,2,14,900
15474023@N03,1594,3,1229861890,1229861980,1,14,90
15474023@N03,1595,25,1229944028,1229944868,1,1,840
15474023@N03,1596,25,1259295544,1259295545,3,2,1
15474023@N03,1596,26,1259295545,1259296445,6,2,900
15474023@N03,1597,16,1409345149,1409345340,4,10,191
15474023@N03,1597,12,1409345340,1409345580,3,10,240
15474023@N03,1597,7,1409346364,1409346459,4,10,95
15474023@N03,1597,26,1409346459,1409346480,2,10,21
15474023@N03,1597,30,1409346480,1409347560,2,10,1080
15474023@N03,1597,1,1409363624,1409363684,4,10,60
15474023@N03,1597,26,1409371588,1409372488,3,10,900
15474023@N03,1597,17,1409373398,1409373698,2,10,300
15474023@N03,1597,15,1409374073,1409374343,4,10,270
15474023@N03,1597,1,1409378784,1409378844,2,10,60
15474023@N03,1598,14,1409429963,1409430203,2,5,240
15474023@N03,1598,30,1409432580,1409432770,3,5,190
15474023@N03,1598,6,1409432770,1409432890,2,5,120
15474023@N03,1598,15,1409432924,1409433060,2,5,136
15474023@N03,1598,21,1409433060,1409433630,2,5,570
15474023@N03,1599,1,1409471961,1409472021,2,6,60
15474023@N03,1599,10,1409474983,1409475223,3,6,240
15474023@N03,1599,30,1409475375,1409475551,3,6,176
15474023@N03,1599,23,1409475551,1409476151,3,6,600
15474023@N03,1599,26,1409479160,1409479343,3,6,183
15474023@N03,1599,16,1409479343,1409479613,1,6,270
15499532@N06,1600,1,1464405991,1464406051,3,10,60
15499532@N06,1600,29,1464407307,1464408207,2,10,900
15499532@N06,1600,30,1464411146,1464411476,2,10,330
15499532@N06,1600,26,1464411476,1464412143,2,10,667
15499532@N06,1600,13,1464412143,1464412383,3,10,240
15499532@N06,1600,4,1464416445,1464416546,2,10,101
15499532@N06,1600,13,1464418325,1464418565,2,10,240
15499532@N06,1600,21,1464418664,1464419234,2,10,570
15499532@N06,1600,16,1464419493,1464419763,2,10,270
15499532@N06,1600,17,1464426414,1464426714,1,10,300
15532592@N00,1601,7,1365935317,1365935497,1,1,180
15532592@N00,1602,5,1370146912,1370147032,1,1,120
15532592@N00,1603,28,1387016217,1387017117,1,1,900
15532592@N00,1604,26,1393144454,1393145354,3,4,900
15532592@N00,1604,1,1393147786,1393147846,2,4,60
15532592@N00,1604,3,1393149242,1393149332,2,4,90
15532592@N00,1604,1,1393149446,1393149506,1,4,60
15532592@N00,1605,26,1393201367,1393202267,3,1,900
15532592@N00,1606,13,1405982000,1405982240,1,1,240
15532592@N00,1607,19,1414759145,1414759685,3,1,540
15533065@N08,1608,28,1257748415,1257749315,1,1,900
15533594@N00,1609,26,1309157421,1309158321,1,1,900
15533594@N00,1610,1,1368930552,1368930612,1,1,60
15535152@N08,1611,28,1195448694,1195449594,2,1,900
15535152@N08,1612,28,1195511180,1195512080,11,1,900
15588726@N00,1613,1,1373275469,1373275529,4,1,60
15588726@N00,1614,1,1373331171,1373331231,25,1,60
15588726@N00,1615,1,1373420955,1373421015,12,1,60
15588726@N00,1616,1,1373524259,1373524319,11,1,60
15588726@N00,1617,1,1373600197,1373600257,8,1,60
15588726@N00,1618,1,1374480107,1374480167,1,1,60
15641461@N03,1619,1,1376176488,1376176548,2,5,60
15641461@N03,1619,16,1376182548,1376182818,2,5,270
15641461@N03,1619,14,1376200976,1376201216,2,5,240
15641461@N03,1619,29,1376219697,1376220597,2,5,900
15641461@N03,1619,27,1376225250,1376226150,1,5,900
15771726@N05,1620,13,1357343573,1357343813,1,1,240
15778445@N02,1621,30,1394260620,1394261700,2,1,1080
15855011@N03,1622,20,1230347207,1230347747,2,4,540
15855011@N03,1622,31,1230349011,1230350511,2,4,1500
15855011@N03,1622,26,1230358763,1230359663,2,4,900
15855011@N03,1622,3,1230362838,1230362928,1,4,90
15892878@N05,1623,1,1413771604,1413771664,1,1,60
15892878@N05,1624,1,1413843257,1413843317,1,1,60
15923079@N07,1625,12,1371093133,1371093373,1,1,240
15926431@N02,1626,29,1359152623,1359153523,8,1,900
15935500@N02,1627,12,1338771665,1338771905,2,8,240
15935500@N02,1627,24,1338773057,1338773837,2,8,780
15935500@N02,1627,22,1338778376,1338778976,3,8,600
15935500@N02,1627,31,1338780764,1338782264,3,8,1500
15935500@N02,1627,30,1338786597,1338787677,5,8,1080
15935500@N02,1627,13,1338790841,1338791081,2,8,240
15935500@N02,1627,29,1338793581,1338794481,3,8,900
15935500@N02,1627,19,1338794778,1338795318,1,8,540
15935500@N02,1628,8,1342256873,1342257053,2,3,180
15935500@N02,1628,5,1342261654,1342261774,2,3,120
15935500@N02,1628,6,1342262567,1342262687,2,3,120
15935500@N02,1629,20,1342352934,1342353474,2,3,540
15935500@N02,1629,12,1342354153,1342354393,2,3,240
15935500@N02,1629,20,1342354893,1342355433,3,3,540
15935500@N02,1630,12,1408765042,1408765282,2,4,240
15935500@N02,1630,24,1408769661,1408769898,3,4,237
15935500@N02,1630,15,1408769898,1408770168,2,4,270
15935500@N02,1630,27,1408772841,1408773741,1,4,900
15935500@N02,1631,26,1420257008,1420257908,8,1,900
15935500@N02,1632,15,1425788227,1425788497,1,1,270
15935500@N02,1633,27,1433030767,1433031667,3,4,900
15935500@N02,1633,4,1433036537,1433036638,2,4,101
15935500@N02,1633,30,1433040920,1433042000,4,4,1080
15935500@N02,1633,28,1433042344,1433043244,12,4,900
15935500@N02,1634,12,1437371874,1437372114,6,3,240
15935500@N02,1634,25,1437375223,1437376063,3,3,840
15935500@N02,1634,28,1437390511,1437391411,6,3,900
15935500@N02,1635,1,1443923317,1443923377,3,10,60
15935500@N02,1635,28,1443923513,1443923525,2,10,12
15935500@N02,1635,26,1443923525,1443923665,2,10,140
15935500@N02,1635,28,1443923665,1443923877,2,10,212
15935500@N02,1635,26,1443923877,1443924016,10,10,139
15935500@N02,1635,1,1443924016,1443924076,2,10,60
15935500@N02,1635,26,1443924408,1443925308,4,10,900
15935500@N02,1635,31,1443928182,1443929400,2,10,1218
15935500@N02,1635,20,1443929400,1443929940,3,10,540
15935500@N02,1635,28,1443937852,1443938752,1,10,900
15935500@N02,1636,12,1451779542,1451779782,2,2,240
15935500@N02,1636,26,1451788251,1451789151,5,2,900
15935500@N02,1637,15,1469917674,1469917944,2,11,270
15935500@N02,1637,12,1469919706,1469919946,3,11,240
15935500@N02,1637,10,1469922299,1469922539,2,11,240
15935500@N02,1637,30,1469924595,1469925675,3,11,1080
15935500@N02,1637,22,1469925727,1469926327,3,11,600
15935500@N02,1637,15,1469933220,1469933297,2,11,77
15935500@N02,1637,27,1469933297,1469933398,2,11,101
15935500@N02,1637,15,1469933398,1469933668,8,11,270
15935500@N02,1637,27,1469934358,1469935258,2,11,900
15935500@N02,1637,28,1469935473,1469936373,2,11,900
15935500@N02,1637,1,1469947551,1469947611,6,11,60
16035349@N05,1638,16,1264814668,1264814938,2,7,270
16035349@N05,1638,12,1264816276,1264816516,2,7,240
16035349@N05,1638,24,1264818513,1264819293,8,7,780
16035349@N05,1638,5,1264825939,1264826059,2,7,120
16035349@N05,1638,12,1264844284,1264844524,2,7,240
16035349@N05,1638,13,1264845664,1264845904,2,7,240
16035349@N05,1638,11,1264852436,1264852676,1,7,240
16038948@N00,1639,26,1363229111,1363230011,1,1,900
16082542@N00,1640,28,1241306964,1241307864,1,1,900
16093042@N00,1641,17,1345859250,1345859550,2,4,300
16093042@N00,1641,25,1345862050,1345862890,2,4,840
16093042@N00,1641,28,1345885127,1345886027,2,4,900
16093042@N00,1641,26,1345890763,1345891663,1,4,900
16093042@N00,1642,16,1379731173,1379731443,2,2,270
16093042@N00,1642,27,1379733500,1379734400,1,2,900
16130164@N06,1643,17,1366853946,1366854246,1,1,300
16131811@N00,1644,31,1340166120,1340167620,1,1,1500
16171417@N00,1645,9,1468121195,1468121375,4,4,180
16171417@N00,1645,20,1468121587,1468121857,4,4,270
16171417@N00,1645,17,1468121857,1468122017,3,4,160
16171417@N00,1645,9,1468122017,1468122197,1,4,180
16222234@N00,1646,26,1198291597,1198292497,68,1,900
16222234@N00,1647,26,1203726131,1203727031,80,1,900
16222234@N00,1648,26,1203831105,1203832005,4,1,900
16222234@N00,1649,27,1368930501,1368931401,1,1,900
16222234@N00,1650,18,1447999145,1447999595,1,1,450
16272116@N03,1651,25,1259840521,1259841361,3,2,840
16272116@N03,1651,28,1259842010,1259842910,2,2,900
16272116@N03,1652,28,1260844200,1260845100,2,2,900
16272116@N03,1652,11,1260848749,1260848989,1,2,240
16272116@N03,1653,30,1263730936,1263732016,1,1,1080
16272116@N03,1654,20,1291534784,1291535324,1,1,540
16272116@N03,1655,20,1303279704,1303279719,2,3,15
16272116@N03,1655,28,1303279719,1303279735,2,3,16
16272116@N03,1655,16,1303279735,1303280005,1,3,270
16295466@N00,1656,17,1411789688,1411789988,2,2,300
16295466@N00,1656,19,1411808576,1411809116,1,2,540
16336194@N00,1657,19,1415067550,1415068090,2,6,540
16336194@N00,1657,20,1415069902,1415070442,2,6,540
16336194@N00,1657,30,1415072568,1415073648,3,6,1080
16336194@N00,1657,17,1415076490,1415076790,2,6,300
16336194@N00,1657,16,1415079914,1415080184,2,6,270
16336194@N00,1657,28,1415083664,1415084564,1,6,900
16336194@N00,1658,18,1421378027,1421378477,2,3,450
16336194@N00,1658,19,1421379427,1421379967,2,3,540
16336194@N00,1658,29,1421395193,1421396093,1,3,900
16336194@N00,1659,17,1429147533,1429147833,2,2,300
16336194@N00,1659,30,1429149079,1429150159,2,2,1080
16336194@N00,1660,19,1431742133,1431742673,4,1,540
16336194@N00,1661,1,1446597027,1446597087,2,4,60
16336194@N00,1661,20,1446598691,1446599231,2,4,540
16336194@N00,1661,19,1446603843,1446604383,2,4,540
16336194@N00,1661,30,1446606213,1446607293,1,4,1080
16438861@N00,1662,12,1353889059,1353889299,2,9,240
16438861@N00,1662,13,1353893334,1353893574,2,9,240
16438861@N00,1662,17,1353895605,1353895905,2,9,300
16438861@N00,1662,16,1353899015,1353899285,3,9,270
16438861@N00,1662,26,1353901001,1353901901,2,9,900
16438861@N00,1662,18,1353928218,1353928257,2,9,39
16438861@N00,1662,16,1353928257,1353928350,2,9,93
16438861@N00,1662,24,1353928350,1353929130,2,9,780
16438861@N00,1662,25,1353929248,1353930088,1,9,840
16442000@N00,1663,1,1412375568,1412375628,3,11,60
16442000@N00,1663,28,1412375777,1412376677,2,11,900
16442000@N00,1663,21,1412379027,1412379597,3,11,570
16442000@N00,1663,3,1412379783,1412379873,3,11,90
16442000@N00,1663,26,1412381593,1412381599,2,11,6
16442000@N00,1663,24,1412381599,1412382379,4,11,780
16442000@N00,1663,26,1412395849,1412396749,64,11,900
16442000@N00,1663,13,1412397603,1412397843,7,11,240
16442000@N00,1663,26,1412402700,1412403600,25,11,900
16442000@N00,1663,8,1412405680,1412405685,2,11,5
16442000@N00,1663,26,1412405685,1412406585,22,11,900
16442000@N00,1664,18,1421107667,1421108117,2,21,450
16442000@N00,1664,26,1421113582,1421114482,71,21,900
16442000@N00,1664,3,1421145285,1421145285,2,21,0
16442000@N00,1664,26,1421145285,1421145290,3,21,5
16442000@N00,1664,21,1421145290,1421145364,2,21,74
16442000@N00,1664,15,1421145364,1421145364,2,21,0
16442000@N00,1664,26,1421145364,1421145371,2,21,7
16442000@N00,1664,15,1421145371,1421145383,6,21,12
16442000@N00,1664,26,1421145383,1421145389,7,21,6
16442000@N00,1664,15,1421145389,1421145393,3,21,4
16442000@N00,1664,26,1421145393,1421145395,2,21,2
16442000@N00,1664,15,1421145395,1421145401,4,21,6
16442000@N00,1664,26,1421145401,1421145402,2,21,1
16442000@N00,1664,15,1421145402,1421145402,2,21,0
16442000@N00,1664,26,1421145402,1421145406,2,21,4
16442000@N00,1664,15,1421145406,1421145407,2,21,1
16442000@N00,1664,26,1421145407,1421145409,2,21,2
16442000@N00,1664,15,1421145409,1421145410,2,21,1
16442000@N00,1664,26,1421145410,1421145415,4,21,5
16442000@N00,1664,11,1421145415,1421145415,2,21,0
16442000@N00,1664,26,1421145415,1421146315,1,21,900
16442000@N00,1665,23,1421666167,1421666767,1,1,600
16442000@N00,1666,26,1428804682,1428805582,12,5,900
16442000@N00,1666,19,1428807315,1428807420,2,5,105
16442000@N00,1666,29,1428807420,1428808320,2,5,900
16442000@N00,1666,31,1428811890,1428811896,2,5,6
16442000@N00,1666,22,1428811896,1428812496,3,5,600
16442000@N00,1667,5,1431822018,1431822138,1,1,120
16442000@N00,1668,26,1438482397,1438483297,15,2,900
16442000@N00,1668,16,1438489832,1438490102,26,2,270
16442000@N00,1669,16,1445128314,1445128584,3,1,270
16442000@N00,1670,7,1467857677,1467857689,5,11,12
16442000@N00,1670,4,1467857689,1467857790,2,11,101
16442000@N00,1670,21,1467861790,1467861954,3,11,164
16442000@N00,1670,11,1467861954,1467862194,3,11,240
16442000@N00,1670,12,1467863758,1467863998,6,11,240
16442000@N00,1670,24,1467865027,1467865807,6,11,780
16442000@N00,1670,26,1467869558,1467870458,16,11,900
16442000@N00,1670,16,1467873796,1467873802,2,11,6
16442000@N00,1670,26,1467873802,1467874702,3,11,900
16442000@N00,1670,30,1467875875,1467876343,2,11,468
16442000@N00,1670,16,1467876343,1467876613,2,11,270
16472222@N00,1671,18,1361157595,1361158045,1,1,450
16520490@N08,1672,3,1198124545,1198124635,5,3,90
16520490@N08,1672,25,1198142586,1198143426,2,3,840
16520490@N08,1672,3,1198146976,1198147066,1,3,90
16520490@N08,1673,16,1207190892,1207191162,1,1,270
16562518@N00,1674,29,1251853686,1251854586,4,1,900
16562518@N00,1675,29,1252014898,1252015798,1,1,900
16569276@N00,1676,20,1325416853,1325417393,1,1,540
16572880@N08,1677,1,1379494855,1379494915,2,2,60
16572880@N08,1677,20,1379495329,1379495869,1,2,540
16572880@N08,1678,1,1386309637,1386309697,1,1,60
16591891@N00,1679,29,1353491372,1353492272,2,3,900
16591891@N00,1679,25,1353496701,1353496941,2,3,240
16591891@N00,1679,26,1353496941,1353497841,1,3,900
16591891@N00,1680,1,1391937767,1391937827,1,1,60
16591891@N00,1681,1,1394333138,1394333198,1,1,60
16591891@N00,1682,13,1408866942,1408867182,1,1,240
16591891@N00,1683,19,1418637845,1418638385,1,1,540
16591891@N00,1684,30,1426400567,1426401647,1,1,1080
16591891@N00,1685,18,1430036236,1430036686,1,1,450
16591891@N00,1686,18,1431255904,1431256354,1,1,450
16591891@N00,1687,30,1433064493,1433065573,1,1,1080
16613671@N00,1688,4,1391741377,1391741478,1,1,101
16613671@N00,1689,18,1431254782,1431255232,1,1,450
16651106@N00,1690,26,1304773849,1304774749,51,1,900
16712945@N00,1691,26,1355306756,1355307656,2,1,900
16766249@N00,1692,21,1199425694,1199425696,2,4,2
16766249@N00,1692,29,1199425696,1199425699,4,4,3
16766249@N00,1692,13,1199425699,1199425702,3,4,3
16766249@N00,1692,20,1199425702,1199426242,1,4,540
16778006@N00,1693,19,1411289354,1411289894,1,1,540
16811913@N00,1694,28,1333790000,1333790900,1,1,900
16811913@N00,1695,15,1333869005,1333869275,1,1,270
16811913@N00,1696,28,1334192448,1334193348,1,1,900
16811913@N00,1697,17,1346112656,1346112956,1,1,300
16811913@N00,1698,27,1346290546,1346291446,1,1,900
16813616@N00,1699,27,1328245691,1328246591,1,1,900
16813616@N00,1700,28,1330652353,1330653253,2,1,900
16813616@N00,1701,17,1330693178,1330693478,1,1,300
16813616@N00,1702,29,1333942631,1333943531,3,1,900
16911222@N04,1703,1,1365119244,1365119304,2,1,60
16911222@N04,1704,4,1403566048,1403566149,2,3,101
16911222@N04,1704,28,1403577455,1403578355,2,3,900
16911222@N04,1704,4,1403583929,1403584030,1,3,101
16911222@N04,1705,3,1407151465,1407151555,1,1,90
16911222@N04,1706,16,1451453290,1451453560,4,4,270
16911222@N04,1706,18,1451457431,1451457881,2,4,450
16911222@N04,1706,7,1451459717,1451459897,2,4,180
16911222@N04,1706,1,1451468711,1451468771,1,4,60
16911222@N04,1707,1,1464309831,1464309891,2,4,60
16911222@N04,1707,7,1464313435,1464313615,2,4,180
16911222@N04,1707,29,1464314859,1464315759,2,4,900
16911222@N04,1707,31,1464317292,1464318792,1,4,1500
16911222@N04,1708,26,1464350931,1464351831,1,1,900
16959346@N06,1709,25,1366766222,1366767062,9,8,840
16959346@N06,1709,26,1366768329,1366769229,2,8,900
16959346@N06,1709,27,1366770866,1366771019,2,8,153
16959346@N06,1709,26,1366771019,1366771919,2,8,900
16959346@N06,1709,29,1366784430,1366784477,2,8,47
16959346@N06,1709,31,1366784477,1366785977,3,8,1500
16959346@N06,1709,26,1366797636,1366797773,2,8,137
16959346@N06,1709,28,1366797773,1366798673,1,8,900
16997251@N05,1710,23,1208548860,1208549460,1,1,600
16997251@N05,1711,31,1208582028,1208583528,1,1,1500
16997251@N05,1712,30,1222459672,1222460752,1,1,1080
16997251@N05,1713,16,1227639720,1227639990,1,1,270
16997251@N05,1714,30,1227677358,1227678438,1,1,1080
16997251@N05,1715,26,1232779872,1232780772,2,3,900
16997251@N05,1715,1,1232786688,1232786748,3,3,60
16997251@N05,1715,22,1232799951,1232800551,1,3,600
16997251@N05,1716,27,1236584688,1236585588,7,2,900
16997251@N05,1716,17,1236587397,1236587697,1,2,300
17119587@N00,1717,1,1290375506,1290375566,110,1,60
17122396@N00,1718,30,1295134010,1295135090,40,1,1080
17122396@N00,1719,30,1295221131,1295222211,31,1,1080
17145135@N00,1720,28,1338430594,1338431494,1,1,900
17187387@N04,1721,1,1356241387,1356241447,4,1,60
17187387@N04,1722,1,1356303110,1356303170,33,1,60
17187387@N04,1723,1,1356386030,1356386090,20,1,60
17187387@N04,1724,26,1385183356,1385184256,1,1,900
17221717@N02,1725,29,1367398496,1367399396,1,1,900
17221717@N02,1726,18,1372823686,1372824136,2,1,450
17221717@N02,1727,8,1373432549,1373432729,1,1,180
17398899@N05,1728,8,1330937476,1330937656,1,1,180
17398899@N05,1729,21,1331086418,1331086988,1,1,570
17404515@N00,1730,17,1320556778,1320557078,1,1,300
17442971@N00,1731,15,1275183461,1275183731,2,3,270
17442971@N00,1731,22,1275195702,1275196302,2,3,600
17442971@N00,1731,30,1275196742,1275197822,1,3,1080
17529682@N05,1732,26,1202010091,1202010991,2,2,900
17529682@N05,1732,16,1202011449,1202011719,1,2,270
17529682@N05,1733,17,1212602087,1212602387,2,2,300
17529682@N05,1733,3,1212630849,1212630939,1,2,90
17596088@N00,1734,19,1260575315,1260575855,2,3,540
17596088@N00,1734,28,1260581869,1260582769,5,3,900
17596088@N00,1734,18,1260593849,1260594299,1,3,450
17596088@N00,1735,28,1260660849,1260661749,2,2,900
17596088@N00,1735,19,1260671583,1260672123,3,2,540
17596088@N00,1736,1,1348225195,1348225255,4,1,60
17726320@N03,1737,1,1421631491,1421631551,1,1,60
17816422@N00,1738,28,1325280778,1325281678,1,1,900
17816422@N00,1739,28,1325397119,1325398019,1,1,900
17816422@N00,1740,19,1407072366,1407072906,1,1,540
17818511@N00,1741,26,1228520931,1228521504,4,5,573
17818511@N00,1741,15,1228521504,1228521774,2,5,270
17818511@N00,1741,25,1228527206,1228528046,2,5,840
17818511@N00,1741,30,1228531402,1228532482,2,5,1080
17818511@N00,1741,22,1228532924,1228533524,1,5,600
17832362@N00,1742,8,1337689942,1337690122,2,3,180
17832362@N00,1742,14,1337694941,1337695181,2,3,240
17832362@N00,1742,27,1337707625,1337708525,1,3,900
17865663@N00,1743,26,1258602841,1258603700,3,2,859
17865663@N00,1743,28,1258603700,1258604600,2,2,900
17865663@N00,1744,29,1377420347,1377421247,1,1,900
17955069@N04,1745,23,1189959092,1189959411,2,2,319
17955069@N04,1745,26,1189959411,1189960311,1,2,900
17985434@N00,1746,6,1325115052,1325115172,2,1,120
17995170@N00,1747,26,1387974249,1387975149,1,1,900
18026860@N03,1748,30,1346829226,1346830306,2,2,1080
18026860@N03,1748,27,1346832515,1346833415,1,2,900
18026860@N03,1749,13,1348535138,1348535378,5,2,240
18026860@N03,1749,4,1348535681,1348535782,1,2,101
18026860@N03,1750,22,1350203211,1350203811,1,1,600
18026860@N03,1751,26,1430207475,1430208375,1,1,900
18026860@N03,1752,20,1443079847,1443080387,1,1,540
18027113@N07,1753,29,1302400226,1302401126,1,1,900
18061845@N00,1754,18,1250200089,1250200539,29,1,450
18082086@N00,1755,16,1219672800,1219672802,3,3,2
18082086@N00,1755,21,1219672802,1219672805,4,3,3
18082086@N00,1755,23,1219672805,1219673405,1,3,600
18114679@N00,1756,17,1338085408,1338085708,2,8,300
18114679@N00,1756,15,1338088923,1338089193,2,8,270
18114679@N00,1756,29,1338090681,1338091581,33,8,900
18114679@N00,1756,16,1338103129,1338103399,5,8,270
18114679@N00,1756,27,1338104060,1338104960,3,8,900
18114679@N00,1756,17,1338110025,1338110325,2,8,300
18114679@N00,1756,8,1338111716,1338111896,2,8,180
18114679@N00,1756,23,1338122815,1338123415,3,8,600
18174036@N05,1757,23,1394358088,1394358688,1,1,600
18174036@N05,1758,23,1394423531,1394424131,1,1,600
18198369@N03,1759,5,1294894499,1294894619,1,1,120
18291524@N00,1760,7,1250393966,1250394146,1,1,180
18366889@N00,1761,17,1440456526,1440456826,10,10,300
18366889@N00,1761,16,1440460955,1440461225,5,10,270
18366889@N00,1761,24,1440463367,1440464147,4,10,780
18366889@N00,1761,12,1440465105,1440465345,3,10,240
18366889@N00,1761,25,1440466251,1440467091,4,10,840
18366889@N00,1761,13,1440467918,1440468158,5,10,240
18366889@N00,1761,29,1440476018,1440476918,5,10,900
18366889@N00,1761,16,1440482262,1440482532,2,10,270
18366889@N00,1761,7,1440486657,1440486837,2,10,180
18366889@N00,1761,17,1440489118,1440489418,2,10,300
18366889@N00,1762,25,1440577261,1440578101,4,3,840
18366889@N00,1762,4,1440581848,1440581949,4,3,101
18366889@N00,1762,3,1440585456,1440585546,7,3,90
18366889@N00,1763,26,1440718626,1440719213,3,11,587
18366889@N00,1763,6,1440719213,1440719333,3,11,120
18366889@N00,1763,5,1440722732,1440722852,5,11,120
18366889@N00,1763,21,1440725912,1440726020,2,11,108
18366889@N00,1763,11,1440726020,1440726212,3,11,192
18366889@N00,1763,21,1440726212,1440726782,2,11,570
18366889@N00,1763,27,1440731105,1440732005,2,11,900
18366889@N00,1763,14,1440745726,1440745966,2,11,240
18366889@N00,1763,28,1440761165,1440762065,3,11,900
18366889@N00,1763,26,1440763268,1440764168,2,11,900
18366889@N00,1763,15,1440767210,1440767480,1,11,270
18382722@N00,1764,4,1331541730,1331541831,1,1,101
18384077@N00,1765,29,1324987885,1324988785,2,2,900
18384077@N00,1765,28,1325010364,1325011264,1,2,900
18384077@N00,1766,20,1325102165,1325102705,1,1,540
18384077@N00,1767,28,1331450099,1331450999,1,1,900
18384077@N00,1768,20,1331494911,1331495451,1,1,540
18384077@N00,1769,13,1344763893,1344764133,1,1,240
18384077@N00,1770,29,1344858009,1344858909,3,3,900
18384077@N00,1770,20,1344864401,1344864941,2,3,540
18384077@N00,1770,29,1344891496,1344892396,2,3,900
18384077@N00,1771,28,1355549840,1355550740,1,1,900
18384077@N00,1772,13,1355642473,1355642713,1,1,240
18579339@N04,1773,18,1439174727,1439175177,1,1,450
18699029@N00,1774,20,1237564692,1237565232,2,1,540
18753948@N00,1775,1,1289429402,1289429462,2,24,60
18753948@N00,1775,29,1289431564,1289432149,6,24,585
18753948@N00,1775,20,1289432149,1289432689,3,24,540
18753948@N00,1775,31,1289434638,1289434669,2,24,31
18753948@N00,1775,30,1289434669,1289434716,2,24,47
18753948@N00,1775,31,1289434716,1289435901,2,24,1185
18753948@N00,1775,10,1289435901,1289436141,6,24,240
18753948@N00,1775,26,1289437457,1289438357,4,24,900
18753948@N00,1775,28,1289438723,1289439445,2,24,722
18753948@N00,1775,1,1289439445,1289439505,2,24,60
18753948@N00,1775,28,1289440642,1289441153,4,24,511
18753948@N00,1775,12,1289441153,1289441253,2,24,100
18753948@N00,1775,16,1289441253,1289441343,2,24,90
18753948@N00,1775,27,1289441343,1289442243,2,24,900
18753948@N00,1775,25,1289445213,1289445530,4,24,317
18753948@N00,1775,13,1289445530,1289445770,7,24,240
18753948@N00,1775,5,1289449089,1289449209,3,24,120
18753948@N00,1775,7,1289449530,1289449710,2,24,180
18753948@N00,1775,5,1289450092,1289450212,2,24,120
18753948@N00,1775,25,1289454241,1289455081,10,24,840
18753948@N00,1775,15,1289461008,1289461278,3,24,270
18753948@N00,1775,16,1289463405,1289463675,8,24,270
18753948@N00,1775,17,1289471144,1289471444,2,24,300
18753948@N00,1775,28,1289471902,1289472802,1,24,900
18753948@N00,1776,22,1289516521,1289517121,6,4,600
18753948@N00,1776,20,1289518900,1289519440,13,4,540
18753948@N00,1776,28,1289537748,1289538648,29,4,900
18753948@N00,1776,15,1289541674,1289541944,9,4,270
18753948@N00,1777,28,1289597430,1289597662,2,14,232
18753948@N00,1777,26,1289597662,1289598562,2,14,900
18753948@N00,1777,25,1289599393,1289600233,2,14,840
18753948@N00,1777,29,1289604164,1289604990,2,14,826
18753948@N00,1777,20,1289604990,1289605530,4,14,540
18753948@N00,1777,23,1289607565,1289608165,7,14,600
18753948@N00,1777,30,1289620331,1289621411,4,14,1080
18753948@N00,1777,29,1289628842,1289629341,5,14,499
18753948@N00,1777,31,1289629341,1289630841,2,14,1500
18753948@N00,1777,25,1289634585,1289635425,4,14,840
18753948@N00,1777,3,1289636858,1289636948,2,14,90
18753948@N00,1777,20,1289637604,1289637975,3,14,371
18753948@N00,1777,22,1289637975,1289638575,2,14,600
18753948@N00,1777,26,1289642734,1289643634,2,14,900
18753948@N00,1778,1,1326754497,1326754557,3,22,60
18753948@N00,1778,28,1326754843,1326755075,3,22,232
18753948@N00,1778,26,1326755075,1326755099,2,22,24
18753948@N00,1778,23,1326755099,1326755699,2,22,600
18753948@N00,1778,29,1326756441,1326756625,4,22,184
18753948@N00,1778,31,1326756625,1326756831,4,22,206
18753948@N00,1778,30,1326756831,1326757911,2,22,1080
18753948@N00,1778,22,1326758920,1326759520,4,22,600
18753948@N00,1778,31,1326760025,1326761525,6,22,1500
18753948@N00,1778,16,1326763343,1326763483,2,22,140
18753948@N00,1778,17,1326763483,1326763783,2,22,300
18753948@N00,1778,26,1326767051,1326767951,4,22,900
18753948@N00,1778,29,1326768018,1326768918,2,22,900
18753948@N00,1778,20,1326770987,1326771527,2,22,540
18753948@N00,1778,3,1326773380,1326773428,2,22,48
18753948@N00,1778,25,1326773428,1326774268,6,22,840
18753948@N00,1778,13,1326775189,1326775429,8,22,240
18753948@N00,1778,28,1326778275,1326779175,4,22,900
18753948@N00,1778,26,1326782841,1326783334,3,22,493
18753948@N00,1778,3,1326783334,1326783424,2,22,90
18753948@N00,1778,25,1326783607,1326784294,4,22,687
18753948@N00,1778,16,1326784294,1326784564,1,22,270
18753948@N00,1779,26,1414373252,1414374152,12,2,900
18753948@N00,1779,20,1414383229,1414383769,11,2,540
18753948@N00,1780,26,1414448498,1414449398,3,3,900
18753948@N00,1780,20,1414457776,1414458316,9,3,540
18753948@N00,1780,26,1414467930,1414468830,2,3,900
18753948@N00,1781,24,1414540276,1414541056,3,4,780
18753948@N00,1781,26,1414546043,1414546943,2,4,900
18753948@N00,1781,20,1414547034,1414547574,12,4,540
18753948@N00,1781,26,1414557262,1414558162,1,4,900
18753948@N00,1782,26,1414623126,1414624026,4,5,900
18753948@N00,1782,20,1414626282,1414626822,2,5,540
18753948@N00,1782,11,1414628449,1414628689,8,5,240
18753948@N00,1782,24,1414630507,1414631287,3,5,780
18753948@N00,1782,26,1414633879,1414634779,3,5,900
18753948@N00,1783,26,1414712699,1414713599,2,2,900
18753948@N00,1783,11,1414715168,1414715408,6,2,240
18813519@N00,1784,30,1329167847,1329168927,1,1,1080
18837886@N00,1785,16,1391736331,1391736601,1,1,270
18840194@N02,1786,1,1218676702,1218676762,4,7,60
18840194@N02,1786,26,1218677322,1218678157,2,7,835
18840194@N02,1786,7,1218678157,1218678337,2,7,180
18840194@N02,1786,29,1218680496,1218681396,2,7,900
18840194@N02,1786,31,1218687010,1218688510,7,7,1500
18840194@N02,1786,4,1218690198,1218690299,2,7,101
18840194@N02,1786,11,1218691161,1218691401,1,7,240
18840194@N02,1787,16,1218720635,1218720905,1,1,270
18843927@N00,1788,18,1430361655,1430362105,1,1,450
18884029@N00,1789,26,1324533384,1324534284,2,6,900
18884029@N00,1789,21,1324537339,1324537909,6,6,570
18884029@N00,1789,26,1324539328,1324540158,3,6,830
18884029@N00,1789,21,1324540158,1324540728,2,6,570
18884029@N00,1789,25,1324553756,1324554596,4,6,840
18884029@N00,1789,28,1324554727,1324555627,1,6,900
18898819@N03,1790,26,1188091697,1188092597,1,1,900
18898819@N03,1791,25,1194919453,1194920293,1,1,840
18963732@N06,1792,20,1408091395,1408091527,2,5,132
18963732@N06,1792,1,1408091527,1408091587,2,5,60
18963732@N06,1792,15,1408102371,1408102641,2,5,270
18963732@N06,1792,6,1408103465,1408103585,2,5,120
18963732@N06,1792,19,1408107676,1408108216,2,5,540
18963732@N06,1793,24,1408142878,1408143658,2,7,780
18963732@N06,1793,27,1408154136,1408155036,2,7,900
18963732@N06,1793,3,1408157478,1408157568,2,7,90
18963732@N06,1793,13,1408157596,1408157701,2,7,105
18963732@N06,1793,25,1408157701,1408158541,2,7,840
18963732@N06,1793,18,1408167991,1408168091,2,7,100
18963732@N06,1793,14,1408168091,1408168331,2,7,240
18963732@N06,1794,30,1408244266,1408245346,1,1,1080
18966792@N00,1795,29,1429269688,1429270588,3,2,900
18966792@N00,1795,6,1429272877,1429272997,1,2,120
18966792@N00,1796,29,1463191541,1463192441,2,1,900
18991733@N00,1797,3,1340713876,1340713896,2,3,20
18991733@N00,1797,23,1340713896,1340713916,2,3,20
18991733@N00,1797,19,1340713916,1340714456,1,3,540
19017254@N03,1798,6,1462359708,1462359828,2,3,120
19017254@N03,1798,10,1462361151,1462361391,2,3,240
19017254@N03,1798,16,1462363117,1462363387,1,3,270
19026178@N00,1799,29,1191539768,1191540668,5,23,900
19026178@N00,1799,20,1191541088,1191541228,2,23,140
19026178@N00,1799,29,1191541228,1191541532,2,23,304
19026178@N00,1799,23,1191541532,1191541591,2,23,59
19026178@N00,1799,26,1191541591,1191541855,4,23,264
19026178@N00,1799,16,1191541855,1191542125,2,23,270
19026178@N00,1799,12,1191542287,1191542527,2,23,240
19026178@N00,1799,17,1191542861,1191543161,2,23,300
19026178@N00,1799,26,1191544449,1191545349,12,23,900
19026178@N00,1799,16,1191545490,1191545760,3,23,270
19026178@N00,1799,28,1191547050,1191547950,4,23,900
19026178@N00,1799,30,1191550681,1191551179,2,23,498
19026178@N00,1799,12,1191551179,1191551375,2,23,196
19026178@N00,1799,24,1191551375,1191552155,6,23,780
19026178@N00,1799,12,1191553244,1191553484,2,23,240
19026178@N00,1799,16,1191554334,1191554454,2,23,120
19026178@N00,1799,26,1191554454,1191554862,2,23,408
19026178@N00,1799,1,1191554862,1191554922,2,23,60
19026178@N00,1799,28,1191559313,1191560016,2,23,703
19026178@N00,1799,26,1191560016,1191560916,2,23,900
19026178@N00,1799,29,1191561252,1191562152,8,23,900
19026178@N00,1799,26,1191565815,1191566715,3,23,900
19026178@N00,1799,15,1191586063,1191586333,1,23,270
19026178@N00,1800,17,1191735674,1191735974,1,1,300
19026178@N00,1801,1,1215986007,1215986067,2,6,60
19026178@N00,1801,29,1215996599,1215997499,2,6,900
19026178@N00,1801,1,1216002383,1216002443,3,6,60
19026178@N00,1801,27,1216013626,1216013694,4,6,68
19026178@N00,1801,17,1216013694,1216013994,2,6,300
19026178@N00,1801,1,1216016847,1216016907,1,6,60
19026178@N00,1802,25,1242442136,1242442976,11,9,840
19026178@N00,1802,13,1242443212,1242443452,2,9,240
19026178@N00,1802,7,1242445341,1242445521,3,9,180
19026178@N00,1802,14,1242452965,1242453205,3,9,240
19026178@N00,1802,25,1242456698,1242457538,4,9,840
19026178@N00,1802,13,1242457970,1242458210,3,9,240
19026178@N00,1802,12,1242458506,1242458746,2,9,240
19026178@N00,1802,17,1242458798,1242459098,10,9,300
19026178@N00,1802,24,1242459745,1242460525,4,9,780
19026178@N00,1803,1,1272513679,1272513739,3,2,60
19026178@N00,1803,26,1272515648,1272516548,3,2,900
19026178@N00,1804,29,1340753191,1340754091,76,1,900
19174219@N00,1805,29,1225789613,1225790513,2,1,900
19174219@N00,1806,28,1238280698,1238281212,2,2,514
19174219@N00,1806,23,1238281212,1238281812,1,2,600
19174219@N00,1807,23,1238377794,1238378394,2,1,600
19174219@N00,1808,28,1238458914,1238459814,2,2,900
19174219@N00,1808,22,1238480765,1238481365,1,2,600
19174219@N00,1809,11,1238545304,1238545544,3,3,240
19174219@N00,1809,29,1238570306,1238571206,2,3,900
19174219@N00,1809,23,1238574514,1238575114,1,3,600
19174219@N00,1810,29,1240433638,1240434538,1,1,900
19174219@N00,1811,13,1258635827,1258636067,3,2,240
19174219@N00,1811,30,1258637518,1258638598,1,2,1080
19277091@N00,1812,1,1222735982,1222736042,2,9,60
19277091@N00,1812,19,1222738739,1222739279,2,9,540
19277091@N00,1812,29,1222740105,1222741005,2,9,900
19277091@N00,1812,22,1222742005,1222742605,2,9,600
19277091@N00,1812,14,1222743336,1222743576,2,9,240
19277091@N00,1812,29,1222747814,1222748714,2,9,900
19277091@N00,1812,26,1222749374,1222750274,2,9,900
19277091@N00,1812,22,1222751422,1222752022,2,9,600
19277091@N00,1812,21,1222758831,1222759401,1,9,570
19286282@N00,1813,7,1355788533,1355788713,1,1,180
19291889@N00,1814,18,1370742526,1370742585,2,5,59
19291889@N00,1814,26,1370742585,1370743485,2,5,900
19291889@N00,1814,5,1370744887,1370745007,2,5,120
19291889@N00,1814,29,1370751511,1370752411,2,5,900
19291889@N00,1814,7,1370760803,1370760983,1,5,180
19291889@N00,1815,30,1402193763,1402194843,1,1,1080
19302008@N00,1816,30,1403228267,1403229347,1,1,1080
19302008@N00,1817,28,1435058222,1435059122,1,1,900
19302008@N00,1818,28,1435092853,1435093753,1,1,900
19302008@N00,1819,6,1435877432,1435877552,1,1,120
19302008@N00,1820,18,1436088830,1436089280,1,1,450
19329919@N00,1821,3,1226208475,1226208565,1,1,90
19329919@N00,1822,16,1226485690,1226485960,6,1,270
19329919@N00,1823,28,1226537036,1226537936,1,1,900
19329919@N00,1824,27,1289444764,1289445664,1,1,900
19329919@N00,1825,28,1289640984,1289641884,1,1,900
19387612@N00,1826,16,1359266147,1359266417,3,1,270
19452106@N00,1827,21,1344066605,1344067175,2,3,570
19452106@N00,1827,31,1344074712,1344076212,2,3,1500
19452106@N00,1827,26,1344091844,1344092744,1,3,900
19466493@N00,1828,26,1469672250,1469673150,3,2,900
19466493@N00,1828,5,1469683919,1469684039,1,2,120
19482074@N00,1829,26,1235890291,1235891191,1,1,900
19482074@N00,1830,7,1242009753,1242009933,1,1,180
19482074@N00,1831,1,1275792825,1275792885,1,1,60
19567516@N00,1832,22,1462148392,1462148404,2,16,12
19567516@N00,1832,30,1462148404,1462149484,2,16,1080
19567516@N00,1832,23,1462149971,1462149976,2,16,5
19567516@N00,1832,17,1462149976,1462150276,2,16,300
19567516@N00,1832,21,1462160731,1462161301,3,16,570
19567516@N00,1832,28,1462161848,1462161857,2,16,9
19567516@N00,1832,11,1462161857,1462161919,8,16,62
19567516@N00,1832,4,1462161919,1462161950,3,16,31
19567516@N00,1832,21,1462161950,1462162520,7,16,570
19567516@N00,1832,23,1462162593,1462162898,7,16,305
19567516@N00,1832,19,1462162898,1462162929,4,16,31
19567516@N00,1832,18,1462162929,1462163379,3,16,450
19567516@N00,1832,20,1462169169,1462169709,2,16,540
19567516@N00,1832,14,1462181001,1462181241,5,16,240
19567516@N00,1832,27,1462186825,1462186834,3,16,9
19567516@N00,1832,28,1462186834,1462187734,15,16,900
19575849@N00,1833,14,1375838494,1375838734,2,2,240
19575849@N00,1833,24,1375861601,1375862381,1,2,780
19575849@N00,1834,17,1395638312,1395638612,1,1,300
19601457@N00,1835,17,1299187171,1299187471,3,1,300
19655415@N00,1836,20,1198534454,1198534994,5,11,540
19655415@N00,1836,18,1198555604,1198556054,7,11,450
19655415@N00,1836,19,1198556135,1198556675,3,11,540
19655415@N00,1836,29,1198558271,1198559171,6,11,900
19655415@N00,1836,26,1198561131,1198562031,2,11,900
19655415@N00,1836,28,1198564552,1198565452,3,11,900
19655415@N00,1836,31,1198576020,1198576103,2,11,83
19655415@N00,1836,28,1198576103,1198577003,2,11,900
19655415@N00,1836,17,1198580105,1198580405,5,11,300
19655415@N00,1836,26,1198588036,1198588541,5,11,505
19655415@N00,1836,28,1198588541,1198589441,3,11,900
19709423@N04,1837,26,1284357553,1284357801,7,2,248
19709423@N04,1837,29,1284357801,1284358701,3,2,900
19712216@N08,1838,26,1236503350,1236503362,2,7,12
19712216@N08,1838,17,1236503362,1236503363,2,7,1
19712216@N08,1838,26,1236503363,1236503365,3,7,2
19712216@N08,1838,20,1236503365,1236503368,2,7,3
19712216@N08,1838,10,1236503368,1236503371,2,7,3
19712216@N08,1838,20,1236503371,1236503374,2,7,3
19712216@N08,1838,10,1236503374,1236503614,1,7,240
19712216@N08,1839,23,1238023218,1238023467,2,8,249
19712216@N08,1839,19,1238023467,1238023654,3,8,187
19712216@N08,1839,10,1238023654,1238023702,2,8,48
19712216@N08,1839,19,1238023702,1238024242,3,8,540
19712216@N08,1839,20,1238025069,1238025609,8,8,540
19712216@N08,1839,31,1238027387,1238027606,2,8,219
19712216@N08,1839,10,1238027606,1238027846,3,8,240
19712216@N08,1839,5,1238029138,1238029258,1,8,120
19712216@N08,1840,10,1240034431,1240034671,23,1,240
19712216@N08,1841,10,1240463722,1240463962,3,1,240
19712216@N08,1842,23,1243479003,1243479596,4,3,593
19712216@N08,1842,20,1243479596,1243480136,5,3,540
19712216@N08,1842,23,1243481669,1243482269,6,3,600
19712216@N08,1843,26,1248739023,1248739190,2,6,167
19712216@N08,1843,28,1248739190,1248740090,3,6,900
19712216@N08,1843,20,1248745469,1248746009,3,6,540
19712216@N08,1843,23,1248747991,1248748591,2,6,600
19712216@N08,1843,3,1248753456,1248753546,2,6,90
19712216@N08,1843,29,1248755350,1248756250,1,6,900
19712216@N08,1844,28,1256776325,1256776796,3,4,471
19712216@N08,1844,26,1256776796,1256777696,2,4,900
19712216@N08,1844,20,1256777876,1256778416,7,4,540
19712216@N08,1844,18,1256780947,1256781397,8,4,450
19712216@N08,1845,19,1270526069,1270526609,1,1,540
19712216@N08,1846,18,1281414792,1281415242,6,1,450
19712216@N08,1847,10,1288245507,1288245747,2,3,240
19712216@N08,1847,29,1288260330,1288260693,2,3,363
19712216@N08,1847,19,1288260693,1288261233,3,3,540
19712216@N08,1848,26,1295326586,1295327486,1,1,900
19714819@N00,1849,18,1423278291,1423278741,2,4,450
19714819@N00,1849,13,1423281609,1423281849,3,4,240
19714819@N00,1849,21,1423301854,1423302067,2,4,213
19714819@N00,1849,3,1423302067,1423302157,1,4,90
19741840@N00,1850,28,1261611375,1261612275,1,1,900
19797342@N00,1851,26,1370264117,1370265017,1,1,900
19797342@N00,1852,19,1406080569,1406081109,3,1,540
19898864@N00,1853,30,1231199753,1231200833,2,2,1080
19898864@N00,1853,18,1231207071,1231207521,1,2,450
19909714@N00,1854,16,1279836482,1279836752,2,6,270
19909714@N00,1854,4,1279837053,1279837154,2,6,101
19909714@N00,1854,13,1279840766,1279841006,3,6,240
19909714@N00,1854,4,1279859255,1279859356,5,6,101
19909714@N00,1854,28,1279866638,1279866816,2,6,178
19909714@N00,1854,1,1279866816,1279866876,1,6,60
19944325@N00,1855,17,1379771984,1379772284,1,1,300
19944325@N00,1856,7,1411432048,1411432228,2,3,180
19944325@N00,1856,23,1411444219,1411444819,2,3,600
19944325@N00,1856,18,1411446335,1411446785,1,3,450
20008009@N05,1857,29,1418256600,1418257500,2,10,900
20008009@N05,1857,26,1418259440,1418260005,2,10,565
20008009@N05,1857,20,1418260005,1418260545,2,10,540
20008009@N05,1857,30,1418268376,1418269456,2,10,1080
20008009@N05,1857,26,1418274614,1418275514,2,10,900
20008009@N05,1857,19,1418280472,1418281012,2,10,540
20008009@N05,1857,17,1418282123,1418282128,2,10,5
20008009@N05,1857,18,1418282128,1418282578,2,10,450
20008009@N05,1857,17,1418283394,1418283694,2,10,300
20008009@N05,1857,28,1418287491,1418288391,1,10,900
20009658@N00,1858,29,1232328405,1232329305,2,5,900
20009658@N00,1858,20,1232341155,1232341695,3,5,540
20009658@N00,1858,10,1232349893,1232350133,2,5,240
20009658@N00,1858,26,1232350692,1232351592,2,5,900
20009658@N00,1858,28,1232364218,1232365118,1,5,900
20009658@N00,1859,16,1232930847,1232931117,2,2,270
20009658@N00,1859,20,1232931790,1232932330,1,2,540
20021588@N00,1860,28,1449560676,1449561576,1,1,900
20075673@N04,1861,26,1332980131,1332980551,3,2,420
20075673@N04,1861,28,1332980551,1332981451,1,2,900
20121804@N05,1862,1,1433544489,1433544549,71,1,60
20154444@N04,1863,26,1362808291,1362809191,1,1,900
20154444@N04,1864,1,1470012236,1470012296,1,1,60
20163306@N00,1865,17,1228625079,1228625379,5,4,300
20163306@N00,1865,12,1228629978,1228630218,2,4,240
20163306@N00,1865,22,1228633333,1228633933,4,4,600
20163306@N00,1865,19,1228639871,1228640411,4,4,540
20206627@N03,1866,28,1257920131,1257921031,1,1,900
20231549@N08,1867,28,1447236639,1447237539,1,1,900
20258091@N02,1868,30,1422347317,1422348397,1,1,1080
20258091@N02,1869,18,1422410920,1422411370,1,1,450
20300186@N02,1870,18,1459996054,1459996504,5,1,450
20300186@N02,1871,18,1460082055,1460082505,1,1,450
20306506@N08,1872,28,1309141451,1309141456,3,24,5
20306506@N08,1872,27,1309141456,1309141461,2,24,5
20306506@N08,1872,28,1309141461,1309141487,2,24,26
20306506@N08,1872,18,1309141487,1309141533,2,24,46
20306506@N08,1872,1,1309141533,1309141536,2,24,3
20306506@N08,1872,28,1309141536,1309142189,2,24,653
20306506@N08,1872,20,1309142189,1309142383,15,24,194
20306506@N08,1872,29,1309142383,1309142394,2,24,11
20306506@N08,1872,20,1309142394,1309142934,4,24,540
20306506@N08,1872,29,1309144102,1309145002,31,24,900
20306506@N08,1872,20,1309145334,1309145874,4,24,540
20306506@N08,1872,8,1309148108,1309148119,2,24,11
20306506@N08,1872,12,1309148119,1309148136,4,24,17
20306506@N08,1872,8,1309148136,1309148246,8,24,110
20306506@N08,1872,5,1309148246,1309148366,25,24,120
20306506@N08,1872,6,1309148860,1309148906,4,24,46
20306506@N08,1872,26,1309148906,1309149091,4,24,185
20306506@N08,1872,23,1309149091,1309149270,11,24,179
20306506@N08,1872,26,1309149270,1309150170,6,24,900
20306506@N08,1872,19,1309150261,1309150631,5,24,370
20306506@N08,1872,23,1309150631,1309151231,10,24,600
20306506@N08,1872,1,1309165664,1309165724,3,24,60
20306506@N08,1872,23,1309172180,1309172780,6,24,600
20306506@N08,1872,26,1309181222,1309182122,4,24,900
20319059@N06,1873,1,1217237473,1217237533,5,12,60
20319059@N06,1873,26,1217237897,1217238079,10,12,182
20319059@N06,1873,18,1217238079,1217238173,3,12,94
20319059@N06,1873,23,1217238173,1217238273,3,12,100
20319059@N06,1873,30,1217238273,1217238351,2,12,78
20319059@N06,1873,29,1217238351,1217239251,48,12,900
20319059@N06,1873,20,1217241050,1217241590,17,12,540
20319059@N06,1873,31,1217242098,1217243598,115,12,1500
20319059@N06,1873,23,1217246248,1217246848,2,12,600
20319059@N06,1873,18,1217247148,1217247484,2,12,336
20319059@N06,1873,28,1217247484,1217247707,4,12,223
20319059@N06,1873,1,1217247707,1217247767,10,12,60
20319059@N06,1874,24,1217321355,1217322135,3,7,780
20319059@N06,1874,12,1217325175,1217325219,3,7,44
20319059@N06,1874,24,1217325219,1217325999,7,7,780
20319059@N06,1874,21,1217327555,1217328125,23,7,570
20319059@N06,1874,12,1217328776,1217329016,3,7,240
20319059@N06,1874,16,1217329101,1217329371,13,7,270
20319059@N06,1874,26,1217334685,1217335585,3,7,900
20319059@N06,1875,31,1217385385,1217386216,3,15,831
20319059@N06,1875,21,1217386216,1217386245,2,15,29
20319059@N06,1875,31,1217386245,1217386573,2,15,328
20319059@N06,1875,22,1217386573,1217386723,3,15,150
20319059@N06,1875,31,1217386723,1217387427,3,15,704
20319059@N06,1875,30,1217387427,1217387676,3,15,249
20319059@N06,1875,26,1217387676,1217388576,6,15,900
20319059@N06,1875,16,1217394571,1217394841,6,15,270
20319059@N06,1875,3,1217396014,1217396104,5,15,90
20319059@N06,1875,26,1217400745,1217401645,2,15,900
20319059@N06,1875,29,1217403953,1217404216,2,15,263
20319059@N06,1875,20,1217404216,1217404756,18,15,540
20319059@N06,1875,22,1217406659,1217407259,5,15,600
20319059@N06,1875,29,1217407551,1217408451,19,15,900
20319059@N06,1875,28,1217409826,1217410726,1,15,900
20319059@N06,1876,1,1218857662,1218857722,4,2,60
20319059@N06,1876,26,1218881498,1218882398,1,2,900
20319059@N06,1877,29,1221221034,1221221934,5,1,900
20319059@N06,1878,1,1221284799,1221284859,3,4,60
20319059@N06,1878,28,1221284919,1221285819,2,4,900
20319059@N06,1878,23,1221288706,1221289306,4,4,600
20319059@N06,1878,28,1221295977,1221296877,2,4,900
20319059@N06,1879,1,1223782829,1223782889,5,10,60
20319059@N06,1879,28,1223783507,1223784407,4,10,900
20319059@N06,1879,24,1223786332,1223787112,10,10,780
20319059@N06,1879,21,1223788098,1223788668,2,10,570
20319059@N06,1879,12,1223788740,1223788980,5,10,240
20319059@N06,1879,11,1223793477,1223793717,2,10,240
20319059@N06,1879,30,1223794593,1223795673,5,10,1080
20319059@N06,1879,20,1223795973,1223796513,6,10,540
20319059@N06,1879,26,1223805467,1223806367,3,10,900
20319059@N06,1879,17,1223808327,1223808627,1,10,300
20319059@N06,1880,28,1225537685,1225538585,2,1,900
20319059@N06,1881,28,1227315393,1227316293,5,11,900
20319059@N06,1881,29,1227318081,1227318981,8,11,900
20319059@N06,1881,25,1227328862,1227329702,38,11,840
20319059@N06,1881,21,1227331026,1227331596,33,11,570
20319059@N06,1881,11,1227332959,1227333199,5,11,240
20319059@N06,1881,30,1227336008,1227337088,2,11,1080
20319059@N06,1881,22,1227338807,1227339407,4,11,600
20319059@N06,1881,14,1227340093,1227340333,4,11,240
20319059@N06,1881,29,1227341755,1227342042,3,11,287
20319059@N06,1881,26,1227342042,1227342942,6,11,900
20319059@N06,1881,28,1227346345,1227347245,3,11,900
20319059@N06,1882,1,1230369030,1230369090,2,3,60
20319059@N06,1882,28,1230373500,1230373702,3,3,202
20319059@N06,1882,26,1230373702,1230374602,2,3,900
20319059@N06,1883,30,1237010101,1237011181,4,2,1080
20319059@N06,1883,26,1237014511,1237015411,7,2,900
20319059@N06,1884,28,1243677989,1243678809,6,3,820
20319059@N06,1884,14,1243678809,1243679049,2,3,240
20319059@N06,1884,28,1243684853,1243685753,1,3,900
20319059@N06,1885,26,1243732274,1243733174,2,4,900
20319059@N06,1885,27,1243733600,1243734500,4,4,900
20319059@N06,1885,20,1243737274,1243737814,6,4,540
20319059@N06,1885,29,1243739013,1243739913,2,4,900
20319059@N06,1886,28,1258759241,1258759406,2,2,165
20319059@N06,1886,26,1258759406,1258760306,2,2,900
20319059@N06,1887,20,1258806619,1258807159,1,1,540
20319059@N06,1888,20,1261206642,1261207182,2,1,540
20319059@N06,1889,16,1264832566,1264832836,2,2,270
20319059@N06,1889,26,1264833609,1264834509,18,2,900
20319059@N06,1890,23,1274515958,1274515969,2,4,11
20319059@N06,1890,28,1274515969,1274516869,2,4,900
20319059@N06,1890,17,1274518462,1274518762,3,4,300
20319059@N06,1890,28,1274524406,1274525306,1,4,900
20319059@N06,1891,28,1289632554,1289633454,5,3,900
20319059@N06,1891,3,1289635124,1289635214,9,3,90
20319059@N06,1891,9,1289637526,1289637706,4,3,180
20319059@N06,1892,28,1312003834,1312004734,3,4,900
20319059@N06,1892,1,1312005899,1312005959,2,4,60
20319059@N06,1892,28,1312006894,1312007794,40,4,900
20319059@N06,1892,30,1312010508,1312011588,1,4,1080
20319059@N06,1893,26,1312097178,1312098078,1,1,900
20319059@N06,1894,4,1312178435,1312178536,50,4,101
20319059@N06,1894,28,1312186460,1312187360,2,4,900
20319059@N06,1894,29,1312193677,1312194577,2,4,900
20319059@N06,1894,30,1312196422,1312197502,1,4,1080
20322483@N05,1895,25,1200650808,1200651648,2,10,840
20322483@N05,1895,21,1200652093,1200652663,2,10,570
20322483@N05,1895,23,1200653272,1200653872,2,10,600
20322483@N05,1895,20,1200657181,1200657721,3,10,540
20322483@N05,1895,26,1200660112,1200661012,2,10,900
20322483@N05,1895,1,1200661445,1200661505,2,10,60
20322483@N05,1895,18,1200663550,1200664000,2,10,450
20322483@N05,1895,28,1200667431,1200668331,4,10,900
20322483@N05,1895,21,1200680273,1200680843,2,10,570
20322483@N05,1895,26,1200680921,1200681821,3,10,900
20322483@N05,1896,21,1200757615,1200758185,2,5,570
20322483@N05,1896,15,1200760854,1200761124,3,5,270
20322483@N05,1896,28,1200764654,1200765554,3,5,900
20322483@N05,1896,21,1200781524,1200782094,2,5,570
20322483@N05,1896,26,1200784227,1200785127,1,5,900
20322483@N05,1897,26,1201073892,1201074792,1,1,900
20322483@N05,1898,29,1204340162,1204341062,1,1,900
20363327@N00,1899,30,1209256711,1209257791,1,1,1080
20363327@N00,1900,26,1221176907,1221177807,87,1,900
20363327@N00,1901,26,1221303357,1221304257,1,1,900
20363327@N00,1902,26,1221347174,1221348074,15,1,900
20363327@N00,1903,26,1221735137,1221736037,2,1,900
20363327@N00,1904,30,1230639534,1230639717,3,2,183
20363327@N00,1904,26,1230639717,1230640617,2,2,900
20363327@N00,1905,30,1291605420,1291606500,21,3,1080
20363327@N00,1905,26,1291612196,1291612549,2,3,353
20363327@N00,1905,30,1291612549,1291613629,27,3,1080
20363327@N00,1906,30,1291673736,1291674816,56,1,1080
20363327@N00,1907,30,1291890725,1291891805,4,1,1080
20372999@N03,1908,28,1294632790,1294633690,1,1,900
20420206@N07,1909,10,1237348664,1237348904,9,1,240
20420206@N07,1910,1,1301446080,1301446140,4,19,60
20420206@N07,1910,13,1301446597,1301446837,2,19,240
20420206@N07,1910,10,1301446999,1301447005,2,19,6
20420206@N07,1910,15,1301447005,1301447230,3,19,225
20420206@N07,1910,26,1301447230,1301447313,2,19,83
20420206@N07,1910,17,1301447313,1301447478,2,19,165
20420206@N07,1910,28,1301447478,1301447760,2,19,282
20420206@N07,1910,10,1301447760,1301448000,2,19,240
20420206@N07,1910,28,1301448381,1301449281,4,19,900
20420206@N07,1910,18,1301450371,1301450821,23,19,450
20420206@N07,1910,19,1301451186,1301451726,2,19,540
20420206@N07,1910,14,1301453573,1301453813,3,19,240
20420206@N07,1910,30,1301454857,1301455937,2,19,1080
20420206@N07,1910,26,1301460498,1301461398,3,19,900
20420206@N07,1910,5,1301464340,1301464460,7,19,120
20420206@N07,1910,11,1301465158,1301465398,5,19,240
20420206@N07,1910,10,1301465533,1301465773,4,19,240
20420206@N07,1910,26,1301473300,1301474200,2,19,900
20420206@N07,1910,29,1301480792,1301481692,6,19,900
20420206@N07,1911,1,1395277701,1395277761,2,4,60
20420206@N07,1911,7,1395279253,1395279433,2,4,180
20420206@N07,1911,30,1395292889,1395293969,2,4,1080
20420206@N07,1911,13,1395317709,1395317949,1,4,240
20493744@N00,1912,18,1200707046,1200707496,2,7,450
20493744@N00,1912,19,1200707819,1200708359,2,7,540
20493744@N00,1912,17,1200718882,1200719182,2,7,300
20493744@N00,1912,28,1200725197,1200726097,2,7,900
20493744@N00,1912,16,1200727771,1200728041,2,7,270
20493744@N00,1912,26,1200728552,1200728774,2,7,222
20493744@N00,1912,16,1200728774,1200729044,1,7,270
20493744@N00,1913,28,1230587304,1230587446,2,7,142
20493744@N00,1913,26,1230587446,1230588346,2,7,900
20493744@N00,1913,12,1230591292,1230591532,2,7,240
20493744@N00,1913,23,1230598170,1230598770,2,7,600
20493744@N00,1913,30,1230618655,1230619735,2,7,1080
20493744@N00,1913,23,1230620117,1230620717,2,7,600
20493744@N00,1913,26,1230623778,1230624678,2,7,900
20496242@N00,1914,16,1283828053,1283828323,2,2,270
20496242@N00,1914,28,1283831976,1283832876,2,2,900
20505456@N00,1915,7,1318143867,1318144047,1,1,180
20521043@N03,1916,25,1287788942,1287789782,1,1,840
20536887@N03,1917,27,1357374138,1357375038,1,1,900
20536887@N03,1918,18,1448143504,1448143954,2,1,450
20536887@N03,1919,18,1449304285,1449304735,3,1,450
20544648@N06,1920,30,1310018596,1310018709,4,5,113
20544648@N06,1920,21,1310018709,1310018761,3,5,52
20544648@N06,1920,12,1310018761,1310018793,2,5,32
20544648@N06,1920,3,1310018793,1310018809,2,5,16
20544648@N06,1920,1,1310018809,1310018869,2,5,60
20544648@N06,1921,12,1333587521,1333587612,2,14,91
20544648@N06,1921,21,1333587612,1333587637,2,14,25
20544648@N06,1921,29,1333587637,1333587675,2,14,38
20544648@N06,1921,18,1333587675,1333587689,2,14,14
20544648@N06,1921,29,1333587689,1333587760,4,14,71
20544648@N06,1921,12,1333587760,1333587769,2,14,9
20544648@N06,1921,26,1333587769,1333587808,2,14,39
20544648@N06,1921,12,1333587808,1333587856,2,14,48
20544648@N06,1921,20,1333587856,1333588396,3,14,540
20544648@N06,1921,29,1333589552,1333589578,2,14,26
20544648@N06,1921,26,1333589578,1333589596,2,14,18
20544648@N06,1921,1,1333589596,1333589607,2,14,11
20544648@N06,1921,26,1333589607,1333589648,2,14,41
20544648@N06,1921,18,1333589648,1333590098,1,14,450
20544648@N06,1922,25,1377205003,1377205010,2,6,7
20544648@N06,1922,1,1377205010,1377205021,2,6,11
20544648@N06,1922,29,1377205021,1377205043,2,6,22
20544648@N06,1922,15,1377205043,1377205158,2,6,115
20544648@N06,1922,26,1377205158,1377205226,2,6,68
20544648@N06,1922,29,1377205226,1377206126,1,6,900
20544648@N06,1923,25,1389441239,1389441277,3,11,38
20544648@N06,1923,19,1389441277,1389441281,2,11,4
20544648@N06,1923,18,1389441281,1389441302,4,11,21
20544648@N06,1923,28,1389441302,1389441340,4,11,38
20544648@N06,1923,16,1389441340,1389441610,2,11,270
20544648@N06,1923,1,1389441670,1389441679,2,11,9
20544648@N06,1923,15,1389441679,1389441689,2,11,10
20544648@N06,1923,24,1389441689,1389441708,2,11,19
20544648@N06,1923,12,1389441708,1389441717,2,11,9
20544648@N06,1923,7,1389441717,1389441726,2,11,9
20544648@N06,1923,21,1389441726,1389442296,1,11,570
20544648@N06,1924,21,1389567545,1389567575,2,7,30
20544648@N06,1924,29,1389567575,1389567579,2,7,4
20544648@N06,1924,15,1389567579,1389567583,2,7,4
20544648@N06,1924,26,1389567583,1389567586,2,7,3
20544648@N06,1924,15,1389567586,1389567590,2,7,4
20544648@N06,1924,29,1389567590,1389567593,2,7,3
20544648@N06,1924,12,1389567593,1389567833,1,7,240
20558299@N07,1925,1,1447302070,1447302130,4,7,60
20558299@N07,1925,28,1447303150,1447304050,2,7,900
20558299@N07,1925,27,1447310632,1447311532,3,7,900
20558299@N07,1925,30,1447312492,1447313572,3,7,1080
20558299@N07,1925,26,1447315299,1447316199,2,7,900
20558299@N07,1925,7,1447319012,1447319192,2,7,180
20558299@N07,1925,28,1447322033,1447322933,1,7,900
20558299@N07,1926,1,1447506829,1447506889,1,1,60
20558299@N07,1927,7,1447544305,1447544410,2,2,105
20558299@N07,1927,26,1447544410,1447545310,1,2,900
20624969@N06,1928,28,1315370207,1315371107,7,5,900
20624969@N06,1928,24,1315377317,1315377427,2,5,110
20624969@N06,1928,15,1315377427,1315377697,2,5,270
20624969@N06,1928,29,1315381752,1315382652,3,5,900
20624969@N06,1928,30,1315386257,1315387337,1,5,1080
20635459@N00,1929,26,1366325549,1366326449,1,1,900
20635459@N00,1930,1,1366499276,1366499336,1,1,60
20642429@N00,1931,13,1332830994,1332831234,1,1,240
20733134@N08,1932,22,1286180130,1286180730,1,1,600
20818329@N06,1933,28,1241840960,1241841860,4,2,900
20818329@N06,1933,21,1241848919,1241849489,6,2,570
20826856@N04,1934,1,1377826287,1377826347,2,2,60
20826856@N04,1934,24,1377826589,1377827369,1,2,780
20826856@N04,1935,1,1392596367,1392596427,1,1,60
20953529@N03,1936,17,1306301315,1306301615,1,1,300
20953529@N03,1937,28,1306443817,1306444717,1,1,900
20955720@N00,1938,17,1297552183,1297552331,2,4,148
20955720@N00,1938,15,1297552331,1297552601,2,4,270
20955720@N00,1938,16,1297552873,1297553143,3,4,270
20955720@N00,1938,25,1297557557,1297558397,2,4,840
20955720@N00,1939,26,1307837658,1307838558,1,1,900
20955720@N00,1940,28,1309062324,1309063224,3,1,900
21035134@N07,1941,28,1311387528,1311388428,58,1,900
21039548@N03,1942,30,1302079685,1302080765,1,1,1080
21039548@N03,1943,29,1302230028,1302230928,1,1,900
21045988@N07,1944,26,1350614285,1350615185,1,1,900
21068473@N06,1945,16,1436450797,1436451067,1,1,270
21073818@N00,1946,26,1372738604,1372739504,2,2,900
21073818@N00,1946,1,1372749726,1372749786,1,2,60
21077668@N06,1947,24,1429401370,1429401706,2,3,336
21077668@N06,1947,26,1429401706,1429401925,2,3,219
21077668@N06,1947,31,1429401925,1429403425,1,3,1500
21077668@N06,1948,24,1429444747,1429445527,3,1,780
21124913@N00,1949,30,1452918579,1452919659,1,1,1080
21125890@N00,1950,28,1344234235,1344235135,1,1,900
21138471@N00,1951,24,1221787149,1221787929,3,5,780
21138471@N00,1951,29,1221794440,1221795340,3,5,900
21138471@N00,1951,26,1221796449,1221797349,2,5,900
21138471@N00,1951,28,1221801024,1221801924,2,5,900
21138471@N00,1951,24,1221802632,1221803412,1,5,780
21186435@N00,1952,26,1190019815,1190020715,1,1,900
21228638@N00,1953,1,1220246148,1220246208,1,1,60
21228638@N00,1954,3,1224240443,1224240533,2,1,90
21228638@N00,1955,28,1226916868,1226917193,2,2,325
21228638@N00,1955,1,1226917193,1226917253,1,2,60
21242794@N08,1956,28,1238911570,1238912470,2,3,900
21242794@N08,1956,13,1238915662,1238915902,2,3,240
21242794@N08,1956,22,1238925966,1238926566,4,3,600
21276195@N08,1957,20,1201659956,1201660496,1,1,540
21313533@N02,1958,20,1355456450,1355456990,1,1,540
21313533@N02,1959,16,1402553072,1402553183,2,2,111
21313533@N02,1959,26,1402553183,1402554083,2,2,900
21313533@N02,1960,30,1414297825,1414298905,2,2,1080
21313533@N02,1960,4,1414316488,1414316589,1,2,101
21313533@N02,1961,29,1416140700,1416141600,1,1,900
21313533@N02,1962,19,1416708452,1416708992,1,1,540
21313533@N02,1963,26,1433160584,1433161484,1,1,900
21327522@N04,1964,28,1196179627,1196180527,21,1,900
21327522@N04,1965,28,1200499477,1200500377,4,1,900
21327522@N04,1966,28,1200698682,1200699582,3,1,900
21327522@N04,1967,28,1233028831,1233029731,1,1,900
21327522@N04,1968,26,1247140863,1247141763,8,3,900
21327522@N04,1968,25,1247149563,1247150403,8,3,840
21327522@N04,1968,26,1247167551,1247168451,2,3,900
21340539@N05,1969,29,1425609817,1425610717,2,2,900
21340539@N05,1969,16,1425612302,1425612572,1,2,270
21358387@N02,1970,3,1323491016,1323491106,2,3,90
21358387@N02,1970,13,1323492099,1323492339,2,3,240
21358387@N02,1970,28,1323503713,1323504613,1,3,900
21361610@N00,1971,28,1312838969,1312839869,1,1,900
21392083@N05,1972,7,1436590328,1436590508,2,1,180
21392573@N02,1973,1,1196826820,1196826880,4,12,60
21392573@N02,1973,28,1196826920,1196827226,10,12,306
21392573@N02,1973,18,1196827226,1196827346,4,12,120
21392573@N02,1973,26,1196827346,1196827353,2,12,7
21392573@N02,1973,12,1196827353,1196827389,2,12,36
21392573@N02,1973,26,1196827389,1196827837,2,12,448
21392573@N02,1973,29,1196827837,1196828737,20,12,900
21392573@N02,1973,30,1196836126,1196837206,3,12,1080
21392573@N02,1973,12,1196837877,1196838117,3,12,240
21392573@N02,1973,25,1196842092,1196842932,14,12,840
21392573@N02,1973,26,1196844092,1196844992,4,12,900
21392573@N02,1973,28,1196846638,1196847538,5,12,900
21393146@N07,1974,19,1269826607,1269827147,2,3,540
21393146@N07,1974,23,1269827366,1269827966,2,3,600
21393146@N07,1974,22,1269832735,1269833335,1,3,600
21394157@N04,1975,6,1270172767,1270172887,2,3,120
21394157@N04,1975,7,1270178901,1270179081,2,3,180
21394157@N04,1975,15,1270198032,1270198302,2,3,270
21407390@N00,1976,16,1287562821,1287563091,1,1,270
21407390@N00,1977,31,1376708650,1376710150,2,2,1500
21407390@N00,1977,23,1376720484,1376721084,1,2,600
21419770@N07,1978,16,1255831360,1255831630,1,1,270
21419770@N07,1979,1,1256605589,1256605649,2,3,60
21419770@N07,1979,30,1256610211,1256611291,2,3,1080
21419770@N07,1979,28,1256614514,1256615414,1,3,900
21435190@N00,1980,26,1296344878,1296345778,10,1,900
21435190@N00,1981,26,1296524383,1296525283,17,1,900
21447068@N04,1982,1,1343206986,1343207046,1,1,60
21450435@N05,1983,26,1297392003,1297392177,2,5,174
21450435@N05,1983,6,1297392177,1297392187,2,5,10
21450435@N05,1983,8,1297392187,1297392355,3,5,168
21450435@N05,1983,21,1297392355,1297392925,3,5,570
21450435@N05,1983,29,1297398112,1297399012,2,5,900
21502601@N06,1984,29,1196937955,1196938855,6,1,900
21502601@N06,1985,29,1197019172,1197020072,8,1,900
21502601@N06,1986,29,1197118523,1197119423,2,1,900
21502601@N06,1987,29,1197277008,1197277908,4,1,900
21502601@N06,1988,29,1197380940,1197381840,1,1,900
21502601@N06,1989,29,1197459838,1197460738,1,1,900
21522703@N00,1990,25,1347666424,1347667264,1,1,840
21532305@N05,1991,18,1432779740,1432780190,2,3,450
21532305@N05,1991,29,1432784103,1432785003,3,3,900
21532305@N05,1991,18,1432799083,1432799533,1,3,450
21532305@N05,1992,18,1432855427,1432855877,1,1,450
21533607@N03,1993,25,1273824120,1273824318,2,3,198
21533607@N03,1993,24,1273824318,1273824771,2,3,453
21533607@N03,1993,13,1273824771,1273825011,1,3,240
21534233@N00,1994,18,1272156513,1272156963,2,5,450
21534233@N00,1994,26,1272160017,1272160274,2,5,257
21534233@N00,1994,31,1272160274,1272160466,2,5,192
21534233@N00,1994,29,1272160466,1272161366,2,5,900
21534233@N00,1994,26,1272166312,1272167212,1,5,900
21541710@N00,1995,3,1213487431,1213487521,4,4,90
21541710@N00,1995,4,1213488686,1213488787,2,4,101
21541710@N00,1995,11,1213488846,1213489086,7,4,240
21541710@N00,1995,29,1213493898,1213494798,8,4,900
21541710@N00,1996,29,1213619980,1213620880,2,1,900
21541710@N00,1997,17,1214015765,1214016065,2,1,300
21541710@N00,1998,28,1229743480,1229743892,2,3,412
21541710@N00,1998,26,1229743892,1229744792,3,3,900
21541710@N00,1998,21,1229746477,1229747047,1,3,570
21541710@N00,1999,30,1235016967,1235018047,1,1,1080
21591624@N00,2000,24,1373424520,1373425300,4,3,780
21591624@N00,2000,8,1373447748,1373447928,37,3,180
21591624@N00,2000,11,1373453359,1373453599,21,3,240
21597019@N06,2001,28,1200014706,1200015606,1,1,900
21597019@N06,2002,28,1202176377,1202177277,3,1,900
21597019@N06,2003,28,1210313324,1210314224,4,1,900
21597019@N06,2004,28,1212651742,1212652642,1,1,900
21597019@N06,2005,28,1225060607,1225061507,7,1,900
21597019@N06,2006,28,1230948535,1230949435,4,1,900
21597019@N06,2007,28,1233877960,1233878860,7,1,900
21597019@N06,2008,28,1238886581,1238887481,3,1,900
21597019@N06,2009,28,1243123010,1243123910,7,1,900
21597019@N06,2010,28,1245537989,1245538889,7,1,900
21597019@N06,2011,28,1249688433,1249689333,9,1,900
21615035@N08,2012,1,1366543295,1366543355,1,1,60
21632110@N06,2013,1,1379201328,1379201388,13,3,60
21632110@N06,2013,25,1379207314,1379208154,4,3,840
21632110@N06,2013,29,1379210498,1379211398,1,3,900
21646564@N04,2014,18,1439803232,1439803682,1,1,450
21647199@N03,2015,14,1302927021,1302927261,2,2,240
21647199@N03,2015,5,1302932174,1302932294,2,2,120
21675646@N04,2016,26,1224719891,1224720791,58,1,900
21681738@N03,2017,13,1309222699,1309222939,2,4,240
21681738@N03,2017,26,1309231207,1309232107,2,4,900
21681738@N03,2017,15,1309233027,1309233297,2,4,270
21681738@N03,2017,1,1309233538,1309233598,1,4,60
21739162@N04,2018,26,1195335777,1195336677,13,1,900
21739162@N04,2019,1,1240970195,1240970255,2,12,60
21739162@N04,2019,28,1240971265,1240972165,2,12,900
21739162@N04,2019,27,1240973461,1240974361,2,12,900
21739162@N04,2019,17,1240974781,1240975081,2,12,300
21739162@N04,2019,26,1240978005,1240978835,7,12,830
21739162@N04,2019,7,1240978835,1240979004,4,12,169
21739162@N04,2019,21,1240979004,1240979574,3,12,570
21739162@N04,2019,4,1240980348,1240980366,2,12,18
21739162@N04,2019,11,1240980366,1240980470,3,12,104
21739162@N04,2019,4,1240980470,1240980520,3,12,50
21739162@N04,2019,21,1240980520,1240981090,2,12,570
21739162@N04,2019,25,1240981294,1240982134,1,12,840
21739162@N04,2020,1,1255047483,1255047543,4,10,60
21739162@N04,2020,16,1255063888,1255064158,2,10,270
21739162@N04,2020,27,1255064159,1255065059,5,10,900
21739162@N04,2020,16,1255065444,1255065714,2,10,270
21739162@N04,2020,26,1255065905,1255066791,3,10,886
21739162@N04,2020,9,1255066791,1255066971,2,10,180
21739162@N04,2020,11,1255067235,1255067475,2,10,240
21739162@N04,2020,28,1255071568,1255072468,2,10,900
21739162@N04,2020,26,1255076865,1255077765,2,10,900
21739162@N04,2020,28,1255087360,1255088260,2,10,900
21743740@N03,2021,29,1417167047,1417167947,1,1,900
21743740@N03,2022,8,1440154613,1440154793,1,1,180
21745344@N04,2023,26,1260273447,1260274347,1,1,900
21747974@N04,2024,28,1345591591,1345592491,1,1,900
21748548@N00,2025,1,1280127806,1280127866,2,12,60
21748548@N00,2025,27,1280128341,1280129241,2,12,900
21748548@N00,2025,17,1280129630,1280129642,2,12,12
21748548@N00,2025,27,1280129642,1280130542,12,12,900
21748548@N00,2025,17,1280130615,1280130824,2,12,209
21748548@N00,2025,30,1280130824,1280131904,2,12,1080
21748548@N00,2025,8,1280134690,1280134782,2,12,92
21748548@N00,2025,26,1280134782,1280135575,2,12,793
21748548@N00,2025,21,1280135575,1280136118,3,12,543
21748548@N00,2025,30,1280136118,1280137198,2,12,1080
21748548@N00,2025,16,1280141737,1280142007,2,12,270
21748548@N00,2025,28,1280144093,1280144993,6,12,900
21748548@N00,2026,26,1280183857,1280184757,4,2,900
21748548@N00,2026,19,1280188532,1280189072,3,2,540
21748548@N00,2027,24,1280269955,1280270735,4,19,780
21748548@N00,2027,15,1280272346,1280272616,3,19,270
21748548@N00,2027,19,1280275118,1280275312,2,19,194
21748548@N00,2027,20,1280275312,1280275852,2,19,540
21748548@N00,2027,17,1280277723,1280278023,4,19,300
21748548@N00,2027,15,1280278784,1280278897,2,19,113
21748548@N00,2027,24,1280278897,1280279677,7,19,780
21748548@N00,2027,29,1280280080,1280280980,5,19,900
21748548@N00,2027,22,1280283767,1280284367,3,19,600
21748548@N00,2027,31,1280284806,1280285216,2,19,410
21748548@N00,2027,22,1280285216,1280285816,3,19,600
21748548@N00,2027,14,1280287623,1280287863,3,19,240
21748548@N00,2027,29,1280288766,1280289463,4,19,697
21748548@N00,2027,30,1280289463,1280290543,2,19,1080
21748548@N00,2027,13,1280294991,1280295231,3,19,240
21748548@N00,2027,14,1280298086,1280298326,5,19,240
21748548@N00,2027,23,1280300357,1280300957,2,19,600
21748548@N00,2027,15,1280306478,1280306748,2,19,270
21748548@N00,2027,29,1280315418,1280316318,9,19,900
21748548@N00,2028,28,1280351394,1280351588,2,19,194
21748548@N00,2028,26,1280351588,1280352488,2,19,900
21748548@N00,2028,4,1280353376,1280353453,2,19,77
21748548@N00,2028,5,1280353453,1280353573,2,19,120
21748548@N00,2028,3,1280354908,1280354998,2,19,90
21748548@N00,2028,4,1280355962,1280356013,2,19,51
21748548@N00,2028,11,1280356013,1280356119,2,19,106
21748548@N00,2028,21,1280356119,1280356689,3,19,570
21748548@N00,2028,28,1280375046,1280375946,2,19,900
21748548@N00,2028,23,1280376053,1280376653,2,19,600
21748548@N00,2028,26,1280377254,1280378154,2,19,900
21748548@N00,2028,30,1280379331,1280380104,4,19,773
21748548@N00,2028,23,1280380104,1280380704,2,19,600
21748548@N00,2028,30,1280380783,1280380797,2,19,14
21748548@N00,2028,23,1280380797,1280381397,2,19,600
21748548@N00,2028,29,1280384755,1280385165,2,19,410
21748548@N00,2028,30,1280385165,1280386245,3,19,1080
21748548@N00,2028,31,1280386728,1280388228,2,19,1500
21748548@N00,2028,1,1280398775,1280398835,1,19,60
21748548@N00,2029,16,1280443032,1280443302,2,4,270
21748548@N00,2029,28,1280446739,1280447639,2,4,900
21748548@N00,2029,29,1280450295,1280451195,4,4,900
21748548@N00,2029,23,1280453531,1280454131,1,4,600
21748548@N00,2030,30,1280565234,1280566314,8,1,1080
21748548@N00,2031,7,1301956274,1301956454,2,6,180
21748548@N00,2031,16,1301960741,1301961011,2,6,270
21748548@N00,2031,15,1301967740,1301968010,2,6,270
21748548@N00,2031,18,1301990575,1301990597,2,6,22
21748548@N00,2031,23,1301990597,1301991197,2,6,600
21748548@N00,2031,17,1301992689,1301992989,1,6,300
21748548@N00,2032,24,1302042840,1302043620,1,1,780
21748548@N00,2033,26,1313968517,1313969113,11,24,596
21748548@N00,2033,28,1313969113,1313969265,2,24,152
21748548@N00,2033,26,1313969265,1313970165,22,24,900
21748548@N00,2033,7,1313971405,1313971413,5,24,8
21748548@N00,2033,5,1313971413,1313971533,7,24,120
21748548@N00,2033,26,1313971558,1313972458,5,24,900
21748548@N00,2033,30,1313973201,1313973945,5,24,744
21748548@N00,2033,29,1313973945,1313973952,3,24,7
21748548@N00,2033,10,1313973952,1313974009,2,24,57
21748548@N00,2033,30,1313974009,1313974024,2,24,15
21748548@N00,2033,31,1313974024,1313974882,3,24,858
21748548@N00,2033,26,1313974882,1313975128,5,24,246
21748548@N00,2033,14,1313975128,1313975167,3,24,39
21748548@N00,2033,22,1313975167,1313975449,3,24,282
21748548@N00,2033,26,1313975449,1313976349,5,24,900
21748548@N00,2033,22,1313976476,1313977076,8,24,600
21748548@N00,2033,30,1313980718,1313980728,3,24,10
21748548@N00,2033,26,1313980728,1313980785,3,24,57
21748548@N00,2033,6,1313980785,1313980905,2,24,120
21748548@N00,2033,25,1313981170,1313982010,3,24,840
21748548@N00,2033,1,1313986320,1313986380,3,24,60
21748548@N00,2033,27,1313990298,1313990495,3,24,197
21748548@N00,2033,16,1313990495,1313990765,3,24,270
21748548@N00,2033,28,1313992818,1313993718,2,24,900
21748548@N00,2034,16,1376042064,1376042334,1,1,270
21748548@N00,2035,1,1376219634,1376219694,1,1,60
21748548@N00,2036,4,1376260309,1376260410,1,1,101
21748548@N00,2037,16,1376537183,1376537453,1,1,270
21756137@N00,2038,18,1387778621,1387779071,2,2,450
21756137@N00,2038,27,1387792668,1387793568,1,2,900
21757303@N06,2039,13,1233296752,1233296753,2,3,1
21757303@N06,2039,26,1233296753,1233296755,3,3,2
21757303@N06,2039,29,1233296755,1233297655,1,3,900
21757303@N06,2040,13,1233817845,1233818085,1,1,240
21760961@N08,2041,26,1197678370,1197679270,44,1,900
21778462@N04,2042,17,1399501863,1399501959,2,2,96
21778462@N04,2042,1,1399501959,1399502019,1,2,60
21778462@N04,2043,1,1400721208,1400721268,1,1,60
21857090@N08,2044,14,1189348871,1189349111,1,1,240
21897757@N00,2045,27,1191715171,1191716071,3,5,900
21897757@N00,2045,3,1191716269,1191716359,2,5,90
21897757@N00,2045,12,1191716954,1191717194,2,5,240
21897757@N00,2045,26,1191725659,1191726559,2,5,900
21897757@N00,2045,3,1191734365,1191734455,1,5,90
21897757@N00,2046,28,1226099181,1226099336,3,23,155
21897757@N00,2046,26,1226099336,1226099607,2,23,271
21897757@N00,2046,29,1226099607,1226100507,6,23,900
21897757@N00,2046,20,1226102128,1226102668,7,23,540
21897757@N00,2046,22,1226103675,1226104275,3,23,600
21897757@N00,2046,10,1226105068,1226105308,4,23,240
21897757@N00,2046,7,1226105894,1226106074,5,23,180
21897757@N00,2046,26,1226106122,1226107022,2,23,900
21897757@N00,2046,3,1226107161,1226107251,5,23,90
21897757@N00,2046,13,1226108196,1226108436,3,23,240
21897757@N00,2046,4,1226110798,1226110899,4,23,101
21897757@N00,2046,13,1226111293,1226111533,20,23,240
21897757@N00,2046,15,1226120384,1226120654,2,23,270
21897757@N00,2046,27,1226120662,1226120984,2,23,322
21897757@N00,2046,16,1226120984,1226121254,3,23,270
21897757@N00,2046,6,1226123932,1226124052,2,23,120
21897757@N00,2046,28,1226124671,1226125571,2,23,900
21897757@N00,2046,20,1226142091,1226142631,4,23,540
21897757@N00,2046,29,1226145758,1226146004,2,23,246
21897757@N00,2046,26,1226146004,1226146169,2,23,165
21897757@N00,2046,7,1226146169,1226146219,2,23,50
21897757@N00,2046,3,1226146219,1226146309,2,23,90
21897757@N00,2046,1,1226147046,1226147106,1,23,60
21897757@N00,2047,28,1226187451,1226187859,6,25,408
21897757@N00,2047,23,1226187859,1226188459,2,25,600
21897757@N00,2047,12,1226188562,1226188802,3,25,240
21897757@N00,2047,26,1226189622,1226189853,4,25,231
21897757@N00,2047,18,1226189853,1226189866,2,25,13
21897757@N00,2047,23,1226189866,1226189976,2,25,110
21897757@N00,2047,18,1226189976,1226190426,5,25,450
21897757@N00,2047,19,1226191206,1226191746,6,25,540
21897757@N00,2047,29,1226192233,1226192767,3,25,534
21897757@N00,2047,10,1226192767,1226193007,4,25,240
21897757@N00,2047,30,1226193560,1226194512,5,25,952
21897757@N00,2047,26,1226194512,1226195412,14,25,900
21897757@N00,2047,31,1226198183,1226199170,4,25,987
21897757@N00,2047,30,1226199170,1226199222,2,25,52
21897757@N00,2047,31,1226199222,1226200722,4,25,1500
21897757@N00,2047,22,1226201398,1226201998,2,25,600
21897757@N00,2047,30,1226205861,1226206092,2,25,231
21897757@N00,2047,19,1226206092,1226206632,3,25,540
21897757@N00,2047,10,1226206814,1226207054,2,25,240
21897757@N00,2047,18,1226208139,1226208589,2,25,450
21897757@N00,2047,28,1226209396,1226210296,2,25,900
21897757@N00,2047,3,1226216770,1226216860,5,25,90
21897757@N00,2047,6,1226218163,1226218283,2,25,120
21897757@N00,2047,18,1226219066,1226219516,2,25,450
21897757@N00,2047,29,1226226358,1226227258,2,25,900
21897757@N00,2048,16,1226823618,1226823888,1,1,270
21897757@N00,2049,18,1241310900,1241311140,2,11,240
21897757@N00,2049,26,1241311140,1241311320,2,11,180
21897757@N00,2049,23,1241311320,1241311920,2,11,600
21897757@N00,2049,19,1241311971,1241312400,4,11,429
21897757@N00,2049,18,1241312400,1241312520,2,11,120
21897757@N00,2049,19,1241312520,1241313060,4,11,540
21897757@N00,2049,29,1241313391,1241313870,2,11,479
21897757@N00,2049,22,1241313870,1241314470,3,11,600
21897757@N00,2049,26,1241315066,1241315966,3,11,900
21897757@N00,2049,29,1241322855,1241323755,2,11,900
21897757@N00,2049,3,1241334644,1241334734,1,11,90
21897757@N00,2050,17,1265330812,1265331112,1,1,300
21897757@N00,2051,10,1265619586,1265619826,2,2,240
21897757@N00,2051,16,1265624422,1265624692,1,2,270
21897757@N00,2052,3,1284511970,1284512060,2,3,90
21897757@N00,2052,10,1284513659,1284513899,2,3,240
21897757@N00,2052,26,1284519063,1284519963,1,3,900
21897757@N00,2053,20,1285060943,1285061483,2,2,540
21897757@N00,2053,6,1285064053,1285064173,1,2,120
21897757@N00,2054,29,1298782566,1298783466,1,1,900
21897757@N00,2055,26,1317259450,1317260350,2,2,900
21897757@N00,2055,29,1317261653,1317262553,1,2,900
21897757@N00,2056,28,1320539786,1320540686,1,1,900
21897757@N00,2057,26,1327540720,1327541620,1,1,900
21897757@N00,2058,20,1349664388,1349664928,1,1,540
21897757@N00,2059,26,1355866327,1355867227,2,2,900
21897757@N00,2059,29,1355873013,1355873913,1,2,900
21897757@N00,2060,28,1359958381,1359958553,2,2,172
21897757@N00,2060,5,1359958553,1359958673,1,2,120
21899239@N04,2061,26,1443495388,1443496288,3,13,900
21899239@N04,2061,6,1443497498,1443497618,3,13,120
21899239@N04,2061,7,1443499012,1443499111,3,13,99
21899239@N04,2061,9,1443499111,1443499291,2,13,180
21899239@N04,2061,4,1443500158,1443500259,5,13,101
21899239@N04,2061,15,1443501745,1443502015,2,13,270
21899239@N04,2061,21,1443505295,1443505626,3,13,331
21899239@N04,2061,11,1443505626,1443505866,5,13,240
21899239@N04,2061,23,1443506960,1443507560,2,13,600
21899239@N04,2061,20,1443508133,1443508673,2,13,540
21899239@N04,2061,29,1443510065,1443510965,3,13,900
21899239@N04,2061,16,1443512481,1443512751,3,13,270
21899239@N04,2061,28,1443521751,1443522651,7,13,900
21945198@N05,2062,16,1204028079,1204028349,1,1,270
21978095@N03,2063,23,1440316018,1440316618,1,1,600
21978095@N03,2064,23,1440591653,1440592253,1,1,600
21978095@N03,2065,23,1441077927,1441078527,1,1,600
21978095@N03,2066,18,1441865292,1441865742,1,1,450
21978095@N03,2067,23,1442992542,1442993142,2,1,600
21978095@N03,2068,18,1443591674,1443592124,1,1,450
21978095@N03,2069,18,1443926545,1443926995,1,1,450
21978095@N03,2070,18,1450093087,1450093537,1,1,450
21978095@N03,2071,18,1451897516,1451897966,1,1,450
21978095@N03,2072,18,1454143523,1454143973,1,1,450
21978095@N03,2073,18,1454306330,1454306780,1,1,450
21978095@N03,2074,18,1454832250,1454832700,1,1,450
21981021@N03,2075,10,1242606098,1242606338,19,1,240
21997370@N00,2076,1,1376756266,1376756326,1,1,60
21997370@N00,2077,12,1376795191,1376795431,1,1,240
22005296@N07,2078,10,1284292223,1284292463,1,1,240
22026393@N00,2079,26,1280320531,1280321431,1,1,900
22026393@N00,2080,25,1375181234,1375182074,1,1,840
22090021@N07,2081,15,1331264268,1331264538,1,1,270
22117934@N05,2082,1,1375670855,1375670915,1,1,60
22174377@N05,2083,16,1212300582,1212300852,1,1,270
22191840@N00,2084,14,1211848811,1211849051,9,20,240
22191840@N00,2084,16,1211851185,1211851289,4,20,104
22191840@N00,2084,14,1211851289,1211851529,95,20,240
22191840@N00,2084,27,1211862112,1211862327,2,20,215
22191840@N00,2084,16,1211862327,1211862597,36,20,270
22191840@N00,2084,26,1211868049,1211868949,7,20,900
22191840@N00,2084,29,1211872269,1211873169,36,20,900
22191840@N00,2084,17,1211876711,1211877011,10,20,300
22191840@N00,2084,14,1211877416,1211877503,2,20,87
22191840@N00,2084,22,1211877503,1211878015,3,20,512
22191840@N00,2084,18,1211878015,1211878465,30,20,450
22191840@N00,2084,29,1211881015,1211881021,2,20,6
22191840@N00,2084,19,1211881021,1211881561,6,20,540
22191840@N00,2084,16,1211883025,1211883295,3,20,270
22191840@N00,2084,19,1211883350,1211883890,5,20,540
22191840@N00,2084,26,1211886614,1211887514,3,20,900
22191840@N00,2084,27,1211888234,1211888773,3,20,539
22191840@N00,2084,26,1211888773,1211889155,4,20,382
22191840@N00,2084,6,1211889155,1211889275,17,20,120
22191840@N00,2084,3,1211890257,1211890347,3,20,90
22191840@N00,2085,17,1243466509,1243466809,4,35,300
22191840@N00,2085,15,1243467228,1243467299,2,35,71
22191840@N00,2085,24,1243467299,1243467772,2,35,473
22191840@N00,2085,12,1243467772,1243468012,2,35,240
22191840@N00,2085,3,1243468061,1243468151,6,35,90
22191840@N00,2085,21,1243468426,1243468469,3,35,43
22191840@N00,2085,4,1243468469,1243468509,2,35,40
22191840@N00,2085,5,1243468509,1243468587,2,35,78
22191840@N00,2085,11,1243468587,1243468653,2,35,66
22191840@N00,2085,7,1243468653,1243468672,4,35,19
22191840@N00,2085,5,1243468672,1243468792,3,35,120
22191840@N00,2085,6,1243469313,1243469433,7,35,120
22191840@N00,2085,3,1243469715,1243469805,2,35,90
22191840@N00,2085,7,1243470218,1243470289,2,35,71
22191840@N00,2085,26,1243470289,1243471028,14,35,739
22191840@N00,2085,30,1243471028,1243471328,2,35,300
22191840@N00,2085,22,1243471328,1243471928,4,35,600
22191840@N00,2085,14,1243472368,1243472608,12,35,240
22191840@N00,2085,20,1243474021,1243474561,38,35,540
22191840@N00,2085,29,1243476429,1243477329,49,35,900
22191840@N00,2085,18,1243478835,1243479070,2,35,235
22191840@N00,2085,26,1243479070,1243479970,3,35,900
22191840@N00,2085,16,1243480728,1243480829,2,35,101
22191840@N00,2085,26,1243480829,1243481093,5,35,264
22191840@N00,2085,23,1243481093,1243481693,2,35,600
22191840@N00,2085,19,1243482526,1243482828,6,35,302
22191840@N00,2085,20,1243482828,1243482968,2,35,140
22191840@N00,2085,19,1243482968,1243483181,4,35,213
22191840@N00,2085,18,1243483181,1243483631,2,35,450
22191840@N00,2085,26,1243484465,1243485365,4,35,900
22191840@N00,2085,15,1243501989,1243502259,2,35,270
22191840@N00,2085,24,1243502676,1243503456,6,35,780
22191840@N00,2085,12,1243503765,1243504005,3,35,240
22191840@N00,2085,13,1243504552,1243504792,14,35,240
22191840@N00,2085,8,1243507587,1243507767,1,35,180
22191840@N00,2086,13,1301025462,1301025702,16,10,240
22191840@N00,2086,4,1301028916,1301028989,8,10,73
22191840@N00,2086,11,1301028989,1301029201,4,10,212
22191840@N00,2086,21,1301029201,1301029771,2,10,570
22191840@N00,2086,26,1301031048,1301031948,3,10,900
22191840@N00,2086,16,1301032583,1301032853,2,10,270
22191840@N00,2086,27,1301046535,1301047435,5,10,900
22191840@N00,2086,26,1301052774,1301052937,2,10,163
22191840@N00,2086,23,1301052937,1301053537,2,10,600
22191840@N00,2086,1,1301054500,1301054560,1,10,60
22191840@N00,2087,27,1309133081,1309133581,5,21,500
22191840@N00,2087,15,1309133581,1309133851,12,21,270
22191840@N00,2087,12,1309135215,1309135390,2,21,175
22191840@N00,2087,26,1309135390,1309136290,2,21,900
22191840@N00,2087,14,1309139042,1309139282,8,21,240
22191840@N00,2087,22,1309140209,1309140809,2,21,600
22191840@N00,2087,29,1309141205,1309141880,2,21,675
22191840@N00,2087,31,1309141880,1309142442,14,21,562
22191840@N00,2087,30,1309142442,1309142886,2,21,444
22191840@N00,2087,31,1309142886,1309143266,2,21,380
22191840@N00,2087,22,1309143266,1309143675,2,21,409
22191840@N00,2087,31,1309143675,1309144878,2,21,1203
22191840@N00,2087,19,1309144878,1309145418,3,21,540
22191840@N00,2087,18,1309145492,1309145942,11,21,450
22191840@N00,2087,17,1309149937,1309150047,7,21,110
22191840@N00,2087,27,1309150047,1309150947,2,21,900
22191840@N00,2087,15,1309163326,1309163596,5,21,270
22191840@N00,2087,17,1309165027,1309165327,4,21,300
22191840@N00,2087,20,1309173016,1309173556,56,21,540
22191840@N00,2087,23,1309175034,1309175634,5,21,600
22191840@N00,2087,3,1309175853,1309175943,2,21,90
22191840@N00,2088,13,1321830629,1321830869,19,16,240
22191840@N00,2088,16,1321836713,1321836983,6,16,270
22191840@N00,2088,15,1321839135,1321839405,6,16,270
22191840@N00,2088,1,1321839469,1321839529,16,16,60
22191840@N00,2088,15,1321840948,1321841017,4,16,69
22191840@N00,2088,1,1321841017,1321841077,12,16,60
22191840@N00,2088,29,1321841602,1321841816,2,16,214
22191840@N00,2088,20,1321841816,1321841946,4,16,130
22191840@N00,2088,31,1321841946,1321842111,2,16,165
22191840@N00,2088,22,1321842111,1321842711,6,16,600
22191840@N00,2088,14,1321844794,1321845034,8,16,240
22191840@N00,2088,29,1321848468,1321849368,5,16,900
22191840@N00,2088,14,1321858113,1321858353,18,16,240
22191840@N00,2088,20,1321859816,1321860356,66,16,540
22191840@N00,2088,26,1321862343,1321863243,5,16,900
22191840@N00,2088,25,1321863249,1321864089,3,16,840
22191840@N00,2089,28,1321910829,1321911611,3,20,782
22191840@N00,2089,26,1321911611,1321912455,4,20,844
22191840@N00,2089,3,1321912455,1321912545,3,20,90
22191840@N00,2089,5,1321913453,1321913573,3,20,120
22191840@N00,2089,3,1321913603,1321913693,2,20,90
22191840@N00,2089,30,1321915311,1321915357,2,20,46
22191840@N00,2089,29,1321915357,1321915425,3,20,68
22191840@N00,2089,31,1321915425,1321915532,3,20,107
22191840@N00,2089,22,1321915532,1321915900,6,20,368
22191840@N00,2089,31,1321915900,1321916874,6,20,974
22191840@N00,2089,29,1321916874,1321917774,14,20,900
22191840@N00,2089,14,1321917998,1321918238,33,20,240
22191840@N00,2089,19,1321920591,1321921131,14,20,540
22191840@N00,2089,18,1321922971,1321923421,10,20,450
22191840@N00,2089,1,1321925492,1321925552,43,20,60
22191840@N00,2089,14,1321947101,1321947341,13,20,240
22191840@N00,2089,22,1321947520,1321948120,2,20,600
22191840@N00,2089,6,1321948730,1321948850,28,20,120
22191840@N00,2089,3,1321950793,1321950883,3,20,90
22191840@N00,2089,29,1321955322,1321956222,104,20,900
22191840@N00,2090,28,1332718236,1332719136,2,21,900
22191840@N00,2090,24,1332720200,1332720980,39,21,780
22191840@N00,2090,16,1332722979,1332723249,6,21,270
22191840@N00,2090,27,1332724009,1332724066,2,21,57
22191840@N00,2090,16,1332724066,1332724336,5,21,270
22191840@N00,2090,27,1332724385,1332724398,2,21,13
22191840@N00,2090,16,1332724398,1332724420,2,21,22
22191840@N00,2090,27,1332724420,1332724536,6,21,116
22191840@N00,2090,16,1332724536,1332724561,2,21,25
22191840@N00,2090,27,1332724561,1332725461,7,21,900
22191840@N00,2090,16,1332725866,1332726136,5,21,270
22191840@N00,2090,19,1332727362,1332727902,2,21,540
22191840@N00,2090,20,1332730959,1332731499,51,21,540
22191840@N00,2090,23,1332739315,1332739915,2,21,600
22191840@N00,2090,30,1332743856,1332744936,3,21,1080
22191840@N00,2090,20,1332746651,1332747191,2,21,540
22191840@N00,2090,25,1332747206,1332747733,2,21,527
22191840@N00,2090,17,1332747733,1332748033,17,21,300
22191840@N00,2090,24,1332752866,1332753646,7,21,780
22191840@N00,2090,29,1332760553,1332761453,8,21,900
22191840@N00,2090,20,1332763184,1332763724,5,21,540
22191840@N00,2091,22,1416562404,1416563004,1,1,600
22191840@N00,2092,16,1416742389,1416742659,1,1,270
22198509@N03,2093,26,1298157507,1298158407,2,2,900
22198509@N03,2093,13,1298164316,1298164556,2,2,240
22198509@N03,2094,28,1298194235,1298195135,1,1,900
22198509@N03,2095,16,1298252543,1298252795,2,2,252
22198509@N03,2095,28,1298252795,1298253695,3,2,900
22201281@N08,2096,10,1314264789,1314264874,15,2,85
22201281@N08,2096,28,1314264874,1314265774,6,2,900
22201281@N08,2097,12,1314445706,1314445946,44,1,240
22213891@N03,2098,26,1299411927,1299412827,1,1,900
22213891@N03,2099,26,1316256505,1316257405,1,1,900
22224184@N00,2100,1,1395820594,1395820654,3,1,60
22232518@N05,2101,8,1196427600,1196427600,2,10,0
22232518@N05,2101,16,1196427600,1196427600,2,10,0
22232518@N05,2101,17,1196427600,1196427600,2,10,0
22232518@N05,2101,20,1196427600,1196427600,8,10,0
22232518@N05,2101,22,1196427600,1196427600,2,10,0
22232518@N05,2101,23,1196427600,1196427600,2,10,0
22232518@N05,2101,25,1196427600,1196427600,5,10,0
22232518@N05,2101,26,1196427600,1196427600,4,10,0
22232518@N05,2101,28,1196427600,1196427600,8,10,0
22232518@N05,2101,29,1196427600,1196428500,1,10,900
22232518@N05,2102,26,1271029144,1271030044,4,33,900
22232518@N05,2102,23,1271030150,1271030750,2,33,600
22232518@N05,2102,29,1271032048,1271032948,5,33,900
22232518@N05,2102,23,1271035406,1271036006,4,33,600
22232518@N05,2102,10,1271037162,1271037402,2,33,240
22232518@N05,2102,23,1271037476,1271038076,2,33,600
22232518@N05,2102,29,1271039211,1271040111,3,33,900
22232518@N05,2102,23,1271042399,1271042999,3,33,600
22232518@N05,2102,17,1271043055,1271043355,3,33,300
22232518@N05,2102,10,1271044149,1271044389,5,33,240
22232518@N05,2102,27,1271044546,1271044826,2,33,280
22232518@N05,2102,10,1271044826,1271044945,2,33,119
22232518@N05,2102,17,1271044945,1271044978,3,33,33
22232518@N05,2102,27,1271044978,1271045190,2,33,212
22232518@N05,2102,12,1271045190,1271045430,2,33,240
22232518@N05,2102,24,1271045888,1271046668,7,33,780
22232518@N05,2102,29,1271048383,1271048700,2,33,317
22232518@N05,2102,3,1271048700,1271048790,4,33,90
22232518@N05,2102,27,1271049886,1271050241,2,33,355
22232518@N05,2102,3,1271050241,1271050331,4,33,90
22232518@N05,2102,8,1271050823,1271051003,5,33,180
22232518@N05,2102,4,1271051471,1271051572,2,33,101
22232518@N05,2102,17,1271053460,1271053760,2,33,300
22232518@N05,2102,25,1271053997,1271054837,2,33,840
22232518@N05,2102,13,1271056928,1271057168,4,33,240
22232518@N05,2102,8,1271058172,1271058352,5,33,180
22232518@N05,2102,13,1271058638,1271058878,2,33,240
22232518@N05,2102,1,1271059163,1271059223,2,33,60
22232518@N05,2102,29,1271060053,1271060953,5,33,900
22232518@N05,2102,13,1271064839,1271065079,3,33,240
22232518@N05,2102,1,1271066119,1271066179,2,33,60
22232518@N05,2102,29,1271066211,1271067111,5,33,900
22232518@N05,2102,28,1271068712,1271069612,1,33,900
22232518@N05,2103,28,1271138045,1271138945,3,12,900
22232518@N05,2103,26,1271141000,1271141900,4,12,900
22232518@N05,2103,10,1271142557,1271142797,2,12,240
22232518@N05,2103,29,1271145509,1271146409,2,12,900
22232518@N05,2103,22,1271147456,1271148056,2,12,600
22232518@N05,2103,26,1271148094,1271148390,3,12,296
22232518@N05,2103,22,1271148390,1271148415,2,12,25
22232518@N05,2103,30,1271148415,1271149495,2,12,1080
22232518@N05,2103,22,1271149711,1271150311,5,12,600
22232518@N05,2103,20,1271151258,1271151798,2,12,540
22232518@N05,2103,1,1271155644,1271155704,3,12,60
22232518@N05,2103,28,1271162590,1271163490,1,12,900
22232518@N05,2104,28,1347692992,1347693892,3,2,900
22232518@N05,2104,17,1347700541,1347700841,3,2,300
22232518@N05,2105,28,1355276953,1355277853,3,5,900
22232518@N05,2105,17,1355281574,1355281620,2,5,46
22232518@N05,2105,28,1355281620,1355282520,3,5,900
22232518@N05,2105,1,1355285272,1355285332,2,5,60
22232518@N05,2105,28,1355286487,1355287387,5,5,900
22245172@N07,2106,10,1198133062,1198133302,1,1,240
22276416@N03,2107,28,1214464639,1214465539,2,2,900
22276416@N03,2107,16,1214472258,1214472528,1,2,270
22285503@N00,2108,30,1356065198,1356066278,2,2,1080
22285503@N00,2108,25,1356073200,1356074040,1,2,840
22299423@N05,2109,10,1287046008,1287046123,4,5,115
22299423@N05,2109,30,1287046123,1287046255,2,5,132
22299423@N05,2109,10,1287046255,1287046263,2,5,8
22299423@N05,2109,30,1287046263,1287047343,4,5,1080
22299423@N05,2109,18,1287050086,1287050536,1,5,450
22299423@N05,2110,24,1287187967,1287188307,2,9,340
22299423@N05,2110,12,1287188307,1287188547,2,9,240
22299423@N05,2110,24,1287189649,1287190429,2,9,780
22299423@N05,2110,29,1287194140,1287195040,4,9,900
22299423@N05,2110,12,1287196119,1287196225,2,9,106
22299423@N05,2110,26,1287196225,1287196572,6,9,347
22299423@N05,2110,28,1287196572,1287196850,2,9,278
22299423@N05,2110,16,1287196850,1287196961,2,9,111
22299423@N05,2110,1,1287196961,1287197021,3,9,60
22309110@N03,2111,1,1292747724,1292747784,3,1,60
22309110@N03,2112,1,1292800180,1292800240,14,2,60
22309110@N03,2112,9,1292804402,1292804582,2,2,180
22309110@N03,2113,29,1292845662,1292846484,6,6,822
22309110@N03,2113,20,1292846484,1292847024,17,6,540
22309110@N03,2113,29,1292847324,1292847444,2,6,120
22309110@N03,2113,19,1292847444,1292847678,2,6,234
22309110@N03,2113,23,1292847678,1292847964,3,6,286
22309110@N03,2113,28,1292847964,1292848864,2,6,900
22309110@N03,2114,28,1292901081,1292901981,7,2,900
22309110@N03,2114,1,1292902829,1292902889,5,2,60
22309110@N03,2115,29,1297505301,1297506201,51,1,900
22309110@N03,2116,16,1297551379,1297551649,4,2,270
22309110@N03,2116,28,1297553373,1297554273,2,2,900
22309110@N03,2117,16,1302995668,1302995938,2,6,270
22309110@N03,2117,6,1303013308,1303013428,4,6,120
22309110@N03,2117,18,1303014945,1303015395,57,6,450
22309110@N03,2117,24,1303018475,1303019255,14,6,780
22309110@N03,2117,31,1303038210,1303039710,33,6,1500
22309110@N03,2117,29,1303043574,1303044474,73,6,900
22309110@N03,2118,18,1303096629,1303097079,38,1,450
22309110@N03,2119,26,1303174868,1303175768,27,1,900
22309110@N03,2120,18,1303274256,1303274706,46,1,450
22309110@N03,2121,28,1310027752,1310028652,60,1,900
22309110@N03,2122,18,1310099757,1310100207,11,4,450
22309110@N03,2122,25,1310105154,1310105994,57,4,840
22309110@N03,2122,28,1310106595,1310107495,74,4,900
22309110@N03,2122,29,1310128398,1310129298,52,4,900
22309110@N03,2123,21,1313647622,1313648192,104,4,570
22309110@N03,2123,28,1313648943,1313649843,21,4,900
22309110@N03,2123,25,1313657669,1313658509,48,4,840
22309110@N03,2123,29,1313670834,1313671734,58,4,900
22309110@N03,2124,31,1313843688,1313845188,36,1,1500
22309110@N03,2125,25,1313906621,1313907461,104,3,840
22309110@N03,2125,28,1313908091,1313908991,35,3,900
22309110@N03,2125,25,1313916883,1313917723,50,3,840
22309110@N03,2126,16,1313993670,1313993940,101,3,270
22309110@N03,2126,25,1314003347,1314004187,47,3,840
22309110@N03,2126,31,1314014699,1314016199,50,3,1500
22309110@N03,2127,16,1314058819,1314059089,7,4,270
22309110@N03,2127,24,1314059520,1314060300,41,4,780
22309110@N03,2127,16,1314080492,1314080762,73,4,270
22309110@N03,2127,25,1314089668,1314090508,40,4,840
22309110@N03,2128,1,1317533715,1317533775,14,2,60
22309110@N03,2128,25,1317542173,1317543013,57,2,840
22309110@N03,2129,16,1318028807,1318029077,4,8,270
22309110@N03,2129,21,1318029758,1318030328,12,8,570
22309110@N03,2129,9,1318036984,1318037164,2,8,180
22309110@N03,2129,29,1318039676,1318040553,4,8,877
22309110@N03,2129,26,1318040553,1318041453,24,8,900
22309110@N03,2129,25,1318050547,1318051387,85,8,840
22309110@N03,2129,28,1318052170,1318053070,24,8,900
22309110@N03,2129,25,1318060630,1318061470,46,8,840
22309110@N03,2130,1,1319171655,1319171715,99,7,60
22309110@N03,2130,25,1319180185,1319181025,66,7,840
22309110@N03,2130,26,1319190059,1319190959,56,7,900
22309110@N03,2130,28,1319196787,1319197687,45,7,900
22309110@N03,2130,25,1319197718,1319198558,37,7,840
22309110@N03,2130,30,1319200840,1319201851,17,7,1011
22309110@N03,2130,24,1319201851,1319202631,2,7,780
22309110@N03,2131,25,1319260141,1319260981,74,5,840
22309110@N03,2131,1,1319261867,1319261927,12,5,60
22309110@N03,2131,25,1319270285,1319271125,45,5,840
22309110@N03,2131,29,1319282371,1319283271,57,5,900
22309110@N03,2131,26,1319287284,1319288184,2,5,900
22309110@N03,2132,28,1320449794,1320450694,460,1,900
22309110@N03,2133,28,1325390239,1325391139,59,3,900
22309110@N03,2133,25,1325401057,1325401897,47,3,840
22309110@N03,2133,29,1325416840,1325417740,45,3,900
22309110@N03,2134,28,1325476367,1325477267,73,4,900
22309110@N03,2134,26,1325479020,1325479920,4,4,900
22309110@N03,2134,16,1325480056,1325480326,6,4,270
22309110@N03,2134,25,1325487409,1325488249,47,4,840
22309110@N03,2135,25,1325660051,1325660891,60,1,840
22309110@N03,2136,25,1325746544,1325747384,52,2,840
22309110@N03,2136,29,1325757808,1325758708,95,2,900
22309110@N03,2137,28,1325831767,1325832667,41,2,900
22309110@N03,2137,29,1325844268,1325845168,66,2,900
22309110@N03,2138,24,1325900589,1325901369,25,4,780
22309110@N03,2138,21,1325907600,1325908170,96,4,570
22309110@N03,2138,28,1325909735,1325910635,18,4,900
22309110@N03,2138,25,1325919374,1325920214,33,4,840
22309110@N03,2139,21,1325993864,1325994434,103,2,570
22309110@N03,2139,28,1325995765,1325996665,18,2,900
22309110@N03,2140,25,1326431186,1326432026,64,3,840
22309110@N03,2140,28,1326432905,1326433805,26,3,900
22309110@N03,2140,1,1326440388,1326440448,35,3,60
22309110@N03,2141,25,1326603681,1326604521,76,3,840
22309110@N03,2141,1,1326605388,1326605448,22,3,60
22309110@N03,2141,28,1326612516,1326613416,45,3,900
22309110@N03,2142,25,1327035988,1327036828,49,4,840
22309110@N03,2142,21,1327038287,1327038857,6,4,570
22309110@N03,2142,28,1327041349,1327042249,14,4,900
22309110@N03,2142,1,1327044971,1327045031,38,4,60
22309110@N03,2143,21,1327118568,1327119138,15,2,570
22309110@N03,2143,25,1327122107,1327122947,48,2,840
22309110@N03,2144,16,1327196071,1327196341,5,4,270
22309110@N03,2144,25,1327208650,1327209490,63,4,840
22309110@N03,2144,21,1327210453,1327211023,11,4,570
22309110@N03,2144,28,1327217683,1327218583,44,4,900
22309110@N03,2145,28,1327473217,1327474117,3,3,900
22309110@N03,2145,21,1327478761,1327479331,50,3,570
22309110@N03,2145,28,1327480128,1327481028,25,3,900
22309110@N03,2146,8,1328228766,1328228946,2,8,180
22309110@N03,2146,3,1328242160,1328242250,7,8,90
22309110@N03,2146,26,1328242475,1328242717,5,8,242
22309110@N03,2146,28,1328242717,1328243037,4,8,320
22309110@N03,2146,1,1328243037,1328243097,12,8,60
22309110@N03,2146,25,1328245483,1328246323,36,8,840
22309110@N03,2146,28,1328247071,1328247971,32,8,900
22309110@N03,2146,25,1328255884,1328256724,35,8,840
22309110@N03,2147,28,1328419427,1328420327,40,2,900
22309110@N03,2147,25,1328428426,1328429266,26,2,840
22309110@N03,2148,1,1329002266,1329002326,5,6,60
22309110@N03,2148,29,1329003510,1329004410,44,6,900
22309110@N03,2148,26,1329014658,1329015558,3,6,900
22309110@N03,2148,25,1329023050,1329023890,46,6,840
22309110@N03,2148,28,1329028713,1329029613,27,6,900
22309110@N03,2148,25,1329033217,1329034057,23,6,840
22309110@N03,2149,25,1329455100,1329455940,43,3,840
22309110@N03,2149,28,1329456548,1329457448,15,3,900
22309110@N03,2149,25,1329465511,1329466351,35,3,840
22309110@N03,2150,28,1329629826,1329630726,21,2,900
22309110@N03,2150,25,1329637986,1329638826,20,2,840
22309110@N03,2151,16,1330121862,1330122132,6,4,270
22309110@N03,2151,11,1330126995,1330127235,2,4,240
22309110@N03,2151,29,1330127519,1330128419,67,4,900
22309110@N03,2151,25,1330146248,1330147088,91,4,840
22309110@N03,2152,28,1330504079,1330504979,16,3,900
22309110@N03,2152,25,1330515366,1330516206,25,3,840
22309110@N03,2152,29,1330524182,1330525082,65,3,900
22309110@N03,2153,28,1330756684,1330757584,25,3,900
22309110@N03,2153,25,1330761167,1330762007,29,3,840
22309110@N03,2153,29,1330773447,1330774347,101,3,900
22309110@N03,2154,28,1331188782,1331189682,16,1,900
22309110@N03,2155,26,1331257529,1331258429,2,6,900
22309110@N03,2155,29,1331258710,1331259610,41,6,900
22309110@N03,2155,25,1331270056,1331270896,68,6,840
22309110@N03,2155,28,1331273447,1331274347,13,6,900
22309110@N03,2155,25,1331279557,1331280397,36,6,840
22309110@N03,2155,29,1331287322,1331288222,97,6,900
22309110@N03,2156,18,1331783006,1331783456,3,3,450
22309110@N03,2156,25,1331797859,1331798699,35,3,840
22309110@N03,2156,29,1331805698,1331806598,126,3,900
22309110@N03,2157,25,1332738126,1332738966,92,2,840
22309110@N03,2157,29,1332756125,1332757025,68,2,900
22309110@N03,2158,25,1333260471,1333261311,82,2,840
22309110@N03,2158,29,1333278133,1333279033,28,2,900
22309110@N03,2159,16,1333838796,1333839066,2,4,270
22309110@N03,2159,1,1333843756,1333843816,10,4,60
22309110@N03,2159,25,1333864908,1333865748,54,4,840
22309110@N03,2159,31,1333888384,1333889884,45,4,1500
22309110@N03,2160,26,1334383808,1334384708,28,3,900
22309110@N03,2160,29,1334401314,1334402214,48,3,900
22309110@N03,2160,31,1334406713,1334408213,36,3,1500
22309110@N03,2161,28,1335172863,1335173763,34,1,900
22309110@N03,2162,25,1335689441,1335690281,20,2,840
22309110@N03,2162,29,1335697336,1335698236,105,2,900
22309110@N03,2163,28,1336203503,1336204403,11,1,900
22309110@N03,2164,25,1336987401,1336988241,44,3,840
22309110@N03,2164,29,1337002329,1337003229,50,3,900
22309110@N03,2164,1,1337005773,1337005833,41,3,60
22309110@N03,2165,28,1337308545,1337309445,21,6,900
22309110@N03,2165,25,1337310562,1337311402,53,6,840
22309110@N03,2165,11,1337324053,1337324293,22,6,240
22309110@N03,2165,28,1337326823,1337327723,6,6,900
22309110@N03,2165,25,1337331167,1337332007,18,6,840
22309110@N03,2165,29,1337343429,1337344329,39,6,900
22309110@N03,2166,25,1338012151,1338012991,98,2,840
22309110@N03,2166,29,1338035545,1338036445,35,2,900
22309110@N03,2167,21,1338523276,1338523846,5,1,570
22309110@N03,2168,29,1338553037,1338553937,54,1,900
22309110@N03,2169,25,1339059300,1339060140,40,2,840
22309110@N03,2169,29,1339071511,1339072411,38,2,900
22309110@N03,2170,29,1340281216,1340282116,38,1,900
22309110@N03,2171,1,1341045311,1341045371,29,1,60
22309110@N03,2172,25,1341565112,1341565952,27,1,840
22309110@N03,2173,25,1342255992,1342256832,18,2,840
22309110@N03,2173,29,1342269099,1342269999,44,2,900
22309110@N03,2174,25,1342342341,1342343181,41,1,840
22309110@N03,2175,24,1342489407,1342490187,7,3,780
22309110@N03,2175,25,1342494146,1342494986,10,3,840
22309110@N03,2175,1,1342499410,1342499470,40,3,60
22309110@N03,2176,29,1343133125,1343134025,35,1,900
22309110@N03,2177,28,1343439649,1343440549,28,1,900
22309110@N03,2178,21,1344224495,1344225065,2,1,570
22309110@N03,2179,11,1345700120,1345700360,15,1,240
22309110@N03,2180,11,1345781491,1345781731,8,1,240
22309110@N03,2181,14,1346038952,1346039192,4,1,240
22309110@N03,2182,29,1348230897,1348231797,48,1,900
22309110@N03,2183,18,1348891469,1348891919,30,2,450
22309110@N03,2183,28,1348894677,1348895577,38,2,900
22309110@N03,2184,1,1349422567,1349422627,65,4,60
22309110@N03,2184,29,1349430900,1349431800,16,4,900
22309110@N03,2184,28,1349434173,1349435073,15,4,900
22309110@N03,2184,25,1349441402,1349442242,13,4,840
22309110@N03,2185,28,1350164172,1350164692,11,6,520
22309110@N03,2185,26,1350164692,1350165149,7,6,457
22309110@N03,2185,21,1350165149,1350165584,13,6,435
22309110@N03,2185,7,1350165584,1350165764,4,6,180
22309110@N03,2185,11,1350165825,1350166065,4,6,240
22309110@N03,2185,29,1350166377,1350167277,3,6,900
22309110@N03,2186,25,1350639306,1350640146,15,3,840
22309110@N03,2186,28,1350646466,1350647366,17,3,900
22309110@N03,2186,15,1350652377,1350652647,2,3,270
22309110@N03,2187,25,1351899382,1351899951,11,5,569
22309110@N03,2187,28,1351899951,1351900851,49,5,900
22309110@N03,2187,16,1351902220,1351902403,6,5,183
22309110@N03,2187,28,1351902403,1351903303,11,5,900
22309110@N03,2187,1,1351903373,1351903433,81,5,60
22309110@N03,2188,28,1353039574,1353040474,56,2,900
22309110@N03,2188,21,1353048745,1353049315,31,2,570
22309110@N03,2189,28,1353644282,1353645182,28,1,900
22309110@N03,2190,11,1354681145,1354681385,17,1,240
22309110@N03,2191,29,1355047340,1355048240,67,1,900
22309110@N03,2192,21,1356145479,1356146049,7,2,570
22309110@N03,2192,1,1356150186,1356150246,39,2,60
22309110@N03,2193,28,1356668617,1356669517,25,1,900
22309110@N03,2194,30,1357873412,1357874492,24,1,1080
22309110@N03,2195,29,1358643622,1358644522,8,1,900
22309110@N03,2196,29,1359075727,1359076627,19,3,900
22309110@N03,2196,30,1359083027,1359084107,27,3,1080
22309110@N03,2196,1,1359093659,1359093719,6,3,60
22309110@N03,2197,30,1359781301,1359782381,37,2,1080
22309110@N03,2197,29,1359783268,1359784168,15,2,900
22309110@N03,2198,29,1360458007,1360458907,17,2,900
22309110@N03,2198,25,1360472660,1360473500,13,2,840
22309110@N03,2199,29,1360815916,1360816816,4,2,900
22309110@N03,2199,21,1360818330,1360818900,11,2,570
22309110@N03,2200,29,1361095315,1361096215,66,1,900
22309110@N03,2201,1,1361690028,1361690088,3,2,60
22309110@N03,2201,29,1361700115,1361701015,65,2,900
22309110@N03,2202,29,1362915126,1362916026,42,1,900
22309110@N03,2203,26,1363915030,1363915930,36,1,900
22309110@N03,2204,29,1364292099,1364292999,49,1,900
22309110@N03,2205,25,1364543853,1364544693,16,2,840
22309110@N03,2205,29,1364556786,1364557686,9,2,900
22309110@N03,2206,28,1364610757,1364611657,4,1,900
22309110@N03,2207,26,1365296842,1365297742,16,2,900
22309110@N03,2207,1,1365323508,1365323568,24,2,60
22309110@N03,2208,1,1365927594,1365927654,16,1,60
22309110@N03,2209,29,1369479738,1369480638,55,1,900
22309110@N03,2210,29,1371467006,1371467906,37,1,900
22309110@N03,2211,29,1372158150,1372159050,63,1,900
22309110@N03,2212,1,1372840525,1372840585,37,2,60
22309110@N03,2212,29,1372849353,1372850253,84,2,900
22309110@N03,2213,1,1372930250,1372930310,3,1,60
22309110@N03,2214,1,1373964263,1373964323,4,2,60
22309110@N03,2214,29,1373972570,1373973470,45,2,900
22309110@N03,2215,14,1374025215,1374025455,10,7,240
22309110@N03,2215,20,1374026893,1374027433,5,7,540
22309110@N03,2215,1,1374027656,1374027716,5,7,60
22309110@N03,2215,29,1374030704,1374031604,5,7,900
22309110@N03,2215,28,1374035594,1374036494,18,7,900
22309110@N03,2215,14,1374041532,1374041772,6,7,240
22309110@N03,2215,29,1374058954,1374059854,50,7,900
22309110@N03,2216,1,1374569097,1374569157,6,2,60
22309110@N03,2216,29,1374583326,1374584226,9,2,900
22309110@N03,2217,1,1375517034,1375517094,5,4,60
22309110@N03,2217,28,1375519200,1375520100,8,4,900
22309110@N03,2217,29,1375527794,1375528694,44,4,900
22309110@N03,2217,1,1375538556,1375538616,3,4,60
22309110@N03,2218,29,1376305391,1376306291,32,1,900
22309110@N03,2219,28,1376382960,1376383860,14,1,900
22309110@N03,2220,1,1376815698,1376815758,2,1,60
22309110@N03,2221,29,1376997770,1376998670,35,1,900
22309110@N03,2222,28,1377593110,1377594010,8,1,900
22309110@N03,2223,1,1377762598,1377762658,17,1,60
22309110@N03,2224,29,1377860576,1377861476,76,1,900
22309110@N03,2225,29,1380371578,1380372478,12,1,900
22309110@N03,2226,28,1381607731,1381608571,5,4,840
22309110@N03,2226,11,1381608571,1381608811,2,4,240
22309110@N03,2226,21,1381609034,1381609604,28,4,570
22309110@N03,2226,24,1381609822,1381610602,6,4,780
22309110@N03,2227,26,1382664116,1382665016,10,6,900
22309110@N03,2227,13,1382686246,1382686486,17,6,240
22309110@N03,2227,25,1382693664,1382694504,13,6,840
22309110@N03,2227,1,1382694538,1382694598,74,6,60
22309110@N03,2227,25,1382701684,1382702524,31,6,840
22309110@N03,2227,14,1382705376,1382705616,1,6,240
22309110@N03,2228,16,1384038125,1384038395,13,8,270
22309110@N03,2228,28,1384040383,1384041283,160,8,900
22309110@N03,2228,16,1384046254,1384046524,10,8,270
22309110@N03,2228,28,1384054477,1384054478,2,8,1
22309110@N03,2228,1,1384054478,1384054479,2,8,1
22309110@N03,2228,28,1384054479,1384054480,2,8,1
22309110@N03,2228,1,1384054480,1384054481,2,8,1
22309110@N03,2228,28,1384054481,1384055381,5,8,900
22309110@N03,2229,28,1384660505,1384661405,35,2,900
22309110@N03,2229,1,1384672580,1384672640,4,2,60
22309110@N03,2230,28,1385448203,1385449103,25,4,900
22309110@N03,2230,21,1385449652,1385449881,7,4,229
22309110@N03,2230,25,1385449881,1385450721,17,4,840
22309110@N03,2230,29,1385460230,1385461130,104,4,900
22309110@N03,2231,26,1387936245,1387937145,20,2,900
22309110@N03,2231,29,1387965957,1387966857,94,2,900
22309110@N03,2232,26,1388707675,1388708575,45,3,900
22309110@N03,2232,21,1388720198,1388720768,23,3,570
22309110@N03,2232,26,1388727256,1388728156,23,3,900
22309110@N03,2233,1,1390022844,1390022904,26,3,60
22309110@N03,2233,26,1390027797,1390028697,16,3,900
22309110@N03,2233,25,1390032034,1390032874,2,3,840
22309110@N03,2234,1,1391240054,1391240114,16,1,60
22309110@N03,2235,25,1392528043,1392528883,1,1,840
22309110@N03,2236,29,1393149827,1393150727,92,1,900
22309110@N03,2237,29,1394355832,1394356732,67,1,900
22309110@N03,2238,29,1397127837,1397128737,50,1,900
22309110@N03,2239,29,1399115061,1399115961,57,1,900
22309110@N03,2240,29,1404904098,1404904998,46,1,900
22309110@N03,2241,1,1405555920,1405555980,12,4,60
22309110@N03,2241,21,1405577251,1405577821,19,4,570
22309110@N03,2241,28,1405586500,1405587400,12,4,900
22309110@N03,2241,29,1405595365,1405596265,53,4,900
22309110@N03,2242,25,1405673717,1405674557,14,2,840
22309110@N03,2242,28,1405677894,1405678794,1,2,900
22309110@N03,2243,25,1406182401,1406183241,1,1,840
22309110@N03,2244,29,1406632087,1406632987,24,1,900
22309110@N03,2245,28,1406960609,1406961509,15,2,900
22309110@N03,2245,29,1406977525,1406978425,64,2,900
22309110@N03,2246,28,1407825324,1407826224,22,1,900
22309110@N03,2247,28,1408170517,1408171417,25,2,900
22309110@N03,2247,29,1408187619,1408188519,26,2,900
22309110@N03,2248,28,1408343640,1408344540,8,1,900
22309110@N03,2249,28,1408862440,1408863340,33,2,900
22309110@N03,2249,29,1408878308,1408879208,45,2,900
22309110@N03,2250,26,1409279160,1409280060,21,3,900
22309110@N03,2250,28,1409293629,1409294529,21,3,900
22309110@N03,2250,29,1409315692,1409316592,19,3,900
22309110@N03,2251,25,1411797991,1411798831,8,2,840
22309110@N03,2251,28,1411807236,1411808136,7,2,900
22309110@N03,2252,11,1413059460,1413059700,2,5,240
22309110@N03,2252,7,1413059766,1413059946,29,5,180
22309110@N03,2252,21,1413060769,1413061339,9,5,570
22309110@N03,2252,7,1413069874,1413070054,2,5,180
22309110@N03,2252,21,1413090786,1413091356,8,5,570
22309110@N03,2253,21,1413538607,1413539177,22,4,570
22309110@N03,2253,28,1413539395,1413540295,39,4,900
22309110@N03,2253,25,1413547218,1413548058,25,4,840
22309110@N03,2253,1,1413550615,1413550675,17,4,60
22309110@N03,2254,26,1414647732,1414648632,16,1,900
22309110@N03,2255,28,1415506815,1415507715,20,2,900
22309110@N03,2255,25,1415517837,1415518677,2,2,840
22309110@N03,2256,28,1416543614,1416544514,8,3,900
22309110@N03,2256,26,1416546693,1416547593,4,3,900
22309110@N03,2256,29,1416569531,1416570431,28,3,900
22309110@N03,2257,21,1417752464,1417753034,23,3,570
22309110@N03,2257,25,1417763010,1417763850,28,3,840
22309110@N03,2257,29,1417773802,1417774702,54,3,900
22309110@N03,2258,29,1417860163,1417861063,56,1,900
22309110@N03,2259,29,1417946601,1417947501,102,1,900
22309110@N03,2260,28,1420344988,1420345888,19,2,900
22309110@N03,2260,1,1420353998,1420354058,8,2,60
22309110@N03,2261,26,1420863439,1420864339,36,2,900
22309110@N03,2261,21,1420866368,1420866938,4,2,570
22309110@N03,2262,21,1424408245,1424408815,19,5,570
22309110@N03,2262,1,1424409976,1424410008,2,5,32
22309110@N03,2262,28,1424410008,1424410908,10,5,900
22309110@N03,2262,1,1424417598,1424417658,8,5,60
22309110@N03,2262,21,1424418960,1424419530,1,5,570
22309110@N03,2263,29,1426759807,1426760707,42,1,900
22311697@N06,2264,26,1445126523,1445127423,2,4,900
22311697@N06,2264,4,1445128905,1445129006,2,4,101
22311697@N06,2264,16,1445130844,1445131114,2,4,270
22311697@N06,2264,30,1445145741,1445146821,1,4,1080
22316898@N07,2265,1,1446376708,1446376768,2,4,60
22316898@N07,2265,28,1446376886,1446377668,7,4,782
22316898@N07,2265,16,1446377668,1446377938,3,4,270
22316898@N07,2265,3,1446377973,1446378063,2,4,90
22316898@N07,2266,29,1447373911,1447373912,7,14,1
22316898@N07,2266,31,1447373912,1447373913,2,14,1
22316898@N07,2266,14,1447373913,1447373914,2,14,1
22316898@N07,2266,13,1447373914,1447373942,4,14,28
22316898@N07,2266,28,1447373942,1447373951,5,14,9
22316898@N07,2266,13,1447373951,1447373951,6,14,0
22316898@N07,2266,24,1447373951,1447373951,2,14,0
22316898@N07,2266,25,1447373951,1447373952,3,14,1
22316898@N07,2266,13,1447373952,1447373952,4,14,0
22316898@N07,2266,14,1447373952,1447373952,4,14,0
22316898@N07,2266,15,1447373952,1447373952,3,14,0
22316898@N07,2266,28,1447373952,1447373953,2,14,1
22316898@N07,2266,14,1447373953,1447373953,8,14,0
22316898@N07,2266,20,1447373953,1447374493,3,14,540
22325101@N00,2267,16,1218722401,1218722461,2,6,60
22325101@N00,2267,18,1218722461,1218722581,3,6,120
22325101@N00,2267,29,1218722581,1218722641,2,6,60
22325101@N00,2267,31,1218722641,1218723121,2,6,480
22325101@N00,2267,13,1218723121,1218723241,3,6,120
22325101@N00,2267,26,1218723241,1218724141,1,6,900
22342760@N05,2268,18,1440880394,1440880844,1,1,450
22342760@N05,2269,18,1440940685,1440941135,1,1,450
22356039@N00,2270,3,1344176180,1344176270,1,1,90
22362762@N00,2271,19,1402800906,1402801446,1,1,540
22364250@N00,2272,13,1213228554,1213228794,1,1,240
22369752@N08,2273,30,1421470306,1421471386,1,1,1080
22386927@N05,2274,28,1273281366,1273282266,1,1,900
22426268@N04,2275,10,1224885690,1224885930,1,1,240
22456113@N00,2276,17,1231632990,1231633290,4,12,300
22456113@N00,2276,30,1231653632,1231654712,4,12,1080
22456113@N00,2276,10,1231656237,1231656477,3,12,240
22456113@N00,2276,26,1231657807,1231658517,2,12,710
22456113@N00,2276,28,1231658517,1231658955,2,12,438
22456113@N00,2276,14,1231658955,1231659195,2,12,240
22456113@N00,2276,17,1231659895,1231660195,5,12,300
22456113@N00,2276,11,1231662600,1231662840,2,12,240
22456113@N00,2276,29,1231663878,1231664778,8,12,900
22456113@N00,2276,14,1231665265,1231665505,3,12,240
22456113@N00,2276,22,1231665529,1231666129,2,12,600
22456113@N00,2276,28,1231674809,1231675709,1,12,900
22472042@N02,2277,8,1365590452,1365590632,1,1,180
22499205@N00,2278,18,1427159966,1427160416,1,1,450
22519766@N03,2279,15,1339033202,1339033472,8,16,270
22519766@N03,2279,25,1339038543,1339039383,78,16,840
22519766@N03,2279,20,1339041893,1339042147,15,16,254
22519766@N03,2279,13,1339042147,1339042287,3,16,140
22519766@N03,2279,22,1339042287,1339042288,2,16,1
22519766@N03,2279,13,1339042288,1339042528,6,16,240
22519766@N03,2279,3,1339043125,1339043215,19,16,90
22519766@N03,2279,11,1339043847,1339044080,6,16,233
22519766@N03,2279,9,1339044080,1339044260,4,16,180
22519766@N03,2279,18,1339048916,1339048926,3,16,10
22519766@N03,2279,19,1339048926,1339049466,3,16,540
22519766@N03,2279,31,1339050390,1339051890,2,16,1500
22519766@N03,2279,10,1339053432,1339053672,4,16,240
22519766@N03,2279,21,1339054359,1339054929,5,16,570
22519766@N03,2279,11,1339054981,1339054993,4,16,12
22519766@N03,2279,15,1339054993,1339055263,2,16,270
22548746@N07,2280,26,1349487311,1349487520,2,3,209
22548746@N07,2280,27,1349487520,1349488414,3,3,894
22548746@N07,2280,16,1349488414,1349488684,5,3,270
22551995@N08,2281,20,1367730045,1367730585,1,1,540
22560305@N06,2282,30,1200462108,1200463188,1,1,1080
22560305@N06,2283,12,1224362345,1224362585,1,1,240
22569657@N07,2284,4,1364526208,1364526309,2,1,101
22576224@N08,2285,1,1347624277,1347624337,5,25,60
22576224@N08,2285,28,1347624731,1347624826,3,25,95
22576224@N08,2285,16,1347624826,1347624911,3,25,85
22576224@N08,2285,23,1347624911,1347625042,4,25,131
22576224@N08,2285,31,1347625042,1347625175,9,25,133
22576224@N08,2285,20,1347625175,1347625257,5,25,82
22576224@N08,2285,22,1347625257,1347625857,3,25,600
22576224@N08,2285,14,1347626369,1347626460,3,25,91
22576224@N08,2285,22,1347626460,1347626622,4,25,162
22576224@N08,2285,31,1347626622,1347626699,5,25,77
22576224@N08,2285,20,1347626699,1347626755,2,25,56
22576224@N08,2285,29,1347626755,1347626813,3,25,58
22576224@N08,2285,31,1347626813,1347626819,2,25,6
22576224@N08,2285,23,1347626819,1347626904,2,25,85
22576224@N08,2285,29,1347626904,1347626945,3,25,41
22576224@N08,2285,31,1347626945,1347626953,2,25,8
22576224@N08,2285,23,1347626953,1347627553,4,25,600
22576224@N08,2285,31,1347629651,1347630452,2,25,801
22576224@N08,2285,23,1347630452,1347630982,3,25,530
22576224@N08,2285,19,1347630982,1347631522,18,25,540
22576224@N08,2285,23,1347631673,1347632273,3,25,600
22576224@N08,2285,16,1347633421,1347633641,5,25,220
22576224@N08,2285,27,1347633641,1347633798,3,25,157
22576224@N08,2285,16,1347633798,1347634068,2,25,270
22576224@N08,2285,27,1347634712,1347635612,4,25,900
22576224@N08,2286,1,1356712307,1356712367,4,10,60
22576224@N08,2286,30,1356713274,1356713501,2,10,227
22576224@N08,2286,29,1356713501,1356714401,7,10,900
22576224@N08,2286,23,1356717875,1356718475,3,10,600
22576224@N08,2286,28,1356720956,1356721856,8,10,900
22576224@N08,2286,29,1356726783,1356727683,3,10,900
22576224@N08,2286,10,1356729133,1356729373,2,10,240
22576224@N08,2286,21,1356729425,1356729527,4,10,102
22576224@N08,2286,16,1356729527,1356729797,7,10,270
22576224@N08,2286,26,1356731678,1356732578,1,10,900
22576224@N08,2287,23,1356793939,1356794539,18,4,600
22576224@N08,2287,21,1356798040,1356798610,23,4,570
22576224@N08,2287,27,1356799370,1356800270,19,4,900
22576224@N08,2287,16,1356808586,1356808856,21,4,270
22606730@N08,2288,12,1225486239,1225486479,1,1,240
22620178@N02,2289,19,1403604104,1403604644,1,1,540
22623063@N00,2290,27,1358031085,1358031985,2,2,900
22623063@N00,2290,17,1358039699,1358039999,1,2,300
22625471@N08,2291,26,1206083310,1206084210,1,1,900
22648301@N07,2292,1,1235373017,1235373077,2,1,60
22672393@N08,2293,16,1366268584,1366268854,1,1,270
22688581@N06,2294,13,1361927156,1361927396,1,1,240
22695386@N07,2295,17,1429876510,1429876810,1,1,300
22695386@N07,2296,26,1431252680,1431253580,1,1,900
22696986@N08,2297,25,1276149185,1276150025,1,1,840
22713429@N00,2298,17,1328437186,1328437486,3,2,300
22713429@N00,2298,14,1328441891,1328442131,1,2,240
22713429@N00,2299,27,1330251063,1330251963,1,1,900
22721767@N08,2300,30,1428312973,1428314053,1,1,1080
22729779@N04,2301,7,1357469037,1357469217,2,2,180
22729779@N04,2301,21,1357470954,1357471524,2,2,570
22729779@N04,2302,26,1357600289,1357601189,2,18,900
22729779@N04,2302,1,1357616653,1357616713,5,18,60
22729779@N04,2302,28,1357616834,1357616912,2,18,78
22729779@N04,2302,1,1357616912,1357616972,3,18,60
22729779@N04,2302,28,1357617164,1357617553,4,18,389
22729779@N04,2302,27,1357617553,1357617613,2,18,60
22729779@N04,2302,17,1357617613,1357617913,2,18,300
22729779@N04,2302,26,1357619940,1357620840,3,18,900
22729779@N04,2302,25,1357621617,1357622457,4,18,840
22729779@N04,2302,21,1357623620,1357624190,3,18,570
22729779@N04,2302,24,1357625412,1357626192,10,18,780
22729779@N04,2302,21,1357627407,1357627977,2,18,570
22729779@N04,2302,26,1357628863,1357629648,4,18,785
22729779@N04,2302,28,1357629648,1357630548,3,18,900
22729779@N04,2302,15,1357633799,1357634069,3,18,270
22729779@N04,2302,22,1357641855,1357642455,5,18,600
22729779@N04,2302,13,1357643329,1357643569,2,18,240
22729779@N04,2302,7,1357650771,1357650951,1,18,180
22733375@N04,2303,10,1238219813,1238220053,6,1,240
22733375@N04,2304,10,1238367063,1238367303,3,1,240
22733375@N04,2305,10,1238470718,1238470958,1,1,240
22751315@N05,2306,26,1400492082,1400492982,1,1,900
22774022@N07,2307,26,1227151333,1227152233,4,2,900
22774022@N07,2307,16,1227152661,1227152931,1,2,270
22774022@N07,2308,26,1237422380,1237423280,4,4,900
22774022@N07,2308,31,1237423750,1237424621,2,4,871
22774022@N07,2308,16,1237424621,1237424891,3,4,270
22774022@N07,2308,21,1237425278,1237425848,1,4,570
22789128@N00,2309,25,1200725555,1200726395,1,1,840
22789621@N02,2310,24,1247786749,1247787529,2,6,780
22789621@N02,2310,1,1247797099,1247797159,2,6,60
22789621@N02,2310,18,1247798126,1247798576,2,6,450
22789621@N02,2310,16,1247800683,1247800953,4,6,270
22789621@N02,2310,15,1247802762,1247803032,3,6,270
22789621@N02,2310,23,1247814689,1247815289,1,6,600
22809375@N06,2311,16,1224309200,1224309224,2,4,24
22809375@N06,2311,10,1224309224,1224309464,2,4,240
22809375@N06,2311,9,1224316763,1224316943,4,4,180
22809375@N06,2311,21,1224326083,1224326653,3,4,570
22826842@N04,2312,26,1265595572,1265596472,1,1,900
22826842@N04,2313,13,1291952974,1291953214,1,1,240
22826842@N04,2314,26,1292114698,1292115598,1,1,900
22826842@N04,2315,7,1293849788,1293849968,1,1,180
22826842@N04,2316,12,1294450049,1294450289,1,1,240
22826842@N04,2317,27,1357851350,1357852250,1,1,900
22826842@N04,2318,31,1389275694,1389277194,3,1,1500
22858034@N08,2319,1,1321848108,1321848168,2,11,60
22858034@N08,2319,28,1321850693,1321851593,2,11,900
22858034@N08,2319,30,1321857959,1321859039,2,11,1080
22858034@N08,2319,15,1321866451,1321866721,2,11,270
22858034@N08,2319,26,1321874066,1321874173,2,11,107
22858034@N08,2319,17,1321874173,1321874473,3,11,300
22858034@N08,2319,25,1321879428,1321880268,3,11,840
22858034@N08,2319,21,1321880550,1321881120,2,11,570
22858034@N08,2319,15,1321881563,1321881833,2,11,270
22858034@N08,2319,26,1321884448,1321884641,2,11,193
22858034@N08,2319,16,1321884641,1321884911,1,11,270
22868474@N07,2320,12,1312156781,1312157021,1,1,240
22872338@N03,2321,22,1210934618,1210935218,1,1,600
22884086@N03,2322,26,1260046902,1260047802,2,2,900
22884086@N03,2322,25,1260049503,1260050343,1,2,840
22890516@N03,2323,15,1366413076,1366413346,1,1,270
22890555@N06,2324,1,1383017567,1383017627,1,1,60
22890555@N06,2325,29,1392704429,1392705329,1,1,900
22890555@N06,2326,30,1396444313,1396445393,1,1,1080
22892300@N05,2327,28,1276855027,1276855274,2,6,247
22892300@N05,2327,12,1276855274,1276855514,9,6,240
22892300@N05,2327,15,1276860844,1276861114,12,6,270
22892300@N05,2327,27,1276861308,1276861498,2,6,190
22892300@N05,2327,26,1276861498,1276862398,4,6,900
22892300@N05,2327,12,1276864651,1276864891,1,6,240
22909555@N04,2328,27,1330215355,1330216255,2,2,900
22909555@N04,2328,18,1330217412,1330217862,1,2,450
22918179@N08,2329,1,1208040920,1208040980,3,9,60
22918179@N08,2329,28,1208041007,1208041389,5,9,382
22918179@N08,2329,26,1208041389,1208041520,2,9,131
22918179@N08,2329,6,1208041520,1208041640,2,9,120
22918179@N08,2329,4,1208042219,1208042320,2,9,101
22918179@N08,2329,12,1208043616,1208043856,4,9,240
22918179@N08,2329,3,1208048604,1208048694,2,9,90
22918179@N08,2329,23,1208051687,1208052024,3,9,337
22918179@N08,2329,29,1208052024,1208052924,6,9,900
22918179@N08,2330,24,1208128489,1208129269,8,6,780
22918179@N08,2330,17,1208130315,1208130615,7,6,300
22918179@N08,2330,27,1208135389,1208136108,2,6,719
22918179@N08,2330,16,1208136108,1208136378,7,6,270
22918179@N08,2330,25,1208145509,1208145888,2,6,379
22918179@N08,2330,13,1208145888,1208146128,12,6,240
22918179@N08,2331,31,1208308388,1208309888,5,6,1500
22918179@N08,2331,22,1208312797,1208313397,2,6,600
22918179@N08,2331,3,1208315522,1208315612,5,6,90
22918179@N08,2331,26,1208317562,1208317659,2,6,97
22918179@N08,2331,27,1208317659,1208318057,2,6,398
22918179@N08,2331,28,1208318057,1208318957,1,6,900
22918179@N08,2332,16,1208390628,1208390898,5,16,270
22918179@N08,2332,24,1208393724,1208394504,4,16,780
22918179@N08,2332,17,1208394604,1208394904,2,16,300
22918179@N08,2332,28,1208396027,1208396927,2,16,900
22918179@N08,2332,21,1208404365,1208404723,2,16,358
22918179@N08,2332,23,1208404723,1208405323,2,16,600
22918179@N08,2332,29,1208409320,1208410220,10,16,900
22918179@N08,2332,18,1208411565,1208412015,4,16,450
22918179@N08,2332,27,1208412530,1208413430,5,16,900
22918179@N08,2332,4,1208416736,1208416837,4,16,101
22918179@N08,2332,5,1208417107,1208417227,5,16,120
22918179@N08,2332,29,1208419941,1208420841,7,16,900
22918179@N08,2332,22,1208423988,1208424588,7,16,600
22918179@N08,2332,26,1208425666,1208426566,2,16,900
22918179@N08,2332,3,1208428747,1208428837,2,16,90
22918179@N08,2332,29,1208434373,1208435273,1,16,900
22918179@N08,2333,28,1208508018,1208508918,14,1,900
22925214@N04,2334,26,1200808496,1200809396,9,1,900
22929347@N07,2335,27,1395531941,1395532841,1,1,900
22935007@N08,2336,28,1246460274,1246461174,1,1,900
22937808@N04,2337,23,1408800965,1408801565,1,1,600
22937808@N04,2338,21,1410615234,1410615804,2,2,570
22937808@N04,2338,28,1410617788,1410618688,1,2,900
22937808@N04,2339,28,1411829834,1411830734,1,1,900
22937808@N04,2340,28,1417183555,1417184455,1,1,900
22937808@N04,2341,11,1418127260,1418127500,1,1,240
22937808@N04,2342,26,1420118921,1420119821,2,1,900
22937808@N04,2343,21,1426252462,1426253032,2,2,570
22937808@N04,2343,26,1426254211,1426255111,1,2,900
22937808@N04,2344,26,1427635850,1427636750,3,2,900
22937808@N04,2344,28,1427637351,1427638251,1,2,900
22937808@N04,2345,12,1432331508,1432331748,2,3,240
22937808@N04,2345,26,1432332760,1432333660,2,3,900
22937808@N04,2345,29,1432335401,1432336301,2,3,900
22937808@N04,2346,26,1435923571,1435924471,3,2,900
22937808@N04,2346,20,1435929091,1435929631,1,2,540
22937808@N04,2347,20,1439040782,1439041322,2,2,540
22937808@N04,2347,21,1439043770,1439044340,1,2,570
22937808@N04,2348,21,1442667872,1442668442,2,2,570
22937808@N04,2348,16,1442673217,1442673487,1,2,270
22937808@N04,2349,24,1444473621,1444474401,2,1,780
22937808@N04,2350,6,1448536748,1448536868,2,2,120
22937808@N04,2350,26,1448538229,1448539129,1,2,900
22937808@N04,2351,28,1451131276,1451132176,1,1,900
22937808@N04,2352,28,1465657935,1465658835,1,1,900
22937808@N04,2353,21,1469273481,1469274051,1,1,570
22937808@N04,2354,26,1471098776,1471099676,2,2,900
22937808@N04,2354,1,1471100469,1471100529,1,2,60
22937808@N04,2355,20,1471585425,1471585965,1,1,540
22938314@N08,2356,28,1242392444,1242392559,4,3,115
22938314@N08,2356,14,1242392559,1242392799,3,3,240
22938314@N08,2356,28,1242395389,1242396289,1,3,900
22938314@N08,2357,28,1244203797,1244204697,1,1,900
22938314@N08,2358,16,1246264714,1246264984,1,1,270
22938314@N08,2359,28,1246872946,1246873846,2,2,900
22938314@N08,2359,21,1246877393,1246877963,6,2,570
22938314@N08,2360,29,1247487158,1247488058,1,1,900
22957560@N05,2361,28,1319350528,1319351428,1,1,900
23004611@N00,2362,19,1416317002,1416317542,1,1,540
23032267@N00,2363,24,1298691717,1298692497,2,2,780
23032267@N00,2363,29,1298699117,1298700017,1,2,900
23032267@N00,2364,29,1299911815,1299912715,1,1,900
23036476@N00,2365,23,1229378840,1229378938,2,2,98
23036476@N00,2365,18,1229378938,1229379388,1,2,450
23036476@N00,2366,16,1229469558,1229469828,1,1,270
23036476@N00,2367,31,1229549659,1229549916,3,2,257
23036476@N00,2367,23,1229549916,1229550516,1,2,600
23036476@N00,2368,13,1229642722,1229642962,1,1,240
23049720@N00,2369,18,1446771677,1446772127,2,1,450
23065916@N04,2370,15,1238038100,1238038370,2,2,270
23065916@N04,2370,26,1238040304,1238041204,1,2,900
23065916@N04,2371,26,1238153826,1238154726,1,1,900
23065916@N04,2372,20,1274864925,1274865427,3,2,502
23065916@N04,2372,30,1274865427,1274866507,1,2,1080
23065916@N04,2373,23,1274952219,1274952819,1,1,600
23065916@N04,2374,18,1275021333,1275021783,1,1,450
23065916@N04,2375,1,1298155155,1298155215,2,2,60
23065916@N04,2375,26,1298162844,1298163744,1,2,900
23065916@N04,2376,26,1323512357,1323513257,1,1,900
23065916@N04,2377,28,1323573818,1323574718,2,2,900
23065916@N04,2377,26,1323592870,1323593770,1,2,900
23065916@N04,2378,26,1354757894,1354758794,1,1,900
23089307@N02,2379,6,1356996921,1356997041,2,20,120
23089307@N02,2379,7,1356997071,1356997239,2,20,168
23089307@N02,2379,6,1356997239,1356997359,2,20,120
23089307@N02,2379,24,1356998937,1356999017,2,20,80
23089307@N02,2379,15,1356999017,1356999287,9,20,270
23089307@N02,2379,17,1357001455,1357001755,3,20,300
23089307@N02,2379,24,1357002939,1357003029,2,20,90
23089307@N02,2379,15,1357003029,1357003299,2,20,270
23089307@N02,2379,21,1357004438,1357004984,3,20,546
23089307@N02,2379,25,1357004984,1357005824,12,20,840
23089307@N02,2379,29,1357017026,1357017926,2,20,900
23089307@N02,2379,31,1357018035,1357018448,3,20,413
23089307@N02,2379,22,1357018448,1357018628,3,20,180
23089307@N02,2379,31,1357018628,1357019567,3,20,939
23089307@N02,2379,29,1357019567,1357020467,5,20,900
23089307@N02,2379,26,1357029210,1357030110,2,20,900
23089307@N02,2379,24,1357030644,1357031342,3,20,698
23089307@N02,2379,16,1357031342,1357031545,2,20,203
23089307@N02,2379,28,1357031545,1357031676,2,20,131
23089307@N02,2379,1,1357031676,1357031736,5,20,60
23089307@N02,2380,1,1357098576,1357098636,1,1,60
23097875@N00,2381,16,1286751630,1286751900,2,8,270
23097875@N00,2381,15,1286753652,1286753922,2,8,270
23097875@N00,2381,26,1286754228,1286755128,2,8,900
23097875@N00,2381,17,1286770510,1286770810,2,8,300
23097875@N00,2381,28,1286771179,1286772079,2,8,900
23097875@N00,2381,26,1286772295,1286773088,2,8,793
23097875@N00,2381,1,1286773088,1286773148,3,8,60
23097875@N00,2381,25,1286779798,1286780638,5,8,840
23108813@N00,2382,26,1350722129,1350723029,1,1,900
23108813@N00,2383,24,1351137286,1351138066,1,1,780
23108813@N00,2384,30,1351318400,1351319480,1,1,1080
23113465@N08,2385,1,1381593910,1381593970,1,1,60
23113465@N08,2386,1,1388999605,1388999665,2,1,60
23113465@N08,2387,1,1389189240,1389189300,1,1,60
23113465@N08,2388,1,1395368736,1395368796,1,1,60
23113465@N08,2389,1,1396768791,1396768851,1,1,60
23113465@N08,2390,19,1405700204,1405700744,1,1,540
23113465@N08,2391,27,1408851878,1408852778,1,1,900
23113465@N08,2392,19,1412425635,1412426175,2,3,540
23113465@N08,2392,20,1412429367,1412429431,2,3,64
23113465@N08,2392,19,1412429431,1412429971,1,3,540
23113465@N08,2393,19,1419593011,1419593551,1,1,540
23113465@N08,2394,18,1426390275,1426390725,1,1,450
23113465@N08,2395,18,1428565035,1428565485,1,1,450
23113465@N08,2396,18,1430716623,1430717073,2,1,450
23113465@N08,2397,18,1431001348,1431001798,1,1,450
23113465@N08,2398,18,1431084261,1431084711,1,1,450
23113465@N08,2399,18,1432362019,1432362469,1,1,450
23113465@N08,2400,17,1435323745,1435324045,2,2,300
23113465@N08,2400,18,1435336037,1435336487,1,2,450
23113465@N08,2401,18,1440582024,1440582474,1,1,450
23113465@N08,2402,18,1441542137,1441542587,1,1,450
23113465@N08,2403,18,1441791665,1441792115,1,1,450
23113465@N08,2404,17,1443011230,1443011530,1,1,300
23113465@N08,2405,18,1443057858,1443058308,1,1,450
23113465@N08,2406,18,1443156144,1443156594,4,1,450
23113465@N08,2407,18,1443415906,1443416356,2,3,450
23113465@N08,2407,30,1443424333,1443425413,2,3,1080
23113465@N08,2407,18,1443428356,1443428806,3,3,450
23113465@N08,2408,18,1443955018,1443955468,1,1,450
23113465@N08,2409,18,1444020502,1444020952,4,1,450
23113465@N08,2410,18,1451442567,1451443017,1,1,450
23113465@N08,2411,20,1451566679,1451567219,2,2,540
23113465@N08,2411,18,1451567843,1451568293,3,2,450
23113465@N08,2412,18,1451612903,1451613353,1,1,450
23113465@N08,2413,15,1452579276,1452579546,2,2,270
23113465@N08,2413,18,1452580541,1452580991,1,2,450
23113465@N08,2414,18,1454246280,1454246730,1,1,450
23113465@N08,2415,18,1454501048,1454501498,1,1,450
23113465@N08,2416,18,1454713591,1454714041,2,1,450
23113465@N08,2417,18,1456053292,1456053742,1,1,450
23113465@N08,2418,18,1458004406,1458004856,1,1,450
23113465@N08,2419,20,1466480341,1466480881,1,1,540
23113465@N08,2420,10,1467434992,1467435232,2,2,240
23113465@N08,2420,20,1467439222,1467439762,1,2,540
23119895@N00,2421,17,1288674142,1288674442,2,1,300
23119895@N00,2422,13,1288752839,1288753079,2,4,240
23119895@N00,2422,24,1288756125,1288756905,2,4,780
23119895@N00,2422,16,1288760210,1288760480,2,4,270
23119895@N00,2422,18,1288762542,1288762992,1,4,450
23119895@N00,2423,8,1288918454,1288918634,1,1,180
23119895@N00,2424,3,1288999601,1288999691,2,2,90
23119895@N00,2424,29,1289015264,1289016164,1,2,900
23119895@N00,2425,12,1289044638,1289044878,1,1,240
23119895@N00,2426,1,1324248370,1324248430,3,7,60
23119895@N00,2426,8,1324249517,1324249697,2,7,180
23119895@N00,2426,3,1324251562,1324251652,2,7,90
23119895@N00,2426,5,1324252555,1324252675,4,7,120
23119895@N00,2426,16,1324262299,1324262569,2,7,270
23119895@N00,2426,22,1324275666,1324276266,2,7,600
23119895@N00,2426,16,1324289245,1324289515,1,7,270
23119895@N00,2427,7,1324427565,1324427745,2,7,180
23119895@N00,2427,6,1324427872,1324427992,2,7,120
23119895@N00,2427,7,1324435306,1324435382,2,7,76
23119895@N00,2427,5,1324435382,1324435502,2,7,120
23119895@N00,2427,11,1324438794,1324439034,4,7,240
23119895@N00,2427,16,1324445750,1324446020,4,7,270
23119895@N00,2427,26,1324466145,1324467045,1,7,900
23119895@N00,2428,5,1406900864,1406900984,1,1,120
23124863@N02,2429,29,1338164706,1338165606,1,1,900
23125652@N06,2430,16,1257569455,1257569725,1,1,270
23129782@N00,2431,1,1435018882,1435018942,2,19,60
23129782@N00,2431,16,1435019623,1435019791,2,19,168
23129782@N00,2431,26,1435019791,1435020301,2,19,510
23129782@N00,2431,5,1435020301,1435020421,2,19,120
23129782@N00,2431,21,1435022047,1435022143,2,19,96
23129782@N00,2431,12,1435022143,1435022383,3,19,240
23129782@N00,2431,24,1435024443,1435025104,5,19,661
23129782@N00,2431,12,1435025104,1435025344,3,19,240
23129782@N00,2431,24,1435025896,1435026676,2,19,780
23129782@N00,2431,19,1435032541,1435032917,4,19,376
23129782@N00,2431,23,1435032917,1435032930,2,19,13
23129782@N00,2431,19,1435032930,1435033470,2,19,540
23129782@N00,2431,30,1435034120,1435034512,3,19,392
23129782@N00,2431,22,1435034512,1435034926,3,19,414
23129782@N00,2431,31,1435034926,1435036256,2,19,1330
23129782@N00,2431,20,1435036256,1435036796,2,19,540
23129782@N00,2431,25,1435050550,1435050875,5,19,325
23129782@N00,2431,11,1435050875,1435050878,2,19,3
23129782@N00,2431,25,1435050878,1435051718,4,19,840
23149244@N02,2432,26,1277839060,1277839960,24,3,900
23149244@N02,2432,27,1277844808,1277845708,8,3,900
23149244@N02,2432,26,1277851264,1277852164,5,3,900
23156426@N07,2433,18,1320292495,1320292497,2,3,2
23156426@N07,2433,23,1320292497,1320292669,2,3,172
23156426@N07,2433,18,1320292669,1320293119,3,3,450
23197443@N07,2434,21,1323300098,1323300668,1,1,570
23197443@N07,2435,16,1323452774,1323453044,1,1,270
23197443@N07,2436,26,1325717088,1325717988,2,1,900
23205379@N02,2437,29,1329721497,1329722397,1,1,900
23205379@N02,2438,29,1329903776,1329904676,1,1,900
23205379@N02,2439,29,1330074975,1330075875,1,1,900
23205379@N02,2440,3,1330133925,1330134015,1,1,90
23205379@N02,2441,27,1330810310,1330811210,1,1,900
23205379@N02,2442,5,1331512698,1331512714,2,2,16
23205379@N02,2442,18,1331512714,1331513164,1,2,450
23205379@N02,2443,28,1332068505,1332069405,1,1,900
23205379@N02,2444,7,1332392012,1332392111,2,3,99
23205379@N02,2444,18,1332392111,1332392143,2,3,32
23205379@N02,2444,6,1332392143,1332392263,1,3,120
23205379@N02,2445,30,1332669724,1332670208,2,4,484
23205379@N02,2445,28,1332670208,1332670224,2,4,16
23205379@N02,2445,18,1332670224,1332670244,2,4,20
23205379@N02,2445,24,1332670244,1332671024,1,4,780
23205379@N02,2446,15,1332757828,1332758098,1,1,270
23205379@N02,2447,4,1332977163,1332977177,2,3,14
23205379@N02,2447,9,1332977177,1332977266,2,3,89
23205379@N02,2447,15,1332977266,1332977536,1,3,270
23205379@N02,2448,26,1333162079,1333162096,2,3,17
23205379@N02,2448,15,1333162096,1333162147,2,3,51
23205379@N02,2448,28,1333162147,1333163047,1,3,900
23205379@N02,2449,10,1333683683,1333683738,2,6,55
23205379@N02,2449,26,1333683738,1333683855,2,6,117
23205379@N02,2449,4,1333683855,1333683956,2,6,101
23205379@N02,2449,28,1333684082,1333684119,2,6,37
23205379@N02,2449,26,1333684119,1333684191,2,6,72
23205379@N02,2449,28,1333684191,1333685091,1,6,900
23205379@N02,2450,18,1334997376,1334997462,2,2,86
23205379@N02,2450,29,1334997462,1334998362,1,2,900
23205379@N02,2451,14,1335054096,1335054120,2,2,24
23205379@N02,2451,18,1335054120,1335054570,1,2,450
23205379@N02,2452,29,1335400579,1335400673,2,6,94
23205379@N02,2452,1,1335400673,1335400698,2,6,25
23205379@N02,2452,11,1335400698,1335400719,2,6,21
23205379@N02,2452,23,1335400719,1335400758,2,6,39
23205379@N02,2452,20,1335400758,1335400945,2,6,187
23205379@N02,2452,24,1335400945,1335401725,1,6,780
23205379@N02,2453,26,1336007262,1336008162,2,1,900
23205379@N02,2454,28,1341371249,1341372149,1,1,900
23205379@N02,2455,15,1342047579,1342047849,1,1,270
23205379@N02,2456,28,1342162196,1342162274,2,2,78
23205379@N02,2456,18,1342162274,1342162724,1,2,450
23205379@N02,2457,28,1343194529,1343195429,1,1,900
23205379@N02,2458,28,1343357404,1343357479,3,6,75
23205379@N02,2458,31,1343357479,1343357496,2,6,17
23205379@N02,2458,30,1343357496,1343357573,2,6,77
23205379@N02,2458,22,1343357573,1343357586,2,6,13
23205379@N02,2458,28,1343357586,1343357640,2,6,54
23205379@N02,2458,30,1343357640,1343358720,1,6,1080
23205379@N02,2459,29,1357373875,1357374775,1,1,900
23205379@N02,2460,28,1362896675,1362897575,1,1,900
23205379@N02,2461,29,1368960516,1368961416,1,1,900
23205379@N02,2462,11,1378029966,1378030206,1,1,240
23205379@N02,2463,28,1382339936,1382340836,2,3,900
23205379@N02,2463,7,1382347174,1382347354,2,3,180
23205379@N02,2463,28,1382350923,1382351823,1,3,900
23205379@N02,2464,29,1386572301,1386573201,2,1,900
23205379@N02,2465,28,1398566276,1398567176,1,1,900
23205379@N02,2466,26,1399174046,1399174946,1,1,900
23205379@N02,2467,17,1400328991,1400329291,1,1,300
23205379@N02,2468,28,1401523079,1401523979,1,1,900
23205379@N02,2469,1,1402126072,1402126132,1,1,60
23205379@N02,2470,28,1404553462,1404554362,1,1,900
23205379@N02,2471,19,1405760317,1405760857,2,2,540
23205379@N02,2471,29,1405769756,1405770656,2,2,900
23205379@N02,2472,19,1409445003,1409445543,3,3,540
23205379@N02,2472,28,1409449521,1409450421,2,3,900
23205379@N02,2472,19,1409451249,1409451789,2,3,540
23205379@N02,2473,19,1411133490,1411134030,1,1,540
23205379@N02,2474,19,1411883614,1411884154,2,5,540
23205379@N02,2474,28,1411888514,1411889414,2,5,900
23205379@N02,2474,20,1411891703,1411892243,2,5,540
23205379@N02,2474,27,1411897379,1411898279,2,5,900
23205379@N02,2474,19,1411907110,1411907650,1,5,540
23205379@N02,2475,28,1412032849,1412033749,2,3,900
23205379@N02,2475,17,1412053292,1412053592,2,3,300
23205379@N02,2475,28,1412067013,1412067913,1,3,900
23205379@N02,2476,19,1412116128,1412116668,1,1,540
23205379@N02,2477,29,1412216649,1412217549,2,2,900
23205379@N02,2477,19,1412227456,1412227996,1,2,540
23205379@N02,2478,24,1412310090,1412310870,1,1,780
23205379@N02,2479,28,1412426199,1412427099,2,2,900
23205379@N02,2479,20,1412428969,1412429509,1,2,540
23205379@N02,2480,19,1412646949,1412647489,1,1,540
23205379@N02,2481,28,1412680845,1412681745,1,1,900
23205379@N02,2482,20,1412757074,1412757614,1,1,540
23205379@N02,2483,19,1412904627,1412905167,1,1,540
23205379@N02,2484,19,1413163093,1413163633,2,1,540
23205379@N02,2485,19,1413625369,1413625909,1,1,540
23205379@N02,2486,19,1413795241,1413795781,2,1,540
23205379@N02,2487,17,1413857484,1413857784,1,1,300
23205379@N02,2488,28,1413887888,1413888788,1,1,900
23205379@N02,2489,30,1414483543,1414484623,1,1,1080
23205379@N02,2490,19,1415436478,1415437018,2,4,540
23205379@N02,2490,27,1415437882,1415438782,2,4,900
23205379@N02,2490,19,1415441353,1415441893,2,4,540
23205379@N02,2490,26,1415449562,1415450462,1,4,900
23205379@N02,2491,25,1415966017,1415966857,1,1,840
23205379@N02,2492,19,1416471219,1416471759,1,1,540
23205379@N02,2493,19,1416625986,1416626526,1,1,540
23205379@N02,2494,26,1417172671,1417173571,1,1,900
23205379@N02,2495,19,1418189601,1418190141,1,1,540
23205379@N02,2496,19,1418461030,1418461570,3,1,540
23205379@N02,2497,19,1418892340,1418892880,1,1,540
23205379@N02,2498,28,1419288398,1419289298,1,1,900
23205379@N02,2499,26,1419857103,1419858003,1,1,900
23205379@N02,2500,26,1419988832,1419989732,1,1,900
23205379@N02,2501,29,1420173021,1420173921,1,1,900
23205379@N02,2502,19,1420258496,1420259036,1,1,540
23205379@N02,2503,28,1420872773,1420873673,2,2,900
23205379@N02,2503,30,1420877249,1420878329,1,2,1080
23205379@N02,2504,18,1421878708,1421879158,1,1,450
23205379@N02,2505,28,1422154459,1422155359,1,1,900
23205379@N02,2506,28,1422403007,1422403907,1,1,900
23205379@N02,2507,26,1423628148,1423629048,1,1,900
23205379@N02,2508,18,1424074599,1424075049,1,1,450
23205379@N02,2509,18,1424987565,1424988015,1,1,450
23205379@N02,2510,18,1425092395,1425092845,2,2,450
23205379@N02,2510,29,1425112352,1425113252,1,2,900
23205379@N02,2511,13,1425178928,1425179168,2,2,240
23205379@N02,2511,18,1425188549,1425188999,1,2,450
23205379@N02,2512,4,1425262802,1425262903,1,1,101
23205379@N02,2513,18,1425433630,1425434080,1,1,450
23205379@N02,2514,18,1425510466,1425510916,2,3,450
23205379@N02,2514,28,1425522259,1425523159,2,3,900
23205379@N02,2514,13,1425538801,1425539041,1,3,240
23205379@N02,2515,18,1425608255,1425608705,2,1,450
23205379@N02,2516,29,1425788749,1425789649,1,1,900
23205379@N02,2517,18,1425850809,1425851259,1,1,450
23205379@N02,2518,18,1425954415,1425954865,1,1,450
23205379@N02,2519,26,1426039960,1426040860,1,1,900
23205379@N02,2520,13,1426632651,1426632891,2,2,240
23205379@N02,2520,18,1426657886,1426658336,1,2,450
23205379@N02,2521,9,1426716556,1426716736,2,2,180
23205379@N02,2521,18,1426724412,1426724862,2,2,450
23205379@N02,2522,25,1427163275,1427164115,1,1,840
23205379@N02,2523,18,1427238421,1427238871,1,1,450
23205379@N02,2524,28,1427601104,1427602004,1,1,900
23205379@N02,2525,26,1427840327,1427841227,1,1,900
23205379@N02,2526,28,1427957639,1427958539,1,1,900
23205379@N02,2527,18,1428536130,1428536580,1,1,450
23205379@N02,2528,26,1428902833,1428903733,1,1,900
23205379@N02,2529,28,1428967375,1428968275,1,1,900
23205379@N02,2530,18,1429007168,1429007618,1,1,450
23205379@N02,2531,28,1429064197,1429065097,2,2,900
23205379@N02,2531,26,1429087198,1429088098,1,2,900
23205379@N02,2532,28,1429168540,1429169440,2,2,900
23205379@N02,2532,18,1429181621,1429182071,1,2,450
23205379@N02,2533,18,1429330054,1429330504,1,1,450
23205379@N02,2534,18,1429495908,1429496358,2,2,450
23205379@N02,2534,14,1429519494,1429519734,1,2,240
23205379@N02,2535,18,1429607840,1429608290,2,2,450
23205379@N02,2535,28,1429612288,1429613188,1,2,900
23205379@N02,2536,26,1429836431,1429837331,1,1,900
23205379@N02,2537,18,1430115376,1430115826,1,1,450
23205379@N02,2538,18,1430260118,1430260568,1,1,450
23205379@N02,2539,28,1430641626,1430642526,1,1,900
23205379@N02,2540,18,1430709705,1430710155,1,1,450
23205379@N02,2541,18,1430785149,1430785599,1,1,450
23205379@N02,2542,30,1431146481,1431147561,2,2,1080
23205379@N02,2542,18,1431151261,1431151711,1,2,450
23205379@N02,2543,18,1431399512,1431399962,1,1,450
23205379@N02,2544,26,1431682543,1431683443,1,1,900
23205379@N02,2545,18,1432103477,1432103927,2,1,450
23205379@N02,2546,26,1432160814,1432161714,2,4,900
23205379@N02,2546,18,1432170753,1432171203,2,4,450
23205379@N02,2546,28,1432178032,1432178932,2,4,900
23205379@N02,2546,3,1432204905,1432204995,1,4,90
23205379@N02,2547,18,1432255756,1432256206,2,3,450
23205379@N02,2547,28,1432261341,1432262241,2,3,900
23205379@N02,2547,1,1432286457,1432286517,1,3,60
23205379@N02,2548,20,1432439195,1432439735,2,2,540
23205379@N02,2548,22,1432449082,1432449682,1,2,600
23205379@N02,2549,18,1432527781,1432528231,2,2,450
23205379@N02,2549,28,1432555817,1432556717,1,2,900
23205379@N02,2550,4,1432598557,1432598658,2,3,101
23205379@N02,2550,18,1432608483,1432608933,2,3,450
23205379@N02,2550,29,1432614440,1432615340,1,3,900
23205379@N02,2551,3,1433214053,1433214143,1,1,90
23205379@N02,2552,14,1433403997,1433404237,2,2,240
23205379@N02,2552,18,1433412753,1433413203,1,2,450
23205379@N02,2553,18,1433651790,1433652240,1,1,450
23205379@N02,2554,18,1433846804,1433847254,1,1,450
23205379@N02,2555,3,1434260355,1434260445,1,1,90
23205379@N02,2556,28,1434500399,1434501299,1,1,900
23205379@N02,2557,28,1434853497,1434854397,1,1,900
23205379@N02,2558,18,1434976656,1434977106,1,1,450
23205379@N02,2559,28,1435096047,1435096947,1,1,900
23205379@N02,2560,12,1435300161,1435300401,1,1,240
23205379@N02,2561,11,1435996302,1435996542,2,2,240
23205379@N02,2561,18,1436000304,1436000754,1,2,450
23205379@N02,2562,18,1436173361,1436173811,1,1,450
23205379@N02,2563,28,1436274531,1436275431,1,1,900
23205379@N02,2564,28,1436350562,1436351462,1,1,900
23205379@N02,2565,18,1436679425,1436679875,1,1,450
23205379@N02,2566,29,1437020096,1437020996,1,1,900
23205379@N02,2567,18,1438166002,1438166452,1,1,450
23205379@N02,2568,28,1438435445,1438436345,1,1,900
23205379@N02,2569,29,1438602758,1438603658,1,1,900
23205379@N02,2570,28,1438740000,1438740900,1,1,900
23205379@N02,2571,28,1439105682,1439106582,2,2,900
23205379@N02,2571,30,1439112957,1439114037,1,2,1080
23205379@N02,2572,18,1441323855,1441324305,1,1,450
23205379@N02,2573,18,1441413391,1441413841,1,1,450
23208151@N05,2574,31,1334879658,1334881158,1,1,1500
23211922@N04,2575,18,1457074008,1457074458,1,1,450
23212779@N04,2576,26,1209116442,1209117342,1,1,900
23212779@N04,2577,26,1275544692,1275545592,2,5,900
23212779@N04,2577,12,1275557919,1275558159,2,5,240
23212779@N04,2577,3,1275558196,1275558286,2,5,90
23212779@N04,2577,21,1275558661,1275559231,2,5,570
23212779@N04,2577,24,1275559582,1275560362,1,5,780
23212779@N04,2578,29,1279509455,1279509950,2,2,495
23212779@N04,2578,26,1279509950,1279510850,1,2,900
23212779@N04,2579,26,1281954009,1281954909,2,4,900
23212779@N04,2579,29,1281962993,1281963893,3,4,900
23212779@N04,2579,21,1281967900,1281968470,2,4,570
23212779@N04,2579,26,1281969225,1281970125,2,4,900
23212779@N04,2580,16,1282741128,1282741398,1,1,270
23212779@N04,2581,6,1286112467,1286112587,2,4,120
23212779@N04,2581,26,1286113022,1286113527,2,4,505
23212779@N04,2581,28,1286113527,1286114427,3,4,900
23212779@N04,2581,1,1286115080,1286115140,1,4,60
23212779@N04,2582,29,1289988637,1289989537,2,4,900
23212779@N04,2582,26,1289990995,1289991895,3,4,900
23212779@N04,2582,28,1289992115,1289993015,2,4,900
23212779@N04,2582,1,1289994113,1289994173,1,4,60
23212779@N04,2583,24,1290066981,1290067761,2,5,780
23212779@N04,2583,26,1290068054,1290068954,2,5,900
23212779@N04,2583,28,1290069189,1290070089,2,5,900
23212779@N04,2583,13,1290072095,1290072335,2,5,240
23212779@N04,2583,26,1290076248,1290077148,1,5,900
23212779@N04,2584,30,1294720449,1294721529,2,3,1080
23212779@N04,2584,12,1294728584,1294728824,3,3,240
23212779@N04,2584,6,1294742411,1294742531,1,3,120
23212779@N04,2585,13,1297414003,1297414243,2,2,240
23212779@N04,2585,15,1297421526,1297421796,1,2,270
23212779@N04,2586,29,1303206766,1303207666,3,2,900
23212779@N04,2586,28,1303216492,1303217392,1,2,900
23212779@N04,2587,12,1304244310,1304244550,1,1,240
23212779@N04,2588,29,1307944138,1307945038,2,2,900
23212779@N04,2588,28,1307957725,1307958625,1,2,900
23212779@N04,2589,26,1308805780,1308806680,1,1,900
23212779@N04,2590,26,1310484915,1310485815,1,1,900
23212779@N04,2591,16,1314900710,1314900980,1,1,270
23212779@N04,2592,26,1316791959,1316792859,1,1,900
23212779@N04,2593,24,1316866936,1316867716,1,1,780
23212779@N04,2594,12,1318838171,1318838411,1,1,240
23212779@N04,2595,12,1319341764,1319342004,2,2,240
23212779@N04,2595,26,1319353792,1319354692,1,2,900
23212779@N04,2596,17,1319621528,1319621828,1,1,300
23212779@N04,2597,26,1321617182,1321618082,2,2,900
23212779@N04,2597,1,1321633619,1321633679,1,2,60
23212779@N04,2598,22,1323949608,1323950208,2,2,600
23212779@N04,2598,25,1323961896,1323962736,1,2,840
23212779@N04,2599,12,1324015135,1324015375,1,1,240
23212779@N04,2600,26,1326345252,1326346152,2,2,900
23212779@N04,2600,17,1326354105,1326354405,1,2,300
23212779@N04,2601,12,1327652951,1327653191,1,1,240
23212779@N04,2602,26,1330467195,1330468095,4,1,900
23212779@N04,2603,26,1330548012,1330548912,1,1,900
23212779@N04,2604,29,1336126308,1336127208,2,2,900
23212779@N04,2604,21,1336128953,1336129523,1,2,570
23212779@N04,2605,1,1350535242,1350535302,1,1,60
23212779@N04,2606,28,1352646344,1352647244,1,1,900
23212779@N04,2607,3,1354075617,1354075707,1,1,90
23212779@N04,2608,26,1354232873,1354233773,1,1,900
23212779@N04,2609,16,1355920222,1355920492,1,1,270
23212779@N04,2610,24,1357898777,1357899557,1,1,780
23218963@N00,2611,16,1428700285,1428700555,4,4,270
23218963@N00,2611,24,1428703866,1428704044,2,4,178
23218963@N00,2611,15,1428704044,1428704314,2,4,270
23218963@N00,2611,13,1428712093,1428712333,1,4,240
23218963@N00,2612,15,1471076056,1471076295,3,3,239
23218963@N00,2612,24,1471076295,1471077075,2,3,780
23218963@N00,2612,12,1471077422,1471077662,1,3,240
23218963@N00,2613,27,1471303416,1471304316,32,3,900
23218963@N00,2613,17,1471310184,1471310484,2,3,300
23218963@N00,2613,30,1471318795,1471319875,2,3,1080
23218963@N00,2614,10,1471414165,1471414405,2,2,240
23218963@N00,2614,7,1471421775,1471421955,2,2,180
23249325@N08,2615,29,1425084914,1425085814,1,1,900
23322134@N02,2616,29,1218718193,1218719093,5,2,900
23322134@N02,2616,20,1218721524,1218722064,3,2,540
23322134@N02,2617,1,1218760308,1218760368,4,19,60
23322134@N02,2617,28,1218760865,1218761765,2,19,900
23322134@N02,2617,3,1218763533,1218763623,4,19,90
23322134@N02,2617,21,1218764449,1218765019,2,19,570
23322134@N02,2617,10,1218766441,1218766681,2,19,240
23322134@N02,2617,30,1218766717,1218767797,2,19,1080
23322134@N02,2617,22,1218768128,1218768209,3,19,81
23322134@N02,2617,14,1218768209,1218768449,3,19,240
23322134@N02,2617,22,1218769876,1218770476,2,19,600
23322134@N02,2617,14,1218771377,1218771617,2,19,240
23322134@N02,2617,22,1218771791,1218772391,3,19,600
23322134@N02,2617,20,1218774904,1218775444,2,19,540
23322134@N02,2617,28,1218777676,1218778576,2,19,900
23322134@N02,2617,26,1218793938,1218794838,6,19,900
23322134@N02,2617,10,1218795035,1218795275,3,19,240
23322134@N02,2617,6,1218795899,1218796019,2,19,120
23322134@N02,2617,29,1218797524,1218798424,6,19,900
23322134@N02,2617,17,1218807063,1218807363,6,19,300
23322134@N02,2617,19,1218811935,1218812475,2,19,540
23322134@N02,2618,1,1218844103,1218844163,2,3,60
23322134@N02,2618,24,1218846942,1218847305,2,3,363
23322134@N02,2618,12,1218847305,1218847545,1,3,240
23322134@N02,2619,13,1250225012,1250225252,2,2,240
23322134@N02,2619,29,1250234471,1250235371,1,2,900
23322134@N02,2620,3,1250297393,1250297483,2,11,90
23322134@N02,2620,20,1250304762,1250305302,2,11,540
23322134@N02,2620,29,1250309302,1250310202,2,11,900
23322134@N02,2620,30,1250314188,1250315199,3,11,1011
23322134@N02,2620,4,1250315199,1250315300,2,11,101
23322134@N02,2620,20,1250321739,1250321760,2,11,21
23322134@N02,2620,16,1250321760,1250322030,3,11,270
23322134@N02,2620,26,1250322100,1250323000,5,11,900
23322134@N02,2620,27,1250335413,1250336292,2,11,879
23322134@N02,2620,16,1250336292,1250336562,2,11,270
23322134@N02,2620,26,1250337802,1250338702,1,11,900
23322134@N02,2621,25,1250385070,1250385910,1,1,840
23322134@N02,2622,28,1250415592,1250416492,2,3,900
23322134@N02,2622,22,1250417574,1250418174,2,3,600
23322134@N02,2622,28,1250422805,1250423705,1,3,900
23322958@N08,2623,17,1311470794,1311471094,1,1,300
23369489@N07,2624,3,1451519872,1451519962,1,1,90
23375196@N06,2625,28,1298671314,1298671459,2,7,145
23375196@N06,2625,26,1298671459,1298672359,2,7,900
23375196@N06,2625,10,1298672606,1298672846,6,7,240
23375196@N06,2625,29,1298674948,1298675515,3,7,567
23375196@N06,2625,30,1298675515,1298676431,5,7,916
23375196@N06,2625,11,1298676431,1298676671,9,7,240
23375196@N06,2625,28,1298683301,1298684201,2,7,900
23375196@N06,2626,24,1328752369,1328752828,2,2,459
23375196@N06,2626,25,1328752828,1328753668,1,2,840
23375196@N06,2627,8,1328909975,1328910155,2,4,180
23375196@N06,2627,21,1328910522,1328911092,2,4,570
23375196@N06,2627,3,1328911248,1328911338,2,4,90
23375196@N06,2627,13,1328911770,1328912010,2,4,240
23375196@N06,2628,1,1328952956,1328953016,14,1,60
23399885@N00,2629,15,1304953252,1304953522,18,3,270
23399885@N00,2629,26,1304957180,1304957997,2,3,817
23399885@N00,2629,29,1304957997,1304958897,1,3,900
23399885@N00,2630,22,1305017073,1305017673,9,6,600
23399885@N00,2630,21,1305021952,1305022522,13,6,570
23399885@N00,2630,17,1305023579,1305023879,5,6,300
23399885@N00,2630,26,1305030303,1305030441,5,6,138
23399885@N00,2630,21,1305030441,1305031011,14,6,570
23399885@N00,2630,25,1305034378,1305035218,4,6,840
23403837@N05,2631,29,1293489925,1293490825,2,1,900
23403837@N05,2632,29,1293529461,1293530361,1,1,900
23404661@N06,2633,26,1362558947,1362559847,1,1,900
23405060@N03,2634,12,1202598962,1202599202,2,2,240
23405060@N03,2634,10,1202613234,1202613474,1,2,240
23411300@N00,2635,23,1428992135,1428992735,2,2,600
23411300@N00,2635,18,1429002794,1429003244,2,2,450
23411300@N00,2636,17,1429145350,1429145650,1,1,300
23450846@N07,2637,20,1257067982,1257068522,1,1,540
23450846@N07,2638,26,1291468926,1291469826,1,1,900
23450846@N07,2639,29,1291644830,1291645730,1,1,900
23450846@N07,2640,20,1292905519,1292906059,2,3,540
23450846@N07,2640,13,1292914508,1292914748,2,3,240
23450846@N07,2640,29,1292926677,1292927577,1,3,900
23450846@N07,2641,30,1293463801,1293464881,1,1,1080
23450846@N07,2642,30,1293506340,1293507420,4,3,1080
23450846@N07,2642,22,1293509904,1293510504,3,3,600
23450846@N07,2642,20,1293532123,1293532663,1,3,540
23450846@N07,2643,26,1310451115,1310452015,1,1,900
23450846@N07,2644,26,1324560067,1324560967,1,1,900
23450846@N07,2645,26,1325341486,1325342386,1,1,900
23450846@N07,2646,28,1326174912,1326175812,2,2,900
23450846@N07,2646,30,1326183346,1326184426,1,2,1080
23450846@N07,2647,26,1330463388,1330464288,1,1,900
23450846@N07,2648,18,1346745923,1346746373,1,1,450
23450846@N07,2649,28,1357392596,1357393496,1,1,900
23450846@N07,2650,13,1369350524,1369350764,1,1,240
23450846@N07,2651,9,1371729074,1371729254,1,1,180
23450846@N07,2652,16,1373547539,1373547809,1,1,270
23450846@N07,2653,28,1393681793,1393682693,1,1,900
23450846@N07,2654,30,1394967886,1394967982,3,2,96
23450846@N07,2654,4,1394967982,1394968083,1,2,101
23450846@N07,2655,29,1397399781,1397400681,1,1,900
23450846@N07,2656,28,1404673799,1404674699,1,1,900
23450846@N07,2657,29,1408843325,1408844225,1,1,900
23450846@N07,2658,26,1408987680,1408988580,1,1,900
23450846@N07,2659,26,1410278789,1410279689,1,1,900
23450846@N07,2660,26,1421410631,1421411531,1,1,900
23450846@N07,2661,20,1432536975,1432537515,1,1,540
23450846@N07,2662,28,1438775035,1438775935,1,1,900
23459187@N07,2663,12,1306931790,1306931798,2,2,8
23459187@N07,2663,16,1306931798,1306932068,1,2,270
23484004@N03,2664,3,1324296030,1324296120,1,1,90
23496566@N07,2665,1,1342833207,1342833267,2,3,60
23496566@N07,2665,25,1342836734,1342837574,2,3,840
23496566@N07,2665,1,1342860665,1342860725,1,3,60
23496566@N07,2666,25,1342925270,1342926110,9,1,840
23508660@N06,2667,13,1349558238,1349558478,1,1,240
23517140@N07,2668,15,1334053395,1334053665,1,1,270
23517147@N00,2669,28,1289903866,1289904766,1,1,900
23555295@N04,2670,18,1206683087,1206683537,2,2,450
23555295@N04,2670,23,1206684224,1206684824,1,2,600
23571697@N00,2671,26,1218600413,1218601313,2,3,900
23571697@N00,2671,1,1218601595,1218601655,2,3,60
23571697@N00,2671,20,1218602265,1218602805,1,3,540
23571697@N00,2672,28,1221306024,1221306924,1,1,900
23571697@N00,2673,20,1225005029,1225005569,1,1,540
23571697@N00,2674,28,1232625903,1232626803,1,1,900
23571697@N00,2675,19,1270038136,1270038676,1,1,540
23571697@N00,2676,20,1351050346,1351050886,1,1,540
23571697@N00,2677,1,1363930544,1363930604,1,1,60
23571697@N00,2678,26,1383711325,1383712225,2,1,900
23571697@N00,2679,28,1384309710,1384310610,2,1,900
23579531@N07,2680,26,1225023759,1225024659,9,1,900
23600002@N05,2681,26,1293379516,1293380416,48,1,900
23621009@N07,2682,28,1202167374,1202167688,3,10,314
23621009@N07,2682,12,1202167688,1202167928,2,10,240
23621009@N07,2682,26,1202168342,1202169242,2,10,900
23621009@N07,2682,19,1202169811,1202170351,2,10,540
23621009@N07,2682,29,1202173043,1202173943,3,10,900
23621009@N07,2682,10,1202178498,1202178738,2,10,240
23621009@N07,2682,4,1202180452,1202180553,5,10,101
23621009@N07,2682,17,1202183931,1202184231,4,10,300
23621009@N07,2682,26,1202207226,1202208126,7,10,900
23621009@N07,2682,28,1202208492,1202209392,1,10,900
23631144@N02,2683,29,1214194134,1214195034,1,1,900
23645312@N03,2684,26,1262018799,1262019699,1,1,900
23651429@N03,2685,26,1201908108,1201909008,1,1,900
23653693@N04,2686,27,1377415117,1377416017,2,1,900
23654380@N00,2687,28,1257725040,1257725940,3,12,900
23654380@N00,2687,21,1257727618,1257728188,10,12,570
23654380@N00,2687,4,1257728699,1257728800,2,12,101
23654380@N00,2687,7,1257728908,1257728965,4,12,57
23654380@N00,2687,4,1257728965,1257729066,2,12,101
23654380@N00,2687,7,1257729395,1257729575,5,12,180
23654380@N00,2687,12,1257733646,1257733886,8,12,240
23654380@N00,2687,13,1257739921,1257740161,25,12,240
23654380@N00,2687,29,1257743416,1257744316,16,12,900
23654380@N00,2687,31,1257748008,1257749508,6,12,1500
23654380@N00,2687,26,1257755745,1257756645,13,12,900
23654380@N00,2687,28,1257757104,1257758004,6,12,900
23673310@N02,2688,1,1241907994,1241908054,2,12,60
23673310@N02,2688,16,1241909601,1241909871,2,12,270
23673310@N02,2688,27,1241910163,1241911063,3,12,900
23673310@N02,2688,10,1241913002,1241913242,3,12,240
23673310@N02,2688,30,1241913670,1241913900,2,12,230
23673310@N02,2688,22,1241913900,1241914500,7,12,600
23673310@N02,2688,19,1241920384,1241920924,7,12,540
23673310@N02,2688,18,1241921294,1241921744,4,12,450
23673310@N02,2688,26,1241922673,1241923099,2,12,426
23673310@N02,2688,25,1241923099,1241923939,11,12,840
23673310@N02,2688,29,1241927863,1241928763,2,12,900
23673310@N02,2688,24,1241949543,1241950323,4,12,780
23673310@N02,2689,31,1313837956,1313839456,7,2,1500
23673310@N02,2689,27,1313840702,1313841602,5,2,900
23673310@N02,2690,1,1313966922,1313966982,2,17,60
23673310@N02,2690,28,1313967019,1313967919,2,17,900
23673310@N02,2690,5,1313969156,1313969276,2,17,120
23673310@N02,2690,16,1313969558,1313969828,3,17,270
23673310@N02,2690,22,1313971521,1313972121,3,17,600
23673310@N02,2690,10,1313977449,1313977689,2,17,240
23673310@N02,2690,13,1313977712,1313977952,9,17,240
23673310@N02,2690,24,1313981022,1313981802,2,17,780
23673310@N02,2690,28,1313990748,1313991648,2,17,900
23673310@N02,2690,1,1313992458,1313992518,2,17,60
23673310@N02,2690,28,1313993104,1313994004,33,17,900
23673310@N02,2690,26,1314003897,1314004797,3,17,900
23673310@N02,2690,25,1314009022,1314009862,14,17,840
23673310@N02,2690,28,1314011876,1314012551,2,17,675
23673310@N02,2690,27,1314012551,1314012835,4,17,284
23673310@N02,2690,28,1314012835,1314012851,2,17,16
23673310@N02,2690,27,1314012851,1314013751,3,17,900
23673310@N02,2691,28,1314062844,1314063230,2,7,386
23673310@N02,2691,5,1314063230,1314063350,3,7,120
23673310@N02,2691,4,1314063574,1314063675,15,7,101
23673310@N02,2691,18,1314068644,1314068653,2,7,9
23673310@N02,2691,26,1314068653,1314069553,2,7,900
23673310@N02,2691,13,1314073577,1314073608,2,7,31
23673310@N02,2691,12,1314073608,1314073848,1,7,240
23673310@N02,2692,20,1369895689,1369896229,2,3,540
23673310@N02,2692,13,1369899579,1369899819,4,3,240
23673310@N02,2692,8,1369903402,1369903582,27,3,180
23673310@N02,2693,24,1369963752,1369964532,2,4,780
23673310@N02,2693,3,1369964704,1369964794,2,4,90
23673310@N02,2693,16,1369966580,1369966850,2,4,270
23673310@N02,2693,29,1369970153,1369971053,3,4,900
23677659@N00,2694,19,1412984245,1412984785,1,1,540
23679036@N04,2695,28,1396746450,1396747350,2,2,900
23679036@N04,2695,20,1396747925,1396748465,1,2,540
23679036@N04,2696,20,1396857638,1396858178,1,1,540
23679036@N04,2697,26,1426146001,1426146901,1,1,900
23684486@N07,2698,12,1188732226,1188732226,3,6,0
23684486@N07,2698,16,1188732226,1188732226,2,6,0
23684486@N07,2698,23,1188732226,1188732226,3,6,0
23684486@N07,2698,25,1188732226,1188732226,2,6,0
23684486@N07,2698,26,1188732226,1188732226,3,6,0
23684486@N07,2698,28,1188732226,1188733126,3,6,900
23684642@N08,2699,26,1244764302,1244765202,2,16,900
23684642@N08,2699,21,1244767726,1244767814,2,16,88
23684642@N08,2699,4,1244767814,1244767915,2,16,101
23684642@N08,2699,21,1244768028,1244768568,3,16,540
23684642@N08,2699,25,1244768568,1244769408,4,16,840
23684642@N08,2699,15,1244771366,1244771636,2,16,270
23684642@N08,2699,27,1244771845,1244772081,2,16,236
23684642@N08,2699,15,1244772081,1244772351,6,16,270
23684642@N08,2699,27,1244777696,1244778596,4,16,900
23684642@N08,2699,24,1244779419,1244780199,3,16,780
23684642@N08,2699,12,1244787076,1244787316,2,16,240
23684642@N08,2699,13,1244787922,1244788162,6,16,240
23684642@N08,2699,21,1244797496,1244798066,3,16,570
23684642@N08,2699,25,1244798343,1244799183,2,16,840
23684642@N08,2699,16,1244801943,1244802213,2,16,270
23684642@N08,2699,28,1244802460,1244803360,4,16,900
23684642@N08,2700,26,1244933313,1244933546,4,18,233
23684642@N08,2700,18,1244933546,1244933577,2,18,31
23684642@N08,2700,23,1244933577,1244934177,2,18,600
23684642@N08,2700,29,1244935673,1244935746,2,18,73
23684642@N08,2700,18,1244935746,1244936183,2,18,437
23684642@N08,2700,28,1244936183,1244936511,2,18,328
23684642@N08,2700,29,1244936511,1244936672,2,18,161
23684642@N08,2700,19,1244936672,1244937212,5,18,540
23684642@N08,2700,30,1244938789,1244939472,2,18,683
23684642@N08,2700,20,1244939472,1244940012,2,18,540
23684642@N08,2700,22,1244946094,1244946694,2,18,600
23684642@N08,2700,29,1244947230,1244947268,2,18,38
23684642@N08,2700,19,1244947268,1244947808,2,18,540
23684642@N08,2700,23,1244948775,1244949375,2,18,600
23684642@N08,2700,16,1244955460,1244955730,3,18,270
23684642@N08,2700,26,1244956049,1244956949,2,18,900
23684642@N08,2700,16,1244961945,1244962215,5,18,270
23684642@N08,2700,24,1244963488,1244964268,1,18,780
23684642@N08,2701,1,1245116000,1245116009,2,16,9
23684642@N08,2701,28,1245116009,1245116099,3,16,90
23684642@N08,2701,27,1245116099,1245116113,2,16,14
23684642@N08,2701,16,1245116113,1245116321,3,16,208
23684642@N08,2701,26,1245116321,1245117221,3,16,900
23684642@N08,2701,21,1245122954,1245123300,2,16,346
23684642@N08,2701,3,1245123300,1245123390,2,16,90
23684642@N08,2701,7,1245124885,1245125065,5,16,180
23684642@N08,2701,11,1245126889,1245127129,2,16,240
23684642@N08,2701,4,1245127186,1245127287,2,16,101
23684642@N08,2701,7,1245127949,1245128129,2,16,180
23684642@N08,2701,30,1245128743,1245129541,2,16,798
23684642@N08,2701,29,1245129541,1245130441,4,16,900
23684642@N08,2701,30,1245134260,1245135340,2,16,1080
23684642@N08,2701,14,1245139008,1245139248,3,16,240
23684642@N08,2701,17,1245148898,1245149198,2,16,300
23684642@N08,2702,27,1251593723,1251594623,2,2,900
23684642@N08,2702,23,1251610868,1251611468,1,2,600
23684642@N08,2703,31,1251681820,1251682243,2,2,423
23684642@N08,2703,22,1251682243,1251682843,1,2,600
23684642@N08,2704,1,1251755628,1251755688,2,8,60
23684642@N08,2704,29,1251766465,1251767365,2,8,900
23684642@N08,2704,18,1251770468,1251770918,3,8,450
23684642@N08,2704,19,1251771173,1251771695,3,8,522
23684642@N08,2704,23,1251771695,1251772295,2,8,600
23684642@N08,2704,16,1251775294,1251775564,2,8,270
23684642@N08,2704,26,1251775706,1251776606,2,8,900
23684642@N08,2704,18,1251780332,1251780782,1,8,450
23684642@N08,2705,12,1251849829,1251850069,2,4,240
23684642@N08,2705,16,1251850112,1251850382,3,4,270
23684642@N08,2705,30,1251883479,1251884559,2,4,1080
23684642@N08,2705,29,1251886930,1251887830,2,4,900
23684642@N08,2706,18,1251933636,1251934086,2,1,450
23684642@N08,2707,29,1251968418,1251969318,1,1,900
23688169@N00,2708,17,1385532081,1385532381,2,2,300
23688169@N00,2708,25,1385540940,1385541780,1,2,840
23693552@N03,2709,1,1340875059,1340875119,2,1,60
23693552@N03,2710,28,1340941397,1340941900,3,2,503
23693552@N03,2710,1,1340941900,1340941960,1,2,60
23693552@N03,2711,13,1341020153,1341020393,1,1,240
23693552@N03,2712,30,1342680237,1342681317,2,2,1080
23693552@N03,2712,26,1342697679,1342698579,1,2,900
23693552@N03,2713,16,1343017086,1343017356,2,5,270
23693552@N03,2713,1,1343040778,1343040838,2,5,60
23693552@N03,2713,28,1343040956,1343041856,2,5,900
23693552@N03,2713,29,1343042735,1343042796,2,5,61
23693552@N03,2713,26,1343042796,1343043696,1,5,900
23694509@N06,2714,1,1428355583,1428355643,1,1,60
23694509@N06,2715,23,1428486174,1428486774,1,1,600
23708393@N07,2716,17,1246840893,1246841193,1,1,300
23708590@N03,2717,11,1327108346,1327108586,2,2,240
23708590@N03,2717,28,1327121174,1327122074,1,2,900
23708590@N03,2718,1,1330908093,1330908153,1,1,60
23708590@N03,2719,4,1332298086,1332298187,1,1,101
23708590@N03,2720,1,1340012050,1340012110,1,1,60
23708590@N03,2721,9,1346833923,1346834065,2,2,142
23708590@N03,2721,11,1346834065,1346834305,1,2,240
23708590@N03,2722,26,1358743476,1358744376,1,1,900
23708590@N03,2723,28,1363400970,1363401870,2,1,900
23708590@N03,2724,7,1378099615,1378099795,1,1,180
23708590@N03,2725,11,1378955053,1378955293,2,2,240
23708590@N03,2725,21,1378959406,1378959976,1,2,570
23708590@N03,2726,22,1381195191,1381195791,1,1,600
23716112@N06,2727,1,1371960163,1371960223,4,15,60
23716112@N06,2727,26,1371960734,1371961505,4,15,771
23716112@N06,2727,30,1371961505,1371962585,3,15,1080
23716112@N06,2727,18,1371963008,1371963458,5,15,450
23716112@N06,2727,29,1371965653,1371966553,2,15,900
23716112@N06,2727,14,1371970251,1371970260,3,15,9
23716112@N06,2727,29,1371970260,1371970296,2,15,36
23716112@N06,2727,14,1371970296,1371970536,3,15,240
23716112@N06,2727,22,1371971251,1371971851,3,15,600
23716112@N06,2727,29,1371974504,1371975404,2,15,900
23716112@N06,2727,26,1371976184,1371976440,4,15,256
23716112@N06,2727,6,1371976440,1371976560,2,15,120
23716112@N06,2727,17,1371986234,1371986534,3,15,300
23716112@N06,2727,16,1371986806,1371987076,6,15,270
23716112@N06,2727,1,1371988755,1371988815,1,15,60
23716112@N06,2728,28,1372045095,1372045995,3,3,900
23716112@N06,2728,13,1372050804,1372051044,2,3,240
23716112@N06,2728,28,1372055413,1372056313,3,3,900
23716112@N06,2729,1,1372110153,1372110169,2,13,16
23716112@N06,2729,28,1372110169,1372110325,9,13,156
23716112@N06,2729,26,1372110325,1372110329,2,13,4
23716112@N06,2729,12,1372110329,1372110569,2,13,240
23716112@N06,2729,17,1372112218,1372112518,4,13,300
23716112@N06,2729,26,1372113275,1372113358,4,13,83
23716112@N06,2729,30,1372113358,1372113442,6,13,84
23716112@N06,2729,29,1372113442,1372113554,3,13,112
23716112@N06,2729,31,1372113554,1372115054,3,13,1500
23716112@N06,2729,7,1372115440,1372115620,3,13,180
23716112@N06,2729,18,1372118017,1372118467,7,13,450
23716112@N06,2729,26,1372120508,1372121408,5,13,900
23716112@N06,2729,1,1372122097,1372122157,3,13,60
23720661@N08,2730,1,1225944480,1225944508,2,5,28
23720661@N08,2730,28,1225944508,1225945408,2,5,900
23720661@N08,2730,29,1225946418,1225946640,2,5,222
23720661@N08,2730,20,1225946640,1225947180,2,5,540
23720661@N08,2730,28,1225949803,1225950703,1,5,900
23720661@N08,2731,17,1226055103,1226055149,2,2,46
23720661@N08,2731,27,1226055149,1226056049,1,2,900
23720661@N08,2732,29,1226112526,1226112707,2,7,181
23720661@N08,2732,22,1226112707,1226113307,3,7,600
23720661@N08,2732,30,1226117753,1226118833,2,7,1080
23720661@N08,2732,20,1226123427,1226123967,2,7,540
23720661@N08,2732,29,1226124032,1226124191,5,7,159
23720661@N08,2732,30,1226124191,1226125271,2,7,1080
23720661@N08,2732,13,1226131792,1226132032,1,7,240
23720661@N08,2733,1,1226193557,1226193617,2,7,60
23720661@N08,2733,26,1226194016,1226194916,3,7,900
23720661@N08,2733,29,1226196031,1226196931,2,7,900
23720661@N08,2733,20,1226199394,1226199402,2,7,8
23720661@N08,2733,29,1226199402,1226200302,2,7,900
23720661@N08,2733,1,1226200562,1226200622,2,7,60
23720661@N08,2733,28,1226200715,1226201615,1,7,900
23720661@N08,2734,26,1226660390,1226661290,1,1,900
23720661@N08,2735,29,1226720751,1226721651,2,2,900
23720661@N08,2735,20,1226734691,1226735231,1,2,540
23720661@N08,2736,30,1227061820,1227062900,1,1,1080
23720661@N08,2737,20,1227162162,1227162702,1,1,540
23720661@N08,2738,26,1227331270,1227332170,2,2,900
23720661@N08,2738,29,1227334088,1227334988,1,2,900
23720661@N08,2739,29,1227413309,1227414209,1,1,900
23720661@N08,2740,20,1227665049,1227665589,1,1,540
23720661@N08,2741,23,1227787322,1227787922,1,1,600
23720661@N08,2742,29,1227856304,1227857204,1,1,900
23720661@N08,2743,20,1227917748,1227918288,1,1,540
23720661@N08,2744,20,1227952514,1227953054,1,1,540
23720661@N08,2745,26,1228118194,1228119094,1,1,900
23720661@N08,2746,20,1228521342,1228521882,1,1,540
23720661@N08,2747,26,1228821984,1228822884,1,1,900
23720661@N08,2748,26,1229179586,1229180486,1,1,900
23720661@N08,2749,26,1229239971,1229240871,1,1,900
23720661@N08,2750,30,1229311863,1229312943,1,1,1080
23720661@N08,2751,28,1230165867,1230166767,1,1,900
23720661@N08,2752,20,1230613250,1230613790,1,1,540
23720661@N08,2753,1,1230988134,1230988194,1,1,60
23720661@N08,2754,30,1231246017,1231247097,1,1,1080
23720661@N08,2755,20,1231926571,1231927111,1,1,540
23720661@N08,2756,28,1232856484,1232857384,1,1,900
23720661@N08,2757,1,1232953584,1232953644,1,1,60
23720661@N08,2758,26,1237789518,1237790418,1,1,900
23720661@N08,2759,23,1240931897,1240932497,1,1,600
23720661@N08,2760,29,1241255960,1241256860,1,1,900
23720661@N08,2761,26,1241679915,1241680815,1,1,900
23720661@N08,2762,1,1243957563,1243957623,1,1,60
23720661@N08,2763,17,1247312538,1247312838,1,1,300
23751350@N02,2764,5,1395098777,1395098897,1,1,120
23759021@N07,2765,28,1343167104,1343167207,2,4,103
23759021@N07,2765,26,1343167207,1343167465,4,4,258
23759021@N07,2765,29,1343167465,1343167541,2,4,76
23759021@N07,2765,16,1343167541,1343167811,1,4,270
23806189@N00,2766,31,1303352100,1303353600,2,2,1500
23806189@N00,2766,16,1303373376,1303373646,1,2,270
23806189@N00,2767,28,1384488087,1384488987,1,1,900
23807199@N00,2768,1,1278888535,1278888595,2,5,60
23807199@N00,2768,25,1278891481,1278892321,2,5,840
23807199@N00,2768,29,1278896470,1278897370,3,5,900
23807199@N00,2768,20,1278897402,1278897942,2,5,540
23807199@N00,2768,18,1278906473,1278906923,1,5,450
23807199@N00,2769,5,1278970956,1278971076,2,5,120
23807199@N00,2769,24,1278973676,1278974456,2,5,780
23807199@N00,2769,29,1278977580,1278978480,2,5,900
23807199@N00,2769,31,1278980733,1278982233,3,5,1500
23807199@N00,2769,18,1278984064,1278984514,2,5,450
23807199@N00,2770,25,1279014130,1279014970,4,5,840
23807199@N00,2770,7,1279016039,1279016219,5,5,180
23807199@N00,2770,3,1279018155,1279018245,2,5,90
23807199@N00,2770,7,1279020967,1279021147,9,5,180
23807199@N00,2770,26,1279022641,1279023541,1,5,900
23807199@N00,2771,7,1279067160,1279067340,4,3,180
23807199@N00,2771,3,1279068893,1279068983,2,3,90
23807199@N00,2771,16,1279070559,1279070829,1,3,270
23807199@N00,2772,1,1309992434,1309992494,2,7,60
23807199@N00,2772,5,1309995320,1309995440,2,7,120
23807199@N00,2772,7,1309996002,1309996182,2,7,180
23807199@N00,2772,21,1309997488,1309998058,3,7,570
23807199@N00,2772,25,1309999676,1310000516,9,7,840
23807199@N00,2772,29,1310007411,1310008311,3,7,900
23807199@N00,2772,17,1310013470,1310013770,3,7,300
23807199@N00,2773,1,1310080174,1310080234,2,10,60
23807199@N00,2773,28,1310082183,1310083083,2,10,900
23807199@N00,2773,4,1310085528,1310085629,4,10,101
23807199@N00,2773,25,1310087251,1310088091,4,10,840
23807199@N00,2773,17,1310089514,1310089814,10,10,300
23807199@N00,2773,23,1310091990,1310092590,2,10,600
23807199@N00,2773,29,1310096445,1310097345,6,10,900
23807199@N00,2773,18,1310099617,1310100067,11,10,450
23807199@N00,2773,29,1310107439,1310108339,2,10,900
23807199@N00,2773,7,1310110475,1310110655,5,10,180
23807199@N00,2774,1,1371420198,1371420258,2,11,60
23807199@N00,2774,25,1371420897,1371421737,8,11,840
23807199@N00,2774,7,1371427347,1371427527,3,11,180
23807199@N00,2774,4,1371427991,1371428092,4,11,101
23807199@N00,2774,29,1371432954,1371433854,6,11,900
23807199@N00,2774,20,1371435834,1371436374,2,11,540
23807199@N00,2774,16,1371455925,1371456195,5,11,270
23807199@N00,2774,24,1371457842,1371458622,2,11,780
23807199@N00,2774,25,1371458696,1371459536,5,11,840
23807199@N00,2774,11,1371462761,1371462776,2,11,15
23807199@N00,2774,25,1371462776,1371463616,2,11,840
23807199@N00,2775,6,1371520554,1371520674,4,3,120
23807199@N00,2775,28,1371536002,1371536902,2,3,900
23807199@N00,2775,31,1371538689,1371540189,1,3,1500
23807199@N00,2776,29,1371612238,1371613138,4,5,900
23807199@N00,2776,18,1371614007,1371614457,5,5,450
23807199@N00,2776,13,1371616965,1371617205,2,5,240
23807199@N00,2776,25,1371621789,1371622629,5,5,840
23807199@N00,2776,29,1371633122,1371634022,2,5,900
23807199@N00,2777,23,1371683881,1371684481,2,5,600
23807199@N00,2777,18,1371685547,1371685997,2,5,450
23807199@N00,2777,12,1371688138,1371688378,3,5,240
23807199@N00,2777,24,1371689269,1371690049,5,5,780
23807199@N00,2777,28,1371693336,1371694236,1,5,900
23807199@N00,2778,25,1419574940,1419575780,1,1,840
23807199@N00,2779,6,1419636244,1419636364,3,2,120
23807199@N00,2779,25,1419663066,1419663906,19,2,840
23807199@N00,2780,18,1419725831,1419726281,3,1,450
23807199@N00,2781,25,1419806716,1419807556,2,2,840
23807199@N00,2781,13,1419809930,1419810170,4,2,240
23835518@N02,2782,16,1293986680,1293986686,4,2,6
23835518@N02,2782,31,1293986686,1293988186,1,2,1500
23836685@N07,2783,30,1294703527,1294704607,40,1,1080
23837366@N00,2784,20,1352002529,1352003069,1,1,540
23837366@N00,2785,14,1355030365,1355030605,1,1,240
23837366@N00,2786,25,1355914646,1355915486,2,3,840
23837366@N00,2786,26,1355916246,1355916360,2,3,114
23837366@N00,2786,28,1355916360,1355917260,1,3,900
23837366@N00,2787,26,1357443461,1357444361,4,5,900
23837366@N00,2787,30,1357446393,1357447473,7,5,1080
23837366@N00,2787,20,1357448831,1357449371,4,5,540
23837366@N00,2787,13,1357456629,1357456869,2,5,240
23837366@N00,2787,26,1357462666,1357463566,1,5,900
23837366@N00,2788,29,1359859478,1359859505,2,2,27
23837366@N00,2788,31,1359859505,1359861005,1,2,1500
23837366@N00,2789,10,1363320361,1363320601,1,1,240
23837366@N00,2790,7,1368947923,1368948103,2,2,180
23837366@N00,2790,25,1368949378,1368950218,2,2,840
23837366@N00,2791,1,1379914973,1379915033,2,4,60
23837366@N00,2791,28,1379915274,1379916174,3,4,900
23837366@N00,2791,30,1379924565,1379924835,2,4,270
23837366@N00,2791,20,1379924835,1379925375,1,4,540
23837366@N00,2792,1,1380443819,1380443879,2,2,60
23837366@N00,2792,28,1380449235,1380450135,2,2,900
23837366@N00,2793,18,1384659891,1384660341,2,1,450
23837366@N00,2794,28,1387083960,1387084860,1,1,900
23837366@N00,2795,31,1411876882,1411878382,1,1,1500
23837366@N00,2796,16,1434366923,1434367193,2,1,270
23837366@N00,2797,31,1441618310,1441619810,1,1,1500
23837366@N00,2798,20,1445307148,1445307688,2,2,540
23837366@N00,2798,29,1445312538,1445313438,1,2,900
23837366@N00,2799,25,1449820977,1449821817,2,3,840
23837366@N00,2799,20,1449824911,1449825451,2,3,540
23837366@N00,2799,28,1449829120,1449830020,2,3,900
23837366@N00,2800,6,1452046252,1452046372,2,2,120
23837366@N00,2800,22,1452052711,1452053311,6,2,600
23837366@N00,2801,21,1456651038,1456651608,1,1,570
23837366@N00,2802,29,1460886884,1460887784,2,1,900
23837366@N00,2803,26,1465459768,1465460668,2,3,900
23837366@N00,2803,28,1465461073,1465461973,4,3,900
23837366@N00,2803,3,1465464203,1465464293,1,3,90
23858875@N05,2804,22,1237972091,1237972691,1,1,600
23866387@N03,2805,20,1347760607,1347761147,4,3,540
23866387@N03,2805,31,1347761677,1347763177,3,3,1500
23866387@N03,2805,30,1347765433,1347766513,2,3,1080
23866387@N03,2806,5,1350779980,1350780100,3,13,120
23866387@N03,2806,11,1350781011,1350781251,2,13,240
23866387@N03,2806,17,1350798492,1350798792,3,13,300
23866387@N03,2806,28,1350799342,1350800242,2,13,900
23866387@N03,2806,23,1350802684,1350802690,2,13,6
23866387@N03,2806,18,1350802690,1350803140,8,13,450
23866387@N03,2806,23,1350803956,1350804008,5,13,52
23866387@N03,2806,18,1350804008,1350804458,2,13,450
23866387@N03,2806,20,1350804835,1350805375,15,13,540
23866387@N03,2806,22,1350805766,1350806366,2,13,600
23866387@N03,2806,14,1350808029,1350808269,2,13,240
23866387@N03,2806,22,1350808675,1350809275,2,13,600
23866387@N03,2806,28,1350812408,1350813308,1,13,900
23866387@N03,2807,23,1351993134,1351993441,4,5,307
23866387@N03,2807,8,1351993441,1351993621,2,5,180
23866387@N03,2807,30,1351995999,1351997079,3,5,1080
23866387@N03,2807,29,1351998239,1351999139,4,5,900
23866387@N03,2807,22,1352000223,1352000823,4,5,600
23866387@N03,2808,20,1352096230,1352096770,14,2,540
23866387@N03,2808,13,1352098404,1352098644,4,2,240
23866387@N03,2809,1,1353459597,1353459624,2,3,27
23866387@N03,2809,28,1353459624,1353459812,2,3,188
23866387@N03,2809,26,1353459812,1353460712,3,3,900
23866387@N03,2810,1,1354409384,1354409444,2,20,60
23866387@N03,2810,24,1354411760,1354411872,5,20,112
23866387@N03,2810,12,1354411872,1354412112,2,20,240
23866387@N03,2810,25,1354413168,1354414008,18,20,840
23866387@N03,2810,18,1354424416,1354424734,6,20,318
23866387@N03,2810,19,1354424734,1354424770,5,20,36
23866387@N03,2810,29,1354424770,1354424820,3,20,50
23866387@N03,2810,19,1354424820,1354424823,2,20,3
23866387@N03,2810,18,1354424823,1354424924,2,20,101
23866387@N03,2810,19,1354424924,1354425464,2,20,540
23866387@N03,2810,30,1354431047,1354431189,2,20,142
23866387@N03,2810,20,1354431189,1354431729,14,20,540
23866387@N03,2810,25,1354433546,1354434386,5,20,840
23866387@N03,2810,3,1354434640,1354434730,3,20,90
23866387@N03,2810,15,1354434942,1354435212,2,20,270
23866387@N03,2810,26,1354444055,1354444422,2,20,367
23866387@N03,2810,29,1354444422,1354444612,4,20,190
23866387@N03,2810,31,1354444612,1354446031,4,20,1419
23866387@N03,2810,21,1354446031,1354446148,3,20,117
23866387@N03,2810,25,1354446148,1354446988,28,20,840
23866387@N03,2811,30,1355110317,1355111397,6,16,1080
23866387@N03,2811,3,1355113482,1355113572,3,16,90
23866387@N03,2811,15,1355115285,1355115383,4,16,98
23866387@N03,2811,12,1355115383,1355115386,2,16,3
23866387@N03,2811,24,1355115386,1355116166,5,16,780
23866387@N03,2811,29,1355116230,1355116281,2,16,51
23866387@N03,2811,22,1355116281,1355116881,2,16,600
23866387@N03,2811,30,1355117601,1355118681,2,16,1080
23866387@N03,2811,7,1355119887,1355119915,2,16,28
23866387@N03,2811,9,1355119915,1355119928,3,16,13
23866387@N03,2811,6,1355119928,1355120030,5,16,102
23866387@N03,2811,26,1355120030,1355120058,2,16,28
23866387@N03,2811,10,1355120058,1355120298,4,16,240
23866387@N03,2811,21,1355121364,1355121453,6,16,89
23866387@N03,2811,4,1355121453,1355121554,3,16,101
23866387@N03,2811,28,1355122398,1355123298,2,16,900
23866387@N03,2812,21,1357010270,1357010840,2,18,570
23866387@N03,2812,30,1357014605,1357015099,7,18,494
23866387@N03,2812,31,1357015099,1357015102,2,18,3
23866387@N03,2812,22,1357015102,1357015490,5,18,388
23866387@N03,2812,31,1357015490,1357015625,3,18,135
23866387@N03,2812,30,1357015625,1357016577,4,18,952
23866387@N03,2812,14,1357016577,1357016588,2,18,11
23866387@N03,2812,22,1357016588,1357017091,6,18,503
23866387@N03,2812,14,1357017091,1357017331,2,18,240
23866387@N03,2812,31,1357018001,1357018216,3,18,215
23866387@N03,2812,22,1357018216,1357018376,4,18,160
23866387@N03,2812,20,1357018376,1357018916,4,18,540
23866387@N03,2812,29,1357019311,1357019313,2,18,2
23866387@N03,2812,30,1357019313,1357019949,4,18,636
23866387@N03,2812,29,1357019949,1357019991,2,18,42
23866387@N03,2812,31,1357019991,1357020107,7,18,116
23866387@N03,2812,22,1357020107,1357020707,5,18,600
23866387@N03,2812,28,1357021068,1357021968,6,18,900
23866387@N03,2813,29,1362886998,1362887244,2,14,246
23866387@N03,2813,1,1362887244,1362887304,2,14,60
23866387@N03,2813,29,1362888784,1362889035,2,14,251
23866387@N03,2813,20,1362889035,1362889076,2,14,41
23866387@N03,2813,31,1362889076,1362889131,3,14,55
23866387@N03,2813,20,1362889131,1362889166,2,14,35
23866387@N03,2813,31,1362889166,1362889210,2,14,44
23866387@N03,2813,20,1362889210,1362889377,3,14,167
23866387@N03,2813,29,1362889377,1362889486,2,14,109
23866387@N03,2813,20,1362889486,1362890026,4,14,540
23866387@N03,2813,22,1362890434,1362891034,3,14,600
23866387@N03,2813,25,1362893322,1362894162,5,14,840
23866387@N03,2813,15,1362896425,1362896695,5,14,270
23866387@N03,2813,17,1362907687,1362907987,1,14,300
23866387@N03,2814,24,1365302622,1365303402,3,14,780
23866387@N03,2814,15,1365303630,1365303900,2,14,270
23866387@N03,2814,31,1365307802,1365309302,4,14,1500
23866387@N03,2814,20,1365309635,1365309705,3,14,70
23866387@N03,2814,22,1365309705,1365310026,3,14,321
23866387@N03,2814,20,1365310026,1365310136,4,14,110
23866387@N03,2814,14,1365310136,1365310138,2,14,2
23866387@N03,2814,20,1365310138,1365310678,3,14,540
23866387@N03,2814,30,1365312057,1365312375,3,14,318
23866387@N03,2814,29,1365312375,1365312390,2,14,15
23866387@N03,2814,31,1365312390,1365312471,2,14,81
23866387@N03,2814,22,1365312471,1365312728,5,14,257
23866387@N03,2814,31,1365312728,1365314228,2,14,1500
23866387@N03,2814,1,1365315391,1365315451,3,14,60
23866387@N03,2815,18,1367124112,1367124562,2,4,450
23866387@N03,2815,29,1367128356,1367129256,14,4,900
23866387@N03,2815,27,1367131280,1367131619,2,4,339
23866387@N03,2815,15,1367131619,1367131889,1,4,270
23866387@N03,2816,24,1369625782,1369626562,2,8,780
23866387@N03,2816,29,1369628911,1369629811,3,8,900
23866387@N03,2816,14,1369631709,1369631949,3,8,240
23866387@N03,2816,31,1369633516,1369633528,3,8,12
23866387@N03,2816,29,1369633528,1369633547,2,8,19
23866387@N03,2816,31,1369633547,1369633568,2,8,21
23866387@N03,2816,20,1369633568,1369634108,9,8,540
23866387@N03,2816,1,1369637415,1369637475,3,8,60
23866387@N03,2817,1,1373100619,1373100679,3,10,60
23866387@N03,2817,29,1373101461,1373101648,2,10,187
23866387@N03,2817,31,1373101648,1373101712,3,10,64
23866387@N03,2817,29,1373101712,1373102612,3,10,900
23866387@N03,2817,20,1373103470,1373104010,2,10,540
23866387@N03,2817,30,1373104373,1373105247,2,10,874
23866387@N03,2817,6,1373105247,1373105367,2,10,120
23866387@N03,2817,8,1373105934,1373106114,4,10,180
23866387@N03,2817,7,1373106637,1373106817,3,10,180
23866387@N03,2817,9,1373106984,1373107164,1,10,180
23866387@N03,2818,24,1376191719,1376192402,5,11,683
23866387@N03,2818,5,1376192402,1376192522,3,11,120
23866387@N03,2818,7,1376192827,1376193007,6,11,180
23866387@N03,2818,8,1376193060,1376193240,2,11,180
23866387@N03,2818,20,1376194666,1376195206,9,11,540
23866387@N03,2818,19,1376196103,1376196643,9,11,540
23866387@N03,2818,29,1376198434,1376199334,2,11,900
23866387@N03,2818,14,1376199405,1376199436,2,11,31
23866387@N03,2818,22,1376199436,1376199515,2,11,79
23866387@N03,2818,14,1376199515,1376199518,2,11,3
23866387@N03,2818,22,1376199518,1376200118,2,11,600
23866387@N03,2819,31,1380332854,1380333410,2,8,556
23866387@N03,2819,20,1380333410,1380333950,4,8,540
23866387@N03,2819,22,1380334651,1380334737,2,8,86
23866387@N03,2819,20,1380334737,1380335068,12,8,331
23866387@N03,2819,14,1380335068,1380335166,3,8,98
23866387@N03,2819,20,1380335166,1380335389,3,8,223
23866387@N03,2819,19,1380335389,1380335929,2,8,540
23866387@N03,2819,30,1380337746,1380338826,1,8,1080
23866387@N03,2820,15,1380942923,1380943193,3,3,270
23866387@N03,2820,1,1380944809,1380944869,2,3,60
23866387@N03,2820,29,1380945908,1380946808,2,3,900
23866387@N03,2821,15,1382922622,1382922779,7,15,157
23866387@N03,2821,17,1382922779,1382922867,8,15,88
23866387@N03,2821,1,1382922867,1382922927,3,15,60
23866387@N03,2821,20,1382923926,1382924146,7,15,220
23866387@N03,2821,22,1382924146,1382924152,2,15,6
23866387@N03,2821,20,1382924152,1382924159,2,15,7
23866387@N03,2821,31,1382924159,1382924323,3,15,164
23866387@N03,2821,20,1382924323,1382924863,11,15,540
23866387@N03,2821,17,1382926172,1382926472,2,15,300
23866387@N03,2821,13,1382929134,1382929374,2,15,240
23866387@N03,2821,22,1382930475,1382931075,2,15,600
23866387@N03,2821,19,1382931694,1382932234,2,15,540
23866387@N03,2821,23,1382933282,1382933785,2,15,503
23866387@N03,2821,18,1382933785,1382934235,3,15,450
23866387@N03,2821,23,1382934887,1382935487,1,15,600
23866387@N03,2822,15,1384661220,1384661490,4,14,270
23866387@N03,2822,31,1384662960,1384664460,2,14,1500
23866387@N03,2822,29,1384664939,1384665460,3,14,521
23866387@N03,2822,28,1384665460,1384666360,2,14,900
23866387@N03,2822,1,1384677221,1384677281,3,14,60
23866387@N03,2822,26,1384678329,1384679229,3,14,900
23866387@N03,2822,3,1384679671,1384679761,3,14,90
23866387@N03,2822,21,1384680068,1384680181,2,14,113
23866387@N03,2822,25,1384680181,1384681021,34,14,840
23866387@N03,2822,24,1384684536,1384685316,5,14,780
23866387@N03,2822,18,1384686257,1384686707,2,14,450
23866387@N03,2822,20,1384688426,1384688966,8,14,540
23866387@N03,2822,21,1384689785,1384689788,3,14,3
23866387@N03,2822,25,1384689788,1384690628,4,14,840
23866387@N03,2823,26,1386562161,1386563007,2,6,846
23866387@N03,2823,3,1386563007,1386563097,2,6,90
23866387@N03,2823,21,1386565071,1386565641,4,6,570
23866387@N03,2823,24,1386566248,1386567028,4,6,780
23866387@N03,2823,21,1386570410,1386570667,3,6,257
23866387@N03,2823,13,1386570667,1386570907,7,6,240
23866387@N03,2824,26,1389492400,1389492721,3,5,321
23866387@N03,2824,25,1389492721,1389493008,3,5,287
23866387@N03,2824,21,1389493008,1389493344,3,5,336
23866387@N03,2824,25,1389493344,1389494184,5,5,840
23866387@N03,2824,22,1389494701,1389495301,2,5,600
23866387@N03,2825,19,1390702534,1390702539,2,6,5
23866387@N03,2825,18,1390702539,1390702919,2,6,380
23866387@N03,2825,31,1390702919,1390703556,2,6,637
23866387@N03,2825,22,1390703556,1390704156,3,6,600
23866387@N03,2825,1,1390712161,1390712221,2,6,60
23866387@N03,2825,19,1390714180,1390714720,2,6,540
23866387@N03,2826,31,1398050993,1398052493,2,8,1500
23866387@N03,2826,30,1398053695,1398054346,2,8,651
23866387@N03,2826,7,1398054346,1398054459,2,8,113
23866387@N03,2826,6,1398054459,1398054574,2,8,115
23866387@N03,2826,7,1398054574,1398054754,2,8,180
23866387@N03,2826,6,1398054838,1398054958,6,8,120
23866387@N03,2826,30,1398055681,1398056761,7,8,1080
23866387@N03,2826,28,1398057327,1398058227,2,8,900
23866387@N03,2827,30,1400383892,1400384003,3,8,111
23866387@N03,2827,29,1400384003,1400384093,2,8,90
23866387@N03,2827,30,1400384093,1400384291,2,8,198
23866387@N03,2827,22,1400384291,1400384542,2,8,251
23866387@N03,2827,31,1400384542,1400384763,2,8,221
23866387@N03,2827,30,1400384763,1400385843,5,8,1080
23866387@N03,2827,28,1400391564,1400392464,2,8,900
23866387@N03,2827,30,1400392555,1400393635,15,8,1080
23866387@N03,2828,12,1408183064,1408183304,3,14,240
23866387@N03,2828,30,1408184802,1408185218,7,14,416
23866387@N03,2828,10,1408185218,1408185331,6,14,113
23866387@N03,2828,30,1408185331,1408186293,7,14,962
23866387@N03,2828,29,1408186293,1408187193,5,14,900
23866387@N03,2828,20,1408188659,1408188691,2,14,32
23866387@N03,2828,14,1408188691,1408188931,3,14,240
23866387@N03,2828,29,1408189163,1408189164,2,14,1
23866387@N03,2828,30,1408189164,1408190244,2,14,1080
23866387@N03,2828,3,1408191062,1408191152,15,14,90
23866387@N03,2828,8,1408191374,1408191400,5,14,26
23866387@N03,2828,5,1408191400,1408191415,5,14,15
23866387@N03,2828,8,1408191415,1408191504,6,14,89
23866387@N03,2828,5,1408191504,1408191624,6,14,120
23866387@N03,2829,17,1410688212,1410688512,3,8,300
23866387@N03,2829,20,1410691326,1410691866,8,8,540
23866387@N03,2829,31,1410691891,1410692165,20,8,274
23866387@N03,2829,22,1410692165,1410692398,14,8,233
23866387@N03,2829,20,1410692398,1410692938,44,8,540
23866387@N03,2829,18,1410694504,1410694954,10,8,450
23866387@N03,2829,17,1410695001,1410695301,6,8,300
23866387@N03,2829,24,1410697151,1410697931,3,8,780
23877122@N08,2830,4,1205363274,1205363375,1,1,101
23877277@N08,2831,25,1319323746,1319324586,1,1,840
23877277@N08,2832,28,1323507422,1323508322,1,1,900
23881252@N00,2833,15,1413438762,1413439032,1,1,270
23933172@N00,2834,27,1227177166,1227178066,2,5,900
23933172@N00,2834,29,1227181066,1227181966,3,5,900
23933172@N00,2834,22,1227184267,1227184867,3,5,600
23933172@N00,2834,28,1227189516,1227189668,2,5,152
23933172@N00,2834,1,1227189668,1227189728,1,5,60
23933172@N00,2835,29,1266712574,1266713474,1,1,900
23944567@N05,2836,28,1224222832,1224223091,2,2,259
23944567@N05,2836,17,1224223091,1224223391,1,2,300
23951075@N06,2837,7,1214370641,1214370821,2,2,180
23951075@N06,2837,21,1214371821,1214372391,1,2,570
23951075@N06,2838,26,1238361184,1238361640,2,2,456
23951075@N06,2838,7,1238361640,1238361820,1,2,180
23951075@N06,2839,7,1255933561,1255933741,1,1,180
23951075@N06,2840,7,1260623880,1260624060,6,1,180
23951075@N06,2841,7,1260729272,1260729452,1,1,180
23951075@N06,2842,28,1262464979,1262465879,3,19,900
23951075@N06,2842,7,1262466843,1262467023,2,19,180
23951075@N06,2842,29,1262467456,1262467518,2,19,62
23951075@N06,2842,20,1262467518,1262468058,2,19,540
23951075@N06,2842,7,1262469531,1262469711,7,19,180
23951075@N06,2842,13,1262474024,1262474107,2,19,83
23951075@N06,2842,7,1262474107,1262474287,6,19,180
23951075@N06,2842,11,1262478724,1262478964,2,19,240
23951075@N06,2842,7,1262490660,1262490840,7,19,180
23951075@N06,2842,30,1262490927,1262490935,3,19,8
23951075@N06,2842,7,1262490935,1262491115,4,19,180
23951075@N06,2842,29,1262491144,1262491153,3,19,9
23951075@N06,2842,7,1262491153,1262491193,3,19,40
23951075@N06,2842,29,1262491193,1262491466,2,19,273
23951075@N06,2842,7,1262491466,1262491510,2,19,44
23951075@N06,2842,29,1262491510,1262492410,3,19,900
23951075@N06,2842,7,1262496757,1262496937,3,19,180
23951075@N06,2842,30,1262498105,1262499185,2,19,1080
23951075@N06,2842,7,1262500774,1262500954,2,19,180
23951075@N06,2843,7,1262562932,1262563112,4,10,180
23951075@N06,2843,22,1262572308,1262572635,3,10,327
23951075@N06,2843,7,1262572635,1262572815,7,10,180
23951075@N06,2843,23,1262574226,1262574578,2,10,352
23951075@N06,2843,7,1262574578,1262574621,3,10,43
23951075@N06,2843,26,1262574621,1262575521,5,10,900
23951075@N06,2843,7,1262576481,1262576656,2,10,175
23951075@N06,2843,26,1262576656,1262577234,2,10,578
23951075@N06,2843,16,1262577234,1262577504,2,10,270
23951075@N06,2843,7,1262587992,1262588172,9,10,180
23951075@N06,2844,26,1262643038,1262643831,2,7,793
23951075@N06,2844,4,1262643831,1262643932,3,7,101
23951075@N06,2844,21,1262644532,1262644846,4,7,314
23951075@N06,2844,7,1262644846,1262645026,3,7,180
23951075@N06,2844,21,1262645698,1262646268,3,7,570
23951075@N06,2844,29,1262649218,1262650118,2,7,900
23951075@N06,2844,28,1262650442,1262651342,1,7,900
23951075@N06,2845,26,1272062249,1272062597,2,14,348
23951075@N06,2845,29,1272062597,1272063497,2,14,900
23951075@N06,2845,13,1272070073,1272070313,7,14,240
23951075@N06,2845,8,1272072031,1272072211,2,14,180
23951075@N06,2845,1,1272093338,1272093398,2,14,60
23951075@N06,2845,26,1272093797,1272094238,4,14,441
23951075@N06,2845,3,1272094238,1272094328,2,14,90
23951075@N06,2845,7,1272094602,1272094638,2,14,36
23951075@N06,2845,10,1272094638,1272094875,2,14,237
23951075@N06,2845,11,1272094875,1272095115,2,14,240
23951075@N06,2845,21,1272095155,1272095725,4,14,570
23951075@N06,2845,10,1272097205,1272097445,2,14,240
23951075@N06,2845,18,1272098587,1272099037,2,14,450
23951075@N06,2845,16,1272099950,1272100220,2,14,270
23951075@N06,2846,11,1272160478,1272160718,2,3,240
23951075@N06,2846,23,1272166161,1272166464,2,3,303
23951075@N06,2846,18,1272166464,1272166914,1,3,450
23951075@N06,2847,27,1277453198,1277454098,3,9,900
23951075@N06,2847,17,1277454366,1277454666,2,9,300
23951075@N06,2847,27,1277455394,1277455642,3,9,248
23951075@N06,2847,16,1277455642,1277455788,2,9,146
23951075@N06,2847,26,1277455788,1277455976,3,9,188
23951075@N06,2847,10,1277455976,1277456216,2,9,240
23951075@N06,2847,6,1277456522,1277456642,2,9,120
23951075@N06,2847,21,1277456697,1277457267,2,9,570
23951075@N06,2847,28,1277457325,1277458225,5,9,900
23951075@N06,2848,28,1277502051,1277502166,2,17,115
23951075@N06,2848,26,1277502166,1277503066,3,17,900
23951075@N06,2848,20,1277504111,1277504651,5,17,540
23951075@N06,2848,29,1277504934,1277505321,4,17,387
23951075@N06,2848,19,1277505321,1277505377,2,17,56
23951075@N06,2848,18,1277505377,1277505429,2,17,52
23951075@N06,2848,19,1277505429,1277505696,3,17,267
23951075@N06,2848,29,1277505696,1277505732,2,17,36
23951075@N06,2848,19,1277505732,1277505963,3,17,231
23951075@N06,2848,18,1277505963,1277506413,3,17,450
23951075@N06,2848,12,1277506597,1277506837,3,17,240
23951075@N06,2848,13,1277508776,1277509016,2,17,240
23951075@N06,2848,3,1277509297,1277509387,2,17,90
23951075@N06,2848,21,1277510432,1277511002,2,17,570
23951075@N06,2848,5,1277511184,1277511304,2,17,120
23951075@N06,2848,3,1277511647,1277511737,2,17,90
23951075@N06,2848,31,1277526179,1277527679,1,17,1500
23951075@N06,2849,26,1277597600,1277598171,2,6,571
23951075@N06,2849,8,1277598171,1277598351,2,6,180
23951075@N06,2849,7,1277599750,1277599930,2,6,180
23951075@N06,2849,21,1277600004,1277600070,2,6,66
23951075@N06,2849,3,1277600070,1277600160,2,6,90
23951075@N06,2849,28,1277603025,1277603925,1,6,900
23951075@N06,2850,26,1288302785,1288303685,7,6,900
23951075@N06,2850,30,1288303686,1288304766,2,6,1080
23951075@N06,2850,29,1288304860,1288305760,4,6,900
23951075@N06,2850,12,1288307849,1288308089,2,6,240
23951075@N06,2850,29,1288314229,1288314736,2,6,507
23951075@N06,2850,20,1288314736,1288315276,2,6,540
23951075@N06,2851,27,1306806589,1306807489,1,1,900
23951075@N06,2852,27,1325473354,1325474254,1,1,900
23951075@N06,2853,28,1325568186,1325569086,1,1,900
23951075@N06,2854,26,1325717877,1325718777,1,1,900
23965310@N07,2855,1,1415605147,1415605207,2,2,60
23965310@N07,2855,13,1415608594,1415608834,1,2,240
23965310@N07,2856,5,1416881791,1416881911,2,5,120
23965310@N07,2856,3,1416882619,1416882709,2,5,90
23965310@N07,2856,29,1416889216,1416890105,2,5,889
23965310@N07,2856,31,1416890105,1416891429,6,5,1324
23965310@N07,2856,22,1416891429,1416892029,1,5,600
23965310@N07,2857,21,1427964655,1427965225,1,1,570
23965310@N07,2858,27,1454733123,1454734023,2,11,900
23965310@N07,2858,4,1454736218,1454736319,2,11,101
23965310@N07,2858,11,1454736419,1454736659,2,11,240
23965310@N07,2858,26,1454739047,1454739236,2,11,189
23965310@N07,2858,23,1454739236,1454739836,2,11,600
23965310@N07,2858,19,1454741617,1454742107,4,11,490
23965310@N07,2858,23,1454742107,1454742707,2,11,600
23965310@N07,2858,26,1454742948,1454743395,2,11,447
23965310@N07,2858,27,1454743395,1454743711,2,11,316
23965310@N07,2858,17,1454743711,1454743986,2,11,275
23965310@N07,2858,15,1454743986,1454744256,17,11,270
23965310@N07,2859,15,1458973739,1458974009,3,6,270
23965310@N07,2859,30,1458985057,1458986137,2,6,1080
23965310@N07,2859,16,1458986541,1458986811,3,6,270
23965310@N07,2859,27,1458987112,1458988012,2,6,900
23965310@N07,2859,3,1458988967,1458989057,2,6,90
23965310@N07,2859,28,1458993382,1458994282,2,6,900
23988660@N06,2860,1,1382999724,1382999784,1,1,60
24034668@N07,2861,18,1441320860,1441321310,1,1,450
24046138@N00,2862,29,1359267243,1359268143,1,1,900
24063938@N02,2863,28,1323587719,1323588619,2,3,900
24063938@N02,2863,26,1323592436,1323593336,2,3,900
24063938@N02,2863,28,1323599655,1323600555,1,3,900
24064040@N08,2864,11,1310982284,1310982524,2,4,240
24064040@N08,2864,3,1310982684,1310982774,2,4,90
24064040@N08,2864,21,1310984702,1310985272,2,4,570
24064040@N08,2864,25,1310985338,1310986178,1,4,840
24068712@N00,2865,26,1295636593,1295637493,1,1,900
24068712@N00,2866,20,1305376366,1305376906,2,3,540
24068712@N00,2866,10,1305395948,1305396188,2,3,240
24068712@N00,2866,30,1305396256,1305397336,1,3,1080
24074281@N06,2867,3,1240363042,1240363132,1,1,90
24078248@N00,2868,15,1393108979,1393109249,21,1,270
24089179@N00,2869,28,1199055596,1199056496,2,1,900
24089179@N00,2870,28,1199107156,1199108056,2,1,900
24089179@N00,2871,28,1199154050,1199154950,4,1,900
24089179@N00,2872,28,1199229250,1199230150,5,1,900
24089179@N00,2873,28,1199328718,1199329618,5,1,900
24090212@N04,2874,12,1237849342,1237849582,2,3,240
24090212@N04,2874,4,1237851958,1237852059,3,3,101
24090212@N04,2874,11,1237853610,1237853850,1,3,240
24090212@N04,2875,12,1238011980,1238012220,11,11,240
24090212@N04,2875,26,1238014941,1238015841,2,11,900
24090212@N04,2875,18,1238016110,1238016560,7,11,450
24090212@N04,2875,31,1238018536,1238019483,3,11,947
24090212@N04,2875,22,1238019483,1238020083,2,11,600
24090212@N04,2875,31,1238020488,1238021902,12,11,1414
24090212@N04,2875,30,1238021902,1238022982,3,11,1080
24090212@N04,2875,26,1238023950,1238024850,2,11,900
24090212@N04,2875,24,1238025566,1238026346,5,11,780
24090212@N04,2875,13,1238032867,1238033107,6,11,240
24090212@N04,2875,9,1238033308,1238033488,2,11,180
24108474@N06,2876,1,1316762881,1316762941,1,1,60
24122903@N00,2877,17,1292238316,1292238616,1,1,300
24122903@N00,2878,26,1298262584,1298263446,2,5,862
24122903@N00,2878,17,1298263446,1298263746,3,5,300
24122903@N00,2878,3,1298266926,1298267016,2,5,90
24122903@N00,2878,5,1298268978,1298269098,2,5,120
24122903@N00,2878,17,1298287764,1298288064,1,5,300
24122903@N00,2879,27,1313286838,1313287738,1,1,900
24122903@N00,2880,29,1313543259,1313544159,1,1,900
24122903@N00,2881,1,1383167451,1383167511,1,1,60
24122903@N00,2882,22,1405887392,1405887992,1,1,600
24122903@N00,2883,17,1422681768,1422682068,1,1,300
24124275@N08,2884,3,1427007000,1427007090,1,1,90
24153575@N00,2885,29,1345004782,1345005682,1,1,900
24153575@N00,2886,20,1345268799,1345269339,1,1,540
24153575@N00,2887,30,1345370631,1345371711,1,1,1080
24153575@N00,2888,12,1345471078,1345471318,1,1,240
24153575@N00,2889,7,1345556284,1345556464,1,1,180
24153575@N00,2890,3,1347104943,1347105033,1,1,90
24207284@N03,2891,14,1353546153,1353546169,3,10,16
24207284@N03,2891,22,1353546169,1353546251,3,10,82
24207284@N03,2891,20,1353546251,1353546299,2,10,48
24207284@N03,2891,22,1353546299,1353546404,9,10,105
24207284@N03,2891,20,1353546404,1353546526,4,10,122
24207284@N03,2891,22,1353546526,1353547126,2,10,600
24207284@N03,2891,30,1353550331,1353551411,3,10,1080
24207284@N03,2891,24,1353553617,1353554397,4,10,780
24207284@N03,2891,15,1353558020,1353558290,4,10,270
24207284@N03,2891,28,1353562864,1353563764,3,10,900
24230954@N06,2892,1,1218073667,1218073727,2,5,60
24230954@N06,2892,26,1218077976,1218078050,2,5,74
24230954@N06,2892,3,1218078050,1218078059,2,5,9
24230954@N06,2892,26,1218078059,1218078959,2,5,900
24230954@N06,2892,3,1218080646,1218080736,1,5,90
24293654@N00,2893,1,1319543732,1319543792,1,1,60
24293654@N00,2894,24,1320023542,1320023545,3,2,3
24293654@N00,2894,5,1320023545,1320023665,1,2,120
24293654@N00,2895,1,1320064568,1320064568,2,8,0
24293654@N00,2895,28,1320064568,1320064569,2,8,1
24293654@N00,2895,25,1320064569,1320064570,3,8,1
24293654@N00,2895,26,1320064570,1320064572,4,8,2
24293654@N00,2895,6,1320064572,1320064572,2,8,0
24293654@N00,2895,26,1320064572,1320064573,2,8,1
24293654@N00,2895,1,1320064573,1320064597,42,8,24
24293654@N00,2895,16,1320064597,1320064867,10,8,270
24293654@N00,2896,18,1362390252,1362390702,1,1,450
24293654@N00,2897,1,1382342578,1382342638,1,1,60
24295504@N05,2898,17,1298209083,1298209383,1,1,300
24295504@N05,2899,26,1304231713,1304232613,1,1,900
24295504@N05,2900,17,1305790889,1305791189,2,3,300
24295504@N05,2900,21,1305793366,1305793936,2,3,570
24295504@N05,2900,29,1305798267,1305799167,2,3,900
24295504@N05,2901,27,1306228981,1306229881,2,3,900
24295504@N05,2901,28,1306231276,1306232176,2,3,900
24295504@N05,2901,16,1306237687,1306237957,1,3,270
24295504@N05,2902,19,1314092276,1314092705,5,15,429
24295504@N05,2902,28,1314092705,1314092837,2,15,132
24295504@N05,2902,29,1314092837,1314092861,2,15,24
24295504@N05,2902,28,1314092861,1314092916,2,15,55
24295504@N05,2902,18,1314092916,1314093105,2,15,189
24295504@N05,2902,23,1314093105,1314093705,3,15,600
24295504@N05,2902,18,1314093953,1314094118,3,15,165
24295504@N05,2902,23,1314094118,1314094171,3,15,53
24295504@N05,2902,18,1314094171,1314094208,2,15,37
24295504@N05,2902,23,1314094208,1314094299,4,15,91
24295504@N05,2902,18,1314094299,1314094488,5,15,189
24295504@N05,2902,23,1314094488,1314094533,2,15,45
24295504@N05,2902,18,1314094533,1314094983,2,15,450
24295504@N05,2902,23,1314096159,1314096759,2,15,600
24295504@N05,2902,18,1314097214,1314097664,1,15,450
24295504@N05,2903,18,1314871174,1314871624,1,1,450
24295504@N05,2904,19,1316154982,1316155522,7,5,540
24295504@N05,2904,18,1316155633,1316156083,2,5,450
24295504@N05,2904,23,1316158797,1316158804,2,5,7
24295504@N05,2904,18,1316158804,1316158809,2,5,5
24295504@N05,2904,23,1316158809,1316159409,3,5,600
24295504@N05,2905,23,1316190780,1316190793,2,2,13
24295504@N05,2905,18,1316190793,1316191243,2,2,450
24295504@N05,2906,18,1318930481,1318930931,1,1,450
24295504@N05,2907,6,1321169254,1321169374,2,2,120
24295504@N05,2907,26,1321171382,1321172282,3,2,900
24295504@N05,2908,20,1325834718,1325835258,2,3,540
24295504@N05,2908,23,1325838372,1325838972,2,3,600
24295504@N05,2908,29,1325858189,1325859089,1,3,900
24295504@N05,2909,20,1328451489,1328452029,1,1,540
24295504@N05,2910,24,1331615880,1331616660,2,1,780
24328796@N05,2911,28,1295172446,1295173346,1,1,900
24328796@N05,2912,23,1297552823,1297553423,1,1,600
24328796@N05,2913,26,1297597988,1297598888,1,1,900
24328796@N05,2914,29,1301820324,1301821224,1,1,900
24328796@N05,2915,16,1321411244,1321411514,4,3,270
24328796@N05,2915,4,1321421858,1321421959,2,3,101
24328796@N05,2915,8,1321423418,1321423598,1,3,180
24328796@N05,2916,28,1356037065,1356037965,1,1,900
24328796@N05,2917,28,1356094086,1356094986,1,1,900
24328796@N05,2918,26,1362310113,1362311013,1,1,900
24329359@N00,2919,28,1350297975,1350298875,1,1,900
24342711@N06,2920,26,1287304078,1287304978,1,1,900
24344010@N02,2921,23,1437218514,1437219114,1,1,600
24353989@N06,2922,1,1204152474,1204152534,2,4,60
24353989@N06,2922,26,1204162976,1204163876,3,4,900
24353989@N06,2922,17,1204168528,1204168828,2,4,300
24353989@N06,2922,16,1204182904,1204183174,1,4,270
24354425@N03,2923,27,1295353819,1295353933,2,2,114
24354425@N03,2923,17,1295353933,1295354233,1,2,300
24356860@N00,2924,1,1374283012,1374283072,1,1,60
24356860@N00,2925,27,1374320023,1374320923,2,2,900
24356860@N00,2925,28,1374326967,1374327867,1,2,900
24356860@N00,2926,22,1374387867,1374388467,1,1,600
24376530@N00,2927,26,1300750159,1300751059,1,1,900
24435646@N00,2928,1,1209110419,1209110479,3,5,60
24435646@N00,2928,26,1209112492,1209113392,3,5,900
24435646@N00,2928,17,1209119263,1209119563,4,5,300
24435646@N00,2928,27,1209119615,1209120515,5,5,900
24435646@N00,2928,26,1209126074,1209126974,8,5,900
24435646@N00,2929,18,1444722456,1444722906,1,1,450
24435646@N00,2930,18,1446534077,1446534527,2,1,450
24435646@N00,2931,18,1454652498,1454652948,1,1,450
24435646@N00,2932,18,1454806228,1454806678,2,3,450
24435646@N00,2932,15,1454806993,1454807263,2,3,270
24435646@N00,2932,18,1454809796,1454810246,1,3,450
24435646@N00,2933,18,1457751378,1457751828,2,1,450
24435646@N00,2934,26,1469327115,1469328015,1,1,900
24435646@N00,2935,26,1470561680,1470562580,1,1,900
24503701@N02,2936,1,1282255403,1282255463,3,3,60
24503701@N02,2936,17,1282260565,1282260865,2,3,300
24503701@N02,2936,22,1282262186,1282262786,2,3,600
24503701@N02,2937,26,1282342663,1282343559,2,6,896
24503701@N02,2937,3,1282343559,1282343649,2,6,90
24503701@N02,2937,12,1282343723,1282343963,2,6,240
24503701@N02,2937,20,1282346436,1282346976,2,6,540
24503701@N02,2937,29,1282347176,1282348076,2,6,900
24503701@N02,2937,21,1282349444,1282350014,1,6,570
24509213@N00,2938,11,1434937411,1434937651,2,7,240
24509213@N00,2938,17,1434954447,1434954747,2,7,300
24509213@N00,2938,15,1434957639,1434957909,2,7,270
24509213@N00,2938,25,1434959605,1434960445,2,7,840
24509213@N00,2938,24,1434965747,1434966527,3,7,780
24509213@N00,2938,26,1434968283,1434969183,2,7,900
24509213@N00,2938,28,1434973560,1434974460,1,7,900
24509213@N00,2939,28,1435112698,1435113598,2,8,900
24509213@N00,2939,26,1435122479,1435123379,3,8,900
24509213@N00,2939,13,1435130706,1435130946,2,8,240
24509213@N00,2939,4,1435140068,1435140169,2,8,101
24509213@N00,2939,21,1435143279,1435143362,2,8,83
24509213@N00,2939,25,1435143362,1435143939,4,8,577
24509213@N00,2939,21,1435143939,1435144509,3,8,570
24509213@N00,2939,30,1435151145,1435152225,2,8,1080
24509213@N00,2940,26,1435293140,1435294040,2,3,900
24509213@N00,2940,16,1435297893,1435298163,2,3,270
24509213@N00,2940,24,1435313559,1435314339,1,3,780
24528629@N06,2941,29,1368571205,1368572105,2,1,900
24528629@N06,2942,1,1368665743,1368665803,11,51,60
24528629@N06,2942,28,1368666186,1368666502,29,51,316
24528629@N06,2942,26,1368666502,1368666989,19,51,487
24528629@N06,2942,7,1368666989,1368667169,14,51,180
24528629@N06,2942,4,1368667473,1368667481,3,51,8
24528629@N06,2942,7,1368667481,1368667661,2,51,180
24528629@N06,2942,4,1368667773,1368667874,11,51,101
24528629@N06,2942,11,1368669985,1368669991,3,51,6
24528629@N06,2942,21,1368669991,1368670561,8,51,570
24528629@N06,2942,4,1368671569,1368671606,11,51,37
24528629@N06,2942,11,1368671606,1368671695,5,51,89
24528629@N06,2942,4,1368671695,1368671734,5,51,39
24528629@N06,2942,21,1368671734,1368672304,11,51,570
24528629@N06,2942,25,1368673975,1368674090,6,51,115
24528629@N06,2942,11,1368674090,1368674095,3,51,5
24528629@N06,2942,25,1368674095,1368674378,8,51,283
24528629@N06,2942,4,1368674378,1368674391,3,51,13
24528629@N06,2942,25,1368674391,1368675231,11,51,840
24528629@N06,2942,30,1368678604,1368679684,9,51,1080
24528629@N06,2942,29,1368682581,1368683481,5,51,900
24528629@N06,2942,19,1368684114,1368684654,10,51,540
24528629@N06,2942,18,1368684654,1368685104,9,51,450
24528629@N06,2942,19,1368686158,1368686176,3,51,18
24528629@N06,2942,29,1368686176,1368686289,5,51,113
24528629@N06,2942,18,1368686289,1368686329,3,51,40
24528629@N06,2942,19,1368686329,1368686512,3,51,183
24528629@N06,2942,18,1368686512,1368686962,3,51,450
24528629@N06,2942,11,1368689216,1368689309,4,51,93
24528629@N06,2942,12,1368689309,1368689549,3,51,240
24528629@N06,2942,24,1368690037,1368690817,4,51,780
24528629@N06,2942,21,1368690937,1368691248,3,51,311
24528629@N06,2942,11,1368691248,1368691251,3,51,3
24528629@N06,2942,24,1368691251,1368691374,6,51,123
24528629@N06,2942,4,1368691374,1368691435,4,51,61
24528629@N06,2942,12,1368691435,1368691523,5,51,88
24528629@N06,2942,24,1368691523,1368691607,7,51,84
24528629@N06,2942,12,1368691607,1368691618,3,51,11
24528629@N06,2942,21,1368691618,1368692188,7,51,570
24528629@N06,2942,11,1368692561,1368692801,2,51,240
24528629@N06,2942,24,1368693337,1368693372,3,51,35
24528629@N06,2942,15,1368693372,1368693642,3,51,270
24528629@N06,2942,11,1368694155,1368694160,2,51,5
24528629@N06,2942,15,1368694160,1368694371,2,51,211
24528629@N06,2942,24,1368694371,1368694586,5,51,215
24528629@N06,2942,15,1368694586,1368694606,2,51,20
24528629@N06,2942,24,1368694606,1368694778,3,51,172
24528629@N06,2942,11,1368694778,1368695017,3,51,239
24528629@N06,2942,15,1368695017,1368695287,3,51,270
24528629@N06,2942,29,1368696684,1368697584,3,51,900
24528629@N06,2942,16,1368698596,1368698866,7,51,270
24528629@N06,2942,28,1368699647,1368700547,4,51,900
24528629@N06,2943,28,1368756014,1368756055,3,24,41
24528629@N06,2943,8,1368756055,1368756235,3,24,180
24528629@N06,2943,4,1368757136,1368757175,5,24,39
24528629@N06,2943,11,1368757175,1368757415,3,24,240
24528629@N06,2943,30,1368758873,1368759026,3,24,153
24528629@N06,2943,4,1368759026,1368759127,3,24,101
24528629@N06,2943,11,1368759325,1368759565,5,24,240
24528629@N06,2943,6,1368759638,1368759758,3,24,120
24528629@N06,2943,11,1368760230,1368760470,5,24,240
24528629@N06,2943,10,1368761178,1368761418,9,24,240
24528629@N06,2943,11,1368761724,1368761964,3,24,240
24528629@N06,2943,26,1368762135,1368762487,11,24,352
24528629@N06,2943,10,1368762487,1368762727,5,24,240
24528629@N06,2943,17,1368764908,1368765208,11,24,300
24528629@N06,2943,11,1368767973,1368768213,3,24,240
24528629@N06,2943,9,1368768880,1368769026,2,24,146
24528629@N06,2943,11,1368769026,1368769266,3,24,240
24528629@N06,2943,24,1368770776,1368771556,3,24,780
24528629@N06,2943,11,1368773940,1368773943,3,24,3
24528629@N06,2943,26,1368773943,1368774843,2,24,900
24528629@N06,2943,31,1368775463,1368775527,3,24,64
24528629@N06,2943,20,1368775527,1368776067,7,24,540
24528629@N06,2943,29,1368778441,1368779341,9,24,900
24528629@N06,2943,26,1368786310,1368787210,6,24,900
24537422@N02,2944,1,1395092079,1395092139,95,1,60
24537422@N02,2945,28,1395265825,1395266079,4,7,254
24537422@N02,2945,1,1395266079,1395266139,70,7,60
24537422@N02,2945,14,1395275365,1395275605,2,7,240
24537422@N02,2945,11,1395279581,1395279821,2,7,240
24537422@N02,2945,15,1395283462,1395283732,6,7,270
24537422@N02,2945,23,1395299499,1395299589,4,7,90
24537422@N02,2945,18,1395299589,1395300039,1,7,450
24567273@N07,2946,23,1243697335,1243697935,2,3,600
24567273@N07,2946,16,1243699911,1243700181,3,3,270
24567273@N07,2946,20,1243705793,1243706333,1,3,540
24577327@N06,2947,11,1343617765,1343618005,2,4,240
24577327@N06,2947,27,1343618105,1343619005,2,4,900
24577327@N06,2947,16,1343631482,1343631752,2,4,270
24577327@N06,2947,21,1343638255,1343638825,7,4,570
24577327@N06,2948,28,1429342959,1429343859,2,3,900
24577327@N06,2948,16,1429346712,1429346982,3,3,270
24577327@N06,2948,21,1429347531,1429348101,1,3,570
24577736@N04,2949,11,1300093527,1300093767,2,1,240
24603283@N00,2950,16,1248610952,1248611222,1,1,270
24603283@N00,2951,28,1248845054,1248845954,2,1,900
24603283@N00,2952,26,1256009546,1256010446,1,1,900
24633725@N00,2953,20,1193901326,1193901866,34,1,540
24635124@N03,2954,26,1297566804,1297567704,1,1,900
24635124@N03,2955,31,1300181111,1300182611,1,1,1500
24635124@N03,2956,20,1300446445,1300446985,1,1,540
24635124@N03,2957,26,1303778097,1303778997,104,1,900
24646193@N05,2958,6,1208315758,1208315878,1,1,120
24655146@N08,2959,29,1306206226,1306207126,10,1,900
24675871@N02,2960,1,1374122284,1374122344,1,1,60
24684763@N02,2961,28,1353551989,1353552889,2,1,900
24684763@N02,2962,24,1353635970,1353636750,2,2,780
24684763@N02,2962,30,1353642796,1353643876,1,2,1080
24685814@N04,2963,28,1268773062,1268773962,1,1,900
24688575@N06,2964,28,1296350247,1296351147,2,7,900
24688575@N06,2964,26,1296351681,1296352187,2,7,506
24688575@N06,2964,16,1296352187,1296352457,2,7,270
24688575@N06,2964,28,1296357369,1296358269,2,7,900
24688575@N06,2964,16,1296358614,1296358884,2,7,270
24688575@N06,2964,3,1296372309,1296372399,2,7,90
24688575@N06,2964,16,1296372744,1296373014,2,7,270
24688575@N06,2965,13,1298169174,1298169414,1,1,240
24689127@N07,2966,26,1437127823,1437128723,3,1,900
24692700@N00,2967,26,1298850246,1298851146,50,1,900
24692700@N00,2968,1,1448227239,1448227299,3,11,60
24692700@N00,2968,20,1448227838,1448228378,5,11,540
24692700@N00,2968,29,1448229339,1448230239,3,11,900
24692700@N00,2968,18,1448230948,1448230979,2,11,31
24692700@N00,2968,29,1448230979,1448231503,2,11,524
24692700@N00,2968,19,1448231503,1448231513,2,11,10
24692700@N00,2968,29,1448231513,1448231574,3,11,61
24692700@N00,2968,19,1448231574,1448231624,2,11,50
24692700@N00,2968,18,1448231624,1448232074,3,11,450
24692700@N00,2968,25,1448249651,1448250491,10,11,840
24692700@N00,2968,21,1448250682,1448251252,7,11,570
24692700@N00,2969,26,1448317200,1448318100,2,7,900
24692700@N00,2969,27,1448322836,1448323736,6,7,900
24692700@N00,2969,16,1448325848,1448325850,2,7,2
24692700@N00,2969,27,1448325850,1448326750,2,7,900
24692700@N00,2969,17,1448326859,1448327159,2,7,300
24692700@N00,2969,15,1448330563,1448330833,6,7,270
24692700@N00,2969,28,1448344868,1448345768,9,7,900
24719278@N05,2970,25,1411275080,1411275920,37,1,840
24732960@N03,2971,1,1376122513,1376122573,1,1,60
24732960@N03,2972,19,1407223978,1407224518,2,1,540
24733288@N07,2973,17,1287732226,1287732526,3,2,300
24733288@N07,2973,26,1287748622,1287749522,1,2,900
24736628@N05,2974,23,1415059141,1415059741,2,7,600
24736628@N05,2974,17,1415061579,1415061879,2,7,300
24736628@N05,2974,22,1415067524,1415068124,2,7,600
24736628@N05,2974,20,1415070080,1415070620,3,7,540
24736628@N05,2974,28,1415085275,1415085597,2,7,322
24736628@N05,2974,23,1415085597,1415086197,2,7,600
24736628@N05,2974,26,1415092173,1415093073,1,7,900
24736628@N05,2975,27,1446702346,1446703246,1,1,900
24739740@N00,2976,26,1297926244,1297926262,2,5,18
24739740@N00,2976,12,1297926262,1297926278,2,5,16
24739740@N00,2976,10,1297926278,1297926287,2,5,9
24739740@N00,2976,26,1297926287,1297926294,2,5,7
24739740@N00,2976,27,1297926294,1297927194,1,5,900
24739740@N00,2977,23,1301458490,1301459090,2,2,600
24739740@N00,2977,24,1301467385,1301468165,1,2,780
24739867@N02,2978,7,1215318166,1215318346,1,1,180
24761610@N04,2979,10,1204635600,1204635602,2,4,2
24761610@N04,2979,12,1204635602,1204635604,3,4,2
24761610@N04,2979,13,1204635604,1204635605,2,4,1
24761610@N04,2979,3,1204635605,1204635695,2,4,90
24792498@N07,2980,28,1345454465,1345455365,3,1,900
24792498@N07,2981,28,1353305153,1353306053,2,5,900
24792498@N07,2981,1,1353306187,1353306247,2,5,60
24792498@N07,2981,28,1353309953,1353310189,2,5,236
24792498@N07,2981,1,1353310189,1353310249,3,5,60
24792498@N07,2981,28,1353311011,1353311911,1,5,900
24792498@N07,2982,28,1353920278,1353921178,1,1,900
24850040@N07,2983,26,1197782482,1197783382,4,5,900
24850040@N07,2983,28,1197783510,1197783863,2,5,353
24850040@N07,2983,1,1197783863,1197783923,2,5,60
24850040@N07,2983,28,1197785615,1197786515,5,5,900
24850040@N07,2983,26,1197787865,1197788765,2,5,900
24850040@N07,2984,26,1197820421,1197821321,2,2,900
24850040@N07,2984,28,1197821776,1197822676,2,2,900
24850040@N07,2985,20,1197877345,1197877885,2,2,540
24850040@N07,2985,3,1197896336,1197896426,1,2,90
24850040@N07,2986,17,1213613634,1213613934,3,4,300
24850040@N07,2986,7,1213614923,1213615091,2,4,168
24850040@N07,2986,11,1213615091,1213615331,2,4,240
24850040@N07,2986,23,1213616742,1213617342,1,4,600
24850040@N07,2987,16,1213672280,1213672414,2,2,134
24850040@N07,2987,26,1213672414,1213673314,2,2,900
24850040@N07,2988,15,1215682935,1215683205,1,1,270
24850040@N07,2989,30,1215753340,1215754420,7,4,1080
24850040@N07,2989,9,1215758547,1215758727,3,4,180
24850040@N07,2989,17,1215759573,1215759873,4,4,300
24850040@N07,2989,24,1215761138,1215761918,4,4,780
24850040@N07,2990,1,1215924768,1215924828,9,5,60
24850040@N07,2990,28,1215945819,1215946719,3,5,900
24850040@N07,2990,26,1215949507,1215950407,8,5,900
24850040@N07,2990,24,1215954056,1215954836,3,5,780
24850040@N07,2990,17,1215963329,1215963629,1,5,300
24850040@N07,2991,29,1216025498,1216026398,4,3,900
24850040@N07,2991,19,1216052205,1216052745,2,3,540
24850040@N07,2991,18,1216053358,1216053808,1,3,450
24850040@N07,2992,28,1216098017,1216098917,4,1,900
24850040@N07,2993,15,1218196670,1218196736,2,4,66
24850040@N07,2993,24,1218196736,1218196910,4,4,174
24850040@N07,2993,26,1218196910,1218196939,2,4,29
24850040@N07,2993,9,1218196939,1218197119,2,4,180
24850040@N07,2994,26,1233904589,1233905489,1,1,900
24850040@N07,2995,28,1233981258,1233982158,5,2,900
24850040@N07,2995,30,1233988032,1233989112,1,2,1080
24850040@N07,2996,1,1234064395,1234064455,7,3,60
24850040@N07,2996,22,1234074195,1234074795,2,3,600
24850040@N07,2996,27,1234097765,1234098665,3,3,900
24850040@N07,2997,1,1236163309,1236163369,3,2,60
24850040@N07,2997,27,1236163686,1236164586,1,2,900
24850040@N07,2998,28,1247654354,1247654566,2,9,212
24850040@N07,2998,16,1247654566,1247654836,3,9,270
24850040@N07,2998,18,1247655806,1247656250,5,9,444
24850040@N07,2998,23,1247656250,1247656650,2,9,400
24850040@N07,2998,18,1247656650,1247657100,6,9,450
24850040@N07,2998,29,1247658624,1247659524,14,9,900
24850040@N07,2998,26,1247661307,1247662207,2,9,900
24850040@N07,2998,12,1247663091,1247663331,2,9,240
24850040@N07,2998,16,1247666358,1247666628,3,9,270
24850040@N07,2999,26,1247761063,1247761963,2,1,900
24850040@N07,3000,1,1247808844,1247808904,2,12,60
24850040@N07,3000,22,1247811198,1247811798,3,12,600
24850040@N07,3000,31,1247811979,1247813479,6,12,1500
24850040@N07,3000,18,1247818068,1247818518,3,12,450
24850040@N07,3000,19,1247819529,1247820069,4,12,540
24850040@N07,3000,30,1247820144,1247820761,4,12,617
24850040@N07,3000,22,1247820761,1247821147,4,12,386
24850040@N07,3000,31,1247821147,1247821901,4,12,754
24850040@N07,3000,30,1247821901,1247822795,2,12,894
24850040@N07,3000,13,1247822795,1247823035,6,12,240
24850040@N07,3000,27,1247834996,1247835896,5,12,900
24850040@N07,3000,29,1247848320,1247849220,9,12,900
24850040@N07,3001,28,1247889383,1247890236,3,2,853
24850040@N07,3001,26,1247890236,1247891136,7,2,900
24850040@N07,3002,7,1248067894,1248068045,2,8,151
24850040@N07,3002,3,1248068045,1248068135,2,8,90
24850040@N07,3002,4,1248068279,1248068380,2,8,101
24850040@N07,3002,11,1248068439,1248068679,2,8,240
24850040@N07,3002,30,1248072155,1248072671,5,8,516
24850040@N07,3002,23,1248072671,1248073271,3,8,600
24850040@N07,3002,15,1248094494,1248094764,7,8,270
24850040@N07,3002,29,1248106553,1248107453,5,8,900
24850040@N07,3003,17,1248152737,1248152818,5,12,81
24850040@N07,3003,1,1248152818,1248152878,6,12,60
24850040@N07,3003,28,1248154051,1248154903,4,12,852
24850040@N07,3003,18,1248154903,1248155353,3,12,450
24850040@N07,3003,22,1248160480,1248161080,2,12,600
24850040@N07,3003,26,1248161484,1248161640,2,12,156
24850040@N07,3003,18,1248161640,1248162090,7,12,450
24850040@N07,3003,23,1248163794,1248164394,6,12,600
24850040@N07,3003,12,1248180138,1248180378,6,12,240
24850040@N07,3003,20,1248184764,1248185304,6,12,540
24850040@N07,3003,22,1248185967,1248186567,2,12,600
24850040@N07,3003,20,1248187732,1248188272,1,12,540
24850040@N07,3004,20,1253012972,1253013512,1,1,540
24850040@N07,3005,28,1263569433,1263570333,3,3,900
24850040@N07,3005,20,1263570490,1263571030,2,3,540
24850040@N07,3005,29,1263572417,1263573317,1,3,900
24850040@N07,3006,1,1263614059,1263614119,6,6,60
24850040@N07,3006,29,1263615818,1263616718,2,6,900
24850040@N07,3006,12,1263624664,1263624904,7,6,240
24850040@N07,3006,26,1263627106,1263628006,3,6,900
24850040@N07,3006,29,1263628739,1263629639,5,6,900
24850040@N07,3006,20,1263630790,1263631330,1,6,540
24850040@N07,3007,16,1263700600,1263700870,2,3,270
24850040@N07,3007,30,1263713267,1263714347,2,3,1080
24850040@N07,3007,20,1263732998,1263733538,5,3,540
24850040@N07,3008,11,1263804412,1263804652,2,2,240
24850040@N07,3008,30,1263808453,1263809533,1,2,1080
24850040@N07,3009,21,1266621480,1266622050,1,1,570
24850040@N07,3010,26,1266661994,1266662894,1,1,900
24850040@N07,3011,26,1279128440,1279129052,4,3,612
24850040@N07,3011,18,1279129052,1279129502,2,3,450
24850040@N07,3011,28,1279129634,1279130534,1,3,900
24850040@N07,3012,18,1279179987,1279180437,10,7,450
24850040@N07,3012,12,1279182835,1279183075,3,7,240
24850040@N07,3012,21,1279183599,1279184169,4,7,570
24850040@N07,3012,25,1279184616,1279185456,2,7,840
24850040@N07,3012,23,1279186124,1279186368,2,7,244
24850040@N07,3012,31,1279186368,1279187868,2,7,1500
24850040@N07,3012,23,1279188089,1279188689,2,7,600
24850040@N07,3013,31,1279275659,1279277159,4,1,1500
24850040@N07,3014,1,1279343129,1279343189,5,8,60
24850040@N07,3014,30,1279348554,1279349634,25,8,1080
24850040@N07,3014,28,1279350690,1279351590,2,8,900
24850040@N07,3014,15,1279360875,1279361027,4,8,152
24850040@N07,3014,17,1279361027,1279361327,4,8,300
24850040@N07,3014,26,1279364258,1279365158,4,8,900
24850040@N07,3014,29,1279365259,1279366159,6,8,900
24850040@N07,3014,30,1279384851,1279385931,1,8,1080
24850040@N07,3015,1,1279521282,1279521342,4,3,60
24850040@N07,3015,18,1279522201,1279522651,3,3,450
24850040@N07,3015,26,1279522794,1279523694,8,3,900
24850040@N07,3016,20,1279556975,1279557515,3,4,540
24850040@N07,3016,29,1279559116,1279559565,3,4,449
24850040@N07,3016,19,1279559565,1279559828,2,4,263
24850040@N07,3016,23,1279559828,1279560428,3,4,600
24850040@N07,3017,28,1287289273,1287289360,2,4,87
24850040@N07,3017,1,1287289360,1287289420,2,4,60
24850040@N07,3017,28,1287289483,1287290362,3,4,879
24850040@N07,3017,30,1287290362,1287291442,4,4,1080
24850040@N07,3018,8,1287467428,1287467608,2,6,180
24850040@N07,3018,17,1287488221,1287488521,3,6,300
24850040@N07,3018,20,1287497201,1287497741,12,6,540
24850040@N07,3018,18,1287499824,1287500036,2,6,212
24850040@N07,3018,30,1287500036,1287500320,3,6,284
24850040@N07,3018,20,1287500320,1287500860,1,6,540
24850040@N07,3019,21,1287547060,1287547526,3,14,466
24850040@N07,3019,3,1287547526,1287547616,3,14,90
24850040@N07,3019,26,1287548527,1287549427,3,14,900
24850040@N07,3019,20,1287550313,1287550853,4,14,540
24850040@N07,3019,23,1287555199,1287555799,11,14,600
24850040@N07,3019,20,1287561558,1287561601,2,14,43
24850040@N07,3019,29,1287561601,1287561713,2,14,112
24850040@N07,3019,20,1287561713,1287562211,2,14,498
24850040@N07,3019,31,1287562211,1287563711,6,14,1500
24850040@N07,3019,17,1287566109,1287566409,3,14,300
24850040@N07,3019,20,1287567381,1287567921,4,14,540
24850040@N07,3019,31,1287572035,1287572271,3,14,236
24850040@N07,3019,22,1287572271,1287572614,2,14,343
24850040@N07,3019,30,1287572614,1287573694,1,14,1080
24850040@N07,3020,1,1309442400,1309442400,4,18,0
24850040@N07,3020,4,1309442400,1309442400,4,18,0
24850040@N07,3020,6,1309442400,1309442400,2,18,0
24850040@N07,3020,12,1309442400,1309442400,2,18,0
24850040@N07,3020,14,1309442400,1309442400,2,18,0
24850040@N07,3020,15,1309442400,1309442400,5,18,0
24850040@N07,3020,16,1309442400,1309442400,7,18,0
24850040@N07,3020,18,1309442400,1309442400,4,18,0
24850040@N07,3020,21,1309442400,1309442400,2,18,0
24850040@N07,3020,22,1309442400,1309442400,4,18,0
24850040@N07,3020,23,1309442400,1309442400,2,18,0
24850040@N07,3020,24,1309442400,1309442400,2,18,0
24850040@N07,3020,25,1309442400,1309442400,2,18,0
24850040@N07,3020,26,1309442400,1309442400,8,18,0
24850040@N07,3020,27,1309442400,1309442400,5,18,0
24850040@N07,3020,29,1309442400,1309442400,6,18,0
24850040@N07,3020,30,1309442400,1309442400,6,18,0
24850040@N07,3020,31,1309442400,1309443900,3,18,1500
24850040@N07,3021,17,1349256857,1349257157,2,3,300
24850040@N07,3021,30,1349258430,1349259510,9,3,1080
24850040@N07,3021,19,1349263810,1349264350,3,3,540
24850040@N07,3022,16,1349452892,1349453162,2,1,270
24850040@N07,3023,28,1349682239,1349682743,2,2,504
24850040@N07,3023,1,1349682743,1349682803,1,2,60
24850040@N07,3024,30,1358255593,1358256673,1,1,1080
24850040@N07,3025,20,1407813610,1407814150,2,2,540
24850040@N07,3025,25,1407814692,1407815532,1,2,840
24850040@N07,3026,28,1407851577,1407852477,3,5,900
24850040@N07,3026,27,1407854201,1407855101,3,5,900
24850040@N07,3026,26,1407860736,1407861636,4,5,900
24850040@N07,3026,16,1407861902,1407862172,2,5,270
24850040@N07,3026,28,1407862372,1407863272,1,5,900
24850040@N07,3027,17,1407979349,1407979649,2,2,300
24850040@N07,3027,27,1407980691,1407981591,1,2,900
24851604@N03,3028,1,1417225609,1417225669,2,1,60
24875210@N06,3029,26,1246008536,1246009436,1,1,900
24875210@N06,3030,28,1246181348,1246182248,1,1,900
24913492@N00,3031,24,1316765780,1316766560,1,1,780
24914070@N07,3032,28,1253760153,1253761053,16,1,900
24914070@N07,3033,28,1254371897,1254372797,10,1,900
24928011@N00,3034,26,1381546591,1381547491,2,5,900
24928011@N00,3034,15,1381564841,1381565111,3,5,270
24928011@N00,3034,26,1381571272,1381571442,2,5,170
24928011@N00,3034,23,1381571442,1381572042,2,5,600
24928011@N00,3034,28,1381579606,1381580506,1,5,900
24959465@N08,3035,16,1330568405,1330568675,1,1,270
24959465@N08,3036,18,1330769905,1330769912,2,4,7
24959465@N08,3036,19,1330769912,1330769930,4,4,18
24959465@N08,3036,8,1330769930,1330769969,2,4,39
24959465@N08,3036,26,1330769969,1330770869,1,4,900
24959465@N08,3037,27,1330942169,1330943069,1,1,900
24959465@N08,3038,17,1352600662,1352600962,1,1,300
24959465@N08,3039,21,1352781567,1352782137,2,3,570
24959465@N08,3039,27,1352786695,1352787595,2,3,900
24959465@N08,3039,23,1352795814,1352796414,1,3,600
24959465@N08,3040,29,1363225252,1363226152,2,2,900
24959465@N08,3040,21,1363247658,1363248228,1,2,570
24959465@N08,3041,17,1363562633,1363562933,2,2,300
24959465@N08,3041,18,1363571356,1363571806,2,2,450
24959465@N08,3042,24,1367314575,1367315355,1,1,780
24959465@N08,3043,7,1367540509,1367540689,2,3,180
24959465@N08,3043,27,1367552483,1367553383,2,3,900
24959465@N08,3043,12,1367568829,1367569069,1,3,240
24959465@N08,3044,12,1374818089,1374818329,1,1,240
24959465@N08,3045,27,1378120427,1378121327,1,1,900
24959465@N08,3046,24,1378279622,1378280402,1,1,780
24959465@N08,3047,26,1386146382,1386147282,1,1,900
24959465@N08,3048,27,1418448918,1418449818,1,1,900
24959465@N08,3049,9,1424090789,1424090969,1,1,180
24959465@N08,3050,27,1440413715,1440414615,1,1,900
25013736@N03,3051,26,1223544024,1223544924,1,1,900
25017746@N00,3052,23,1197158306,1197158906,1,1,600
25027171@N08,3053,28,1346718769,1346719287,27,26,518
25027171@N08,3053,27,1346719287,1346719314,3,26,27
25027171@N08,3053,28,1346719314,1346720214,7,26,900
25027171@N08,3053,15,1346723776,1346724046,11,26,270
25027171@N08,3053,24,1346728959,1346729677,7,26,718
25027171@N08,3053,25,1346729677,1346730517,15,26,840
25027171@N08,3053,21,1346731917,1346731931,3,26,14
25027171@N08,3053,25,1346731931,1346731951,3,26,20
25027171@N08,3053,13,1346731951,1346732191,13,26,240
25027171@N08,3053,21,1346732318,1346732888,5,26,570
25027171@N08,3053,3,1346733470,1346733560,7,26,90
25027171@N08,3053,4,1346733590,1346733655,3,26,65
25027171@N08,3053,11,1346733655,1346733734,5,26,79
25027171@N08,3053,9,1346733734,1346733786,5,26,52
25027171@N08,3053,6,1346733786,1346733906,11,26,120
25027171@N08,3053,26,1346733992,1346734386,45,26,394
25027171@N08,3053,30,1346734386,1346734388,3,26,2
25027171@N08,3053,26,1346734388,1346734416,3,26,28
25027171@N08,3053,30,1346734416,1346734910,17,26,494
25027171@N08,3053,29,1346734910,1346735810,9,26,900
25027171@N08,3053,31,1346742937,1346743060,5,26,123
25027171@N08,3053,30,1346743060,1346743330,3,26,270
25027171@N08,3053,29,1346743330,1346744230,3,26,900
25027171@N08,3053,26,1346749903,1346750803,83,26,900
25027171@N08,3053,16,1346751146,1346751255,3,26,109
25027171@N08,3053,28,1346751255,1346752155,8,26,900
25027171@N08,3054,14,1386644397,1386644424,3,8,27
25027171@N08,3054,22,1386644424,1386644439,4,8,15
25027171@N08,3054,14,1386644439,1386644679,15,8,240
25027171@N08,3054,22,1386644853,1386644997,5,8,144
25027171@N08,3054,31,1386644997,1386645058,2,8,61
25027171@N08,3054,20,1386645058,1386645598,14,8,540
25027171@N08,3054,28,1386647882,1386648782,4,8,900
25027171@N08,3054,1,1386652879,1386652939,3,8,60
25027171@N08,3055,18,1386802821,1386803271,4,16,450
25027171@N08,3055,19,1386804912,1386805452,2,16,540
25027171@N08,3055,29,1386808995,1386809895,6,16,900
25027171@N08,3055,20,1386811891,1386812431,6,16,540
25027171@N08,3055,31,1386812516,1386812784,3,16,268
25027171@N08,3055,20,1386812784,1386813065,8,16,281
25027171@N08,3055,14,1386813065,1386813104,3,16,39
25027171@N08,3055,20,1386813104,1386813552,2,16,448
25027171@N08,3055,22,1386813552,1386813658,4,16,106
25027171@N08,3055,14,1386813658,1386813898,3,16,240
25027171@N08,3055,25,1386818952,1386819792,54,16,840
25027171@N08,3055,26,1386825774,1386826674,3,16,900
25027171@N08,3055,1,1386828058,1386828118,100,16,60
25027171@N08,3055,28,1386833864,1386834764,6,16,900
25027171@N08,3055,21,1386836634,1386837204,2,16,570
25027171@N08,3055,26,1386839105,1386840005,7,16,900
25027171@N08,3056,30,1386897923,1386899003,2,7,1080
25027171@N08,3056,29,1386899525,1386899532,2,7,7
25027171@N08,3056,30,1386899532,1386900612,2,7,1080
25027171@N08,3056,11,1386901993,1386902233,2,7,240
25027171@N08,3056,13,1386902396,1386902636,25,7,240
25027171@N08,3056,24,1386905145,1386905925,2,7,780
25027171@N08,3056,29,1386924148,1386925048,154,7,900
25033627@N00,3057,12,1350096085,1350096325,1,1,240
25069338@N05,3058,24,1307923159,1307923939,2,2,780
25069338@N05,3058,25,1307924371,1307925211,1,2,840
25069338@N05,3059,14,1307961982,1307962222,1,1,240
25119612@N02,3060,1,1189301294,1189301354,2,1,60
25119612@N02,3061,29,1190512230,1190513130,4,1,900
25119612@N02,3062,16,1192927657,1192927927,2,3,270
25119612@N02,3062,21,1192941999,1192942569,3,3,570
25119612@N02,3062,28,1192942696,1192943596,3,3,900
25119612@N02,3063,28,1195948047,1195948947,2,3,900
25119612@N02,3063,26,1195953377,1195954277,5,3,900
25119612@N02,3063,8,1195954337,1195954517,1,3,180
25119612@N02,3064,1,1197152351,1197152411,3,2,60
25119612@N02,3064,29,1197154300,1197155200,4,2,900
25119612@N02,3065,28,1198384190,1198385090,2,1,900
25119612@N02,3066,28,1199591165,1199591672,2,3,507
25119612@N02,3066,21,1199591672,1199592242,3,3,570
25119612@N02,3066,28,1199593044,1199593944,11,3,900
25119612@N02,3067,1,1200003352,1200003412,4,7,60
25119612@N02,3067,28,1200008661,1200009015,3,7,354
25119612@N02,3067,21,1200009015,1200009043,2,7,28
25119612@N02,3067,26,1200009043,1200009276,2,7,233
25119612@N02,3067,28,1200009276,1200010176,2,7,900
25119612@N02,3067,18,1200016615,1200017065,2,7,450
25119612@N02,3067,28,1200024883,1200025783,5,7,900
25119612@N02,3068,11,1201393123,1201393363,2,2,240
25119612@N02,3068,28,1201407611,1201408511,3,2,900
25119612@N02,3069,3,1222601510,1222601600,2,1,90
25119612@N02,3070,26,1226193500,1226194400,2,2,900
25119612@N02,3070,21,1226209790,1226210360,1,2,570
25119612@N02,3071,28,1238912290,1238913190,8,1,900
25119612@N02,3072,18,1240722091,1240722541,2,2,450
25119612@N02,3072,28,1240735460,1240736360,1,2,900
25119612@N02,3073,28,1241331075,1241331975,5,1,900
25119612@N02,3074,16,1247797344,1247797614,2,2,270
25119612@N02,3074,21,1247822021,1247822591,1,2,570
25119612@N02,3075,28,1272261489,1272262389,1,1,900
25119612@N02,3076,21,1281084265,1281084835,1,1,570
25119612@N02,3077,28,1281267865,1281268765,3,1,900
25119612@N02,3078,26,1283756925,1283757825,1,1,900
25119612@N02,3079,26,1286575565,1286576465,2,8,900
25119612@N02,3079,18,1286577042,1286577492,2,8,450
25119612@N02,3079,8,1286579120,1286579300,2,8,180
25119612@N02,3079,3,1286585212,1286585302,7,8,90
25119612@N02,3079,21,1286590257,1286590827,23,8,570
25119612@N02,3079,28,1286592052,1286592952,19,8,900
25119612@N02,3079,27,1286601975,1286602875,2,8,900
25119612@N02,3079,25,1286603230,1286604070,4,8,840
25119612@N02,3080,29,1290472650,1290473550,1,1,900
25126997@N08,3081,26,1411738131,1411739031,1,1,900
25126997@N08,3082,26,1467591521,1467592421,1,1,900
25138015@N03,3083,1,1368489577,1368489637,1,1,60
25138015@N03,3084,17,1368781427,1368781727,1,1,300
25194038@N02,3085,16,1295741709,1295741979,1,1,270
25199567@N05,3086,26,1213277602,1213278001,2,2,399
25199567@N05,3086,8,1213278001,1213278181,1,2,180
25203548@N00,3087,12,1413770898,1413770957,2,2,59
25203548@N00,3087,1,1413770957,1413771017,1,2,60
25203548@N00,3088,17,1429076179,1429076479,1,1,300
25217083@N08,3089,28,1213364690,1213365590,1,1,900
25224114@N08,3090,26,1378025371,1378026271,1,1,900
25228353@N03,3091,28,1457911641,1457912541,1,1,900
25228353@N03,3092,26,1457940716,1457941616,2,2,900
25228353@N03,3092,28,1457955259,1457956159,1,2,900
25233266@N04,3093,17,1291010786,1291011086,1,1,300
25262413@N03,3094,28,1199106000,1199106900,1,1,900
25262413@N03,3095,18,1448794612,1448795062,1,1,450
25262413@N03,3096,17,1460946428,1460946728,1,1,300
25269451@N07,3097,26,1213961423,1213962323,1,1,900
25276142@N07,3098,13,1213539147,1213539387,3,1,240
25295728@N08,3099,1,1369262563,1369262623,1,1,60
25360342@N02,3100,26,1393221616,1393222516,2,5,900
25360342@N02,3100,21,1393222755,1393223007,2,5,252
25360342@N02,3100,13,1393223007,1393223247,2,5,240
25360342@N02,3100,6,1393223983,1393224103,2,5,120
25360342@N02,3100,26,1393224336,1393225236,1,5,900
25360342@N02,3101,12,1393282518,1393282758,2,5,240
25360342@N02,3101,22,1393287244,1393287844,2,5,600
25360342@N02,3101,1,1393303615,1393303675,2,5,60
25360342@N02,3101,26,1393308267,1393309070,2,5,803
25360342@N02,3101,30,1393309070,1393310150,1,5,1080
25360342@N02,3102,29,1393384540,1393385440,2,4,900
25360342@N02,3102,17,1393396734,1393397034,2,4,300
25360342@N02,3102,3,1393399947,1393400037,2,4,90
25360342@N02,3102,24,1393404520,1393405300,2,4,780
25360342@N02,3103,16,1393547179,1393547449,3,5,270
25360342@N02,3103,23,1393547652,1393548252,2,5,600
25360342@N02,3103,11,1393553960,1393554200,3,5,240
25360342@N02,3103,29,1393555934,1393556834,2,5,900
25360342@N02,3103,15,1393562016,1393562286,1,5,270
25387061@N06,3104,18,1458558919,1458559369,1,1,450
25387336@N07,3105,29,1300955120,1300955125,2,2,5
25387336@N07,3105,30,1300955125,1300956205,1,2,1080
25403350@N00,3106,28,1255751821,1255752721,2,2,900
25403350@N00,3106,20,1255754797,1255755337,1,2,540
25449594@N07,3107,28,1294928886,1294929786,2,4,900
25449594@N07,3107,11,1294931401,1294931641,2,4,240
25449594@N07,3107,3,1294941166,1294941256,2,4,90
25449594@N07,3107,15,1294945461,1294945731,1,4,270
25468573@N08,3108,26,1238384096,1238384293,3,4,197
25468573@N08,3108,23,1238384293,1238384893,6,4,600
25468573@N08,3108,25,1238404922,1238405762,6,4,840
25468573@N08,3108,12,1238411434,1238411674,2,4,240
25468671@N00,3109,1,1391901237,1391901297,1,1,60
25468671@N00,3110,17,1458368617,1458368917,2,3,300
25468671@N00,3110,19,1458384957,1458385497,2,3,540
25468671@N00,3110,28,1458386360,1458387260,1,3,900
25495689@N03,3111,25,1464994443,1464995283,1,1,840
25514912@N08,3112,19,1431462071,1431462611,1,1,540
25554959@N06,3113,24,1213702037,1213702817,2,2,780
25554959@N06,3113,26,1213703060,1213703960,1,2,900
25569106@N00,3114,1,1404711342,1404711402,1,1,60
25596925@N05,3115,28,1217041693,1217042548,10,13,855
25596925@N05,3115,18,1217042548,1217042998,32,13,450
25596925@N05,3115,30,1217047307,1217048387,3,13,1080
25596925@N05,3115,11,1217050380,1217050620,5,13,240
25596925@N05,3115,21,1217051905,1217052475,13,13,570
25596925@N05,3115,27,1217064859,1217065759,7,13,900
25596925@N05,3115,24,1217069794,1217069935,2,13,141
25596925@N05,3115,16,1217069935,1217070205,8,13,270
25596925@N05,3115,26,1217071361,1217072261,5,13,900
25596925@N05,3115,30,1217072953,1217073732,2,13,779
25596925@N05,3115,12,1217073732,1217073972,2,13,240
25596925@N05,3115,30,1217074955,1217076035,2,13,1080
25596925@N05,3115,26,1217076660,1217077560,4,13,900
25601992@N00,3116,1,1432514924,1432514984,4,8,60
25601992@N00,3116,28,1432515138,1432515639,2,8,501
25601992@N00,3116,12,1432515639,1432515879,4,8,240
25601992@N00,3116,26,1432516220,1432516594,2,8,374
25601992@N00,3116,29,1432516594,1432516985,3,8,391
25601992@N00,3116,22,1432516985,1432517585,7,8,600
25601992@N00,3116,26,1432518910,1432519750,2,8,840
25601992@N00,3116,1,1432519750,1432519810,1,8,60
25609254@N02,3117,8,1261738945,1261739125,1,1,180
25628053@N00,3118,26,1230526956,1230527856,4,1,900
25628053@N00,3119,28,1236314169,1236315069,1,1,900
25628053@N00,3120,26,1236379686,1236380586,24,1,900
25628053@N00,3121,26,1236474919,1236475819,5,1,900
25628053@N00,3122,26,1242885784,1242886684,2,1,900
25628053@N00,3123,26,1242948406,1242949306,3,1,900
25628053@N00,3124,26,1243001579,1243002479,1,1,900
25628053@N00,3125,26,1243076714,1243077614,6,1,900
25633301@N00,3126,5,1414808812,1414808932,5,2,120
25633301@N00,3126,29,1414812480,1414813380,1,2,900
25633301@N00,3127,19,1414880918,1414881458,5,6,540
25633301@N00,3127,27,1414887648,1414888548,2,6,900
25633301@N00,3127,26,1414890503,1414891403,2,6,900
25633301@N00,3127,1,1414891497,1414891557,6,6,60
25633301@N00,3127,11,1414898790,1414899030,5,6,240
25633301@N00,3127,28,1414912208,1414913108,1,6,900
25633301@N00,3128,16,1415067651,1415067921,8,1,270
25638916@N05,3129,26,1457358034,1457358934,1,1,900
25728552@N00,3130,21,1461650706,1461651276,1,1,570
25728552@N00,3131,16,1461797852,1461798122,2,3,270
25728552@N00,3131,17,1461800076,1461800376,2,3,300
25728552@N00,3131,26,1461803218,1461804118,3,3,900
25728552@N00,3132,25,1461891923,1461892686,6,3,763
25728552@N00,3132,13,1461892686,1461892926,2,3,240
25728552@N00,3132,28,1461900226,1461901126,1,3,900
25771935@N08,3133,15,1334113792,1334114062,1,1,270
25771935@N08,3134,18,1340584034,1340584484,1,1,450
25771935@N08,3135,27,1348102801,1348103701,1,1,900
25771935@N08,3136,27,1348274571,1348275471,2,2,900
25771935@N08,3136,24,1348277953,1348278733,1,2,780
25771935@N08,3137,27,1351498693,1351499593,1,1,900
25771935@N08,3138,29,1351853679,1351854579,1,1,900
25792183@N00,3139,26,1258966766,1258967666,3,2,900
25792183@N00,3139,28,1258973826,1258974726,1,2,900
25793750@N07,3140,26,1207836018,1207836918,1,1,900
25827417@N00,3141,7,1367468142,1367468322,1,1,180
25827417@N00,3142,10,1447629570,1447629810,1,1,240
25827417@N00,3143,26,1447899308,1447900208,1,1,900
25827417@N00,3144,26,1447976362,1447977262,3,1,900
25854008@N00,3145,29,1327929916,1327930816,1,1,900
25854008@N00,3146,17,1327990166,1327990466,2,3,300
25854008@N00,3146,18,1327990595,1327990742,2,3,147
25854008@N00,3146,13,1327990742,1327990982,1,3,240
25854008@N00,3147,20,1358672512,1358673052,1,1,540
25854008@N00,3148,23,1358745557,1358746157,3,2,600
25854008@N00,3148,18,1358750459,1358750909,3,2,450
25855529@N04,3149,28,1336093760,1336094660,2,1,900
25855529@N04,3150,26,1336280786,1336281143,2,6,357
25855529@N04,3150,23,1336281143,1336281232,2,6,89
25855529@N04,3150,26,1336281232,1336281431,2,6,199
25855529@N04,3150,10,1336281431,1336281671,4,6,240
25855529@N04,3150,29,1336282239,1336283139,3,6,900
25855529@N04,3150,10,1336284787,1336285027,1,6,240
25950855@N08,3151,27,1340660887,1340661787,32,3,900
25950855@N08,3151,7,1340671070,1340671250,4,3,180
25950855@N08,3151,9,1340685160,1340685340,1,3,180
25950855@N08,3152,16,1449175972,1449176242,2,18,270
25950855@N08,3152,17,1449176787,1449177087,4,18,300
25950855@N08,3152,27,1449179242,1449180142,3,18,900
25950855@N08,3152,6,1449184912,1449185032,3,18,120
25950855@N08,3152,7,1449187668,1449187848,2,18,180
25950855@N08,3152,30,1449192380,1449193094,12,18,714
25950855@N08,3152,20,1449193094,1449193634,5,18,540
25950855@N08,3152,29,1449195654,1449196554,2,18,900
25950855@N08,3152,30,1449198493,1449199573,13,18,1080
25950855@N08,3152,23,1449202554,1449203154,3,18,600
25950855@N08,3152,1,1449206895,1449206955,2,18,60
25950855@N08,3152,18,1449207826,1449207844,2,18,18
25950855@N08,3152,23,1449207844,1449208444,4,18,600
25950855@N08,3152,18,1449209163,1449209613,5,18,450
25950855@N08,3152,23,1449209744,1449209755,2,18,11
25950855@N08,3152,18,1449209755,1449209890,3,18,135
25950855@N08,3152,23,1449209890,1449210290,3,18,400
25950855@N08,3152,31,1449210290,1449211790,1,18,1500
25972243@N07,3153,30,1302175312,1302176392,1,1,1080
25992206@N08,3154,1,1377950532,1377950592,1,1,60
25992206@N08,3155,1,1383452372,1383452432,2,1,60
25995071@N02,3156,3,1300796488,1300796578,1,1,90
26000176@N07,3157,1,1211083336,1211083396,2,2,60
26000176@N07,3157,23,1211092077,1211092677,1,2,600
26000176@N07,3158,28,1211182522,1211183422,1,1,900
26000176@N07,3159,12,1223088501,1223088741,2,2,240
26000176@N07,3159,27,1223100075,1223100975,1,2,900
26000176@N07,3160,18,1223170479,1223170929,1,1,450
26000176@N07,3161,28,1223246098,1223246998,1,1,900
26000176@N07,3162,23,1314231898,1314232498,1,1,600
26000176@N07,3163,3,1321673526,1321673616,1,1,90
26000176@N07,3164,14,1321739746,1321739986,1,1,240
26000176@N07,3165,18,1321844301,1321844751,1,1,450
26000176@N07,3166,3,1321876356,1321876446,1,1,90
26000176@N07,3167,23,1345191572,1345192172,1,1,600
26000176@N07,3168,31,1345271998,1345273498,1,1,1500
26000176@N07,3169,17,1391661948,1391662248,2,2,300
26000176@N07,3169,19,1391664868,1391665408,1,2,540
26000176@N07,3170,15,1448184010,1448184280,1,1,270
26000176@N07,3171,15,1452296093,1452296363,1,1,270
26051472@N05,3172,25,1358570212,1358571052,3,2,840
26051472@N05,3172,13,1358572896,1358573136,2,2,240
26051472@N05,3173,1,1358636913,1358636973,3,8,60
26051472@N05,3173,13,1358642169,1358642409,2,8,240
26051472@N05,3173,21,1358643064,1358643634,3,8,570
26051472@N05,3173,4,1358644218,1358644319,2,8,101
26051472@N05,3173,11,1358644330,1358644478,2,8,148
26051472@N05,3173,21,1358644478,1358645041,2,8,563
26051472@N05,3173,24,1358645041,1358645821,2,8,780
26051472@N05,3173,26,1358665401,1358666301,1,8,900
26051623@N00,3174,28,1260085554,1260086454,2,5,900
26051623@N00,3174,21,1260089216,1260089786,15,5,570
26051623@N00,3174,4,1260110833,1260110934,2,5,101
26051623@N00,3174,26,1260111072,1260111276,2,5,204
26051623@N00,3174,28,1260111276,1260112176,1,5,900
26054914@N08,3175,28,1327825737,1327826637,2,1,900
26066055@N00,3176,29,1221790203,1221791103,6,1,900
26066055@N00,3177,29,1221860428,1221861328,30,1,900
26066055@N00,3178,29,1221952888,1221953788,18,1,900
26066055@N00,3179,17,1296338934,1296339234,1,1,300
26071009@N04,3180,25,1336867095,1336867935,2,1,840
26094076@N08,3181,14,1354876440,1354876680,1,1,240
26104563@N00,3182,26,1283886213,1283887113,2,7,900
26104563@N00,3182,1,1283887919,1283887919,2,7,0
26104563@N00,3182,5,1283887919,1283887919,2,7,0
26104563@N00,3182,16,1283887919,1283887919,2,7,0
26104563@N00,3182,26,1283887919,1283887919,2,7,0
26104563@N00,3182,28,1283887919,1283887919,2,7,0
26104563@N00,3182,29,1283887919,1283888819,1,7,900
26118937@N08,3183,25,1368062295,1368063135,1,1,840
26142249@N08,3184,18,1434786177,1434786627,1,1,450
26153219@N00,3185,28,1284597451,1284597851,5,9,400
26153219@N00,3185,16,1284597851,1284598121,5,9,270
26153219@N00,3185,29,1284598226,1284599126,2,9,900
26153219@N00,3185,22,1284599691,1284600291,3,9,600
26153219@N00,3185,29,1284600586,1284601486,3,9,900
26153219@N00,3185,28,1284622376,1284623260,3,9,884
26153219@N00,3185,16,1284623260,1284623530,3,9,270
26153219@N00,3185,4,1284624640,1284624741,2,9,101
26153219@N00,3185,16,1284630693,1284630963,1,9,270
26161002@N03,3186,27,1321139767,1321140667,2,4,900
26161002@N03,3186,20,1321144194,1321144734,3,4,540
26161002@N03,3186,17,1321150218,1321150518,2,4,300
26161002@N03,3186,25,1321167386,1321168226,3,4,840
26163728@N02,3187,1,1241834884,1241834944,11,1,60
26168151@N00,3188,20,1279162116,1279162656,1,1,540
26170480@N05,3189,1,1380437434,1380437494,2,3,60
26170480@N05,3189,24,1380439013,1380439582,3,3,569
26170480@N05,3189,16,1380439582,1380439852,1,3,270
26173770@N06,3190,1,1370646902,1370646962,1,1,60
26173770@N06,3191,31,1370837602,1370839102,1,1,1500
26175247@N00,3192,25,1312678285,1312679125,2,4,840
26175247@N00,3192,18,1312682546,1312682996,2,4,450
26175247@N00,3192,1,1312689795,1312689855,2,4,60
26175247@N00,3192,29,1312695971,1312696871,1,4,900
26232027@N02,3193,10,1209715247,1209715487,1,1,240
26232027@N02,3194,30,1218955812,1218956892,1,1,1080
26251489@N04,3195,29,1292147927,1292148827,1,1,900
26284290@N05,3196,22,1241272800,1241272801,2,2,1
26284290@N05,3196,16,1241272801,1241273071,1,2,270
26284290@N05,3197,28,1274450400,1274451300,1,1,900
26284290@N05,3198,3,1290862800,1290862801,2,2,1
26284290@N05,3198,31,1290862801,1290864301,2,2,1500
26284290@N05,3199,29,1299330000,1299330003,2,2,3
26284290@N05,3199,28,1299330003,1299330903,1,2,900
26284290@N05,3200,17,1375663913,1375664213,1,1,300
26312461@N00,3201,20,1234779592,1234780132,1,1,540
26326476@N05,3202,29,1350985420,1350986320,1,1,900
26340416@N07,3203,16,1312291080,1312291350,1,1,270
26340416@N07,3204,27,1316583972,1316584872,1,1,900
26340416@N07,3205,28,1321418274,1321419174,1,1,900
26340416@N07,3206,28,1328429254,1328430154,2,2,900
26340416@N07,3206,23,1328434795,1328435395,1,2,600
26340416@N07,3207,28,1330500099,1330500999,1,1,900
26340416@N07,3208,28,1335261993,1335262893,1,1,900
26340416@N07,3209,16,1338693678,1338693948,2,2,270
26340416@N07,3209,28,1338719571,1338720471,1,2,900
26340416@N07,3210,28,1339484543,1339485443,3,2,900
26340416@N07,3210,27,1339501842,1339502742,1,2,900
26340416@N07,3211,28,1340698345,1340699245,1,1,900
26340416@N07,3212,28,1342954899,1342955799,1,1,900
26340416@N07,3213,28,1348552650,1348553550,2,1,900
26340416@N07,3214,30,1348999409,1349000489,2,2,1080
26340416@N07,3214,28,1349012483,1349013383,1,2,900
26340416@N07,3215,28,1349055411,1349056311,1,1,900
26340416@N07,3216,28,1353080539,1353081439,1,1,900
26340416@N07,3217,29,1355048692,1355049592,1,1,900
26340416@N07,3218,16,1355987066,1355987336,1,1,270
26340416@N07,3219,18,1357895651,1357896101,2,2,450
26340416@N07,3219,28,1357900701,1357901601,1,2,900
26340416@N07,3220,1,1366547170,1366547230,1,1,60
26376681@N00,3221,11,1377651434,1377651674,1,1,240
26391574@N07,3222,26,1217229427,1217230327,29,1,900
26392736@N03,3223,18,1449001923,1449002373,2,2,450
26392736@N03,3223,28,1449008423,1449009323,1,2,900
26392736@N03,3224,18,1452670611,1452671061,1,1,450
26392736@N03,3225,18,1456686505,1456686955,1,1,450
26410425@N03,3226,28,1245013976,1245014876,102,1,900
26415623@N00,3227,26,1276658678,1276659235,3,6,557
26415623@N00,3227,7,1276659235,1276659415,3,6,180
26415623@N00,3227,21,1276659872,1276660442,5,6,570
26415623@N00,3227,25,1276662451,1276663291,2,6,840
26415623@N00,3227,15,1276666461,1276666731,2,6,270
26415623@N00,3227,4,1276687204,1276687305,1,6,101
26433797@N00,3228,26,1240101007,1240101907,16,1,900
26433797@N00,3229,26,1240193313,1240194213,12,1,900
26433797@N00,3230,26,1240268325,1240269225,9,1,900
26460999@N02,3231,28,1297853869,1297854769,5,2,900
26460999@N02,3231,13,1297857946,1297858186,8,2,240
26475706@N08,3232,26,1335476457,1335477357,3,2,900
26475706@N08,3232,16,1335478396,1335478666,1,2,270
26522673@N07,3233,1,1203560048,1203560108,2,22,60
26522673@N07,3233,28,1203560197,1203560664,8,22,467
26522673@N07,3233,26,1203560664,1203561564,2,22,900
26522673@N07,3233,17,1203562910,1203562950,2,22,40
26522673@N07,3233,15,1203562950,1203563082,2,22,132
26522673@N07,3233,12,1203563082,1203563322,2,22,240
26522673@N07,3233,24,1203564116,1203564896,2,22,780
26522673@N07,3233,27,1203568214,1203569114,2,22,900
26522673@N07,3233,17,1203569456,1203569756,3,22,300
26522673@N07,3233,27,1203570408,1203570532,2,22,124
26522673@N07,3233,23,1203570532,1203571132,2,22,600
26522673@N07,3233,18,1203571676,1203571941,5,22,265
26522673@N07,3233,19,1203571941,1203572481,2,22,540
26522673@N07,3233,18,1203572585,1203573035,2,22,450
26522673@N07,3233,10,1203576680,1203576920,3,22,240
26522673@N07,3233,31,1203578269,1203579769,2,22,1500
26522673@N07,3233,30,1203580540,1203581620,2,22,1080
26522673@N07,3233,22,1203582121,1203582135,2,22,14
26522673@N07,3233,20,1203582135,1203582675,3,22,540
26522673@N07,3233,21,1203587476,1203587538,2,22,62
26522673@N07,3233,3,1203587538,1203587628,2,22,90
26522673@N07,3233,28,1203590078,1203590978,1,22,900
26522673@N07,3234,12,1203975503,1203975743,1,1,240
26522673@N07,3235,23,1211536724,1211536736,2,2,12
26522673@N07,3235,24,1211536736,1211537516,1,2,780
26522673@N07,3236,22,1212410758,1212411358,1,1,600
26522673@N07,3237,22,1213268390,1213268990,1,1,600
26522673@N07,3238,16,1216453378,1216453648,1,1,270
26522673@N07,3239,12,1222855879,1222856119,2,1,240
26522673@N07,3240,24,1226104814,1226105594,1,1,780
26522673@N07,3241,12,1226325574,1226325814,1,1,240
26538493@N00,3242,26,1234568481,1234569381,3,11,900
26538493@N00,3242,10,1234570971,1234571211,4,11,240
26538493@N00,3242,26,1234575000,1234575900,2,11,900
26538493@N00,3242,12,1234577560,1234577800,2,11,240
26538493@N00,3242,26,1234578511,1234579411,2,11,900
26538493@N00,3242,25,1234590916,1234591756,3,11,840
26538493@N00,3242,26,1234596224,1234597124,2,11,900
26538493@N00,3242,25,1234598023,1234598414,2,11,391
26538493@N00,3242,8,1234598414,1234598594,2,11,180
26538493@N00,3242,16,1234602076,1234602346,3,11,270
26538493@N00,3242,26,1234608108,1234609008,1,11,900
26544234@N03,3243,30,1399969092,1399970172,6,1,1080
26544234@N03,3244,28,1418902564,1418903464,3,2,900
26544234@N03,3244,25,1418904039,1418904879,2,2,840
26565770@N02,3245,28,1404258804,1404259704,66,1,900
26565770@N02,3246,28,1408529758,1408530658,1,1,900
26567016@N08,3247,28,1218705863,1218706763,1,1,900
26568149@N00,3248,1,1236125306,1236125366,3,34,60
26568149@N00,3248,28,1236125518,1236126418,2,34,900
26568149@N00,3248,14,1236127436,1236127676,3,34,240
26568149@N00,3248,26,1236128892,1236129174,2,34,282
26568149@N00,3248,4,1236129174,1236129275,3,34,101
26568149@N00,3248,15,1236132162,1236132432,2,34,270
26568149@N00,3248,24,1236132451,1236133231,13,34,780
26568149@N00,3248,16,1236137795,1236138065,2,34,270
26568149@N00,3248,13,1236138514,1236138605,2,34,91
26568149@N00,3248,21,1236138605,1236138837,2,34,232
26568149@N00,3248,8,1236138837,1236139017,2,34,180
26568149@N00,3248,16,1236139573,1236139843,4,34,270
26568149@N00,3248,26,1236140916,1236141267,4,34,351
26568149@N00,3248,16,1236141267,1236141537,4,34,270
26568149@N00,3248,27,1236142462,1236143362,2,34,900
26568149@N00,3248,24,1236143471,1236144251,4,34,780
26568149@N00,3248,12,1236144694,1236144773,2,34,79
26568149@N00,3248,25,1236144773,1236144819,2,34,46
26568149@N00,3248,12,1236144819,1236145036,2,34,217
26568149@N00,3248,24,1236145036,1236145197,2,34,161
26568149@N00,3248,15,1236145197,1236145467,3,34,270
26568149@N00,3248,1,1236146073,1236146133,2,34,60
26568149@N00,3248,18,1236147910,1236148360,4,34,450
26568149@N00,3248,29,1236149669,1236150569,2,34,900
26568149@N00,3248,13,1236153133,1236153373,4,34,240
26568149@N00,3248,25,1236153548,1236153760,2,34,212
26568149@N00,3248,4,1236153760,1236153861,4,34,101
26568149@N00,3248,7,1236154447,1236154627,3,34,180
26568149@N00,3248,6,1236154940,1236154992,2,34,52
26568149@N00,3248,7,1236154992,1236155102,2,34,110
26568149@N00,3248,8,1236155102,1236155196,2,34,94
26568149@N00,3248,26,1236155196,1236155434,2,34,238
26568149@N00,3248,16,1236155434,1236155704,5,34,270
26568149@N00,3248,28,1236156269,1236157169,1,34,900
26568149@N00,3249,1,1245059865,1245059925,4,3,60
26568149@N00,3249,28,1245060233,1245061133,3,3,900
26568149@N00,3249,27,1245061217,1245062117,2,3,900
26616207@N00,3250,1,1293415060,1293415120,2,4,60
26616207@N00,3250,25,1293422924,1293423764,2,4,840
26616207@N00,3250,24,1293441394,1293442174,2,4,780
26616207@N00,3250,29,1293455072,1293455972,1,4,900
26616207@N00,3251,21,1336537108,1336537117,2,2,9
26616207@N00,3251,5,1336537117,1336537237,1,2,120
26624922@N03,3252,18,1469494883,1469495333,2,5,450
26624922@N03,3252,15,1469496579,1469496849,4,5,270
26624922@N03,3252,21,1469511084,1469511654,2,5,570
26624922@N03,3252,27,1469512272,1469513172,2,5,900
26624922@N03,3252,16,1469515893,1469516163,4,5,270
26631756@N04,3253,28,1243041901,1243042801,1,1,900
26640890@N04,3254,28,1325813899,1325814799,1,1,900
26640890@N04,3255,28,1352774411,1352775311,2,1,900
26646647@N04,3256,16,1336036281,1336036551,1,1,270
26646647@N04,3257,28,1348653664,1348654564,1,1,900
26670686@N06,3258,7,1459313518,1459313698,2,2,180
26670686@N06,3258,26,1459321469,1459322369,1,2,900
26670686@N06,3259,15,1464313688,1464313867,2,4,179
26670686@N06,3259,27,1464313867,1464313869,2,4,2
26670686@N06,3259,16,1464313869,1464313923,2,4,54
26670686@N06,3259,28,1464313923,1464314823,1,4,900
26670686@N06,3260,29,1465110649,1465111549,1,1,900
26670686@N06,3261,28,1465557021,1465557921,2,1,900
26670686@N06,3262,26,1468720490,1468721390,2,2,900
26670686@N06,3262,22,1468749268,1468749868,1,2,600
26670686@N06,3263,16,1469938814,1469939084,1,1,270
26681113@N00,3264,19,1405418314,1405418854,1,1,540
26704339@N05,3265,17,1211255887,1211255895,2,4,8
26704339@N05,3265,7,1211255895,1211256075,2,4,180
26704339@N05,3265,15,1211262019,1211262040,2,4,21
26704339@N05,3265,12,1211262040,1211262280,1,4,240
26766729@N06,3266,16,1286110514,1286110784,2,2,270
26766729@N06,3266,28,1286113692,1286114592,1,2,900
26766729@N06,3267,30,1287318466,1287319546,1,1,1080
26794632@N00,3268,1,1383083326,1383083386,1,1,60
26806480@N07,3269,26,1439890466,1439891366,9,1,900
26806480@N07,3270,26,1439976677,1439977577,3,1,900
26806480@N07,3271,26,1440063105,1440064005,2,1,900
26806480@N07,3272,26,1455676758,1455677658,34,1,900
26806480@N07,3273,26,1458795868,1458796768,7,1,900
26806480@N07,3274,26,1461313672,1461314572,10,1,900
26806480@N07,3275,26,1464184427,1464185327,2,1,900
26806480@N07,3276,26,1464270860,1464271760,3,1,900
26854278@N08,3277,18,1191460156,1191460606,3,1,450
26874770@N06,3278,16,1219845887,1219846157,1,1,270
26874770@N06,3279,24,1219888147,1219888927,1,1,780
26874770@N06,3280,29,1219927656,1219928556,3,2,900
26874770@N06,3280,20,1219929721,1219930261,1,2,540
26874770@N06,3281,1,1219974097,1219974157,3,6,60
26874770@N06,3281,29,1219976876,1219976904,2,6,28
26874770@N06,3281,31,1219976904,1219978404,2,6,1500
26874770@N06,3281,20,1219981981,1219982234,2,6,253
26874770@N06,3281,29,1219982234,1219983134,2,6,900
26874770@N06,3281,24,1219985743,1219986523,2,6,780
26874770@N06,3282,17,1220017689,1220017989,3,2,300
26874770@N06,3282,20,1220021809,1220022349,4,2,540
26874770@N06,3283,15,1220061084,1220061354,3,9,270
26874770@N06,3283,27,1220062570,1220062591,2,9,21
26874770@N06,3283,17,1220062591,1220062615,2,9,24
26874770@N06,3283,27,1220062615,1220062730,2,9,115
26874770@N06,3283,24,1220062730,1220062903,2,9,173
26874770@N06,3283,17,1220062903,1220063045,2,9,142
26874770@N06,3283,15,1220063045,1220063149,2,9,104
26874770@N06,3283,24,1220063149,1220063929,8,9,780
26874770@N06,3283,27,1220064688,1220065588,1,9,900
26874770@N06,3284,29,1220194427,1220195327,5,1,900
26874770@N06,3285,27,1220231526,1220232426,5,15,900
26874770@N06,3285,17,1220236229,1220236529,3,15,300
26874770@N06,3285,24,1220237148,1220237302,2,15,154
26874770@N06,3285,25,1220237302,1220237448,2,15,146
26874770@N06,3285,4,1220237448,1220237549,2,15,101
26874770@N06,3285,22,1220241006,1220241131,2,15,125
26874770@N06,3285,31,1220241131,1220241470,3,15,339
26874770@N06,3285,22,1220241470,1220241905,4,15,435
26874770@N06,3285,31,1220241905,1220242020,2,15,115
26874770@N06,3285,22,1220242020,1220242274,2,15,254
26874770@N06,3285,31,1220242274,1220242322,2,15,48
26874770@N06,3285,29,1220242322,1220242470,2,15,148
26874770@N06,3285,31,1220242470,1220243970,4,15,1500
26874770@N06,3285,29,1220263200,1220264100,2,15,900
26874770@N06,3285,5,1220277666,1220277786,1,15,120
26874770@N06,3286,16,1220318777,1220318901,2,7,124
26874770@N06,3286,27,1220318901,1220319568,2,7,667
26874770@N06,3286,17,1220319568,1220319868,3,7,300
26874770@N06,3286,12,1220320767,1220321007,2,7,240
26874770@N06,3286,24,1220322478,1220323077,2,7,599
26874770@N06,3286,5,1220323077,1220323197,2,7,120
26874770@N06,3286,29,1220330205,1220331105,5,7,900
26874770@N06,3287,20,1220416002,1220416542,2,6,540
26874770@N06,3287,16,1220417995,1220418265,2,6,270
26874770@N06,3287,5,1220419121,1220419241,2,6,120
26874770@N06,3287,17,1220420581,1220420881,2,6,300
26874770@N06,3287,25,1220439227,1220439480,2,6,253
26874770@N06,3287,24,1220439480,1220440260,1,6,780
26874770@N06,3288,17,1220515210,1220515220,2,4,10
26874770@N06,3288,15,1220515220,1220515369,3,4,149
26874770@N06,3288,24,1220515369,1220516149,3,4,780
26874770@N06,3288,31,1220533433,1220534933,3,4,1500
26874770@N06,3289,31,1220594472,1220594768,5,5,296
26874770@N06,3289,16,1220594768,1220594794,2,5,26
26874770@N06,3289,24,1220594794,1220595574,2,5,780
26874770@N06,3289,20,1220597794,1220598334,2,5,540
26874770@N06,3289,24,1220598652,1220599432,1,5,780
26874770@N06,3290,3,1221310505,1221310595,1,1,90
26874770@N06,3291,5,1225154112,1225154232,4,8,120
26874770@N06,3291,16,1225159833,1225160103,7,8,270
26874770@N06,3291,17,1225163100,1225163108,2,8,8
26874770@N06,3291,27,1225163108,1225163491,2,8,383
26874770@N06,3291,26,1225163491,1225164269,2,8,778
26874770@N06,3291,29,1225164269,1225164380,2,8,111
26874770@N06,3291,20,1225164380,1225164920,2,8,540
26874770@N06,3291,29,1225165975,1225166875,4,8,900
26874770@N06,3292,29,1225250154,1225251054,3,2,900
26874770@N06,3292,20,1225253756,1225254296,8,2,540
26874770@N06,3293,5,1225326275,1225326395,2,4,120
26874770@N06,3293,24,1225328478,1225329258,2,4,780
26874770@N06,3293,20,1225330150,1225330690,3,4,540
26874770@N06,3293,17,1225335466,1225335766,2,4,300
26874770@N06,3294,20,1225447102,1225447642,2,5,540
26874770@N06,3294,16,1225453524,1225453534,2,5,10
26874770@N06,3294,27,1225453534,1225453741,3,5,207
26874770@N06,3294,29,1225453741,1225454281,2,5,540
26874770@N06,3294,20,1225454281,1225454821,1,5,540
26874770@N06,3295,6,1227003239,1227003359,1,1,120
26874770@N06,3296,27,1227701324,1227702224,1,1,900
26874770@N06,3297,15,1228548303,1228548573,1,1,270
26874770@N06,3298,20,1229074296,1229074836,2,1,540
26874770@N06,3299,15,1248234522,1248234792,2,3,270
26874770@N06,3299,26,1248239994,1248240894,12,3,900
26874770@N06,3299,20,1248240995,1248241535,1,3,540
26874770@N06,3300,25,1248318999,1248319772,2,2,773
26874770@N06,3300,16,1248319772,1248320042,1,2,270
26874770@N06,3301,31,1276393682,1276395182,1,1,1500
26874770@N06,3302,1,1277712914,1277712974,2,2,60
26874770@N06,3302,29,1277714925,1277715825,1,2,900
26874770@N06,3303,27,1277831105,1277832005,1,1,900
26874770@N06,3304,21,1285328194,1285328764,4,3,570
26874770@N06,3304,17,1285345506,1285345806,2,3,300
26874770@N06,3304,26,1285348362,1285349262,2,3,900
26874770@N06,3305,1,1285426941,1285427001,1,1,60
26874770@N06,3306,1,1285470135,1285470195,1,1,60
26874770@N06,3307,5,1285502367,1285502487,2,3,120
26874770@N06,3307,29,1285506747,1285507647,2,3,900
26874770@N06,3307,28,1285516829,1285517729,2,3,900
26874770@N06,3308,28,1285555955,1285556855,3,7,900
26874770@N06,3308,21,1285557881,1285558451,2,7,570
26874770@N06,3308,28,1285560131,1285561031,2,7,900
26874770@N06,3308,1,1285571140,1285571200,2,7,60
26874770@N06,3308,17,1285577271,1285577571,2,7,300
26874770@N06,3308,27,1285577635,1285578056,2,7,421
26874770@N06,3308,26,1285578056,1285578956,1,7,900
26874770@N06,3309,29,1307398358,1307399258,6,1,900
26874770@N06,3310,29,1307451215,1307452115,2,1,900
26874770@N06,3311,1,1439784913,1439784973,1,1,60
26879117@N08,3312,1,1405036209,1405036269,2,2,60
26879117@N08,3312,21,1405047747,1405048317,2,2,570
26879117@N08,3313,13,1414361122,1414361362,2,3,240
26879117@N08,3313,11,1414361879,1414362119,2,3,240
26879117@N08,3313,20,1414365253,1414365793,2,3,540
26897917@N02,3314,19,1422667409,1422667949,1,1,540
26920251@N04,3315,10,1253949544,1253949784,1,1,240
26968331@N00,3316,26,1212541275,1212542175,10,1,900
26970624@N02,3317,26,1438656074,1438656974,6,2,900
26970624@N02,3317,3,1438671554,1438671644,2,2,90
27012782@N02,3318,26,1230334306,1230335206,39,1,900
27012782@N02,3319,26,1261875139,1261876039,11,1,900
27045606@N06,3320,29,1325478529,1325479429,1,1,900
27045606@N06,3321,24,1358226860,1358227640,1,1,780
27059988@N08,3322,17,1365938011,1365938311,1,1,300
27059988@N08,3323,1,1460839207,1460839267,1,1,60
27059988@N08,3324,1,1461486615,1461486675,1,1,60
27059988@N08,3325,1,1462003224,1462003284,1,1,60
27087639@N00,3326,15,1399888015,1399888285,1,1,270
27103307@N00,3327,7,1388581366,1388581546,2,1,180
27103307@N00,3328,28,1388732177,1388733077,1,1,900
27107561@N00,3329,28,1269056297,1269057174,3,2,877
27107561@N00,3329,19,1269057174,1269057714,8,2,540
27116474@N08,3330,28,1213143589,1213144489,2,3,900
27116474@N08,3330,12,1213151261,1213151501,2,3,240
27116474@N08,3330,20,1213166521,1213167061,1,3,540
27136682@N00,3331,26,1209089584,1209090484,2,7,900
27136682@N00,3331,23,1209095123,1209095723,5,7,600
27136682@N00,3331,31,1209097799,1209099299,2,7,1500
27136682@N00,3331,3,1209117043,1209117133,2,7,90
27136682@N00,3331,30,1209117493,1209118519,2,7,1026
27136682@N00,3331,29,1209118519,1209119419,4,7,900
27136682@N00,3331,28,1209119848,1209120748,1,7,900
27136682@N00,3332,6,1209179741,1209179861,2,2,120
27136682@N00,3332,19,1209186442,1209186982,1,2,540
27136682@N00,3333,4,1209252537,1209252638,2,2,101
27136682@N00,3333,3,1209253755,1209253845,1,2,90
27176897@N05,3334,18,1447671773,1447672223,5,2,450
27176897@N05,3334,15,1447672450,1447672720,1,2,270
27188738@N02,3335,17,1334123788,1334124088,1,1,300
27188738@N02,3336,30,1334180851,1334181931,1,1,1080
27188738@N02,3337,17,1334364766,1334365066,1,1,300
27190564@N02,3338,26,1356499853,1356500753,39,4,900
27190564@N02,3338,22,1356559172,1356559772,2,4,600
27190564@N02,3338,30,1356562592,1356563672,5,4,1080
27190564@N02,3338,26,1356568569,1356569469,36,4,900
27190564@N02,3339,26,1356739090,1356739990,8,1,900
27190564@N02,3340,30,1356860279,1356861359,6,6,1080
27190564@N02,3340,26,1356881498,1356882398,2,6,900
27190564@N02,3340,30,1356887046,1356888126,19,6,1080
27190564@N02,3340,26,1356908746,1356909646,19,6,900
27190564@N02,3340,30,1356916727,1356917807,2,6,1080
27190564@N02,3340,26,1356927158,1356928058,7,6,900
27191491@N06,3341,28,1355004446,1355005346,1,1,900
27204329@N02,3342,28,1216045370,1216046270,14,1,900
27204329@N02,3343,28,1216080957,1216081857,169,1,900
27205052@N05,3344,1,1299450495,1299450555,2,29,60
27205052@N05,3344,28,1299450569,1299450849,4,29,280
27205052@N05,3344,27,1299450849,1299450967,2,29,118
27205052@N05,3344,24,1299450967,1299451747,3,29,780
27205052@N05,3344,25,1299454400,1299455240,9,29,840
27205052@N05,3344,7,1299456764,1299456808,2,29,44
27205052@N05,3344,6,1299456808,1299456928,3,29,120
27205052@N05,3344,30,1299456953,1299458033,10,29,1080
27205052@N05,3344,29,1299460981,1299461132,3,29,151
27205052@N05,3344,19,1299461132,1299461596,2,29,464
27205052@N05,3344,29,1299461596,1299462496,8,29,900
27205052@N05,3344,20,1299462611,1299463151,2,29,540
27205052@N05,3344,29,1299463949,1299464849,7,29,900
27205052@N05,3344,18,1299465405,1299465855,16,29,450
27205052@N05,3344,26,1299468507,1299469407,2,29,900
27205052@N05,3344,12,1299469554,1299469794,2,29,240
27205052@N05,3344,24,1299470740,1299471520,2,29,780
27205052@N05,3344,25,1299473508,1299474348,2,29,840
27205052@N05,3344,15,1299474364,1299474634,8,29,270
27205052@N05,3344,17,1299477324,1299477624,5,29,300
27205052@N05,3344,24,1299478930,1299479528,2,29,598
27205052@N05,3344,1,1299479528,1299479588,2,29,60
27205052@N05,3344,24,1299479607,1299480172,3,29,565
27205052@N05,3344,12,1299480172,1299480412,2,29,240
27205052@N05,3344,30,1299480992,1299482072,2,29,1080
27205052@N05,3344,19,1299483869,1299484409,6,29,540
27205052@N05,3344,29,1299484740,1299485640,4,29,900
27205052@N05,3344,26,1299486656,1299487556,4,29,900
27205052@N05,3344,28,1299487669,1299488569,1,29,900
27245281@N05,3345,29,1278143228,1278144128,1,1,900
27249348@N03,3346,1,1370059310,1370059370,2,1,60
27258925@N00,3347,28,1218972117,1218973017,2,1,900
27258925@N00,3348,27,1239538050,1239538950,1,1,900
27258925@N00,3349,16,1239668954,1239669224,3,2,270
27258925@N00,3349,28,1239675225,1239676125,4,2,900
27258925@N00,3350,3,1281993733,1281993820,5,3,87
27258925@N00,3350,7,1281993820,1281993831,2,3,11
27258925@N00,3350,12,1281993831,1281994071,3,3,240
27258925@N00,3351,26,1282042438,1282043338,1,1,900
27258925@N00,3352,17,1287736898,1287737198,3,2,300
27258925@N00,3352,10,1287738048,1287738288,1,2,240
27261720@N00,3353,19,1202308208,1202308748,1,1,540
27270059@N04,3354,10,1218793405,1218793645,10,1,240
27270059@N04,3355,10,1221881629,1221881869,14,1,240
27270059@N04,3356,10,1224387733,1224387973,6,1,240
27270059@N04,3357,10,1224915216,1224915456,1,1,240
27270059@N04,3358,10,1227507520,1227507760,3,1,240
27270059@N04,3359,10,1230778322,1230778562,10,1,240
27270059@N04,3360,10,1235191947,1235192187,11,1,240
27270059@N04,3361,10,1235870740,1235870980,2,1,240
27276174@N07,3362,1,1368066971,1368067031,1,1,60
27343295@N07,3363,28,1230418387,1230419287,2,1,900
27343295@N07,3364,9,1230448999,1230449179,2,4,180
27343295@N07,3364,24,1230455625,1230456405,2,4,780
27343295@N07,3364,21,1230456947,1230457189,2,4,242
27343295@N07,3364,26,1230457189,1230458089,1,4,900
27343295@N07,3365,22,1230507586,1230508020,2,5,434
27343295@N07,3365,14,1230508020,1230508260,3,5,240
27343295@N07,3365,28,1230509230,1230510130,4,5,900
27343295@N07,3365,17,1230532342,1230532642,2,5,300
27343295@N07,3365,7,1230533724,1230533904,1,5,180
27343295@N07,3366,26,1232881855,1232882755,1,1,900
27365671@N00,3367,20,1353646551,1353647091,1,1,540
27365671@N00,3368,27,1383435034,1383435934,2,3,900
27365671@N00,3368,7,1383451100,1383451280,2,3,180
27365671@N00,3368,5,1383451921,1383452041,1,3,120
27365671@N00,3369,18,1417297499,1417297949,2,3,450
27365671@N00,3369,11,1417304097,1417304337,2,3,240
27365671@N00,3369,20,1417305100,1417305640,2,3,540
27365671@N00,3370,21,1419371883,1419372453,1,1,570
27374044@N00,3371,28,1280810144,1280810566,3,9,422
27374044@N00,3371,27,1280810566,1280811466,2,9,900
27374044@N00,3371,26,1280812730,1280813630,2,9,900
27374044@N00,3371,15,1280815075,1280815345,2,9,270
27374044@N00,3371,20,1280817933,1280818473,3,9,540
27374044@N00,3371,13,1280822104,1280822112,2,9,8
27374044@N00,3371,25,1280822112,1280822607,2,9,495
27374044@N00,3371,1,1280822607,1280822667,2,9,60
27374044@N00,3371,28,1280823949,1280824849,5,9,900
27374044@N00,3372,30,1280897801,1280898881,6,10,1080
27374044@N00,3372,10,1280900497,1280900737,4,10,240
27374044@N00,3372,26,1280903835,1280904735,2,10,900
27374044@N00,3372,1,1280907745,1280907805,2,10,60
27374044@N00,3372,28,1280910684,1280911584,7,10,900
27374044@N00,3372,24,1280912969,1280913749,3,10,780
27374044@N00,3372,12,1280914325,1280914565,2,10,240
27374044@N00,3372,25,1280916102,1280916695,2,10,593
27374044@N00,3372,21,1280916695,1280917265,3,10,570
27374044@N00,3372,26,1280917348,1280918248,4,10,900
27374044@N00,3373,28,1312519752,1312520652,1,1,900
27379479@N00,3374,23,1308314557,1308315157,1,1,600
27379479@N00,3375,26,1308461439,1308462339,1,1,900
27379479@N00,3376,28,1308569604,1308570504,1,1,900
27388187@N07,3377,1,1310518939,1310518999,2,5,60
27388187@N07,3377,19,1310521681,1310522221,3,5,540
27388187@N07,3377,20,1310528987,1310529527,2,5,540
27388187@N07,3377,4,1310535831,1310535932,2,5,101
27388187@N07,3377,3,1310536350,1310536440,3,5,90
27388187@N07,3378,21,1310605061,1310605631,2,3,570
27388187@N07,3378,22,1310606995,1310607595,2,3,600
27388187@N07,3378,1,1310627827,1310627887,1,3,60
27428435@N00,3379,14,1244347545,1244347785,2,2,240
27428435@N00,3379,4,1244358002,1244358103,1,2,101
27428435@N00,3380,28,1261619243,1261620143,1,1,900
27428435@N00,3381,3,1266033980,1266034070,1,1,90
27428435@N00,3382,24,1266647328,1266648108,1,1,780
27428435@N00,3383,13,1280557613,1280557853,2,1,240
27428435@N00,3384,1,1290568806,1290568866,2,1,60
27428435@N00,3385,14,1293154367,1293154607,1,1,240
27452410@N00,3386,26,1374839679,1374840579,1,1,900
27453680@N05,3387,26,1246581301,1246582201,2,4,900
27453680@N05,3387,30,1246598961,1246600041,2,4,1080
27453680@N05,3387,22,1246601728,1246602328,2,4,600
27453680@N05,3387,16,1246618286,1246618556,1,4,270
27464730@N06,3388,13,1332573777,1332574017,1,1,240
27464730@N06,3389,27,1332721659,1332722559,3,2,900
27464730@N06,3389,24,1332748644,1332749424,1,2,780
27466777@N05,3390,1,1190435294,1190435354,1,1,60
27467292@N03,3391,3,1261427448,1261427538,1,1,90
27467292@N03,3392,23,1268178005,1268178605,1,1,600
27467292@N03,3393,10,1275941873,1275942113,1,1,240
27467292@N03,3394,27,1276023761,1276024661,1,1,900
27467292@N03,3395,13,1299582628,1299582868,1,1,240
27467292@N03,3396,6,1299717343,1299717463,1,1,120
27467292@N03,3397,6,1307136985,1307137105,1,1,120
27467292@N03,3398,28,1307222019,1307222919,1,1,900
27467292@N03,3399,13,1307263409,1307263649,1,1,240
27467292@N03,3400,1,1333486211,1333486271,2,2,60
27467292@N03,3400,26,1333488912,1333489812,2,2,900
27468992@N04,3401,26,1219317405,1219318305,3,2,900
27468992@N04,3401,17,1219327261,1219327561,1,2,300
27468992@N04,3402,19,1219416428,1219416968,2,1,540
27502547@N02,3403,26,1354956350,1354957250,1,1,900
27502547@N02,3404,29,1355119396,1355120296,1,1,900
27502547@N02,3405,30,1355189233,1355190313,1,1,1080
27522121@N02,3406,27,1276570169,1276571069,1,1,900
27527078@N05,3407,28,1310955569,1310956469,4,2,900
27527078@N05,3407,9,1310957538,1310957718,2,2,180
27527078@N05,3408,25,1311154158,1311154998,2,1,840
27527078@N05,3409,1,1311217101,1311217161,4,3,60
27527078@N05,3409,5,1311218607,1311218727,5,3,120
27527078@N05,3409,4,1311236209,1311236310,1,3,101
27534487@N08,3410,30,1351573908,1351574988,1,1,1080
27534487@N08,3411,17,1355290154,1355290454,1,1,300
27534487@N08,3412,17,1358128649,1358128949,2,2,300
27534487@N08,3412,23,1358133694,1358134294,1,2,600
27534487@N08,3413,17,1360716988,1360717288,2,2,300
27534487@N08,3413,23,1360722286,1360722886,1,2,600
27534487@N08,3414,18,1362011795,1362012245,2,3,450
27534487@N08,3414,28,1362012738,1362013638,2,3,900
27534487@N08,3414,29,1362028998,1362029898,1,3,900
27534487@N08,3415,10,1365486628,1365486868,1,1,240
27534487@N08,3416,15,1366687684,1366687954,2,1,270
27534487@N08,3417,29,1368090148,1368091048,1,1,900
27534487@N08,3418,13,1369726472,1369726712,1,1,240
27534487@N08,3419,29,1389241230,1389242130,1,1,900
27534487@N08,3420,28,1394516348,1394517248,1,1,900
27534487@N08,3421,17,1422968579,1422968879,1,1,300
27537590@N00,3422,26,1354481956,1354482856,1,1,900
27550464@N05,3423,13,1236830404,1236830644,1,1,240
27583299@N03,3424,20,1241685218,1241685758,1,1,540
27583299@N03,3425,28,1306218069,1306218969,2,2,900
27583299@N03,3425,26,1306235618,1306236518,1,2,900
27583299@N03,3426,23,1332295641,1332296241,1,1,600
27583299@N03,3427,30,1332819314,1332820394,2,2,1080
27583299@N03,3427,28,1332835090,1332835990,2,2,900
27583299@N03,3428,17,1370213129,1370213429,1,1,300
27609173@N03,3429,18,1306966211,1306966661,2,12,450
27609173@N03,3429,16,1306966738,1306967008,6,12,270
27609173@N03,3429,4,1306980180,1306980281,4,12,101
27609173@N03,3429,21,1306980620,1306980731,2,12,111
27609173@N03,3429,5,1306980731,1306980771,2,12,40
27609173@N03,3429,21,1306980771,1306981341,2,12,570
27609173@N03,3429,25,1306981784,1306982624,6,12,840
27609173@N03,3429,13,1306982744,1306982984,2,12,240
27609173@N03,3429,5,1306983628,1306983748,3,12,120
27609173@N03,3429,21,1306983930,1306984262,3,12,332
27609173@N03,3429,3,1306984262,1306984352,2,12,90
27609173@N03,3429,15,1306989499,1306989769,1,12,270
27615993@N03,3430,29,1271227031,1271227931,1,1,900
27637794@N05,3431,28,1335421962,1335422862,2,2,900
27637794@N05,3431,7,1335436669,1335436849,1,2,180
27666630@N00,3432,18,1401445635,1401446085,1,1,450
27668789@N00,3433,28,1195696688,1195697588,24,1,900
27681352@N05,3434,1,1239011331,1239011391,1,1,60
27693484@N06,3435,26,1466244791,1466245691,1,1,900
27702462@N07,3436,18,1358575499,1358575949,2,2,450
27702462@N07,3436,20,1358592416,1358592956,1,2,540
27702462@N07,3437,27,1358650169,1358651069,2,7,900
27702462@N07,3437,12,1358657681,1358657921,2,7,240
27702462@N07,3437,25,1358660570,1358661410,2,7,840
27702462@N07,3437,5,1358663828,1358663948,2,7,120
27702462@N07,3437,13,1358664403,1358664643,2,7,240
27702462@N07,3437,12,1358667417,1358667657,2,7,240
27702462@N07,3437,17,1358685399,1358685699,1,7,300
27705062@N03,3438,26,1466423675,1466424575,1,1,900
27711944@N03,3439,26,1468824066,1468824966,1,1,900
27745483@N07,3440,19,1419836337,1419836877,5,22,540
27745483@N07,3440,21,1419863073,1419863156,2,22,83
27745483@N07,3440,25,1419863156,1419863777,3,22,621
27745483@N07,3440,19,1419863777,1419863929,2,22,152
27745483@N07,3440,30,1419863929,1419863943,2,22,14
27745483@N07,3440,29,1419863943,1419864010,2,22,67
27745483@N07,3440,19,1419864010,1419864086,2,22,76
27745483@N07,3440,23,1419864086,1419864169,2,22,83
27745483@N07,3440,26,1419864169,1419864479,3,22,310
27745483@N07,3440,23,1419864479,1419865079,2,22,600
27745483@N07,3440,19,1419865865,1419866090,2,22,225
27745483@N07,3440,23,1419866090,1419866244,2,22,154
27745483@N07,3440,28,1419866244,1419867144,2,22,900
27745483@N07,3440,23,1419867334,1419867441,3,22,107
27745483@N07,3440,19,1419867441,1419867556,4,22,115
27745483@N07,3440,27,1419867556,1419867796,4,22,240
27745483@N07,3440,7,1419867796,1419867976,2,22,180
27745483@N07,3440,23,1419868056,1419868130,2,22,74
27745483@N07,3440,18,1419868130,1419868234,2,22,104
27745483@N07,3440,19,1419868234,1419868469,2,22,235
27745483@N07,3440,15,1419868469,1419868739,3,22,270
27745483@N07,3440,19,1419869123,1419869663,3,22,540
27751748@N08,3441,9,1262056060,1262056240,2,4,180
27751748@N08,3441,30,1262065378,1262066458,3,4,1080
27751748@N08,3441,28,1262076309,1262077209,2,4,900
27751748@N08,3441,16,1262090519,1262090789,7,4,270
27761152@N03,3442,11,1223958485,1223958725,4,1,240
27761152@N03,3443,11,1227676827,1227677067,6,1,240
27801060@N00,3444,16,1430694950,1430695220,3,2,270
27801060@N00,3444,29,1430701843,1430702743,1,2,900
27813472@N00,3445,25,1358415744,1358416584,1,1,840
27813472@N00,3446,6,1358463137,1358463257,2,3,120
27813472@N00,3446,11,1358463289,1358463351,2,3,62
27813472@N00,3446,26,1358463351,1358464251,1,3,900
27813472@N00,3447,11,1360523452,1360523516,2,2,64
27813472@N00,3447,4,1360523516,1360523617,1,2,101
27813472@N00,3448,28,1360997931,1360998831,2,2,900
27813472@N00,3448,29,1361000486,1361001386,1,2,900
27813472@N00,3449,12,1361052752,1361052778,2,18,26
27813472@N00,3449,24,1361052778,1361053272,6,18,494
27813472@N00,3449,15,1361053272,1361053542,6,18,270
27813472@N00,3449,1,1361053720,1361053780,2,18,60
27813472@N00,3449,20,1361053911,1361054017,2,18,106
27813472@N00,3449,29,1361054017,1361054054,2,18,37
27813472@N00,3449,15,1361054054,1361054167,2,18,113
27813472@N00,3449,29,1361054167,1361054442,2,18,275
27813472@N00,3449,1,1361054442,1361054502,2,18,60
27813472@N00,3449,29,1361055941,1361056841,5,18,900
27813472@N00,3449,22,1361057486,1361058086,4,18,600
27813472@N00,3449,29,1361058451,1361059142,3,18,691
27813472@N00,3449,18,1361059142,1361059592,13,18,450
27813472@N00,3449,30,1361061752,1361062832,9,18,1080
27813472@N00,3449,26,1361065678,1361066122,3,18,444
27813472@N00,3449,24,1361066122,1361066733,4,18,611
27813472@N00,3449,12,1361066733,1361066973,2,18,240
27813472@N00,3449,24,1361067488,1361068268,1,18,780
27813472@N00,3450,28,1361157850,1361157940,2,10,90
27813472@N00,3450,1,1361157940,1361158000,7,10,60
27813472@N00,3450,28,1361158346,1361158548,3,10,202
27813472@N00,3450,1,1361158548,1361158608,2,10,60
27813472@N00,3450,28,1361158665,1361159565,4,10,900
27813472@N00,3450,16,1361174061,1361174331,2,10,270
27813472@N00,3450,26,1361176180,1361176892,3,10,712
27813472@N00,3450,18,1361176892,1361177342,2,10,450
27813472@N00,3450,17,1361182222,1361182522,2,10,300
27813472@N00,3450,24,1361183155,1361183935,2,10,780
27813472@N00,3451,27,1361260692,1361261592,2,9,900
27813472@N00,3451,17,1361262415,1361262715,2,9,300
27813472@N00,3451,3,1361263946,1361263976,2,9,30
27813472@N00,3451,7,1361263976,1361264089,2,9,113
27813472@N00,3451,26,1361264089,1361264989,13,9,900
27813472@N00,3451,22,1361265664,1361266264,3,9,600
27813472@N00,3451,30,1361268776,1361269165,2,9,389
27813472@N00,3451,7,1361269165,1361269345,6,9,180
27813472@N00,3451,26,1361271116,1361272016,1,9,900
27813472@N00,3452,26,1361319243,1361319507,2,23,264
27813472@N00,3452,11,1361319507,1361319730,2,23,223
27813472@N00,3452,10,1361319730,1361319762,2,23,32
27813472@N00,3452,9,1361319762,1361319891,2,23,129
27813472@N00,3452,6,1361319891,1361319898,2,23,7
27813472@N00,3452,7,1361319898,1361319952,3,23,54
27813472@N00,3452,6,1361319952,1361320072,9,23,120
27813472@N00,3452,7,1361321706,1361321886,2,23,180
27813472@N00,3452,26,1361322406,1361323306,6,23,900
27813472@N00,3452,31,1361324123,1361324132,2,23,9
27813472@N00,3452,29,1361324132,1361324267,5,23,135
27813472@N00,3452,31,1361324267,1361324371,4,23,104
27813472@N00,3452,20,1361324371,1361324409,2,23,38
27813472@N00,3452,22,1361324409,1361324723,2,23,314
27813472@N00,3452,31,1361324723,1361324732,2,23,9
27813472@N00,3452,29,1361324732,1361325615,2,23,883
27813472@N00,3452,22,1361325615,1361326215,3,23,600
27813472@N00,3452,14,1361329238,1361329478,3,23,240
27813472@N00,3452,29,1361333316,1361334080,5,23,764
27813472@N00,3452,19,1361334080,1361334620,5,23,540
27813472@N00,3452,18,1361334711,1361334891,2,23,180
27813472@N00,3452,23,1361334891,1361335491,3,23,600
27813472@N00,3452,28,1361336282,1361337182,1,23,900
27813472@N00,3453,28,1361395470,1361396370,3,5,900
27813472@N00,3453,3,1361396400,1361396490,5,5,90
27813472@N00,3453,7,1361397408,1361397483,2,5,75
27813472@N00,3453,26,1361397483,1361397723,2,5,240
27813472@N00,3453,1,1361397723,1361397783,1,5,60
27813472@N00,3454,26,1361500869,1361501769,1,1,900
27813472@N00,3455,28,1362264347,1362265247,2,1,900
27813472@N00,3456,26,1367470798,1367471033,3,8,235
27813472@N00,3456,20,1367471033,1367471196,2,8,163
27813472@N00,3456,4,1367471196,1367471297,2,8,101
27813472@N00,3456,27,1367471434,1367471530,2,8,96
27813472@N00,3456,28,1367471530,1367471982,3,8,452
27813472@N00,3456,4,1367471982,1367472083,3,8,101
27813472@N00,3456,29,1367472480,1367473380,2,8,900
27813472@N00,3456,28,1367478367,1367479267,1,8,900
27813472@N00,3457,26,1403326094,1403326994,2,2,900
27813472@N00,3457,28,1403335231,1403336131,1,2,900
27813472@N00,3458,25,1418278898,1418279738,1,1,840
27813472@N00,3459,28,1418333281,1418334181,2,8,900
27813472@N00,3459,22,1418337116,1418337716,2,8,600
27813472@N00,3459,12,1418339286,1418339526,2,8,240
27813472@N00,3459,24,1418355156,1418355936,2,8,780
27813472@N00,3459,28,1418370277,1418371177,2,8,900
27813472@N00,3459,25,1418374247,1418375087,3,8,840
27813472@N00,3459,26,1418375844,1418376561,2,8,717
27813472@N00,3459,3,1418376561,1418376651,1,8,90
27813472@N00,3460,1,1418452569,1418452629,1,1,60
27813472@N00,3461,26,1425003755,1425004655,1,1,900
27813472@N00,3462,18,1425037782,1425038232,1,1,450
27813472@N00,3463,31,1425102005,1425102011,2,6,6
27813472@N00,3463,22,1425102011,1425102611,2,6,600
27813472@N00,3463,26,1425105205,1425105716,17,6,511
27813472@N00,3463,6,1425105716,1425105743,2,6,27
27813472@N00,3463,26,1425105743,1425106643,2,6,900
27813472@N00,3463,29,1425114728,1425115628,2,6,900
27813472@N00,3464,20,1425158681,1425159221,5,9,540
27813472@N00,3464,31,1425159645,1425161145,2,9,1500
27813472@N00,3464,30,1425161282,1425161879,3,9,597
27813472@N00,3464,29,1425161879,1425161971,2,9,92
27813472@N00,3464,31,1425161971,1425162064,3,9,93
27813472@N00,3464,22,1425162064,1425162454,2,9,390
27813472@N00,3464,31,1425162454,1425162480,2,9,26
27813472@N00,3464,30,1425162480,1425162766,2,9,286
27813472@N00,3464,23,1425162766,1425163366,5,9,600
27813472@N00,3465,1,1437024051,1437024111,4,4,60
27813472@N00,3465,25,1437026190,1437027030,10,4,840
27813472@N00,3465,29,1437032509,1437033114,2,4,605
27813472@N00,3465,28,1437033114,1437034014,28,4,900
27813472@N00,3466,1,1437079597,1437079657,2,19,60
27813472@N00,3466,28,1437079697,1437080597,6,19,900
27813472@N00,3466,23,1437081055,1437081106,3,19,51
27813472@N00,3466,19,1437081106,1437081646,2,19,540
27813472@N00,3466,20,1437084471,1437084776,2,19,305
27813472@N00,3466,22,1437084776,1437084862,3,19,86
27813472@N00,3466,14,1437084862,1437084885,2,19,23
27813472@N00,3466,22,1437084885,1437084909,4,19,24
27813472@N00,3466,14,1437084909,1437085149,2,19,240
27813472@N00,3466,20,1437085204,1437085744,2,19,540
27813472@N00,3466,14,1437085933,1437086173,3,19,240
27813472@N00,3466,10,1437087744,1437087984,2,19,240
27813472@N00,3466,3,1437089687,1437089777,2,19,90
27813472@N00,3466,21,1437090671,1437091241,5,19,570
27813472@N00,3466,1,1437112472,1437112532,2,19,60
27813472@N00,3466,26,1437113214,1437114114,4,19,900
27813472@N00,3466,1,1437115240,1437115300,2,19,60
27813472@N00,3466,29,1437128899,1437129799,5,19,900
27813472@N00,3466,26,1437134468,1437135368,4,19,900
27813472@N00,3467,26,1437174192,1437175092,2,26,900
27813472@N00,3467,21,1437180597,1437180821,6,26,224
27813472@N00,3467,4,1437180821,1437180851,3,26,30
27813472@N00,3467,11,1437180851,1437181021,4,26,170
27813472@N00,3467,4,1437181021,1437181043,2,26,22
27813472@N00,3467,21,1437181043,1437181613,4,26,570
27813472@N00,3467,26,1437182367,1437182690,6,26,323
27813472@N00,3467,28,1437182690,1437183590,5,26,900
27813472@N00,3467,1,1437189762,1437189822,3,26,60
27813472@N00,3467,18,1437189985,1437190003,2,26,18
27813472@N00,3467,28,1437190003,1437190043,2,26,40
27813472@N00,3467,1,1437190043,1437190103,9,26,60
27813472@N00,3467,28,1437190611,1437191511,2,26,900
27813472@N00,3467,1,1437192797,1437192857,3,26,60
27813472@N00,3467,28,1437200621,1437200712,2,26,91
27813472@N00,3467,27,1437200712,1437201612,3,26,900
27813472@N00,3467,28,1437201622,1437201789,3,26,167
27813472@N00,3467,1,1437201789,1437201849,2,26,60
27813472@N00,3467,29,1437206118,1437206512,3,26,394
27813472@N00,3467,22,1437206512,1437206607,2,26,95
27813472@N00,3467,29,1437206607,1437207004,2,26,397
27813472@N00,3467,22,1437207004,1437207604,5,26,600
27813472@N00,3467,31,1437209973,1437210134,2,26,161
27813472@N00,3467,29,1437210134,1437210308,3,26,174
27813472@N00,3467,23,1437210308,1437210457,2,26,149
27813472@N00,3467,28,1437210457,1437211357,3,26,900
27813472@N00,3468,1,1437256063,1437256123,2,12,60
27813472@N00,3468,16,1437256855,1437256953,2,12,98
27813472@N00,3468,26,1437256953,1437257449,7,12,496
27813472@N00,3468,28,1437257449,1437257636,2,12,187
27813472@N00,3468,1,1437257636,1437257696,2,12,60
27813472@N00,3468,28,1437257760,1437257869,3,12,109
27813472@N00,3468,1,1437257869,1437257929,11,12,60
27813472@N00,3468,28,1437260471,1437261371,2,12,900
27813472@N00,3468,30,1437266940,1437267996,2,12,1056
27813472@N00,3468,1,1437267996,1437268056,4,12,60
27813472@N00,3468,28,1437274778,1437275678,5,12,900
27813472@N00,3468,30,1437280434,1437281514,2,12,1080
27813472@N00,3469,1,1437735811,1437735824,2,5,13
27813472@N00,3469,28,1437735824,1437736724,3,5,900
27813472@N00,3469,21,1437738833,1437739403,2,5,570
27813472@N00,3469,28,1437741105,1437741848,2,5,743
27813472@N00,3469,1,1437741848,1437741908,2,5,60
27813472@N00,3470,28,1437775191,1437775574,13,18,383
27813472@N00,3470,1,1437775574,1437775634,7,18,60
27813472@N00,3470,31,1437780021,1437780425,2,18,404
27813472@N00,3470,22,1437780425,1437781025,4,18,600
27813472@N00,3470,29,1437782624,1437783109,4,18,485
27813472@N00,3470,19,1437783109,1437783649,2,18,540
27813472@N00,3470,26,1437783650,1437784550,5,18,900
27813472@N00,3470,15,1437787284,1437787554,3,18,270
27813472@N00,3470,26,1437796106,1437797006,3,18,900
27813472@N00,3470,30,1437798719,1437798874,3,18,155
27813472@N00,3470,29,1437798874,1437798895,3,18,21
27813472@N00,3470,31,1437798895,1437799435,7,18,540
27813472@N00,3470,22,1437799435,1437799812,3,18,377
27813472@N00,3470,30,1437799812,1437800214,3,18,402
27813472@N00,3470,23,1437800214,1437800814,3,18,600
27813472@N00,3470,1,1437807720,1437807780,3,18,60
27813472@N00,3470,28,1437807867,1437808767,2,18,900
27813472@N00,3470,1,1437826926,1437826986,3,18,60
27813472@N00,3471,1,1437861639,1437861699,12,3,60
27813472@N00,3471,28,1437863787,1437864139,5,3,352
27813472@N00,3471,23,1437864139,1437864739,1,3,600
27813472@N00,3472,1,1439352547,1439352607,5,11,60
27813472@N00,3472,28,1439352870,1439353228,3,11,358
27813472@N00,3472,19,1439353228,1439353768,2,11,540
27813472@N00,3472,31,1439357514,1439357576,2,11,62
27813472@N00,3472,29,1439357576,1439358476,2,11,900
27813472@N00,3472,26,1439362086,1439362986,2,11,900
27813472@N00,3472,22,1439373168,1439373768,6,11,600
27813472@N00,3472,14,1439373881,1439374121,2,11,240
27813472@N00,3472,20,1439380584,1439381124,2,11,540
27813472@N00,3472,28,1439381519,1439382419,2,11,900
27813472@N00,3472,1,1439383118,1439383178,4,11,60
27813472@N00,3473,28,1439416599,1439417499,3,17,900
27813472@N00,3473,1,1439417727,1439417787,5,17,60
27813472@N00,3473,29,1439418368,1439419268,2,17,900
27813472@N00,3473,15,1439419661,1439419931,2,17,270
27813472@N00,3473,29,1439420181,1439420204,2,17,23
27813472@N00,3473,10,1439420204,1439420444,2,17,240
27813472@N00,3473,30,1439420836,1439421916,2,17,1080
27813472@N00,3473,25,1439422918,1439423758,16,17,840
27813472@N00,3473,29,1439424695,1439425595,2,17,900
27813472@N00,3473,17,1439427542,1439427842,2,17,300
27813472@N00,3473,30,1439428658,1439428709,2,17,51
27813472@N00,3473,23,1439428709,1439428783,3,17,74
27813472@N00,3473,19,1439428783,1439428806,2,17,23
27813472@N00,3473,29,1439428806,1439429029,3,17,223
27813472@N00,3473,31,1439429029,1439430471,3,17,1442
27813472@N00,3473,14,1439430471,1439430711,2,17,240
27813472@N00,3473,18,1439434048,1439434498,2,17,450
27813472@N00,3474,21,1439463061,1439463631,3,3,570
27813472@N00,3474,20,1439475470,1439475530,2,3,60
27813472@N00,3474,29,1439475530,1439476430,2,3,900
27813472@N00,3475,13,1439505121,1439505187,3,17,66
27813472@N00,3475,25,1439505187,1439505910,2,17,723
27813472@N00,3475,23,1439505910,1439506040,2,17,130
27813472@N00,3475,29,1439506040,1439506814,3,17,774
27813472@N00,3475,20,1439506814,1439506842,2,17,28
27813472@N00,3475,22,1439506842,1439506886,2,17,44
27813472@N00,3475,14,1439506886,1439507126,2,17,240
27813472@N00,3475,20,1439507610,1439508150,3,17,540
27813472@N00,3475,30,1439509397,1439510477,2,17,1080
27813472@N00,3475,29,1439516058,1439516912,3,17,854
27813472@N00,3475,26,1439516912,1439517812,5,17,900
27813472@N00,3475,11,1439524319,1439524559,4,17,240
27813472@N00,3475,29,1439530905,1439531562,4,17,657
27813472@N00,3475,17,1439531562,1439531862,2,17,300
27813472@N00,3475,28,1439536450,1439537350,2,17,900
27813472@N00,3475,18,1439552247,1439552697,2,17,450
27813472@N00,3475,27,1439553089,1439553989,1,17,900
27813472@N00,3476,6,1439634656,1439634682,2,21,26
27813472@N00,3476,10,1439634682,1439634855,5,21,173
27813472@N00,3476,6,1439634855,1439634975,2,21,120
27813472@N00,3476,26,1439635019,1439635919,2,21,900
27813472@N00,3476,28,1439638404,1439639304,9,21,900
27813472@N00,3476,30,1439648129,1439649209,3,21,1080
27813472@N00,3476,1,1439673665,1439673725,5,21,60
27813472@N00,3476,26,1439676066,1439676394,3,21,328
27813472@N00,3476,9,1439676394,1439676574,2,21,180
27813472@N00,3476,26,1439676678,1439676839,7,21,161
27813472@N00,3476,30,1439676839,1439677122,3,21,283
27813472@N00,3476,20,1439677122,1439677182,2,21,60
27813472@N00,3476,29,1439677182,1439677304,4,21,122
27813472@N00,3476,20,1439677304,1439677825,7,21,521
27813472@N00,3476,29,1439677825,1439677875,3,21,50
27813472@N00,3476,20,1439677875,1439678006,4,21,131
27813472@N00,3476,29,1439678006,1439678349,8,21,343
27813472@N00,3476,19,1439678349,1439678804,9,21,455
27813472@N00,3476,29,1439678804,1439679099,2,21,295
27813472@N00,3476,30,1439679099,1439680179,3,21,1080
27813472@N00,3476,28,1439680983,1439681883,4,21,900
27813472@N00,3477,1,1445306828,1445306888,2,7,60
27813472@N00,3477,28,1445308150,1445309050,3,7,900
27813472@N00,3477,26,1445309059,1445309959,2,7,900
27813472@N00,3477,8,1445311584,1445311764,2,7,180
27813472@N00,3477,18,1445336011,1445336088,2,7,77
27813472@N00,3477,28,1445336088,1445336988,2,7,900
27813472@N00,3477,1,1445337001,1445337061,2,7,60
27813472@N00,3478,30,1445386396,1445387476,3,12,1080
27813472@N00,3478,18,1445404013,1445404306,3,12,293
27813472@N00,3478,19,1445404306,1445404511,4,12,205
27813472@N00,3478,18,1445404511,1445404937,2,12,426
27813472@N00,3478,30,1445404937,1445406017,3,12,1080
27813472@N00,3478,19,1445406985,1445407525,5,12,540
27813472@N00,3478,5,1445408502,1445408622,2,12,120
27813472@N00,3478,6,1445408998,1445409118,2,12,120
27813472@N00,3478,3,1445411262,1445411352,2,12,90
27813472@N00,3478,15,1445412745,1445412965,2,12,220
27813472@N00,3478,12,1445412965,1445413205,2,12,240
27813472@N00,3478,24,1445415093,1445415873,3,12,780
27813472@N00,3479,1,1445478058,1445478118,3,20,60
27813472@N00,3479,18,1445480928,1445481378,5,20,450
27813472@N00,3479,23,1445481555,1445481667,2,20,112
27813472@N00,3479,18,1445481667,1445481715,2,20,48
27813472@N00,3479,19,1445481715,1445481854,3,20,139
27813472@N00,3479,18,1445481854,1445482304,5,20,450
27813472@N00,3479,22,1445483620,1445483683,2,20,63
27813472@N00,3479,20,1445483683,1445484223,2,20,540
27813472@N00,3479,14,1445484279,1445484519,2,20,240
27813472@N00,3479,28,1445485942,1445486842,3,20,900
27813472@N00,3479,1,1445499690,1445499750,6,20,60
27813472@N00,3479,17,1445500320,1445500620,2,20,300
27813472@N00,3479,26,1445501428,1445501687,2,20,259
27813472@N00,3479,8,1445501687,1445501867,2,20,180
27813472@N00,3479,13,1445502638,1445502878,2,20,240
27813472@N00,3479,6,1445503635,1445503755,3,20,120
27813472@N00,3479,10,1445503911,1445504151,2,20,240
27813472@N00,3479,16,1445509141,1445509411,2,20,270
27813472@N00,3479,30,1445511024,1445511462,2,20,438
27813472@N00,3479,28,1445511462,1445512362,3,20,900
27813472@N00,3480,1,1449732993,1449733053,4,3,60
27813472@N00,3480,28,1449733278,1449733717,2,3,439
27813472@N00,3480,21,1449733717,1449734287,8,3,570
27813472@N00,3481,29,1453949772,1453950672,2,3,900
27813472@N00,3481,31,1453966890,1453968390,3,3,1500
27813472@N00,3481,25,1453973107,1453973947,2,3,840
27813472@N00,3482,15,1454023498,1454023768,2,4,270
27813472@N00,3482,26,1454025044,1454025944,12,4,900
27813472@N00,3482,10,1454047355,1454047595,4,4,240
27813472@N00,3482,21,1454047961,1454048531,3,4,570
27813472@N00,3483,1,1454099545,1454099605,2,12,60
27813472@N00,3483,16,1454100063,1454100136,2,12,73
27813472@N00,3483,26,1454100136,1454100261,2,12,125
27813472@N00,3483,28,1454100261,1454100686,7,12,425
27813472@N00,3483,1,1454100686,1454100746,2,12,60
27813472@N00,3483,16,1454100951,1454101099,2,12,148
27813472@N00,3483,26,1454101099,1454101446,2,12,347
27813472@N00,3483,18,1454101446,1454101896,2,12,450
27813472@N00,3483,31,1454102277,1454102455,4,12,178
27813472@N00,3483,29,1454102455,1454102489,3,12,34
27813472@N00,3483,31,1454102489,1454103989,2,12,1500
27813472@N00,3483,12,1454105399,1454105639,1,12,240
27813472@N00,3484,29,1454136404,1454136636,2,5,232
27813472@N00,3484,1,1454136636,1454136696,2,5,60
27813472@N00,3484,23,1454138974,1454139574,2,5,600
27813472@N00,3484,29,1454142814,1454143568,2,5,754
27813472@N00,3484,31,1454143568,1454145068,1,5,1500
27813472@N00,3485,1,1455521973,1455522033,3,2,60
27813472@N00,3485,28,1455522451,1455523351,1,2,900
27813472@N00,3486,31,1455574991,1455575492,2,8,501
27813472@N00,3486,30,1455575492,1455575881,2,8,389
27813472@N00,3486,17,1455575881,1455576181,2,8,300
27813472@N00,3486,19,1455582799,1455583339,2,8,540
27813472@N00,3486,20,1455585833,1455586373,2,8,540
27813472@N00,3486,31,1455586378,1455587878,2,8,1500
27813472@N00,3486,14,1455601009,1455601249,2,8,240
27813472@N00,3486,24,1455603643,1455604423,1,8,780
27813472@N00,3487,28,1455660317,1455661217,2,10,900
27813472@N00,3487,3,1455664087,1455664177,2,10,90
27813472@N00,3487,4,1455664261,1455664362,2,10,101
27813472@N00,3487,6,1455665634,1455665722,3,10,88
27813472@N00,3487,26,1455665722,1455666622,2,10,900
27813472@N00,3487,12,1455678235,1455678475,2,10,240
27813472@N00,3487,30,1455680838,1455681918,3,10,1080
27813472@N00,3487,25,1455702991,1455703831,7,10,840
27813472@N00,3487,31,1455707028,1455707690,4,10,662
27813472@N00,3487,28,1455707690,1455708590,2,10,900
27813472@N00,3488,29,1455747835,1455748735,3,7,900
27813472@N00,3488,6,1455751836,1455751857,2,7,21
27813472@N00,3488,26,1455751857,1455751974,5,7,117
27813472@N00,3488,8,1455751974,1455752029,2,7,55
27813472@N00,3488,26,1455752029,1455752212,3,7,183
27813472@N00,3488,8,1455752212,1455752291,2,7,79
27813472@N00,3488,26,1455752291,1455753191,1,7,900
27813472@N00,3489,3,1461498075,1461498165,2,2,90
27813472@N00,3489,20,1461499059,1461499599,2,2,540
27813472@N00,3490,20,1461543554,1461544094,2,5,540
27813472@N00,3490,28,1461550200,1461551100,3,5,900
27813472@N00,3490,1,1461568783,1461568843,7,5,60
27813472@N00,3490,26,1461570663,1461571563,3,5,900
27813472@N00,3490,9,1461571866,1461572046,1,5,180
27813472@N00,3491,28,1461624057,1461624957,6,5,900
27813472@N00,3491,23,1461625551,1461625726,2,5,175
27813472@N00,3491,29,1461625726,1461626105,2,5,379
27813472@N00,3491,31,1461626105,1461626385,2,5,280
27813472@N00,3491,29,1461626385,1461627285,1,5,900
27813472@N00,3492,7,1461714426,1461714606,2,6,180
27813472@N00,3492,25,1461716996,1461717836,2,6,840
27813472@N00,3492,26,1461719641,1461720198,2,6,557
27813472@N00,3492,1,1461720198,1461720258,2,6,60
27813472@N00,3492,28,1461720344,1461720772,2,6,428
27813472@N00,3492,23,1461720772,1461721372,1,6,600
27813472@N00,3493,26,1461751915,1461752815,2,3,900
27813472@N00,3493,30,1461754017,1461754187,2,3,170
27813472@N00,3493,31,1461754187,1461755687,3,3,1500
27813472@N00,3494,1,1461880118,1461880178,2,2,60
27813472@N00,3494,23,1461880823,1461881423,1,2,600
27815295@N00,3495,27,1379145762,1379146662,1,1,900
27815295@N00,3496,30,1397366459,1397367539,1,1,1080
27837910@N00,3497,27,1353203867,1353204767,1,1,900
27860489@N03,3498,26,1342487541,1342488441,2,2,900
27860489@N03,3498,23,1342510486,1342511086,1,2,600
27867978@N08,3499,29,1328430841,1328431693,3,2,852
27867978@N08,3499,30,1328431693,1328432773,1,2,1080
27867978@N08,3500,23,1355625188,1355625788,1,1,600
27867978@N08,3501,11,1361755186,1361755426,5,3,240
27867978@N08,3501,10,1361755647,1361755887,2,3,240
27867978@N08,3501,23,1361755914,1361756514,1,3,600
27867978@N08,3502,11,1378440482,1378440722,4,1,240
27867978@N08,3503,11,1378796217,1378796457,8,1,240
27867978@N08,3504,11,1379496070,1379496310,13,1,240
27874578@N06,3505,13,1441074491,1441074731,3,1,240
27883541@N00,3506,28,1286768590,1286769490,1,1,900
27891275@N00,3507,29,1206415342,1206416242,1,1,900
27917561@N00,3508,26,1461804279,1461805179,38,1,900
27927327@N04,3509,1,1387682340,1387682400,1,1,60
27934342@N00,3510,6,1420761615,1420761735,2,4,120
27934342@N00,3510,4,1420763196,1420763297,3,4,101
27934342@N00,3510,16,1420778308,1420778578,2,4,270
27934342@N00,3510,20,1420788067,1420788607,1,4,540
27948083@N02,3511,28,1329448273,1329449173,1,1,900
27948083@N02,3512,28,1329531623,1329532523,1,1,900
27948083@N02,3513,1,1363859457,1363859517,1,1,60
27950434@N04,3514,1,1352421898,1352421958,17,1,60
27950434@N04,3515,1,1355800506,1355800566,6,1,60
27950434@N04,3516,1,1414637534,1414637594,19,1,60
27950434@N04,3517,1,1415577801,1415577861,19,1,60
27950434@N04,3518,1,1416296190,1416296250,3,1,60
27983123@N00,3519,20,1254545413,1254545953,2,2,540
27983123@N00,3519,29,1254548905,1254549805,1,2,900
27983123@N00,3520,20,1270960654,1270961194,2,3,540
27983123@N00,3520,22,1270963761,1270964361,2,3,600
27983123@N00,3520,29,1270969531,1270970431,1,3,900
27983123@N00,3521,20,1302316830,1302317370,2,3,540
27983123@N00,3521,31,1302323326,1302324826,2,3,1500
27983123@N00,3521,26,1302339188,1302340088,1,3,900
27991056@N07,3522,26,1298810278,1298810279,2,3,1
27991056@N07,3522,16,1298810279,1298810280,2,3,1
27991056@N07,3522,4,1298810280,1298810381,1,3,101
27991056@N07,3523,12,1299331313,1299331314,2,4,1
27991056@N07,3523,4,1299331314,1299331315,2,4,1
27991056@N07,3523,17,1299331315,1299331316,2,4,1
27991056@N07,3523,15,1299331316,1299331586,1,4,270
28043814@N06,3524,17,1357393304,1357393604,1,1,300
28046435@N05,3525,30,1398500995,1398502075,9,1,1080
28057734@N03,3526,28,1286606542,1286607442,1,1,900
28057734@N03,3527,15,1318668008,1318668010,2,3,2
28057734@N03,3527,29,1318668010,1318668013,2,3,3
28057734@N03,3527,1,1318668013,1318668073,1,3,60
28057734@N03,3528,28,1335786851,1335787751,3,1,900
28057734@N03,3529,22,1336424539,1336425139,2,4,600
28057734@N03,3529,30,1336443240,1336443251,2,4,11
28057734@N03,3529,1,1336443251,1336443311,2,4,60
28057734@N03,3529,29,1336444202,1336445102,1,4,900
28057734@N03,3530,28,1336615589,1336616489,1,1,900
28059153@N08,3531,23,1366423392,1366423992,1,1,600
28059153@N08,3532,28,1385375193,1385376093,3,1,900
28096801@N05,3533,24,1274514471,1274515251,2,1,780
28096801@N05,3534,24,1290218252,1290219032,1,1,780
28132447@N00,3535,19,1257648186,1257648726,1,1,540
28139097@N00,3536,28,1230881569,1230882469,1,1,900
28139097@N00,3537,25,1236403521,1236404361,58,2,840
28139097@N00,3537,27,1236429189,1236430089,1,2,900
28172462@N00,3538,29,1303434515,1303435415,1,1,900
28172462@N00,3539,16,1337754233,1337754503,1,1,270
28173907@N00,3540,14,1283576398,1283576638,1,1,240
28176577@N04,3541,16,1400838731,1400839001,1,1,270
28215341@N07,3542,28,1429058360,1429058392,3,28,32
28215341@N07,3542,1,1429058392,1429058452,2,28,60
28215341@N07,3542,28,1429058452,1429058745,10,28,293
28215341@N07,3542,16,1429058745,1429059004,3,28,259
28215341@N07,3542,27,1429059004,1429059108,2,28,104
28215341@N07,3542,16,1429059108,1429059378,5,28,270
28215341@N07,3542,26,1429059518,1429059525,3,28,7
28215341@N07,3542,17,1429059525,1429059825,2,28,300
28215341@N07,3542,15,1429062114,1429062384,3,28,270
28215341@N07,3542,13,1429065294,1429065534,12,28,240
28215341@N07,3542,21,1429067141,1429067528,2,28,387
28215341@N07,3542,11,1429067528,1429067623,4,28,95
28215341@N07,3542,4,1429067623,1429067638,3,28,15
28215341@N07,3542,21,1429067638,1429067842,5,28,204
28215341@N07,3542,5,1429067842,1429067962,3,28,120
28215341@N07,3542,6,1429068250,1429068281,2,28,31
28215341@N07,3542,5,1429068281,1429068380,2,28,99
28215341@N07,3542,4,1429068380,1429068386,3,28,6
28215341@N07,3542,5,1429068386,1429068506,5,28,120
28215341@N07,3542,23,1429070782,1429071382,4,28,600
28215341@N07,3542,18,1429071497,1429071834,2,28,337
28215341@N07,3542,17,1429071834,1429071898,2,28,64
28215341@N07,3542,18,1429071898,1429071904,3,28,6
28215341@N07,3542,28,1429071904,1429071980,3,28,76
28215341@N07,3542,29,1429071980,1429072880,5,28,900
28215341@N07,3542,20,1429079157,1429079257,3,28,100
28215341@N07,3542,22,1429079257,1429079857,2,28,600
28215341@N07,3542,30,1429082674,1429083754,1,28,1080
28223347@N00,3543,1,1270073769,1270073829,2,12,60
28223347@N00,3543,26,1270074029,1270074084,2,12,55
28223347@N00,3543,16,1270074084,1270074354,2,12,270
28223347@N00,3543,24,1270074441,1270075221,2,12,780
28223347@N00,3543,20,1270077101,1270077641,5,12,540
28223347@N00,3543,29,1270078803,1270079024,3,12,221
28223347@N00,3543,26,1270079024,1270079835,2,12,811
28223347@N00,3543,6,1270079835,1270079955,3,12,120
28223347@N00,3543,25,1270080948,1270081788,3,12,840
28223347@N00,3543,28,1270085287,1270086187,3,12,900
28223347@N00,3543,13,1270096305,1270096545,6,12,240
28223347@N00,3543,18,1270116821,1270117271,1,12,450
28248687@N00,3544,1,1393389536,1393389596,2,1,60
28254653@N03,3545,18,1337501151,1337501601,2,1,450
28254965@N04,3546,17,1311673762,1311674062,1,1,300
28287117@N00,3547,20,1282006545,1282007085,1,1,540
28287117@N00,3548,13,1282375061,1282375301,2,1,240
28288340@N03,3549,29,1297484468,1297485368,1,1,900
28289318@N07,3550,26,1454116963,1454117863,21,1,900
28293356@N00,3551,27,1381461319,1381462219,1,1,900
28293356@N00,3552,14,1381536915,1381537155,1,1,240
28293356@N00,3553,1,1381703263,1381703323,3,2,60
28293356@N00,3553,23,1381713289,1381713889,1,2,600
28310527@N05,3554,24,1188801947,1188802727,17,1,780
28366245@N03,3555,17,1386078148,1386078448,2,2,300
28366245@N03,3555,27,1386078781,1386079681,1,2,900
28402154@N03,3556,23,1379077107,1379077707,1,1,600
28402154@N03,3557,26,1386938218,1386939118,5,2,900
28402154@N03,3557,28,1386939871,1386940771,1,2,900
28402154@N03,3558,18,1388376389,1388376839,2,4,450
28402154@N03,3558,31,1388401336,1388402836,2,4,1500
28402154@N03,3558,26,1388407597,1388408497,2,4,900
28402154@N03,3558,18,1388410581,1388411031,1,4,450
28402154@N03,3559,23,1391235136,1391235146,2,3,10
28402154@N03,3559,18,1391235146,1391235596,2,3,450
28402154@N03,3559,17,1391255412,1391255712,1,3,300
28402154@N03,3560,27,1391302386,1391303286,1,1,900
28402154@N03,3561,1,1411002466,1411002526,6,1,60
28402154@N03,3562,28,1417266093,1417266993,2,1,900
28402154@N03,3563,5,1419590869,1419590989,1,1,120
28438133@N08,3564,12,1304293691,1304293931,1,1,240
28438133@N08,3565,26,1304414067,1304414967,1,1,900
28443026@N04,3566,26,1221815315,1221816215,1,1,900
28443026@N04,3567,26,1221878587,1221879487,1,1,900
28443026@N04,3568,17,1385355833,1385356133,1,1,300
28450912@N02,3569,26,1446783812,1446784712,1,1,900
28450912@N02,3570,1,1446857294,1446857354,2,7,60
28450912@N02,3570,28,1446857376,1446858276,2,7,900
28450912@N02,3570,26,1446859440,1446860340,4,7,900
28450912@N02,3570,15,1446870280,1446870416,2,7,136
28450912@N02,3570,17,1446870416,1446870548,2,7,132
28450912@N02,3570,15,1446870548,1446870818,2,7,270
28450912@N02,3570,26,1446876336,1446877236,5,7,900
28450912@N02,3571,19,1446947354,1446947548,2,8,194
28450912@N02,3571,28,1446947548,1446948382,2,8,834
28450912@N02,3571,16,1446948382,1446948652,2,8,270
28450912@N02,3571,21,1446949736,1446949842,2,8,106
28450912@N02,3571,13,1446949842,1446950082,6,8,240
28450912@N02,3571,31,1446952142,1446953642,3,8,1500
28450912@N02,3571,29,1446955648,1446956252,2,8,604
28450912@N02,3571,30,1446956252,1446957332,1,8,1080
28495222@N04,3572,15,1238380633,1238380702,3,4,69
28495222@N04,3572,27,1238380702,1238381602,2,4,900
28495222@N04,3572,30,1238385630,1238386710,3,4,1080
28495222@N04,3572,1,1238402973,1238403033,3,4,60
28505792@N06,3573,29,1292725582,1292726482,2,2,900
28505792@N06,3573,26,1292746422,1292747322,1,2,900
28519626@N07,3574,1,1299188392,1299188452,1,1,60
28519626@N07,3575,28,1299217706,1299218606,3,4,900
28519626@N07,3575,1,1299225655,1299225715,2,4,60
28519626@N07,3575,28,1299226735,1299227382,3,4,647
28519626@N07,3575,1,1299227382,1299227442,1,4,60
28519626@N07,3576,1,1299273711,1299273771,1,1,60
28519626@N07,3577,28,1353457039,1353457939,1,1,900
28530203@N03,3578,30,1388105734,1388106814,4,2,1080
28530203@N03,3578,29,1388108514,1388109414,6,2,900
28555425@N00,3579,1,1347867837,1347867897,2,12,60
28555425@N00,3579,30,1347868271,1347869351,2,12,1080
28555425@N00,3579,20,1347869818,1347870002,4,12,184
28555425@N00,3579,30,1347870002,1347870026,2,12,24
28555425@N00,3579,20,1347870026,1347870566,4,12,540
28555425@N00,3579,30,1347870932,1347872012,2,12,1080
28555425@N00,3579,4,1347873734,1347873835,2,12,101
28555425@N00,3579,3,1347876163,1347876253,2,12,90
28555425@N00,3579,26,1347876304,1347876370,2,12,66
28555425@N00,3579,16,1347876370,1347876640,2,12,270
28555425@N00,3579,27,1347879394,1347879480,2,12,86
28555425@N00,3579,28,1347879480,1347880380,1,12,900
28555425@N00,3580,28,1347925317,1347926217,2,6,900
28555425@N00,3580,4,1347941792,1347941893,2,6,101
28555425@N00,3580,30,1347949254,1347950334,2,6,1080
28555425@N00,3580,20,1347951073,1347951613,2,6,540
28555425@N00,3580,29,1347952270,1347953170,2,6,900
28555425@N00,3580,11,1347953422,1347953662,1,6,240
28558260@N04,3581,26,1470621432,1470622332,27,1,900
28558260@N04,3582,26,1470729411,1470730311,1,1,900
28578888@N02,3583,4,1457174435,1457174536,1,1,101
28582753@N08,3584,17,1315688344,1315688644,1,1,300
28585603@N04,3585,1,1363812931,1363812991,3,11,60
28585603@N04,3585,28,1363813261,1363813556,2,11,295
28585603@N04,3585,14,1363813556,1363813796,8,11,240
28585603@N04,3585,26,1363817486,1363818153,2,11,667
28585603@N04,3585,3,1363818153,1363818243,3,11,90
28585603@N04,3585,26,1363823322,1363823689,3,11,367
28585603@N04,3585,4,1363823689,1363823790,6,11,101
28585603@N04,3585,13,1363824467,1363824707,4,11,240
28585603@N04,3585,8,1363848161,1363848341,7,11,180
28585603@N04,3585,29,1363850013,1363850913,2,11,900
28585603@N04,3585,14,1363862103,1363862343,1,11,240
28630872@N08,3586,23,1310903326,1310903926,85,2,600
28630872@N08,3586,18,1310915055,1310915505,1,2,450
28721101@N05,3587,18,1293265941,1293266391,1,1,450
28736650@N07,3588,16,1244543769,1244544039,2,2,270
28736650@N07,3588,20,1244548606,1244549146,1,2,540
28736650@N07,3589,16,1244611378,1244611648,1,1,270
28736650@N07,3590,16,1244703489,1244703759,2,2,270
28736650@N07,3590,1,1244704379,1244704439,1,2,60
28736650@N07,3591,27,1338839967,1338840867,1,1,900
28742299@N04,3592,26,1468575382,1468576282,2,1,900
28757300@N06,3593,1,1367847085,1367847145,1,1,60
28757300@N06,3594,1,1367961947,1367962007,1,1,60
28786002@N00,3595,28,1244166257,1244167157,1,1,900
28786002@N00,3596,28,1244265790,1244266690,5,3,900
28786002@N00,3596,21,1244269258,1244269828,6,3,570
28786002@N00,3596,28,1244273576,1244274476,2,3,900
28789416@N05,3597,12,1343275215,1343275455,1,1,240
28799689@N00,3598,21,1203157760,1203158330,4,2,570
28799689@N00,3598,26,1203160940,1203161840,1,2,900
28934867@N04,3599,26,1233580079,1233580979,2,1,900
28934867@N04,3600,26,1242623000,1242623900,1,1,900
28934867@N04,3601,26,1242785727,1242786627,1,1,900
28935188@N00,3602,17,1349691866,1349692166,1,1,300
28935188@N00,3603,24,1349767408,1349768188,1,1,780
28935188@N00,3604,1,1349949589,1349949649,1,1,60
28935188@N00,3605,25,1350000517,1350001357,1,1,840
28935188@N00,3606,17,1350076210,1350076510,2,2,300
28935188@N00,3606,3,1350078138,1350078228,2,2,90
28935188@N00,3607,1,1383530764,1383530824,2,3,60
28935188@N00,3607,20,1383537996,1383538536,2,3,540
28935188@N00,3607,14,1383544285,1383544525,2,3,240
28935188@N00,3608,12,1383605432,1383605672,1,1,240
28935188@N00,3609,22,1383707749,1383708349,2,2,600
28935188@N00,3609,29,1383708897,1383709797,1,2,900
28935188@N00,3610,3,1450416464,1450416554,1,1,90
28977679@N02,3611,3,1453077783,1453077873,2,3,90
28977679@N02,3611,8,1453077879,1453077949,2,3,70
28977679@N02,3611,3,1453077949,1453078039,1,3,90
28977679@N02,3612,1,1453173047,1453173107,1,1,60
28977679@N02,3613,1,1453223258,1453223318,2,6,60
28977679@N02,3613,27,1453225036,1453225936,5,6,900
28977679@N02,3613,30,1453234668,1453235748,2,6,1080
28977679@N02,3613,10,1453243009,1453243249,2,6,240
28977679@N02,3613,19,1453248008,1453248548,9,6,540
28977679@N02,3613,29,1453249484,1453250384,1,6,900
28977679@N02,3614,20,1453495487,1453496027,11,1,540
28977679@N02,3615,16,1453605316,1453605586,15,1,270
28977679@N02,3616,12,1453671182,1453671422,2,5,240
28977679@N02,3616,13,1453671485,1453671725,2,5,240
28977679@N02,3616,21,1453671932,1453672101,2,5,169
28977679@N02,3616,26,1453672101,1453673001,2,5,900
28977679@N02,3616,28,1453675471,1453676371,1,5,900
28979635@N02,3617,3,1283920532,1283920622,1,1,90
28980639@N02,3618,29,1388943598,1388943820,2,6,222
28980639@N02,3618,27,1388943820,1388944071,3,6,251
28980639@N02,3618,24,1388944071,1388944207,2,6,136
28980639@N02,3618,27,1388944207,1388945107,2,6,900
28980639@N02,3618,22,1388945517,1388945730,2,6,213
28980639@N02,3618,27,1388945730,1388946630,1,6,900
28986472@N02,3619,1,1233448431,1233448491,1,1,60
28986472@N02,3620,29,1233533901,1233534801,1,1,900
29013352@N06,3621,24,1303639795,1303640575,2,5,780
29013352@N06,3621,26,1303645065,1303645378,2,5,313
29013352@N06,3621,28,1303645378,1303645468,2,5,90
29013352@N06,3621,16,1303645468,1303645738,2,5,270
29013352@N06,3621,28,1303645813,1303646713,6,5,900
29013352@N06,3622,12,1305593078,1305593318,2,3,240
29013352@N06,3622,24,1305594559,1305595339,2,3,780
29013352@N06,3622,16,1305602957,1305603227,1,3,270
29061824@N04,3623,29,1236391582,1236392482,1,1,900
29066111@N06,3624,20,1464071058,1464071598,2,7,540
29066111@N06,3624,30,1464074483,1464075563,2,7,1080
29066111@N06,3624,22,1464089830,1464089894,2,7,64
29066111@N06,3624,20,1464089894,1464089902,2,7,8
29066111@N06,3624,22,1464089902,1464090502,11,7,600
29066111@N06,3624,26,1464093858,1464094758,2,7,900
29066111@N06,3624,16,1464095409,1464095679,2,7,270
29066111@N06,3625,11,1464239710,1464239765,2,5,55
29066111@N06,3625,30,1464239765,1464240845,2,5,1080
29066111@N06,3625,28,1464245849,1464246034,5,5,185
29066111@N06,3625,1,1464246034,1464246067,2,5,33
29066111@N06,3625,28,1464246067,1464246967,1,5,900
29080772@N05,3626,1,1221196691,1221196751,2,2,60
29080772@N05,3626,21,1221198368,1221198938,1,2,570
29080772@N05,3627,19,1221270425,1221270965,1,1,540
29129621@N05,3628,24,1243330166,1243330946,1,1,780
29131150@N07,3629,26,1438736080,1438736980,1,1,900
29173152@N08,3630,28,1270253269,1270254169,1,1,900
29224349@N04,3631,17,1351901100,1351901400,2,2,300
29224349@N04,3631,24,1351905560,1351906340,5,2,780
29225947@N00,3632,24,1318393303,1318394083,7,15,780
29225947@N00,3632,28,1318395551,1318395708,3,15,157
29225947@N00,3632,1,1318395708,1318395768,8,15,60
29225947@N00,3632,28,1318402678,1318402944,5,15,266
29225947@N00,3632,26,1318402944,1318403127,8,15,183
29225947@N00,3632,16,1318403127,1318403137,3,15,10
29225947@N00,3632,26,1318403137,1318403414,7,15,277
29225947@N00,3632,3,1318403414,1318403504,2,15,90
29225947@N00,3632,12,1318405177,1318405417,2,15,240
29225947@N00,3632,16,1318406286,1318406556,3,15,270
29225947@N00,3632,27,1318408099,1318408999,12,15,900
29225947@N00,3632,21,1318409947,1318409991,2,15,44
29225947@N00,3632,25,1318409991,1318410419,2,15,428
29225947@N00,3632,16,1318410419,1318410650,2,15,231
29225947@N00,3632,18,1318410650,1318411100,1,15,450
29225947@N00,3633,16,1318452255,1318452525,48,12,270
29225947@N00,3633,22,1318456600,1318457200,21,12,600
29225947@N00,3633,1,1318470556,1318470616,9,12,60
29225947@N00,3633,28,1318470743,1318471643,23,12,900
29225947@N00,3633,23,1318477039,1318477639,7,12,600
29225947@N00,3633,20,1318478549,1318479089,9,12,540
29225947@N00,3633,30,1318480344,1318481424,3,12,1080
29225947@N00,3633,11,1318482122,1318482362,3,12,240
29225947@N00,3633,26,1318502042,1318502942,8,12,900
29225947@N00,3633,25,1318504532,1318504811,6,12,279
29225947@N00,3633,13,1318504811,1318505051,27,12,240
29225947@N00,3633,3,1318507777,1318507867,7,12,90
29225947@N00,3634,3,1318539832,1318539922,5,3,90
29225947@N00,3634,4,1318542288,1318542389,49,3,101
29225947@N00,3634,28,1318578163,1318579063,6,3,900
29225947@N00,3635,1,1318627383,1318627443,4,6,60
29225947@N00,3635,26,1318627602,1318628502,3,6,900
29225947@N00,3635,16,1318628507,1318628777,11,6,270
29225947@N00,3635,22,1318630779,1318631379,3,6,600
29225947@N00,3635,14,1318632616,1318632856,10,6,240
29225947@N00,3635,28,1318633917,1318634817,1,6,900
29226741@N00,3636,26,1364202220,1364203120,1,1,900
29238928@N03,3637,16,1349487241,1349487511,1,1,270
29238928@N03,3638,26,1349521389,1349522289,2,1,900
29251788@N07,3639,14,1227763259,1227763499,5,5,240
29251788@N07,3639,3,1227764074,1227764164,2,5,90
29251788@N07,3639,5,1227764734,1227764854,2,5,120
29251788@N07,3639,6,1227765771,1227765891,3,5,120
29251788@N07,3639,26,1227767895,1227768795,1,5,900
29251788@N07,3640,22,1227932890,1227933280,2,7,390
29251788@N07,3640,31,1227933280,1227933801,2,7,521
29251788@N07,3640,10,1227933801,1227934041,2,7,240
29251788@N07,3640,14,1227939586,1227939826,2,7,240
29251788@N07,3640,28,1227949621,1227950521,2,7,900
29251788@N07,3640,1,1227951139,1227951199,2,7,60
29251788@N07,3640,24,1227956034,1227956814,1,7,780
29259314@N04,3641,12,1254771319,1254771559,3,36,240
29259314@N04,3641,1,1254778740,1254778800,3,36,60
29259314@N04,3641,28,1254780237,1254780507,3,36,270
29259314@N04,3641,15,1254780507,1254780579,2,36,72
29259314@N04,3641,17,1254780579,1254780693,2,36,114
29259314@N04,3641,12,1254780693,1254780801,2,36,108
29259314@N04,3641,17,1254780801,1254781101,3,36,300
29259314@N04,3641,24,1254781549,1254781918,3,36,369
29259314@N04,3641,12,1254781918,1254782029,2,36,111
29259314@N04,3641,24,1254782029,1254782809,2,36,780
29259314@N04,3641,12,1254784047,1254784287,2,36,240
29259314@N04,3641,3,1254784318,1254784408,2,36,90
29259314@N04,3641,21,1254784478,1254784842,4,36,364
29259314@N04,3641,3,1254784842,1254784932,4,36,90
29259314@N04,3641,7,1254785538,1254785632,4,36,94
29259314@N04,3641,9,1254785632,1254785812,2,36,180
29259314@N04,3641,30,1254787009,1254787805,7,36,796
29259314@N04,3641,29,1254787805,1254788705,2,36,900
29259314@N04,3641,20,1254789376,1254789916,6,36,540
29259314@N04,3641,30,1254790034,1254790050,2,36,16
29259314@N04,3641,31,1254790050,1254790092,3,36,42
29259314@N04,3641,29,1254790092,1254790122,2,36,30
29259314@N04,3641,20,1254790122,1254790170,2,36,48
29259314@N04,3641,31,1254790170,1254791473,12,36,1303
29259314@N04,3641,22,1254791473,1254791636,2,36,163
29259314@N04,3641,31,1254791636,1254791819,2,36,183
29259314@N04,3641,22,1254791819,1254792419,2,36,600
29259314@N04,3641,20,1254793036,1254793576,3,36,540
29259314@N04,3641,29,1254794385,1254795285,8,36,900
29259314@N04,3641,1,1254800233,1254800293,3,36,60
29259314@N04,3641,22,1254802459,1254803059,5,36,600
29259314@N04,3641,25,1254808055,1254808895,2,36,840
29259314@N04,3641,1,1254814750,1254814810,2,36,60
29259314@N04,3641,26,1254815363,1254816263,2,36,900
29259314@N04,3641,20,1254818958,1254819079,2,36,121
29259314@N04,3641,19,1254819079,1254819619,1,36,540
29259314@N04,3642,12,1254886942,1254887182,2,2,240
29259314@N04,3642,10,1254888663,1254888903,1,2,240
29259314@N04,3643,25,1314997085,1314997202,2,15,117
29259314@N04,3643,22,1314997202,1314997675,3,15,473
29259314@N04,3643,13,1314997675,1314997824,2,15,149
29259314@N04,3643,25,1314997824,1314997967,3,15,143
29259314@N04,3643,5,1314997967,1314998087,2,15,120
29259314@N04,3643,28,1314998154,1314998237,2,15,83
29259314@N04,3643,26,1314998237,1314998395,2,15,158
29259314@N04,3643,28,1314998395,1314998474,2,15,79
29259314@N04,3643,1,1314998474,1314998534,2,15,60
29259314@N04,3643,10,1315007534,1315007774,9,15,240
29259314@N04,3643,22,1315010181,1315010781,2,15,600
29259314@N04,3643,19,1315012081,1315012621,5,15,540
29259314@N04,3643,27,1315013846,1315014746,5,15,900
29259314@N04,3643,30,1315034230,1315035310,3,15,1080
29259314@N04,3643,10,1315041712,1315041952,2,15,240
29259314@N04,3644,1,1315081902,1315081928,2,12,26
29259314@N04,3644,28,1315081928,1315082207,3,12,279
29259314@N04,3644,12,1315082207,1315082277,2,12,70
29259314@N04,3644,6,1315082277,1315082280,2,12,3
29259314@N04,3644,26,1315082280,1315082361,4,12,81
29259314@N04,3644,30,1315082361,1315082409,3,12,48
29259314@N04,3644,29,1315082409,1315082542,2,12,133
29259314@N04,3644,22,1315082542,1315082674,2,12,132
29259314@N04,3644,14,1315082674,1315082888,2,12,214
29259314@N04,3644,13,1315082888,1315082949,3,12,61
29259314@N04,3644,21,1315082949,1315082967,2,12,18
29259314@N04,3644,25,1315082967,1315083807,2,12,840
29259314@N04,3645,26,1315185020,1315185610,2,6,590
29259314@N04,3645,27,1315185610,1315186510,2,6,900
29259314@N04,3645,22,1315187717,1315188317,2,6,600
29259314@N04,3645,28,1315193719,1315193938,5,6,219
29259314@N04,3645,16,1315193938,1315194208,2,6,270
29259314@N04,3645,27,1315197227,1315198127,1,6,900
29259314@N04,3646,26,1315265727,1315266627,2,4,900
29259314@N04,3646,4,1315267394,1315267495,10,4,101
29259314@N04,3646,12,1315269592,1315269832,3,4,240
29259314@N04,3646,26,1315270431,1315271331,1,4,900
29259314@N04,3647,29,1315364793,1315365693,28,7,900
29259314@N04,3647,1,1315371925,1315371985,3,7,60
29259314@N04,3647,10,1315377977,1315378217,2,7,240
29259314@N04,3647,28,1315381649,1315382000,2,7,351
29259314@N04,3647,26,1315382000,1315382239,3,7,239
29259314@N04,3647,28,1315382239,1315383139,2,7,900
29259314@N04,3647,1,1315384364,1315384424,1,7,60
29259314@N04,3648,13,1377899553,1377899793,2,3,240
29259314@N04,3648,30,1377900184,1377900460,2,3,276
29259314@N04,3648,26,1377900460,1377901360,1,3,900
29259314@N04,3649,1,1378079689,1378079749,2,8,60
29259314@N04,3649,26,1378081363,1378081655,2,8,292
29259314@N04,3649,18,1378081655,1378082105,2,8,450
29259314@N04,3649,26,1378082737,1378083637,2,8,900
29259314@N04,3649,30,1378083945,1378085025,2,8,1080
29259314@N04,3649,26,1378085127,1378086027,2,8,900
29259314@N04,3649,11,1378086531,1378086771,3,8,240
29259314@N04,3649,24,1378088791,1378089571,1,8,780
29259314@N04,3650,31,1378193469,1378194969,1,1,1500
29259314@N04,3651,4,1378253968,1378254069,4,13,101
29259314@N04,3651,11,1378259256,1378259496,2,13,240
29259314@N04,3651,4,1378260151,1378260252,2,13,101
29259314@N04,3651,3,1378260509,1378260599,2,13,90
29259314@N04,3651,4,1378260748,1378260849,2,13,101
29259314@N04,3651,22,1378266265,1378266865,3,13,600
29259314@N04,3651,29,1378268431,1378268740,2,13,309
29259314@N04,3651,23,1378268740,1378269340,4,13,600
29259314@N04,3651,19,1378271877,1378272417,2,13,540
29259314@N04,3651,18,1378273660,1378274110,3,13,450
29259314@N04,3651,26,1378274823,1378275415,2,13,592
29259314@N04,3651,10,1378275415,1378275655,3,13,240
29259314@N04,3651,3,1378275776,1378275866,1,13,90
29311223@N00,3652,16,1223192877,1223193147,1,1,270
29311223@N00,3653,15,1223277147,1223277417,1,1,270
29311223@N00,3654,23,1225591839,1225592439,2,2,600
29311223@N00,3654,30,1225594437,1225595517,3,2,1080
29311223@N00,3655,17,1240907654,1240907954,1,1,300
29311223@N00,3656,26,1244337398,1244338298,5,17,900
29311223@N00,3656,29,1244340970,1244341870,2,17,900
29311223@N00,3656,22,1244342403,1244342412,2,17,9
29311223@N00,3656,26,1244342412,1244342688,4,17,276
29311223@N00,3656,22,1244342688,1244343288,2,17,600
29311223@N00,3656,26,1244344504,1244345404,6,17,900
29311223@N00,3656,15,1244349888,1244349901,3,17,13
29311223@N00,3656,26,1244349901,1244350204,3,17,303
29311223@N00,3656,15,1244350204,1244350212,2,17,8
29311223@N00,3656,26,1244350212,1244350221,2,17,9
29311223@N00,3656,15,1244350221,1244350323,2,17,102
29311223@N00,3656,17,1244350323,1244350623,2,17,300
29311223@N00,3656,26,1244352429,1244353329,2,17,900
29311223@N00,3656,25,1244357247,1244357463,3,17,216
29311223@N00,3656,26,1244357463,1244357477,2,17,14
29311223@N00,3656,25,1244357477,1244357608,3,17,131
29311223@N00,3656,26,1244357608,1244358508,7,17,900
29311223@N00,3657,16,1244543372,1244543642,2,1,270
29311223@N00,3658,24,1251601224,1251602004,1,1,780
29311223@N00,3659,24,1260906735,1260907515,1,1,780
29311223@N00,3660,28,1265243934,1265244834,1,1,900
29311223@N00,3661,17,1285979254,1285979554,1,1,300
29315916@N07,3662,29,1373506104,1373507004,2,2,900
29315916@N07,3662,31,1373519970,1373521470,1,2,1500
29329200@N04,3663,27,1419898225,1419899125,2,5,900
29329200@N04,3663,29,1419923496,1419924396,3,5,900
29329200@N04,3663,26,1419927721,1419928556,3,5,835
29329200@N04,3663,6,1419928556,1419928676,2,5,120
29329200@N04,3663,19,1419950328,1419950868,1,5,540
29329200@N04,3664,6,1419983790,1419983910,2,2,120
29329200@N04,3664,7,1419984842,1419985022,1,2,180
29335885@N00,3665,25,1388482665,1388483505,1,1,840
29336227@N00,3666,17,1198638894,1198639194,1,1,300
29349767@N03,3667,28,1360633824,1360634273,3,9,449
29349767@N03,3667,30,1360634273,1360635353,2,9,1080
29349767@N03,3667,17,1360636568,1360636868,2,9,300
29349767@N03,3667,24,1360639322,1360640102,3,9,780
29349767@N03,3667,25,1360642139,1360642315,2,9,176
29349767@N03,3667,13,1360642315,1360642555,3,9,240
29349767@N03,3667,30,1360645143,1360646223,2,9,1080
29349767@N03,3667,20,1360647564,1360648104,2,9,540
29349767@N03,3667,18,1360648580,1360649030,1,9,450
29358051@N07,3668,26,1216264200,1216265100,2,5,900
29358051@N07,3668,5,1216265591,1216265711,2,5,120
29358051@N07,3668,16,1216268795,1216269065,3,5,270
29358051@N07,3668,13,1216275201,1216275441,2,5,240
29358051@N07,3668,28,1216280457,1216281357,3,5,900
29358051@N07,3669,24,1216451614,1216452394,2,7,780
29358051@N07,3669,16,1216453256,1216453526,2,7,270
29358051@N07,3669,21,1216454910,1216455335,2,7,425
29358051@N07,3669,5,1216455335,1216455455,2,7,120
29358051@N07,3669,10,1216456437,1216456677,2,7,240
29358051@N07,3669,11,1216457816,1216458056,2,7,240
29358051@N07,3669,26,1216465380,1216466280,1,7,900
29358051@N07,3670,28,1229470452,1229471352,2,9,900
29358051@N07,3670,24,1229473753,1229474533,2,9,780
29358051@N07,3670,7,1229491342,1229491522,2,9,180
29358051@N07,3670,11,1229494024,1229494264,3,9,240
29358051@N07,3670,21,1229494389,1229494639,3,9,250
29358051@N07,3670,13,1229494639,1229494879,2,9,240
29358051@N07,3670,25,1229496126,1229496966,2,9,840
29358051@N07,3670,26,1229497892,1229498164,2,9,272
29358051@N07,3670,28,1229498164,1229499064,1,9,900
29389873@N00,3671,1,1239159075,1239159135,3,6,60
29389873@N00,3671,22,1239166291,1239166891,4,6,600
29389873@N00,3671,18,1239172650,1239173100,2,6,450
29389873@N00,3671,30,1239176483,1239177563,2,6,1080
29389873@N00,3671,5,1239181496,1239181616,5,6,120
29389873@N00,3671,17,1239189122,1239189422,3,6,300
29412746@N00,3672,28,1299560409,1299561309,5,2,900
29412746@N00,3672,18,1299567265,1299567715,2,2,450
29426527@N03,3673,26,1361414229,1361415129,1,1,900
29426527@N03,3674,17,1361622750,1361623050,1,1,300
29426527@N03,3675,28,1362899745,1362900645,1,1,900
29426527@N03,3676,1,1364701288,1364701348,2,2,60
29426527@N03,3676,26,1364712025,1364712925,1,2,900
29426527@N03,3677,14,1364814170,1364814410,1,1,240
29426527@N03,3678,26,1365726311,1365727211,1,1,900
29426527@N03,3679,1,1366703427,1366703487,1,1,60
29426527@N03,3680,1,1367032141,1367032201,1,1,60
29426527@N03,3681,26,1367134611,1367135511,1,1,900
29426527@N03,3682,1,1367271862,1367271922,1,1,60
29426527@N03,3683,1,1367964924,1367964984,1,1,60
29426527@N03,3684,1,1368066427,1368066487,1,1,60
29426527@N03,3685,26,1369371762,1369372662,2,1,900
29426527@N03,3686,1,1370327426,1370327486,1,1,60
29426527@N03,3687,1,1370482185,1370482245,1,1,60
29426527@N03,3688,12,1373332926,1373333166,1,1,240
29426527@N03,3689,1,1374710407,1374710467,1,1,60
29426527@N03,3690,1,1374965762,1374965822,1,1,60
29426527@N03,3691,1,1376379345,1376379405,1,1,60
29426527@N03,3692,4,1378200727,1378200828,1,1,101
29426527@N03,3693,1,1380015609,1380015669,1,1,60
29428169@N02,3694,28,1351991380,1351992280,2,2,900
29428169@N02,3694,30,1351998681,1351999761,2,2,1080
29428169@N02,3695,14,1352086360,1352086600,2,2,240
29428169@N02,3695,27,1352094802,1352095702,1,2,900
29428169@N02,3696,28,1352158951,1352159851,1,1,900
29449403@N00,3697,16,1250481997,1250482267,3,4,270
29449403@N00,3697,28,1250483036,1250483936,2,4,900
29449403@N00,3697,19,1250485021,1250485561,2,4,540
29449403@N00,3697,27,1250505528,1250506428,1,4,900
29456148@N00,3698,28,1319232895,1319233795,1,1,900
29456148@N00,3699,29,1319328924,1319329824,1,1,900
29466940@N03,3700,25,1326530105,1326530945,1,1,840
29468257@N08,3701,16,1343106893,1343107163,1,1,270
29501028@N00,3702,16,1273635367,1273635637,7,1,270
29501028@N00,3703,16,1273704164,1273704434,12,1,270
29501028@N00,3704,16,1273792571,1273792841,7,5,270
29501028@N00,3704,27,1273800857,1273800872,2,5,15
29501028@N00,3704,16,1273800872,1273801142,11,5,270
29501028@N00,3704,18,1273820338,1273820788,2,5,450
29501028@N00,3704,16,1273820963,1273821233,8,5,270
29501028@N00,3705,16,1273888893,1273889163,4,1,270
29501028@N00,3706,16,1273977130,1273977400,11,1,270
29501028@N00,3707,16,1276162310,1276162580,1,1,270
29501028@N00,3708,16,1276219432,1276219702,23,1,270
29501028@N00,3709,16,1288849380,1288849650,4,1,270
29501028@N00,3710,28,1350134284,1350135184,1,1,900
29507492@N07,3711,28,1276507684,1276508017,16,17,333
29507492@N07,3711,16,1276508017,1276508134,5,17,117
29507492@N07,3711,26,1276508134,1276508616,19,17,482
29507492@N07,3711,5,1276508616,1276508736,2,17,120
29507492@N07,3711,4,1276508817,1276508918,5,17,101
29507492@N07,3711,21,1276509420,1276509612,2,17,192
29507492@N07,3711,4,1276509612,1276509648,2,17,36
29507492@N07,3711,21,1276509648,1276509701,4,17,53
29507492@N07,3711,11,1276509701,1276509886,5,17,185
29507492@N07,3711,21,1276509886,1276510295,3,17,409
29507492@N07,3711,13,1276510295,1276510535,13,17,240
29507492@N07,3711,21,1276514841,1276515355,5,17,514
29507492@N07,3711,13,1276515355,1276515595,2,17,240
29507492@N07,3711,5,1276515703,1276515823,7,17,120
29507492@N07,3711,30,1276517057,1276517846,4,17,789
29507492@N07,3711,22,1276517846,1276518446,2,17,600
29507492@N07,3711,28,1276519800,1276520700,40,17,900
29507492@N07,3712,17,1276579057,1276579357,2,2,300
29507492@N07,3712,23,1276581580,1276582180,1,2,600
29507492@N07,3713,12,1276881834,1276882074,7,3,240
29507492@N07,3713,22,1276883178,1276883778,3,3,600
29507492@N07,3713,29,1276887686,1276888586,13,3,900
29507492@N07,3714,28,1277025226,1277025364,7,10,138
29507492@N07,3714,26,1277025364,1277025391,2,10,27
29507492@N07,3714,28,1277025391,1277025664,5,10,273
29507492@N07,3714,16,1277025664,1277025927,2,10,263
29507492@N07,3714,24,1277025927,1277026707,12,10,780
29507492@N07,3714,16,1277029778,1277030048,3,10,270
29507492@N07,3714,26,1277030228,1277030595,2,10,367
29507492@N07,3714,18,1277030595,1277031045,3,10,450
29507492@N07,3714,22,1277038464,1277039064,2,10,600
29507492@N07,3714,13,1277039208,1277039448,9,10,240
29507492@N07,3715,19,1277280694,1277281234,8,13,540
29507492@N07,3715,26,1277283785,1277284685,3,13,900
29507492@N07,3715,13,1277286841,1277287081,2,13,240
29507492@N07,3715,12,1277288809,1277288941,2,13,132
29507492@N07,3715,24,1277288941,1277289160,2,13,219
29507492@N07,3715,12,1277289160,1277289181,2,13,21
29507492@N07,3715,26,1277289181,1277290081,3,13,900
29507492@N07,3715,25,1277290858,1277291698,2,13,840
29507492@N07,3715,29,1277293134,1277293216,3,13,82
29507492@N07,3715,26,1277293216,1277294116,2,13,900
29507492@N07,3715,1,1277297179,1277297239,4,13,60
29507492@N07,3715,22,1277311993,1277312593,2,13,600
29507492@N07,3715,26,1277312875,1277313775,1,13,900
29507492@N07,3716,26,1277372960,1277373860,3,1,900
29555476@N06,3717,7,1319100216,1319100396,1,1,180
29555476@N06,3718,29,1322642726,1322643626,1,1,900
29577569@N02,3719,26,1216612189,1216613089,1,1,900
29652206@N07,3720,1,1228360781,1228360841,1,1,60
29674761@N02,3721,26,1417137096,1417137996,10,1,900
29684629@N08,3722,18,1421450363,1421450813,4,1,450
29684629@N08,3723,18,1421643790,1421644240,1,1,450
29708201@N00,3724,24,1222653705,1222654485,1,1,780
29709298@N02,3725,26,1410363728,1410364628,1,1,900
29709298@N02,3726,16,1410394467,1410394530,3,6,63
29709298@N02,3726,27,1410394530,1410394717,2,6,187
29709298@N02,3726,16,1410394717,1410394838,3,6,121
29709298@N02,3726,28,1410394838,1410395738,8,6,900
29709298@N02,3726,18,1410397116,1410397245,2,6,129
29709298@N02,3726,26,1410397245,1410398145,1,6,900
29722669@N05,3727,26,1354282408,1354283308,1,1,900
29758791@N00,3728,29,1273422246,1273423146,1,1,900
29758791@N00,3729,27,1358662251,1358663019,2,2,768
29758791@N00,3729,16,1358663019,1358663289,1,2,270
29758791@N00,3730,30,1385518815,1385519895,1,1,1080
29762068@N03,3731,14,1252097572,1252097812,2,11,240
29762068@N03,3731,1,1252098083,1252098133,2,11,50
29762068@N03,3731,17,1252098133,1252098187,2,11,54
29762068@N03,3731,27,1252098187,1252098241,2,11,54
29762068@N03,3731,8,1252098241,1252098294,2,11,53
29762068@N03,3731,25,1252098294,1252098397,3,11,103
29762068@N03,3731,13,1252098397,1252098449,2,11,52
29762068@N03,3731,11,1252098449,1252098551,2,11,102
29762068@N03,3731,26,1252098551,1252098604,2,11,53
29762068@N03,3731,28,1252098604,1252099089,7,11,485
29762068@N03,3731,1,1252099089,1252099149,1,11,60
29762068@N03,3732,1,1252181550,1252181600,2,7,50
29762068@N03,3732,17,1252181600,1252181653,2,7,53
29762068@N03,3732,12,1252181653,1252181702,2,7,49
29762068@N03,3732,5,1252181702,1252181758,2,7,56
29762068@N03,3732,30,1252181758,1252181808,2,7,50
29762068@N03,3732,31,1252181808,1252181858,2,7,50
29762068@N03,3732,14,1252181858,1252182098,1,7,240
29764570@N00,3733,12,1286996130,1286996370,2,5,240
29764570@N00,3733,16,1287009220,1287009490,2,5,270
29764570@N00,3733,17,1287011236,1287011536,2,5,300
29764570@N00,3733,19,1287013145,1287013685,2,5,540
29764570@N00,3733,29,1287015215,1287016115,1,5,900
29764570@N00,3734,1,1287884887,1287884947,2,18,60
29764570@N00,3734,26,1287885542,1287885713,2,18,171
29764570@N00,3734,23,1287885713,1287886174,2,18,461
29764570@N00,3734,18,1287886174,1287886624,9,18,450
29764570@N00,3734,31,1287887675,1287887891,2,18,216
29764570@N00,3734,22,1287887891,1287888451,2,18,560
29764570@N00,3734,30,1287888451,1287888798,2,18,347
29764570@N00,3734,26,1287888798,1287888845,3,18,47
29764570@N00,3734,8,1287888845,1287889025,2,18,180
29764570@N00,3734,25,1287890067,1287890907,20,18,840
29764570@N00,3734,29,1287897671,1287898571,12,18,900
29764570@N00,3734,20,1287901480,1287902020,2,18,540
29764570@N00,3734,22,1287902130,1287902730,9,18,600
29764570@N00,3734,30,1287904777,1287905117,2,18,340
29764570@N00,3734,26,1287905117,1287905398,3,18,281
29764570@N00,3734,16,1287905398,1287905668,7,18,270
29764570@N00,3734,28,1287913494,1287914394,4,18,900
29764570@N00,3734,30,1287917595,1287918675,1,18,1080
29774230@N00,3735,23,1397099447,1397100047,2,2,600
29774230@N00,3735,24,1397110829,1397111609,1,2,780
29781127@N07,3736,28,1284694608,1284695508,1,1,900
29797746@N08,3737,8,1230548483,1230548663,1,1,180
29807137@N03,3738,12,1248858709,1248858949,2,2,240
29807137@N03,3738,26,1248867527,1248868427,1,2,900
29848483@N05,3739,28,1354779075,1354779975,2,1,900
29848483@N05,3740,25,1354870535,1354871375,1,1,840
29848483@N05,3741,18,1399344913,1399345363,2,2,450
29848483@N05,3741,16,1399350937,1399351207,1,2,270
29856669@N02,3742,12,1357086054,1357086294,2,6,240
29856669@N02,3742,31,1357090633,1357092133,2,6,1500
29856669@N02,3742,29,1357096535,1357097435,2,6,900
29856669@N02,3742,31,1357099281,1357100705,2,6,1424
29856669@N02,3742,21,1357100705,1357101275,4,6,570
29856669@N02,3742,28,1357106823,1357107723,29,6,900
29870964@N06,3743,26,1249859176,1249860076,1,1,900
29873212@N05,3744,19,1416970028,1416970568,2,1,540
29874979@N07,3745,21,1382845403,1382845973,1,1,570
29874979@N07,3746,20,1383439408,1383439948,1,1,540
29885425@N02,3747,25,1303871753,1303872593,4,1,840
29888328@N03,3748,13,1281958137,1281958377,2,3,240
29888328@N03,3748,7,1281961493,1281961673,2,3,180
29888328@N03,3748,26,1281964961,1281965861,1,3,900
29918730@N00,3749,7,1399017880,1399018060,1,1,180
29948744@N03,3750,22,1193711795,1193712395,3,4,600
29948744@N03,3750,3,1193724703,1193724793,2,4,90
29948744@N03,3750,4,1193725292,1193725393,2,4,101
29948744@N03,3750,26,1193726456,1193727356,1,4,900
29948744@N03,3751,3,1193808099,1193808189,2,2,90
29948744@N03,3751,7,1193810021,1193810201,1,2,180
29948744@N03,3752,3,1209364809,1209364899,1,1,90
29966284@N00,3753,20,1352114175,1352114715,1,1,540
29966284@N00,3754,13,1461145452,1461145692,1,1,240
30002708@N03,3755,17,1290137570,1290137870,2,2,300
30002708@N03,3755,20,1290142062,1290142602,1,2,540
30034659@N02,3756,28,1303518958,1303519858,1,1,900
30034659@N02,3757,29,1352015100,1352016000,1,1,900
30082031@N04,3758,28,1354258973,1354259873,1,1,900
30082031@N04,3759,28,1360814253,1360815153,1,1,900
30082031@N04,3760,30,1365498701,1365499781,1,1,1080
30082031@N04,3761,15,1367474164,1367474434,1,1,270
30141170@N07,3762,28,1298758501,1298759401,2,2,900
30141170@N07,3762,30,1298761450,1298762530,1,2,1080
30141170@N07,3763,16,1307844004,1307844274,1,1,270
30141170@N07,3764,27,1319755163,1319756063,1,1,900
30141170@N07,3765,22,1319872869,1319873469,1,1,600
30141170@N07,3766,26,1323600985,1323601885,1,1,900
30141170@N07,3767,27,1333793714,1333794614,1,1,900
30141170@N07,3768,27,1333833283,1333834183,2,6,900
30141170@N07,3768,16,1333835248,1333835518,3,6,270
30141170@N07,3768,29,1333836456,1333837356,2,6,900
30141170@N07,3768,30,1333837399,1333838479,2,6,1080
30141170@N07,3768,22,1333838660,1333839260,2,6,600
30141170@N07,3768,25,1333842124,1333842964,1,6,840
30141170@N07,3769,4,1333919891,1333919992,1,1,101
30141170@N07,3770,26,1335571775,1335572491,5,3,716
30141170@N07,3770,30,1335572491,1335572819,2,3,328
30141170@N07,3770,23,1335572819,1335573419,1,3,600
30141170@N07,3771,17,1335651228,1335651528,1,1,300
30141170@N07,3772,26,1364594924,1364595824,1,1,900
30141170@N07,3773,24,1372895557,1372896337,1,1,780
30141170@N07,3774,1,1374813350,1374813410,1,1,60
30147619@N04,3775,18,1455148526,1455148976,2,2,450
30147619@N04,3775,3,1455157108,1455157198,1,2,90
30184872@N06,3776,22,1301634681,1301635112,2,2,431
30184872@N06,3776,30,1301635112,1301636192,1,2,1080
30184872@N06,3777,17,1315376320,1315376620,1,1,300
30184872@N06,3778,5,1349912098,1349912218,1,1,120
30184872@N06,3779,24,1352674854,1352675634,2,2,780
30184872@N06,3779,14,1352680852,1352681092,1,2,240
30184872@N06,3780,15,1357008738,1357009008,2,2,270
30184872@N06,3780,29,1357013574,1357014474,1,2,900
30184872@N06,3781,29,1364105339,1364106239,1,1,900
30184872@N06,3782,15,1373172061,1373172331,2,3,270
30184872@N06,3782,3,1373172747,1373172837,2,3,90
30184872@N06,3782,26,1373172936,1373173836,2,3,900
30213495@N02,3783,3,1314398424,1314398514,2,4,90
30213495@N02,3783,4,1314399541,1314399642,3,4,101
30213495@N02,3783,15,1314410731,1314411001,2,4,270
30213495@N02,3783,22,1314422144,1314422744,1,4,600
30314547@N00,3784,27,1262500904,1262501804,1,1,900
30314547@N00,3785,29,1287047945,1287048845,1,1,900
30346812@N07,3786,26,1221177571,1221178471,1,1,900
30346812@N07,3787,28,1226450084,1226450984,1,1,900
30346812@N07,3788,26,1250222536,1250223436,1,1,900
30346812@N07,3789,4,1334893104,1334893205,1,1,101
30346812@N07,3790,4,1417753886,1417753987,1,1,101
30346812@N07,3791,30,1417990064,1417990367,2,2,303
30346812@N07,3791,16,1417990367,1417990637,1,2,270
30346812@N07,3792,30,1454385470,1454386550,2,4,1080
30346812@N07,3792,16,1454390681,1454390784,2,4,103
30346812@N07,3792,4,1454390784,1454390885,2,4,101
30346812@N07,3792,26,1454390956,1454391856,1,4,900
30350281@N06,3793,31,1344235472,1344235493,2,4,21
30350281@N06,3793,22,1344235493,1344236093,2,4,600
30350281@N06,3793,27,1344237318,1344237353,2,4,35
30350281@N06,3793,16,1344237353,1344237623,1,4,270
30350281@N06,3794,28,1348897718,1348897996,2,5,278
30350281@N06,3794,17,1348897996,1348898296,3,5,300
30350281@N06,3794,26,1348898311,1348899211,3,5,900
30350281@N06,3794,17,1348899427,1348899727,2,5,300
30350281@N06,3794,28,1348902815,1348903715,1,5,900
30352121@N05,3795,26,1376307541,1376308441,1,1,900
30352121@N05,3796,1,1393275100,1393275160,1,1,60
30352121@N05,3797,1,1402917787,1402917847,1,1,60
30401284@N05,3798,3,1342665885,1342665975,2,2,90
30401284@N05,3798,13,1342666355,1342666595,7,2,240
30410290@N07,3799,27,1374467929,1374468829,2,2,900
30410290@N07,3799,1,1374477425,1374477485,1,2,60
30427204@N02,3800,28,1221359031,1221359931,1,1,900
30441069@N05,3801,26,1399111812,1399112712,1,1,900
30441069@N05,3802,23,1399774435,1399775035,2,3,600
30441069@N05,3802,20,1399775113,1399775653,2,3,540
30441069@N05,3802,17,1399785958,1399786258,1,3,300
30441069@N05,3803,1,1401961520,1401961580,1,1,60
30441069@N05,3804,1,1408203321,1408203381,3,2,60
30441069@N05,3804,19,1408255596,1408256136,1,2,540
30441069@N05,3805,18,1408501585,1408502035,1,1,450
30441069@N05,3806,30,1410596667,1410597747,2,2,1080
30441069@N05,3806,3,1410605064,1410605154,1,2,90
30441069@N05,3807,18,1442038163,1442038613,1,1,450
30441069@N05,3808,23,1467784851,1467785451,2,1,600
30441069@N05,3809,3,1467869402,1467869492,1,1,90
30446909@N07,3810,29,1293266092,1293266992,1,1,900
30450479@N04,3811,13,1373632403,1373632643,2,3,240
30450479@N04,3811,29,1373632823,1373633723,2,3,900
30450479@N04,3811,1,1373637916,1373637976,1,3,60
30455563@N00,3812,26,1275788787,1275789687,18,1,900
30517235@N02,3813,21,1261614321,1261614891,1,1,570
30517235@N02,3814,1,1263298930,1263298990,2,3,60
30517235@N02,3814,19,1263299001,1263299032,2,3,31
30517235@N02,3814,21,1263299032,1263299602,1,3,570
30517235@N02,3815,29,1264847221,1264848121,1,1,900
30521264@N03,3816,28,1248440457,1248441238,2,8,781
30521264@N03,3816,29,1248441238,1248442138,2,8,900
30521264@N03,3816,28,1248442383,1248443283,5,8,900
30521264@N03,3816,16,1248443490,1248443673,2,8,183
30521264@N03,3816,26,1248443673,1248444573,2,8,900
30521264@N03,3816,11,1248454211,1248454451,2,8,240
30521264@N03,3816,26,1248456192,1248456259,2,8,67
30521264@N03,3816,28,1248456259,1248457159,1,8,900
30521264@N03,3817,30,1248532252,1248533332,1,1,1080
30545687@N00,3818,26,1213323714,1213324614,30,1,900
30545687@N00,3819,28,1233270352,1233271252,25,1,900
30573133@N00,3820,6,1375506594,1375506714,1,1,120
30573133@N00,3821,16,1375573861,1375573861,2,5,0
30573133@N00,3821,27,1375573861,1375574163,2,5,302
30573133@N00,3821,16,1375574163,1375574433,2,5,270
30573133@N00,3821,19,1375586702,1375586767,2,5,65
30573133@N00,3821,29,1375586767,1375587667,1,5,900
30573133@N00,3822,23,1375679451,1375680051,2,2,600
30573133@N00,3822,18,1375680960,1375681410,1,2,450
30573204@N04,3823,16,1392162925,1392163195,10,1,270
30573204@N04,3824,16,1392246894,1392247164,24,1,270
30573204@N04,3825,16,1392326466,1392326736,14,1,270
30573204@N04,3826,26,1412734547,1412734560,3,3,13
30573204@N04,3826,4,1412734560,1412734658,2,3,98
30573204@N04,3826,26,1412734658,1412735558,1,3,900
30573204@N04,3827,26,1412816625,1412817525,5,1,900
30573204@N04,3828,29,1444197335,1444198235,2,2,900
30573204@N04,3828,1,1444212704,1444212764,8,2,60
30586074@N07,3829,1,1271640210,1271640270,3,8,60
30586074@N07,3829,29,1271640332,1271641232,8,8,900
30586074@N07,3829,13,1271655464,1271655704,8,8,240
30586074@N07,3829,12,1271658715,1271658920,3,8,205
30586074@N07,3829,26,1271658920,1271659481,4,8,561
30586074@N07,3829,23,1271659481,1271660081,5,8,600
30586074@N07,3829,29,1271664303,1271665203,2,8,900
30586074@N07,3829,1,1271668356,1271668416,11,8,60
30628679@N04,3830,28,1222386031,1222386931,5,3,900
30628679@N04,3830,14,1222393339,1222393579,4,3,240
30628679@N04,3830,28,1222400177,1222401077,2,3,900
30650680@N02,3831,4,1333343400,1333343501,2,2,101
30650680@N02,3831,24,1333345167,1333345947,1,2,780
30650680@N02,3832,3,1333674584,1333674674,2,2,90
30650680@N02,3832,21,1333674992,1333675562,1,2,570
30650680@N02,3833,1,1359337344,1359337404,2,3,60
30650680@N02,3833,26,1359340820,1359341720,2,3,900
30650680@N02,3833,16,1359341883,1359342153,1,3,270
30650680@N02,3834,30,1359525178,1359526258,1,1,1080
30650680@N02,3835,15,1359593412,1359593682,3,6,270
30650680@N02,3835,28,1359595200,1359595386,2,6,186
30650680@N02,3835,16,1359595386,1359595545,2,6,159
30650680@N02,3835,24,1359595545,1359595744,2,6,199
30650680@N02,3835,8,1359595744,1359595924,2,6,180
30650680@N02,3835,11,1359596855,1359597095,1,6,240
30650680@N02,3836,17,1361696526,1361696826,1,1,300
30650680@N02,3837,26,1361768938,1361768946,2,2,8
30650680@N02,3837,16,1361768946,1361769216,1,2,270
30650680@N02,3838,8,1367887009,1367887189,2,12,180
30650680@N02,3838,28,1367887503,1367887510,2,12,7
30650680@N02,3838,16,1367887510,1367887707,3,12,197
30650680@N02,3838,18,1367887707,1367887758,2,12,51
30650680@N02,3838,23,1367887758,1367887761,2,12,3
30650680@N02,3838,18,1367887761,1367887860,2,12,99
30650680@N02,3838,10,1367887860,1367888100,2,12,240
30650680@N02,3838,26,1367888326,1367889226,2,12,900
30650680@N02,3838,10,1367890137,1367890377,2,12,240
30650680@N02,3838,29,1367890655,1367890674,3,12,19
30650680@N02,3838,28,1367890674,1367891510,2,12,836
30650680@N02,3838,18,1367891510,1367891960,1,12,450
30674850@N00,3839,4,1228519227,1228519328,1,1,101
30674850@N00,3840,4,1228551575,1228551676,2,2,101
30674850@N00,3840,26,1228568431,1228569331,1,2,900
30696510@N06,3841,26,1289678520,1289679420,1,1,900
30704692@N00,3842,28,1278690196,1278691096,2,1,900
30726295@N05,3843,28,1307450811,1307451711,5,1,900
30738244@N07,3844,22,1236314904,1236315504,2,3,600
30738244@N07,3844,5,1236317472,1236317592,2,3,120
30738244@N07,3844,25,1236319572,1236320412,3,3,840
30738244@N07,3845,17,1236408427,1236408727,2,4,300
30738244@N07,3845,24,1236410024,1236410804,7,4,780
30738244@N07,3845,19,1236426134,1236426674,5,4,540
30738244@N07,3845,17,1236429191,1236429491,1,4,300
30755785@N02,3846,25,1325020365,1325021205,2,7,840
30755785@N02,3846,1,1325021446,1325021506,2,7,60
30755785@N02,3846,28,1325024028,1325024928,2,7,900
30755785@N02,3846,25,1325027409,1325028249,3,7,840
30755785@N02,3846,19,1325041175,1325041715,2,7,540
30755785@N02,3846,26,1325065088,1325065658,2,7,570
30755785@N02,3846,6,1325065658,1325065778,1,7,120
30755785@N02,3847,16,1325224470,1325224740,2,2,270
30755785@N02,3847,27,1325231592,1325232492,1,2,900
30755785@N02,3848,26,1325296119,1325297019,1,1,900
30755785@N02,3849,28,1325327218,1325328118,1,1,900
30758629@N00,3850,19,1296272472,1296273012,2,1,540
30759752@N08,3851,5,1396502828,1396502948,1,1,120
30768270@N04,3852,27,1303079687,1303080587,2,2,900
30768270@N04,3852,26,1303081136,1303082036,2,2,900
30768270@N04,3853,25,1303168436,1303169276,1,1,840
30783759@N06,3854,19,1414466339,1414466879,1,1,540
30793917@N07,3855,5,1305957890,1305958010,2,2,120
30793917@N07,3855,29,1305979407,1305980307,1,2,900
30832998@N02,3856,20,1284174072,1284174612,1,1,540
30832998@N02,3857,30,1288419683,1288420763,1,1,1080
30844146@N02,3858,26,1370659621,1370660521,2,4,900
30844146@N02,3858,15,1370661325,1370661595,2,4,270
30844146@N02,3858,27,1370662571,1370663471,2,4,900
30844146@N02,3858,24,1370670321,1370671101,1,4,780
30848780@N03,3859,28,1239489234,1239490134,18,1,900
30848780@N03,3860,28,1239577342,1239578242,5,1,900
30848780@N03,3861,28,1239613346,1239614246,1,1,900
30848780@N03,3862,28,1239669281,1239670181,12,1,900
30848780@N03,3863,28,1239839828,1239840728,2,1,900
30892581@N08,3864,26,1392668508,1392669408,2,1,900
30894945@N04,3865,1,1354953867,1354953927,5,9,60
30894945@N04,3865,28,1354954016,1354954916,9,9,900
30894945@N04,3865,26,1354955512,1354955567,2,9,55
30894945@N04,3865,16,1354955567,1354955792,4,9,225
30894945@N04,3865,26,1354955792,1354956074,3,9,282
30894945@N04,3865,3,1354956074,1354956164,5,9,90
30894945@N04,3865,21,1354956221,1354956791,13,9,570
30894945@N04,3865,15,1354956918,1354957188,2,9,270
30894945@N04,3865,16,1354958649,1354958919,4,9,270
30902022@N00,3866,28,1203683200,1203683278,2,8,78
30902022@N00,3866,29,1203683278,1203683349,3,8,71
30902022@N00,3866,30,1203683349,1203683364,2,8,15
30902022@N00,3866,28,1203683364,1203683390,2,8,26
30902022@N00,3866,1,1203683390,1203683430,2,8,40
30902022@N00,3866,29,1203683430,1203683459,2,8,29
30902022@N00,3866,28,1203683459,1203683565,3,8,106
30902022@N00,3866,29,1203683565,1203684465,1,8,900
30902022@N00,3867,30,1203762594,1203763674,1,1,1080
30941874@N03,3868,26,1244128024,1244128924,1,1,900
30981640@N05,3869,29,1373266841,1373267741,2,2,900
30981640@N05,3869,20,1373268557,1373269097,1,2,540
31019923@N00,3870,16,1343598831,1343599101,4,15,270
31019923@N00,3870,23,1343602801,1343603401,2,15,600
31019923@N00,3870,3,1343605169,1343605220,2,15,51
31019923@N00,3870,12,1343605220,1343605257,3,15,37
31019923@N00,3870,3,1343605257,1343605347,3,15,90
31019923@N00,3870,26,1343605511,1343606261,3,15,750
31019923@N00,3870,30,1343606261,1343607341,3,15,1080
31019923@N00,3870,29,1343608247,1343609147,6,15,900
31019923@N00,3870,6,1343610327,1343610342,2,15,15
31019923@N00,3870,26,1343610342,1343610370,2,15,28
31019923@N00,3870,6,1343610370,1343610490,2,15,120
31019923@N00,3870,17,1343617932,1343618232,2,15,300
31019923@N00,3870,26,1343620307,1343620550,3,15,243
31019923@N00,3870,8,1343620550,1343620730,2,15,180
31019923@N00,3870,17,1343623715,1343624015,2,15,300
31019923@N00,3871,18,1352694103,1352694257,3,10,154
31019923@N00,3871,23,1352694257,1352694503,2,10,246
31019923@N00,3871,18,1352694503,1352694804,2,10,301
31019923@N00,3871,19,1352694804,1352695137,3,10,333
31019923@N00,3871,18,1352695137,1352695587,9,10,450
31019923@N00,3871,29,1352698381,1352698558,4,10,177
31019923@N00,3871,31,1352698558,1352698596,2,10,38
31019923@N00,3871,20,1352698596,1352698682,3,10,86
31019923@N00,3871,29,1352698682,1352698700,2,10,18
31019923@N00,3871,20,1352698700,1352699240,8,10,540
31052620@N00,3872,11,1262150625,1262150865,1,1,240
31070925@N07,3873,15,1416183011,1416183281,17,3,270
31070925@N07,3873,14,1416195650,1416195890,6,3,240
31070925@N07,3873,26,1416201345,1416202245,1,3,900
31105023@N06,3874,26,1309690604,1309691504,1,1,900
31130361@N06,3875,28,1326367992,1326368506,4,2,514
31130361@N06,3875,25,1326368506,1326369346,1,2,840
31130361@N06,3876,28,1326516518,1326517418,2,1,900
31138817@N00,3877,21,1290568036,1290568606,2,5,570
31138817@N00,3877,25,1290569183,1290570023,3,5,840
31138817@N00,3877,18,1290574959,1290575409,2,5,450
31138817@N00,3877,16,1290577465,1290577735,2,5,270
31138817@N00,3877,30,1290577803,1290578883,3,5,1080
31160848@N06,3878,28,1346911585,1346912485,1,1,900
31172882@N02,3879,1,1222977331,1222977391,3,15,60
31172882@N02,3879,28,1222977558,1222977977,3,15,419
31172882@N02,3879,16,1222977977,1222978018,2,15,41
31172882@N02,3879,26,1222978018,1222978464,9,15,446
31172882@N02,3879,30,1222978464,1222979411,2,15,947
31172882@N02,3879,21,1222979411,1222979981,4,15,570
31172882@N02,3879,12,1222980444,1222980684,3,15,240
31172882@N02,3879,29,1222986688,1222987588,10,15,900
31172882@N02,3879,20,1222989678,1222990218,17,15,540
31172882@N02,3879,23,1222993459,1222994059,2,15,600
31172882@N02,3879,26,1222994370,1222994706,4,15,336
31172882@N02,3879,8,1222994706,1222994886,2,15,180
31172882@N02,3879,6,1222994908,1222995028,4,15,120
31172882@N02,3879,11,1222995278,1222995518,3,15,240
31172882@N02,3879,3,1222996538,1222996628,3,15,90
31172882@N02,3880,20,1224844368,1224844908,1,1,540
31177379@N02,3881,27,1387526187,1387527087,1,1,900
31195909@N07,3882,24,1424066146,1424066926,4,1,780
31208576@N06,3883,30,1347710039,1347711119,1,1,1080
31223689@N00,3884,17,1236552144,1236552444,4,5,300
31223689@N00,3884,26,1236554347,1236555247,4,5,900
31223689@N00,3884,29,1236555476,1236556376,5,5,900
31223689@N00,3884,23,1236556896,1236557496,2,5,600
31223689@N00,3884,26,1236557955,1236558855,1,5,900
31232304@N05,3885,26,1282752948,1282753848,1,1,900
31254726@N03,3886,26,1292916950,1292917850,2,7,900
31254726@N03,3886,18,1292918073,1292918357,2,7,284
31254726@N03,3886,15,1292918357,1292918418,2,7,61
31254726@N03,3886,18,1292918418,1292918457,2,7,39
31254726@N03,3886,28,1292918457,1292918616,2,7,159
31254726@N03,3886,26,1292918616,1292918713,2,7,97
31254726@N03,3886,23,1292918713,1292919313,1,7,600
31266253@N06,3887,26,1227769762,1227770662,1,1,900
31266253@N06,3888,26,1227860661,1227861561,1,1,900
31266253@N06,3889,8,1231458538,1231458718,1,1,180
31266253@N06,3890,1,1259899259,1259899319,2,6,60
31266253@N06,3890,18,1259899637,1259899870,2,6,233
31266253@N06,3890,29,1259899870,1259900300,2,6,430
31266253@N06,3890,20,1259900300,1259900840,2,6,540
31266253@N06,3890,19,1259904927,1259905467,3,6,540
31266253@N06,3890,24,1259910204,1259910984,1,6,780
31266253@N06,3891,26,1259992555,1259993455,2,1,900
31355566@N06,3892,26,1279577228,1279578128,2,3,900
31355566@N06,3892,10,1279585083,1279585323,2,3,240
31355566@N06,3892,13,1279591803,1279592043,2,3,240
31385681@N02,3893,14,1257737066,1257737306,1,1,240
31397036@N00,3894,26,1279687118,1279688018,18,1,900
31397036@N00,3895,26,1280356176,1280357076,3,1,900
31428730@N07,3896,26,1377982707,1377983607,18,1,900
31428878@N02,3897,26,1245991770,1245992670,1,1,900
31428878@N02,3898,29,1251343993,1251344893,2,1,900
31428878@N02,3899,16,1253251741,1253252011,1,1,270
31428878@N02,3900,17,1254454040,1254454340,1,1,300
31429576@N04,3901,12,1250722660,1250722900,2,4,240
31429576@N04,3901,26,1250724664,1250725564,3,4,900
31429576@N04,3901,6,1250738267,1250738387,2,4,120
31429576@N04,3901,28,1250745625,1250746525,1,4,900
31429576@N04,3902,23,1288405274,1288405874,7,3,600
31429576@N04,3902,26,1288422399,1288423299,12,3,900
31429576@N04,3902,28,1288433781,1288434681,1,3,900
31429576@N04,3903,25,1294034037,1294034877,2,9,840
31429576@N04,3903,30,1294042602,1294043682,2,9,1080
31429576@N04,3903,6,1294044308,1294044428,2,9,120
31429576@N04,3903,13,1294046252,1294046492,3,9,240
31429576@N04,3903,26,1294050393,1294051293,5,9,900
31429576@N04,3903,25,1294054948,1294055788,2,9,840
31429576@N04,3903,29,1294061484,1294062384,2,9,900
31429576@N04,3903,26,1294062909,1294063809,3,9,900
31429576@N04,3903,28,1294067360,1294068260,1,9,900
31453381@N02,3904,10,1306831297,1306831537,1,1,240
31468609@N00,3905,26,1301277107,1301278007,18,1,900
31479144@N00,3906,16,1336265763,1336266033,1,1,270
31508945@N06,3907,30,1322538206,1322539286,1,1,1080
31544947@N00,3908,30,1437736596,1437737676,3,2,1080
31544947@N00,3908,26,1437742223,1437743123,2,2,900
31544947@N00,3909,26,1437832748,1437833648,1,1,900
31544947@N00,3910,26,1437915528,1437916428,2,1,900
31579500@N08,3911,28,1345636876,1345637776,1,1,900
31579500@N08,3912,20,1347628414,1347628954,1,1,540
31579500@N08,3913,20,1353382486,1353383011,2,2,525
31579500@N08,3913,11,1353383011,1353383251,1,2,240
31599559@N00,3914,19,1412458968,1412459508,1,1,540
31599559@N00,3915,20,1412493250,1412493790,1,1,540
31641212@N05,3916,13,1309256711,1309256951,1,1,240
31641212@N05,3917,16,1309364280,1309364550,1,1,270
31641212@N05,3918,29,1388107911,1388108180,2,3,269
31641212@N05,3918,20,1388108180,1388108720,2,3,540
31641212@N05,3918,15,1388114585,1388114855,1,3,270
31641212@N05,3919,29,1388145024,1388145924,1,1,900
31641212@N05,3920,30,1397548823,1397549903,2,2,1080
31641212@N05,3920,18,1397552029,1397552479,2,2,450
31641212@N05,3921,26,1397697351,1397698251,1,1,900
31648659@N08,3922,18,1447915237,1447915687,1,1,450
31660989@N05,3923,26,1279584634,1279585534,3,4,900
31660989@N05,3923,18,1279598030,1279598480,2,4,450
31660989@N05,3923,30,1279598872,1279599952,2,4,1080
31660989@N05,3923,28,1279613011,1279613911,1,4,900
31660989@N05,3924,1,1279698176,1279698236,2,1,60
31664770@N02,3925,26,1283162407,1283163307,2,1,900
31664770@N02,3926,26,1312761090,1312761990,2,2,900
31664770@N02,3926,29,1312779958,1312780858,3,2,900
31664770@N02,3927,29,1346738187,1346739087,2,2,900
31664770@N02,3927,26,1346744627,1346745527,1,2,900
31692641@N00,3928,24,1465251904,1465252684,8,11,780
31692641@N00,3928,5,1465257544,1465257664,2,11,120
31692641@N00,3928,3,1465257673,1465257763,2,11,90
31692641@N00,3928,13,1465262316,1465262556,3,11,240
31692641@N00,3928,24,1465264307,1465265087,2,11,780
31692641@N00,3928,20,1465287658,1465288198,2,11,540
31692641@N00,3928,18,1465290112,1465290562,6,11,450
31692641@N00,3928,23,1465291975,1465292575,3,11,600
31692641@N00,3928,29,1465293286,1465294186,3,11,900
31692641@N00,3928,7,1465302254,1465302434,2,11,180
31692641@N00,3928,16,1465304218,1465304488,2,11,270
31701053@N08,3929,26,1290924446,1290925346,1,1,900
31751836@N04,3930,26,1362449343,1362450243,2,1,900
31753774@N00,3931,20,1195724089,1195724629,3,1,540
31779495@N05,3932,26,1416017980,1416018880,4,1,900
31779495@N05,3933,19,1416062442,1416062982,2,8,540
31779495@N05,3933,15,1416070829,1416071099,2,8,270
31779495@N05,3933,28,1416096186,1416096777,2,8,591
31779495@N05,3933,5,1416096777,1416096783,2,8,6
31779495@N05,3933,21,1416096783,1416097353,2,8,570
31779495@N05,3933,26,1416104783,1416104954,2,8,171
31779495@N05,3933,28,1416104954,1416105854,2,8,900
31779495@N05,3933,1,1416106459,1416106519,2,8,60
31794493@N00,3934,27,1305955381,1305956281,4,5,900
31794493@N00,3934,21,1305960241,1305960486,2,5,245
31794493@N00,3934,13,1305960486,1305960726,2,5,240
31794493@N00,3934,29,1305965082,1305965982,2,5,900
31794493@N00,3934,20,1305966850,1305967390,4,5,540
31794493@N00,3935,31,1306201548,1306201554,2,20,6
31794493@N00,3935,30,1306201554,1306201599,2,20,45
31794493@N00,3935,29,1306201599,1306202437,15,20,838
31794493@N00,3935,20,1306202437,1306202977,4,20,540
31794493@N00,3935,29,1306203713,1306204613,5,20,900
31794493@N00,3935,15,1306209141,1306209411,6,20,270
31794493@N00,3935,3,1306212381,1306212471,6,20,90
31794493@N00,3935,5,1306212620,1306212684,3,20,64
31794493@N00,3935,9,1306212684,1306212735,2,20,51
31794493@N00,3935,26,1306212735,1306212758,3,20,23
31794493@N00,3935,5,1306212758,1306212792,2,20,34
31794493@N00,3935,6,1306212792,1306212829,3,20,37
31794493@N00,3935,8,1306212829,1306212853,2,20,24
31794493@N00,3935,6,1306212853,1306212973,5,20,120
31794493@N00,3935,10,1306213396,1306213424,2,20,28
31794493@N00,3935,26,1306213424,1306214324,5,20,900
31794493@N00,3935,18,1306215951,1306216001,4,20,50
31794493@N00,3935,23,1306216001,1306216601,2,20,600
31794493@N00,3935,18,1306217461,1306217719,2,20,258
31794493@N00,3935,28,1306217719,1306218619,3,20,900
31794493@N00,3936,20,1306337823,1306338363,3,8,540
31794493@N00,3936,28,1306344556,1306344968,2,8,412
31794493@N00,3936,8,1306344968,1306345148,2,8,180
31794493@N00,3936,26,1306345165,1306345187,2,8,22
31794493@N00,3936,8,1306345187,1306345205,2,8,18
31794493@N00,3936,27,1306345205,1306345239,2,8,34
31794493@N00,3936,3,1306345239,1306345278,3,8,39
31794493@N00,3936,28,1306345278,1306346178,1,8,900
31864937@N00,3937,28,1293886816,1293887716,1,1,900
31864937@N00,3938,1,1294056174,1294056234,1,1,60
31898392@N03,3939,16,1359881358,1359881628,2,2,270
31898392@N03,3939,17,1359884416,1359884716,5,2,300
31916258@N00,3940,12,1205876093,1205876333,7,17,240
31916258@N00,3940,17,1205878188,1205878488,2,17,300
31916258@N00,3940,12,1205879669,1205879909,10,17,240
31916258@N00,3940,13,1205881521,1205881761,6,17,240
31916258@N00,3940,27,1205884120,1205885020,3,17,900
31916258@N00,3940,17,1205886281,1205886581,2,17,300
31916258@N00,3940,16,1205888201,1205888471,3,17,270
31916258@N00,3940,26,1205888937,1205888956,3,17,19
31916258@N00,3940,12,1205888956,1205889196,2,17,240
31916258@N00,3940,29,1205889473,1205890373,8,17,900
31916258@N00,3940,20,1205892172,1205892712,3,17,540
31916258@N00,3940,18,1205895114,1205895564,8,17,450
31916258@N00,3940,10,1205896949,1205897189,4,17,240
31916258@N00,3940,18,1205897798,1205898248,5,17,450
31916258@N00,3940,28,1205898802,1205898823,2,17,21
31916258@N00,3940,1,1205898823,1205898883,3,17,60
31916258@N00,3940,26,1205922441,1205923341,1,17,900
31916258@N00,3941,29,1247273687,1247274587,2,5,900
31916258@N00,3941,26,1247279002,1247279902,3,5,900
31916258@N00,3941,13,1247283096,1247283336,2,5,240
31916258@N00,3941,26,1247292019,1247292919,2,5,900
31916258@N00,3941,29,1247300011,1247300911,2,5,900
31916258@N00,3942,17,1247357341,1247357641,2,1,300
31916258@N00,3943,26,1247471889,1247472789,1,1,900
31916258@N00,3944,17,1248572962,1248573262,2,3,300
31916258@N00,3944,3,1248580958,1248581048,2,3,90
31916258@N00,3944,12,1248581250,1248581490,1,3,240
31916258@N00,3945,13,1257563764,1257564004,4,6,240
31916258@N00,3945,26,1257565634,1257566534,5,6,900
31916258@N00,3945,30,1257574936,1257575882,2,6,946
31916258@N00,3945,29,1257575882,1257576782,5,6,900
31916258@N00,3945,23,1257578710,1257579310,2,6,600
31916258@N00,3945,30,1257581509,1257582589,1,6,1080
31916258@N00,3946,26,1298172545,1298173445,21,1,900
31918796@N02,3947,26,1188172727,1188173627,1,1,900
31940369@N04,3948,28,1348031080,1348031980,2,2,900
31940369@N04,3948,10,1348039012,1348039252,1,2,240
31940369@N04,3949,26,1353412434,1353413334,1,1,900
31949792@N00,3950,29,1266976327,1266977227,2,3,900
31949792@N00,3950,3,1266984419,1266984509,2,3,90
31949792@N00,3950,17,1266985913,1266986213,1,3,300
31949792@N00,3951,23,1267064961,1267065561,1,1,600
31949792@N00,3952,23,1267343038,1267343638,1,1,600
31954625@N00,3953,1,1384833525,1384833585,18,5,60
31954625@N00,3953,28,1384834057,1384834283,5,5,226
31954625@N00,3953,26,1384834283,1384835115,2,5,832
31954625@N00,3953,30,1384835115,1384836195,3,5,1080
31954625@N00,3953,1,1384837735,1384837795,1,5,60
31954625@N00,3954,26,1386131505,1386132290,3,3,785
31954625@N00,3954,11,1386132290,1386132530,2,3,240
31954625@N00,3954,1,1386135413,1386135473,2,3,60
31954625@N00,3955,28,1386648682,1386649582,3,1,900
31954625@N00,3956,17,1397019771,1397020071,2,3,300
31954625@N00,3956,18,1397022502,1397022539,2,3,37
31954625@N00,3956,17,1397022539,1397022839,3,3,300
31954625@N00,3957,20,1399961082,1399961622,2,2,540
31954625@N00,3957,1,1399961860,1399961920,1,2,60
31954625@N00,3958,31,1401340318,1401341818,1,1,1500
31954625@N00,3959,27,1401776545,1401777445,1,1,900
31954625@N00,3960,30,1401884588,1401885668,2,2,1080
31954625@N00,3960,17,1401886465,1401886765,1,2,300
31954625@N00,3961,20,1401970402,1401970942,2,2,540
31954625@N00,3961,1,1401970994,1401971054,2,2,60
31954625@N00,3962,27,1409285408,1409286308,1,1,900
31954625@N00,3963,1,1410755142,1410755202,3,4,60
31954625@N00,3963,28,1410755240,1410755353,8,4,113
31954625@N00,3963,16,1410755353,1410755521,2,4,168
31954625@N00,3963,17,1410755521,1410755821,1,4,300
31954625@N00,3964,1,1412575237,1412575241,2,2,4
31954625@N00,3964,28,1412575241,1412576141,2,2,900
31954625@N00,3965,27,1414044667,1414045567,2,2,900
31954625@N00,3965,26,1414048649,1414049549,1,2,900
31954625@N00,3966,30,1414561518,1414562598,2,1,1080
31954625@N00,3967,28,1416458098,1416458998,2,3,900
31954625@N00,3967,26,1416459756,1416460106,2,3,350
31954625@N00,3967,1,1416460106,1416460166,5,3,60
31954625@N00,3968,26,1417575779,1417576679,2,2,900
31954625@N00,3968,29,1417578490,1417579390,1,2,900
31954625@N00,3969,15,1418875071,1418875341,11,5,270
31954625@N00,3969,12,1418879816,1418879959,2,5,143
31954625@N00,3969,26,1418879959,1418880170,11,5,211
31954625@N00,3969,7,1418880170,1418880350,7,5,180
31954625@N00,3969,28,1418884596,1418885496,1,5,900
31957707@N08,3970,28,1346464932,1346465832,4,8,900
31957707@N08,3970,11,1346473255,1346473258,2,8,3
31957707@N08,3970,26,1346473258,1346474158,4,8,900
31957707@N08,3970,20,1346484572,1346485112,2,8,540
31957707@N08,3970,30,1346486344,1346487424,5,8,1080
31957707@N08,3970,7,1346489298,1346489339,2,8,41
31957707@N08,3970,3,1346489339,1346489345,2,8,6
31957707@N08,3970,5,1346489345,1346489465,2,8,120
32021900@N00,3971,28,1331414294,1331415194,1,1,900
32046871@N00,3972,28,1361608553,1361609453,1,1,900
32169245@N00,3973,1,1325285421,1325285481,2,8,60
32169245@N00,3973,17,1325286823,1325287123,2,8,300
32169245@N00,3973,31,1325289822,1325291322,2,8,1500
32169245@N00,3973,16,1325293181,1325293451,2,8,270
32169245@N00,3973,30,1325298186,1325299266,2,8,1080
32169245@N00,3973,29,1325300082,1325300982,2,8,900
32169245@N00,3973,28,1325322034,1325322934,2,8,900
32169245@N00,3973,26,1325323899,1325324799,1,8,900
32218114@N00,3974,23,1361592277,1361592877,1,1,600
32218114@N00,3975,17,1361624685,1361624985,1,1,300
32218114@N00,3976,17,1361668350,1361668650,2,7,300
32218114@N00,3976,30,1361679873,1361679917,2,7,44
32218114@N00,3976,31,1361679917,1361679940,2,7,23
32218114@N00,3976,30,1361679940,1361681020,3,7,1080
32218114@N00,3976,17,1361681529,1361681829,2,7,300
32218114@N00,3976,26,1361683920,1361684820,2,7,900
32218114@N00,3976,30,1361698605,1361699685,1,7,1080
32218114@N00,3977,17,1361758677,1361758977,3,1,300
32218114@N00,3978,30,1378431629,1378432486,3,5,857
32218114@N00,3978,20,1378432486,1378433026,4,5,540
32218114@N00,3978,30,1378444885,1378445965,5,5,1080
32218114@N00,3978,13,1378449921,1378450161,4,5,240
32218114@N00,3978,26,1378458516,1378459416,5,5,900
32218114@N00,3979,26,1393131316,1393132216,2,1,900
32233251@N07,3980,26,1440125147,1440126047,1,1,900
32233251@N07,3981,26,1440153964,1440154864,1,1,900
32248086@N03,3982,30,1430059961,1430061041,3,3,1080
32248086@N03,3982,6,1430062847,1430062967,2,3,120
32248086@N03,3982,26,1430064418,1430065318,2,3,900
32248086@N03,3983,26,1461937759,1461938659,2,1,900
32255839@N00,3984,16,1334617260,1334617530,2,13,270
32255839@N00,3984,17,1334619160,1334619460,2,13,300
32255839@N00,3984,26,1334619599,1334620499,2,13,900
32255839@N00,3984,17,1334630421,1334630721,2,13,300
32255839@N00,3984,12,1334631300,1334631540,2,13,240
32255839@N00,3984,7,1334631614,1334631794,4,13,180
32255839@N00,3984,20,1334642866,1334643406,2,13,540
32255839@N00,3984,28,1334645531,1334646431,2,13,900
32255839@N00,3984,24,1334650404,1334651184,3,13,780
32255839@N00,3984,8,1334659609,1334659784,3,13,175
32255839@N00,3984,15,1334659784,1334660054,3,13,270
32255839@N00,3984,28,1334660786,1334661109,2,13,323
32255839@N00,3984,16,1334661109,1334661379,1,13,270
32281247@N08,3985,12,1301631420,1301631496,2,3,76
32281247@N08,3985,16,1301631496,1301631549,2,3,53
32281247@N08,3985,12,1301631549,1301631789,1,3,240
32288855@N08,3986,26,1435467274,1435468174,2,4,900
32288855@N08,3986,21,1435469245,1435469815,2,4,570
32288855@N08,3986,25,1435470200,1435471040,4,4,840
32288855@N08,3986,4,1435473297,1435473398,2,4,101
32288855@N08,3987,21,1435579266,1435579836,1,1,570
32289743@N03,3988,11,1309679373,1309679613,1,1,240
32289743@N03,3989,20,1310185531,1310186071,1,1,540
32289743@N03,3990,13,1314503701,1314503941,1,1,240
32289743@N03,3991,28,1319255455,1319256355,1,1,900
32289743@N03,3992,12,1327618504,1327618744,2,2,240
32289743@N03,3992,13,1327619638,1327619878,1,2,240
32289743@N03,3993,26,1329360187,1329361087,1,1,900
32289743@N03,3994,10,1330046956,1330047196,2,4,240
32289743@N03,3994,30,1330047717,1330048797,2,4,1080
32289743@N03,3994,26,1330051835,1330052045,3,4,210
32289743@N03,3994,12,1330052045,1330052285,1,4,240
32289743@N03,3995,16,1330462807,1330463077,2,4,270
32289743@N03,3995,23,1330463131,1330463731,2,4,600
32289743@N03,3995,11,1330463856,1330464096,2,4,240
32289743@N03,3995,7,1330466111,1330466291,1,4,180
32289743@N03,3996,28,1330496753,1330497653,1,1,900
32289743@N03,3997,28,1330534182,1330534378,2,3,196
32289743@N03,3997,16,1330534378,1330534648,2,3,270
32289743@N03,3997,3,1330535876,1330535966,1,3,90
32289743@N03,3998,18,1332145993,1332146443,1,1,450
32289743@N03,3999,18,1332382808,1332382968,2,4,160
32289743@N03,3999,31,1332382968,1332383066,2,4,98
32289743@N03,3999,30,1332383066,1332383851,2,4,785
32289743@N03,3999,20,1332383851,1332384391,1,4,540
32289743@N03,4000,12,1333587574,1333587814,2,4,240
32289743@N03,4000,23,1333590775,1333590809,2,4,34
32289743@N03,4000,18,1333590809,1333590873,2,4,64
32289743@N03,4000,23,1333590873,1333591473,1,4,600
32289743@N03,4001,1,1334309195,1334309255,1,1,60
32289743@N03,4002,6,1334797948,1334798068,2,3,120
32289743@N03,4002,29,1334798389,1334799289,2,3,900
32289743@N03,4002,13,1334800153,1334800393,1,3,240
32289743@N03,4003,4,1335430595,1335430696,2,2,101
32289743@N03,4003,30,1335434652,1335435732,1,2,1080
32289743@N03,4004,13,1335767292,1335767532,1,1,240
32289743@N03,4005,22,1335863308,1335863908,3,1,600
32289743@N03,4006,28,1336006818,1336007718,2,3,900
32289743@N03,4006,13,1336009047,1336009287,3,3,240
32289743@N03,4006,31,1336011884,1336013384,1,3,1500
32289743@N03,4007,30,1336627495,1336628575,3,2,1080
32289743@N03,4007,28,1336634795,1336635695,1,2,900
32289743@N03,4008,28,1337235487,1337236034,2,2,547
32289743@N03,4008,16,1337236034,1337236304,1,2,270
32289743@N03,4009,1,1338259236,1338259296,2,2,60
32289743@N03,4009,28,1338259985,1338260885,1,2,900
32289743@N03,4010,13,1339038147,1339038387,3,2,240
32289743@N03,4010,30,1339042464,1339043544,1,2,1080
32289743@N03,4011,29,1339645303,1339646203,2,1,900
32289743@N03,4012,3,1340518325,1340518415,2,3,90
32289743@N03,4012,12,1340518860,1340519100,2,3,240
32289743@N03,4012,21,1340519281,1340519851,1,3,570
32289743@N03,4013,13,1342077449,1342077689,1,1,240
32289743@N03,4014,26,1342497654,1342498554,2,1,900
32289743@N03,4015,27,1342701918,1342702818,1,1,900
32289743@N03,4016,31,1342764798,1342766298,1,1,1500
32289743@N03,4017,30,1343278992,1343279036,2,2,44
32289743@N03,4017,29,1343279036,1343279936,1,2,900
32289743@N03,4018,24,1343889180,1343889960,5,4,780
32289743@N03,4018,30,1343891709,1343892151,2,4,442
32289743@N03,4018,10,1343892151,1343892391,4,4,240
32289743@N03,4018,30,1343893302,1343894382,1,4,1080
32289743@N03,4019,28,1347584907,1347585806,2,2,899
32289743@N03,4019,30,1347585806,1347586886,2,2,1080
32289743@N03,4020,1,1348571090,1348571150,2,1,60
32289743@N03,4021,29,1348733596,1348733979,2,2,383
32289743@N03,4021,22,1348733979,1348734579,1,2,600
32289743@N03,4022,1,1352944416,1352944476,2,2,60
32289743@N03,4022,20,1352946726,1352947266,2,2,540
32303563@N00,4023,1,1288306843,1288306892,2,13,49
32303563@N00,4023,28,1288306892,1288307337,3,13,445
32303563@N00,4023,29,1288307337,1288308237,3,13,900
32303563@N00,4023,20,1288311483,1288312023,3,13,540
32303563@N00,4023,29,1288315080,1288315980,2,13,900
32303563@N00,4023,22,1288318592,1288319192,6,13,600
32303563@N00,4023,10,1288321121,1288321277,3,13,156
32303563@N00,4023,3,1288321277,1288321367,2,13,90
32303563@N00,4023,24,1288323694,1288324474,3,13,780
32303563@N00,4023,26,1288332644,1288333062,2,13,418
32303563@N00,4023,17,1288333062,1288333362,3,13,300
32303563@N00,4023,27,1288337994,1288338395,2,13,401
32303563@N00,4023,28,1288338395,1288339295,1,13,900
32349630@N00,4024,26,1227744679,1227745579,27,1,900
32349630@N00,4025,26,1254352421,1254353321,18,1,900
32349630@N00,4026,26,1259240684,1259241584,1,1,900
32349630@N00,4027,26,1259332877,1259333777,1,1,900
32352764@N00,4028,28,1191919930,1191920830,2,2,900
32352764@N00,4028,13,1191936722,1191936962,1,2,240
32354567@N00,4029,29,1365909213,1365910113,2,1,900
32373689668@N01,4030,28,1257458016,1257458916,2,1,900
32404529@N05,4031,11,1279878048,1279878288,1,1,240
32431753@N00,4032,17,1387344250,1387344550,1,1,300
32431753@N00,4033,27,1448663872,1448664772,2,4,900
32431753@N00,4033,18,1448680988,1448681438,2,4,450
32431753@N00,4033,29,1448695509,1448696409,2,4,900
32431753@N00,4033,17,1448702965,1448703265,1,4,300
32434595@N02,4034,3,1320461622,1320461712,1,1,90
32442033@N00,4035,3,1423975669,1423975759,4,5,90
32442033@N00,4035,30,1423978272,1423979352,3,5,1080
32442033@N00,4035,29,1423980415,1423981315,2,5,900
32442033@N00,4035,20,1423981769,1423982309,5,5,540
32442033@N00,4035,25,1423985013,1423985853,3,5,840
32444760@N02,4036,22,1294817240,1294817840,2,2,600
32444760@N02,4036,26,1294822410,1294823310,1,2,900
32471539@N03,4037,18,1290598577,1290599027,1,1,450
32491696@N00,4038,26,1285458561,1285459461,1,1,900
32491696@N00,4039,26,1323311956,1323312856,1,1,900
32493439@N00,4040,17,1356479015,1356479113,2,5,98
32493439@N00,4040,26,1356479113,1356479866,2,5,753
32493439@N00,4040,8,1356479866,1356480046,2,5,180
32493439@N00,4040,13,1356481337,1356481577,2,5,240
32493439@N00,4040,18,1356486137,1356486587,1,5,450
32493439@N00,4041,3,1356519394,1356519484,2,3,90
32493439@N00,4041,26,1356523030,1356523640,2,3,610
32493439@N00,4041,25,1356523640,1356524480,1,3,840
32504140@N05,4042,28,1341125673,1341126573,1,1,900
32504140@N05,4043,17,1341156112,1341156412,1,1,300
32518478@N02,4044,17,1361634778,1361635078,2,2,300
32518478@N02,4044,28,1361644177,1361645077,1,2,900
32518478@N02,4045,1,1396857839,1396857899,1,1,60
32586096@N00,4046,18,1440218052,1440218502,2,1,450
32589831@N04,4047,8,1248400425,1248400605,1,1,180
32601772@N07,4048,31,1200022941,1200024441,1,1,1500
32601772@N07,4049,26,1209119641,1209120541,1,1,900
32601772@N07,4050,30,1274414862,1274415942,1,1,1080
32604470@N08,4051,1,1398124888,1398124948,2,6,60
32604470@N08,4051,13,1398129711,1398129951,2,6,240
32604470@N08,4051,29,1398138357,1398139257,4,6,900
32604470@N08,4051,31,1398149773,1398151273,2,6,1500
32604470@N08,4051,17,1398153730,1398154030,3,6,300
32604470@N08,4051,16,1398157090,1398157360,1,6,270
32604470@N08,4052,29,1435727531,1435728431,1,1,900
32609765@N00,4053,16,1460701834,1460702104,2,2,270
32609765@N00,4053,29,1460705205,1460706105,1,2,900
32609765@N00,4054,6,1460805835,1460805955,1,1,120
32627881@N07,4055,31,1338783644,1338785144,731,1,1500
32627881@N07,4056,31,1338854648,1338856148,668,1,1500
32627881@N07,4057,31,1339020251,1339021751,1,1,1500
32627881@N07,4058,31,1341609149,1341610649,8,1,1500
32643997@N00,4059,26,1385258349,1385259249,1,1,900
32715151@N04,4060,29,1449558065,1449558965,2,2,900
32715151@N04,4060,17,1449566645,1449566945,1,2,300
32715151@N04,4061,18,1449824361,1449824811,1,1,450
32715151@N04,4062,18,1449971182,1449971632,1,1,450
32715761@N00,4063,7,1201244795,1201244975,8,1,180
32715761@N00,4064,1,1201301163,1201301223,4,17,60
32715761@N00,4064,28,1201301344,1201301519,2,17,175
32715761@N00,4064,16,1201301519,1201301789,2,17,270
32715761@N00,4064,12,1201302067,1201302083,2,17,16
32715761@N00,4064,24,1201302083,1201302357,2,17,274
32715761@N00,4064,12,1201302357,1201302457,2,17,100
32715761@N00,4064,24,1201302457,1201303237,17,17,780
32715761@N00,4064,17,1201307106,1201307406,2,17,300
32715761@N00,4064,24,1201308558,1201309338,5,17,780
32715761@N00,4064,27,1201310893,1201311272,3,17,379
32715761@N00,4064,16,1201311272,1201311542,3,17,270
32715761@N00,4064,26,1201312626,1201312743,2,17,117
32715761@N00,4064,16,1201312743,1201312816,2,17,73
32715761@N00,4064,26,1201312816,1201313716,16,17,900
32715761@N00,4064,7,1201335843,1201336023,2,17,180
32715761@N00,4064,3,1201337843,1201337933,5,17,90
32715761@N00,4064,24,1201339813,1201340593,1,17,780
32715761@N00,4065,26,1201387592,1201387736,2,10,144
32715761@N00,4065,5,1201387736,1201387817,3,10,81
32715761@N00,4065,3,1201387817,1201387907,5,10,90
32715761@N00,4065,7,1201388505,1201388685,6,10,180
32715761@N00,4065,5,1201390624,1201390744,3,10,120
32715761@N00,4065,31,1201391856,1201392106,2,10,250
32715761@N00,4065,22,1201392106,1201392706,4,10,600
32715761@N00,4065,29,1201393318,1201394218,2,10,900
32715761@N00,4065,23,1201398404,1201398680,2,10,276
32715761@N00,4065,19,1201398680,1201399220,2,10,540
32715761@N00,4066,1,1201475213,1201475273,4,5,60
32715761@N00,4066,23,1201475644,1201476244,2,5,600
32715761@N00,4066,4,1201477221,1201477322,6,5,101
32715761@N00,4066,21,1201478825,1201479395,3,5,570
32715761@N00,4066,28,1201480399,1201481299,3,5,900
32715761@N00,4067,28,1223502795,1223503695,4,15,900
32715761@N00,4067,27,1223505513,1223505888,2,15,375
32715761@N00,4067,26,1223505888,1223506460,6,15,572
32715761@N00,4067,7,1223506460,1223506640,2,15,180
32715761@N00,4067,5,1223506891,1223507011,2,15,120
32715761@N00,4067,21,1223507119,1223507689,7,15,570
32715761@N00,4067,4,1223508861,1223508882,3,15,21
32715761@N00,4067,11,1223508882,1223509036,4,15,154
32715761@N00,4067,4,1223509036,1223509137,2,15,101
32715761@N00,4067,21,1223509760,1223510247,3,15,487
32715761@N00,4067,3,1223510247,1223510337,13,15,90
32715761@N00,4067,13,1223514916,1223515156,11,15,240
32715761@N00,4067,30,1223520199,1223521279,6,15,1080
32715761@N00,4067,31,1223521641,1223523141,2,15,1500
32715761@N00,4067,1,1223523809,1223523869,1,15,60
32715761@N00,4068,28,1223594102,1223594173,2,9,71
32715761@N00,4068,23,1223594173,1223594773,2,9,600
32715761@N00,4068,12,1223597635,1223597875,4,9,240
32715761@N00,4068,26,1223598525,1223598759,2,9,234
32715761@N00,4068,29,1223598759,1223599659,2,9,900
32715761@N00,4068,30,1223600399,1223601479,6,9,1080
32715761@N00,4068,29,1223602631,1223602919,2,9,288
32715761@N00,4068,19,1223602919,1223603459,11,9,540
32715761@N00,4068,1,1223605326,1223605386,3,9,60
32715761@N00,4069,24,1223669812,1223670592,6,12,780
32715761@N00,4069,12,1223671294,1223671359,3,12,65
32715761@N00,4069,24,1223671359,1223672139,2,12,780
32715761@N00,4069,15,1223672333,1223672603,2,12,270
32715761@N00,4069,17,1223676918,1223677218,2,12,300
32715761@N00,4069,24,1223679806,1223679900,2,12,94
32715761@N00,4069,15,1223679900,1223680170,2,12,270
32715761@N00,4069,26,1223682568,1223682635,2,12,67
32715761@N00,4069,23,1223682635,1223683235,3,12,600
32715761@N00,4069,31,1223687676,1223689176,9,12,1500
32715761@N00,4069,22,1223689260,1223689860,5,12,600
32715761@N00,4069,1,1223691027,1223691087,1,12,60
32715761@N00,4070,24,1223764739,1223765497,2,7,758
32715761@N00,4070,21,1223765497,1223766067,4,7,570
32715761@N00,4070,4,1223766209,1223766310,2,7,101
32715761@N00,4070,3,1223766752,1223766842,5,7,90
32715761@N00,4070,13,1223768220,1223768460,4,7,240
32715761@N00,4070,24,1223770762,1223771124,2,7,362
32715761@N00,4070,27,1223771124,1223772024,1,7,900
32752574@N07,4071,26,1337180828,1337181728,1,1,900
32771019@N07,4072,1,1273890673,1273890733,1,1,60
32771930@N03,4073,29,1276419425,1276420325,2,1,900
32771930@N03,4074,29,1280656578,1280657478,3,1,900
32782751@N07,4075,29,1302087786,1302088686,1,1,900
32782751@N07,4076,22,1302156770,1302157370,1,1,600
32783047@N07,4077,26,1427014018,1427014918,1,1,900
32783264@N08,4078,16,1437097142,1437097412,2,3,270
32783264@N08,4078,4,1437098430,1437098531,2,3,101
32783264@N08,4078,7,1437098626,1437098806,1,3,180
32814878@N00,4079,28,1353241215,1353242115,1,1,900
32814878@N00,4080,28,1353301191,1353302091,1,1,900
32823446@N00,4081,1,1300576288,1300576348,2,4,60
32823446@N00,4081,16,1300582157,1300582427,2,4,270
32823446@N00,4081,17,1300589494,1300589794,2,4,300
32823446@N00,4081,30,1300599704,1300600784,1,4,1080
32823446@N00,4082,16,1301031733,1301032003,2,1,270
32823446@N00,4083,1,1364677030,1364677090,2,3,60
32823446@N00,4083,26,1364684097,1364684997,2,3,900
32823446@N00,4083,14,1364688161,1364688401,1,3,240
32823446@N00,4084,21,1450484390,1450484795,2,3,405
32823446@N00,4084,8,1450484795,1450484975,2,3,180
32823446@N00,4084,31,1450501409,1450502909,1,3,1500
32823446@N00,4085,1,1450662254,1450662314,1,1,60
32835156@N00,4086,26,1260250117,1260251017,5,1,900
32835156@N00,4087,28,1260325126,1260326026,1,1,900
32835156@N00,4088,16,1260506983,1260507043,2,2,60
32835156@N00,4088,15,1260507043,1260507313,1,2,270
32835156@N00,4089,20,1408247774,1408247806,2,2,32
32835156@N00,4089,22,1408247806,1408248406,1,2,600
32835156@N00,4090,28,1408325719,1408326619,1,1,900
32835156@N00,4091,16,1408492091,1408492361,2,4,270
32835156@N00,4091,26,1408498475,1408498504,3,4,29
32835156@N00,4091,16,1408498504,1408498520,2,4,16
32835156@N00,4091,26,1408498520,1408499420,4,4,900
32835156@N00,4092,5,1408573274,1408573394,2,2,120
32835156@N00,4092,29,1408577905,1408578805,5,2,900
32841500@N05,4093,1,1402640517,1402640577,5,2,60
32841500@N05,4093,26,1402667978,1402668878,1,2,900
32841500@N05,4094,23,1402903081,1402903193,2,3,112
32841500@N05,4094,14,1402903193,1402903316,2,3,123
32841500@N05,4094,19,1402903316,1402903856,6,3,540
32841500@N05,4095,19,1402978259,1402978799,1,1,540
32853736@N08,4096,22,1277136462,1277137062,1,1,600
32917595@N00,4097,27,1303078817,1303079717,2,8,900
32917595@N00,4097,8,1303083593,1303083773,2,8,180
32917595@N00,4097,5,1303085257,1303085377,2,8,120
32917595@N00,4097,30,1303087657,1303088737,2,8,1080
32917595@N00,4097,29,1303093234,1303094134,2,8,900
32917595@N00,4097,27,1303097558,1303098458,2,8,900
32917595@N00,4097,1,1303102758,1303102818,2,8,60
32917595@N00,4097,30,1303124031,1303125111,1,8,1080
32917595@N00,4098,7,1303167683,1303167863,2,2,180
32917595@N00,4098,1,1303191011,1303191071,1,2,60
32927192@N00,4099,28,1223073596,1223074496,2,7,900
32927192@N00,4099,12,1223075140,1223075380,2,7,240
32927192@N00,4099,24,1223076673,1223076685,2,7,12
32927192@N00,4099,12,1223076685,1223076925,2,7,240
32927192@N00,4099,26,1223078246,1223079146,3,7,900
32927192@N00,4099,29,1223080457,1223081357,6,7,900
32927192@N00,4099,20,1223082351,1223082891,19,7,540
32927192@N00,4100,17,1223119288,1223119588,2,1,300
32932933@N00,4101,28,1361506281,1361507181,1,1,900
32932933@N00,4102,1,1387062110,1387062170,3,2,60
32932933@N00,4102,20,1387071145,1387071685,1,2,540
32932933@N00,4103,29,1387103088,1387103988,1,1,900
32941012@N08,4104,24,1417373242,1417374022,2,2,780
32941012@N08,4104,19,1417385728,1417386268,1,2,540
32955865@N04,4105,16,1327287292,1327287562,2,1,270
32975422@N06,4106,26,1356000096,1356000996,1,1,900
33005083@N00,4107,8,1316824888,1316825068,2,2,180
33005083@N00,4107,3,1316852271,1316852361,1,2,90
33005083@N00,4108,1,1328741409,1328741469,2,5,60
33005083@N00,4108,26,1328743137,1328744037,2,5,900
33005083@N00,4108,17,1328748859,1328748995,4,5,136
33005083@N00,4108,27,1328748995,1328749895,2,5,900
33005083@N00,4108,17,1328752847,1328753147,1,5,300
33005083@N00,4109,17,1370733739,1370734039,2,5,300
33005083@N00,4109,12,1370736430,1370736430,2,5,0
33005083@N00,4109,17,1370736430,1370736730,3,5,300
33005083@N00,4109,12,1370739946,1370740186,2,5,240
33005083@N00,4109,17,1370744698,1370744998,1,5,300
33022236@N05,4110,18,1445441595,1445442045,1,1,450
33063488@N02,4111,21,1260525377,1260525947,2,2,570
33063488@N02,4111,26,1260534964,1260535864,1,2,900
33063488@N02,4112,1,1281864522,1281864582,4,6,60
33063488@N02,4112,26,1281866749,1281867649,2,6,900
33063488@N02,4112,21,1281867930,1281868500,2,6,570
33063488@N02,4112,12,1281869160,1281869400,2,6,240
33063488@N02,4112,17,1281887444,1281887744,2,6,300
33063488@N02,4112,15,1281888706,1281888976,1,6,270
33063488@N02,4113,3,1281940061,1281940151,2,16,90
33063488@N02,4113,16,1281962540,1281962810,2,16,270
33063488@N02,4113,26,1281963184,1281964084,5,16,900
33063488@N02,4113,29,1281970195,1281971095,2,16,900
33063488@N02,4113,22,1281972064,1281972664,4,16,600
33063488@N02,4113,29,1281973045,1281973941,2,16,896
33063488@N02,4113,10,1281973941,1281974181,2,16,240
33063488@N02,4113,21,1281974678,1281974975,3,16,297
33063488@N02,4113,25,1281974975,1281975456,2,16,481
33063488@N02,4113,21,1281975456,1281975899,2,16,443
33063488@N02,4113,15,1281975899,1281976169,2,16,270
33063488@N02,4113,28,1281976434,1281976594,2,16,160
33063488@N02,4113,16,1281976594,1281976668,2,16,74
33063488@N02,4113,26,1281976668,1281977151,2,16,483
33063488@N02,4113,28,1281977151,1281977414,3,16,263
33063488@N02,4113,1,1281977414,1281977474,2,16,60
33063488@N02,4114,28,1282024267,1282025167,1,1,900
33063488@N02,4115,12,1294736226,1294736466,3,11,240
33063488@N02,4115,24,1294738701,1294739304,2,11,603
33063488@N02,4115,15,1294739304,1294739574,3,11,270
33063488@N02,4115,31,1294746568,1294748068,3,11,1500
33063488@N02,4115,11,1294748097,1294748337,2,11,240
33063488@N02,4115,7,1294748518,1294748698,3,11,180
33063488@N02,4115,6,1294749184,1294749304,2,11,120
33063488@N02,4115,26,1294749620,1294750135,2,11,515
33063488@N02,4115,28,1294750135,1294750848,4,11,713
33063488@N02,4115,18,1294750848,1294751298,2,11,450
33063488@N02,4115,1,1294751397,1294751457,1,11,60
33063488@N02,4116,29,1326360909,1326361809,2,3,900
33063488@N02,4116,22,1326362433,1326363033,2,3,600
33063488@N02,4116,26,1326367828,1326368728,2,3,900
33063488@N02,4117,26,1346424391,1346425291,1,1,900
33063488@N02,4118,26,1353232240,1353233140,1,1,900
33063488@N02,4119,16,1354099838,1354100108,3,2,270
33063488@N02,4119,28,1354101395,1354102295,2,2,900
33063488@N02,4120,26,1386227567,1386228467,1,1,900
33067733@N05,4121,28,1349522143,1349523043,1,1,900
33077451@N02,4122,28,1238280617,1238281517,2,3,900
33077451@N02,4122,29,1238283971,1238284871,2,3,900
33077451@N02,4122,28,1238289310,1238290210,1,3,900
33077451@N02,4123,20,1238394279,1238394819,1,1,540
33077451@N02,4124,11,1238465898,1238466138,3,3,240
33077451@N02,4124,20,1238479932,1238480472,2,3,540
33077451@N02,4124,29,1238484316,1238485216,2,3,900
33077451@N02,4125,28,1238541209,1238542109,2,5,900
33077451@N02,4125,18,1238551579,1238552029,2,5,450
33077451@N02,4125,1,1238560257,1238560317,2,5,60
33077451@N02,4125,28,1238568645,1238569545,2,5,900
33077451@N02,4125,23,1238575395,1238575995,1,5,600
33077451@N02,4126,28,1238631633,1238632533,2,4,900
33077451@N02,4126,29,1238634396,1238635296,3,4,900
33077451@N02,4126,11,1238644125,1238644365,2,4,240
33077451@N02,4126,23,1238646552,1238647152,1,4,600
33077451@N02,4127,28,1240464349,1240465249,1,1,900
33124345@N07,4128,26,1226231441,1226232341,1,1,900
33149991@N00,4129,30,1305967489,1305968569,1,1,1080
33176557@N06,4130,18,1444881607,1444882057,1,1,450
33207205@N00,4131,12,1255739535,1255739775,2,2,240
33207205@N00,4131,28,1255760572,1255761472,2,2,900
33207205@N00,4132,29,1265167422,1265168322,1,1,900
33207205@N00,4133,27,1265238534,1265239434,1,1,900
33207205@N00,4134,21,1271916470,1271917040,1,1,570
33207205@N00,4135,29,1275280205,1275281105,1,1,900
33207205@N00,4136,1,1280576498,1280576558,2,2,60
33207205@N00,4136,27,1280584744,1280585644,1,2,900
33207205@N00,4137,26,1285899570,1285900444,2,2,874
33207205@N00,4137,29,1285900444,1285901344,3,2,900
33207205@N00,4138,28,1289096715,1289097615,1,1,900
33207205@N00,4139,17,1292649578,1292649878,1,1,300
33207205@N00,4140,27,1305846830,1305847730,1,1,900
33207205@N00,4141,3,1317365872,1317365962,1,1,90
33207205@N00,4142,19,1317462464,1317463004,1,1,540
33207205@N00,4143,16,1317550540,1317550810,1,1,270
33212119@N00,4144,15,1301047743,1301048013,1,1,270
33213804@N04,4145,20,1354862311,1354862851,3,4,540
33213804@N04,4145,16,1354872478,1354872748,2,4,270
33213804@N04,4145,12,1354876820,1354877060,2,4,240
33213804@N04,4145,18,1354883666,1354884116,1,4,450
33213804@N04,4146,21,1354938122,1354938124,2,4,2
33213804@N04,4146,26,1354938124,1354939024,2,4,900
33213804@N04,4146,21,1354940003,1354940573,2,4,570
33213804@N04,4146,28,1354945377,1354946277,1,4,900
33213804@N04,4147,26,1370226337,1370227237,1,1,900
33213804@N04,4148,28,1373622906,1373623806,1,1,900
33213804@N04,4149,29,1373948559,1373949459,1,1,900
33213804@N04,4150,30,1401613273,1401614353,3,1,1080
33213804@N04,4151,7,1401763685,1401763865,1,1,180
33213804@N04,4152,12,1404726625,1404726865,2,2,240
33213804@N04,4152,17,1404730947,1404731247,1,2,300
33213804@N04,4153,30,1462582610,1462583690,3,4,1080
33213804@N04,4153,31,1462584505,1462584513,2,4,8
33213804@N04,4153,20,1462584513,1462585053,3,4,540
33213804@N04,4153,29,1462586136,1462587036,1,4,900
33213804@N04,4154,27,1462664802,1462665702,2,18,900
33213804@N04,4154,16,1462667098,1462667368,3,18,270
33213804@N04,4154,15,1462668643,1462668913,4,18,270
33213804@N04,4154,3,1462669146,1462669236,3,18,90
33213804@N04,4154,15,1462670843,1462671113,3,18,270
33213804@N04,4154,7,1462671214,1462671394,3,18,180
33213804@N04,4154,17,1462672436,1462672736,2,18,300
33213804@N04,4154,28,1462673693,1462674593,4,18,900
33213804@N04,4154,6,1462676473,1462676593,3,18,120
33213804@N04,4154,11,1462679782,1462680022,4,18,240
33213804@N04,4154,7,1462681963,1462681964,2,18,1
33213804@N04,4154,9,1462681964,1462682144,3,18,180
33213804@N04,4154,12,1462686921,1462687161,2,18,240
33213804@N04,4154,5,1462689459,1462689579,3,18,120
33213804@N04,4154,6,1462692100,1462692220,2,18,120
33213804@N04,4154,29,1462696858,1462697758,2,18,900
33213804@N04,4154,30,1462698407,1462699487,3,18,1080
33213804@N04,4154,23,1462707066,1462707666,1,18,600
33213804@N04,4155,16,1462750302,1462750321,2,3,19
33213804@N04,4155,27,1462750321,1462751221,2,3,900
33213804@N04,4155,20,1462754883,1462755423,3,3,540
33227061@N08,4156,18,1406955539,1406955989,2,2,450
33227061@N08,4156,26,1406961965,1406962865,2,2,900
33234549@N02,4157,28,1325748260,1325749160,2,1,900
33234549@N02,4158,28,1325807003,1325807903,2,1,900
33234549@N02,4159,30,1325847382,1325848462,1,1,1080
33234549@N02,4160,26,1325895543,1325896443,1,1,900
33254284@N02,4161,19,1402795220,1402795760,1,1,540
33274024@N04,4162,21,1255571049,1255571050,2,3,1
33274024@N04,4162,26,1255571050,1255571051,2,3,1
33274024@N04,4162,18,1255571051,1255571501,1,3,450
33295748@N00,4163,30,1263913745,1263914825,1,1,1080
33295748@N00,4164,30,1263952923,1263954003,12,1,1080
33308929@N04,4165,26,1232835408,1232836308,6,3,900
33308929@N04,4165,14,1232869442,1232869682,2,3,240
33308929@N04,4165,26,1232870277,1232871177,5,3,900
33308929@N04,4166,26,1235725405,1235726305,4,1,900
33308929@N04,4167,26,1235799526,1235800426,5,1,900
33308929@N04,4168,14,1237682435,1237682675,3,1,240
33308929@N04,4169,26,1251503416,1251504316,7,1,900
33308929@N04,4170,26,1256298917,1256299817,1,1,900
33308929@N04,4171,26,1260095356,1260096256,9,1,900
33308929@N04,4172,26,1280144314,1280145214,6,1,900
33308929@N04,4173,26,1283852125,1283853025,1,1,900
33308929@N04,4174,26,1287799548,1287800448,7,1,900
33308929@N04,4175,26,1295151359,1295152259,2,1,900
33308929@N04,4176,22,1312683199,1312683799,1,1,600
33308929@N04,4177,26,1319285499,1319286399,10,1,900
33308929@N04,4178,26,1323430312,1323431212,1,1,900
33308929@N04,4179,26,1324974961,1324975861,3,1,900
33308929@N04,4180,28,1327223914,1327224814,5,2,900
33308929@N04,4180,8,1327229146,1327229326,9,2,180
33308929@N04,4181,1,1327282836,1327282896,1,1,60
33308929@N04,4182,26,1328353250,1328354150,1,1,900
33308929@N04,4183,10,1331447143,1331447383,3,2,240
33308929@N04,4183,26,1331457955,1331458855,6,2,900
33308929@N04,4184,6,1331528385,1331528505,1,1,120
33308929@N04,4185,12,1331956968,1331957085,2,4,117
33308929@N04,4185,21,1331957085,1331957205,2,4,120
33308929@N04,4185,7,1331957205,1331957385,2,4,180
33308929@N04,4185,10,1331960201,1331960441,2,4,240
33308929@N04,4186,10,1332031294,1332031534,1,1,240
33308929@N04,4187,27,1333850277,1333851047,2,3,770
33308929@N04,4187,26,1333851047,1333851757,2,3,710
33308929@N04,4187,31,1333851757,1333853257,1,3,1500
33308929@N04,4188,17,1339846914,1339847214,1,1,300
33308929@N04,4189,28,1339978917,1339979817,1,1,900
33308929@N04,4190,26,1342784760,1342785660,2,1,900
33308929@N04,4191,24,1342827489,1342828269,1,1,780
33308929@N04,4192,16,1347418737,1347419007,1,1,270
33308929@N04,4193,26,1348319527,1348320427,1,1,900
33308929@N04,4194,18,1350124420,1350124870,3,1,450
33308929@N04,4195,26,1350687497,1350687961,2,3,464
33308929@N04,4195,20,1350687961,1350688501,2,3,540
33308929@N04,4195,26,1350702423,1350703323,2,3,900
33308929@N04,4196,18,1359866027,1359866477,2,2,450
33308929@N04,4196,26,1359873705,1359874605,1,2,900
33308929@N04,4197,26,1386414756,1386415093,2,2,337
33308929@N04,4197,25,1386415093,1386415933,4,2,840
33308929@N04,4198,26,1456535245,1456536145,1,1,900
33312419@N07,4199,17,1363717152,1363717452,1,1,300
33312419@N07,4200,18,1363766480,1363766930,1,1,450
33312419@N07,4201,26,1363815674,1363816574,1,1,900
33313572@N02,4202,3,1240481874,1240481964,3,1,90
33349859@N00,4203,14,1395902541,1395902781,1,1,240
33356547@N02,4204,18,1299361164,1299361614,4,1,450
33356547@N02,4205,18,1299410080,1299410530,24,1,450
33420213@N06,4206,10,1264665886,1264666126,1,1,240
33439043@N06,4207,26,1247021994,1247022894,5,1,900
33444594@N02,4208,21,1314318684,1314319254,1,1,570
33445276@N03,4209,26,1197071483,1197072383,3,1,900
33472625@N07,4210,26,1356810675,1356811575,1,1,900
33509969@N08,4211,1,1364850640,1364850700,6,10,60
33509969@N08,4211,16,1364861784,1364861975,16,10,191
33509969@N08,4211,28,1364861975,1364862062,10,10,87
33509969@N08,4211,16,1364862062,1364862332,19,10,270
33509969@N08,4211,13,1364869873,1364870113,7,10,240
33509969@N08,4211,6,1364876689,1364876809,4,10,120
33509969@N08,4211,26,1364877949,1364878849,16,10,900
33509969@N08,4211,10,1364879027,1364879088,4,10,61
33509969@N08,4211,26,1364879088,1364879988,7,10,900
33509969@N08,4211,27,1364886582,1364887482,3,10,900
33509969@N08,4212,26,1364954767,1364955667,28,2,900
33509969@N08,4212,29,1364957385,1364958285,12,2,900
33509969@N08,4213,22,1365035223,1365035407,7,2,184
33509969@N08,4213,31,1365035407,1365036907,20,2,1500
33516396@N06,4214,20,1318808038,1318808578,7,2,540
33516396@N06,4214,25,1318825604,1318826444,2,2,840
33516396@N06,4215,20,1318888357,1318888897,4,2,540
33516396@N06,4215,19,1318889654,1318890194,1,2,540
33516396@N06,4216,28,1318920689,1318921130,4,3,441
33516396@N06,4216,26,1318921130,1318922030,3,3,900
33516396@N06,4216,30,1318922478,1318923558,1,3,1080
33537150@N06,4217,26,1310127212,1310128112,1,1,900
33547445@N04,4218,28,1246876610,1246877510,1,1,900
33547445@N04,4219,28,1261973721,1261974621,1,1,900
33587686@N07,4220,16,1304329428,1304329698,1,1,270
33591736@N08,4221,28,1353979431,1353980331,1,1,900
33620268@N07,4222,16,1260182318,1260182588,2,1,270
33620268@N07,4223,15,1324478892,1324479162,1,1,270
33658269@N00,4224,18,1449758446,1449758896,1,1,450
33745480@N05,4225,25,1420532489,1420533329,1,1,840
33753067@N04,4226,26,1411133150,1411134050,3,1,900
33791276@N06,4227,7,1230728400,1230728580,1,1,180
33803664@N06,4228,14,1253829231,1253829471,2,28,240
33803664@N06,4228,1,1253831949,1253832009,3,28,60
33803664@N06,4228,29,1253835033,1253835933,5,28,900
33803664@N06,4228,22,1253837406,1253837867,3,28,461
33803664@N06,4228,29,1253837867,1253838767,2,28,900
33803664@N06,4228,28,1253841390,1253841479,3,28,89
33803664@N06,4228,16,1253841479,1253841605,2,28,126
33803664@N06,4228,24,1253841605,1253842090,2,28,485
33803664@N06,4228,15,1253842090,1253842360,3,28,270
33803664@N06,4228,28,1253843439,1253844339,6,28,900
33803664@N06,4228,1,1253851735,1253851795,10,28,60
33803664@N06,4228,15,1253852551,1253852821,2,28,270
33803664@N06,4228,28,1253854040,1253854567,6,28,527
33803664@N06,4228,26,1253854567,1253854864,4,28,297
33803664@N06,4228,13,1253854864,1253855104,2,28,240
33803664@N06,4228,26,1253855858,1253856758,3,28,900
33803664@N06,4228,15,1253858895,1253859052,2,28,157
33803664@N06,4228,24,1253859052,1253859832,2,28,780
33803664@N06,4228,13,1253861187,1253861427,3,28,240
33803664@N06,4228,11,1253861472,1253861535,2,28,63
33803664@N06,4228,13,1253861535,1253861775,2,28,240
33803664@N06,4228,11,1253862593,1253862786,2,28,193
33803664@N06,4228,13,1253862786,1253863026,3,28,240
33803664@N06,4228,24,1253865079,1253865859,3,28,780
33803664@N06,4228,28,1253867318,1253868218,2,28,900
33803664@N06,4228,24,1253874458,1253875238,5,28,780
33803664@N06,4228,28,1253876561,1253877461,2,28,900
33803664@N06,4228,22,1253879983,1253880583,2,28,600
33803664@N06,4229,28,1253999186,1253999585,4,5,399
33803664@N06,4229,24,1253999585,1254000365,3,5,780
33803664@N06,4229,29,1254006894,1254007055,2,5,161
33803664@N06,4229,22,1254007055,1254007655,5,5,600
33803664@N06,4229,28,1254009953,1254010853,1,5,900
33803664@N06,4230,28,1254040596,1254041496,1,1,900
33813043@N00,4231,26,1250226244,1250227144,59,1,900
33813043@N00,4232,26,1342433311,1342434211,29,1,900
33813043@N00,4233,26,1437265780,1437266680,39,3,900
33813043@N00,4233,30,1437307710,1437308790,5,3,1080
33813043@N00,4233,26,1437310002,1437310902,4,3,900
33823100@N00,4234,16,1353379873,1353380143,2,7,270
33823100@N00,4234,26,1353382248,1353383148,2,7,900
33823100@N00,4234,11,1353403787,1353404027,2,7,240
33823100@N00,4234,17,1353414506,1353414735,2,7,229
33823100@N00,4234,28,1353414735,1353415177,3,7,442
33823100@N00,4234,27,1353415177,1353415227,2,7,50
33823100@N00,4234,28,1353415227,1353416127,1,7,900
33823100@N00,4235,16,1370844382,1370844470,2,7,88
33823100@N00,4235,1,1370844470,1370844530,2,7,60
33823100@N00,4235,30,1370844605,1370845685,2,7,1080
33823100@N00,4235,26,1370846181,1370847081,3,7,900
33823100@N00,4235,15,1370854641,1370854911,2,7,270
33823100@N00,4235,14,1370857740,1370857980,2,7,240
33823100@N00,4235,1,1370866128,1370866188,1,7,60
33823100@N00,4236,1,1383020467,1383020527,3,3,60
33823100@N00,4236,20,1383029887,1383030016,3,3,129
33823100@N00,4236,11,1383030016,1383030256,1,3,240
33823100@N00,4237,24,1383193636,1383193756,3,5,120
33823100@N00,4237,12,1383193756,1383193865,2,5,109
33823100@N00,4237,24,1383193865,1383194645,3,5,780
33823100@N00,4237,20,1383216398,1383216655,2,5,257
33823100@N00,4237,1,1383216655,1383216715,1,5,60
33823100@N00,4238,1,1383305487,1383305547,1,1,60
33823100@N00,4239,1,1387856193,1387856253,1,1,60
33823100@N00,4240,18,1421914656,1421915106,1,1,450
33843414@N02,4241,26,1260005905,1260006805,1,1,900
33873368@N00,4242,24,1361671576,1361672356,1,1,780
33876889@N05,4243,1,1393230361,1393230421,1,1,60
33884092@N04,4244,22,1276331556,1276332156,1,1,600
33884801@N02,4245,27,1358855129,1358856029,2,2,900
33884801@N02,4245,24,1358876866,1358877646,1,2,780
33888060@N00,4246,18,1441532160,1441532610,1,1,450
33896813@N03,4247,10,1278845007,1278845247,2,1,240
33959358@N05,4248,17,1298781554,1298781854,1,1,300
33959358@N05,4249,26,1306229234,1306230134,1,1,900
33959358@N05,4250,3,1306838622,1306838712,1,1,90
33959358@N05,4251,29,1307239468,1307240368,1,1,900
33959358@N05,4252,28,1338596815,1338597715,1,1,900
33959358@N05,4253,28,1338691229,1338692129,1,1,900
33959358@N05,4254,12,1346019706,1346019946,1,1,240
33959358@N05,4255,20,1348038849,1348039389,1,1,540
33959358@N05,4256,28,1348387597,1348388497,1,1,900
33959358@N05,4257,28,1349090193,1349091093,1,1,900
33959358@N05,4258,26,1353441659,1353442559,1,1,900
33959358@N05,4259,26,1359765677,1359766577,1,1,900
33959358@N05,4260,12,1359842478,1359842718,1,1,240
33959358@N05,4261,28,1361250324,1361251224,1,1,900
33999459@N06,4262,1,1367101321,1367101381,3,2,60
33999459@N06,4262,14,1367105311,1367105551,1,2,240
33999674@N02,4263,27,1307936714,1307937614,6,3,900
33999674@N02,4263,29,1307941243,1307942143,12,3,900
33999674@N02,4263,17,1307952259,1307952559,1,3,300
34008959@N02,4264,30,1245982977,1245984057,3,1,1080
34019920@N06,4265,26,1310365617,1310366517,1,1,900
34052289@N06,4266,28,1293501011,1293501911,1,1,900
34052289@N06,4267,27,1305623907,1305624807,1,1,900
34061516@N06,4268,20,1368088945,1368089485,1,1,540
34078107@N00,4269,1,1392441646,1392441706,1,1,60
34078107@N00,4270,18,1458206245,1458206695,1,1,450
34095068@N03,4271,4,1299551664,1299551765,3,1,101
34095068@N03,4272,28,1345702526,1345703426,1,1,900
34095068@N03,4273,28,1356663291,1356664191,1,1,900
34095068@N03,4274,28,1359366696,1359367596,1,1,900
34118276@N04,4275,28,1228454363,1228455105,2,4,742
34118276@N04,4275,16,1228455105,1228455375,2,4,270
34118276@N04,4275,26,1228467781,1228467990,2,4,209
34118276@N04,4275,28,1228467990,1228468890,1,4,900
34128007@N04,4276,1,1238200546,1238200606,3,23,60
34128007@N04,4276,26,1238200916,1238201816,3,23,900
34128007@N04,4276,31,1238202538,1238202839,2,23,301
34128007@N04,4276,30,1238202839,1238203859,4,23,1020
34128007@N04,4276,31,1238203859,1238205295,2,23,1436
34128007@N04,4276,22,1238205295,1238205895,4,23,600
34128007@N04,4276,31,1238207599,1238209099,2,23,1500
34128007@N04,4276,14,1238209446,1238209649,2,23,203
34128007@N04,4276,22,1238209649,1238209766,2,23,117
34128007@N04,4276,29,1238209766,1238210666,6,23,900
34128007@N04,4276,4,1238211998,1238212077,2,23,79
34128007@N04,4276,3,1238212077,1238212167,2,23,90
34128007@N04,4276,24,1238212391,1238213171,2,23,780
34128007@N04,4276,19,1238213265,1238213805,3,23,540
34128007@N04,4276,28,1238213817,1238214717,10,23,900
34128007@N04,4276,16,1238218270,1238218540,2,23,270
34128007@N04,4276,19,1238220017,1238220557,2,23,540
34128007@N04,4276,24,1238224168,1238224948,3,23,780
34128007@N04,4276,13,1238227464,1238227704,3,23,240
34128007@N04,4276,28,1238231363,1238231468,2,23,105
34128007@N04,4276,26,1238231468,1238232262,2,23,794
34128007@N04,4276,28,1238232262,1238233162,3,23,900
34128007@N04,4276,1,1238233198,1238233258,1,23,60
34128007@N04,4277,24,1284177079,1284177859,3,1,780
34131297@N02,4278,26,1291122000,1291122000,19,2,0
34131297@N02,4278,28,1291122000,1291122900,3,2,900
34154171@N00,4279,1,1310454707,1310454767,2,3,60
34154171@N00,4279,26,1310456334,1310457234,2,3,900
34154171@N00,4279,16,1310472682,1310472952,1,3,270
34154171@N00,4280,30,1311315632,1311316712,1,1,1080
34154171@N00,4281,13,1313726392,1313726632,1,1,240
34154171@N00,4282,17,1315727465,1315727765,1,1,300
34154171@N00,4283,28,1318681682,1318682582,1,1,900
34154171@N00,4284,20,1321012775,1321013315,1,1,540
34154171@N00,4285,31,1335937104,1335938604,1,1,1500
34154171@N00,4286,1,1337670828,1337670888,2,3,60
34154171@N00,4286,17,1337672815,1337673115,2,3,300
34154171@N00,4286,1,1337681862,1337681922,1,3,60
34154171@N00,4287,28,1338800672,1338801572,1,1,900
34154171@N00,4288,28,1339917036,1339917936,2,2,900
34154171@N00,4288,31,1339933227,1339934727,1,2,1500
34154171@N00,4289,28,1341567073,1341567973,1,1,900
34154171@N00,4290,28,1346995364,1346996264,1,1,900
34154171@N00,4291,28,1347772592,1347773492,1,1,900
34154171@N00,4292,28,1349444519,1349445419,1,1,900
34168709@N00,4293,28,1232314590,1232315490,2,4,900
34168709@N00,4293,23,1232328635,1232328861,2,4,226
34168709@N00,4293,29,1232328861,1232329761,2,4,900
34168709@N00,4293,27,1232330267,1232331167,1,4,900
34168709@N00,4294,29,1232768282,1232769182,3,11,900
34168709@N00,4294,14,1232770462,1232770702,4,11,240
34168709@N00,4294,29,1232771496,1232772111,2,11,615
34168709@N00,4294,16,1232772111,1232772303,2,11,192
34168709@N00,4294,26,1232772303,1232773203,2,11,900
34168709@N00,4294,12,1232774931,1232775138,3,11,207
34168709@N00,4294,26,1232775138,1232776038,2,11,900
34168709@N00,4294,3,1232787467,1232787557,5,11,90
34168709@N00,4294,7,1232789367,1232789547,2,11,180
34168709@N00,4294,26,1232789699,1232790599,2,11,900
34168709@N00,4294,19,1232791555,1232792095,1,11,540
34168709@N00,4295,27,1232973026,1232973572,2,2,546
34168709@N00,4295,7,1232973572,1232973752,1,2,180
34168709@N00,4296,26,1244975681,1244976581,9,4,900
34168709@N00,4296,29,1244982825,1244983725,13,4,900
34168709@N00,4296,26,1244985459,1244985971,3,4,512
34168709@N00,4296,25,1244985971,1244986811,2,4,840
34168709@N00,4297,1,1245416865,1245416873,2,16,8
34168709@N00,4297,12,1245416873,1245416897,4,16,24
34168709@N00,4297,15,1245416897,1245416905,2,16,8
34168709@N00,4297,12,1245416905,1245416912,2,16,7
34168709@N00,4297,26,1245416912,1245416917,2,16,5
34168709@N00,4297,22,1245416917,1245416924,2,16,7
34168709@N00,4297,31,1245416924,1245416932,2,16,8
34168709@N00,4297,30,1245416932,1245416999,9,16,67
34168709@N00,4297,15,1245416999,1245417018,4,16,19
34168709@N00,4297,26,1245417018,1245417024,2,16,6
34168709@N00,4297,6,1245417024,1245417031,2,16,7
34168709@N00,4297,12,1245417031,1245417044,3,16,13
34168709@N00,4297,26,1245417044,1245417050,2,16,6
34168709@N00,4297,19,1245417050,1245417058,2,16,8
34168709@N00,4297,26,1245417058,1245417065,2,16,7
34168709@N00,4297,28,1245417065,1245417965,1,16,900
34168709@N00,4298,28,1246340764,1246341664,2,1,900
34168709@N00,4299,29,1262517551,1262518451,4,1,900
34168709@N00,4300,1,1279076732,1279076792,2,6,60
34168709@N00,4300,28,1279076795,1279077695,2,6,900
34168709@N00,4300,12,1279080307,1279080547,4,6,240
34168709@N00,4300,27,1279082618,1279083518,6,6,900
34168709@N00,4300,29,1279091324,1279091514,2,6,190
34168709@N00,4300,30,1279091514,1279092594,2,6,1080
34180475@N06,4301,18,1416048335,1416048785,2,1,450
34183523@N00,4302,26,1355313473,1355314373,1,1,900
34190461@N04,4303,29,1237968877,1237969777,3,5,900
34190461@N04,4303,30,1237973426,1237973991,3,5,565
34190461@N04,4303,29,1237973991,1237974891,3,5,900
34190461@N04,4303,26,1237978336,1237979236,3,5,900
34190461@N04,4303,28,1237986536,1237987436,1,5,900
34194745@N06,4304,15,1376214473,1376214743,2,1,270
34204052@N00,4305,18,1420765645,1420766095,2,2,450
34204052@N00,4305,20,1420783144,1420783684,2,2,540
34204052@N00,4306,18,1420851092,1420851201,2,2,109
34204052@N00,4306,15,1420851201,1420851471,1,2,270
34207923@N02,4307,28,1325901486,1325902386,1,1,900
34207923@N02,4308,26,1326514508,1326515408,1,1,900
34207923@N02,4309,12,1336779489,1336779587,5,8,98
34207923@N02,4309,21,1336779587,1336779588,2,8,1
34207923@N02,4309,3,1336779588,1336779594,4,8,6
34207923@N02,4309,12,1336779594,1336779834,4,8,240
34207923@N02,4309,26,1336779906,1336780806,2,8,900
34207923@N02,4309,21,1336782029,1336782599,7,8,570
34207923@N02,4309,26,1336782649,1336783549,10,8,900
34207923@N02,4309,28,1336786275,1336787175,8,8,900
34207923@N02,4310,30,1359165185,1359165381,3,8,196
34207923@N02,4310,26,1359165381,1359166062,14,8,681
34207923@N02,4310,29,1359166062,1359166962,24,8,900
34207923@N02,4310,30,1359168451,1359169528,8,8,1077
34207923@N02,4310,29,1359169528,1359169704,14,8,176
34207923@N02,4310,31,1359169704,1359170395,11,8,691
34207923@N02,4310,30,1359170395,1359171475,31,8,1080
34207923@N02,4310,26,1359171552,1359172452,1,8,900
34207923@N02,4311,1,1388441603,1388441663,7,8,60
34207923@N02,4311,28,1388441776,1388441842,6,8,66
34207923@N02,4311,26,1388441842,1388442742,7,8,900
34207923@N02,4311,30,1388447434,1388447591,13,8,157
34207923@N02,4311,31,1388447591,1388447739,7,8,148
34207923@N02,4311,22,1388447739,1388448339,18,8,600
34207923@N02,4311,9,1388451610,1388451790,2,8,180
34207923@N02,4311,26,1388451908,1388452808,1,8,900
34207923@N02,4312,28,1438421802,1438422702,1,1,900
34240084@N05,4313,26,1262517523,1262518423,1,1,900
34240084@N05,4314,24,1268298096,1268298876,1,1,780
34240084@N05,4315,26,1290388574,1290389474,1,1,900
34240084@N05,4316,7,1340550145,1340550325,1,1,180
34240084@N05,4317,28,1355650120,1355651020,1,1,900
34240084@N05,4318,26,1362784906,1362785806,1,1,900
34248408@N03,4319,17,1310838142,1310838442,2,1,300
34249366@N03,4320,28,1345104976,1345105876,2,1,900
34270790@N07,4321,1,1373769781,1373769841,2,3,60
34270790@N07,4321,29,1373785996,1373786896,2,3,900
34270790@N07,4321,14,1373787580,1373787820,1,3,240
34320594@N07,4322,3,1232782771,1232782861,1,1,90
34342819@N07,4323,26,1230031839,1230032739,1,1,900
34359597@N00,4324,25,1323846183,1323847023,1,1,840
34361471@N02,4325,26,1327212993,1327213893,1,1,900
34366518@N00,4326,13,1293505121,1293505361,1,1,240
34379501@N00,4327,26,1383399442,1383400342,1,1,900
34379501@N00,4328,29,1434785591,1434786491,1,1,900
34390084@N07,4329,1,1207835870,1207835930,2,2,60
34390084@N07,4329,23,1207840478,1207841078,1,2,600
34390084@N07,4330,30,1208041384,1208042464,2,4,1080
34390084@N07,4330,31,1208048036,1208049261,6,4,1225
34390084@N07,4330,29,1208049261,1208050161,2,4,900
34390084@N07,4330,26,1208053355,1208054255,1,4,900
34390084@N07,4331,28,1208093640,1208094415,5,7,775
34390084@N07,4331,26,1208094415,1208094790,3,7,375
34390084@N07,4331,6,1208094790,1208094910,3,7,120
34390084@N07,4331,20,1208104143,1208104683,2,7,540
34390084@N07,4331,16,1208105270,1208105540,2,7,270
34390084@N07,4331,28,1208108583,1208109409,2,7,826
34390084@N07,4331,1,1208109409,1208109469,1,7,60
34390084@N07,4332,24,1228408229,1228409009,2,3,780
34390084@N07,4332,13,1228428793,1228429033,3,3,240
34390084@N07,4332,21,1228430776,1228431346,1,3,570
34390084@N07,4333,28,1228606205,1228607105,6,2,900
34390084@N07,4333,18,1228613854,1228614304,2,2,450
34390084@N07,4334,28,1228671366,1228672266,2,2,900
34390084@N07,4334,12,1228684518,1228684758,1,2,240
34390084@N07,4335,22,1233151199,1233151799,2,4,600
34390084@N07,4335,31,1233152374,1233153070,2,4,696
34390084@N07,4335,26,1233153070,1233153970,2,4,900
34390084@N07,4335,28,1233156015,1233156915,1,4,900
34390084@N07,4336,26,1241879074,1241879974,4,4,900
34390084@N07,4336,25,1241880554,1241881295,2,4,741
34390084@N07,4336,3,1241881295,1241881385,2,4,90
34390084@N07,4336,30,1241882191,1241883271,1,4,1080
34390084@N07,4337,28,1242101345,1242102245,2,2,900
34390084@N07,4337,26,1242102995,1242103895,1,2,900
34390084@N07,4338,28,1260099656,1260100556,6,1,900
34426369@N06,4339,7,1385458689,1385458869,1,1,180
34426369@N06,4340,1,1394529404,1394529464,1,1,60
34428567@N02,4341,1,1238319051,1238319111,1,1,60
34444521@N03,4342,15,1339203544,1339203814,2,10,270
34444521@N03,4342,19,1339203946,1339204486,12,10,540
34444521@N03,4342,15,1339209815,1339210085,2,10,270
34444521@N03,4342,19,1339210479,1339211019,9,10,540
34444521@N03,4342,29,1339216951,1339217851,2,10,900
34444521@N03,4342,19,1339217951,1339217965,2,10,14
34444521@N03,4342,29,1339217965,1339218036,2,10,71
34444521@N03,4342,19,1339218036,1339218234,3,10,198
34444521@N03,4342,29,1339218234,1339218327,2,10,93
34444521@N03,4342,19,1339218327,1339218867,56,10,540
34444521@N03,4343,16,1339297422,1339297692,3,8,270
34444521@N03,4343,19,1339298388,1339298401,2,8,13
34444521@N03,4343,16,1339298401,1339298671,2,8,270
34444521@N03,4343,19,1339300888,1339301428,5,8,540
34444521@N03,4343,29,1339301469,1339302369,2,8,900
34444521@N03,4343,19,1339303138,1339303678,13,8,540
34444521@N03,4343,29,1339323370,1339324270,2,8,900
34444521@N03,4343,25,1339331710,1339332550,4,8,840
34444521@N03,4344,19,1339380199,1339380739,32,1,540
34453007@N00,4345,7,1268463407,1268463587,1,1,180
34453007@N00,4346,30,1323233313,1323234393,1,1,1080
34457978@N00,4347,28,1221442786,1221443686,3,1,900
34459091@N07,4348,31,1335596722,1335598222,1,1,1500
34468249@N06,4349,1,1366882322,1366882382,1,1,60
34469598@N00,4350,16,1278591323,1278591593,1,1,270
34475966@N02,4351,1,1367804604,1367804630,3,9,26
34475966@N02,4351,28,1367804630,1367805530,4,9,900
34475966@N02,4351,20,1367807389,1367807929,2,9,540
34475966@N02,4351,31,1367812577,1367812984,3,9,407
34475966@N02,4351,26,1367812984,1367813884,2,9,900
34475966@N02,4351,18,1367826481,1367826931,3,9,450
34475966@N02,4351,28,1367829777,1367830225,2,9,448
34475966@N02,4351,1,1367830225,1367830285,2,9,60
34475966@N02,4351,28,1367831974,1367832874,1,9,900
34478296@N07,4352,28,1347157856,1347158756,1,1,900
34505603@N02,4353,28,1306075794,1306076694,6,1,900
34505603@N02,4354,28,1308455130,1308456030,2,1,900
34540702@N06,4355,21,1354672626,1354673196,1,1,570
34561876@N07,4356,1,1338811745,1338811805,1,1,60
34572651@N00,4357,25,1291947767,1291948607,1,1,840
34576019@N02,4358,26,1245273404,1245274304,3,2,900
34576019@N02,4358,18,1245287511,1245287961,1,2,450
34583114@N03,4359,11,1248517544,1248517784,2,1,240
34588263@N00,4360,29,1201921112,1201922012,11,1,900
34649366@N06,4361,26,1290597783,1290598683,2,2,900
34649366@N06,4361,28,1290600170,1290601070,2,2,900
34649366@N06,4362,24,1291370042,1291370822,2,3,780
34649366@N06,4362,16,1291372660,1291372930,3,3,270
34649366@N06,4362,26,1291373761,1291374661,1,3,900
34681290@N00,4363,1,1448588013,1448588073,4,16,60
34681290@N00,4363,28,1448588420,1448589320,2,16,900
34681290@N00,4363,16,1448593091,1448593361,3,16,270
34681290@N00,4363,17,1448597104,1448597404,2,16,300
34681290@N00,4363,27,1448599570,1448599596,3,16,26
34681290@N00,4363,17,1448599596,1448599661,2,16,65
34681290@N00,4363,27,1448599661,1448600561,4,16,900
34681290@N00,4363,12,1448602505,1448602745,2,16,240
34681290@N00,4363,11,1448608057,1448608297,2,16,240
34681290@N00,4363,30,1448609880,1448610475,5,16,595
34681290@N00,4363,10,1448610475,1448610659,3,16,184
34681290@N00,4363,30,1448610659,1448611739,6,16,1080
34681290@N00,4363,29,1448612289,1448612576,3,16,287
34681290@N00,4363,31,1448612576,1448614076,2,16,1500
34681290@N00,4363,28,1448626725,1448627489,3,16,764
34681290@N00,4363,1,1448627489,1448627549,2,16,60
34729147@N00,4364,22,1358492708,1358493308,1,1,600
34754162@N00,4365,28,1260619579,1260620479,8,1,900
34794168@N00,4366,18,1242439664,1242440114,5,1,450
34849589@N03,4367,28,1262222715,1262223615,4,5,900
34849589@N03,4367,29,1262227891,1262228791,4,5,900
34849589@N03,4367,31,1262229439,1262230939,2,5,1500
34849589@N03,4367,8,1262239034,1262239214,4,5,180
34849589@N03,4367,28,1262255664,1262256564,8,5,900
34864673@N08,4368,26,1299235362,1299236262,1,1,900
34864673@N08,4369,23,1324116427,1324117027,1,1,600
34875170@N06,4370,28,1235625284,1235626184,9,1,900
34899062@N05,4371,8,1337504936,1337505116,1,1,180
34899062@N05,4372,30,1337571605,1337572685,2,4,1080
34899062@N05,4372,16,1337581061,1337581331,2,4,270
34899062@N05,4372,17,1337587913,1337588213,2,4,300
34899062@N05,4372,28,1337600319,1337601219,1,4,900
34899062@N05,4373,20,1348991914,1348992454,2,3,540
34899062@N05,4373,29,1348998869,1348999769,2,3,900
34899062@N05,4373,14,1349011962,1349012202,1,3,240
34899062@N05,4374,27,1366860548,1366861448,1,1,900
34899062@N05,4375,30,1383887622,1383888702,2,2,1080
34899062@N05,4375,27,1383890526,1383891426,1,2,900
34899062@N05,4376,12,1390883758,1390883998,1,1,240
34899062@N05,4377,29,1406326335,1406327235,1,1,900
34935493@N04,4378,6,1307329605,1307329725,2,2,120
34935493@N04,4378,16,1307333083,1307333353,1,2,270
34935493@N04,4379,30,1308214239,1308215319,1,1,1080
34938885@N08,4380,1,1383973386,1383973446,3,1,60
34964115@N00,4381,4,1424649814,1424649915,2,2,101
34964115@N00,4381,15,1424659003,1424659273,1,2,270
35002274@N02,4382,8,1236415756,1236415936,1,1,180
35016968@N07,4383,26,1233886035,1233886935,1,1,900
35034346886@N01,4384,24,1451728058,1451728838,1,1,780
35034347347@N01,4385,29,1247206724,1247207624,2,3,900
35034347347@N01,4385,24,1247210567,1247211347,2,3,780
35034347347@N01,4385,29,1247222447,1247223347,1,3,900
35034347782@N01,4386,28,1367822771,1367822779,2,2,8
35034347782@N01,4386,27,1367822779,1367823679,1,2,900
35034348340@N01,4387,28,1333368829,1333369729,1,1,900
35068332@N00,4388,27,1200186078,1200186978,3,1,900
35068332@N00,4389,27,1213395842,1213396742,3,1,900
35068332@N00,4390,15,1309952408,1309952678,4,1,270
35068332@N00,4391,27,1310031250,1310032150,1,1,900
35068332@N00,4392,15,1380854741,1380855011,2,3,270
35068332@N00,4392,29,1380861693,1380862593,2,3,900
35068332@N00,4392,18,1380879164,1380879614,1,3,450
35068332@N00,4393,29,1380962841,1380963741,1,1,900
35085650@N00,4394,17,1279377558,1279377858,1,1,300
35085650@N00,4395,17,1279421912,1279422212,3,1,300
35125112@N02,4396,23,1238362848,1238363448,1,1,600
35136866@N03,4397,31,1429076911,1429078411,1,1,1500
35137530@N00,4398,23,1231066747,1231067347,1,1,600
35149878@N08,4399,26,1354418517,1354419417,1,1,900
35172613@N00,4400,28,1292397718,1292398618,26,1,900
35172613@N00,4401,26,1314773382,1314774146,4,2,764
35172613@N00,4401,7,1314774146,1314774326,1,2,180
35172613@N00,4402,31,1323156247,1323156844,2,5,597
35172613@N00,4402,21,1323156844,1323156891,2,5,47
35172613@N00,4402,25,1323156891,1323157002,2,5,111
35172613@N00,4402,21,1323157002,1323157572,3,5,570
35172613@N00,4402,25,1323157675,1323158515,2,5,840
35172613@N00,4403,20,1350267616,1350268156,2,7,540
35172613@N00,4403,26,1350273332,1350274232,3,7,900
35172613@N00,4403,21,1350276091,1350276661,3,7,570
35172613@N00,4403,11,1350276812,1350277052,2,7,240
35172613@N00,4403,29,1350277793,1350278693,2,7,900
35172613@N00,4403,11,1350280411,1350280651,2,7,240
35172613@N00,4403,29,1350282319,1350283219,1,7,900
35172613@N00,4404,26,1355198288,1355199188,3,5,900
35172613@N00,4404,13,1355199349,1355199589,2,5,240
35172613@N00,4404,7,1355199866,1355200013,3,5,147
35172613@N00,4404,11,1355200013,1355200253,2,5,240
35172613@N00,4404,29,1355210042,1355210942,5,5,900
35172613@N00,4405,30,1360410283,1360411363,1,1,1080
35172613@N00,4406,26,1362287404,1362288304,5,4,900
35172613@N00,4406,29,1362292057,1362292957,2,4,900
35172613@N00,4406,26,1362300289,1362300297,2,4,8
35172613@N00,4406,18,1362300297,1362300747,1,4,450
35172613@N00,4407,22,1411970371,1411970971,1,1,600
35176540@N05,4408,28,1371860493,1371861393,1,1,900
35176540@N05,4409,27,1371901855,1371902008,2,2,153
35176540@N05,4409,15,1371902008,1371902278,1,2,270
35181047@N04,4410,1,1283931461,1283931521,9,13,60
35181047@N04,4410,28,1283931920,1283932747,9,13,827
35181047@N04,4410,16,1283932747,1283933017,5,13,270
35181047@N04,4410,21,1283933703,1283933973,2,13,270
35181047@N04,4410,5,1283933973,1283934093,5,13,120
35181047@N04,4410,6,1283935141,1283935261,4,13,120
35181047@N04,4410,7,1283936083,1283936263,2,13,180
35181047@N04,4410,23,1283936833,1283937052,2,13,219
35181047@N04,4410,28,1283937052,1283937854,6,13,802
35181047@N04,4410,26,1283937854,1283938754,19,13,900
35181047@N04,4410,17,1283941434,1283941734,4,13,300
35181047@N04,4410,28,1283942028,1283942698,8,13,670
35181047@N04,4410,23,1283942698,1283943298,1,13,600
35237090871@N01,4411,25,1196468541,1196469381,3,1,840
35237090871@N01,4412,1,1206754911,1206754971,2,8,60
35237090871@N01,4412,26,1206755627,1206756527,2,8,900
35237090871@N01,4412,17,1206775501,1206775801,2,8,300
35237090871@N01,4412,25,1206780149,1206780989,4,8,840
35237090871@N01,4412,7,1206783081,1206783261,2,8,180
35237090871@N01,4412,30,1206786098,1206787178,2,8,1080
35237090871@N01,4412,26,1206789462,1206789848,2,8,386
35237090871@N01,4412,28,1206789848,1206790748,2,8,900
35237091648@N01,4413,28,1229724484,1229725384,1,1,900
35237098292@N01,4414,28,1294551077,1294551977,2,1,900
35237099571@N01,4415,28,1324616517,1324617417,4,1,900
35237099571@N01,4416,20,1328351274,1328351814,3,3,540
35237099571@N01,4416,3,1328356658,1328356748,2,3,90
35237099571@N01,4416,17,1328359202,1328359502,1,3,300
35237099571@N01,4417,28,1330524421,1330525321,4,1,900
35237099571@N01,4418,28,1344500848,1344501748,1,1,900
35237099571@N01,4419,17,1356095974,1356096274,1,1,300
35258228@N00,4420,29,1357897993,1357898893,2,1,900
35258228@N00,4421,28,1372600130,1372601030,1,1,900
35258228@N00,4422,18,1378461887,1378462337,1,1,450
35261188@N00,4423,28,1304204155,1304205055,3,2,900
35261188@N00,4423,16,1304208256,1304208526,1,2,270
35263184@N05,4424,28,1250580200,1250580272,2,11,72
35263184@N05,4424,16,1250580272,1250580401,2,11,129
35263184@N05,4424,26,1250580401,1250580855,3,11,454
35263184@N05,4424,8,1250580855,1250581035,2,11,180
35263184@N05,4424,4,1250581854,1250581955,6,11,101
35263184@N05,4424,21,1250587153,1250587723,2,11,570
35263184@N05,4424,30,1250587804,1250588884,2,11,1080
35263184@N05,4424,29,1250592842,1250593742,3,11,900
35263184@N05,4424,28,1250606717,1250607617,18,11,900
35263184@N05,4424,4,1250622913,1250623014,4,11,101
35263184@N05,4424,6,1250623040,1250623160,2,11,120
35306697@N07,4425,27,1366413839,1366414739,2,2,900
35306697@N07,4425,18,1366426147,1366426597,1,2,450
35306697@N07,4426,1,1377398170,1377398230,2,2,60
35306697@N07,4426,29,1377404545,1377405445,1,2,900
35306697@N07,4427,17,1382709644,1382709944,1,1,300
35344579@N00,4428,13,1461314459,1461314699,1,1,240
35351453@N02,4429,30,1262283980,1262285060,2,2,1080
35351453@N02,4429,22,1262296776,1262297376,1,2,600
35371784@N00,4430,15,1278830718,1278830988,4,2,270
35371784@N00,4430,24,1278832620,1278833400,7,2,780
35371784@N00,4431,24,1278896513,1278897293,2,1,780
35371784@N00,4432,24,1278990740,1278991520,3,2,780
35371784@N00,4432,18,1279003160,1279003610,2,2,450
35371784@N00,4433,24,1279067588,1279067603,3,5,15
35371784@N00,4433,12,1279067603,1279067843,2,5,240
35371784@N00,4433,22,1279068945,1279069545,2,5,600
35371784@N00,4433,13,1279069908,1279070148,10,5,240
35371784@N00,4433,22,1279076340,1279076940,1,5,600
35371784@N00,4434,30,1279159277,1279160357,2,2,1080
35371784@N00,4434,31,1279161579,1279163079,3,2,1500
35387868@N00,4435,13,1261967186,1261967426,2,2,240
35387868@N00,4435,29,1261972703,1261973603,1,2,900
35421783@N04,4436,1,1301223417,1301223477,3,1,60
35426585@N04,4437,1,1325452855,1325452915,2,1,60
35439195@N08,4438,16,1263015152,1263015422,1,1,270
35439195@N08,4439,1,1268484110,1268484170,1,1,60
35439195@N08,4440,31,1278302175,1278303675,1,1,1500
35439195@N08,4441,29,1281778606,1281779506,1,1,900
35439195@N08,4442,16,1284108632,1284108902,1,1,270
35439195@N08,4443,26,1286618847,1286619747,1,1,900
35439195@N08,4444,6,1287204040,1287204160,1,1,120
35439195@N08,4445,24,1295230587,1295231367,1,1,780
35468135814@N01,4446,4,1278502979,1278503080,1,1,101
35468135814@N01,4447,26,1416076311,1416077211,1,1,900
35468150569@N01,4448,15,1329379604,1329379874,2,2,270
35468150569@N01,4448,17,1329396109,1329396409,1,2,300
35481620@N00,4449,28,1290825737,1290826637,1,1,900
35498711@N04,4450,3,1304822909,1304822999,2,6,90
35498711@N04,4450,26,1304824263,1304825163,2,6,900
35498711@N04,4450,27,1304840182,1304841082,2,6,900
35498711@N04,4450,29,1304844565,1304845465,3,6,900
35498711@N04,4450,13,1304855987,1304856151,2,6,164
35498711@N04,4450,11,1304856151,1304856391,1,6,240
35498711@N04,4451,13,1305099176,1305099416,2,1,240
35498711@N04,4452,22,1376880600,1376881200,3,6,600
35498711@N04,4452,13,1376888400,1376888402,3,6,2
35498711@N04,4452,12,1376888402,1376888403,2,6,1
35498711@N04,4452,27,1376888403,1376889303,4,6,900
35498711@N04,4452,20,1376892601,1376892602,2,6,1
35498711@N04,4452,13,1376892602,1376892842,1,6,240
35577481@N08,4453,16,1247800463,1247800733,2,1,270
35577481@N08,4454,13,1293083872,1293084112,3,2,240
35577481@N08,4454,20,1293104154,1293104694,3,2,540
35577481@N08,4455,29,1317560345,1317561245,1,1,900
35577481@N08,4456,26,1325687196,1325688096,2,1,900
35577481@N08,4457,6,1327235534,1327235654,1,1,120
35577481@N08,4458,28,1329988431,1329989331,1,1,900
35577481@N08,4459,16,1330459416,1330459686,1,1,270
35595560@N00,4460,28,1325139204,1325140104,1,1,900
35595560@N00,4461,3,1330920422,1330920512,1,1,90
35599995@N04,4462,1,1231673749,1231673809,3,8,60
35599995@N04,4462,23,1231674288,1231674888,2,8,600
35599995@N04,4462,29,1231674891,1231675791,4,8,900
35599995@N04,4462,4,1231682292,1231682393,2,8,101
35599995@N04,4462,26,1231686237,1231687137,14,8,900
35599995@N04,4462,30,1231688650,1231689730,4,8,1080
35599995@N04,4462,26,1231691859,1231692111,3,8,252
35599995@N04,4462,4,1231692111,1231692212,1,8,101
35599995@N04,4463,12,1231840147,1231840387,2,3,240
35599995@N04,4463,10,1231844937,1231845177,2,3,240
35599995@N04,4463,30,1231852250,1231853330,1,3,1080
35616624@N05,4464,16,1316851988,1316852258,1,1,270
35659651@N00,4465,29,1363518700,1363519600,1,1,900
35727288@N00,4466,24,1292262029,1292262809,1,1,780
35727989@N00,4467,11,1450240592,1450240832,2,2,240
35727989@N00,4467,22,1450251283,1450251883,1,2,600
35727989@N00,4468,27,1450299521,1450300266,2,7,745
35727989@N00,4468,24,1450300266,1450301046,2,7,780
35727989@N00,4468,31,1450306108,1450307608,2,7,1500
35727989@N00,4468,24,1450309489,1450310269,2,7,780
35727989@N00,4468,29,1450314900,1450315800,2,7,900
35727989@N00,4468,13,1450342104,1450342344,2,7,240
35727989@N00,4468,28,1450344420,1450345320,2,7,900
35727989@N00,4469,28,1450402438,1450403338,2,2,900
35727989@N00,4469,15,1450405206,1450405476,1,2,270
35736481@N00,4470,26,1300321113,1300322013,55,1,900
35737816@N04,4471,28,1387363552,1387364452,1,1,900
35737816@N04,4472,25,1387447600,1387448440,1,1,840
35795945@N02,4473,16,1242285599,1242285700,2,15,101
35795945@N02,4473,15,1242285700,1242285825,2,15,125
35795945@N02,4473,12,1242285825,1242285881,2,15,56
35795945@N02,4473,24,1242285881,1242285899,2,15,18
35795945@N02,4473,12,1242285899,1242286025,2,15,126
35795945@N02,4473,21,1242286025,1242286143,2,15,118
35795945@N02,4473,5,1242286143,1242286197,3,15,54
35795945@N02,4473,9,1242286197,1242286265,3,15,68
35795945@N02,4473,11,1242286265,1242286505,2,15,240
35795945@N02,4473,30,1242286546,1242286765,3,15,219
35795945@N02,4473,29,1242286765,1242286955,6,15,190
35795945@N02,4473,20,1242286955,1242287144,6,15,189
35795945@N02,4473,22,1242287144,1242287423,2,15,279
35795945@N02,4473,20,1242287423,1242287528,2,15,105
35795945@N02,4473,30,1242287528,1242288608,1,15,1080
35795945@N02,4474,26,1242554180,1242555080,2,12,900
35795945@N02,4474,3,1242555831,1242555921,2,12,90
35795945@N02,4474,4,1242555997,1242556061,2,12,64
35795945@N02,4474,7,1242556061,1242556124,2,12,63
35795945@N02,4474,9,1242556124,1242556304,2,12,180
35795945@N02,4474,31,1242556402,1242556476,2,12,74
35795945@N02,4474,10,1242556476,1242556591,2,12,115
35795945@N02,4474,29,1242556591,1242556620,2,12,29
35795945@N02,4474,30,1242556620,1242556944,2,12,324
35795945@N02,4474,31,1242556944,1242557017,2,12,73
35795945@N02,4474,22,1242557017,1242557558,3,12,541
35795945@N02,4474,1,1242557558,1242557618,1,12,60
35795945@N02,4475,31,1244843302,1244843308,3,18,6
35795945@N02,4475,30,1244843308,1244843312,2,18,4
35795945@N02,4475,31,1244843312,1244843319,3,18,7
35795945@N02,4475,22,1244843319,1244843328,4,18,9
35795945@N02,4475,10,1244843328,1244843342,4,18,14
35795945@N02,4475,9,1244843342,1244843343,2,18,1
35795945@N02,4475,4,1244843343,1244843354,6,18,11
35795945@N02,4475,9,1244843354,1244843356,2,18,2
35795945@N02,4475,8,1244843356,1244843356,2,18,0
35795945@N02,4475,9,1244843356,1244843371,7,18,15
35795945@N02,4475,26,1244843371,1244843373,2,18,2
35795945@N02,4475,6,1244843373,1244843377,3,18,4
35795945@N02,4475,26,1244843377,1244843402,7,18,25
35795945@N02,4475,12,1244843402,1244843403,2,18,1
35795945@N02,4475,17,1244843403,1244843408,2,18,5
35795945@N02,4475,28,1244843408,1244844308,2,18,900
35795945@N02,4475,31,1244844505,1244844511,3,18,6
35795945@N02,4475,26,1244844511,1244845411,2,18,900
35795945@N02,4476,1,1250758768,1250758828,4,6,60
35795945@N02,4476,20,1250759048,1250759462,8,6,414
35795945@N02,4476,18,1250759462,1250759682,3,6,220
35795945@N02,4476,12,1250759682,1250759693,2,6,11
35795945@N02,4476,28,1250759693,1250759921,5,6,228
35795945@N02,4476,1,1250759921,1250759981,2,6,60
35795945@N02,4477,16,1273363544,1273363814,8,4,270
35795945@N02,4477,25,1273363990,1273364830,26,4,840
35795945@N02,4477,11,1273365198,1273365438,5,4,240
35795945@N02,4477,31,1273365920,1273367420,2,4,1500
35795945@N02,4478,16,1274949038,1274949308,2,6,270
35795945@N02,4478,17,1274949464,1274949764,2,6,300
35795945@N02,4478,11,1274949879,1274950071,4,6,192
35795945@N02,4478,29,1274950071,1274950971,22,6,900
35795945@N02,4478,23,1274951462,1274952062,2,6,600
35795945@N02,4478,1,1274952353,1274952413,3,6,60
35795945@N02,4479,17,1276390501,1276390801,2,5,300
35795945@N02,4479,21,1276390826,1276391396,3,5,570
35795945@N02,4479,30,1276391693,1276391751,3,5,58
35795945@N02,4479,31,1276391751,1276392643,5,5,892
35795945@N02,4479,29,1276392643,1276393543,21,5,900
35795945@N02,4480,29,1280527124,1280528024,1,1,900
35815643@N00,4481,8,1193480910,1193481090,11,1,180
35851138@N02,4482,28,1355927494,1355928394,1,1,900
35861125@N08,4483,28,1248260702,1248261095,5,25,393
35861125@N08,4483,26,1248261095,1248261848,19,25,753
35861125@N08,4483,7,1248261848,1248261898,2,25,50
35861125@N08,4483,5,1248261898,1248262018,3,25,120
35861125@N08,4483,7,1248263229,1248263404,3,25,175
35861125@N08,4483,4,1248263404,1248263505,8,25,101
35861125@N08,4483,21,1248264868,1248264999,11,25,131
35861125@N08,4483,4,1248264999,1248265003,2,25,4
35861125@N08,4483,21,1248265003,1248265573,11,25,570
35861125@N08,4483,4,1248266298,1248266399,4,25,101
35861125@N08,4483,5,1248266471,1248266591,2,25,120
35861125@N08,4483,24,1248266741,1248267036,2,25,295
35861125@N08,4483,16,1248267036,1248267306,7,25,270
35861125@N08,4483,27,1248267893,1248268793,2,25,900
35861125@N08,4483,24,1248270027,1248270807,8,25,780
35861125@N08,4483,15,1248271957,1248272227,5,25,270
35861125@N08,4483,29,1248277166,1248278066,7,25,900
35861125@N08,4483,17,1248279316,1248279616,5,25,300
35861125@N08,4483,28,1248284530,1248285430,92,25,900
35861125@N08,4483,18,1248294056,1248294506,16,25,450
35861125@N08,4483,26,1248295312,1248296212,6,25,900
35861125@N08,4483,13,1248297854,1248298094,13,25,240
35861125@N08,4483,11,1248300726,1248300966,2,25,240
35861125@N08,4483,7,1248301236,1248301416,4,25,180
35861125@N08,4483,11,1248301972,1248302212,15,25,240
35861125@N08,4484,4,1248370934,1248371035,1,1,101
35872939@N00,4485,1,1252380221,1252380281,2,6,60
35872939@N00,4485,28,1252380444,1252380964,3,6,520
35872939@N00,4485,26,1252380964,1252381864,2,6,900
35872939@N00,4485,25,1252384623,1252385463,12,6,840
35872939@N00,4485,13,1252389615,1252389855,12,6,240
35872939@N00,4485,28,1252407408,1252408308,11,6,900
35872939@N00,4486,28,1302313988,1302314888,21,1,900
35922097@N00,4487,27,1378004048,1378004948,1,1,900
35942475@N05,4488,26,1289966720,1289967620,2,1,900
35942475@N05,4489,16,1290040278,1290040548,1,1,270
35942475@N05,4490,26,1290340035,1290340935,2,1,900
35942475@N05,4491,26,1292501512,1292502412,7,1,900
35942475@N05,4492,26,1292814143,1292815043,1,1,900
35942475@N05,4493,26,1293022611,1293023511,7,1,900
35942475@N05,4494,26,1294131929,1294132829,1,1,900
35942475@N05,4495,26,1294710452,1294711352,6,1,900
35942475@N05,4496,26,1295261296,1295262196,5,1,900
35942475@N05,4497,26,1296201171,1296202071,3,1,900
35942475@N05,4498,26,1297385477,1297386377,12,1,900
35942475@N05,4499,26,1299370481,1299371381,7,1,900
35942475@N05,4500,26,1301009736,1301010636,4,1,900
35942475@N05,4501,26,1301387363,1301388263,4,1,900
35942475@N05,4502,18,1354578694,1354579144,1,1,450
35942475@N05,4503,18,1363035696,1363036146,1,1,450
35942475@N05,4504,3,1366324611,1366324701,1,1,90
35942475@N05,4505,27,1366664234,1366665134,1,1,900
35942475@N05,4506,29,1376010291,1376011191,1,1,900
35942475@N05,4507,14,1379725887,1379726127,1,1,240
35942475@N05,4508,18,1380332891,1380333341,1,1,450
35945797@N05,4509,28,1353368661,1353369285,3,7,624
35945797@N05,4509,26,1353369285,1353370185,5,7,900
35945797@N05,4509,31,1353370826,1353372132,2,7,1306
35945797@N05,4509,3,1353372132,1353372222,4,7,90
35945797@N05,4509,5,1353372295,1353372352,3,7,57
35945797@N05,4509,21,1353372352,1353372653,3,7,301
35945797@N05,4509,12,1353372653,1353372893,2,7,240
35969374@N06,4510,1,1234720768,1234720828,1,1,60
36015194@N00,4511,27,1346066721,1346067621,1,1,900
36029045@N00,4512,9,1300512146,1300512326,2,2,180
36029045@N00,4512,3,1300515478,1300515568,1,2,90
36029045@N00,4513,26,1300585686,1300586586,1,1,900
36029045@N00,4514,6,1357530189,1357530309,1,1,120
36030204@N08,4515,26,1231058294,1231059194,1,1,900
36033182@N00,4516,12,1210381161,1210381401,1,1,240
36033323@N03,4517,29,1235706183,1235707083,1,1,900
36064583@N03,4518,26,1466653025,1466653925,1,1,900
36084672@N00,4519,28,1362797600,1362798500,3,1,900
36121294@N06,4520,1,1267007685,1267007745,2,5,60
36121294@N06,4520,28,1267009253,1267009820,3,5,567
36121294@N06,4520,26,1267009820,1267010720,3,5,900
36121294@N06,4520,25,1267018199,1267018412,2,5,213
36121294@N06,4520,13,1267018412,1267018652,3,5,240
36141784@N05,4521,13,1372736568,1372736808,1,1,240
36179078@N03,4522,14,1377995631,1377995871,1,1,240
36179078@N03,4523,1,1385815590,1385815650,1,1,60
36179078@N03,4524,17,1386854222,1386854522,1,1,300
36179078@N03,4525,1,1386946741,1386946801,1,1,60
36179078@N03,4526,25,1387379819,1387380659,1,1,840
36179078@N03,4527,15,1391956026,1391956296,1,1,270
36179078@N03,4528,19,1416307426,1416307966,1,1,540
36179078@N03,4529,19,1418398200,1418398740,1,1,540
36179078@N03,4530,18,1425389028,1425389478,1,1,450
36179078@N03,4531,23,1426846920,1426847520,2,1,600
36187047@N05,4532,23,1215900605,1215901205,1,1,600
36190203@N07,4533,26,1293808001,1293808901,1,1,900
36209531@N07,4534,28,1409142315,1409143215,1,1,900
36231632@N00,4535,28,1414629068,1414629968,1,1,900
36234234@N05,4536,26,1349498947,1349499225,2,3,278
36234234@N05,4536,19,1349499225,1349499765,2,3,540
36234234@N05,4536,24,1349500103,1349500883,1,3,780
36234234@N05,4537,3,1389063768,1389063858,1,1,90
36244940@N07,4538,31,1256872215,1256873715,1,1,1500
36244940@N07,4539,26,1256934024,1256934924,1,1,900
36244940@N07,4540,26,1301212911,1301213010,3,8,99
36244940@N07,4540,16,1301213010,1301213280,2,8,270
36244940@N07,4540,3,1301216951,1301217041,4,8,90
36244940@N07,4540,25,1301217101,1301217185,2,8,84
36244940@N07,4540,12,1301217185,1301217425,2,8,240
36244940@N07,4540,26,1301221072,1301221077,2,8,5
36244940@N07,4540,16,1301221077,1301221347,2,8,270
36244940@N07,4540,28,1301224827,1301225727,1,8,900
36244940@N07,4541,20,1301275270,1301275288,2,11,18
36244940@N07,4541,18,1301275288,1301275738,2,11,450
36244940@N07,4541,30,1301276350,1301277430,2,11,1080
36244940@N07,4541,10,1301279763,1301280003,2,11,240
36244940@N07,4541,30,1301280664,1301281744,7,11,1080
36244940@N07,4541,27,1301302774,1301303674,2,11,900
36244940@N07,4541,7,1301315265,1301315445,2,11,180
36244940@N07,4541,6,1301315622,1301315742,2,11,120
36244940@N07,4541,26,1301315762,1301316568,3,11,806
36244940@N07,4541,16,1301316568,1301316653,2,11,85
36244940@N07,4541,26,1301316653,1301317553,2,11,900
36244940@N07,4542,26,1301384076,1301384976,3,4,900
36244940@N07,4542,16,1301392859,1301393129,2,4,270
36244940@N07,4542,30,1301393988,1301395068,2,4,1080
36244940@N07,4542,16,1301402042,1301402312,1,4,270
36244940@N07,4543,26,1301654780,1301655680,2,2,900
36244940@N07,4543,16,1301683497,1301683767,1,2,270
36258343@N03,4544,26,1366980325,1366981225,1,1,900
36258343@N03,4545,26,1441375289,1441376189,1,1,900
36277109@N03,4546,30,1398280285,1398281365,1,1,1080
36330825967@N01,4547,30,1213679273,1213680353,2,4,1080
36330825967@N01,4547,20,1213681104,1213681644,3,4,540
36330825967@N01,4547,7,1213701602,1213701782,2,4,180
36330825967@N01,4547,20,1213721330,1213721870,1,4,540
36330825967@N01,4548,13,1213768686,1213768926,2,1,240
36330825967@N01,4549,7,1213799334,1213799514,2,1,180
36330825967@N01,4550,13,1213852610,1213852850,2,2,240
36330825967@N01,4550,24,1213866393,1213867173,2,2,780
36330825967@N01,4551,29,1227374599,1227375499,1,1,900
36330825967@N01,4552,17,1227504205,1227504505,4,5,300
36330825967@N01,4552,21,1227511512,1227512082,2,5,570
36330825967@N01,4552,18,1227518574,1227519024,2,5,450
36330825967@N01,4552,15,1227524818,1227525088,2,5,270
36330825967@N01,4552,24,1227546894,1227547674,4,5,780
36330825967@N01,4553,16,1227589495,1227589765,1,1,270
36330825967@N01,4554,28,1273795985,1273796885,1,1,900
36330825967@N01,4555,28,1273877210,1273878110,1,1,900
36330825967@N01,4556,28,1273929141,1273930041,1,1,900
36330825967@N01,4557,28,1273965598,1273966498,1,1,900
36330825967@N01,4558,25,1289595267,1289596107,4,1,840
36330825967@N01,4559,17,1289680579,1289680879,2,2,300
36330825967@N01,4559,18,1289695883,1289696333,2,2,450
36330825967@N01,4560,18,1311299282,1311299732,1,1,450
36330825967@N01,4561,17,1311369667,1311369967,2,1,300
36330825967@N01,4562,18,1311423305,1311423755,1,1,450
36330825967@N01,4563,17,1311455905,1311456205,1,1,300
36330825967@N01,4564,30,1357872611,1357873691,2,1,1080
36330825967@N01,4565,17,1357938981,1357939281,4,3,300
36330825967@N01,4565,12,1357940381,1357940621,3,3,240
36330825967@N01,4565,5,1357948395,1357948515,1,3,120
36330825967@N01,4566,17,1358026918,1358027218,3,2,300
36330825967@N01,4566,27,1358036995,1358037895,1,2,900
36330825967@N01,4567,17,1358120509,1358120809,1,1,300
36330825967@N01,4568,29,1371962214,1371963114,2,3,900
36330825967@N01,4568,1,1371964763,1371964773,2,3,10
36330825967@N01,4568,20,1371964773,1371965313,1,3,540
36330825967@N01,4569,17,1372109684,1372109984,2,4,300
36330825967@N01,4569,19,1372117827,1372118367,2,4,540
36330825967@N01,4569,17,1372125277,1372125285,2,4,8
36330825967@N01,4569,15,1372125285,1372125555,1,4,270
36330825967@N01,4570,1,1372162433,1372162493,1,1,60
36330825967@N01,4571,17,1389312291,1389312591,1,1,300
36330825967@N01,4572,9,1389388534,1389388714,1,1,180
36330825967@N01,4573,12,1389427183,1389427423,1,1,240
36330825967@N01,4574,12,1389478880,1389479120,2,1,240
36330825967@N01,4575,1,1464641014,1464641074,2,5,60
36330825967@N01,4575,28,1464643110,1464643720,2,5,610
36330825967@N01,4575,7,1464643720,1464643900,4,5,180
36330825967@N01,4575,18,1464658722,1464658774,2,5,52
36330825967@N01,4575,30,1464658774,1464659854,1,5,1080
36330825967@N01,4576,11,1464770317,1464770557,2,3,240
36330825967@N01,4576,3,1464772992,1464773082,2,3,90
36330825967@N01,4576,18,1464779882,1464780332,3,3,450
36330825967@N01,4577,12,1464820010,1464820250,2,1,240
36330825967@N01,4578,1,1464913547,1464913607,2,3,60
36330825967@N01,4578,20,1464915817,1464916357,2,3,540
36330825967@N01,4578,28,1464940700,1464941600,1,3,900
36330825967@N01,4579,6,1464991149,1464991269,2,3,120
36330825967@N01,4579,23,1465002334,1465002934,2,3,600
36330825967@N01,4579,26,1465003559,1465004459,2,3,900
36342378@N02,4580,27,1392770463,1392771363,1,1,900
36399194@N03,4581,19,1416105173,1416105713,1,1,540
36423739@N02,4582,16,1353387667,1353387671,2,3,4
36423739@N02,4582,15,1353387671,1353387941,2,3,270
36423739@N02,4582,18,1353390530,1353390980,1,3,450
36454787@N08,4583,28,1245303200,1245304100,75,1,900
36454787@N08,4584,27,1245415636,1245416536,69,1,900
36454787@N08,4585,28,1245547068,1245547968,85,1,900
36459656@N00,4586,26,1285925678,1285926578,5,1,900
36459656@N00,4587,28,1292322880,1292323584,4,4,704
36459656@N00,4587,26,1292323584,1292324484,2,4,900
36459656@N00,4587,25,1292327130,1292327970,2,4,840
36459656@N00,4587,26,1292335279,1292336179,1,4,900
36470826@N06,4588,19,1351330721,1351331261,1,1,540
36470826@N06,4589,17,1362799288,1362799588,2,3,300
36470826@N06,4589,26,1362802526,1362803426,2,3,900
36470826@N06,4589,20,1362810731,1362811271,1,3,540
36492333@N02,4590,28,1217904254,1217905154,2,1,900
36507580@N06,4591,26,1300686843,1300687743,1,1,900
36521978714@N01,4592,31,1437881844,1437881989,2,2,145
36521978714@N01,4592,14,1437881989,1437882229,1,2,240
36559368@N07,4593,3,1285888217,1285888307,3,6,90
36559368@N07,4593,21,1285892048,1285892174,2,6,126
36559368@N07,4593,25,1285892174,1285893014,4,6,840
36559368@N07,4593,29,1285894313,1285895213,2,6,900
36559368@N07,4593,24,1285908071,1285908851,3,6,780
36559368@N07,4593,26,1285912326,1285913226,2,6,900
36559368@N07,4594,3,1286027710,1286027800,1,1,90
36594324@N02,4595,9,1386636259,1386636439,2,1,180
36604767@N00,4596,14,1220087859,1220088099,1,1,240
36618387@N06,4597,1,1458264163,1458264223,4,1,60
36618387@N06,4598,30,1458374396,1458375476,1,1,1080
36669200@N05,4599,1,1394951162,1394951222,1,1,60
36671802@N04,4600,26,1468629125,1468630025,3,1,900
36671802@N04,4601,26,1468680008,1468680908,15,1,900
36671802@N04,4602,26,1468890193,1468891093,6,1,900
36671802@N04,4603,26,1468939052,1468939952,8,1,900
36675721@N03,4604,10,1269999692,1269999932,33,1,240
36675721@N03,4605,10,1270087801,1270088041,8,1,240
36675721@N03,4606,10,1270163187,1270163427,10,1,240
36679351@N00,4607,18,1207965486,1207965936,80,1,450
36679351@N00,4608,18,1212976212,1212976662,52,1,450
36679351@N00,4609,18,1213059088,1213059538,1,1,450
36679351@N00,4610,18,1213267358,1213267808,1,1,450
36679351@N00,4611,18,1213389772,1213390222,70,1,450
36679351@N00,4612,18,1213490789,1213491239,11,1,450
36679351@N00,4613,18,1222994629,1222995079,175,1,450
36679351@N00,4614,18,1231283419,1231283869,22,1,450
36783109@N04,4615,28,1358729205,1358730105,1,1,900
36823514@N08,4616,17,1343817745,1343818045,1,1,300
36823514@N08,4617,28,1343880220,1343881120,1,1,900
36846553@N03,4618,30,1255166879,1255167959,1,1,1080
36870866@N04,4619,3,1269510573,1269510663,4,2,90
36870866@N04,4619,28,1269511791,1269512691,8,2,900
36909370@N06,4620,28,1297419459,1297420359,1,1,900
36909370@N06,4621,28,1309312857,1309313757,1,1,900
36909370@N06,4622,13,1317189087,1317189327,2,2,240
36909370@N06,4622,20,1317191660,1317192200,1,2,540
36909370@N06,4623,26,1321248519,1321249419,3,1,900
36909370@N06,4624,16,1350197847,1350198117,1,1,270
36911028@N00,4625,16,1338335672,1338335942,2,3,270
36911028@N00,4625,29,1338343833,1338344733,2,3,900
36911028@N00,4625,21,1338348035,1338348605,1,3,570
36911028@N00,4626,29,1338380679,1338381579,1,1,900
36911028@N00,4627,26,1341818203,1341819103,1,1,900
36911028@N00,4628,30,1341886570,1341887650,1,1,1080
36911028@N00,4629,30,1416296736,1416297816,2,2,1080
36911028@N00,4629,25,1416304548,1416305388,1,2,840
36911028@N00,4630,19,1416456084,1416456624,2,3,540
36911028@N00,4630,20,1416469011,1416469136,2,3,125
36911028@N00,4630,18,1416469136,1416469586,1,3,450
36911028@N00,4631,27,1442023034,1442023934,2,2,900
36911028@N00,4631,13,1442049999,1442050239,1,2,240
36911028@N00,4632,29,1442150891,1442151791,1,1,900
36942952@N00,4633,25,1200736812,1200737652,1,1,840
36942952@N00,4634,15,1201254426,1201254696,1,1,270
36942952@N00,4635,15,1203061602,1203061872,1,1,270
36942952@N00,4636,31,1206952689,1206954189,1,1,1500
36942952@N00,4637,1,1211376368,1211376428,2,2,60
36942952@N00,4637,24,1211381721,1211382501,1,2,780
36942952@N00,4638,22,1211443826,1211444158,2,8,332
36942952@N00,4638,29,1211444158,1211444295,2,8,137
36942952@N00,4638,25,1211444295,1211444514,2,8,219
36942952@N00,4638,21,1211444514,1211444751,2,8,237
36942952@N00,4638,28,1211444751,1211444980,2,8,229
36942952@N00,4638,1,1211444980,1211445040,3,8,60
36942952@N00,4638,18,1211448127,1211448390,2,8,263
36942952@N00,4638,28,1211448390,1211449290,1,8,900
36942952@N00,4639,1,1212038129,1212038189,1,1,60
36942952@N00,4640,28,1214443261,1214444161,3,1,900
36942952@N00,4641,24,1216977999,1216978604,2,3,605
36942952@N00,4641,26,1216978604,1216979504,3,3,900
36942952@N00,4641,23,1216980836,1216981436,2,3,600
36942952@N00,4642,15,1221362874,1221363144,2,1,270
36942952@N00,4643,18,1221569515,1221569965,2,1,450
36942952@N00,4644,24,1221906013,1221906096,2,8,83
36942952@N00,4644,26,1221906096,1221906928,3,8,832
36942952@N00,4644,28,1221906928,1221907130,2,8,202
36942952@N00,4644,26,1221907130,1221907529,3,8,399
36942952@N00,4644,16,1221907529,1221907725,3,8,196
36942952@N00,4644,15,1221907725,1221907995,3,8,270
36942952@N00,4644,24,1221908048,1221908828,2,8,780
36942952@N00,4644,17,1221911690,1221911990,5,8,300
36942952@N00,4645,30,1223634478,1223634932,3,2,454
36942952@N00,4645,31,1223634932,1223636432,1,2,1500
36942952@N00,4646,20,1225519225,1225519515,2,8,290
36942952@N00,4646,1,1225519515,1225519575,2,8,60
36942952@N00,4646,21,1225520109,1225520396,2,8,287
36942952@N00,4646,3,1225520396,1225520486,3,8,90
36942952@N00,4646,30,1225521084,1225521280,3,8,196
36942952@N00,4646,21,1225521280,1225521338,2,8,58
36942952@N00,4646,30,1225521338,1225522418,5,8,1080
36942952@N00,4646,20,1225522444,1225522984,2,8,540
36942952@N00,4647,1,1226208902,1226208962,2,11,60
36942952@N00,4647,30,1226212461,1226212734,2,11,273
36942952@N00,4647,29,1226212734,1226213634,2,11,900
36942952@N00,4647,31,1226213682,1226213871,2,11,189
36942952@N00,4647,1,1226213871,1226213931,2,11,60
36942952@N00,4647,15,1226213937,1226214000,2,11,63
36942952@N00,4647,1,1226214000,1226214060,2,11,60
36942952@N00,4647,28,1226214070,1226214376,2,11,306
36942952@N00,4647,16,1226214376,1226214646,3,11,270
36942952@N00,4647,1,1226215217,1226215254,2,11,37
36942952@N00,4647,29,1226215254,1226216154,1,11,900
36942952@N00,4648,25,1235987994,1235988381,3,4,387
36942952@N00,4648,21,1235988381,1235988951,2,4,570
36942952@N00,4648,25,1235989412,1235990013,4,4,601
36942952@N00,4648,26,1235990013,1235990913,1,4,900
36942952@N00,4649,26,1236940416,1236940459,2,3,43
36942952@N00,4649,30,1236940459,1236940762,4,3,303
36942952@N00,4649,12,1236940762,1236941002,1,3,240
36942952@N00,4650,30,1242121064,1242122144,2,4,1080
36942952@N00,4650,23,1242128440,1242129040,2,4,600
36942952@N00,4650,22,1242129085,1242129685,2,4,600
36942952@N00,4650,30,1242130280,1242131360,5,4,1080
36942952@N00,4651,28,1244814143,1244815043,1,1,900
36942952@N00,4652,26,1246144575,1246145475,2,3,900
36942952@N00,4652,29,1246155794,1246156694,3,3,900
36942952@N00,4652,23,1246178912,1246179512,1,3,600
36942952@N00,4653,26,1246263921,1246264242,3,6,321
36942952@N00,4653,5,1246264242,1246264362,4,6,120
36942952@N00,4653,3,1246267536,1246267626,2,6,90
36942952@N00,4653,18,1246268074,1246268524,2,6,450
36942952@N00,4653,22,1246268548,1246269148,2,6,600
36942952@N00,4653,23,1246269241,1246269841,7,6,600
36942952@N00,4654,23,1246354673,1246354828,2,8,155
36942952@N00,4654,18,1246354828,1246355081,3,8,253
36942952@N00,4654,29,1246355081,1246355342,3,8,261
36942952@N00,4654,19,1246355342,1246355882,3,8,540
36942952@N00,4654,23,1246361248,1246361651,2,8,403
36942952@N00,4654,18,1246361651,1246362101,2,8,450
36942952@N00,4654,29,1246363890,1246364474,3,8,584
36942952@N00,4654,18,1246364474,1246364924,1,8,450
36942952@N00,4655,22,1251954938,1251955538,2,3,600
36942952@N00,4655,17,1251961848,1251962148,3,3,300
36942952@N00,4655,21,1251964312,1251964882,1,3,570
36942952@N00,4656,1,1252739082,1252739142,2,3,60
36942952@N00,4656,29,1252739783,1252740683,3,3,900
36942952@N00,4656,23,1252753690,1252754290,1,3,600
36942952@N00,4657,1,1255232439,1255232499,5,2,60
36942952@N00,4657,26,1255235230,1255236130,2,2,900
36942952@N00,4658,30,1256722122,1256723202,1,1,1080
36942952@N00,4659,17,1256807353,1256807358,4,2,5
36942952@N00,4659,20,1256807358,1256807898,1,2,540
36942952@N00,4660,19,1257057452,1257057458,2,5,6
36942952@N00,4660,12,1257057458,1257057460,2,5,2
36942952@N00,4660,24,1257057460,1257057470,2,5,10
36942952@N00,4660,27,1257057470,1257057480,2,5,10
36942952@N00,4660,12,1257057480,1257057720,1,5,240
36942952@N00,4661,23,1259125269,1259125869,2,4,600
36942952@N00,4661,28,1259152475,1259152548,3,4,73
36942952@N00,4661,23,1259152548,1259152560,2,4,12
36942952@N00,4661,28,1259152560,1259153460,1,4,900
36942952@N00,4662,29,1259317210,1259318110,1,1,900
36942952@N00,4663,25,1259487511,1259488351,2,1,840
36942952@N00,4664,23,1269385280,1269385880,4,21,600
36942952@N00,4664,29,1269385978,1269386517,2,21,539
36942952@N00,4664,22,1269386517,1269387094,3,21,577
36942952@N00,4664,29,1269387094,1269387994,4,21,900
36942952@N00,4664,30,1269389786,1269389939,2,21,153
36942952@N00,4664,19,1269389939,1269390479,2,21,540
36942952@N00,4664,28,1269390775,1269390893,3,21,118
36942952@N00,4664,1,1269390893,1269390953,2,21,60
36942952@N00,4664,28,1269392545,1269392699,2,21,154
36942952@N00,4664,16,1269392699,1269392969,2,21,270
36942952@N00,4664,17,1269393222,1269393522,3,21,300
36942952@N00,4664,24,1269395928,1269396134,2,21,206
36942952@N00,4664,12,1269396134,1269396374,2,21,240
36942952@N00,4664,20,1269398032,1269398572,2,21,540
36942952@N00,4664,22,1269398757,1269399357,4,21,600
36942952@N00,4664,17,1269399526,1269399641,2,21,115
36942952@N00,4664,1,1269399641,1269399701,3,21,60
36942952@N00,4664,20,1269400158,1269400214,2,21,56
36942952@N00,4664,29,1269400214,1269401114,2,21,900
36942952@N00,4664,23,1269401666,1269402266,5,21,600
36942952@N00,4664,1,1269404118,1269404178,1,21,60
36942952@N00,4665,1,1289598641,1289598701,4,5,60
36942952@N00,4665,20,1289603024,1289603564,2,5,540
36942952@N00,4665,29,1289603745,1289604645,6,5,900
36942952@N00,4665,28,1289604843,1289605431,3,5,588
36942952@N00,4665,1,1289605431,1289605491,3,5,60
36942952@N00,4666,28,1298254196,1298254621,2,7,425
36942952@N00,4666,1,1298254621,1298254681,2,7,60
36942952@N00,4666,28,1298254957,1298255857,2,7,900
36942952@N00,4666,30,1298258211,1298258491,2,7,280
36942952@N00,4666,18,1298258491,1298258941,3,7,450
36942952@N00,4666,29,1298259078,1298259978,2,7,900
36942952@N00,4666,30,1298261117,1298262197,1,7,1080
36942952@N00,4667,28,1301360918,1301361818,2,12,900
36942952@N00,4667,31,1301364999,1301365574,2,12,575
36942952@N00,4667,26,1301365574,1301366272,4,12,698
36942952@N00,4667,15,1301366272,1301366542,8,12,270
36942952@N00,4667,26,1301368247,1301368773,5,12,526
36942952@N00,4667,3,1301368773,1301368863,2,12,90
36942952@N00,4667,23,1301369916,1301370516,2,12,600
36942952@N00,4667,19,1301370654,1301371194,3,12,540
36942952@N00,4667,20,1301371208,1301371748,3,12,540
36942952@N00,4667,28,1301380650,1301381454,4,12,804
36942952@N00,4667,29,1301381454,1301382354,5,12,900
36942952@N00,4667,1,1301388884,1301388944,1,12,60
36942952@N00,4668,20,1306116964,1306117504,2,2,540
36942952@N00,4668,27,1306132986,1306133886,27,2,900
36942952@N00,4669,7,1328372319,1328372499,2,22,180
36942952@N00,4669,26,1328372576,1328373476,4,22,900
36942952@N00,4669,20,1328377971,1328378511,6,22,540
36942952@N00,4669,23,1328379686,1328380286,2,22,600
36942952@N00,4669,29,1328380715,1328381615,5,22,900
36942952@N00,4669,12,1328382869,1328382878,2,22,9
36942952@N00,4669,26,1328382878,1328383778,2,22,900
36942952@N00,4669,17,1328384342,1328384499,2,22,157
36942952@N00,4669,15,1328384499,1328384769,3,22,270
36942952@N00,4669,24,1328385207,1328385342,3,22,135
36942952@N00,4669,17,1328385342,1328385642,2,22,300
36942952@N00,4669,15,1328385704,1328385786,2,22,82
36942952@N00,4669,27,1328385786,1328386122,2,22,336
36942952@N00,4669,26,1328386122,1328386315,2,22,193
36942952@N00,4669,30,1328386315,1328386369,2,22,54
36942952@N00,4669,26,1328386369,1328386533,2,22,164
36942952@N00,4669,23,1328386533,1328387133,21,22,600
36942952@N00,4669,28,1328389656,1328390556,4,22,900
36942952@N00,4669,20,1328390760,1328391300,2,22,540
36942952@N00,4669,15,1328391583,1328391691,2,22,108
36942952@N00,4669,17,1328391691,1328391731,2,22,40
36942952@N00,4669,1,1328391731,1328391791,6,22,60
36942952@N00,4670,16,1329306159,1329306429,1,1,270
36942952@N00,4671,23,1398578929,1398579529,3,4,600
36942952@N00,4671,14,1398583765,1398584005,2,4,240
36942952@N00,4671,31,1398585212,1398586390,3,4,1178
36942952@N00,4671,29,1398586390,1398587290,2,4,900
36942952@N00,4672,28,1409303762,1409304662,3,4,900
36942952@N00,4672,29,1409305835,1409306735,2,4,900
36942952@N00,4672,18,1409307957,1409308195,3,4,238
36942952@N00,4672,26,1409308195,1409309095,4,4,900
36942952@N00,4673,29,1413454037,1413454937,1,1,900
36942952@N00,4674,28,1419233062,1419233673,7,5,611
36942952@N00,4674,26,1419233673,1419233984,3,5,311
36942952@N00,4674,30,1419233984,1419234113,2,5,129
36942952@N00,4674,19,1419234113,1419234653,2,5,540
36942952@N00,4674,28,1419234876,1419235776,2,5,900
36942952@N00,4675,28,1420264032,1420264263,3,12,231
36942952@N00,4675,23,1420264263,1420264863,14,12,600
36942952@N00,4675,19,1420266531,1420266711,5,12,180
36942952@N00,4675,23,1420266711,1420267311,10,12,600
36942952@N00,4675,29,1420267935,1420268053,2,12,118
36942952@N00,4675,31,1420268053,1420268221,2,12,168
36942952@N00,4675,22,1420268221,1420268670,2,12,449
36942952@N00,4675,23,1420268670,1420269270,3,12,600
36942952@N00,4675,29,1420269479,1420269572,2,12,93
36942952@N00,4675,19,1420269572,1420270112,2,12,540
36942952@N00,4675,26,1420270312,1420270786,2,12,474
36942952@N00,4675,28,1420270786,1420271686,2,12,900
36942952@N00,4676,1,1429759479,1429759539,3,5,60
36942952@N00,4676,27,1429760546,1429760871,2,5,325
36942952@N00,4676,17,1429760871,1429761171,13,5,300
36942952@N00,4676,16,1429763041,1429763311,2,5,270
36942952@N00,4676,27,1429769433,1429770333,3,5,900
36987405@N02,4677,17,1340939591,1340939891,2,2,300
36987405@N02,4677,27,1340941394,1340942294,1,2,900
36987405@N02,4678,21,1340971880,1340972450,2,2,570
36987405@N02,4678,25,1340973130,1340973970,1,2,840
36987405@N02,4679,27,1341317429,1341317649,2,2,220
36987405@N02,4679,26,1341317649,1341318549,1,2,900
37032567@N05,4680,28,1329087224,1329088124,2,4,900
37032567@N05,4680,3,1329089395,1329089485,2,4,90
37032567@N05,4680,13,1329099024,1329099264,2,4,240
37032567@N05,4680,18,1329107309,1329107759,1,4,450
37047749@N04,4681,1,1355821263,1355821323,1,1,60
37114630@N05,4682,1,1379720572,1379720632,1,1,60
37158363@N08,4683,3,1379170366,1379170456,1,1,90
37167805@N00,4684,17,1219561668,1219561968,1,1,300
37168969@N00,4685,28,1357038723,1357039623,1,1,900
37216856@N00,4686,15,1374637543,1374637813,1,1,270
37225678@N06,4687,3,1277914908,1277914998,1,1,90
37225678@N06,4688,7,1277960305,1277960485,1,1,180
37227722@N02,4689,4,1400214602,1400214703,2,1,101
37236988@N03,4690,26,1330486129,1330487029,2,1,900
37258140@N04,4691,28,1354745433,1354746333,1,1,900
37258140@N04,4692,28,1354834121,1354835021,2,4,900
37258140@N04,4692,12,1354845110,1354845350,2,4,240
37258140@N04,4692,20,1354852596,1354853136,2,4,540
37258140@N04,4692,28,1354864913,1354865813,2,4,900
37258140@N04,4693,13,1354976663,1354976903,1,1,240
37319092@N00,4694,29,1270969690,1270970590,2,1,900
37344578@N02,4695,26,1263608764,1263609664,6,2,900
37344578@N02,4695,25,1263614896,1263615736,1,2,840
37344578@N02,4696,23,1263683783,1263684306,2,2,523
37344578@N02,4696,28,1263684306,1263685206,1,2,900
37363832@N03,4697,29,1323569952,1323570852,1,1,900
37363832@N03,4698,28,1323916224,1323917124,2,4,900
37363832@N03,4698,25,1323943832,1323943973,2,4,141
37363832@N03,4698,26,1323943973,1323944033,2,4,60
37363832@N03,4698,7,1323944033,1323944213,1,4,180
37363832@N03,4699,31,1327808878,1327810378,2,2,1500
37363832@N03,4699,3,1327818079,1327818169,1,2,90
37363832@N03,4700,16,1345950840,1345951110,2,2,270
37363832@N03,4700,24,1345962000,1345962780,1,2,780
37363832@N03,4701,28,1346816747,1346817647,2,2,900
37363832@N03,4701,27,1346817869,1346818769,1,2,900
37363832@N03,4702,28,1348993460,1348993893,2,2,433
37363832@N03,4702,20,1348993893,1348994433,1,2,540
37363832@N03,4703,28,1353228718,1353229618,1,1,900
37363832@N03,4704,22,1354420255,1354420855,1,1,600
37363832@N03,4705,26,1354705596,1354706496,1,1,900
37363832@N03,4706,18,1355103175,1355103276,2,6,101
37363832@N03,4706,28,1355103276,1355104176,2,6,900
37363832@N03,4706,18,1355107293,1355107743,2,6,450
37363832@N03,4706,20,1355120300,1355120769,2,6,469
37363832@N03,4706,13,1355120769,1355120930,2,6,161
37363832@N03,4706,25,1355120930,1355121770,1,6,840
37363832@N03,4707,13,1370164774,1370165014,1,1,240
37363832@N03,4708,9,1370334467,1370334647,1,1,180
37363832@N03,4709,28,1370772747,1370773647,1,1,900
37363832@N03,4710,14,1370831986,1370832226,1,1,240
37363832@N03,4711,18,1372334966,1372335416,1,1,450
37363832@N03,4712,1,1377512407,1377512467,1,1,60
37363832@N03,4713,28,1379570180,1379571080,1,1,900
37363832@N03,4714,1,1379838298,1379838358,1,1,60
37363832@N03,4715,1,1384932379,1384932439,1,1,60
37363832@N03,4716,1,1386544216,1386544276,1,1,60
37363832@N03,4717,1,1386760774,1386760834,1,1,60
37364998@N05,4718,14,1376565433,1376565673,1,1,240
37364998@N05,4719,7,1376600710,1376600890,1,1,180
37364998@N05,4720,26,1376777056,1376777956,1,1,900
37364998@N05,4721,27,1377426198,1377427098,1,1,900
37364998@N05,4722,1,1377826753,1377826813,1,1,60
37364998@N05,4723,1,1378517590,1378517650,1,1,60
37364998@N05,4724,17,1378778055,1378778355,1,1,300
37366843@N07,4725,30,1325828181,1325829261,1,1,1080
37369621@N00,4726,28,1332980629,1332981529,2,2,900
37369621@N00,4726,26,1332984182,1332985082,1,2,900
37369621@N00,4727,1,1334935997,1334936057,1,1,60
37376032@N00,4728,19,1417931661,1417932201,1,1,540
37376032@N00,4729,19,1417991451,1417991991,4,4,540
37376032@N00,4729,29,1418017217,1418018117,2,4,900
37376032@N00,4729,26,1418019697,1418020597,3,4,900
37376032@N00,4729,19,1418036372,1418036912,1,4,540
37376032@N00,4730,28,1418123316,1418124216,1,1,900
37376032@N00,4731,19,1418208974,1418209514,1,1,540
37376032@N00,4732,19,1418250498,1418251038,4,2,540
37376032@N00,4732,28,1418297782,1418298682,1,2,900
37382345@N08,4733,1,1345370437,1345370497,2,9,60
37382345@N08,4733,26,1345370835,1345371043,2,9,208
37382345@N08,4733,16,1345371043,1345371313,3,9,270
37382345@N08,4733,20,1345374178,1345374585,2,9,407
37382345@N08,4733,22,1345374585,1345375158,2,9,573
37382345@N08,4733,14,1345375158,1345375398,2,9,240
37382345@N08,4733,17,1345377707,1345378007,2,9,300
37382345@N08,4733,27,1345381888,1345382788,2,9,900
37382345@N08,4733,1,1345385483,1345385543,1,9,60
37382345@N08,4734,10,1347180821,1347181061,1,1,240
37382345@N08,4735,23,1358146739,1358147339,9,4,600
37382345@N08,4735,16,1358148797,1358148992,3,4,195
37382345@N08,4735,26,1358148992,1358149802,3,4,810
37382345@N08,4735,30,1358149802,1358150882,25,4,1080
37382345@N08,4736,30,1360634300,1360635380,2,6,1080
37382345@N08,4736,28,1360636545,1360637445,3,6,900
37382345@N08,4736,1,1360642349,1360642409,3,6,60
37382345@N08,4736,28,1360644256,1360645027,3,6,771
37382345@N08,4736,15,1360645027,1360645297,3,6,270
37382345@N08,4736,28,1360650509,1360651409,2,6,900
37382345@N08,4737,24,1361096685,1361097465,2,2,780
37382345@N08,4737,15,1361101352,1361101622,22,2,270
37382345@N08,4738,1,1365311377,1365311437,2,6,60
37382345@N08,4738,27,1365313055,1365313212,2,6,157
37382345@N08,4738,12,1365313212,1365313452,2,6,240
37382345@N08,4738,5,1365314841,1365314961,2,6,120
37382345@N08,4738,28,1365329725,1365330201,2,6,476
37382345@N08,4738,1,1365330201,1365330261,1,6,60
37382345@N08,4739,1,1366440034,1366440094,2,14,60
37382345@N08,4739,28,1366440104,1366440474,3,14,370
37382345@N08,4739,27,1366440474,1366441374,2,14,900
37382345@N08,4739,17,1366441689,1366441989,2,14,300
37382345@N08,4739,15,1366442105,1366442375,3,14,270
37382345@N08,4739,19,1366447699,1366448239,2,14,540
37382345@N08,4739,16,1366451044,1366451314,3,14,270
37382345@N08,4739,26,1366451356,1366452256,2,14,900
37382345@N08,4739,16,1366458422,1366458692,4,14,270
37382345@N08,4739,24,1366459041,1366459821,2,14,780
37382345@N08,4739,15,1366460285,1366460555,4,14,270
37382345@N08,4739,27,1366462599,1366463041,2,14,442
37382345@N08,4739,16,1366463041,1366463221,2,14,180
37382345@N08,4739,26,1366463221,1366464121,3,14,900
37382345@N08,4740,27,1368832807,1368833707,2,25,900
37382345@N08,4740,24,1368834041,1368834821,5,25,780
37382345@N08,4740,3,1368835340,1368835430,2,25,90
37382345@N08,4740,24,1368835603,1368835727,2,25,124
37382345@N08,4740,12,1368835727,1368835967,3,25,240
37382345@N08,4740,15,1368836243,1368836513,2,25,270
37382345@N08,4740,26,1368836798,1368837649,5,25,851
37382345@N08,4740,30,1368837649,1368838653,2,25,1004
37382345@N08,4740,22,1368838653,1368839253,2,25,600
37382345@N08,4740,29,1368839480,1368839617,2,25,137
37382345@N08,4740,20,1368839617,1368840157,2,25,540
37382345@N08,4740,16,1368842257,1368842527,3,25,270
37382345@N08,4740,26,1368845909,1368846809,2,25,900
37382345@N08,4740,1,1368857055,1368857115,2,25,60
37382345@N08,4740,28,1368861438,1368862338,2,25,900
37382345@N08,4740,12,1368866014,1368866178,2,25,164
37382345@N08,4740,26,1368866178,1368867078,3,25,900
37382345@N08,4740,12,1368867086,1368867326,2,25,240
37382345@N08,4740,24,1368867649,1368868104,2,25,455
37382345@N08,4740,17,1368868104,1368868404,2,25,300
37382345@N08,4740,26,1368869138,1368869612,2,25,474
37382345@N08,4740,12,1368869612,1368869852,2,25,240
37382345@N08,4740,15,1368877300,1368877570,8,25,270
37382345@N08,4740,16,1368881387,1368881657,3,25,270
37382345@N08,4740,26,1368883161,1368884061,1,25,900
37382345@N08,4741,28,1370321068,1370321968,3,5,900
37382345@N08,4741,3,1370323831,1370323921,2,5,90
37382345@N08,4741,13,1370324206,1370324446,3,5,240
37382345@N08,4741,21,1370325894,1370326464,7,5,570
37382345@N08,4741,28,1370343853,1370344753,1,5,900
37382345@N08,4742,27,1371289376,1371290276,2,5,900
37382345@N08,4742,21,1371292348,1371292555,2,5,207
37382345@N08,4742,3,1371292555,1371292645,2,5,90
37382345@N08,4742,6,1371292731,1371292851,3,5,120
37382345@N08,4742,26,1371293178,1371294078,2,5,900
37382345@N08,4743,28,1371951588,1371952076,2,4,488
37382345@N08,4743,23,1371952076,1371952676,9,4,600
37382345@N08,4743,28,1371959514,1371960414,3,4,900
37382345@N08,4743,1,1371963436,1371963496,1,4,60
37382345@N08,4744,1,1372651974,1372652034,2,8,60
37382345@N08,4744,28,1372652361,1372653261,2,8,900
37382345@N08,4744,22,1372654321,1372654921,3,8,600
37382345@N08,4744,29,1372655061,1372655830,2,8,769
37382345@N08,4744,21,1372655830,1372656400,2,8,570
37382345@N08,4744,13,1372657048,1372657288,2,8,240
37382345@N08,4744,1,1372658699,1372658759,3,8,60
37382345@N08,4744,23,1372667081,1372667681,1,8,600
37382345@N08,4745,18,1372735642,1372736092,2,8,450
37382345@N08,4745,29,1372737116,1372738016,4,8,900
37382345@N08,4745,30,1372738558,1372739638,2,8,1080
37382345@N08,4745,6,1372746798,1372746918,2,8,120
37382345@N08,4745,16,1372748175,1372748445,2,8,270
37382345@N08,4745,1,1372748608,1372748668,3,8,60
37382345@N08,4745,17,1372762078,1372762378,3,8,300
37382345@N08,4745,15,1372763341,1372763611,1,8,270
37382345@N08,4746,1,1373340412,1373340472,2,10,60
37382345@N08,4746,28,1373341529,1373341795,3,10,266
37382345@N08,4746,16,1373341795,1373341845,2,10,50
37382345@N08,4746,12,1373341845,1373342085,4,10,240
37382345@N08,4746,3,1373342127,1373342217,3,10,90
37382345@N08,4746,30,1373343980,1373345060,3,10,1080
37382345@N08,4746,18,1373347392,1373347842,3,10,450
37382345@N08,4746,26,1373351140,1373352040,12,10,900
37382345@N08,4746,16,1373352300,1373352570,2,10,270
37382345@N08,4746,1,1373355928,1373355988,4,10,60
37382345@N08,4747,11,1373716120,1373716360,6,4,240
37382345@N08,4747,31,1373720431,1373720561,3,4,130
37382345@N08,4747,29,1373720561,1373721331,3,4,770
37382345@N08,4747,20,1373721331,1373721871,1,4,540
37382345@N08,4748,28,1374407697,1374408597,2,2,900
37382345@N08,4748,15,1374408824,1374409094,12,2,270
37382345@N08,4749,26,1375964987,1375965887,2,3,900
37382345@N08,4749,18,1375966081,1375966531,2,3,450
37382345@N08,4749,1,1375970123,1375970183,2,3,60
37382345@N08,4750,26,1378633191,1378633940,2,4,749
37382345@N08,4750,16,1378633940,1378634210,3,4,270
37382345@N08,4750,18,1378638534,1378638984,2,4,450
37382345@N08,4750,29,1378639691,1378640591,4,4,900
37382345@N08,4751,20,1382874587,1382875127,1,1,540
37382345@N08,4752,26,1387889045,1387889945,3,1,900
37382345@N08,4753,1,1388901069,1388901129,2,3,60
37382345@N08,4753,21,1388921135,1388921705,2,3,570
37382345@N08,4753,13,1388923287,1388923527,1,3,240
37382345@N08,4754,16,1391835480,1391835713,3,2,233
37382345@N08,4754,26,1391835713,1391836613,2,2,900
37382345@N08,4755,1,1393019128,1393019188,7,3,60
37382345@N08,4755,28,1393027085,1393027215,2,3,130
37382345@N08,4755,1,1393027215,1393027275,1,3,60
37382345@N08,4756,1,1393134808,1393134868,25,4,60
37382345@N08,4756,28,1393136600,1393137500,4,4,900
37382345@N08,4756,22,1393137590,1393138190,3,4,600
37382345@N08,4756,1,1393142698,1393142758,19,4,60
37382345@N08,4757,26,1395568574,1395569474,2,1,900
37382345@N08,4758,16,1395629503,1395629773,2,2,270
37382345@N08,4758,21,1395630800,1395631370,1,2,570
37382345@N08,4759,1,1398044767,1398044827,3,11,60
37382345@N08,4759,15,1398046708,1398046978,2,11,270
37382345@N08,4759,20,1398053942,1398054482,5,11,540
37382345@N08,4759,30,1398059915,1398060995,2,11,1080
37382345@N08,4759,26,1398061864,1398062764,3,11,900
37382345@N08,4759,30,1398063911,1398064991,6,11,1080
37382345@N08,4759,11,1398067929,1398068169,2,11,240
37382345@N08,4759,7,1398068690,1398068870,5,11,180
37382345@N08,4759,5,1398069252,1398069372,5,11,120
37382345@N08,4759,3,1398070502,1398070592,2,11,90
37382345@N08,4759,6,1398070743,1398070863,1,11,120
37382345@N08,4760,28,1401084330,1401085230,18,5,900
37382345@N08,4760,16,1401087043,1401087313,2,5,270
37382345@N08,4760,8,1401087349,1401087529,2,5,180
37382345@N08,4760,26,1401087803,1401088703,2,5,900
37382345@N08,4760,20,1401089265,1401089805,1,5,540
37382345@N08,4761,28,1402872987,1402873887,3,9,900
37382345@N08,4761,18,1402874906,1402875308,2,9,402
37382345@N08,4761,1,1402875308,1402875368,3,9,60
37382345@N08,4761,28,1402875672,1402876422,2,9,750
37382345@N08,4761,1,1402876422,1402876482,3,9,60
37382345@N08,4761,26,1402877889,1402878789,6,9,900
37382345@N08,4761,28,1402885436,1402886336,3,9,900
37382345@N08,4761,20,1402890758,1402891298,2,9,540
37382345@N08,4761,1,1402891852,1402891912,3,9,60
37382345@N08,4762,28,1403916922,1403917822,2,2,900
37382345@N08,4762,26,1403919072,1403919972,1,2,900
37382345@N08,4763,20,1404447116,1404447656,4,2,540
37382345@N08,4763,29,1404450342,1404451242,1,2,900
37382345@N08,4764,1,1404688336,1404688396,2,12,60
37382345@N08,4764,28,1404688595,1404689053,2,12,458
37382345@N08,4764,26,1404689053,1404689317,2,12,264
37382345@N08,4764,23,1404689317,1404689654,2,12,337
37382345@N08,4764,18,1404689654,1404690104,3,12,450
37382345@N08,4764,20,1404691795,1404692335,2,12,540
37382345@N08,4764,21,1404694186,1404694756,2,12,570
37382345@N08,4764,12,1404695494,1404695734,2,12,240
37382345@N08,4764,16,1404696475,1404696745,2,12,270
37382345@N08,4764,8,1404698464,1404698644,4,12,180
37382345@N08,4764,26,1404699117,1404699487,2,12,370
37382345@N08,4764,28,1404699487,1404700387,1,12,900
37382345@N08,4765,15,1404818670,1404818940,13,1,270
37382345@N08,4766,22,1405145234,1405145834,6,2,600
37382345@N08,4766,20,1405146307,1405146847,3,2,540
37413911@N07,4767,26,1302349634,1302350534,1,1,900
37413911@N07,4768,26,1302393379,1302394279,1,1,900
37413911@N07,4769,29,1311937398,1311938298,1,1,900
37413911@N07,4770,28,1318020869,1318021769,2,1,900
37423919@N00,4771,17,1240909165,1240909465,2,2,300
37423919@N00,4771,28,1240909859,1240910759,2,2,900
37423919@N00,4772,1,1405397957,1405398017,1,1,60
37423919@N00,4773,25,1408462043,1408462883,1,1,840
37447227@N03,4774,20,1322884086,1322884626,1,1,540
37473564@N00,4775,26,1316415618,1316416518,2,1,900
37495946@N04,4776,29,1352028949,1352029849,1,1,900
37495946@N04,4777,18,1452153632,1452154082,1,1,450
37495946@N04,4778,26,1470926182,1470927082,2,1,900
37513581@N03,4779,15,1236745377,1236745647,1,1,270
37513581@N03,4780,26,1237547138,1237548038,1,1,900
37541876@N06,4781,13,1380539148,1380539388,2,2,240
37541876@N06,4781,1,1380544946,1380545006,1,2,60
37575596@N07,4782,29,1369924983,1369925883,10,1,900
37645295@N00,4783,1,1249013666,1249013726,2,2,60
37645295@N00,4783,29,1249015250,1249016150,1,2,900
37665974@N07,4784,16,1448520541,1448520811,1,1,270
37665974@N07,4785,17,1449716980,1449717280,1,1,300
37711141@N05,4786,17,1205962884,1205963184,2,1,300
37711141@N05,4787,17,1206027662,1206027962,2,1,300
37718676626@N01,4788,16,1356661120,1356661390,14,1,270
37763182@N03,4789,19,1196305186,1196305726,3,5,540
37763182@N03,4789,13,1196308261,1196308501,2,5,240
37763182@N03,4789,16,1196310524,1196310794,4,5,270
37763182@N03,4789,27,1196311257,1196312157,2,5,900
37763182@N03,4789,26,1196318227,1196319127,2,5,900
37763182@N03,4790,1,1212221197,1212221257,1,1,60
37763182@N03,4791,30,1213233134,1213234214,2,2,1080
37763182@N03,4791,26,1213235327,1213236227,1,2,900
37763182@N03,4792,22,1213623191,1213623791,1,1,600
37763182@N03,4793,16,1215674320,1215674590,1,1,270
37763182@N03,4794,22,1222384535,1222385135,1,1,600
37763182@N03,4795,30,1224213237,1224214317,2,1,1080
37763182@N03,4796,30,1228452683,1228453763,1,1,1080
37763182@N03,4797,19,1235797553,1235798093,2,2,540
37763182@N03,4797,20,1235800682,1235801222,1,2,540
37763182@N03,4798,19,1239934309,1239934849,2,4,540
37763182@N03,4798,30,1239938869,1239939949,3,4,1080
37763182@N03,4798,24,1239940191,1239940971,4,4,780
37763182@N03,4798,19,1239961033,1239961573,1,4,540
37763182@N03,4799,28,1264128924,1264129824,1,1,900
37763182@N03,4800,20,1264485402,1264485942,2,3,540
37763182@N03,4800,3,1264491764,1264491854,2,3,90
37763182@N03,4800,17,1264494599,1264494899,1,3,300
37763182@N03,4801,19,1271414147,1271414687,2,3,540
37763182@N03,4801,20,1271418655,1271419195,2,3,540
37763182@N03,4801,26,1271421735,1271422635,3,3,900
37763182@N03,4802,1,1278463365,1278463425,4,2,60
37763182@N03,4802,23,1278469138,1278469738,1,2,600
37763182@N03,4803,29,1279029087,1279029987,1,1,900
37763182@N03,4804,23,1279102314,1279102914,5,1,600
37763182@N03,4805,27,1280021339,1280022239,1,1,900
37763182@N03,4806,28,1281445047,1281445947,1,1,900
37763182@N03,4807,28,1281697666,1281698566,2,2,900
37763182@N03,4807,29,1281698782,1281699682,2,2,900
37763182@N03,4808,29,1282826069,1282826969,2,1,900
37763182@N03,4809,26,1283382749,1283383649,2,11,900
37763182@N03,4809,25,1283384995,1283385835,7,11,840
37763182@N03,4809,16,1283413426,1283413696,7,11,270
37763182@N03,4809,22,1283414681,1283415281,2,11,600
37763182@N03,4809,30,1283415681,1283416614,4,11,933
37763182@N03,4809,31,1283416614,1283417608,3,11,994
37763182@N03,4809,13,1283417608,1283417848,6,11,240
37763182@N03,4809,21,1283418943,1283419513,16,11,570
37763182@N03,4809,12,1283419718,1283419958,2,11,240
37763182@N03,4809,27,1283421731,1283422480,4,11,749
37763182@N03,4809,16,1283422480,1283422750,4,11,270
37763182@N03,4810,29,1283772310,1283772438,2,4,128
37763182@N03,4810,30,1283772438,1283773518,3,4,1080
37763182@N03,4810,26,1283775412,1283776312,3,4,900
37763182@N03,4810,7,1283781357,1283781537,2,4,180
37763182@N03,4811,12,1284097104,1284097344,2,2,240
37763182@N03,4811,30,1284103482,1284104562,4,2,1080
37763182@N03,4812,13,1284697034,1284697274,2,9,240
37763182@N03,4812,20,1284700393,1284700933,6,9,540
37763182@N03,4812,19,1284702030,1284702570,7,9,540
37763182@N03,4812,18,1284704417,1284704773,5,9,356
37763182@N03,4812,30,1284704773,1284704881,2,9,108
37763182@N03,4812,29,1284704881,1284705781,4,9,900
37763182@N03,4812,26,1284706345,1284706602,2,9,257
37763182@N03,4812,3,1284706602,1284706692,3,9,90
37763182@N03,4812,13,1284707048,1284707288,1,9,240
37763182@N03,4813,31,1285286578,1285286846,2,6,268
37763182@N03,4813,20,1285286846,1285287386,2,6,540
37763182@N03,4813,22,1285288935,1285289128,2,6,193
37763182@N03,4813,31,1285289128,1285289332,4,6,204
37763182@N03,4813,29,1285289332,1285290232,2,6,900
37763182@N03,4813,28,1285290948,1285291848,4,6,900
37763182@N03,4814,19,1286423338,1286423878,2,3,540
37763182@N03,4814,30,1286428981,1286430061,2,3,1080
37763182@N03,4814,26,1286431468,1286432368,1,3,900
37763182@N03,4815,28,1287009690,1287010590,2,10,900
37763182@N03,4815,19,1287011219,1287011759,2,10,540
37763182@N03,4815,18,1287013530,1287013980,3,10,450
37763182@N03,4815,14,1287015586,1287015826,3,10,240
37763182@N03,4815,22,1287016150,1287016706,2,10,556
37763182@N03,4815,30,1287016706,1287017747,2,10,1041
37763182@N03,4815,26,1287017747,1287018647,6,10,900
37763182@N03,4815,20,1287038891,1287039431,3,10,540
37763182@N03,4815,27,1287048718,1287049172,2,10,454
37763182@N03,4815,17,1287049172,1287049472,2,10,300
37763182@N03,4816,20,1287809628,1287810168,2,3,540
37763182@N03,4816,29,1287820175,1287821075,3,3,900
37763182@N03,4816,28,1287823146,1287824046,1,3,900
37763182@N03,4817,26,1289021194,1289022094,2,1,900
37763182@N03,4818,20,1289193697,1289194237,5,3,540
37763182@N03,4818,22,1289196062,1289196662,2,3,600
37763182@N03,4818,20,1289201060,1289201600,1,3,540
37763182@N03,4819,16,1289452797,1289453067,15,3,270
37763182@N03,4819,28,1289457644,1289458544,2,3,900
37763182@N03,4819,21,1289460831,1289461401,1,3,570
37763182@N03,4820,24,1290773872,1290774652,14,1,780
37763182@N03,4821,26,1291346561,1291347461,1,1,900
37763182@N03,4822,26,1291703878,1291704778,20,1,900
37763182@N03,4823,21,1292136707,1292137277,16,1,570
37763182@N03,4824,25,1292246586,1292247426,9,1,840
37763182@N03,4825,28,1293018072,1293018972,2,4,900
37763182@N03,4825,17,1293021033,1293021333,2,4,300
37763182@N03,4825,7,1293021779,1293021959,2,4,180
37763182@N03,4825,23,1293023685,1293024285,1,4,600
37763182@N03,4826,26,1295762658,1295763558,2,4,900
37763182@N03,4826,27,1295764812,1295765191,2,4,379
37763182@N03,4826,17,1295765191,1295765491,2,4,300
37763182@N03,4826,13,1295769738,1295769978,1,4,240
37763182@N03,4827,13,1296005520,1296005760,1,1,240
37763182@N03,4828,1,1302607220,1302607280,2,5,60
37763182@N03,4828,29,1302608149,1302609049,6,5,900
37763182@N03,4828,20,1302611840,1302612380,2,5,540
37763182@N03,4828,16,1302615172,1302615442,2,5,270
37763182@N03,4828,28,1302616886,1302617786,1,5,900
37763182@N03,4829,29,1305537206,1305538106,1,1,900
37763182@N03,4830,3,1308729934,1308730024,2,2,90
37763182@N03,4830,24,1308730984,1308731764,1,2,780
37763182@N03,4831,15,1316747822,1316748092,1,1,270
37763182@N03,4832,1,1317198649,1317198709,5,4,60
37763182@N03,4832,28,1317199156,1317199199,2,4,43
37763182@N03,4832,1,1317199199,1317199259,2,4,60
37763182@N03,4832,20,1317200788,1317201328,1,4,540
37763182@N03,4833,23,1327041330,1327041930,2,1,600
37763182@N03,4834,29,1328266249,1328267149,1,1,900
37763182@N03,4835,12,1330239728,1330239968,1,1,240
37763182@N03,4836,17,1330682710,1330683010,1,1,300
37763182@N03,4837,16,1331191063,1331191333,1,1,270
37763646@N06,4838,16,1409009460,1409009730,1,1,270
37763949@N00,4839,4,1329494603,1329494704,1,1,101
37763949@N00,4840,26,1355712688,1355713080,2,2,392
37763949@N00,4840,25,1355713080,1355713920,1,2,840
37836851@N08,4841,28,1341919604,1341920504,1,1,900
37869753@N06,4842,22,1301538739,1301539058,2,4,319
37869753@N06,4842,14,1301539058,1301539298,2,4,240
37869753@N06,4842,20,1301540524,1301541064,2,4,540
37869753@N06,4842,28,1301551845,1301552745,1,4,900
37869753@N06,4843,28,1327203921,1327204821,3,4,900
37869753@N06,4843,20,1327207954,1327208494,2,4,540
37869753@N06,4843,26,1327210588,1327210991,2,4,403
37869753@N06,4843,7,1327210991,1327211171,1,4,180
37869753@N06,4844,22,1332633246,1332633650,2,3,404
37869753@N06,4844,14,1332633650,1332633890,2,3,240
37869753@N06,4844,8,1332636058,1332636238,1,3,180
37869753@N06,4845,13,1332721581,1332721821,2,3,240
37869753@N06,4845,21,1332727465,1332727659,2,3,194
37869753@N06,4845,26,1332727659,1332728559,2,3,900
37869753@N06,4846,1,1334881662,1334881722,2,7,60
37869753@N06,4846,28,1334882787,1334883687,2,7,900
37869753@N06,4846,19,1334885903,1334886443,2,7,540
37869753@N06,4846,21,1334891343,1334891871,2,7,528
37869753@N06,4846,26,1334891871,1334892771,6,7,900
37869753@N06,4846,18,1334894428,1334894878,4,7,450
37869753@N06,4846,28,1334899084,1334899984,5,7,900
37869753@N06,4847,30,1339541777,1339542275,2,4,498
37869753@N06,4847,11,1339542275,1339542515,2,4,240
37869753@N06,4847,25,1339552959,1339553799,3,4,840
37869753@N06,4847,28,1339564975,1339565875,17,4,900
37869753@N06,4848,15,1344905076,1344905091,2,2,15
37869753@N06,4848,12,1344905091,1344905331,1,2,240
37869753@N06,4849,20,1347876228,1347876768,4,2,540
37869753@N06,4849,28,1347883900,1347884800,3,2,900
37869753@N06,4850,1,1350007925,1350007985,3,5,60
37869753@N06,4850,25,1350011385,1350012225,3,5,840
37869753@N06,4850,28,1350021792,1350022545,2,5,753
37869753@N06,4850,23,1350022545,1350023142,2,5,597
37869753@N06,4850,28,1350023142,1350024042,1,5,900
37869753@N06,4851,1,1352686924,1352686984,2,4,60
37869753@N06,4851,25,1352689660,1352690500,2,4,840
37869753@N06,4851,13,1352690678,1352690918,3,4,240
37869753@N06,4851,28,1352702903,1352703803,6,4,900
37869753@N06,4852,28,1355546178,1355547078,19,1,900
37869753@N06,4853,1,1355617232,1355617292,2,1,60
37869753@N06,4854,1,1361663694,1361663754,3,4,60
37869753@N06,4854,25,1361665508,1361666348,5,4,840
37869753@N06,4854,26,1361667727,1361668627,4,4,900
37869753@N06,4854,1,1361671801,1361671861,3,4,60
37869753@N06,4855,26,1365378120,1365379020,1,1,900
37869753@N06,4856,18,1374885332,1374885782,3,2,450
37869753@N06,4856,28,1374910980,1374911880,1,2,900
37869753@N06,4857,1,1375565855,1375565915,12,4,60
37869753@N06,4857,28,1375569471,1375570098,2,4,627
37869753@N06,4857,26,1375570098,1375570998,2,4,900
37869753@N06,4857,28,1375583668,1375584568,1,4,900
37869753@N06,4858,26,1379806106,1379807006,5,2,900
37869753@N06,4858,28,1379815782,1379816682,1,2,900
37869753@N06,4859,1,1382238250,1382238310,3,2,60
37869753@N06,4859,20,1382241749,1382242289,1,2,540
37869753@N06,4860,19,1387421302,1387421842,2,2,540
37869753@N06,4860,11,1387423359,1387423599,1,2,240
37869753@N06,4861,26,1391653448,1391654348,3,2,900
37869753@N06,4861,23,1391677185,1391677785,1,2,600
37869753@N06,4862,26,1393549612,1393550512,5,1,900
37869753@N06,4863,23,1402627220,1402627820,2,2,600
37869753@N06,4863,28,1402636228,1402637128,6,2,900
37869753@N06,4864,18,1408755086,1408755536,1,1,450
37869753@N06,4865,18,1411708302,1411708752,3,2,450
37869753@N06,4865,28,1411708936,1411709836,1,2,900
37869753@N06,4866,3,1412674974,1412675064,1,1,90
37869753@N06,4867,1,1416025941,1416026001,7,1,60
37869753@N06,4868,26,1425164666,1425165566,4,2,900
37869753@N06,4868,1,1425168488,1425168548,1,2,60
37869753@N06,4869,1,1436412026,1436412086,4,1,60
37869753@N06,4870,26,1441023789,1441024689,8,1,900
37869753@N06,4871,28,1441945343,1441946243,1,1,900
37869753@N06,4872,28,1442702685,1442703585,2,3,900
37869753@N06,4872,23,1442703929,1442704226,2,3,297
37869753@N06,4872,22,1442704226,1442704826,4,3,600
37869753@N06,4873,20,1446104506,1446105046,6,2,540
37869753@N06,4873,26,1446111850,1446112750,2,2,900
37869753@N06,4874,26,1451973934,1451974834,4,2,900
37869753@N06,4874,16,1451981022,1451981292,1,2,270
37869753@N06,4875,1,1453527387,1453527447,4,1,60
37893053@N02,4876,29,1429412137,1429413037,5,2,900
37893053@N02,4876,17,1429426346,1429426646,2,2,300
37908430@N02,4877,22,1434236037,1434236128,2,4,91
37908430@N02,4877,1,1434236128,1434236188,5,4,60
37908430@N02,4877,28,1434237350,1434238068,2,4,718
37908430@N02,4877,18,1434238068,1434238518,1,4,450
37908430@N02,4878,26,1434281660,1434282560,5,1,900
37912374286@N01,4879,16,1244095218,1244095488,2,3,270
37912374286@N01,4879,29,1244101684,1244102584,2,3,900
37912374286@N01,4879,28,1244103246,1244104146,1,3,900
37912374286@N01,4880,12,1266705073,1266705313,2,4,240
37912374286@N01,4880,21,1266705794,1266706364,2,4,570
37912374286@N01,4880,16,1266709842,1266710112,2,4,270
37912374286@N01,4880,29,1266721120,1266722020,1,4,900
37912374286@N01,4881,20,1291346105,1291346645,1,1,540
37912374286@N01,4882,18,1431762099,1431762549,2,3,450
37912374286@N01,4882,23,1431768012,1431768612,3,3,600
37912374286@N01,4882,16,1431769757,1431770027,1,3,270
37912374286@N01,4883,20,1462585638,1462586178,2,2,540
37912374286@N01,4883,28,1462593112,1462594012,2,2,900
37913092@N00,4884,1,1382407717,1382407777,2,3,60
37913092@N00,4884,30,1382412364,1382413444,2,3,1080
37913092@N00,4884,1,1382429664,1382429724,1,3,60
37961843@N00,4885,19,1415425361,1415425901,1,1,540
37983522@N02,4886,24,1260143120,1260143900,1,1,780
37994498834@N01,4887,19,1417919829,1417919967,2,5,138
37994498834@N01,4887,1,1417919967,1417920027,2,5,60
37994498834@N01,4887,23,1417921760,1417922360,2,5,600
37994498834@N01,4887,19,1417926204,1417926744,2,5,540
37994498834@N01,4887,15,1417945062,1417945332,1,5,270
37996583849@N01,4888,28,1342443558,1342444458,1,1,900
37996583849@N01,4889,26,1357296824,1357297724,1,1,900
37996583849@N01,4890,3,1368188493,1368188583,1,1,90
37996583849@N01,4891,1,1370514379,1370514439,1,1,60
37996583849@N01,4892,1,1371122681,1371122741,1,1,60
37996583849@N01,4893,1,1372153961,1372154021,1,1,60
37996583849@N01,4894,1,1373522545,1373522605,1,1,60
37996583849@N01,4895,23,1386219599,1386220199,1,1,600
37996583849@N01,4896,27,1413189030,1413189930,1,1,900
37996615892@N01,4897,11,1290995615,1290995855,1,1,240
37996622233@N01,4898,25,1305944834,1305945674,2,4,840
37996622233@N01,4898,16,1305956192,1305956462,2,4,270
37996622233@N01,4898,26,1305956785,1305957685,2,4,900
37996622233@N01,4898,1,1305965769,1305965829,1,4,60
37996631812@N01,4899,16,1455258193,1455258463,5,2,270
37996631812@N01,4899,21,1455260554,1455261124,2,2,570
37996631812@N01,4900,4,1455335959,1455336057,3,6,98
37996631812@N01,4900,31,1455336057,1455336491,4,6,434
37996631812@N01,4900,22,1455336491,1455337091,3,6,600
37996631812@N01,4900,17,1455337848,1455338148,4,6,300
37996631812@N01,4900,15,1455338578,1455338848,3,6,270
37996631812@N01,4900,28,1455355097,1455355997,11,6,900
37996635091@N01,4901,25,1428017274,1428018114,2,2,840
37996635091@N01,4901,17,1428021704,1428022004,2,2,300
38067879@N08,4902,11,1336881401,1336881641,2,3,240
38067879@N08,4902,14,1336883649,1336883889,2,3,240
38067879@N08,4902,29,1336907688,1336908588,1,3,900
38067879@N08,4903,27,1337043236,1337044136,1,1,900
38067879@N08,4904,6,1337075589,1337075709,2,3,120
38067879@N08,4904,5,1337077116,1337077236,2,3,120
38067879@N08,4904,28,1337089164,1337090064,1,3,900
38067879@N08,4905,20,1338446755,1338447295,1,1,540
38067879@N08,4906,30,1339128680,1339129760,1,1,1080
38067879@N08,4907,30,1354250479,1354251559,1,1,1080
38067879@N08,4908,24,1354427033,1354427048,2,3,15
38067879@N08,4908,7,1354427048,1354427228,2,3,180
38067879@N08,4908,26,1354446364,1354447264,1,3,900
38067879@N08,4909,28,1354493080,1354493980,1,1,900
38067879@N08,4910,25,1354568817,1354569657,1,1,840
38067879@N08,4911,29,1354677899,1354678799,1,1,900
38067879@N08,4912,30,1382762276,1382763356,2,2,1080
38067879@N08,4912,18,1382780003,1382780453,1,2,450
38067879@N08,4913,20,1382920034,1382920574,1,1,540
38067879@N08,4914,16,1397710533,1397710803,2,2,270
38067879@N08,4914,29,1397732160,1397733060,1,2,900
38067879@N08,4915,5,1397872721,1397872841,2,1,120
38067879@N08,4916,29,1434113182,1434114082,1,1,900
38067879@N08,4917,27,1436671969,1436672869,1,1,900
38067879@N08,4918,29,1462178214,1462179114,1,1,900
38084526@N06,4919,1,1275135943,1275136003,2,3,60
38084526@N06,4919,16,1275139038,1275139308,2,3,270
38084526@N06,4919,26,1275147622,1275148522,1,3,900
38084526@N06,4920,26,1275398249,1275399149,1,1,900
38084526@N06,4921,10,1275653842,1275653945,2,5,103
38084526@N06,4921,26,1275653945,1275654087,2,5,142
38084526@N06,4921,21,1275654087,1275654657,3,5,570
38084526@N06,4921,17,1275656185,1275656249,2,5,64
38084526@N06,4921,24,1275656249,1275657029,2,5,780
38084526@N06,4922,11,1276329049,1276329289,1,1,240
38084526@N06,4923,28,1287061693,1287062593,1,1,900
38084526@N06,4924,25,1318578418,1318579258,1,1,840
38096226@N08,4925,18,1277698244,1277698694,2,2,450
38096226@N08,4925,16,1277720735,1277721005,1,2,270
38102706@N05,4926,29,1267801731,1267802631,1,1,900
38102706@N05,4927,1,1267909429,1267909489,10,63,60
38102706@N05,4927,28,1267909738,1267910638,6,63,900
38102706@N05,4927,16,1267910978,1267911248,4,63,270
38102706@N05,4927,27,1267911253,1267911301,3,63,48
38102706@N05,4927,26,1267911301,1267911718,8,63,417
38102706@N05,4927,8,1267911718,1267911898,9,63,180
38102706@N05,4927,4,1267912945,1267912978,2,63,33
38102706@N05,4927,7,1267912978,1267913138,5,63,160
38102706@N05,4927,21,1267913138,1267913176,2,63,38
38102706@N05,4927,3,1267913176,1267913195,2,63,19
38102706@N05,4927,12,1267913195,1267913233,2,63,38
38102706@N05,4927,8,1267913233,1267913279,2,63,46
38102706@N05,4927,21,1267913279,1267913849,6,63,570
38102706@N05,4927,8,1267913898,1267913984,3,63,86
38102706@N05,4927,21,1267913984,1267914175,2,63,191
38102706@N05,4927,12,1267914175,1267914252,2,63,77
38102706@N05,4927,24,1267914252,1267914322,2,63,70
38102706@N05,4927,16,1267914322,1267914592,5,63,270
38102706@N05,4927,27,1267914639,1267914902,4,63,263
38102706@N05,4927,16,1267914902,1267915172,7,63,270
38102706@N05,4927,27,1267916490,1267917390,9,63,900
38102706@N05,4927,15,1267917588,1267917858,6,63,270
38102706@N05,4927,27,1267919500,1267919543,2,63,43
38102706@N05,4927,16,1267919543,1267919813,4,63,270
38102706@N05,4927,26,1267919842,1267919978,4,63,136
38102706@N05,4927,29,1267919978,1267920117,6,63,139
38102706@N05,4927,19,1267920117,1267920657,4,63,540
38102706@N05,4927,29,1267921300,1267922200,19,63,900
38102706@N05,4927,16,1267927480,1267927750,2,63,270
38102706@N05,4927,24,1267928367,1267928375,6,63,8
38102706@N05,4927,12,1267928375,1267928376,2,63,1
38102706@N05,4927,24,1267928376,1267928416,2,63,40
38102706@N05,4927,12,1267928416,1267928656,3,63,240
38102706@N05,4927,24,1267928785,1267928806,2,63,21
38102706@N05,4927,16,1267928806,1267929076,7,63,270
38102706@N05,4927,24,1267930379,1267930590,2,63,211
38102706@N05,4927,21,1267930590,1267930687,3,63,97
38102706@N05,4927,13,1267930687,1267930927,4,63,240
38102706@N05,4927,11,1267931008,1267931248,2,63,240
38102706@N05,4927,13,1267932121,1267932361,6,63,240
38102706@N05,4927,16,1267932853,1267932912,2,63,59
38102706@N05,4927,27,1267932912,1267932932,2,63,20
38102706@N05,4927,16,1267932932,1267933202,2,63,270
38102706@N05,4927,18,1267936697,1267937147,6,63,450
38102706@N05,4927,28,1267940630,1267941027,2,63,397
38102706@N05,4927,27,1267941027,1267941137,2,63,110
38102706@N05,4927,16,1267941137,1267941189,2,63,52
38102706@N05,4927,26,1267941189,1267941275,2,63,86
38102706@N05,4927,29,1267941275,1267942175,13,63,900
38102706@N05,4927,28,1267944387,1267945287,2,63,900
38102706@N05,4927,26,1267945932,1267946832,3,63,900
38102706@N05,4927,29,1267951703,1267952603,2,63,900
38102706@N05,4927,27,1267957929,1267958829,19,63,900
38102706@N05,4927,15,1267960191,1267960461,2,63,270
38102706@N05,4927,28,1267961213,1267961450,3,63,237
38102706@N05,4927,27,1267961450,1267961557,2,63,107
38102706@N05,4927,15,1267961557,1267961668,4,63,111
38102706@N05,4927,16,1267961668,1267961676,2,63,8
38102706@N05,4927,15,1267961676,1267961946,3,63,270
38102706@N05,4927,28,1267964947,1267965847,7,63,900
38102706@N05,4927,1,1267965911,1267965971,3,63,60
38102706@N05,4927,28,1267966111,1267967011,3,63,900
38102706@N05,4927,1,1267967122,1267967182,1,63,60
38102706@N05,4928,28,1268007183,1268008083,6,17,900
38102706@N05,4928,1,1268025052,1268025112,7,17,60
38102706@N05,4928,28,1268025987,1268026343,5,17,356
38102706@N05,4928,16,1268026343,1268026613,4,17,270
38102706@N05,4928,28,1268028175,1268028360,3,17,185
38102706@N05,4928,27,1268028360,1268028410,2,17,50
38102706@N05,4928,16,1268028410,1268028434,3,17,24
38102706@N05,4928,18,1268028434,1268028587,2,17,153
38102706@N05,4928,16,1268028587,1268028694,3,17,107
38102706@N05,4928,27,1268028694,1268028971,4,17,277
38102706@N05,4928,16,1268028971,1268029241,3,17,270
38102706@N05,4928,26,1268029278,1268029322,3,17,44
38102706@N05,4928,8,1268029322,1268029502,8,17,180
38102706@N05,4928,21,1268035694,1268036264,15,17,570
38102706@N05,4928,16,1268038699,1268038969,2,17,270
38102706@N05,4928,27,1268039885,1268040144,4,17,259
38102706@N05,4928,16,1268040144,1268040414,2,17,270
38102706@N05,4929,17,1306224852,1306225152,1,1,300
38102706@N05,4930,12,1306455783,1306456023,5,10,240
38102706@N05,4930,15,1306456045,1306456315,5,10,270
38102706@N05,4930,16,1306456849,1306457119,2,10,270
38102706@N05,4930,29,1306458564,1306459464,4,10,900
38102706@N05,4930,14,1306460693,1306460933,3,10,240
38102706@N05,4930,29,1306461100,1306462000,4,10,900
38102706@N05,4930,1,1306462756,1306462777,2,10,21
38102706@N05,4930,28,1306462777,1306462847,2,10,70
38102706@N05,4930,1,1306462847,1306462907,5,10,60
38102706@N05,4930,28,1306465246,1306466146,1,10,900
38102706@N05,4931,30,1400713872,1400714952,1,1,1080
38102706@N05,4932,1,1400972432,1400972492,1,1,60
38116435@N00,4933,26,1262842707,1262843607,2,1,900
38116435@N00,4934,31,1277943338,1277944838,2,2,1500
38116435@N00,4934,18,1277964199,1277964649,2,2,450
38116435@N00,4935,16,1283756400,1283756670,1,1,270
38116435@N00,4936,16,1284102000,1284102270,1,1,270
38116435@N00,4937,20,1287880026,1287880566,2,4,540
38116435@N00,4937,11,1287888013,1287888105,2,4,92
38116435@N00,4937,4,1287888105,1287888206,2,4,101
38116435@N00,4937,26,1287889976,1287890876,1,4,900
38116435@N00,4938,26,1294109051,1294109315,2,2,264
38116435@N00,4938,12,1294109315,1294109555,1,2,240
38116435@N00,4939,29,1295235906,1295236806,2,1,900
38116435@N00,4940,20,1297649851,1297650275,2,3,424
38116435@N00,4940,26,1297650275,1297651175,3,3,900
38116435@N00,4940,12,1297651459,1297651699,1,3,240
38116435@N00,4941,26,1299849474,1299850374,1,1,900
38116435@N00,4942,19,1305011627,1305012167,2,3,540
38116435@N00,4942,18,1305013546,1305013996,2,3,450
38116435@N00,4942,16,1305015456,1305015726,1,3,270
38116435@N00,4943,22,1318321362,1318321962,1,1,600
38116435@N00,4944,28,1322652655,1322653555,1,1,900
38116435@N00,4945,23,1322827043,1322827643,1,1,600
38116435@N00,4946,26,1322975309,1322976209,1,1,900
38116435@N00,4947,16,1340435151,1340435421,1,1,270
38116435@N00,4948,20,1340534887,1340535427,1,1,540
38116435@N00,4949,5,1340612850,1340612970,1,1,120
38116435@N00,4950,26,1357629566,1357630466,1,1,900
38117207@N03,4951,28,1339985718,1339986618,39,1,900
38149231@N02,4952,15,1294543749,1294544019,2,1,270
38224505@N04,4953,1,1380763985,1380764045,1,1,60
38231195@N04,4954,28,1360282733,1360283302,2,4,569
38231195@N04,4954,12,1360283302,1360283542,5,4,240
38231195@N04,4954,16,1360286362,1360286632,4,4,270
38231195@N04,4954,27,1360286786,1360287686,3,4,900
38231195@N04,4955,1,1360323881,1360323941,1,1,60
38235069@N00,4956,28,1324675614,1324676240,8,11,626
38235069@N00,4956,16,1324676240,1324676510,3,11,270
38235069@N00,4956,26,1324676682,1324677582,2,11,900
38235069@N00,4956,15,1324683062,1324683332,4,11,270
38235069@N00,4956,1,1324683445,1324683505,2,11,60
38235069@N00,4956,20,1324683757,1324684297,4,11,540
38235069@N00,4956,24,1324686577,1324687357,4,11,780
38235069@N00,4956,29,1324690661,1324691561,5,11,900
38235069@N00,4956,27,1324696174,1324697074,5,11,900
38235069@N00,4956,28,1324698283,1324699183,25,11,900
38235069@N00,4956,13,1324711725,1324711965,1,11,240
38235069@N00,4957,28,1324932506,1324933406,3,9,900
38235069@N00,4957,18,1324935338,1324935377,3,9,39
38235069@N00,4957,23,1324935377,1324935859,4,9,482
38235069@N00,4957,18,1324935859,1324936309,6,9,450
38235069@N00,4957,30,1324940694,1324941774,4,9,1080
38235069@N00,4957,18,1324959521,1324959809,2,9,288
38235069@N00,4957,19,1324959809,1324959832,2,9,23
38235069@N00,4957,18,1324959832,1324959894,2,9,62
38235069@N00,4957,19,1324959894,1324960434,3,9,540
38235069@N00,4958,20,1325116481,1325117021,2,3,540
38235069@N00,4958,24,1325120718,1325121498,3,3,780
38235069@N00,4958,28,1325125505,1325126405,6,3,900
38235069@N00,4959,1,1329088812,1329088872,4,1,60
38235069@N00,4960,24,1334356443,1334357223,2,4,780
38235069@N00,4960,8,1334361338,1334361518,5,4,180
38235069@N00,4960,28,1334370326,1334371226,4,4,900
38235069@N00,4960,21,1334382180,1334382750,4,4,570
38235069@N00,4961,13,1339381113,1339381353,5,2,240
38235069@N00,4961,15,1339385461,1339385731,4,2,270
38235069@N00,4962,28,1346134640,1346134817,3,3,177
38235069@N00,4962,31,1346134817,1346135257,8,3,440
38235069@N00,4962,18,1346135257,1346135707,1,3,450
38235069@N00,4963,18,1349437801,1349438251,1,1,450
38235069@N00,4964,22,1349491788,1349492388,1,1,600
38235069@N00,4965,17,1358645529,1358645587,2,3,58
38235069@N00,4965,28,1358645587,1358646487,7,3,900
38235069@N00,4965,15,1358650984,1358651254,17,3,270
38235069@N00,4966,26,1359716521,1359717421,1,1,900
38235069@N00,4967,28,1359800861,1359801761,2,2,900
38235069@N00,4967,30,1359806111,1359807191,2,2,1080
38235069@N00,4968,30,1365812534,1365813614,9,3,1080
38235069@N00,4968,21,1365818275,1365818845,14,3,570
38235069@N00,4968,19,1365823847,1365824387,5,3,540
38235069@N00,4969,28,1371600907,1371601675,12,6,768
38235069@N00,4969,29,1371601675,1371601685,2,6,10
38235069@N00,4969,28,1371601685,1371602585,2,6,900
38235069@N00,4969,11,1371605436,1371605676,4,6,240
38235069@N00,4969,26,1371612698,1371613598,4,6,900
38235069@N00,4969,22,1371618460,1371619060,1,6,600
38235069@N00,4970,28,1374713953,1374714853,3,6,900
38235069@N00,4970,23,1374716082,1374716682,5,6,600
38235069@N00,4970,30,1374719448,1374720528,11,6,1080
38235069@N00,4970,26,1374727784,1374728491,2,6,707
38235069@N00,4970,4,1374728491,1374728592,5,6,101
38235069@N00,4970,28,1374747391,1374748291,13,6,900
38235069@N00,4971,24,1377396451,1377397231,5,2,780
38235069@N00,4971,15,1377397625,1377397895,1,2,270
38235069@N00,4972,14,1377560272,1377560512,2,1,240
38235069@N00,4973,13,1378194857,1378195097,10,2,240
38235069@N00,4973,18,1378199827,1378200277,4,2,450
38235069@N00,4974,27,1380925478,1380925559,4,13,81
38235069@N00,4974,16,1380925559,1380925829,6,13,270
38235069@N00,4974,27,1380926155,1380926210,3,13,55
38235069@N00,4974,16,1380926210,1380926480,15,13,270
38235069@N00,4974,13,1380932941,1380933181,2,13,240
38235069@N00,4974,30,1380933435,1380934515,4,13,1080
38235069@N00,4974,23,1380934920,1380934942,4,13,22
38235069@N00,4974,30,1380934942,1380934979,7,13,37
38235069@N00,4974,23,1380934979,1380935461,3,13,482
38235069@N00,4974,31,1380935461,1380935733,4,13,272
38235069@N00,4974,23,1380935733,1380935747,4,13,14
38235069@N00,4974,30,1380935747,1380936827,12,13,1080
38235069@N00,4974,22,1380941821,1380942421,5,13,600
38235069@N00,4975,1,1385186571,1385186631,13,3,60
38235069@N00,4975,28,1385193359,1385194259,14,3,900
38235069@N00,4975,26,1385195660,1385196560,5,3,900
38235069@N00,4976,29,1385861756,1385862656,4,2,900
38235069@N00,4976,20,1385864250,1385864790,7,2,540
38235069@N00,4977,23,1421993123,1421993723,4,9,600
38235069@N00,4977,31,1421998034,1421998066,2,9,32
38235069@N00,4977,22,1421998066,1421998666,2,9,600
38235069@N00,4977,26,1421999138,1421999156,2,9,18
38235069@N00,4977,25,1421999156,1421999996,4,9,840
38235069@N00,4977,23,1422001428,1422001989,3,9,561
38235069@N00,4977,15,1422001989,1422002259,3,9,270
38235069@N00,4977,11,1422006826,1422006860,2,9,34
38235069@N00,4977,4,1422006860,1422006961,12,9,101
38235069@N00,4978,23,1437085239,1437085839,2,16,600
38235069@N00,4978,22,1437085957,1437086362,2,16,405
38235069@N00,4978,26,1437086362,1437087262,2,16,900
38235069@N00,4978,28,1437090084,1437090984,18,16,900
38235069@N00,4978,1,1437095305,1437095365,8,16,60
38235069@N00,4978,28,1437096382,1437096399,2,16,17
38235069@N00,4978,1,1437096399,1437096459,5,16,60
38235069@N00,4978,28,1437096888,1437096895,2,16,7
38235069@N00,4978,1,1437096895,1437096955,2,16,60
38235069@N00,4978,28,1437097916,1437098816,4,16,900
38235069@N00,4978,26,1437100401,1437101301,7,16,900
38235069@N00,4978,18,1437101620,1437101631,3,16,11
38235069@N00,4978,28,1437101631,1437102531,3,16,900
38235069@N00,4978,22,1437103143,1437103743,2,16,600
38235069@N00,4978,28,1437122511,1437123411,7,16,900
38235069@N00,4978,22,1437139468,1437140068,1,16,600
38235069@N00,4979,22,1437173317,1437173917,2,1,600
38235069@N00,4980,1,1438662263,1438662323,3,3,60
38235069@N00,4980,11,1438672627,1438672867,12,3,240
38235069@N00,4980,20,1438673317,1438673857,9,3,540
38235069@N00,4981,26,1443785348,1443786248,1,1,900
38235069@N00,4982,22,1443840668,1443841268,2,2,600
38235069@N00,4982,26,1443846761,1443847661,2,2,900
38235069@N00,4983,28,1448061193,1448062093,2,3,900
38235069@N00,4983,13,1448074660,1448074900,5,3,240
38235069@N00,4983,1,1448096888,1448096948,2,3,60
38235069@N00,4984,28,1452125113,1452126013,2,11,900
38235069@N00,4984,16,1452132735,1452132739,2,11,4
38235069@N00,4984,27,1452132739,1452133509,2,11,770
38235069@N00,4984,16,1452133509,1452133779,2,11,270
38235069@N00,4984,15,1452135562,1452135832,10,11,270
38235069@N00,4984,17,1452138138,1452138438,9,11,300
38235069@N00,4984,1,1452138533,1452138593,4,11,60
38235069@N00,4984,13,1452141772,1452142012,7,11,240
38235069@N00,4984,22,1452144802,1452145115,7,11,313
38235069@N00,4984,14,1452145115,1452145355,19,11,240
38235069@N00,4984,28,1452147936,1452148836,10,11,900
38235069@N00,4985,26,1453587530,1453588430,4,15,900
38235069@N00,4985,24,1453588731,1453589511,5,15,780
38235069@N00,4985,15,1453589974,1453590244,3,15,270
38235069@N00,4985,13,1453590839,1453591079,4,15,240
38235069@N00,4985,31,1453592459,1453592759,3,15,300
38235069@N00,4985,30,1453592759,1453593839,14,15,1080
38235069@N00,4985,20,1453594027,1453594567,22,15,540
38235069@N00,4985,31,1453596046,1453596178,3,15,132
38235069@N00,4985,20,1453596178,1453596520,2,15,342
38235069@N00,4985,22,1453596520,1453596879,4,15,359
38235069@N00,4985,14,1453596879,1453597119,6,15,240
38235069@N00,4985,31,1453597554,1453598559,9,15,1005
38235069@N00,4985,18,1453598559,1453598905,7,15,346
38235069@N00,4985,23,1453598905,1453599362,4,15,457
38235069@N00,4985,28,1453599362,1453600262,13,15,900
38235069@N00,4986,30,1458338596,1458339676,10,7,1080
38235069@N00,4986,31,1458341237,1458341317,8,7,80
38235069@N00,4986,30,1458341317,1458342120,7,7,803
38235069@N00,4986,29,1458342120,1458342132,2,7,12
38235069@N00,4986,20,1458342132,1458342672,12,7,540
38235069@N00,4986,29,1458344302,1458345202,3,7,900
38235069@N00,4986,21,1458345387,1458345957,3,7,570
38235069@N00,4987,18,1460765619,1460766069,6,8,450
38235069@N00,4987,26,1460766726,1460767626,5,8,900
38235069@N00,4987,13,1460770586,1460770826,2,8,240
38235069@N00,4987,21,1460771698,1460772268,2,8,570
38235069@N00,4987,16,1460774298,1460774568,4,8,270
38235069@N00,4987,26,1460775406,1460776306,15,8,900
38235069@N00,4987,30,1460777214,1460778262,4,8,1048
38235069@N00,4987,31,1460778262,1460779762,2,8,1500
38235069@N00,4988,22,1464409460,1464410060,10,2,600
38235069@N00,4988,23,1464412008,1464412608,3,2,600
38235069@N00,4989,26,1466165336,1466166236,3,1,900
38235069@N00,4990,18,1466238342,1466238792,1,1,450
38235069@N00,4991,28,1470529515,1470529634,4,19,119
38235069@N00,4991,18,1470529634,1470529675,3,19,41
38235069@N00,4991,28,1470529675,1470529885,3,19,210
38235069@N00,4991,18,1470529885,1470530036,2,19,151
38235069@N00,4991,23,1470530036,1470530636,4,19,600
38235069@N00,4991,18,1470533081,1470533156,2,19,75
38235069@N00,4991,26,1470533156,1470533371,4,19,215
38235069@N00,4991,16,1470533371,1470533617,3,19,246
38235069@N00,4991,26,1470533617,1470533921,4,19,304
38235069@N00,4991,12,1470533921,1470534161,16,19,240
38235069@N00,4991,21,1470535027,1470535200,2,19,173
38235069@N00,4991,25,1470535200,1470535284,5,19,84
38235069@N00,4991,13,1470535284,1470535524,4,19,240
38235069@N00,4991,11,1470535976,1470536216,8,19,240
38235069@N00,4991,10,1470536248,1470536488,2,19,240
38235069@N00,4991,30,1470539237,1470539698,4,19,461
38235069@N00,4991,29,1470539698,1470540462,5,19,764
38235069@N00,4991,20,1470540462,1470541002,8,19,540
38235069@N00,4991,23,1470541851,1470542451,4,19,600
38258553@N03,4992,24,1289962034,1289962814,1,1,780
38259817@N06,4993,28,1245281015,1245281915,116,1,900
38376245@N04,4994,11,1243225773,1243226013,1,1,240
38376245@N04,4995,13,1253432351,1253432591,1,1,240
38376245@N04,4996,30,1256912035,1256913115,1,1,1080
38376245@N04,4997,17,1306060179,1306060479,1,1,300
38376245@N04,4998,21,1327454098,1327454668,3,2,570
38376245@N04,4998,15,1327467075,1327467345,1,2,270
38376245@N04,4999,28,1330604824,1330605724,1,1,900
38376245@N04,5000,26,1335854177,1335855077,1,1,900
38376245@N04,5001,26,1338866460,1338867360,1,1,900
38376245@N04,5002,26,1338955223,1338955225,2,2,2
38376245@N04,5002,28,1338955225,1338956125,1,2,900
38376245@N04,5003,20,1348636813,1348637353,2,1,540
38387241@N02,5004,28,1276218662,1276219562,6,18,900
38387241@N02,5004,26,1276219952,1276220202,6,18,250
38387241@N02,5004,5,1276220202,1276220214,2,18,12
38387241@N02,5004,8,1276220214,1276220394,3,18,180
38387241@N02,5004,12,1276220950,1276221138,4,18,188
38387241@N02,5004,24,1276221138,1276221230,3,18,92
38387241@N02,5004,15,1276221230,1276221444,3,18,214
38387241@N02,5004,24,1276221444,1276221716,3,18,272
38387241@N02,5004,12,1276221716,1276221892,2,18,176
38387241@N02,5004,21,1276221892,1276221948,2,18,56
38387241@N02,5004,25,1276221948,1276221954,2,18,6
38387241@N02,5004,21,1276221954,1276222302,2,18,348
38387241@N02,5004,13,1276222302,1276222542,5,18,240
38387241@N02,5004,30,1276223380,1276224460,14,18,1080
38387241@N02,5004,23,1276227464,1276227502,2,18,38
38387241@N02,5004,19,1276227502,1276228042,7,18,540
38387241@N02,5004,10,1276228898,1276229138,10,18,240
38387241@N02,5004,26,1276250054,1276250954,19,18,900
38393814@N07,5005,22,1310421398,1310421998,2,3,600
38393814@N07,5005,15,1310437171,1310437441,2,3,270
38393814@N07,5005,26,1310446522,1310447422,1,3,900
38399068@N03,5006,28,1323128960,1323129860,1,1,900
38501353@N00,5007,26,1255051394,1255052294,7,1,900
38501353@N00,5008,26,1301268551,1301269451,1,1,900
38501353@N00,5009,26,1305424224,1305425124,14,1,900
38501353@N00,5010,26,1318417323,1318418223,5,1,900
38501353@N00,5011,26,1342760162,1342761062,5,1,900
38501353@N00,5012,26,1353065208,1353066108,5,1,900
38501353@N00,5013,26,1353115804,1353116704,9,1,900
38501353@N00,5014,26,1387016217,1387017117,1,1,900
38501353@N00,5015,26,1433563754,1433564654,14,1,900
38507778@N00,5016,18,1437452076,1437452526,1,1,450
38637960@N00,5017,28,1460811955,1460812855,3,2,900
38637960@N00,5017,22,1460815013,1460815613,1,2,600
38662033@N08,5018,1,1318572950,1318573010,9,8,60
38662033@N08,5018,26,1318576155,1318577055,7,8,900
38662033@N08,5018,21,1318578323,1318578893,2,8,570
38662033@N08,5018,29,1318579651,1318579896,2,8,245
38662033@N08,5018,31,1318579896,1318581396,2,8,1500
38662033@N08,5018,16,1318590084,1318590354,2,8,270
38662033@N08,5018,10,1318591502,1318591742,3,8,240
38662033@N08,5018,28,1318591991,1318592891,4,8,900
38662033@N08,5019,28,1323504751,1323505136,4,5,385
38662033@N08,5019,26,1323505136,1323505618,2,5,482
38662033@N08,5019,25,1323505618,1323506458,2,5,840
38662033@N08,5019,16,1323519270,1323519540,2,5,270
38662033@N08,5019,28,1323519579,1323520479,4,5,900
38662490@N00,5020,28,1350611226,1350612126,1,1,900
38662490@N00,5021,28,1383906172,1383907072,2,2,900
38662490@N00,5021,29,1383908274,1383909174,1,2,900
38664640@N00,5022,26,1220491477,1220492377,1,1,900
38690067@N04,5023,1,1275350476,1275350536,4,55,60
38690067@N04,5023,28,1275350587,1275350739,4,55,152
38690067@N04,5023,18,1275350739,1275350764,2,55,25
38690067@N04,5023,23,1275350764,1275350864,3,55,100
38690067@N04,5023,18,1275350864,1275350884,2,55,20
38690067@N04,5023,23,1275350884,1275351484,2,55,600
38690067@N04,5023,29,1275352164,1275352418,5,55,254
38690067@N04,5023,20,1275352418,1275352958,2,55,540
38690067@N04,5023,30,1275353828,1275353902,2,55,74
38690067@N04,5023,31,1275353902,1275354053,2,55,151
38690067@N04,5023,11,1275354053,1275354293,2,55,240
38690067@N04,5023,12,1275354305,1275354545,2,55,240
38690067@N04,5023,27,1275354723,1275354831,2,55,108
38690067@N04,5023,17,1275354831,1275355131,2,55,300
38690067@N04,5023,27,1275355722,1275356622,3,55,900
38690067@N04,5023,17,1275357137,1275357437,5,55,300
38690067@N04,5023,27,1275359642,1275359751,6,55,109
38690067@N04,5023,16,1275359751,1275359882,4,55,131
38690067@N04,5023,26,1275359882,1275359944,6,55,62
38690067@N04,5023,23,1275359944,1275360544,9,55,600
38690067@N04,5023,18,1275361262,1275361300,4,55,38
38690067@N04,5023,19,1275361300,1275361317,3,55,17
38690067@N04,5023,29,1275361317,1275361368,7,55,51
38690067@N04,5023,19,1275361368,1275361404,4,55,36
38690067@N04,5023,18,1275361404,1275361452,5,55,48
38690067@N04,5023,19,1275361452,1275361589,6,55,137
38690067@N04,5023,18,1275361589,1275361967,9,55,378
38690067@N04,5023,23,1275361967,1275362062,3,55,95
38690067@N04,5023,26,1275362062,1275362176,5,55,114
38690067@N04,5023,16,1275362176,1275362446,5,55,270
38690067@N04,5023,24,1275363194,1275363974,9,55,780
38690067@N04,5023,12,1275366674,1275366914,3,55,240
38690067@N04,5023,26,1275366962,1275367508,7,55,546
38690067@N04,5023,30,1275367508,1275367894,6,55,386
38690067@N04,5023,29,1275367894,1275367986,3,55,92
38690067@N04,5023,31,1275367986,1275368179,2,55,193
38690067@N04,5023,22,1275368179,1275368455,2,55,276
38690067@N04,5023,31,1275368455,1275368598,6,55,143
38690067@N04,5023,30,1275368598,1275369678,6,55,1080
38690067@N04,5023,26,1275373961,1275374275,2,55,314
38690067@N04,5023,21,1275374275,1275374425,2,55,150
38690067@N04,5023,25,1275374425,1275375265,10,55,840
38690067@N04,5023,13,1275375739,1275375806,2,55,67
38690067@N04,5023,25,1275375806,1275376014,4,55,208
38690067@N04,5023,13,1275376014,1275376254,8,55,240
38690067@N04,5023,12,1275378566,1275378806,5,55,240
38690067@N04,5023,15,1275379649,1275379919,7,55,270
38690067@N04,5023,24,1275380666,1275380797,4,55,131
38690067@N04,5023,12,1275380797,1275380806,2,55,9
38690067@N04,5023,24,1275380806,1275381136,5,55,330
38690067@N04,5023,15,1275381136,1275381184,2,55,48
38690067@N04,5023,27,1275381184,1275382067,2,55,883
38690067@N04,5023,15,1275382067,1275382337,2,55,270
38690067@N04,5023,27,1275383683,1275383703,2,55,20
38690067@N04,5023,17,1275383703,1275384003,7,55,300
38730049@N08,5024,6,1188010565,1188010685,5,4,120
38730049@N08,5024,9,1188014184,1188014364,5,4,180
38730049@N08,5024,6,1188017518,1188017638,2,4,120
38730049@N08,5024,9,1188018186,1188018366,1,4,180
38730049@N08,5025,9,1188078397,1188078577,3,3,180
38730049@N08,5025,6,1188091781,1188091901,2,3,120
38730049@N08,5025,9,1188093910,1188094090,7,3,180
38730049@N08,5026,9,1188170641,1188170821,4,5,180
38730049@N08,5026,6,1188186260,1188186380,2,5,120
38730049@N08,5026,9,1188190573,1188190753,2,5,180
38730049@N08,5026,6,1188213531,1188213651,2,5,120
38730049@N08,5026,9,1188214928,1188215108,1,5,180
38730049@N08,5027,6,1188253278,1188253398,4,1,120
38730049@N08,5028,9,1197937242,1197937422,12,1,180
38730049@N08,5029,9,1198021552,1198021732,6,1,180
38730049@N08,5030,9,1198160759,1198160939,1,1,180
38730049@N08,5031,9,1219026005,1219026185,8,1,180
38730049@N08,5032,9,1219096980,1219097160,4,1,180
38730049@N08,5033,9,1219186182,1219186362,3,1,180
38730049@N08,5034,9,1219271238,1219271418,4,1,180
38730049@N08,5035,6,1230870793,1230870913,4,5,120
38730049@N08,5035,9,1230872222,1230872402,2,5,180
38730049@N08,5035,6,1230877874,1230877912,2,5,38
38730049@N08,5035,9,1230877912,1230878092,2,5,180
38730049@N08,5035,6,1230878148,1230878268,5,5,120
38730049@N08,5036,9,1230984116,1230984296,3,1,180
38730049@N08,5037,9,1231028569,1231028749,3,5,180
38730049@N08,5037,6,1231042905,1231043025,3,5,120
38730049@N08,5037,9,1231048770,1231048950,3,5,180
38730049@N08,5037,6,1231050530,1231050650,3,5,120
38730049@N08,5037,9,1231050906,1231051086,2,5,180
38730049@N08,5038,9,1231115588,1231115753,3,3,165
38730049@N08,5038,6,1231115753,1231115775,2,3,22
38730049@N08,5038,9,1231115775,1231115955,1,3,180
38730049@N08,5039,9,1253757519,1253757699,5,1,180
38730049@N08,5040,9,1253835382,1253835562,5,1,180
38730049@N08,5041,1,1253922265,1253922325,1,1,60
38730049@N08,5042,9,1254008499,1254008679,2,1,180
38730049@N08,5043,9,1254056181,1254056361,3,1,180
38730049@N08,5044,9,1254096417,1254096597,8,1,180
38730049@N08,5045,6,1260944750,1260944870,5,4,120
38730049@N08,5045,9,1260953594,1260953774,2,4,180
38730049@N08,5045,6,1260953776,1260953896,2,4,120
38730049@N08,5045,9,1260955383,1260955563,4,4,180
38730049@N08,5046,9,1261009935,1261010115,2,2,180
38730049@N08,5046,6,1261028350,1261028470,4,2,120
38730049@N08,5047,6,1261092706,1261092826,6,3,120
38730049@N08,5047,9,1261110033,1261110213,2,3,180
38730049@N08,5047,6,1261119939,1261120059,1,3,120
38730049@N08,5048,9,1281247621,1281247801,2,1,180
38730049@N08,5049,9,1281309437,1281309617,4,1,180
38730049@N08,5050,9,1281420477,1281420657,5,1,180
38730049@N08,5051,9,1281478365,1281478545,6,1,180
38730049@N08,5052,9,1281566497,1281566677,6,1,180
38730049@N08,5053,9,1286769745,1286769925,5,1,180
38730049@N08,5054,9,1286851476,1286851656,5,1,180
38730049@N08,5055,1,1286932922,1286932982,5,2,60
38730049@N08,5055,9,1286933293,1286933473,8,2,180
38730049@N08,5056,9,1287015004,1287015184,5,1,180
38730049@N08,5057,9,1287090117,1287090297,14,1,180
38730049@N08,5058,9,1292213312,1292213492,2,1,180
38730049@N08,5059,9,1292284514,1292284694,6,1,180
38730049@N08,5060,9,1292366755,1292366935,10,1,180
38730049@N08,5061,9,1292448822,1292449002,12,1,180
38730049@N08,5062,9,1302494869,1302495049,3,3,180
38730049@N08,5062,6,1302504012,1302504132,5,3,120
38730049@N08,5062,9,1302511628,1302511808,1,3,180
38730049@N08,5063,6,1302580552,1302580672,8,5,120
38730049@N08,5063,9,1302588846,1302589026,6,5,180
38730049@N08,5063,6,1302592346,1302592466,2,5,120
38730049@N08,5063,9,1302607930,1302608110,2,5,180
38730049@N08,5063,6,1302608526,1302608646,1,5,120
38730049@N08,5064,6,1302648426,1302648546,4,4,120
38730049@N08,5064,9,1302650128,1302650308,3,4,180
38730049@N08,5064,6,1302669324,1302669444,2,4,120
38730049@N08,5064,9,1302670357,1302670537,7,4,180
38730049@N08,5065,9,1302737118,1302737298,4,2,180
38730049@N08,5065,6,1302737341,1302737461,1,2,120
38730049@N08,5066,6,1307312300,1307312420,2,3,120
38730049@N08,5066,9,1307313840,1307314020,3,3,180
38730049@N08,5066,6,1307338347,1307338467,1,3,120
38730049@N08,5067,6,1307399669,1307399789,8,1,120
38730049@N08,5068,9,1319228409,1319228589,23,1,180
38730049@N08,5069,9,1319371962,1319372142,2,1,180
38730049@N08,5070,9,1319403729,1319403909,2,1,180
38730049@N08,5071,9,1323761512,1323761692,1,1,180
38730049@N08,5072,9,1323813016,1323813196,2,5,180
38730049@N08,5072,6,1323832627,1323832747,3,5,120
38730049@N08,5072,9,1323838983,1323839163,2,5,180
38730049@N08,5072,6,1323845611,1323845691,2,5,80
38730049@N08,5072,9,1323845691,1323845871,2,5,180
38730049@N08,5073,6,1323900535,1323900655,2,8,120
38730049@N08,5073,9,1323903125,1323903305,2,8,180
38730049@N08,5073,6,1323915335,1323915455,5,8,120
38730049@N08,5073,9,1323926123,1323926303,7,8,180
38730049@N08,5073,6,1323959477,1323959597,2,8,120
38730049@N08,5073,9,1323959604,1323959784,2,8,180
38730049@N08,5073,6,1323960334,1323960454,2,8,120
38730049@N08,5073,9,1323960613,1323960793,1,8,180
38730049@N08,5074,9,1338275098,1338275278,1,1,180
38730049@N08,5075,9,1338330670,1338330850,12,1,180
38730049@N08,5076,9,1338416105,1338416285,5,1,180
38730049@N08,5077,9,1345503590,1345503770,2,6,180
38730049@N08,5077,6,1345505437,1345505557,2,6,120
38730049@N08,5077,9,1345507464,1345507644,2,6,180
38730049@N08,5077,6,1345518657,1345518777,3,6,120
38730049@N08,5077,9,1345520691,1345520699,2,6,8
38730049@N08,5077,6,1345520699,1345520819,4,6,120
38730049@N08,5078,6,1345638462,1345638582,1,1,120
38730049@N08,5079,6,1345705448,1345705568,7,3,120
38730049@N08,5079,9,1345714150,1345714330,6,3,180
38730049@N08,5079,6,1345718622,1345718742,1,3,120
38730049@N08,5080,9,1349670012,1349670192,11,1,180
38730049@N08,5081,9,1349736433,1349736613,7,1,180
38730049@N08,5082,9,1349823886,1349824066,2,1,180
38730049@N08,5083,6,1355794296,1355794416,4,8,120
38730049@N08,5083,9,1355796288,1355796468,5,8,180
38730049@N08,5083,6,1355797086,1355797140,3,8,54
38730049@N08,5083,9,1355797140,1355797320,3,8,180
38730049@N08,5083,6,1355797366,1355797486,3,8,120
38730049@N08,5083,9,1355798244,1355798424,3,8,180
38730049@N08,5083,6,1355805499,1355805619,2,8,120
38730049@N08,5083,9,1355805625,1355805805,10,8,180
38730049@N08,5084,6,1355950646,1355950766,2,8,120
38730049@N08,5084,9,1355959069,1355959249,2,8,180
38730049@N08,5084,6,1355959832,1355959952,2,8,120
38730049@N08,5084,9,1355960107,1355960287,5,8,180
38730049@N08,5084,6,1355969818,1355969938,2,8,120
38730049@N08,5084,9,1355975327,1355975507,8,8,180
38730049@N08,5084,6,1355986069,1355986189,3,8,120
38730049@N08,5084,9,1355993283,1355993463,1,8,180
38730049@N08,5085,9,1356062677,1356062857,2,4,180
38730049@N08,5085,6,1356063920,1356064040,5,4,120
38730049@N08,5085,9,1356076392,1356076572,2,4,180
38730049@N08,5085,6,1356077189,1356077309,2,4,120
38730049@N08,5086,6,1365392252,1365392372,1,1,120
38730049@N08,5087,6,1365541857,1365541977,3,3,120
38730049@N08,5087,9,1365545132,1365545312,4,3,180
38730049@N08,5087,6,1365563553,1365563673,1,3,120
38730049@N08,5088,9,1369710315,1369710495,10,1,180
38730049@N08,5089,9,1369778762,1369778942,17,1,180
38730049@N08,5090,9,1369906419,1369906599,5,1,180
38730049@N08,5091,6,1376890185,1376890305,3,9,120
38730049@N08,5091,9,1376894611,1376894775,3,9,164
38730049@N08,5091,6,1376894775,1376894895,3,9,120
38730049@N08,5091,9,1376894987,1376895023,2,9,36
38730049@N08,5091,6,1376895023,1376895143,3,9,120
38730049@N08,5091,9,1376895555,1376895688,4,9,133
38730049@N08,5091,6,1376895688,1376895808,4,9,120
38730049@N08,5091,9,1376914541,1376914721,2,9,180
38730049@N08,5091,6,1376914853,1376914973,1,9,120
38730049@N08,5092,6,1376961871,1376961991,3,4,120
38730049@N08,5092,1,1376969899,1376969959,2,4,60
38730049@N08,5092,6,1376974217,1376974337,3,4,120
38730049@N08,5092,9,1376987156,1376987336,1,4,180
38730049@N08,5093,9,1377033611,1377033791,2,5,180
38730049@N08,5093,6,1377033903,1377034023,2,5,120
38730049@N08,5093,9,1377054087,1377054267,4,5,180
38730049@N08,5093,6,1377062067,1377062187,2,5,120
38730049@N08,5093,9,1377081112,1377081292,5,5,180
38730049@N08,5094,9,1377144199,1377144379,2,4,180
38730049@N08,5094,6,1377148371,1377148491,3,4,120
38730049@N08,5094,9,1377148627,1377148807,5,4,180
38730049@N08,5094,6,1377161653,1377161773,1,4,120
38730049@N08,5095,9,1379499849,1379500029,1,1,180
38730049@N08,5096,9,1379559205,1379559278,2,6,73
38730049@N08,5096,6,1379559278,1379559398,5,6,120
38730049@N08,5096,9,1379573196,1379573295,4,6,99
38730049@N08,5096,6,1379573295,1379573315,3,6,20
38730049@N08,5096,9,1379573315,1379573495,4,6,180
38730049@N08,5096,6,1379578941,1379579061,3,6,120
38730049@N08,5097,9,1379628812,1379628992,7,11,180
38730049@N08,5097,6,1379645918,1379646038,2,11,120
38730049@N08,5097,9,1379646269,1379646273,2,11,4
38730049@N08,5097,6,1379646273,1379646393,6,11,120
38730049@N08,5097,9,1379649773,1379649953,2,11,180
38730049@N08,5097,6,1379652493,1379652613,5,11,120
38730049@N08,5097,9,1379667505,1379667685,2,11,180
38730049@N08,5097,6,1379667883,1379668003,3,11,120
38730049@N08,5097,9,1379670279,1379670459,3,11,180
38730049@N08,5097,6,1379673362,1379673482,5,11,120
38730049@N08,5097,9,1379677716,1379677896,4,11,180
38730049@N08,5098,9,1385292854,1385292871,2,2,17
38730049@N08,5098,6,1385292871,1385292991,1,2,120
38730049@N08,5099,6,1385332186,1385332306,3,9,120
38730049@N08,5099,9,1385334644,1385334824,3,9,180
38730049@N08,5099,6,1385338225,1385338345,4,9,120
38730049@N08,5099,9,1385352591,1385352771,3,9,180
38730049@N08,5099,6,1385354213,1385354333,6,9,120
38730049@N08,5099,9,1385364227,1385364242,2,9,15
38730049@N08,5099,6,1385364242,1385364359,2,9,117
38730049@N08,5099,9,1385364359,1385364384,2,9,25
38730049@N08,5099,6,1385364384,1385364504,5,9,120
38730049@N08,5100,6,1385442273,1385442393,2,4,120
38730049@N08,5100,9,1385463677,1385463857,2,4,180
38730049@N08,5100,6,1385470368,1385470488,3,4,120
38730049@N08,5100,9,1385474527,1385474707,2,4,180
38730049@N08,5101,6,1385508918,1385508949,2,10,31
38730049@N08,5101,9,1385508949,1385509129,2,10,180
38730049@N08,5101,6,1385528019,1385528139,2,10,120
38730049@N08,5101,9,1385528667,1385528847,2,10,180
38730049@N08,5101,6,1385530331,1385530451,2,10,120
38730049@N08,5101,9,1385535987,1385536167,2,10,180
38730049@N08,5101,6,1385536217,1385536337,2,10,120
38730049@N08,5101,9,1385536849,1385536878,2,10,29
38730049@N08,5101,6,1385536878,1385536998,2,10,120
38730049@N08,5101,9,1385546668,1385546848,5,10,180
38730049@N08,5102,6,1396234181,1396234301,2,4,120
38730049@N08,5102,9,1396239867,1396240047,2,4,180
38730049@N08,5102,6,1396240134,1396240254,3,4,120
38730049@N08,5102,9,1396261991,1396262171,1,4,180
38730049@N08,5103,9,1396305966,1396305970,2,5,4
38730049@N08,5103,6,1396305970,1396306090,2,5,120
38730049@N08,5103,9,1396306275,1396306455,3,5,180
38730049@N08,5103,6,1396326025,1396326145,2,5,120
38730049@N08,5103,9,1396344244,1396344424,1,5,180
38730049@N08,5104,6,1396383968,1396384088,3,10,120
38730049@N08,5104,9,1396389830,1396390010,5,10,180
38730049@N08,5104,6,1396415587,1396415707,2,10,120
38730049@N08,5104,9,1396417277,1396417457,2,10,180
38730049@N08,5104,6,1396419656,1396419747,2,10,91
38730049@N08,5104,9,1396419747,1396419927,3,10,180
38730049@N08,5104,6,1396421378,1396421498,4,10,120
38730049@N08,5104,9,1396421711,1396421891,2,10,180
38730049@N08,5104,6,1396428327,1396428447,6,10,120
38730049@N08,5104,9,1396431106,1396431286,2,10,180
38730049@N08,5105,6,1396492844,1396492964,5,2,120
38730049@N08,5105,9,1396517982,1396518162,8,2,180
38730049@N08,5106,9,1401688549,1401688729,2,11,180
38730049@N08,5106,6,1401689436,1401689556,3,11,120
38730049@N08,5106,9,1401690072,1401690252,2,11,180
38730049@N08,5106,6,1401692570,1401692690,3,11,120
38730049@N08,5106,9,1401694602,1401694676,2,11,74
38730049@N08,5106,6,1401694676,1401694796,3,11,120
38730049@N08,5106,9,1401694829,1401694854,2,11,25
38730049@N08,5106,6,1401694854,1401694974,5,11,120
38730049@N08,5106,9,1401695436,1401695616,2,11,180
38730049@N08,5106,6,1401696203,1401696323,2,11,120
38730049@N08,5106,9,1401696984,1401697164,1,11,180
38730049@N08,5107,9,1401765519,1401765699,5,8,180
38730049@N08,5107,6,1401772274,1401772394,3,8,120
38730049@N08,5107,9,1401772809,1401772989,2,8,180
38730049@N08,5107,6,1401773113,1401773215,2,8,102
38730049@N08,5107,9,1401773215,1401773395,3,8,180
38730049@N08,5107,6,1401782960,1401783080,3,8,120
38730049@N08,5107,9,1401785447,1401785627,2,8,180
38730049@N08,5107,6,1401791715,1401791835,1,8,120
38730049@N08,5108,6,1401831689,1401831809,2,5,120
38730049@N08,5108,9,1401856478,1401856658,2,5,180
38730049@N08,5108,6,1401858966,1401858989,2,5,23
38730049@N08,5108,9,1401858989,1401859169,2,5,180
38730049@N08,5108,6,1401861220,1401861340,3,5,120
38730049@N08,5109,9,1401931664,1401931752,2,12,88
38730049@N08,5109,6,1401931752,1401931872,6,12,120
38730049@N08,5109,9,1401950999,1401951179,3,12,180
38730049@N08,5109,6,1401951265,1401951385,2,12,120
38730049@N08,5109,9,1401956045,1401956225,2,12,180
38730049@N08,5109,6,1401956436,1401956556,2,12,120
38730049@N08,5109,9,1401964087,1401964267,6,12,180
38730049@N08,5109,6,1401972361,1401972481,5,12,120
38730049@N08,5109,9,1401974206,1401974231,2,12,25
38730049@N08,5109,6,1401974231,1401974262,2,12,31
38730049@N08,5109,9,1401974262,1401974442,6,12,180
38730049@N08,5109,1,1401975698,1401975758,1,12,60
38730049@N08,5110,9,1408507238,1408507418,6,1,180
38730049@N08,5111,9,1408592864,1408593044,3,1,180
38730049@N08,5112,9,1408659430,1408659610,17,1,180
38730049@N08,5113,9,1414552834,1414553014,4,3,180
38730049@N08,5113,6,1414556367,1414556487,2,3,120
38730049@N08,5113,9,1414556625,1414556805,2,3,180
38730049@N08,5114,9,1414629032,1414629212,14,1,180
38730049@N08,5115,9,1414701148,1414701328,7,1,180
38730049@N08,5116,9,1418699417,1418699597,16,1,180
38730049@N08,5117,9,1418772661,1418772841,29,1,180
38730049@N08,5118,9,1418863095,1418863275,49,1,180
38730049@N08,5119,9,1427159959,1427160139,21,1,180
38730049@N08,5120,9,1427224900,1427225080,25,1,180
38730049@N08,5121,9,1427332274,1427332454,17,1,180
38730049@N08,5122,9,1432624931,1432625111,4,2,180
38730049@N08,5122,6,1432639708,1432639828,6,2,120
38730049@N08,5123,9,1432670279,1432670459,30,3,180
38730049@N08,5123,6,1432725560,1432725680,11,3,120
38730049@N08,5123,9,1432726644,1432726824,3,3,180
38730049@N08,5124,9,1432777697,1432777877,6,3,180
38730049@N08,5124,6,1432810978,1432811098,7,3,120
38730049@N08,5124,9,1432812638,1432812818,9,3,180
38730049@N08,5125,9,1433128252,1433128432,5,3,180
38730049@N08,5125,6,1433149445,1433149565,7,3,120
38730049@N08,5125,9,1433151004,1433151184,14,3,180
38730049@N08,5126,9,1433203898,1433204078,9,1,180
38730049@N08,5127,9,1439871980,1439872160,30,3,180
38730049@N08,5127,6,1439891940,1439892060,3,3,120
38730049@N08,5127,9,1439894107,1439894287,7,3,180
38730049@N08,5128,9,1439934686,1439934866,45,3,180
38730049@N08,5128,6,1439978282,1439978402,11,3,120
38730049@N08,5128,9,1439987144,1439987324,2,3,180
38730049@N08,5129,9,1440031959,1440032139,35,3,180
38730049@N08,5129,6,1440064361,1440064481,6,3,120
38730049@N08,5129,9,1440067295,1440067475,21,3,180
38730049@N08,5130,9,1442983115,1442983295,22,2,180
38730049@N08,5130,6,1443008781,1443008901,3,2,120
38730049@N08,5131,9,1443065100,1443065280,29,3,180
38730049@N08,5131,6,1443088791,1443088911,3,3,120
38730049@N08,5131,9,1443090819,1443090999,20,3,180
38730049@N08,5132,9,1443132711,1443132891,24,1,180
38730049@N08,5133,9,1443229164,1443229344,6,1,180
38730049@N08,5134,9,1448178008,1448178188,2,1,180
38730049@N08,5135,9,1448227588,1448227768,56,3,180
38730049@N08,5135,6,1448281114,1448281234,4,3,120
38730049@N08,5135,9,1448282325,1448282505,2,3,180
38730049@N08,5136,9,1448339435,1448339615,22,3,180
38730049@N08,5136,6,1448348400,1448348520,5,3,120
38730049@N08,5136,9,1448350735,1448350915,2,3,180
38730049@N08,5137,9,1448399595,1448399775,22,1,180
38730049@N08,5138,6,1459749178,1459749298,54,1,120
38730049@N08,5139,6,1459821755,1459821875,80,1,120
38730049@N08,5140,6,1459890667,1459890787,68,1,120
38730049@N08,5141,6,1459990415,1459990535,7,1,120
38730049@N08,5142,1,1468040021,1468040081,4,1,60
38730049@N08,5143,6,1471754278,1471754398,88,1,120
38730049@N08,5144,6,1471821296,1471821416,135,1,120
38731688@N06,5145,26,1364683531,1364684431,2,1,900
38731688@N06,5146,1,1384071796,1384071856,1,1,60
38739245@N06,5147,10,1368490432,1368490672,1,1,240
38739245@N06,5148,10,1368523511,1368523751,27,1,240
38765937@N03,5149,25,1380096816,1380097656,1,1,840
38765937@N03,5150,18,1380781032,1380781482,1,1,450
38794272@N04,5151,29,1313931260,1313932160,51,1,900
38794272@N04,5152,29,1313975858,1313976758,49,1,900
38794272@N04,5153,28,1314106741,1314107641,221,1,900
38797526@N05,5154,10,1249387345,1249387585,1,1,240
38825115@N04,5155,21,1329453185,1329453755,1,1,570
38879474@N04,5156,21,1277919362,1277919932,2,2,570
38879474@N04,5156,20,1277930176,1277930716,1,2,540
38894291@N00,5157,24,1412736114,1412736894,1,1,780
38913499@N08,5158,1,1442974527,1442974587,2,5,60
38913499@N08,5158,13,1442977540,1442977780,2,5,240
38913499@N08,5158,31,1442984251,1442985751,2,5,1500
38913499@N08,5158,16,1442999490,1442999760,2,5,270
38913499@N08,5158,24,1443000775,1443001555,1,5,780
38937312@N00,5159,29,1447585710,1447586610,1,1,900
38949505@N05,5160,1,1356827508,1356827568,2,2,60
38949505@N05,5160,28,1356829747,1356830647,1,2,900
38949505@N05,5161,28,1457128594,1457129494,1,1,900
38953180@N04,5162,10,1260997951,1260998191,94,3,240
38953180@N04,5162,16,1261032565,1261032835,3,3,270
38953180@N04,5162,10,1261034126,1261034366,53,3,240
38964012@N06,5163,26,1404357563,1404358463,6,9,900
38964012@N06,5163,27,1404359101,1404360001,3,9,900
38964012@N06,5163,17,1404363487,1404363787,2,9,300
38964012@N06,5163,15,1404365477,1404365747,3,9,270
38964012@N06,5163,21,1404369173,1404369743,2,9,570
38964012@N06,5163,25,1404370303,1404371143,4,9,840
38964012@N06,5163,13,1404373470,1404373710,3,9,240
38964012@N06,5163,7,1404376020,1404376200,2,9,180
38964012@N06,5163,29,1404381368,1404382268,1,9,900
39007581@N07,5164,19,1418451565,1418452105,1,1,540
39024895@N00,5165,30,1219446140,1219447220,16,3,1080
39024895@N00,5165,26,1219451050,1219451950,4,3,900
39024895@N00,5165,30,1219457118,1219458198,2,3,1080
39024895@N00,5166,1,1219540709,1219540769,3,2,60
39024895@N00,5166,28,1219545907,1219546807,8,2,900
39024895@N00,5167,10,1241819213,1241819453,84,1,240
39024895@N00,5168,10,1241908759,1241908999,46,1,240
39024895@N00,5169,10,1242461887,1242462127,2,1,240
39024895@N00,5170,10,1254717433,1254717673,4,1,240
39024895@N00,5171,10,1254783770,1254784010,4,1,240
39024895@N00,5172,10,1267221423,1267221663,376,1,240
39024895@N00,5173,10,1267312043,1267312283,18,1,240
39024895@N00,5174,6,1278628175,1278628295,20,2,120
39024895@N00,5174,29,1278638973,1278639873,10,2,900
39024895@N00,5175,29,1278721041,1278721941,5,6,900
39024895@N00,5175,28,1278725162,1278726062,9,6,900
39024895@N00,5175,29,1278752953,1278753387,7,6,434
39024895@N00,5175,13,1278753387,1278753627,6,6,240
39024895@N00,5175,27,1278754208,1278754504,6,6,296
39024895@N00,5175,28,1278754504,1278755404,3,6,900
39024895@N00,5176,31,1316307995,1316308060,5,2,65
39024895@N00,5176,29,1316308060,1316308960,10,2,900
39024895@N00,5177,31,1326673848,1326675348,35,2,1500
39024895@N00,5177,10,1326676251,1326676491,6,2,240
39038543@N08,5178,25,1360477245,1360478085,2,1,840
39038543@N08,5179,25,1412055124,1412055964,1,1,840
39038543@N08,5180,20,1431490812,1431491352,1,1,540
39066378@N08,5181,1,1406604427,1406604487,3,1,60
39066378@N08,5182,26,1428290152,1428291052,5,3,900
39066378@N08,5182,25,1428296209,1428297049,2,3,840
39066378@N08,5182,1,1428309698,1428309758,1,3,60
39073297@N04,5183,26,1266051997,1266052897,1,1,900
39095070@N02,5184,29,1280550369,1280551269,1,1,900
39095070@N02,5185,29,1281139714,1281140614,1,1,900
39095070@N02,5186,29,1281178354,1281179254,7,1,900
39095070@N02,5187,29,1281483546,1281484446,1,1,900
39101963@N00,5188,1,1228890672,1228890732,2,5,60
39101963@N00,5188,27,1228891070,1228891085,2,5,15
39101963@N00,5188,12,1228891085,1228891325,2,5,240
39101963@N00,5188,14,1228891862,1228891982,2,5,120
39101963@N00,5188,13,1228891982,1228892222,1,5,240
39101963@N00,5189,28,1229137661,1229137670,2,7,9
39101963@N00,5189,26,1229137670,1229137690,3,7,20
39101963@N00,5189,29,1229137690,1229137699,2,7,9
39101963@N00,5189,31,1229137699,1229137710,2,7,11
39101963@N00,5189,29,1229137710,1229137719,2,7,9
39101963@N00,5189,14,1229137719,1229137729,2,7,10
39101963@N00,5189,23,1229137729,1229138329,1,7,600
39146060@N00,5190,17,1192276302,1192276307,3,10,5
39146060@N00,5190,16,1192276307,1192276309,2,10,2
39146060@N00,5190,15,1192276309,1192276319,4,10,10
39146060@N00,5190,6,1192276319,1192276439,2,10,120
39146060@N00,5190,29,1192276701,1192276705,3,10,4
39146060@N00,5190,30,1192276705,1192276720,5,10,15
39146060@N00,5190,26,1192276720,1192277202,2,10,482
39146060@N00,5190,31,1192277202,1192277209,2,10,7
39146060@N00,5190,29,1192277209,1192277213,2,10,4
39146060@N00,5190,26,1192277213,1192278113,2,10,900
39146060@N00,5191,30,1192924174,1192925254,2,1,1080
39146060@N00,5192,20,1201942408,1201942948,2,6,540
39146060@N00,5192,15,1201944338,1201944608,2,6,270
39146060@N00,5192,24,1201944786,1201945566,5,6,780
39146060@N00,5192,12,1201945938,1201946002,2,6,64
39146060@N00,5192,24,1201946002,1201946450,3,6,448
39146060@N00,5192,17,1201946450,1201946750,4,6,300
39146060@N00,5193,28,1205558044,1205558944,10,1,900
39146060@N00,5194,29,1209734289,1209735113,2,2,824
39146060@N00,5194,24,1209735113,1209735893,3,2,780
39146060@N00,5195,26,1209770318,1209771218,8,5,900
39146060@N00,5195,30,1209787068,1209787268,2,5,200
39146060@N00,5195,26,1209787268,1209787879,3,5,611
39146060@N00,5195,30,1209787879,1209788959,14,5,1080
39146060@N00,5195,17,1209790724,1209791024,3,5,300
39146060@N00,5196,11,1209873126,1209873366,2,8,240
39146060@N00,5196,14,1209875136,1209875376,2,8,240
39146060@N00,5196,23,1209877096,1209877696,4,8,600
39146060@N00,5196,13,1209879890,1209880130,4,8,240
39146060@N00,5196,29,1209882502,1209883402,2,8,900
39146060@N00,5196,19,1209886122,1209886662,7,8,540
39146060@N00,5196,18,1209886876,1209887326,3,8,450
39146060@N00,5196,29,1209888060,1209888960,2,8,900
39146060@N00,5197,24,1211509874,1211510654,17,1,780
39146060@N00,5198,29,1216129631,1216129761,9,2,130
39146060@N00,5198,24,1216129761,1216130541,1,2,780
39146060@N00,5199,15,1216296970,1216297016,4,4,46
39146060@N00,5199,29,1216297016,1216297030,3,4,14
39146060@N00,5199,20,1216297030,1216297060,6,4,30
39146060@N00,5199,15,1216297060,1216297330,5,4,270
39146060@N00,5200,1,1224186669,1224186729,11,4,60
39146060@N00,5200,28,1224189135,1224189610,2,4,475
39146060@N00,5200,23,1224189610,1224190210,9,4,600
39146060@N00,5200,1,1224191516,1224191576,2,4,60
39146060@N00,5201,25,1227040388,1227041228,17,1,840
39146060@N00,5202,25,1233905690,1233906530,13,1,840
39146060@N00,5203,1,1234475948,1234476008,2,3,60
39146060@N00,5203,26,1234476130,1234477030,2,3,900
39146060@N00,5203,25,1234478592,1234479432,25,3,840
39146060@N00,5204,25,1235084920,1235085760,6,4,840
39146060@N00,5204,16,1235086211,1235086481,2,4,270
39146060@N00,5204,11,1235087928,1235088168,2,4,240
39146060@N00,5204,26,1235089400,1235090300,2,4,900
39146060@N00,5205,20,1237503655,1237504195,3,1,540
39146060@N00,5206,1,1238663017,1238663077,1,1,60
39146060@N00,5207,22,1238918381,1238918388,3,6,7
39146060@N00,5207,29,1238918388,1238918394,4,6,6
39146060@N00,5207,19,1238918394,1238918406,7,6,12
39146060@N00,5207,29,1238918406,1238918412,3,6,6
39146060@N00,5207,1,1238918412,1238918413,2,6,1
39146060@N00,5207,19,1238918413,1238918953,2,6,540
39146060@N00,5208,26,1241221335,1241222235,2,4,900
39146060@N00,5208,3,1241223140,1241223230,9,4,90
39146060@N00,5208,23,1241227697,1241228297,3,4,600
39146060@N00,5208,30,1241230399,1241231479,17,4,1080
39146060@N00,5209,1,1243574500,1243574560,1,1,60
39146060@N00,5210,24,1244937086,1244937866,9,2,780
39146060@N00,5210,28,1244953747,1244954647,1,2,900
39146060@N00,5211,28,1248250256,1248251156,2,1,900
39146060@N00,5212,26,1248609874,1248610774,1,1,900
39146060@N00,5213,14,1249200501,1249200741,1,1,240
39146060@N00,5214,24,1251538234,1251539014,23,1,780
39146060@N00,5215,24,1253361897,1253362677,5,1,780
39146060@N00,5216,17,1253833871,1253834171,3,2,300
39146060@N00,5216,29,1253837951,1253838851,1,2,900
39146060@N00,5217,1,1254436106,1254436166,7,1,60
39146060@N00,5218,22,1255511332,1255511932,4,5,600
39146060@N00,5218,14,1255513452,1255513692,2,5,240
39146060@N00,5218,26,1255514402,1255514832,2,5,430
39146060@N00,5218,30,1255514832,1255515230,2,5,398
39146060@N00,5218,26,1255515230,1255516130,1,5,900
39146060@N00,5219,1,1256292463,1256292465,2,3,2
39146060@N00,5219,17,1256292465,1256292470,2,3,5
39146060@N00,5219,20,1256292470,1256293010,1,3,540
39146060@N00,5220,1,1258185621,1258185627,3,2,6
39146060@N00,5220,28,1258185627,1258186527,4,2,900
39146060@N00,5221,13,1259825129,1259825145,7,5,16
39146060@N00,5221,25,1259825145,1259825148,2,5,3
39146060@N00,5221,1,1259825148,1259825149,2,5,1
39146060@N00,5221,28,1259825149,1259825168,8,5,19
39146060@N00,5221,1,1259825168,1259825228,1,5,60
39146060@N00,5222,1,1261127308,1261127309,2,3,1
39146060@N00,5222,28,1261127309,1261127318,6,3,9
39146060@N00,5222,1,1261127318,1261127378,8,3,60
39146060@N00,5223,31,1266546512,1266546521,3,3,9
39146060@N00,5223,23,1266546521,1266546527,2,3,6
39146060@N00,5223,30,1266546527,1266547607,1,3,1080
39146060@N00,5224,17,1268525516,1268525816,3,1,300
39146060@N00,5225,24,1273292233,1273293013,1,1,780
39146060@N00,5226,26,1276402665,1276403565,3,4,900
39146060@N00,5226,27,1276414321,1276415221,2,4,900
39146060@N00,5226,9,1276416072,1276416252,2,4,180
39146060@N00,5226,25,1276416610,1276417450,2,4,840
39146060@N00,5227,29,1276752993,1276753893,3,2,900
39146060@N00,5227,18,1276754243,1276754693,2,2,450
39146060@N00,5228,15,1296553701,1296553755,2,8,54
39146060@N00,5228,27,1296553755,1296553807,2,8,52
39146060@N00,5228,17,1296553807,1296553845,2,8,38
39146060@N00,5228,15,1296553845,1296553906,2,8,61
39146060@N00,5228,31,1296553906,1296553949,2,8,43
39146060@N00,5228,29,1296553949,1296553988,2,8,39
39146060@N00,5228,31,1296553988,1296554039,2,8,51
39146060@N00,5228,30,1296554039,1296555119,1,8,1080
39149225@N08,5229,11,1445722136,1445722376,2,6,240
39149225@N08,5229,20,1445722518,1445723058,2,6,540
39149225@N08,5229,26,1445727920,1445728820,2,6,900
39149225@N08,5229,21,1445733219,1445733789,2,6,570
39149225@N08,5229,19,1445737685,1445738225,2,6,540
39149225@N08,5229,1,1445738947,1445739007,1,6,60
39149225@N08,5230,20,1457945399,1457945939,1,1,540
39175339@N07,5231,28,1251788168,1251789068,1,1,900
39205971@N03,5232,1,1286576895,1286576955,1,1,60
39301531@N03,5233,29,1418956458,1418957358,1,1,900
39311404@N00,5234,1,1216539026,1216539086,2,7,60
39311404@N00,5234,30,1216541028,1216542108,2,7,1080
39311404@N00,5234,29,1216545343,1216546243,2,7,900
39311404@N00,5234,31,1216548460,1216549960,3,7,1500
39311404@N00,5234,26,1216559064,1216559964,4,7,900
39311404@N00,5234,5,1216560865,1216560985,2,7,120
39311404@N00,5234,13,1216567678,1216567918,1,7,240
39337740@N00,5235,29,1341316721,1341317621,2,2,900
39337740@N00,5235,21,1341317924,1341318494,1,2,570
39345936@N00,5236,26,1223610863,1223611763,9,1,900
39358979@N03,5237,28,1333172832,1333173732,1,1,900
39358979@N03,5238,21,1335163239,1335163809,1,1,570
39358979@N03,5239,16,1344680707,1344680977,1,1,270
39358979@N03,5240,28,1358623786,1358624686,1,1,900
39360988@N05,5241,28,1318510207,1318511107,1,1,900
39372984@N02,5242,30,1354309901,1354310981,1,1,1080
39375531@N08,5243,22,1339496201,1339496801,1,1,600
39403274@N00,5244,26,1245194016,1245194916,2,5,900
39403274@N00,5244,16,1245206478,1245206669,2,5,191
39403274@N00,5244,26,1245206669,1245207569,2,5,900
39403274@N00,5244,28,1245212114,1245212211,2,5,97
39403274@N00,5244,1,1245212211,1245212271,1,5,60
39437618@N04,5245,28,1261295071,1261295971,2,1,900
39438001@N00,5246,1,1223085740,1223085800,2,22,60
39438001@N00,5246,26,1223086029,1223086314,4,22,285
39438001@N00,5246,13,1223086314,1223086554,2,22,240
39438001@N00,5246,31,1223086786,1223087119,2,22,333
39438001@N00,5246,11,1223087119,1223087359,2,22,240
39438001@N00,5246,13,1223087374,1223087614,11,22,240
39438001@N00,5246,14,1223093095,1223093335,4,22,240
39438001@N00,5246,20,1223093549,1223093876,3,22,327
39438001@N00,5246,19,1223093876,1223094235,6,22,359
39438001@N00,5246,29,1223094235,1223095135,2,22,900
39438001@N00,5246,20,1223095312,1223095852,6,22,540
39438001@N00,5246,22,1223096438,1223097038,5,22,600
39438001@N00,5246,30,1223101159,1223102239,3,22,1080
39438001@N00,5246,18,1223103028,1223103478,3,22,450
39438001@N00,5246,27,1223104561,1223105461,2,22,900
39438001@N00,5246,15,1223106003,1223106273,4,22,270
39438001@N00,5246,8,1223109548,1223109728,4,22,180
39438001@N00,5246,3,1223111429,1223111519,2,22,90
39438001@N00,5246,8,1223123333,1223123513,2,22,180
39438001@N00,5246,20,1223124220,1223124363,2,22,143
39438001@N00,5246,12,1223124363,1223124603,2,22,240
39438001@N00,5246,28,1223127027,1223127927,1,22,900
39438001@N00,5247,1,1223168278,1223168338,2,7,60
39438001@N00,5247,17,1223170902,1223171202,2,7,300
39438001@N00,5247,8,1223171802,1223171982,2,7,180
39438001@N00,5247,16,1223172363,1223172633,2,7,270
39438001@N00,5247,19,1223175059,1223175446,2,7,387
39438001@N00,5247,18,1223175446,1223175896,2,7,450
39438001@N00,5247,29,1223177071,1223177971,2,7,900
39438001@N00,5248,26,1223253865,1223254765,2,6,900
39438001@N00,5248,7,1223256294,1223256474,4,6,180
39438001@N00,5248,5,1223257341,1223257461,2,6,120
39438001@N00,5248,3,1223260422,1223260512,5,6,90
39438001@N00,5248,29,1223261795,1223262695,2,6,900
39438001@N00,5248,28,1223263686,1223264586,2,6,900
39449616@N06,5249,31,1221624034,1221625534,1,1,1500
39457011@N00,5250,1,1254357609,1254357669,3,9,60
39457011@N00,5250,24,1254362106,1254362137,2,9,31
39457011@N00,5250,16,1254362137,1254362407,2,9,270
39457011@N00,5250,12,1254363310,1254363550,2,9,240
39457011@N00,5250,21,1254363772,1254364342,3,9,570
39457011@N00,5250,30,1254368134,1254368159,2,9,25
39457011@N00,5250,31,1254368159,1254369659,2,9,1500
39457011@N00,5250,29,1254370528,1254370654,2,9,126
39457011@N00,5250,31,1254370654,1254372154,2,9,1500
39471939@N00,5251,11,1238365260,1238365500,3,13,240
39471939@N00,5251,7,1238366347,1238366376,2,13,29
39471939@N00,5251,4,1238366376,1238366378,2,13,2
39471939@N00,5251,25,1238366378,1238367218,3,13,840
39471939@N00,5251,21,1238367910,1238368480,2,13,570
39471939@N00,5251,3,1238368827,1238368917,2,13,90
39471939@N00,5251,7,1238369680,1238369691,3,13,11
39471939@N00,5251,6,1238369691,1238369811,2,13,120
39471939@N00,5251,4,1238370198,1238370299,2,13,101
39471939@N00,5251,7,1238370695,1238370875,6,13,180
39471939@N00,5251,6,1238371075,1238371195,6,13,120
39471939@N00,5251,28,1238371876,1238372172,3,13,296
39471939@N00,5251,1,1238372172,1238372232,1,13,60
39471939@N00,5252,1,1238439190,1238439250,4,4,60
39471939@N00,5252,16,1238439714,1238439831,3,4,117
39471939@N00,5252,26,1238439831,1238440157,2,4,326
39471939@N00,5252,13,1238440157,1238440397,1,4,240
39523405@N00,5253,26,1303959787,1303960687,1,1,900
39523405@N00,5254,26,1303989504,1303990404,1,1,900
39523405@N00,5255,26,1304152409,1304153309,1,1,900
39527581@N07,5256,1,1190169932,1190169992,1,1,60
39527581@N07,5257,31,1262264400,1262265900,1,1,1500
39527581@N07,5258,26,1323330179,1323331079,1,1,900
39527581@N07,5259,26,1335179497,1335180397,1,1,900
39527581@N07,5260,18,1367212606,1367213056,1,1,450
39527581@N07,5261,31,1382265780,1382267280,1,1,1500
39527581@N07,5262,18,1382308201,1382308651,1,1,450
39527581@N07,5263,1,1385962899,1385962959,2,2,60
39527581@N07,5263,18,1385963138,1385963588,1,2,450
39527581@N07,5264,7,1444806461,1444806641,1,1,180
39527581@N07,5265,26,1444881308,1444882208,1,1,900
39539890@N02,5266,9,1286778505,1286778685,2,5,180
39539890@N02,5266,11,1286779507,1286779512,2,5,5
39539890@N02,5266,21,1286779512,1286779981,2,5,469
39539890@N02,5266,31,1286779981,1286780750,2,5,769
39539890@N02,5266,26,1286780750,1286781650,1,5,900
39561617@N03,5267,14,1307075330,1307075570,2,2,240
39561617@N03,5267,4,1307077543,1307077644,1,2,101
39561617@N03,5268,1,1369536031,1369536091,1,1,60
39713096@N04,5269,1,1219091861,1219091921,1,1,60
39713096@N04,5270,26,1377314004,1377314904,8,1,900
39713096@N04,5271,26,1377384459,1377385359,2,1,900
39713096@N04,5272,26,1377420732,1377421632,6,1,900
39713096@N04,5273,26,1377554025,1377554925,7,1,900
39713096@N04,5274,26,1377643723,1377644623,4,1,900
39713096@N04,5275,26,1377768001,1377768901,4,1,900
39726265@N00,5276,28,1239956539,1239957439,5,5,900
39726265@N00,5276,29,1239959047,1239959947,16,5,900
39726265@N00,5276,28,1239967588,1239968488,8,5,900
39726265@N00,5276,29,1239970729,1239971629,11,5,900
39726265@N00,5276,28,1239974899,1239975799,5,5,900
39726265@N00,5277,18,1240102099,1240102454,2,6,355
39726265@N00,5277,26,1240102454,1240102703,8,6,249
39726265@N00,5277,21,1240102703,1240102859,2,6,156
39726265@N00,5277,9,1240102859,1240103039,4,6,180
39726265@N00,5277,29,1240103484,1240104384,10,6,900
39726265@N00,5277,13,1240107112,1240107352,5,6,240
39758738@N03,5278,28,1290737065,1290737965,1,1,900
39758738@N03,5279,16,1388450468,1388450738,1,1,270
39758738@N03,5280,1,1388510584,1388510644,1,1,60
39763571@N07,5281,26,1350296840,1350297740,1,1,900
39763571@N07,5282,28,1355705707,1355706607,1,1,900
39766433@N00,5283,24,1196579545,1196580325,1,1,780
39766433@N00,5284,17,1197011969,1197012269,2,2,300
39766433@N00,5284,3,1197016288,1197016378,1,2,90
39796133@N00,5285,29,1306070379,1306071279,1,1,900
39796133@N00,5286,16,1306113513,1306113783,1,1,270
39796133@N00,5287,13,1306198002,1306198242,2,2,240
39796133@N00,5287,3,1306204009,1306204099,1,2,90
39827687@N05,5288,3,1323921600,1323921690,4,1,90
39827687@N05,5289,3,1328234103,1328234193,7,1,90
39827687@N05,5290,3,1328320281,1328320371,12,1,90
39827687@N05,5291,3,1350029976,1350030066,3,1,90
39827687@N05,5292,3,1350162442,1350162532,1,1,90
39857329@N04,5293,8,1276777423,1276777603,1,1,180
39892743@N04,5294,28,1321011688,1321012588,1,1,900
39892743@N04,5295,28,1325046546,1325047446,1,1,900
39892743@N04,5296,28,1328344516,1328345416,1,1,900
39892743@N04,5297,18,1331278148,1331278598,1,1,450
39894601@N00,5298,1,1252880137,1252880197,3,5,60
39894601@N00,5298,24,1252883757,1252884537,2,5,780
39894601@N00,5298,12,1252886749,1252886989,3,5,240
39894601@N00,5298,6,1252888140,1252888260,23,5,120
39894601@N00,5298,25,1252899249,1252900089,1,5,840
39932512@N00,5299,26,1304215144,1304216044,5,1,900
39953677@N06,5300,28,1343467293,1343468193,3,3,900
39953677@N06,5300,15,1343480286,1343480556,2,3,270
39953677@N06,5300,28,1343502149,1343503049,1,3,900
39953677@N06,5301,28,1344006808,1344007708,1,1,900
39953677@N06,5302,1,1369570113,1369570173,1,1,60
39953677@N06,5303,28,1370397282,1370398182,2,3,900
39953677@N06,5303,1,1370403091,1370403151,2,3,60
39953677@N06,5303,4,1370424350,1370424451,1,3,101
39953677@N06,5304,17,1371953220,1371953520,2,3,300
39953677@N06,5304,23,1371957977,1371958577,3,3,600
39953677@N06,5304,26,1371960420,1371961320,1,3,900
39953677@N06,5305,1,1375588585,1375588645,2,2,60
39953677@N06,5305,13,1375592299,1375592539,1,2,240
39953677@N06,5306,1,1382229979,1382230039,2,2,60
39953677@N06,5306,20,1382231403,1382231943,1,2,540
39953677@N06,5307,5,1382267460,1382267569,2,2,109
39953677@N06,5307,1,1382267569,1382267629,1,2,60
39953677@N06,5308,1,1383019488,1383019548,2,4,60
39953677@N06,5308,29,1383028919,1383029819,2,4,900
39953677@N06,5308,26,1383053324,1383053586,2,4,262
39953677@N06,5308,28,1383053586,1383054486,1,4,900
39953677@N06,5309,26,1383377345,1383378245,3,4,900
39953677@N06,5309,1,1383386323,1383386383,2,4,60
39953677@N06,5309,17,1383387221,1383387521,2,4,300
39953677@N06,5309,3,1383390244,1383390334,1,4,90
39953677@N06,5310,1,1384575559,1384575619,1,1,60
39953677@N06,5311,1,1384617131,1384617191,1,1,60
39953677@N06,5312,1,1385250931,1385250991,3,7,60
39953677@N06,5312,18,1385256439,1385256889,2,7,450
39953677@N06,5312,1,1385258580,1385258640,2,7,60
39953677@N06,5312,17,1385263002,1385263302,2,7,300
39953677@N06,5312,1,1385269152,1385269212,3,7,60
39953677@N06,5312,11,1385294488,1385294728,2,7,240
39953677@N06,5312,1,1385296670,1385296730,1,7,60
39953677@N06,5313,1,1391848798,1391848858,2,1,60
39953677@N06,5314,30,1394326751,1394327797,2,2,1046
39953677@N06,5314,1,1394327797,1394327857,4,2,60
39976152@N00,5315,29,1329803063,1329803963,1,1,900
39976152@N00,5316,20,1330113892,1330114432,1,1,540
39980698@N02,5317,13,1386328435,1386328675,1,1,240
39980698@N02,5318,26,1386421578,1386422478,1,1,900
40033932@N00,5319,26,1468367275,1468368175,1,1,900
40086524@N03,5320,28,1470276922,1470277100,2,15,178
40086524@N03,5320,26,1470277100,1470278000,4,15,900
40086524@N03,5320,24,1470279023,1470279803,6,15,780
40086524@N03,5320,13,1470282972,1470283212,7,15,240
40086524@N03,5320,25,1470287921,1470288761,6,15,840
40086524@N03,5320,15,1470291808,1470292078,6,15,270
40086524@N03,5320,23,1470297358,1470297426,3,15,68
40086524@N03,5320,18,1470297426,1470297717,2,15,291
40086524@N03,5320,29,1470297717,1470297980,2,15,263
40086524@N03,5320,19,1470297980,1470298520,5,15,540
40086524@N03,5320,30,1470300380,1470301460,2,15,1080
40086524@N03,5320,19,1470305767,1470306307,2,15,540
40086524@N03,5320,23,1470307286,1470307764,2,15,478
40086524@N03,5320,26,1470307764,1470308394,2,15,630
40086524@N03,5320,28,1470308394,1470309294,7,15,900
40086524@N03,5321,29,1470733103,1470734003,2,11,900
40086524@N03,5321,20,1470735586,1470736126,5,11,540
40086524@N03,5321,19,1470737529,1470738069,4,11,540
40086524@N03,5321,15,1470742827,1470743097,2,11,270
40086524@N03,5321,24,1470744086,1470744409,3,11,323
40086524@N03,5321,16,1470744409,1470744482,2,11,73
40086524@N03,5321,26,1470744482,1470744881,2,11,399
40086524@N03,5321,23,1470744881,1470745481,3,11,600
40086524@N03,5321,19,1470746099,1470746430,6,11,331
40086524@N03,5321,23,1470746430,1470746434,2,11,4
40086524@N03,5321,19,1470746434,1470746974,1,11,540
40128058@N02,5322,27,1243699911,1243700811,1,1,900
40128058@N02,5323,27,1243778682,1243779582,1,1,900
40128058@N02,5324,27,1308470517,1308471417,1,1,900
40135057@N03,5325,18,1422673907,1422674357,1,1,450
40144079@N00,5326,28,1259023033,1259023933,9,3,900
40144079@N00,5326,15,1259033870,1259034140,6,3,270
40144079@N00,5326,22,1259045916,1259046516,9,3,600
40144079@N00,5327,28,1260666532,1260667432,3,3,900
40144079@N00,5327,22,1260678359,1260678959,3,3,600
40144079@N00,5327,6,1260682504,1260682624,4,3,120
40144079@N00,5328,28,1266372949,1266373849,20,4,900
40144079@N00,5328,16,1266377189,1266377459,3,4,270
40144079@N00,5328,26,1266377907,1266378807,4,4,900
40144079@N00,5328,28,1266378974,1266379874,11,4,900
40144079@N00,5329,16,1266973199,1266973469,6,5,270
40144079@N00,5329,21,1266973785,1266974355,10,5,570
40144079@N00,5329,24,1266977822,1266978602,3,5,780
40144079@N00,5329,28,1266982728,1266983628,10,5,900
40144079@N00,5329,22,1266992197,1266992797,21,5,600
40144079@N00,5330,28,1271916300,1271917200,3,3,900
40144079@N00,5330,23,1271922839,1271923439,8,3,600
40144079@N00,5330,29,1271926800,1271927700,5,3,900
40144079@N00,5331,6,1274579720,1274579840,6,2,120
40144079@N00,5331,29,1274586272,1274587172,2,2,900
40144079@N00,5332,16,1277690212,1277690482,6,2,270
40144079@N00,5332,22,1277699359,1277699959,9,2,600
40144079@N00,5333,28,1283920052,1283920952,3,1,900
40144079@N00,5334,25,1290907508,1290908348,7,2,840
40144079@N00,5334,28,1290919749,1290920649,21,2,900
40144079@N00,5335,14,1291946896,1291947136,20,2,240
40144079@N00,5335,7,1291951636,1291951816,11,2,180
40144079@N00,5336,13,1295486861,1295487101,19,1,240
40144079@N00,5337,11,1295588008,1295588248,8,4,240
40144079@N00,5337,31,1295591645,1295591706,2,4,61
40144079@N00,5337,30,1295591706,1295591868,4,4,162
40144079@N00,5337,31,1295591868,1295593368,7,4,1500
40144079@N00,5338,11,1304825361,1304825601,25,1,240
40144079@N00,5339,1,1306890398,1306890458,7,4,60
40144079@N00,5339,21,1306896239,1306896809,3,4,570
40144079@N00,5339,13,1306896947,1306897187,15,4,240
40144079@N00,5339,4,1306897950,1306898051,1,4,101
40144079@N00,5340,28,1307926540,1307927440,10,1,900
40144079@N00,5341,29,1329778456,1329779356,8,3,900
40144079@N00,5341,7,1329792636,1329792639,2,3,3
40144079@N00,5341,6,1329792639,1329792759,4,3,120
40160086@N05,5342,16,1356347941,1356347946,2,8,5
40160086@N05,5342,27,1356347946,1356348090,2,8,144
40160086@N05,5342,16,1356348090,1356348217,2,8,127
40160086@N05,5342,27,1356348217,1356348355,5,8,138
40160086@N05,5342,16,1356348355,1356348625,2,8,270
40160086@N05,5342,28,1356348660,1356349560,4,8,900
40160086@N05,5342,26,1356352100,1356353000,2,8,900
40160086@N05,5342,25,1356353785,1356354625,1,8,840
40160086@N05,5343,14,1356402955,1356403195,2,2,240
40160086@N05,5343,13,1356412111,1356412351,1,2,240
40164336@N00,5344,27,1205060092,1205060992,1,1,900
40170821@N06,5345,26,1421903066,1421903966,1,1,900
40185495@N00,5346,26,1356146458,1356147040,2,7,582
40185495@N00,5346,25,1356147040,1356147880,2,7,840
40185495@N00,5346,21,1356148753,1356149323,3,7,570
40185495@N00,5346,25,1356149345,1356150185,4,7,840
40185495@N00,5346,6,1356156124,1356156244,2,7,120
40185495@N00,5346,26,1356156377,1356157277,2,7,900
40185495@N00,5346,28,1356158761,1356159661,1,7,900
40262057@N06,5347,12,1243203793,1243204033,6,6,240
40262057@N06,5347,17,1243205658,1243205958,3,6,300
40262057@N06,5347,30,1243233466,1243234327,5,6,861
40262057@N06,5347,31,1243234327,1243234875,3,6,548
40262057@N06,5347,30,1243234875,1243235208,4,6,333
40262057@N06,5347,10,1243235208,1243235448,2,6,240
40262057@N06,5348,24,1243290764,1243291180,5,7,416
40262057@N06,5348,12,1243291180,1243291180,2,7,0
40262057@N06,5348,24,1243291180,1243291301,2,7,121
40262057@N06,5348,17,1243291301,1243291601,3,7,300
40262057@N06,5348,25,1243298821,1243299661,16,7,840
40262057@N06,5348,19,1243316878,1243317418,4,7,540
40262057@N06,5348,22,1243331110,1243331710,1,7,600
40262057@N06,5349,12,1243401970,1243401977,2,14,7
40262057@N06,5349,15,1243401977,1243402041,2,14,64
40262057@N06,5349,17,1243402041,1243402341,2,14,300
40262057@N06,5349,12,1243402930,1243403170,5,14,240
40262057@N06,5349,21,1243403174,1243403200,2,14,26
40262057@N06,5349,26,1243403200,1243403277,3,14,77
40262057@N06,5349,21,1243403277,1243403847,2,14,570
40262057@N06,5349,29,1243404308,1243405208,5,14,900
40262057@N06,5349,10,1243408228,1243408468,8,14,240
40262057@N06,5349,26,1243411274,1243412174,7,14,900
40262057@N06,5349,23,1243422637,1243422744,2,14,107
40262057@N06,5349,30,1243422744,1243423824,5,14,1080
40262057@N06,5349,23,1243424934,1243425534,3,14,600
40262057@N06,5349,22,1243425913,1243426513,21,14,600
40262057@N06,5350,19,1252653981,1252654521,2,2,540
40262057@N06,5350,31,1252664792,1252666292,43,2,1500
40262057@N06,5351,1,1259806899,1259806959,4,27,60
40262057@N06,5351,28,1259807154,1259808054,13,27,900
40262057@N06,5351,18,1259808377,1259808827,2,27,450
40262057@N06,5351,29,1259811918,1259812122,2,27,204
40262057@N06,5351,20,1259812122,1259812662,26,27,540
40262057@N06,5351,22,1259813837,1259814003,4,27,166
40262057@N06,5351,30,1259814003,1259814834,4,27,831
40262057@N06,5351,26,1259814834,1259815493,11,27,659
40262057@N06,5351,6,1259815493,1259815613,14,27,120
40262057@N06,5351,9,1259815980,1259816065,2,27,85
40262057@N06,5351,7,1259816065,1259816108,2,27,43
40262057@N06,5351,6,1259816108,1259816228,2,27,120
40262057@N06,5351,11,1259816588,1259816828,2,27,240
40262057@N06,5351,7,1259817301,1259817344,5,27,43
40262057@N06,5351,12,1259817344,1259817567,4,27,223
40262057@N06,5351,25,1259817567,1259818407,45,27,840
40262057@N06,5351,13,1259818793,1259818846,2,27,53
40262057@N06,5351,25,1259818846,1259819650,11,27,804
40262057@N06,5351,28,1259819650,1259820550,2,27,900
40262057@N06,5351,27,1259820822,1259821722,2,27,900
40262057@N06,5351,17,1259822212,1259822512,11,27,300
40262057@N06,5351,18,1259824772,1259825063,2,27,291
40262057@N06,5351,29,1259825063,1259825963,2,27,900
40262057@N06,5351,26,1259830326,1259831226,88,27,900
40262057@N06,5351,16,1259836602,1259836872,7,27,270
40262057@N06,5351,26,1259838695,1259839264,5,27,569
40262057@N06,5351,28,1259839264,1259840164,3,27,900
40262057@N06,5352,28,1259880520,1259880814,20,27,294
40262057@N06,5352,26,1259880814,1259880838,5,27,24
40262057@N06,5352,12,1259880838,1259880856,2,27,18
40262057@N06,5352,26,1259880856,1259880862,2,27,6
40262057@N06,5352,16,1259880862,1259880883,2,27,21
40262057@N06,5352,26,1259880883,1259880941,3,27,58
40262057@N06,5352,16,1259880941,1259880954,3,27,13
40262057@N06,5352,12,1259880954,1259880984,2,27,30
40262057@N06,5352,26,1259880984,1259881747,20,27,763
40262057@N06,5352,29,1259881747,1259881939,4,27,192
40262057@N06,5352,20,1259881939,1259882479,44,27,540
40262057@N06,5352,29,1259882770,1259883670,18,27,900
40262057@N06,5352,28,1259904678,1259905578,4,27,900
40262057@N06,5352,1,1259905814,1259905874,66,27,60
40262057@N06,5352,10,1259909538,1259909778,9,27,240
40262057@N06,5352,3,1259910395,1259910485,3,27,90
40262057@N06,5352,25,1259911155,1259911995,19,27,840
40262057@N06,5352,29,1259914541,1259915441,3,27,900
40262057@N06,5352,25,1259916165,1259917005,2,27,840
40262057@N06,5352,23,1259922560,1259923160,2,27,600
40262057@N06,5352,29,1259926067,1259926967,15,27,900
40262057@N06,5352,31,1259929915,1259930119,8,27,204
40262057@N06,5352,29,1259930119,1259930929,16,27,810
40262057@N06,5352,31,1259930929,1259931040,23,27,111
40262057@N06,5352,30,1259931040,1259931051,4,27,11
40262057@N06,5352,29,1259931051,1259931132,4,27,81
40262057@N06,5352,31,1259931132,1259932632,8,27,1500
40262057@N06,5353,20,1259979265,1259979805,2,8,540
40262057@N06,5353,19,1259986372,1259986617,7,8,245
40262057@N06,5353,18,1259986617,1259987067,3,8,450
40262057@N06,5353,20,1259987389,1259987929,24,8,540
40262057@N06,5353,22,1259989680,1259990280,3,8,600
40262057@N06,5353,30,1259990580,1259991660,6,8,1080
40262057@N06,5353,21,1260011264,1260011834,4,8,570
40262057@N06,5353,25,1260013551,1260014391,6,8,840
40262057@N06,5354,23,1260066076,1260066676,4,12,600
40262057@N06,5354,29,1260069409,1260070032,2,12,623
40262057@N06,5354,20,1260070032,1260070572,8,12,540
40262057@N06,5354,29,1260072491,1260073391,29,12,900
40262057@N06,5354,10,1260084733,1260084973,2,12,240
40262057@N06,5354,7,1260084989,1260085143,3,12,154
40262057@N06,5354,26,1260085143,1260086043,6,12,900
40262057@N06,5354,7,1260086203,1260086383,8,12,180
40262057@N06,5354,16,1260104070,1260104340,2,12,270
40262057@N06,5354,28,1260109606,1260109690,2,12,84
40262057@N06,5354,26,1260109690,1260109741,3,12,51
40262057@N06,5354,28,1260109741,1260110641,1,12,900
40262057@N06,5355,29,1309852868,1309853768,6,11,900
40262057@N06,5355,20,1309854633,1309855173,16,11,540
40262057@N06,5355,27,1309856406,1309857306,28,11,900
40262057@N06,5355,31,1309862517,1309864017,14,11,1500
40262057@N06,5355,29,1309864363,1309864459,2,11,96
40262057@N06,5355,31,1309864459,1309864515,2,11,56
40262057@N06,5355,29,1309864515,1309864658,10,11,143
40262057@N06,5355,31,1309864658,1309865091,11,11,433
40262057@N06,5355,29,1309865091,1309865157,6,11,66
40262057@N06,5355,31,1309865157,1309865796,2,11,639
40262057@N06,5355,29,1309865796,1309866696,10,11,900
40262057@N06,5356,27,1309905034,1309905934,10,15,900
40262057@N06,5356,17,1309907980,1309908280,8,15,300
40262057@N06,5356,28,1309911449,1309912349,7,15,900
40262057@N06,5356,20,1309912720,1309913260,13,15,540
40262057@N06,5356,30,1309914102,1309914106,2,15,4
40262057@N06,5356,29,1309914106,1309915006,16,15,900
40262057@N06,5356,25,1309920673,1309921513,10,15,840
40262057@N06,5356,26,1309925214,1309926114,11,15,900
40262057@N06,5356,29,1309928884,1309929784,10,15,900
40262057@N06,5356,23,1309931151,1309931751,14,15,600
40262057@N06,5356,5,1309943269,1309943389,4,15,120
40262057@N06,5356,7,1309943908,1309944088,3,15,180
40262057@N06,5356,5,1309944105,1309944118,2,15,13
40262057@N06,5356,7,1309944118,1309944298,3,15,180
40262057@N06,5356,10,1309944836,1309945076,6,15,240
40262057@N06,5357,25,1310014251,1310015091,11,1,840
40262057@N06,5358,12,1310082812,1310083052,24,11,240
40262057@N06,5358,3,1310083730,1310083736,2,11,6
40262057@N06,5358,12,1310083736,1310083938,5,11,202
40262057@N06,5358,3,1310083938,1310084028,5,11,90
40262057@N06,5358,5,1310084824,1310084944,3,11,120
40262057@N06,5358,3,1310085241,1310085331,2,11,90
40262057@N06,5358,5,1310085374,1310085494,5,11,120
40262057@N06,5358,29,1310089541,1310090441,11,11,900
40262057@N06,5358,30,1310100554,1310101634,8,11,1080
40262057@N06,5358,16,1310104440,1310104710,6,11,270
40262057@N06,5358,27,1310108940,1310109840,2,11,900
40262057@N06,5359,12,1310170894,1310170948,3,17,54
40262057@N06,5359,5,1310170948,1310171068,3,17,120
40262057@N06,5359,12,1310171571,1310171811,2,17,240
40262057@N06,5359,26,1310173407,1310174307,6,17,900
40262057@N06,5359,30,1310186591,1310187671,3,17,1080
40262057@N06,5359,19,1310188676,1310188770,2,17,94
40262057@N06,5359,29,1310188770,1310189267,6,17,497
40262057@N06,5359,19,1310189267,1310189807,8,17,540
40262057@N06,5359,29,1310190980,1310191880,3,17,900
40262057@N06,5359,27,1310198666,1310199566,3,17,900
40262057@N06,5359,16,1310203705,1310203975,3,17,270
40262057@N06,5359,23,1310205677,1310206277,2,17,600
40262057@N06,5359,12,1310210219,1310210459,2,17,240
40262057@N06,5359,27,1310210557,1310211457,4,17,900
40262057@N06,5359,31,1310215893,1310216507,10,17,614
40262057@N06,5359,29,1310216507,1310217044,4,17,537
40262057@N06,5359,26,1310217044,1310217944,1,17,900
40262057@N06,5360,16,1320314212,1320314482,1,1,270
40262057@N06,5361,28,1321001864,1321002082,2,37,218
40262057@N06,5361,27,1321002082,1321002982,7,37,900
40262057@N06,5361,17,1321005776,1321006076,23,37,300
40262057@N06,5361,14,1321009347,1321009587,3,37,240
40262057@N06,5361,31,1321010449,1321010654,10,37,205
40262057@N06,5361,29,1321010654,1321010662,4,37,8
40262057@N06,5361,31,1321010662,1321010663,2,37,1
40262057@N06,5361,29,1321010663,1321011068,4,37,405
40262057@N06,5361,31,1321011068,1321011148,3,37,80
40262057@N06,5361,29,1321011148,1321011219,2,37,71
40262057@N06,5361,31,1321011219,1321011620,39,37,401
40262057@N06,5361,29,1321011620,1321011655,4,37,35
40262057@N06,5361,31,1321011655,1321013155,13,37,1500
40262057@N06,5361,27,1321013861,1321014761,2,37,900
40262057@N06,5361,26,1321016869,1321017028,2,37,159
40262057@N06,5361,28,1321017028,1321017928,7,37,900
40262057@N06,5361,1,1321045801,1321045861,3,37,60
40262057@N06,5361,28,1321046020,1321046920,4,37,900
40262057@N06,5361,17,1321048590,1321048890,2,37,300
40262057@N06,5361,29,1321050410,1321051310,6,37,900
40262057@N06,5361,20,1321052706,1321053246,6,37,540
40262057@N06,5361,10,1321054348,1321054588,9,37,240
40262057@N06,5361,11,1321056423,1321056663,5,37,240
40262057@N06,5361,4,1321057677,1321057778,3,37,101
40262057@N06,5361,11,1321057788,1321057844,2,37,56
40262057@N06,5361,4,1321057844,1321057945,4,37,101
40262057@N06,5361,7,1321058240,1321058420,4,37,180
40262057@N06,5361,5,1321058626,1321058746,2,37,120
40262057@N06,5361,9,1321059005,1321059185,2,37,180
40262057@N06,5361,12,1321062110,1321062342,2,37,232
40262057@N06,5361,24,1321062342,1321062376,7,37,34
40262057@N06,5361,12,1321062376,1321062616,10,37,240
40262057@N06,5361,25,1321066497,1321067337,18,37,840
40262057@N06,5361,26,1321071108,1321072008,9,37,900
40262057@N06,5361,25,1321078991,1321079831,19,37,840
40262057@N06,5361,20,1321087813,1321088353,8,37,540
40262057@N06,5361,26,1321091328,1321092228,1,37,900
40262057@N06,5362,1,1321137144,1321137204,2,7,60
40262057@N06,5362,29,1321152821,1321153721,3,7,900
40262057@N06,5362,20,1321156355,1321156895,19,7,540
40262057@N06,5362,12,1321163001,1321163241,4,7,240
40262057@N06,5362,3,1321168550,1321168640,5,7,90
40262057@N06,5362,26,1321177849,1321178749,14,7,900
40262057@N06,5362,17,1321178823,1321179123,2,7,300
40262057@N06,5363,26,1321228390,1321228962,4,9,572
40262057@N06,5363,20,1321228962,1321229502,11,9,540
40262057@N06,5363,29,1321231030,1321231930,5,9,900
40262057@N06,5363,31,1321232241,1321232382,3,9,141
40262057@N06,5363,29,1321232382,1321233282,2,9,900
40262057@N06,5363,17,1321235431,1321235731,4,9,300
40262057@N06,5363,1,1321245600,1321245660,2,9,60
40262057@N06,5363,28,1321249012,1321249912,31,9,900
40262057@N06,5363,26,1321257111,1321258011,8,9,900
40277798@N08,5364,26,1275828750,1275829650,1,1,900
40291653@N08,5365,26,1305605468,1305606368,2,6,900
40291653@N08,5365,25,1305608147,1305608987,2,6,840
40291653@N08,5365,13,1305610179,1305610419,2,6,240
40291653@N08,5365,20,1305621396,1305621936,2,6,540
40291653@N08,5365,26,1305626475,1305626614,2,6,139
40291653@N08,5365,12,1305626614,1305626854,1,6,240
40294731@N06,5366,7,1277462783,1277462963,1,1,180
40364661@N00,5367,1,1390166392,1390166452,1,1,60
40364968@N04,5368,16,1325453230,1325453500,106,1,270
40371941@N00,5369,18,1353487031,1353487481,2,4,450
40371941@N00,5369,26,1353487827,1353488233,4,4,406
40371941@N00,5369,28,1353488233,1353489133,2,4,900
40371941@N00,5369,15,1353500951,1353501221,2,4,270
40404453@N04,5370,1,1342867402,1342867462,6,1,60
40414712@N00,5371,28,1288957834,1288958734,2,1,900
40414712@N00,5372,1,1289002939,1289002999,2,7,60
40414712@N00,5372,24,1289013346,1289014126,2,7,780
40414712@N00,5372,28,1289026793,1289027304,2,7,511
40414712@N00,5372,1,1289027304,1289027364,2,7,60
40414712@N00,5372,26,1289033198,1289034098,2,7,900
40414712@N00,5372,28,1289036870,1289037770,4,7,900
40414712@N00,5372,15,1289041741,1289042011,1,7,270
40414712@N00,5373,1,1289098875,1289098935,2,2,60
40414712@N00,5373,29,1289100201,1289101101,1,2,900
40414712@N00,5374,10,1315468723,1315468963,1,1,240
40429316@N00,5375,18,1451085576,1451086026,2,1,450
40429316@N00,5376,18,1451126098,1451126548,3,2,450
40429316@N00,5376,25,1451127033,1451127873,1,2,840
40432809@N05,5377,30,1256867736,1256868816,2,2,1080
40432809@N05,5377,20,1256881381,1256881921,1,2,540
40482053@N07,5378,30,1395551996,1395553076,1,1,1080
40503355@N00,5379,26,1252100320,1252101220,1,1,900
40522857@N07,5380,12,1321748787,1321749027,1,1,240
40542539@N00,5381,1,1325118273,1325118333,1,1,60
40563308@N02,5382,29,1236993391,1236994291,3,1,900
40563308@N02,5383,29,1243734047,1243734947,3,3,900
40563308@N02,5383,16,1243737263,1243737533,2,3,270
40563308@N02,5383,17,1243746012,1243746312,1,3,300
40563308@N02,5384,29,1245538130,1245539030,2,1,900
40563308@N02,5385,5,1253398561,1253398564,2,7,3
40563308@N02,5385,3,1253398564,1253398654,2,7,90
40563308@N02,5385,12,1253399379,1253399619,2,7,240
40563308@N02,5385,22,1253403621,1253404221,2,7,600
40563308@N02,5385,30,1253405804,1253406884,2,7,1080
40563308@N02,5385,18,1253407199,1253407649,2,7,450
40563308@N02,5385,26,1253409517,1253410417,3,7,900
40563308@N02,5386,28,1254088753,1254089401,2,5,648
40563308@N02,5386,5,1254089401,1254089521,2,5,120
40563308@N02,5386,12,1254090240,1254090480,2,5,240
40563308@N02,5386,20,1254093736,1254094276,2,5,540
40563308@N02,5386,28,1254105459,1254106359,1,5,900
40563308@N02,5387,29,1258247666,1258248566,2,3,900
40563308@N02,5387,10,1258257297,1258257537,2,3,240
40563308@N02,5387,18,1258258974,1258259424,1,3,450
40563308@N02,5388,25,1261533683,1261534523,2,2,840
40563308@N02,5388,20,1261545960,1261546500,1,2,540
40563308@N02,5389,1,1263679602,1263679662,2,8,60
40563308@N02,5389,30,1263680108,1263680135,2,8,27
40563308@N02,5389,18,1263680135,1263680585,2,8,450
40563308@N02,5389,26,1263680645,1263681545,4,8,900
40563308@N02,5389,29,1263683142,1263683552,3,8,410
40563308@N02,5389,20,1263683552,1263684092,7,8,540
40563308@N02,5389,16,1263686442,1263686712,2,8,270
40563308@N02,5389,15,1263687014,1263687284,6,8,270
40563308@N02,5390,19,1269748440,1269748442,2,2,2
40563308@N02,5390,20,1269748442,1269748982,1,2,540
40563308@N02,5391,7,1270502501,1270502553,2,7,52
40563308@N02,5391,6,1270502553,1270502673,2,7,120
40563308@N02,5391,29,1270504863,1270505763,2,7,900
40563308@N02,5391,23,1270507838,1270508438,2,7,600
40563308@N02,5391,30,1270511327,1270512407,2,7,1080
40563308@N02,5391,29,1270516160,1270517060,3,7,900
40563308@N02,5391,1,1270521015,1270521075,2,7,60
40563308@N02,5392,20,1276821098,1276821638,3,3,540
40563308@N02,5392,4,1276825639,1276825740,2,3,101
40563308@N02,5392,13,1276826230,1276826470,1,3,240
40563308@N02,5393,18,1279078259,1279078709,1,1,450
40563308@N02,5394,25,1280009468,1280010308,2,7,840
40563308@N02,5394,4,1280010870,1280010971,2,7,101
40563308@N02,5394,11,1280011330,1280011570,2,7,240
40563308@N02,5394,20,1280013483,1280014023,2,7,540
40563308@N02,5394,30,1280015864,1280016353,2,7,489
40563308@N02,5394,10,1280016353,1280016593,2,7,240
40563308@N02,5394,15,1280017549,1280017819,1,7,270
40563308@N02,5395,29,1280047450,1280048350,1,1,900
40563308@N02,5396,29,1282344469,1282345369,2,5,900
40563308@N02,5396,18,1282348514,1282348964,2,5,450
40563308@N02,5396,29,1282350148,1282351048,2,5,900
40563308@N02,5396,9,1282361282,1282361462,3,5,180
40563308@N02,5396,28,1282376837,1282377737,2,5,900
40563308@N02,5397,12,1284762103,1284762343,1,1,240
40563308@N02,5398,13,1289019320,1289019560,1,1,240
40563308@N02,5399,26,1289083405,1289084305,1,1,900
40563308@N02,5400,12,1292102991,1292103231,2,8,240
40563308@N02,5400,30,1292105685,1292106765,2,8,1080
40563308@N02,5400,29,1292107243,1292108143,4,8,900
40563308@N02,5400,18,1292110955,1292111020,2,8,65
40563308@N02,5400,29,1292111020,1292111920,2,8,900
40563308@N02,5400,26,1292112876,1292113776,3,8,900
40563308@N02,5400,11,1292114112,1292114114,2,8,2
40563308@N02,5400,10,1292114114,1292114354,1,8,240
40563308@N02,5401,19,1294444025,1294444565,2,2,540
40563308@N02,5401,18,1294445676,1294446126,1,2,450
40563308@N02,5402,24,1301187938,1301188718,3,3,780
40563308@N02,5402,26,1301188744,1301189644,2,3,900
40563308@N02,5402,28,1301190837,1301191737,1,3,900
40563308@N02,5403,30,1301799058,1301800138,1,1,1080
40563308@N02,5404,29,1303112792,1303113692,6,2,900
40563308@N02,5404,30,1303117738,1303118818,1,2,1080
40563308@N02,5405,1,1303162989,1303163049,2,4,60
40563308@N02,5405,12,1303165809,1303166049,2,4,240
40563308@N02,5405,30,1303173417,1303174497,3,4,1080
40563308@N02,5405,26,1303175551,1303176451,2,4,900
40563308@N02,5406,11,1303250735,1303250975,3,7,240
40563308@N02,5406,10,1303253112,1303253352,2,7,240
40563308@N02,5406,29,1303255108,1303256008,3,7,900
40563308@N02,5406,14,1303257625,1303257865,13,7,240
40563308@N02,5406,29,1303259532,1303259545,2,7,13
40563308@N02,5406,31,1303259545,1303259555,2,7,10
40563308@N02,5406,29,1303259555,1303260455,1,7,900
40563308@N02,5407,29,1303292453,1303293353,2,3,900
40563308@N02,5407,30,1303294954,1303295062,2,3,108
40563308@N02,5407,29,1303295062,1303295962,1,3,900
40563308@N02,5408,28,1303355761,1303356661,9,2,900
40563308@N02,5408,1,1303379429,1303379489,1,2,60
40563308@N02,5409,19,1310858073,1310858613,1,1,540
40563308@N02,5410,28,1311572147,1311573047,4,1,900
40563308@N02,5411,20,1316301396,1316301936,2,2,540
40563308@N02,5411,17,1316304022,1316304322,1,2,300
40563308@N02,5412,6,1367558476,1367558596,1,1,120
40563308@N02,5413,12,1374187547,1374187787,2,2,240
40563308@N02,5413,29,1374191980,1374192880,3,2,900
40563308@N02,5414,29,1379120325,1379121225,3,5,900
40563308@N02,5414,31,1379125209,1379126709,2,5,1500
40563308@N02,5414,18,1379129563,1379130013,2,5,450
40563308@N02,5414,28,1379130596,1379131496,3,5,900
40563308@N02,5414,16,1379153285,1379153555,1,5,270
40563308@N02,5415,9,1399605525,1399605705,1,1,180
40579602@N00,5416,29,1195703537,1195703886,4,10,349
40579602@N00,5416,23,1195703886,1195704486,2,10,600
40579602@N00,5416,28,1195714707,1195715607,13,10,900
40579602@N00,5416,29,1195729397,1195730297,2,10,900
40579602@N00,5416,31,1195731528,1195733028,4,10,1500
40579602@N00,5416,26,1195735172,1195735401,2,10,229
40579602@N00,5416,9,1195735401,1195735581,2,10,180
40579602@N00,5416,4,1195735857,1195735949,2,10,92
40579602@N00,5416,3,1195735949,1195735970,2,10,21
40579602@N00,5416,28,1195735970,1195736870,1,10,900
40579602@N00,5417,28,1258759201,1258760101,2,3,900
40579602@N00,5417,23,1258761550,1258762150,2,3,600
40579602@N00,5417,30,1258764657,1258765737,9,3,1080
40579602@N00,5418,27,1277518245,1277519145,2,1,900
40629276@N07,5419,28,1383454703,1383455603,1,1,900
40629276@N07,5420,19,1401059921,1401060461,1,1,540
40708728@N04,5421,29,1297486810,1297487710,1,1,900
40708728@N04,5422,1,1299414913,1299414973,1,1,60
40708728@N04,5423,24,1313318146,1313318926,2,2,780
40708728@N04,5423,10,1313319120,1313319360,1,2,240
40708728@N04,5424,13,1316931740,1316931980,2,5,240
40708728@N04,5424,22,1316938388,1316938988,2,5,600
40708728@N04,5424,4,1316943810,1316943911,2,5,101
40708728@N04,5424,19,1316948479,1316949019,2,5,540
40708728@N04,5424,6,1316953181,1316953301,1,5,120
40708728@N04,5425,4,1317373004,1317373105,1,1,101
40708728@N04,5426,22,1317546524,1317547124,1,1,600
40708728@N04,5427,7,1318756335,1318756515,2,3,180
40708728@N04,5427,15,1318764663,1318764933,2,3,270
40708728@N04,5427,16,1318765154,1318765424,1,3,270
40708728@N04,5428,11,1319967009,1319967249,2,7,240
40708728@N04,5428,29,1319973033,1319973121,2,7,88
40708728@N04,5428,20,1319973121,1319973661,2,7,540
40708728@N04,5428,26,1319974044,1319974895,3,7,851
40708728@N04,5428,30,1319974895,1319975709,2,7,814
40708728@N04,5428,28,1319975709,1319976609,4,7,900
40708728@N04,5428,1,1319977545,1319977605,1,7,60
40708728@N04,5429,8,1320552435,1320552615,2,2,180
40708728@N04,5429,22,1320575575,1320576175,1,2,600
40708728@N04,5430,29,1321783960,1321784860,2,2,900
40708728@N04,5430,28,1321798115,1321799015,2,2,900
40708728@N04,5431,23,1324394060,1324394660,1,1,600
40708728@N04,5432,29,1326020650,1326021550,1,1,900
40708728@N04,5433,20,1329722910,1329723450,1,1,540
40708728@N04,5434,23,1333027161,1333027761,1,1,600
40708728@N04,5435,17,1333891172,1333891472,2,3,300
40708728@N04,5435,8,1333892309,1333892489,2,3,180
40708728@N04,5435,29,1333892925,1333893825,2,3,900
40708728@N04,5436,14,1336913353,1336913593,1,1,240
40708728@N04,5437,28,1338215884,1338216784,2,1,900
40708728@N04,5438,27,1343568154,1343569054,1,1,900
40708728@N04,5439,23,1350801734,1350802334,2,3,600
40708728@N04,5439,28,1350822677,1350823129,2,3,452
40708728@N04,5439,1,1350823129,1350823189,1,3,60
40708728@N04,5440,13,1352031246,1352031486,5,4,240
40708728@N04,5440,24,1352034735,1352035515,2,4,780
40708728@N04,5440,27,1352035675,1352036575,2,4,900
40708728@N04,5440,28,1352037038,1352037938,2,4,900
40708728@N04,5441,22,1353851941,1353852541,1,1,600
40708728@N04,5442,9,1359292408,1359292588,2,4,180
40708728@N04,5442,26,1359293103,1359293296,2,4,193
40708728@N04,5442,16,1359293296,1359293566,2,4,270
40708728@N04,5442,28,1359293939,1359294839,1,4,900
40708728@N04,5443,28,1364564782,1364565682,3,1,900
40732565660@N01,5444,26,1241057685,1241058585,2,10,900
40732565660@N01,5444,13,1241061645,1241061885,7,10,240
40732565660@N01,5444,27,1241085540,1241086440,2,10,900
40732565660@N01,5444,24,1241087058,1241087653,4,10,595
40732565660@N01,5444,15,1241087653,1241087923,2,10,270
40732565660@N01,5444,27,1241088318,1241088409,2,10,91
40732565660@N01,5444,16,1241088409,1241088679,2,10,270
40732565660@N01,5444,27,1241088719,1241088965,3,10,246
40732565660@N01,5444,16,1241088965,1241089235,4,10,270
40732565660@N01,5444,27,1241089825,1241090725,6,10,900
40732565660@N01,5445,21,1241144679,1241145249,30,9,570
40732565660@N01,5445,13,1241146766,1241146923,4,9,157
40732565660@N01,5445,21,1241146923,1241147018,2,9,95
40732565660@N01,5445,13,1241147018,1241147258,23,9,240
40732565660@N01,5445,7,1241150215,1241150395,3,9,180
40732565660@N01,5445,29,1241154532,1241155432,2,9,900
40732565660@N01,5445,23,1241162519,1241163119,4,9,600
40732565660@N01,5445,11,1241167910,1241168150,5,9,240
40732565660@N01,5445,28,1241170186,1241171086,1,9,900
40732565660@N01,5446,7,1241230460,1241230640,5,4,180
40732565660@N01,5446,4,1241252598,1241252699,2,4,101
40732565660@N01,5446,7,1241253650,1241253830,7,4,180
40732565660@N01,5446,16,1241255136,1241255406,7,4,270
40732565660@N01,5447,28,1241324959,1241325859,6,1,900
40733386@N02,5448,28,1337950982,1337951882,1,1,900
40785688@N08,5449,31,1341893803,1341895303,1,1,1500
40868192@N07,5450,22,1248178058,1248178658,1,1,600
40868192@N07,5451,26,1248228341,1248229241,4,1,900
40868192@N07,5452,20,1248314538,1248315078,3,7,540
40868192@N07,5452,29,1248316165,1248317065,3,7,900
40868192@N07,5452,28,1248317111,1248317243,2,7,132
40868192@N07,5452,18,1248317243,1248317693,3,7,450
40868192@N07,5452,26,1248318822,1248319722,2,7,900
40868192@N07,5452,25,1248322953,1248323793,2,7,840
40868192@N07,5452,28,1248327753,1248328653,1,7,900
40868192@N07,5453,30,1248432371,1248433451,2,1,1080
40868192@N07,5454,7,1248477300,1248477404,2,6,104
40868192@N07,5454,6,1248477404,1248477524,2,6,120
40868192@N07,5454,7,1248478408,1248478588,2,6,180
40868192@N07,5454,13,1248483287,1248483527,2,6,240
40868192@N07,5454,25,1248484454,1248485294,4,6,840
40868192@N07,5454,29,1248502773,1248503673,7,6,900
40868192@N07,5455,5,1248564432,1248564552,2,4,120
40868192@N07,5455,26,1248565855,1248566497,6,4,642
40868192@N07,5455,30,1248566497,1248567577,2,4,1080
40868192@N07,5455,20,1248578235,1248578775,1,4,540
40879331@N06,5456,15,1385167186,1385167456,2,2,270
40879331@N06,5456,3,1385172152,1385172242,1,2,90
40879331@N06,5457,27,1407330599,1407331499,1,1,900
40879331@N06,5458,18,1446947740,1446948190,1,1,450
40904999@N05,5459,15,1354670909,1354671179,1,1,270
40910200@N06,5460,20,1329381468,1329382008,4,1,540
40910200@N06,5461,26,1329468848,1329469748,15,1,900
40910200@N06,5462,28,1329542134,1329543034,2,2,900
40910200@N06,5462,29,1329547099,1329547999,1,2,900
40910200@N06,5463,28,1331511656,1331512556,2,2,900
40910200@N06,5463,26,1331514060,1331514960,1,2,900
40910200@N06,5464,11,1331597694,1331597934,2,3,240
40910200@N06,5464,3,1331599663,1331599753,2,3,90
40910200@N06,5464,11,1331600394,1331600634,1,3,240
40910200@N06,5465,18,1331715313,1331715763,2,2,450
40910200@N06,5465,29,1331727609,1331728509,1,2,900
40910200@N06,5466,1,1349825035,1349825095,4,6,60
40910200@N06,5466,15,1349830215,1349830485,3,6,270
40910200@N06,5466,21,1349832252,1349832822,4,6,570
40910200@N06,5466,23,1349836198,1349836538,2,6,340
40910200@N06,5466,29,1349836538,1349837438,5,6,900
40910200@N06,5466,20,1349838844,1349839384,10,6,540
40910200@N06,5467,28,1349912784,1349913684,3,3,900
40910200@N06,5467,12,1349917896,1349918136,3,3,240
40910200@N06,5467,17,1349935673,1349935973,1,3,300
40910200@N06,5468,1,1350005835,1350005895,2,6,60
40910200@N06,5468,30,1350011508,1350012588,2,6,1080
40910200@N06,5468,31,1350014319,1350014720,2,6,401
40910200@N06,5468,30,1350014720,1350015800,2,6,1080
40910200@N06,5468,14,1350018814,1350019054,2,6,240
40910200@N06,5468,26,1350031140,1350032040,1,6,900
40938484@N02,5469,7,1293329102,1293329282,2,2,180
40938484@N02,5469,3,1293351825,1293351915,1,2,90
40938484@N02,5470,25,1324602525,1324603365,2,1,840
40938484@N02,5471,12,1365208697,1365208937,2,2,240
40938484@N02,5471,25,1365217415,1365218255,1,2,840
40964166@N05,5472,12,1252576418,1252576658,4,11,240
40964166@N05,5472,10,1252578210,1252578450,7,11,240
40964166@N05,5472,30,1252579194,1252579770,4,11,576
40964166@N05,5472,31,1252579770,1252579777,2,11,7
40964166@N05,5472,22,1252579777,1252579967,2,11,190
40964166@N05,5472,31,1252579967,1252581467,2,11,1500
40964166@N05,5472,22,1252582581,1252583181,2,11,600
40964166@N05,5472,16,1252593253,1252593523,2,11,270
40964166@N05,5472,24,1252596666,1252597446,4,11,780
40964166@N05,5472,17,1252597859,1252598159,2,11,300
40964166@N05,5472,28,1252603980,1252604880,1,11,900
40990827@N06,5473,17,1313834327,1313834627,1,1,300
41047258@N00,5474,21,1255148980,1255149550,2,2,570
41047258@N00,5474,29,1255152523,1255153423,1,2,900
41047258@N00,5475,18,1289096298,1289096748,2,2,450
41047258@N00,5475,17,1289105062,1289105362,1,2,300
41047258@N00,5476,20,1335666391,1335666931,2,8,540
41047258@N00,5476,30,1335668973,1335670053,2,8,1080
41047258@N00,5476,31,1335670205,1335671705,2,8,1500
41047258@N00,5476,30,1335672831,1335673911,2,8,1080
41047258@N00,5476,23,1335674017,1335674617,2,8,600
41047258@N00,5476,13,1335678099,1335678339,5,8,240
41047258@N00,5476,1,1335684390,1335684450,3,8,60
41047258@N00,5476,11,1335686541,1335686781,1,8,240
41085159@N00,5477,15,1462504847,1462505117,1,1,270
41090954@N07,5478,1,1371017898,1371017958,2,2,60
41090954@N07,5478,22,1371025883,1371026483,1,2,600
41125479@N07,5479,17,1287277360,1287277660,2,2,300
41125479@N07,5479,9,1287280921,1287281101,1,2,180
41125479@N07,5480,20,1287882479,1287883019,2,1,540
41126359@N00,5481,23,1286723337,1286723937,1,1,600
41126359@N00,5482,26,1330843080,1330843980,2,1,900
41126359@N00,5483,22,1331010889,1331011489,1,1,600
41131248@N00,5484,26,1449714337,1449715237,5,1,900
41145933@N07,5485,29,1337909534,1337910434,2,1,900
41175571@N06,5486,26,1197845442,1197846342,2,1,900
41175571@N06,5487,26,1198020273,1198021173,2,1,900
41175571@N06,5488,26,1222468158,1222469058,9,1,900
41175571@N06,5489,26,1222563085,1222563985,1,1,900
41175571@N06,5490,26,1222651436,1222652336,7,1,900
41175571@N06,5491,26,1223428857,1223429757,1,1,900
41175571@N06,5492,26,1227136538,1227137438,5,1,900
41175571@N06,5493,26,1227251838,1227252738,2,1,900
41175571@N06,5494,26,1227304419,1227305319,14,1,900
41175571@N06,5495,26,1233791509,1233792409,4,1,900
41175571@N06,5496,26,1249377849,1249378749,7,1,900
41175571@N06,5497,26,1249462904,1249463804,1,1,900
41175571@N06,5498,26,1252275559,1252276459,2,1,900
41175571@N06,5499,26,1252373819,1252374719,9,1,900
41184184@N00,5500,29,1314578782,1314579682,2,10,900
41184184@N00,5500,27,1314581488,1314582388,2,10,900
41184184@N00,5500,24,1314586250,1314587030,2,10,780
41184184@N00,5500,18,1314602488,1314602938,3,10,450
41184184@N00,5500,29,1314604160,1314605060,2,10,900
41184184@N00,5500,9,1314607313,1314607465,2,10,152
41184184@N00,5500,3,1314607465,1314607555,8,10,90
41184184@N00,5500,25,1314608133,1314608973,4,10,840
41184184@N00,5500,13,1314609325,1314609565,4,10,240
41184184@N00,5500,1,1314619656,1314619716,1,10,60
41197583@N00,5501,31,1208521000,1208521961,2,7,961
41197583@N00,5501,22,1208521961,1208522561,5,7,600
41197583@N00,5501,23,1208524373,1208524973,2,7,600
41197583@N00,5501,19,1208531108,1208531648,2,7,540
41197583@N00,5501,24,1208539263,1208540043,2,7,780
41197583@N00,5501,7,1208547497,1208547677,3,7,180
41197583@N00,5501,17,1208555247,1208555547,3,7,300
41197583@N00,5502,3,1208602353,1208602443,2,2,90
41197583@N00,5502,13,1208603952,1208604192,2,2,240
41197583@N00,5503,26,1208689248,1208690148,1,1,900
41236077@N02,5504,26,1299815784,1299816684,1,1,900
41254815@N02,5505,29,1408255678,1408256569,2,2,891
41254815@N02,5505,26,1408256569,1408257469,2,2,900
41254815@N02,5506,10,1429314108,1429314348,2,4,240
41254815@N02,5506,13,1429315613,1429315853,5,4,240
41254815@N02,5506,4,1429318593,1429318694,2,4,101
41254815@N02,5506,31,1429322401,1429323901,1,4,1500
41259174@N07,5507,28,1359598430,1359599330,1,1,900
41266898@N04,5508,27,1293065350,1293066250,2,2,900
41266898@N04,5508,15,1293073529,1293073799,1,2,270
41266898@N04,5509,16,1293109243,1293109513,2,3,270
41266898@N04,5509,20,1293112046,1293112586,3,3,540
41266898@N04,5509,26,1293114483,1293115383,3,3,900
41266898@N04,5510,1,1293153603,1293153663,2,1,60
41278086@N00,5511,26,1256019126,1256020026,1,1,900
41287971@N08,5512,29,1339738178,1339739078,1,1,900
41296706@N00,5513,27,1307344595,1307345495,3,1,900
41371213@N04,5514,18,1451606837,1451607287,2,11,450
41371213@N04,5514,20,1451627641,1451628181,2,11,540
41371213@N04,5514,18,1451628513,1451628963,2,11,450
41371213@N04,5514,19,1451629466,1451630006,2,11,540
41371213@N04,5514,18,1451630593,1451631043,4,11,450
41371213@N04,5514,22,1451635898,1451636498,2,11,600
41371213@N04,5514,15,1451636641,1451636911,2,11,270
41371213@N04,5514,18,1451637452,1451637902,2,11,450
41371213@N04,5514,27,1451638357,1451638922,2,11,565
41371213@N04,5514,7,1451638922,1451639102,2,11,180
41371213@N04,5514,18,1451639262,1451639712,1,11,450
41372842@N00,5515,18,1350517554,1350518004,1,1,450
41453183@N05,5516,20,1351670282,1351670822,2,13,540
41453183@N05,5516,29,1351671755,1351672128,2,13,373
41453183@N05,5516,22,1351672128,1351672728,8,13,600
41453183@N05,5516,12,1351675480,1351675720,2,13,240
41453183@N05,5516,15,1351675762,1351676032,2,13,270
41453183@N05,5516,17,1351676186,1351676486,3,13,300
41453183@N05,5516,16,1351677543,1351677813,2,13,270
41453183@N05,5516,1,1351677914,1351677974,2,13,60
41453183@N05,5516,28,1351682482,1351683382,3,13,900
41453183@N05,5516,26,1351684595,1351685190,3,13,595
41453183@N05,5516,28,1351685190,1351685730,5,13,540
41453183@N05,5516,1,1351685730,1351685790,2,13,60
41453183@N05,5516,28,1351685793,1351686693,6,13,900
41453183@N05,5517,15,1351752793,1351753063,3,3,270
41453183@N05,5517,26,1351755519,1351755660,3,3,141
41453183@N05,5517,28,1351755660,1351756560,3,3,900
41453183@N05,5518,26,1351956151,1351956515,2,10,364
41453183@N05,5518,15,1351956515,1351956785,2,10,270
41453183@N05,5518,7,1351957068,1351957248,2,10,180
41453183@N05,5518,3,1351957777,1351957867,2,10,90
41453183@N05,5518,11,1351957975,1351958215,2,10,240
41453183@N05,5518,4,1351958276,1351958377,4,10,101
41453183@N05,5518,26,1351958973,1351959615,4,10,642
41453183@N05,5518,7,1351959615,1351959739,3,10,124
41453183@N05,5518,5,1351959739,1351959787,3,10,48
41453183@N05,5518,3,1351959787,1351959877,1,10,90
41453183@N05,5519,27,1352001174,1352002074,3,12,900
41453183@N05,5519,4,1352007592,1352007693,7,12,101
41453183@N05,5519,19,1352009252,1352009633,2,12,381
41453183@N05,5519,29,1352009633,1352010533,12,12,900
41453183@N05,5519,28,1352011612,1352011721,2,12,109
41453183@N05,5519,18,1352011721,1352011798,4,12,77
41453183@N05,5519,19,1352011798,1352011919,2,12,121
41453183@N05,5519,29,1352011919,1352012401,2,12,482
41453183@N05,5519,23,1352012401,1352012458,2,12,57
41453183@N05,5519,18,1352012458,1352012557,6,12,99
41453183@N05,5519,26,1352012557,1352013041,3,12,484
41453183@N05,5519,25,1352013041,1352013881,1,12,840
41453183@N05,5520,26,1352692813,1352692920,3,12,107
41453183@N05,5520,16,1352692920,1352693034,2,12,114
41453183@N05,5520,26,1352693034,1352693466,13,12,432
41453183@N05,5520,29,1352693466,1352694366,15,12,900
41453183@N05,5520,30,1352697950,1352697957,2,12,7
41453183@N05,5520,29,1352697957,1352697984,2,12,27
41453183@N05,5520,30,1352697984,1352699064,2,12,1080
41453183@N05,5520,28,1352707254,1352708154,5,12,900
41453183@N05,5520,23,1352711731,1352712288,2,12,557
41453183@N05,5520,29,1352712288,1352713188,8,12,900
41453183@N05,5520,25,1352715750,1352716590,2,12,840
41453183@N05,5520,24,1352718530,1352719310,4,12,780
41453183@N05,5521,28,1377306965,1377307865,1,1,900
41476650@N00,5522,29,1408691643,1408692543,1,1,900
41476650@N00,5523,26,1420771878,1420772778,2,2,900
41476650@N00,5523,14,1420778288,1420778528,1,2,240
41476650@N00,5524,3,1420840944,1420841034,2,2,90
41476650@N00,5524,18,1420854653,1420855103,1,2,450
41476650@N00,5525,7,1420887788,1420887968,1,1,180
41476650@N00,5526,22,1433553316,1433553916,1,1,600
41494703@N06,5527,14,1409529952,1409530192,1,1,240
41516706@N03,5528,28,1267165928,1267166199,2,2,271
41516706@N03,5528,23,1267166199,1267166799,1,2,600
41516706@N03,5529,20,1291079969,1291080509,2,5,540
41516706@N03,5529,23,1291085124,1291085724,2,5,600
41516706@N03,5529,26,1291094736,1291095636,2,5,900
41516706@N03,5529,8,1291097035,1291097215,2,5,180
41516706@N03,5529,26,1291097277,1291098177,1,5,900
41516706@N03,5530,18,1317768810,1317768881,2,4,71
41516706@N03,5530,19,1317768881,1317769421,2,4,540
41516706@N03,5530,16,1317771342,1317771433,2,4,91
41516706@N03,5530,26,1317771433,1317772333,1,4,900
41540189@N05,5531,29,1334372786,1334373686,2,2,900
41540189@N05,5531,26,1334375775,1334376675,1,2,900
41540189@N05,5532,27,1350184567,1350185467,2,4,900
41540189@N05,5532,28,1350186315,1350187215,2,4,900
41540189@N05,5532,14,1350191209,1350191233,3,4,24
41540189@N05,5532,20,1350191233,1350191773,1,4,540
41548074@N04,5533,28,1392799996,1392800896,1,1,900
41548074@N04,5534,26,1392866092,1392866992,1,1,900
41556385@N06,5535,30,1241230254,1241231334,2,3,1080
41556385@N06,5535,17,1241241750,1241242050,2,3,300
41556385@N06,5535,25,1241256772,1241257612,1,3,840
41556385@N06,5536,28,1241432334,1241433234,1,1,900
41556385@N06,5537,16,1306125662,1306125932,2,9,270
41556385@N06,5537,29,1306127130,1306128030,2,9,900
41556385@N06,5537,1,1306133099,1306133159,2,9,60
41556385@N06,5537,23,1306133334,1306133635,2,9,301
41556385@N06,5537,26,1306133635,1306133705,2,9,70
41556385@N06,5537,13,1306133705,1306133945,2,9,240
41556385@N06,5537,25,1306134715,1306135555,2,9,840
41556385@N06,5537,23,1306135883,1306136483,2,9,600
41556385@N06,5537,28,1306136839,1306137739,1,9,900
41615479@N05,5538,1,1448039295,1448039355,1,1,60
41623624@N05,5539,17,1305947159,1305947459,2,2,300
41623624@N05,5539,5,1305967417,1305967537,1,2,120
41781191@N00,5540,25,1451523092,1451523932,1,1,840
41781191@N00,5541,18,1451624358,1451624808,1,1,450
41848523@N00,5542,28,1279626066,1279626966,2,1,900
41848523@N00,5543,29,1307170820,1307171720,1,1,900
41848523@N00,5544,29,1307274640,1307275540,2,3,900
41848523@N00,5544,26,1307277465,1307278365,2,3,900
41848523@N00,5544,28,1307282522,1307283422,1,3,900
41848523@N00,5545,1,1307410408,1307410468,2,5,60
41848523@N00,5545,16,1307410795,1307411065,2,5,270
41848523@N00,5545,8,1307411648,1307411828,2,5,180
41848523@N00,5545,25,1307412921,1307413761,2,5,840
41848523@N00,5545,10,1307416140,1307416380,1,5,240
41848523@N00,5546,26,1317616652,1317617552,1,1,900
41848523@N00,5547,23,1343099207,1343099807,1,1,600
41879028@N03,5548,16,1417661361,1417661631,4,1,270
41879028@N03,5549,24,1421201184,1421201964,2,2,780
41879028@N03,5549,16,1421204034,1421204304,1,2,270
41894174086@N01,5550,29,1227316019,1227316234,3,8,215
41894174086@N01,5550,20,1227316234,1227316774,4,8,540
41894174086@N01,5550,31,1227317382,1227317559,2,8,177
41894174086@N01,5550,22,1227317559,1227318159,4,8,600
41894174086@N01,5550,18,1227321840,1227322290,4,8,450
41894174086@N01,5550,30,1227323665,1227324745,4,8,1080
41894174086@N01,5550,22,1227326382,1227326982,2,8,600
41894174086@N01,5550,15,1227336910,1227337180,1,8,270
41894174086@N01,5551,12,1227478126,1227478366,2,14,240
41894174086@N01,5551,24,1227479153,1227479933,2,14,780
41894174086@N01,5551,3,1227480864,1227480954,2,14,90
41894174086@N01,5551,28,1227481921,1227482821,2,14,900
41894174086@N01,5551,27,1227486601,1227487501,2,14,900
41894174086@N01,5551,16,1227489433,1227489703,2,14,270
41894174086@N01,5551,31,1227491870,1227492884,3,14,1014
41894174086@N01,5551,22,1227492884,1227493484,3,14,600
41894174086@N01,5551,12,1227509500,1227509740,2,14,240
41894174086@N01,5551,21,1227509794,1227509953,2,14,159
41894174086@N01,5551,3,1227509953,1227510043,2,14,90
41894174086@N01,5551,7,1227510085,1227510265,2,14,180
41894174086@N01,5551,26,1227510568,1227511468,2,14,900
41894174086@N01,5551,24,1227518297,1227519077,1,14,780
41896017@N05,5552,26,1387243189,1387244089,1,1,900
41915459@N08,5553,1,1383137982,1383138042,1,1,60
41927385@N00,5554,11,1323931024,1323931264,2,2,240
41927385@N00,5554,28,1323933962,1323934862,1,2,900
41996875@N05,5555,1,1407284620,1407284680,3,20,60
41996875@N05,5555,26,1407285188,1407286088,8,20,900
41996875@N05,5555,4,1407286603,1407286704,12,20,101
41996875@N05,5555,14,1407288565,1407288805,3,20,240
41996875@N05,5555,22,1407289091,1407289529,3,20,438
41996875@N05,5555,14,1407289529,1407289769,13,20,240
41996875@N05,5555,22,1407293195,1407293351,2,20,156
41996875@N05,5555,14,1407293351,1407293591,5,20,240
41996875@N05,5555,8,1407294837,1407294838,2,20,1
41996875@N05,5555,6,1407294838,1407294958,2,20,120
41996875@N05,5555,7,1407296273,1407296453,5,20,180
41996875@N05,5555,11,1407297863,1407298103,3,20,240
41996875@N05,5555,28,1407301070,1407301970,2,20,900
41996875@N05,5555,26,1407302288,1407303188,45,20,900
41996875@N05,5555,21,1407304307,1407304877,3,20,570
41996875@N05,5555,26,1407305883,1407306226,3,20,343
41996875@N05,5555,28,1407306226,1407307126,2,20,900
41996875@N05,5555,13,1407307768,1407308008,13,20,240
41996875@N05,5555,25,1407311343,1407312183,16,20,840
41996875@N05,5555,28,1407324437,1407325337,1,20,900
42033249@N08,5556,26,1331333151,1331334051,1,1,900
42045401@N00,5557,28,1292972339,1292973239,1,1,900
42118699@N08,5558,26,1202778767,1202779667,2,2,900
42118699@N08,5558,1,1202789767,1202789827,1,2,60
42118699@N08,5559,29,1208746326,1208747226,1,1,900
42118699@N08,5560,16,1226793073,1226793343,1,1,270
42118699@N08,5561,31,1241657967,1241659467,2,2,1500
42118699@N08,5561,6,1241680748,1241680868,1,2,120
42118699@N08,5562,18,1252303313,1252303763,1,1,450
42118699@N08,5563,29,1254129978,1254130878,2,1,900
42118699@N08,5564,4,1282605093,1282605194,3,4,101
42118699@N08,5564,10,1282628034,1282628274,2,4,240
42118699@N08,5564,8,1282634349,1282634529,2,4,180
42118699@N08,5564,26,1282634943,1282635843,4,4,900
42118699@N08,5565,29,1286172291,1286173191,1,1,900
42118699@N08,5566,16,1301485365,1301485635,2,2,270
42118699@N08,5566,30,1301489332,1301490412,2,2,1080
42118699@N08,5567,1,1301531269,1301531329,1,1,60
42118699@N08,5568,27,1311748835,1311749735,2,2,900
42118699@N08,5568,18,1311756297,1311756747,3,2,450
42118699@N08,5569,30,1311808326,1311809406,4,3,1080
42118699@N08,5569,3,1311812838,1311812928,4,3,90
42118699@N08,5569,27,1311817319,1311818219,2,3,900
42118699@N08,5570,27,1321251350,1321252250,3,3,900
42118699@N08,5570,4,1321256608,1321256709,2,3,101
42118699@N08,5570,31,1321261285,1321262785,1,3,1500
42118699@N08,5571,26,1321351495,1321352395,2,1,900
42118699@N08,5572,11,1321429028,1321429268,2,4,240
42118699@N08,5572,26,1321439187,1321439709,3,4,522
42118699@N08,5572,18,1321439709,1321439943,2,4,234
42118699@N08,5572,16,1321439943,1321440213,1,4,270
42118699@N08,5573,21,1340519966,1340520536,1,1,570
42118699@N08,5574,12,1358061699,1358061939,1,1,240
42118699@N08,5575,22,1358126912,1358126956,2,4,44
42118699@N08,5575,31,1358126956,1358128337,2,4,1381
42118699@N08,5575,28,1358128337,1358129237,2,4,900
42118699@N08,5575,4,1358145705,1358145806,1,4,101
42118699@N08,5576,24,1358302410,1358303190,1,1,780
42118699@N08,5577,29,1362475774,1362476674,2,2,900
42118699@N08,5577,5,1362478520,1362478640,2,2,120
42118699@N08,5578,29,1362536570,1362537470,1,1,900
42118699@N08,5579,26,1372234722,1372235622,1,1,900
42118699@N08,5580,12,1375514819,1375515059,3,3,240
42118699@N08,5580,26,1375516673,1375517158,3,3,485
42118699@N08,5580,28,1375517158,1375518058,1,3,900
42118699@N08,5581,15,1379559157,1379559427,2,2,270
42118699@N08,5581,13,1379562893,1379563133,2,2,240
42118699@N08,5582,26,1460118394,1460119294,1,1,900
42118699@N08,5583,15,1460168141,1460168411,2,3,270
42118699@N08,5583,25,1460174249,1460175089,2,3,840
42118699@N08,5583,16,1460176668,1460176938,1,3,270
42153022@N00,5584,10,1248768796,1248769036,16,1,240
42153022@N00,5585,10,1248821193,1248821433,574,1,240
42185804@N02,5586,10,1252304269,1252304509,1,1,240
42185804@N02,5587,27,1254013824,1254014724,2,4,900
42185804@N02,5587,15,1254040537,1254040537,2,4,0
42185804@N02,5587,17,1254040537,1254040837,2,4,300
42185804@N02,5587,24,1254041028,1254041808,1,4,780
42185804@N02,5588,24,1254998292,1254999072,2,1,780
42185804@N02,5589,17,1255276504,1255276804,1,1,300
42205475@N00,5590,28,1188185645,1188186545,2,1,900
42247438@N07,5591,26,1409397776,1409398676,1,1,900
42278743@N05,5592,26,1370494138,1370495038,8,1,900
42285744@N02,5593,22,1307354327,1307354927,1,1,600
42285744@N02,5594,19,1311461406,1311461946,1,1,540
42299049@N06,5595,6,1256772763,1256772883,6,1,120
42299049@N06,5596,6,1257229132,1257229252,2,1,120
42299049@N06,5597,6,1258419057,1258419177,3,1,120
42299049@N06,5598,6,1261052407,1261052527,1,1,120
42299049@N06,5599,6,1261797204,1261797324,1,1,120
42299049@N06,5600,6,1276240378,1276240498,1,1,120
42299049@N06,5601,6,1276336977,1276337097,2,1,120
42299049@N06,5602,6,1276504933,1276505053,1,1,120
42299049@N06,5603,6,1285507917,1285508037,1,1,120
42299049@N06,5604,6,1293188721,1293188841,1,1,120
42300125@N03,5605,7,1401155577,1401155757,1,1,180
42424870@N00,5606,1,1216984828,1216984888,1,1,60
42424870@N00,5607,1,1217050358,1217050418,2,1,60
42429171@N07,5608,28,1227767956,1227768486,2,4,530
42429171@N07,5608,26,1227768486,1227768732,4,4,246
42429171@N07,5608,8,1227768732,1227768912,2,4,180
42429171@N07,5608,25,1227770501,1227771341,1,4,840
42429171@N07,5609,26,1238323036,1238323936,1,1,900
42429171@N07,5610,22,1255237061,1255237661,2,1,600
42504117@N06,5611,12,1278914135,1278914138,2,2,3
42504117@N06,5611,31,1278914138,1278915638,1,2,1500
42504117@N06,5612,31,1284206721,1284208221,1,1,1500
42504117@N06,5613,9,1326678182,1326678362,2,1,180
42504117@N06,5614,10,1337132955,1337132990,2,2,35
42504117@N06,5614,9,1337132990,1337133170,1,2,180
42504117@N06,5615,16,1405841035,1405841036,2,6,1
42504117@N06,5615,9,1405841036,1405841039,2,6,3
42504117@N06,5615,10,1405841039,1405841044,3,6,5
42504117@N06,5615,9,1405841044,1405841047,6,6,3
42504117@N06,5615,26,1405841047,1405841048,2,6,1
42504117@N06,5615,9,1405841048,1405841228,12,6,180
42504117@N06,5616,9,1408511821,1408511821,2,2,0
42504117@N06,5616,17,1408511821,1408512121,1,2,300
42504117@N06,5617,9,1409639231,1409639411,1,1,180
42504117@N06,5618,9,1415153342,1415153522,2,1,180
42504117@N06,5619,9,1417486259,1417486439,1,1,180
42504117@N06,5620,17,1461030927,1461031227,3,5,300
42504117@N06,5620,26,1461043238,1461044138,7,5,900
42504117@N06,5620,1,1461062902,1461062962,2,5,60
42504117@N06,5620,28,1461062999,1461063899,10,5,900
42504117@N06,5620,1,1461064877,1461064937,1,5,60
42504117@N06,5621,26,1461106062,1461106962,13,7,900
42504117@N06,5621,16,1461108722,1461108992,2,7,270
42504117@N06,5621,24,1461108996,1461109776,2,7,780
42504117@N06,5621,17,1461116165,1461116465,3,7,300
42504117@N06,5621,26,1461119030,1461119727,5,7,697
42504117@N06,5621,30,1461119727,1461120807,5,7,1080
42504117@N06,5621,18,1461123454,1461123904,4,7,450
42531502@N04,5622,19,1412680199,1412680739,1,1,540
42627344@N00,5623,15,1312336456,1312336726,1,1,270
42656047@N06,5624,26,1403503888,1403504788,51,1,900
42656047@N06,5625,26,1447642213,1447643113,1,1,900
42837274@N07,5626,16,1394691328,1394691598,2,4,270
42837274@N07,5626,15,1394691876,1394692146,3,4,270
42837274@N07,5626,4,1394701731,1394701832,2,4,101
42837274@N07,5626,7,1394703053,1394703233,1,4,180
42837274@N07,5627,29,1394859178,1394860078,3,6,900
42837274@N07,5627,12,1394865010,1394865250,2,6,240
42837274@N07,5627,17,1394868357,1394868657,3,6,300
42837274@N07,5627,15,1394871294,1394871564,2,6,270
42837274@N07,5627,8,1394874715,1394874895,2,6,180
42837274@N07,5627,26,1394878942,1394879842,5,6,900
42852007@N07,5628,12,1322728267,1322728507,1,1,240
42889019@N00,5629,22,1252594207,1252594807,6,3,600
42889019@N00,5629,13,1252607773,1252608013,2,3,240
42889019@N00,5629,24,1252610588,1252611368,2,3,780
42892117@N04,5630,28,1253833370,1253834270,15,1,900
42906530@N00,5631,25,1286779854,1286780694,1,1,840
42912996@N00,5632,28,1314055835,1314056735,1,1,900
42912996@N00,5633,17,1317341552,1317341852,2,3,300
42912996@N00,5633,12,1317345175,1317345415,3,3,240
42912996@N00,5633,20,1317348514,1317349054,2,3,540
42912996@N00,5634,28,1328829123,1328830023,3,5,900
42912996@N00,5634,27,1328835257,1328836157,2,5,900
42912996@N00,5634,20,1328838452,1328838992,2,5,540
42912996@N00,5634,22,1328840228,1328840828,2,5,600
42912996@N00,5634,28,1328843736,1328844636,1,5,900
42912996@N00,5635,28,1332021522,1332022422,2,7,900
42912996@N00,5635,26,1332025856,1332025951,3,7,95
42912996@N00,5635,7,1332025951,1332026082,2,7,131
42912996@N00,5635,21,1332026082,1332026555,2,7,473
42912996@N00,5635,30,1332026555,1332027635,2,7,1080
42912996@N00,5635,18,1332030450,1332030900,2,7,450
42912996@N00,5635,28,1332036014,1332036914,1,7,900
42912996@N00,5636,7,1336272381,1336272561,2,2,180
42912996@N00,5636,28,1336274221,1336275121,1,2,900
42912996@N00,5637,26,1347011103,1347011108,2,4,5
42912996@N00,5637,18,1347011108,1347011558,2,4,450
42912996@N00,5637,27,1347011914,1347012814,2,4,900
42912996@N00,5637,29,1347016902,1347017802,1,4,900
42912996@N00,5638,28,1348970914,1348971814,2,5,900
42912996@N00,5638,20,1348978136,1348978651,2,5,515
42912996@N00,5638,30,1348978651,1348979731,2,5,1080
42912996@N00,5638,16,1348983680,1348983950,2,5,270
42912996@N00,5638,30,1348985111,1348986191,1,5,1080
42912996@N00,5639,28,1349018505,1349019405,1,1,900
42912996@N00,5640,18,1349150477,1349150927,2,7,450
42912996@N00,5640,30,1349158828,1349159908,2,7,1080
42912996@N00,5640,28,1349163321,1349164221,2,7,900
42912996@N00,5640,27,1349170630,1349170710,2,7,80
42912996@N00,5640,28,1349170710,1349170794,2,7,84
42912996@N00,5640,18,1349170794,1349171123,2,7,329
42912996@N00,5640,28,1349171123,1349172023,2,7,900
42912996@N00,5641,28,1355019191,1355020091,5,5,900
42912996@N00,5641,20,1355025295,1355025835,2,5,540
42912996@N00,5641,29,1355028115,1355029015,2,5,900
42912996@N00,5641,26,1355035206,1355035316,2,5,110
42912996@N00,5641,28,1355035316,1355036216,1,5,900
42912996@N00,5642,29,1355620969,1355621869,1,1,900
42912996@N00,5643,28,1359071303,1359072203,2,1,900
42912996@N00,5644,26,1359257675,1359258575,2,2,900
42912996@N00,5644,28,1359261127,1359262027,1,2,900
42912996@N00,5645,28,1363301995,1363302895,2,3,900
42912996@N00,5645,10,1363303975,1363304215,2,3,240
42912996@N00,5645,28,1363311459,1363312359,2,3,900
42912996@N00,5646,1,1366930735,1366930795,2,5,60
42912996@N00,5646,15,1366932428,1366932698,2,5,270
42912996@N00,5646,1,1366940746,1366940806,2,5,60
42912996@N00,5646,15,1366944908,1366945178,2,5,270
42912996@N00,5646,1,1366952027,1366952087,1,5,60
42912996@N00,5647,1,1368574058,1368574118,2,4,60
42912996@N00,5647,26,1368577107,1368578007,2,4,900
42912996@N00,5647,27,1368580849,1368581749,2,4,900
42912996@N00,5647,16,1368581892,1368582162,1,4,270
42912996@N00,5648,25,1370132070,1370132249,2,5,179
42912996@N00,5648,1,1370132249,1370132309,2,5,60
42912996@N00,5648,3,1370132448,1370132538,2,5,90
42912996@N00,5648,13,1370138078,1370138318,2,5,240
42912996@N00,5648,1,1370142943,1370143003,1,5,60
42912996@N00,5649,1,1371903811,1371903871,1,1,60
42912996@N00,5650,1,1371948219,1371948279,1,1,60
42912996@N00,5651,1,1378008924,1378008984,1,1,60
42912996@N00,5652,1,1381368351,1381368411,3,5,60
42912996@N00,5652,20,1381370058,1381370598,2,5,540
42912996@N00,5652,28,1381381219,1381382119,2,5,900
42912996@N00,5652,18,1381391296,1381391746,2,5,450
42912996@N00,5652,1,1381392769,1381392829,1,5,60
42912996@N00,5653,1,1385258657,1385258717,2,2,60
42912996@N00,5653,26,1385262367,1385263267,1,2,900
42912996@N00,5654,20,1386462419,1386462542,2,2,123
42912996@N00,5654,1,1386462542,1386462602,2,2,60
42912996@N00,5655,1,1388789703,1388789763,3,3,60
42912996@N00,5655,18,1388802435,1388802885,2,3,450
42912996@N00,5655,1,1388812011,1388812071,1,3,60
42912996@N00,5656,7,1396134323,1396134503,2,2,180
42912996@N00,5656,27,1396137119,1396138019,1,2,900
42912996@N00,5657,5,1397888913,1397889033,2,2,120
42912996@N00,5657,28,1397908079,1397908979,1,2,900
42912996@N00,5658,19,1403945465,1403946005,3,1,540
42912996@N00,5659,19,1417907684,1417908224,1,1,540
42985936@N08,5660,31,1422235386,1422236886,2,2,1500
42985936@N08,5660,13,1422241599,1422241839,1,2,240
42995562@N00,5661,1,1374917914,1374917974,3,1,60
43006884@N05,5662,1,1259632414,1259632474,2,1,60
43017856@N00,5663,17,1350865800,1350866100,1,1,300
43017856@N00,5664,28,1350896722,1350897622,1,1,900
43040292@N08,5665,20,1262651720,1262652055,2,10,335
43040292@N08,5665,14,1262652055,1262652295,5,10,240
43040292@N08,5665,22,1262652551,1262653151,2,10,600
43040292@N08,5665,11,1262656449,1262656689,2,10,240
43040292@N08,5665,25,1262658982,1262659822,4,10,840
43040292@N08,5665,13,1262660732,1262660972,4,10,240
43040292@N08,5665,16,1262665412,1262665682,4,10,270
43040292@N08,5665,26,1262667325,1262668225,4,10,900
43040292@N08,5665,16,1262676077,1262676347,2,10,270
43040292@N08,5665,17,1262678608,1262678908,1,10,300
43082306@N00,5666,26,1278992492,1278993392,3,3,900
43082306@N00,5666,30,1278994360,1278995440,2,3,1080
43082306@N00,5666,21,1279016096,1279016666,1,3,570
43082306@N00,5667,28,1279077534,1279078434,2,4,900
43082306@N00,5667,20,1279079106,1279079451,2,4,345
43082306@N00,5667,22,1279079451,1279080051,2,4,600
43082306@N00,5667,29,1279084756,1279085656,1,4,900
43082306@N00,5668,25,1279210597,1279211437,1,1,840
43082306@N00,5669,15,1279244896,1279245166,1,1,270
43082306@N00,5670,26,1279336557,1279337457,2,4,900
43082306@N00,5670,1,1279354758,1279354818,2,4,60
43082306@N00,5670,20,1279360374,1279360914,4,4,540
43082306@N00,5670,1,1279363661,1279363721,1,4,60
43082306@N00,5671,26,1311221167,1311222067,2,2,900
43082306@N00,5671,1,1311240837,1311240897,1,2,60
43082306@N00,5672,28,1311326973,1311327873,1,1,900
43082306@N00,5673,5,1311509350,1311509470,2,2,120
43082306@N00,5673,8,1311511050,1311511230,1,2,180
43082306@N00,5674,29,1346055175,1346056075,2,2,900
43082306@N00,5674,12,1346058573,1346058813,1,2,240
43082306@N00,5675,26,1346396185,1346397085,1,1,900
43082306@N00,5676,29,1379784418,1379785318,1,1,900
43082306@N00,5677,8,1405582755,1405582935,1,1,180
43086147@N08,5678,21,1374029963,1374030533,1,1,570
43108539@N03,5679,28,1298021156,1298022056,2,3,900
43108539@N03,5679,16,1298023418,1298023688,2,3,270
43108539@N03,5679,19,1298026698,1298027238,1,3,540
43108539@N03,5680,3,1298235967,1298236057,2,2,90
43108539@N03,5680,4,1298245463,1298245564,1,2,101
43108539@N03,5681,15,1306950918,1306951188,1,1,270
43126866@N06,5682,18,1244866608,1244867058,1,1,450
43157990@N00,5683,22,1337231857,1337232457,3,2,600
43157990@N00,5683,14,1337233196,1337233436,2,2,240
43157990@N00,5684,26,1337377839,1337378739,2,2,900
43157990@N00,5684,13,1337379588,1337379828,1,2,240
43168774@N04,5685,1,1417671834,1417671894,4,9,60
43168774@N04,5685,22,1417679090,1417679690,2,9,600
43168774@N04,5685,17,1417683612,1417683912,3,9,300
43168774@N04,5685,27,1417683945,1417684110,3,9,165
43168774@N04,5685,17,1417684110,1417684410,3,9,300
43168774@N04,5685,3,1417687291,1417687302,2,9,11
43168774@N04,5685,21,1417687302,1417687745,2,9,443
43168774@N04,5685,6,1417687745,1417687865,2,9,120
43168774@N04,5685,26,1417687865,1417688765,7,9,900
43171170@N06,5686,29,1293596723,1293597623,2,3,900
43171170@N06,5686,20,1293599166,1293599175,2,3,9
43171170@N06,5686,16,1293599175,1293599445,2,3,270
43195406@N05,5687,1,1294383656,1294383716,1,1,60
43195725@N00,5688,9,1255008344,1255008524,1,1,180
43195725@N00,5689,26,1255091863,1255092763,1,1,900
43195725@N00,5690,1,1255195259,1255195319,1,1,60
43195725@N00,5691,17,1300396333,1300396633,2,4,300
43195725@N00,5691,30,1300411953,1300413033,2,4,1080
43195725@N00,5691,28,1300421526,1300422426,2,4,900
43195725@N00,5691,17,1300444097,1300444397,1,4,300
43195725@N00,5692,10,1300488544,1300488784,2,7,240
43195725@N00,5692,24,1300490965,1300491745,2,7,780
43195725@N00,5692,10,1300492677,1300492917,4,7,240
43195725@N00,5692,29,1300496971,1300497871,2,7,900
43195725@N00,5692,20,1300500307,1300500847,2,7,540
43195725@N00,5692,18,1300501562,1300502012,2,7,450
43195725@N00,5692,24,1300524282,1300525062,1,7,780
43195725@N00,5693,17,1312585208,1312585508,2,10,300
43195725@N00,5693,20,1312597535,1312598075,3,10,540
43195725@N00,5693,30,1312599537,1312600617,4,10,1080
43195725@N00,5693,29,1312603131,1312604031,3,10,900
43195725@N00,5693,7,1312614721,1312614901,2,10,180
43195725@N00,5693,20,1312621260,1312621800,4,10,540
43195725@N00,5693,27,1312626487,1312627387,4,10,900
43195725@N00,5693,28,1312632386,1312633286,2,10,900
43195725@N00,5693,25,1312635382,1312636222,2,10,840
43195725@N00,5693,1,1312639589,1312639649,1,10,60
43195725@N00,5694,3,1323309322,1323309412,3,2,90
43195725@N00,5694,26,1323341866,1323342766,2,2,900
43195725@N00,5695,1,1323381329,1323381389,2,4,60
43195725@N00,5695,26,1323384302,1323385202,2,4,900
43195725@N00,5695,30,1323410085,1323410736,3,4,651
43195725@N00,5695,29,1323410736,1323411636,2,4,900
43195725@N00,5696,26,1351208931,1351209831,2,1,900
43195725@N00,5697,27,1351328045,1351328945,2,3,900
43195725@N00,5697,5,1351330145,1351330265,2,3,120
43195725@N00,5697,17,1351342717,1351343017,1,3,300
43195725@N00,5698,20,1351378221,1351378761,2,3,540
43195725@N00,5698,10,1351383315,1351383555,2,3,240
43195725@N00,5698,22,1351387209,1351387809,1,3,600
43195725@N00,5699,30,1351424985,1351426065,2,1,1080
43195725@N00,5700,30,1361496256,1361496284,2,2,28
43195725@N00,5700,24,1361496284,1361497064,1,2,780
43195725@N00,5701,30,1367027968,1367029048,2,3,1080
43195725@N00,5701,26,1367029317,1367030217,5,3,900
43195725@N00,5701,19,1367034801,1367035341,1,3,540
43195725@N00,5702,31,1367068287,1367068289,2,2,2
43195725@N00,5702,30,1367068289,1367069369,2,2,1080
43195725@N00,5703,23,1367120191,1367120791,2,2,600
43195725@N00,5703,12,1367134508,1367134748,2,2,240
43195725@N00,5704,31,1367208408,1367209908,2,2,1500
43195725@N00,5704,28,1367210156,1367211056,1,2,900
43195725@N00,5705,16,1367297244,1367297514,3,3,270
43195725@N00,5705,27,1367301950,1367302850,2,3,900
43195725@N00,5705,30,1367316006,1367317086,1,3,1080
43195725@N00,5706,10,1373594575,1373594815,2,5,240
43195725@N00,5706,16,1373601454,1373601724,3,5,270
43195725@N00,5706,17,1373612985,1373613285,2,5,300
43195725@N00,5706,1,1373616914,1373616974,2,5,60
43195725@N00,5706,22,1373619181,1373619781,1,5,600
43195725@N00,5707,28,1373699335,1373700235,2,2,900
43195725@N00,5707,9,1373718784,1373718964,1,2,180
43195725@N00,5708,3,1373790265,1373790355,2,3,90
43195725@N00,5708,18,1373796253,1373796703,2,3,450
43195725@N00,5708,27,1373803358,1373804258,1,3,900
43195725@N00,5709,28,1373841963,1373842382,2,2,419
43195725@N00,5709,23,1373842382,1373842982,2,2,600
43195725@N00,5710,18,1380333463,1380333913,1,1,450
43195725@N00,5711,18,1380370601,1380371051,2,1,450
43195725@N00,5712,26,1380409990,1380410890,1,1,900
43195725@N00,5713,30,1380460035,1380461115,2,1,1080
43195725@N00,5714,3,1380521498,1380521588,1,1,90
43195725@N00,5715,22,1380587222,1380587622,2,3,400
43195725@N00,5715,20,1380587622,1380588162,3,3,540
43195725@N00,5715,31,1380589604,1380591104,1,3,1500
43195725@N00,5716,26,1380627274,1380628174,4,2,900
43195725@N00,5716,10,1380629925,1380630165,1,2,240
43195725@N00,5717,22,1414272817,1414273417,3,7,600
43195725@N00,5717,16,1414285429,1414285699,2,7,270
43195725@N00,5717,1,1414294763,1414294823,2,7,60
43195725@N00,5717,12,1414296873,1414297113,2,7,240
43195725@N00,5717,26,1414297254,1414298154,2,7,900
43195725@N00,5717,10,1414304794,1414305034,2,7,240
43195725@N00,5717,27,1414328104,1414329004,1,7,900
43195725@N00,5718,26,1417668270,1417669170,1,1,900
43195725@N00,5719,28,1417875552,1417876452,1,1,900
43195725@N00,5720,18,1417906598,1417907048,2,2,450
43195725@N00,5720,26,1417935084,1417935984,1,2,900
43195725@N00,5721,26,1429941708,1429942608,1,1,900
43195725@N00,5722,30,1430016383,1430017463,1,1,1080
43195725@N00,5723,10,1430204213,1430204453,1,1,240
43195725@N00,5724,7,1434002571,1434002751,1,1,180
43195725@N00,5725,26,1434092896,1434093796,1,1,900
43195725@N00,5726,17,1434199675,1434199975,1,1,300
43195725@N00,5727,26,1434259435,1434260335,2,3,900
43195725@N00,5727,9,1434269408,1434269588,2,3,180
43195725@N00,5727,31,1434270650,1434272150,1,3,1500
43195725@N00,5728,10,1440574753,1440574993,1,1,240
43195725@N00,5729,30,1441187842,1441188922,1,1,1080
43207034@N06,5730,1,1440984817,1440984877,1,1,60
43232455@N07,5731,1,1424416793,1424416853,1,1,60
43232455@N07,5732,26,1425524942,1425525842,6,6,900
43232455@N07,5732,29,1425531189,1425532089,2,6,900
43232455@N07,5732,15,1425539512,1425539782,3,6,270
43232455@N07,5732,17,1425542575,1425542841,2,6,266
43232455@N07,5732,16,1425542841,1425543111,5,6,270
43232455@N07,5732,26,1425543494,1425544394,1,6,900
43232455@N07,5733,28,1426732050,1426732950,3,4,900
43232455@N07,5733,16,1426737270,1426737540,3,4,270
43232455@N07,5733,30,1426746906,1426747986,3,4,1080
43232455@N07,5733,1,1426756924,1426756984,7,4,60
43246079@N05,5734,29,1322204957,1322205857,5,1,900
43246079@N05,5735,31,1323676983,1323678483,2,3,1500
43246079@N05,5735,21,1323684250,1323684820,2,3,570
43246079@N05,5735,17,1323695395,1323695695,3,3,300
43246079@N05,5736,4,1332562967,1332563068,3,2,101
43246079@N05,5736,13,1332563413,1332563653,11,2,240
43246079@N05,5737,17,1338091712,1338092012,4,1,300
43246079@N05,5738,29,1342252721,1342253621,2,2,900
43246079@N05,5738,17,1342273713,1342274013,1,2,300
43246079@N05,5739,24,1347688261,1347689041,3,2,780
43246079@N05,5739,23,1347692060,1347692660,3,2,600
43246079@N05,5740,26,1350698616,1350699244,8,4,628
43246079@N05,5740,13,1350699244,1350699484,3,4,240
43246079@N05,5740,22,1350700282,1350700882,2,4,600
43246079@N05,5740,21,1350705209,1350705779,6,4,570
43246079@N05,5741,20,1350734416,1350734956,13,3,540
43246079@N05,5741,17,1350738487,1350738787,2,3,300
43246079@N05,5741,28,1350739086,1350739986,1,3,900
43246079@N05,5742,29,1360376245,1360377145,9,1,900
43246079@N05,5743,17,1360411775,1360412075,3,1,300
43246079@N05,5744,31,1367643889,1367644443,7,3,554
43246079@N05,5744,20,1367644443,1367644983,3,3,540
43246079@N05,5744,17,1367656415,1367656715,1,3,300
43246079@N05,5745,28,1377152919,1377153819,3,3,900
43246079@N05,5745,17,1377156269,1377156569,3,3,300
43246079@N05,5745,12,1377157710,1377157950,1,3,240
43246079@N05,5746,26,1387001226,1387002073,4,2,847
43246079@N05,5746,21,1387002073,1387002643,5,2,570
43246079@N05,5747,14,1404827983,1404828223,2,1,240
43246079@N05,5748,30,1417150688,1417151768,3,7,1080
43246079@N05,5748,29,1417158177,1417159077,2,7,900
43246079@N05,5748,25,1417169940,1417170780,13,7,840
43246079@N05,5748,17,1417173146,1417173183,6,7,37
43246079@N05,5748,27,1417173183,1417173184,2,7,1
43246079@N05,5748,17,1417173184,1417173484,2,7,300
43246079@N05,5748,26,1417174235,1417175135,5,7,900
43246079@N05,5749,26,1422058528,1422059428,2,5,900
43246079@N05,5749,17,1422068124,1422068424,2,5,300
43246079@N05,5749,31,1422085870,1422087096,2,5,1226
43246079@N05,5749,16,1422087096,1422087145,2,5,49
43246079@N05,5749,27,1422087145,1422088045,3,5,900
43246079@N05,5750,28,1422146077,1422146977,1,1,900
43246079@N05,5751,1,1423623565,1423623625,3,5,60
43246079@N05,5751,28,1423623762,1423624662,2,5,900
43246079@N05,5751,29,1423625208,1423625377,4,5,169
43246079@N05,5751,23,1423625377,1423625977,4,5,600
43246079@N05,5751,28,1423626293,1423627193,6,5,900
43300377@N07,5752,28,1324681739,1324682639,1,1,900
43300377@N07,5753,28,1327733241,1327734141,1,1,900
43317782@N00,5754,26,1203982843,1203983743,36,1,900
43317782@N00,5755,5,1213908527,1213908536,2,10,9
43317782@N00,5755,11,1213908536,1213908570,2,10,34
43317782@N00,5755,24,1213908570,1213908959,3,10,389
43317782@N00,5755,29,1213908959,1213909012,2,10,53
43317782@N00,5755,31,1213909012,1213909117,3,10,105
43317782@N00,5755,18,1213909117,1213909130,3,10,13
43317782@N00,5755,12,1213909130,1213909169,2,10,39
43317782@N00,5755,4,1213909169,1213909192,2,10,23
43317782@N00,5755,28,1213909192,1213909283,3,10,91
43317782@N00,5755,26,1213909283,1213910183,1,10,900
43317782@N00,5756,14,1224280234,1224280474,2,10,240
43317782@N00,5756,1,1224281748,1224281808,3,10,60
43317782@N00,5756,28,1224282054,1224282954,4,10,900
43317782@N00,5756,6,1224283056,1224283176,6,10,120
43317782@N00,5756,28,1224283216,1224283511,2,10,295
43317782@N00,5756,26,1224283511,1224283960,5,10,449
43317782@N00,5756,6,1224283960,1224284080,6,10,120
43317782@N00,5756,26,1224285599,1224285810,3,10,211
43317782@N00,5756,16,1224285810,1224285968,2,10,158
43317782@N00,5756,28,1224285968,1224286868,2,10,900
43317782@N00,5757,1,1238105820,1238105880,3,11,60
43317782@N00,5757,16,1238106401,1238106671,3,11,270
43317782@N00,5757,27,1238108016,1238108916,2,11,900
43317782@N00,5757,1,1238119826,1238119886,2,11,60
43317782@N00,5757,28,1238119903,1238120803,2,11,900
43317782@N00,5757,26,1238121570,1238122470,2,11,900
43317782@N00,5757,20,1238124380,1238124920,2,11,540
43317782@N00,5757,29,1238125562,1238126462,6,11,900
43317782@N00,5757,15,1238130254,1238130524,3,11,270
43317782@N00,5757,16,1238149452,1238149722,8,11,270
43317782@N00,5757,28,1238154492,1238155392,2,11,900
43317782@N00,5758,1,1264799369,1264799429,4,14,60
43317782@N00,5758,28,1264799510,1264799747,2,14,237
43317782@N00,5758,16,1264799747,1264800017,3,14,270
43317782@N00,5758,17,1264800534,1264800834,6,14,300
43317782@N00,5758,10,1264803031,1264803271,2,14,240
43317782@N00,5758,12,1264804532,1264804772,5,14,240
43317782@N00,5758,10,1264805241,1264805481,3,14,240
43317782@N00,5758,29,1264806084,1264806949,5,14,865
43317782@N00,5758,20,1264806949,1264807489,6,14,540
43317782@N00,5758,22,1264808429,1264809029,2,14,600
43317782@N00,5758,26,1264809150,1264809644,4,14,494
43317782@N00,5758,27,1264809644,1264810544,2,14,900
43317782@N00,5758,16,1264810687,1264810957,3,14,270
43317782@N00,5758,19,1264813070,1264813610,1,14,540
43317782@N00,5759,16,1264845019,1264845289,6,2,270
43317782@N00,5759,28,1264846646,1264847546,9,2,900
43317782@N00,5760,16,1264896754,1264897024,2,1,270
43317782@N00,5761,1,1291414735,1291414795,2,10,60
43317782@N00,5761,28,1291414895,1291415795,2,10,900
43317782@N00,5761,29,1291418934,1291419834,5,10,900
43317782@N00,5761,20,1291420065,1291420605,6,10,540
43317782@N00,5761,30,1291423497,1291424577,2,10,1080
43317782@N00,5761,26,1291425470,1291425497,3,10,27
43317782@N00,5761,16,1291425497,1291425767,2,10,270
43317782@N00,5761,1,1291439375,1291439435,10,10,60
43317782@N00,5761,28,1291448373,1291449273,2,10,900
43317782@N00,5761,26,1291462985,1291463885,2,10,900
43317782@N00,5762,26,1318394733,1318395380,2,4,647
43317782@N00,5762,16,1318395380,1318395609,2,4,229
43317782@N00,5762,28,1318395609,1318396135,2,4,526
43317782@N00,5762,1,1318396135,1318396195,1,4,60
43337914@N00,5763,16,1438309201,1438309471,1,1,270
43425779@N04,5764,21,1323491676,1323492246,5,1,570
43425779@N04,5765,22,1323826756,1323827356,1,1,600
43477272@N00,5766,20,1319685565,1319686105,2,2,540
43477272@N00,5766,23,1319699142,1319699742,1,2,600
43477272@N00,5767,18,1319783571,1319784021,3,1,450
43494963@N03,5768,28,1351553029,1351553677,4,2,648
43494963@N03,5768,26,1351553677,1351554577,5,2,900
43494963@N03,5769,16,1424251311,1424251581,1,1,270
43494963@N03,5770,1,1451366643,1451366703,2,7,60
43494963@N03,5770,13,1451372014,1451372254,2,7,240
43494963@N03,5770,1,1451397249,1451397309,3,7,60
43494963@N03,5770,28,1451397446,1451398346,22,7,900
43494963@N03,5770,26,1451401572,1451402287,2,7,715
43494963@N03,5770,29,1451402287,1451403187,3,7,900
43494963@N03,5770,26,1451406994,1451407894,1,7,900
43535605@N00,5771,1,1310800129,1310800189,2,2,60
43535605@N00,5771,20,1310802489,1310803029,1,2,540
43535605@N00,5772,24,1315709525,1315710305,2,6,780
43535605@N00,5772,27,1315710802,1315711702,3,6,900
43535605@N00,5772,24,1315714104,1315714884,6,6,780
43535605@N00,5772,13,1315716200,1315716217,3,6,17
43535605@N00,5772,25,1315716217,1315716869,2,6,652
43535605@N00,5772,28,1315716869,1315717769,2,6,900
43554368@N08,5773,16,1254490740,1254490994,2,3,254
43554368@N08,5773,26,1254490994,1254491894,2,3,900
43554368@N08,5773,7,1254492084,1254492264,2,3,180
43554368@N08,5774,10,1254527887,1254528127,2,2,240
43554368@N08,5774,27,1254538004,1254538904,2,2,900
43579472@N00,5775,28,1195877693,1195877702,2,7,9
43579472@N00,5775,1,1195877702,1195877722,3,7,20
43579472@N00,5775,28,1195877722,1195877728,2,7,6
43579472@N00,5775,23,1195877728,1195877735,2,7,7
43579472@N00,5775,21,1195877735,1195877739,2,7,4
43579472@N00,5775,28,1195877739,1195877760,5,7,21
43579472@N00,5775,1,1195877760,1195877820,1,7,60
43590398@N04,5776,20,1357090369,1357090909,1,1,540
43590398@N04,5777,28,1384515938,1384516838,1,1,900
43652558@N00,5778,12,1432866900,1432867140,1,1,240
43652558@N00,5779,1,1445756360,1445756420,4,7,60
43652558@N00,5779,28,1445756654,1445757554,3,7,900
43652558@N00,5779,26,1445757875,1445758775,2,7,900
43652558@N00,5779,20,1445761908,1445762448,2,7,540
43652558@N00,5779,25,1445766601,1445767441,4,7,840
43652558@N00,5779,28,1445771190,1445772090,3,7,900
43652558@N00,5779,21,1445773188,1445773758,2,7,570
43671228@N00,5780,1,1282743115,1282743175,1,1,60
43671228@N00,5781,1,1282823572,1282823632,1,1,60
43671228@N00,5782,1,1290378789,1290378849,3,1,60
43671228@N00,5783,1,1290416556,1290416616,1,1,60
43675529@N00,5784,15,1284096461,1284096731,1,1,270
43675529@N00,5785,31,1378201503,1378203003,2,2,1500
43675529@N00,5785,26,1378208493,1378209393,1,2,900
43679955@N05,5786,1,1266297231,1266297291,4,17,60
43679955@N05,5786,28,1266297345,1266297415,2,17,70
43679955@N05,5786,1,1266297415,1266297475,2,17,60
43679955@N05,5786,17,1266299394,1266299661,4,17,267
43679955@N05,5786,28,1266299661,1266300561,2,17,900
43679955@N05,5786,18,1266301372,1266301446,2,17,74
43679955@N05,5786,26,1266301446,1266301461,2,17,15
43679955@N05,5786,28,1266301461,1266301621,2,17,160
43679955@N05,5786,23,1266301621,1266302221,11,17,600
43679955@N05,5786,29,1266303374,1266303946,2,17,572
43679955@N05,5786,26,1266303946,1266304551,3,17,605
43679955@N05,5786,29,1266304551,1266305451,6,17,900
43679955@N05,5786,20,1266305506,1266306046,8,17,540
43679955@N05,5786,26,1266307433,1266307522,6,17,89
43679955@N05,5786,16,1266307522,1266307539,2,17,17
43679955@N05,5786,26,1266307539,1266308439,3,17,900
43679955@N05,5786,28,1266308615,1266309515,1,17,900
43716681@N00,5787,30,1273470270,1273471350,1,1,1080
43716681@N00,5788,30,1280103446,1280104526,1,1,1080
43716681@N00,5789,30,1280204316,1280205396,2,1,1080
43716681@N00,5790,30,1280272820,1280273900,9,1,1080
43716681@N00,5791,30,1280555629,1280556709,2,1,1080
43716681@N00,5792,30,1282105387,1282106467,1,1,1080
43716681@N00,5793,30,1282603163,1282604243,1,1,1080
43725348@N00,5794,27,1329454859,1329455237,2,6,378
43725348@N00,5794,26,1329455237,1329456137,10,6,900
43725348@N00,5794,11,1329459254,1329459494,7,6,240
43725348@N00,5794,4,1329460247,1329460348,14,6,101
43725348@N00,5794,9,1329463792,1329463972,2,6,180
43725348@N00,5794,4,1329464510,1329464611,2,6,101
43725348@N00,5795,28,1336549001,1336549901,6,5,900
43725348@N00,5795,18,1336551652,1336552102,5,5,450
43725348@N00,5795,10,1336558323,1336558563,6,5,240
43725348@N00,5795,7,1336559393,1336559400,2,5,7
43725348@N00,5795,23,1336559400,1336560000,1,5,600
43725348@N00,5796,26,1336871403,1336872303,4,8,900
43725348@N00,5796,11,1336873756,1336873996,2,8,240
43725348@N00,5796,30,1336875618,1336876698,6,8,1080
43725348@N00,5796,29,1336876746,1336877113,3,8,367
43725348@N00,5796,30,1336877113,1336878193,3,8,1080
43725348@N00,5796,15,1336881711,1336881981,2,8,270
43725348@N00,5796,23,1336887736,1336887781,2,8,45
43725348@N00,5796,18,1336887781,1336888231,1,8,450
43725348@N00,5797,11,1337910621,1337910861,4,6,240
43725348@N00,5797,10,1337910983,1337911223,4,6,240
43725348@N00,5797,11,1337912607,1337912847,3,6,240
43725348@N00,5797,10,1337916150,1337916390,2,6,240
43725348@N00,5797,11,1337917146,1337917386,7,6,240
43725348@N00,5797,13,1337921331,1337921571,4,6,240
43725348@N00,5798,27,1339228112,1339229012,3,3,900
43725348@N00,5798,11,1339234312,1339234552,3,3,240
43725348@N00,5798,10,1339235513,1339235753,2,3,240
43725348@N00,5799,28,1341122441,1341122533,2,7,92
43725348@N00,5799,26,1341122533,1341123433,4,7,900
43725348@N00,5799,24,1341131050,1341131830,14,7,780
43725348@N00,5799,30,1341136786,1341137208,2,7,422
43725348@N00,5799,20,1341137208,1341137748,4,7,540
43725348@N00,5799,23,1341138438,1341139038,3,7,600
43725348@N00,5799,28,1341141420,1341142320,4,7,900
43725348@N00,5800,1,1342858989,1342858998,2,5,9
43725348@N00,5800,28,1342858998,1342859898,4,5,900
43725348@N00,5800,31,1342863869,1342865369,2,5,1500
43725348@N00,5800,11,1342866591,1342866831,3,5,240
43725348@N00,5800,7,1342867005,1342867185,1,5,180
43725348@N00,5801,28,1343988595,1343989495,4,3,900
43725348@N00,5801,23,1343991776,1343992376,3,3,600
43725348@N00,5801,11,1343993753,1343993993,4,3,240
43725348@N00,5802,28,1345197617,1345198517,5,6,900
43725348@N00,5802,7,1345200244,1345200424,3,6,180
43725348@N00,5802,10,1345202529,1345202536,2,6,7
43725348@N00,5802,7,1345202536,1345202716,4,6,180
43725348@N00,5802,11,1345202727,1345202735,2,6,8
43725348@N00,5802,7,1345202735,1345202915,1,6,180
43725348@N00,5803,28,1353204226,1353205126,4,3,900
43725348@N00,5803,10,1353207045,1353207285,3,3,240
43725348@N00,5803,11,1353208483,1353208723,2,3,240
43725348@N00,5804,10,1356572200,1356572440,4,9,240
43725348@N00,5804,11,1356573042,1356573282,4,9,240
43725348@N00,5804,13,1356574356,1356574596,7,9,240
43725348@N00,5804,4,1356581913,1356582014,6,9,101
43725348@N00,5804,7,1356587092,1356587272,10,9,180
43725348@N00,5804,6,1356588534,1356588539,2,9,5
43725348@N00,5804,7,1356588539,1356588641,3,9,102
43725348@N00,5804,6,1356588641,1356588761,3,9,120
43725348@N00,5804,10,1356589819,1356590059,2,9,240
43725348@N00,5805,1,1357867002,1357867062,2,2,60
43725348@N00,5805,22,1357868320,1357868920,3,2,600
43725348@N00,5806,28,1359593533,1359594433,2,4,900
43725348@N00,5806,6,1359600370,1359600490,3,4,120
43725348@N00,5806,4,1359601063,1359601164,3,4,101
43725348@N00,5806,13,1359601733,1359601973,15,4,240
43726999@N06,5807,17,1387880623,1387880923,2,7,300
43726999@N06,5807,25,1387898553,1387899393,2,7,840
43726999@N06,5807,28,1387907634,1387908534,4,7,900
43726999@N06,5807,5,1387910679,1387910799,2,7,120
43726999@N06,5807,25,1387915024,1387915864,3,7,840
43726999@N06,5807,26,1387921601,1387922501,2,7,900
43726999@N06,5807,28,1387923769,1387924669,1,7,900
43726999@N06,5808,25,1427757870,1427758710,3,7,840
43726999@N06,5808,10,1427764777,1427765017,2,7,240
43726999@N06,5808,23,1427776701,1427777301,2,7,600
43726999@N06,5808,1,1427781369,1427781429,3,7,60
43726999@N06,5808,16,1427784366,1427784636,2,7,270
43726999@N06,5808,7,1427788908,1427789088,2,7,180
43726999@N06,5808,28,1427794133,1427795033,1,7,900
43824287@N02,5809,28,1356106210,1356107110,1,1,900
43825182@N00,5810,6,1229757467,1229757587,2,2,120
43825182@N00,5810,28,1229763562,1229764462,1,2,900
43825182@N00,5811,5,1278148144,1278148264,2,2,120
43825182@N00,5811,16,1278154599,1278154869,1,2,270
43825182@N00,5812,26,1282732210,1282733110,1,1,900
43825182@N00,5813,26,1288171656,1288172556,1,1,900
43825182@N00,5814,28,1289987335,1289987436,2,2,101
43825182@N00,5814,1,1289987436,1289987496,2,2,60
43825182@N00,5815,26,1291777209,1291778109,2,3,900
43825182@N00,5815,1,1291803501,1291803561,2,3,60
43825182@N00,5815,28,1291803949,1291804849,1,3,900
43825182@N00,5816,1,1294827079,1294827139,2,2,60
43825182@N00,5816,23,1294841187,1294841787,1,2,600
43825182@N00,5817,25,1308028461,1308029301,4,1,840
43825182@N00,5818,7,1317690847,1317691027,1,1,180
43825182@N00,5819,1,1321317809,1321317869,3,2,60
43825182@N00,5819,4,1321326321,1321326422,1,2,101
43825182@N00,5820,25,1322633803,1322634643,1,1,840
43825182@N00,5821,26,1323320107,1323321007,1,1,900
43825182@N00,5822,1,1327920812,1327920872,5,4,60
43825182@N00,5822,21,1327926273,1327926282,2,4,9
43825182@N00,5822,3,1327926282,1327926372,3,4,90
43825182@N00,5822,27,1327932375,1327933275,1,4,900
43825182@N00,5823,4,1331529412,1331529513,2,1,101
43825182@N00,5824,7,1335924037,1335924217,1,1,180
43825182@N00,5825,13,1337844491,1337844731,1,1,240
43825182@N00,5826,17,1371447232,1371447532,1,1,300
43825182@N00,5827,29,1372329333,1372330233,1,1,900
43826697@N08,5828,28,1411202585,1411203485,1,1,900
43826697@N08,5829,19,1411345055,1411345595,1,1,540
43841868@N05,5830,1,1284693474,1284693502,2,9,28
43841868@N05,5830,28,1284693502,1284693848,3,9,346
43841868@N05,5830,15,1284693848,1284694118,9,9,270
43841868@N05,5830,27,1284702555,1284703455,2,9,900
43841868@N05,5830,16,1284706624,1284706894,2,9,270
43841868@N05,5830,24,1284708331,1284709111,2,9,780
43841868@N05,5830,29,1284711096,1284711996,2,9,900
43841868@N05,5830,16,1284715210,1284715480,2,9,270
43841868@N05,5830,26,1284715936,1284716836,26,9,900
43942132@N00,5831,1,1289350710,1289350770,1,1,60
43942132@N00,5832,18,1434839883,1434840333,1,1,450
43942132@N00,5833,18,1437900181,1437900631,1,1,450
43942132@N00,5834,18,1441545807,1441546257,1,1,450
43942132@N00,5835,28,1442100618,1442101518,1,1,900
43942132@N00,5836,18,1450012224,1450012674,1,1,450
43942132@N00,5837,18,1453720299,1453720749,1,1,450
43944357@N00,5838,24,1201135142,1201135922,5,2,780
43944357@N00,5838,27,1201139312,1201140212,4,2,900
44029976@N00,5839,14,1319181766,1319181834,2,5,68
44029976@N00,5839,22,1319181834,1319182333,3,5,499
44029976@N00,5839,20,1319182333,1319182873,2,5,540
44029976@N00,5839,27,1319185864,1319186764,2,5,900
44029976@N00,5839,28,1319187259,1319188159,1,5,900
44065701@N00,5840,19,1416057120,1416057660,1,1,540
44065701@N00,5841,18,1444600312,1444600762,2,1,450
44065701@N00,5842,17,1454103519,1454103819,2,2,300
44065701@N00,5842,18,1454112826,1454113276,2,2,450
44118591@N00,5843,16,1225589161,1225589431,3,1,270
44124316579@N01,5844,1,1401658550,1401658610,2,3,60
44124316579@N01,5844,26,1401660095,1401660995,3,3,900
44124316579@N01,5844,27,1401670517,1401671417,1,3,900
44124329770@N01,5845,1,1219790324,1219790384,3,6,60
44124329770@N01,5845,18,1219797978,1219798428,3,6,450
44124329770@N01,5845,22,1219809023,1219809623,3,6,600
44124329770@N01,5845,21,1219815245,1219815815,11,6,570
44124329770@N01,5845,13,1219817044,1219817284,5,6,240
44124329770@N01,5845,28,1219835651,1219836551,9,6,900
44124329770@N01,5846,14,1408354831,1408355071,6,1,240
44124364198@N01,5847,18,1358068712,1358069162,1,1,450
44124364198@N01,5848,30,1359773619,1359774699,1,1,1080
44124364198@N01,5849,29,1363251286,1363252186,2,1,900
44124364198@N01,5850,13,1381736070,1381736310,1,1,240
44124364198@N01,5851,3,1418705850,1418705940,1,1,90
44124364198@N01,5852,28,1432387831,1432388731,1,1,900
44124364198@N01,5853,23,1437535707,1437536307,1,1,600
44124364198@N01,5854,23,1461578273,1461578873,1,1,600
44124364198@N01,5855,28,1463883781,1463884681,1,1,900
44124364198@N01,5856,28,1469274715,1469275615,2,5,900
44124364198@N01,5856,30,1469276583,1469277663,2,5,1080
44124364198@N01,5856,18,1469279515,1469279931,2,5,416
44124364198@N01,5856,23,1469279931,1469280531,2,5,600
44124364198@N01,5856,26,1469281041,1469281941,1,5,900
44124377471@N01,5857,30,1292223200,1292224280,2,4,1080
44124377471@N01,5857,3,1292224670,1292224760,2,4,90
44124377471@N01,5857,7,1292229201,1292229381,2,4,180
44124377471@N01,5857,29,1292234814,1292235714,1,4,900
44124377471@N01,5858,30,1292324977,1292326057,1,1,1080
44124377471@N01,5859,25,1299217202,1299218042,2,3,840
44124377471@N01,5859,13,1299219108,1299219348,2,3,240
44124377471@N01,5859,17,1299226996,1299227296,1,3,300
44124377471@N01,5860,25,1312863393,1312864233,1,1,840
44124377471@N01,5861,30,1320193642,1320194532,2,11,890
44124377471@N01,5861,18,1320194532,1320194982,2,11,450
44124377471@N01,5861,27,1320197181,1320198081,2,11,900
44124377471@N01,5861,20,1320208916,1320208923,2,11,7
44124377471@N01,5861,19,1320208923,1320209463,3,11,540
44124377471@N01,5861,18,1320209627,1320209773,3,11,146
44124377471@N01,5861,28,1320209773,1320210452,2,11,679
44124377471@N01,5861,20,1320210452,1320210992,9,11,540
44124377471@N01,5861,13,1320213686,1320213926,7,11,240
44124377471@N01,5861,7,1320216140,1320216320,2,11,180
44124377471@N01,5861,13,1320217253,1320217493,5,11,240
44124377471@N01,5862,19,1320278071,1320278611,1,1,540
44124377471@N01,5863,7,1328429430,1328429610,2,3,180
44124377471@N01,5863,5,1328435474,1328435594,2,3,120
44124377471@N01,5863,30,1328441422,1328442502,1,3,1080
44124377471@N01,5864,14,1352009005,1352009245,2,2,240
44124377471@N01,5864,23,1352019700,1352020300,1,2,600
44124377471@N01,5865,7,1357793188,1357793256,2,3,68
44124377471@N01,5865,3,1357793256,1357793346,2,3,90
44124377471@N01,5865,17,1357811084,1357811384,1,3,300
44124377471@N01,5866,31,1364444649,1364446149,1,1,1500
44124377471@N01,5867,7,1373522334,1373522386,2,3,52
44124377471@N01,5867,5,1373522386,1373522506,2,3,120
44124377471@N01,5867,3,1373527845,1373527935,1,3,90
44124377471@N01,5868,31,1384236086,1384237586,1,1,1500
44124377471@N01,5869,27,1420546080,1420546980,1,1,900
44124415797@N01,5870,13,1357360888,1357361128,2,2,240
44124415797@N01,5870,3,1357376944,1357377034,1,2,90
44124415797@N01,5871,13,1357953801,1357954041,1,1,240
44124426205@N01,5872,1,1317891860,1317891920,5,1,60
44124426205@N01,5873,1,1317945822,1317945882,34,1,60
44124426205@N01,5874,1,1318110759,1318110819,1,1,60
44124426205@N01,5875,1,1318143640,1318143700,5,1,60
44124426205@N01,5876,1,1318204737,1318204797,10,1,60
44124426205@N01,5877,1,1318289574,1318289634,8,1,60
44124426205@N01,5878,23,1447320649,1447321249,2,2,600
44124426205@N01,5878,18,1447327215,1447327665,1,2,450
44124426205@N01,5879,26,1447357032,1447357135,3,6,103
44124426205@N01,5879,8,1447357135,1447357315,2,6,180
44124426205@N01,5879,20,1447357631,1447357801,2,6,170
44124426205@N01,5879,14,1447357801,1447357907,3,6,106
44124426205@N01,5879,20,1447357907,1447358447,2,6,540
44124426205@N01,5879,18,1447369810,1447370260,3,6,450
44124426205@N01,5880,18,1447484291,1447484741,1,1,450
44124426205@N01,5881,25,1447646607,1447647447,2,6,840
44124426205@N01,5881,18,1447657646,1447657656,2,6,10
44124426205@N01,5881,25,1447657656,1447658496,2,6,840
44124426205@N01,5881,18,1447665683,1447666133,2,6,450
44124426205@N01,5881,3,1447670429,1447670519,2,6,90
44124426205@N01,5881,18,1447674785,1447675235,1,6,450
44124426205@N01,5882,18,1447723901,1447724351,1,1,450
44124426205@N01,5883,18,1448249985,1448250435,1,1,450
44124473586@N01,5884,27,1340885805,1340885816,2,2,11
44124473586@N01,5884,7,1340885816,1340885996,1,2,180
44124473586@N01,5885,28,1340960933,1340961833,1,1,900
44124473586@N01,5886,30,1341068132,1341069212,2,7,1080
44124473586@N01,5886,27,1341070333,1341071233,2,7,900
44124473586@N01,5886,17,1341071540,1341071840,2,7,300
44124473586@N01,5886,27,1341071847,1341072747,2,7,900
44124473586@N01,5886,1,1341073489,1341073549,2,7,60
44124473586@N01,5886,15,1341073559,1341073819,2,7,260
44124473586@N01,5886,28,1341073819,1341074719,1,7,900
44124473586@N01,5887,28,1341213673,1341213918,2,4,245
44124473586@N01,5887,24,1341213918,1341214698,2,4,780
44124473586@N01,5887,7,1341234862,1341235042,2,4,180
44124473586@N01,5887,28,1341240206,1341241106,1,4,900
44124484402@N01,5888,29,1247891634,1247892534,1,1,900
44152828@N06,5889,30,1255927165,1255928245,2,2,1080
44152828@N06,5889,17,1255933002,1255933302,1,2,300
44164246@N00,5890,28,1273125711,1273126252,6,12,541
44164246@N00,5890,27,1273126252,1273127152,5,12,900
44164246@N00,5890,16,1273130038,1273130308,3,12,270
44164246@N00,5890,26,1273130326,1273130423,2,12,97
44164246@N00,5890,23,1273130423,1273131023,3,12,600
44164246@N00,5890,29,1273132061,1273132961,4,12,900
44164246@N00,5890,13,1273135675,1273135915,58,12,240
44164246@N00,5890,4,1273145158,1273145259,6,12,101
44164246@N00,5890,5,1273145475,1273145574,4,12,99
44164246@N00,5890,7,1273145574,1273145754,2,12,180
44164246@N00,5890,4,1273145791,1273145864,5,12,73
44164246@N00,5890,6,1273145864,1273145984,15,12,120
44164246@N00,5891,28,1273224378,1273224689,5,20,311
44164246@N00,5891,16,1273224689,1273224959,7,20,270
44164246@N00,5891,27,1273225231,1273225361,7,20,130
44164246@N00,5891,29,1273225361,1273226261,7,20,900
44164246@N00,5891,30,1273231897,1273232886,2,20,989
44164246@N00,5891,29,1273232886,1273233786,3,20,900
44164246@N00,5891,16,1273233861,1273234040,11,20,179
44164246@N00,5891,26,1273234040,1273234147,4,20,107
44164246@N00,5891,8,1273234147,1273234221,5,20,74
44164246@N00,5891,26,1273234221,1273234332,7,20,111
44164246@N00,5891,8,1273234332,1273234512,5,20,180
44164246@N00,5891,7,1273234950,1273235130,4,20,180
44164246@N00,5891,26,1273235999,1273236214,11,20,215
44164246@N00,5891,3,1273236214,1273236245,3,20,31
44164246@N00,5891,5,1273236245,1273236365,4,20,120
44164246@N00,5891,21,1273236393,1273236665,8,20,272
44164246@N00,5891,13,1273236665,1273236905,22,20,240
44164246@N00,5891,21,1273239061,1273239448,5,20,387
44164246@N00,5891,8,1273239448,1273239604,2,20,156
44164246@N00,5891,16,1273239604,1273239874,1,20,270
44169189@N06,5892,1,1357607506,1357607566,3,17,60
44169189@N06,5892,28,1357607589,1357607735,3,17,146
44169189@N06,5892,1,1357607735,1357607795,3,17,60
44169189@N06,5892,28,1357607866,1357608145,3,17,279
44169189@N06,5892,16,1357608145,1357608415,2,17,270
44169189@N06,5892,12,1357608546,1357608786,8,17,240
44169189@N06,5892,17,1357609842,1357610142,5,17,300
44169189@N06,5892,25,1357612396,1357613236,4,17,840
44169189@N06,5892,4,1357613866,1357613967,2,17,101
44169189@N06,5892,5,1357613995,1357614115,4,17,120
44169189@N06,5892,21,1357614800,1357614959,3,17,159
44169189@N06,5892,13,1357614959,1357615199,11,17,240
44169189@N06,5892,26,1357618088,1357618988,5,17,900
44169189@N06,5892,10,1357620516,1357620756,2,17,240
44169189@N06,5892,18,1357622793,1357623243,3,17,450
44169189@N06,5892,12,1357634758,1357634998,2,17,240
44169189@N06,5892,1,1357645925,1357645985,1,17,60
44169189@N06,5893,14,1357698098,1357698338,6,9,240
44169189@N06,5893,13,1357703654,1357703894,12,9,240
44169189@N06,5893,18,1357709575,1357710025,2,9,450
44169189@N06,5893,8,1357711104,1357711284,3,9,180
44169189@N06,5893,5,1357711610,1357711730,3,9,120
44169189@N06,5893,26,1357713643,1357714543,3,9,900
44169189@N06,5893,18,1357715404,1357715854,2,9,450
44169189@N06,5893,10,1357720602,1357720842,2,9,240
44169189@N06,5893,25,1357722720,1357723560,5,9,840
44175133@N00,5894,29,1348856156,1348857056,2,4,900
44175133@N00,5894,30,1348858234,1348859314,2,4,1080
44175133@N00,5894,15,1348864577,1348864847,3,4,270
44175133@N00,5894,17,1348873245,1348873545,2,4,300
44188899@N00,5895,23,1340943863,1340944463,3,1,600
44225859@N00,5896,28,1188806828,1188807728,1,1,900
44275181@N00,5897,20,1425722495,1425723035,1,1,540
44279418@N00,5898,26,1206396245,1206397145,3,6,900
44279418@N00,5898,22,1206412894,1206413494,2,6,600
44279418@N00,5898,17,1206417401,1206417701,2,6,300
44279418@N00,5898,3,1206419079,1206419169,8,6,90
44279418@N00,5898,6,1206420863,1206420983,2,6,120
44279418@N00,5898,30,1206421974,1206423054,3,6,1080
44279418@N00,5899,16,1206488219,1206488489,1,1,270
44281290@N06,5900,26,1199307726,1199308626,1,1,900
44312671@N03,5901,28,1325147854,1325148754,1,1,900
44312671@N03,5902,26,1326809642,1326810542,1,1,900
44315537@N03,5903,20,1376478736,1376479276,1,1,540
44319460@N06,5904,12,1324616569,1324616809,1,1,240
44356659@N00,5905,8,1195650000,1195650180,14,1,180
44356659@N00,5906,8,1195696058,1195696238,1,1,180
44404893@N00,5907,26,1241915062,1241915962,2,1,900
44404893@N00,5908,24,1303267820,1303268600,1,1,780
44412006@N00,5909,26,1338817034,1338817934,1,1,900
44412893@N02,5910,18,1439514352,1439514802,2,4,450
44412893@N02,5910,23,1439515069,1439515166,2,4,97
44412893@N02,5910,1,1439515166,1439515226,2,4,60
44412893@N02,5910,18,1439520619,1439521069,1,4,450
44433267@N07,5911,22,1353551438,1353552038,2,2,600
44433267@N07,5911,23,1353560848,1353561448,1,2,600
44476715@N00,5912,26,1347025022,1347025151,2,2,129
44476715@N00,5912,28,1347025151,1347026051,1,2,900
44476715@N00,5913,26,1350675903,1350676803,1,1,900
44476715@N00,5914,25,1354586885,1354587725,2,2,840
44476715@N00,5914,28,1354599255,1354600155,2,2,900
44476715@N00,5915,29,1355638058,1355638958,2,4,900
44476715@N00,5915,18,1355640756,1355641206,2,4,450
44476715@N00,5915,28,1355646281,1355647181,2,4,900
44476715@N00,5915,1,1355647258,1355647318,2,4,60
44476715@N00,5916,28,1359247428,1359248328,3,4,900
44476715@N00,5916,27,1359262876,1359263776,2,4,900
44476715@N00,5916,28,1359268161,1359268960,3,4,799
44476715@N00,5916,1,1359268960,1359269020,1,4,60
44476715@N00,5917,29,1359773207,1359774107,2,3,900
44476715@N00,5917,30,1359776626,1359777706,3,3,1080
44476715@N00,5917,28,1359783708,1359784608,1,3,900
44504403@N00,5918,19,1246583177,1246583717,1,1,540
44545287@N07,5919,22,1267069293,1267069893,1,1,600
44547231@N00,5920,14,1236316258,1236316498,1,1,240
44596751@N00,5921,3,1313847009,1313847099,1,1,90
44606632@N02,5922,20,1255919947,1255920487,1,1,540
44606632@N02,5923,28,1283253010,1283253910,6,1,900
44606632@N02,5924,28,1284370051,1284370951,1,1,900
44606632@N02,5925,1,1290582559,1290582619,2,4,60
44606632@N02,5925,28,1290591503,1290592403,3,4,900
44606632@N02,5925,26,1290592804,1290593704,2,4,900
44606632@N02,5925,28,1290594387,1290595287,1,4,900
44606632@N02,5926,29,1294097678,1294098578,2,2,900
44606632@N02,5926,16,1294105629,1294105899,1,2,270
44616109@N08,5927,1,1377908550,1377908610,2,4,60
44616109@N08,5927,27,1377909998,1377910898,2,4,900
44616109@N08,5927,26,1377912312,1377913212,2,4,900
44616109@N08,5927,25,1377916017,1377916857,1,4,840
44616109@N08,5928,1,1391744628,1391744688,1,1,60
44666755@N07,5929,1,1415612654,1415612714,1,1,60
44734355@N07,5930,3,1291643758,1291643848,4,2,90
44734355@N07,5930,18,1291649626,1291650076,1,2,450
44743972@N00,5931,27,1408158911,1408159811,2,1,900
44783403@N05,5932,26,1376481493,1376482393,2,1,900
44795208@N00,5933,26,1304035926,1304036826,2,7,900
44795208@N00,5933,17,1304052364,1304052664,3,7,300
44795208@N00,5933,27,1304056235,1304057135,2,7,900
44795208@N00,5933,30,1304058843,1304059923,4,7,1080
44795208@N00,5933,18,1304061196,1304061646,2,7,450
44795208@N00,5933,16,1304064226,1304064496,2,7,270
44795208@N00,5933,27,1304082200,1304083100,1,7,900
44835587@N05,5934,1,1421397588,1421397648,1,1,60
44835587@N05,5935,1,1421433091,1421433151,2,1,60
44835587@N05,5936,1,1421489893,1421489953,3,1,60
44835587@N05,5937,1,1421523671,1421523731,16,1,60
44835587@N05,5938,1,1421562437,1421562497,2,1,60
44888637@N00,5939,7,1221557580,1221557760,2,1,180
44891756@N00,5940,28,1230620013,1230620034,2,2,21
44891756@N00,5940,26,1230620034,1230620934,1,2,900
44934431@N00,5941,13,1306039651,1306039891,2,2,240
44934431@N00,5941,28,1306064609,1306065509,1,2,900
44934431@N00,5942,26,1306110641,1306111541,1,1,900
44941607@N00,5943,29,1339898543,1339899443,6,4,900
44941607@N00,5943,22,1339912220,1339912815,2,4,595
44941607@N00,5943,14,1339912815,1339913055,2,4,240
44941607@N00,5943,16,1339918967,1339919237,1,4,270
44941607@N00,5944,22,1341843799,1341844399,1,1,600
44947832@N03,5945,22,1320030837,1320031437,1,1,600
44957651@N00,5946,13,1210398308,1210398548,2,2,240
44957651@N00,5946,12,1210399383,1210399623,1,2,240
44957651@N00,5947,17,1210507355,1210507655,2,2,300
44957651@N00,5947,26,1210510884,1210511784,1,2,900
44957651@N00,5948,12,1210770021,1210770033,2,2,12
44957651@N00,5948,29,1210770033,1210770933,1,2,900
44957651@N00,5949,25,1233987923,1233988763,1,1,840
44957651@N00,5950,23,1242469594,1242470194,2,1,600
44957651@N00,5951,17,1267424831,1267425131,1,1,300
44957651@N00,5952,26,1278671904,1278672804,1,1,900
44957651@N00,5953,26,1291693186,1291694086,2,2,900
44957651@N00,5953,28,1291709663,1291710563,1,2,900
44957651@N00,5954,22,1301547632,1301548232,4,2,600
44957651@N00,5954,25,1301576062,1301576902,1,2,840
44957651@N00,5955,25,1307724547,1307725387,3,2,840
44957651@N00,5955,31,1307726474,1307727974,2,2,1500
44957651@N00,5956,28,1323013689,1323014589,3,2,900
44957651@N00,5956,13,1323027033,1323027273,1,2,240
44957651@N00,5957,1,1323098487,1323098547,2,2,60
44957651@N00,5957,22,1323104706,1323105306,1,2,600
44957651@N00,5958,13,1337115334,1337115574,1,1,240
44957651@N00,5959,1,1378089563,1378089623,2,2,60
44957651@N00,5959,16,1378109365,1378109635,1,2,270
44957651@N00,5960,1,1379569292,1379569352,2,3,60
44957651@N00,5960,12,1379569794,1379570034,2,3,240
44957651@N00,5960,31,1379577690,1379579190,1,3,1500
44957651@N00,5961,28,1385963704,1385964604,1,1,900
44957651@N00,5962,30,1419829531,1419830611,1,1,1080
44957651@N00,5963,22,1420607990,1420608590,1,1,600
44957651@N00,5964,4,1421279995,1421280096,2,3,101
44957651@N00,5964,11,1421280116,1421280225,2,3,109
44957651@N00,5964,21,1421280225,1421280795,1,3,570
44991103@N05,5965,26,1287870349,1287871249,44,1,900
45007004@N00,5966,26,1192061224,1192062124,10,1,900
45032460@N06,5967,17,1420239581,1420239601,2,17,20
45032460@N06,5967,28,1420239601,1420240501,2,17,900
45032460@N06,5967,17,1420244221,1420244521,2,17,300
45032460@N06,5967,27,1420245978,1420246878,2,17,900
45032460@N06,5967,13,1420247397,1420247637,4,17,240
45032460@N06,5967,9,1420248503,1420248653,2,17,150
45032460@N06,5967,26,1420248653,1420249553,3,17,900
45032460@N06,5967,20,1420250397,1420250937,4,17,540
45032460@N06,5967,31,1420254710,1420256210,2,17,1500
45032460@N06,5967,18,1420259113,1420259563,5,17,450
45032460@N06,5967,29,1420260871,1420261105,2,17,234
45032460@N06,5967,28,1420261105,1420262005,2,17,900
45032460@N06,5967,26,1420268211,1420268739,2,17,528
45032460@N06,5967,16,1420268739,1420269009,3,17,270
45032460@N06,5967,25,1420270680,1420271155,2,17,475
45032460@N06,5967,26,1420271155,1420271299,2,17,144
45032460@N06,5967,28,1420271299,1420272199,2,17,900
45032460@N06,5968,1,1452896311,1452896371,3,4,60
45032460@N06,5968,14,1452902013,1452902253,10,4,240
45032460@N06,5968,28,1452930051,1452930116,2,4,65
45032460@N06,5968,16,1452930116,1452930386,1,4,270
45032460@N06,5969,28,1453013713,1453014613,3,4,900
45032460@N06,5969,15,1453016121,1453016391,7,4,270
45032460@N06,5969,28,1453020423,1453021323,2,4,900
45032460@N06,5969,15,1453028031,1453028301,1,4,270
45032460@N06,5970,27,1453070248,1453071148,2,3,900
45032460@N06,5970,18,1453078114,1453078564,2,3,450
45032460@N06,5970,28,1453086139,1453087039,3,3,900
45056833@N05,5971,30,1289111601,1289111604,2,5,3
45056833@N05,5971,28,1289111604,1289111608,2,5,4
45056833@N05,5971,16,1289111608,1289111613,2,5,5
45056833@N05,5971,18,1289111613,1289111616,2,5,3
45056833@N05,5971,15,1289111616,1289111886,2,5,270
45067258@N00,5972,29,1339225652,1339225963,2,2,311
45067258@N00,5972,31,1339225963,1339227463,1,2,1500
45067258@N00,5973,31,1340295465,1340296965,1,1,1500
45067258@N00,5974,1,1342836134,1342836194,15,1,60
45067258@N00,5975,13,1342939671,1342939679,2,4,8
45067258@N00,5975,4,1342939679,1342939780,2,4,101
45067258@N00,5975,13,1342940091,1342940331,4,4,240
45067258@N00,5975,28,1342944425,1342945325,4,4,900
45067258@N00,5976,17,1353115419,1353115719,2,2,300
45067258@N00,5976,26,1353116564,1353117464,1,2,900
45067258@N00,5977,30,1359169469,1359170549,2,1,1080
45067258@N00,5978,26,1366340575,1366341475,2,1,900
45067258@N00,5979,18,1376266650,1376267100,1,1,450
45067258@N00,5980,16,1439550158,1439550428,2,2,270
45067258@N00,5980,18,1439550682,1439551132,4,2,450
45067258@N00,5981,28,1439728705,1439729605,41,1,900
45067258@N00,5982,28,1439786342,1439787242,4,1,900
45104424@N00,5983,10,1200940063,1200940303,2,10,240
45104424@N00,5983,22,1200944533,1200945133,3,10,600
45104424@N00,5983,20,1200945532,1200946072,2,10,540
45104424@N00,5983,19,1200946266,1200946692,3,10,426
45104424@N00,5983,18,1200946692,1200947142,2,10,450
45104424@N00,5983,23,1200955097,1200955697,2,10,600
45104424@N00,5983,16,1200959399,1200959669,3,10,270
45104424@N00,5983,28,1200965181,1200966053,2,10,872
45104424@N00,5983,26,1200966053,1200966953,3,10,900
45104424@N00,5983,27,1200980107,1200981007,2,10,900
45104424@N00,5984,10,1295384526,1295384766,2,3,240
45104424@N00,5984,15,1295392390,1295392660,2,3,270
45104424@N00,5984,26,1295396554,1295397454,1,3,900
45104424@N00,5985,16,1328118642,1328118912,2,2,270
45104424@N00,5985,30,1328143733,1328144813,1,2,1080
45121853@N06,5986,1,1361070522,1361070582,2,3,60
45121853@N06,5986,3,1361081483,1361081573,2,3,90
45121853@N06,5986,21,1361081630,1361082200,5,3,570
45121853@N06,5987,30,1364803217,1364804297,1,1,1080
45121853@N06,5988,1,1369559241,1369559301,1,1,60
45121853@N06,5989,28,1388497805,1388498705,1,1,900
45130440@N03,5990,26,1362445147,1362446047,1,1,900
45130440@N03,5991,1,1369275639,1369275699,2,2,60
45130440@N03,5991,13,1369298235,1369298475,1,2,240
45130440@N03,5992,1,1380260962,1380261022,2,3,60
45130440@N03,5992,28,1380267113,1380268013,3,3,900
45130440@N03,5992,18,1380279501,1380279951,1,3,450
45130440@N03,5993,26,1383604690,1383605590,2,2,900
45130440@N03,5993,23,1383616522,1383617122,1,2,600
45130440@N03,5994,19,1416636447,1416636987,1,1,540
45130440@N03,5995,18,1432195050,1432195500,1,1,450
45267362@N03,5996,18,1415925133,1415925583,17,14,450
45267362@N03,5996,26,1415932163,1415932776,2,14,613
45267362@N03,5996,18,1415932776,1415933226,2,14,450
45267362@N03,5996,20,1415934931,1415935471,4,14,540
45267362@N03,5996,28,1415938708,1415939608,9,14,900
45267362@N03,5996,1,1415940710,1415940770,2,14,60
45267362@N03,5996,20,1415942086,1415942626,4,14,540
45267362@N03,5996,28,1415946135,1415946486,2,14,351
45267362@N03,5996,15,1415946486,1415946756,2,14,270
45267362@N03,5996,25,1415950497,1415951337,2,14,840
45267362@N03,5996,28,1415957493,1415957615,2,14,122
45267362@N03,5996,1,1415957615,1415957675,2,14,60
45267362@N03,5996,25,1415958799,1415959639,2,14,840
45267362@N03,5996,1,1415964273,1415964333,2,14,60
45303279@N00,5997,20,1193138697,1193139149,2,3,452
45303279@N00,5997,26,1193139149,1193139361,3,3,212
45303279@N00,5997,20,1193139361,1193139901,1,3,540
45303279@N00,5998,10,1194350082,1194350322,1,1,240
45303279@N00,5999,1,1202033215,1202033275,2,2,60
45303279@N00,5999,26,1202035017,1202035917,1,2,900
45303279@N00,6000,26,1228202532,1228203432,2,1,900
45303279@N00,6001,26,1228727202,1228728102,4,1,900
45303279@N00,6002,26,1233013905,1233014805,2,1,900
45303279@N00,6003,26,1233186681,1233187581,1,1,900
45303279@N00,6004,26,1235000069,1235000969,9,1,900
45303279@N00,6005,26,1235345002,1235345902,9,1,900
45303279@N00,6006,26,1235514627,1235515527,12,1,900
45303279@N00,6007,19,1236038033,1236038573,2,2,540
45303279@N00,6007,26,1236039468,1236040368,3,2,900
45303279@N00,6008,24,1236396790,1236397570,1,1,780
45303279@N00,6009,26,1237243005,1237243905,1,1,900
45303279@N00,6010,26,1237846245,1237847145,16,1,900
45303279@N00,6011,26,1251266610,1251267510,17,1,900
45303279@N00,6012,26,1252464225,1252465125,6,1,900
45303279@N00,6013,26,1262326991,1262327891,26,1,900
45303279@N00,6014,26,1263167739,1263168639,44,1,900
45303279@N00,6015,26,1264376810,1264377710,82,1,900
45303279@N00,6016,26,1265506609,1265507509,2,1,900
45303279@N00,6017,26,1266303830,1266304730,2,1,900
45303279@N00,6018,26,1267057018,1267057918,11,1,900
45303279@N00,6019,26,1270290335,1270291235,14,1,900
45323160@N00,6020,20,1210801543,1210802083,2,4,540
45323160@N00,6020,21,1210817168,1210817537,3,4,369
45323160@N00,6020,5,1210817537,1210817657,5,4,120
45323160@N00,6020,26,1210818793,1210819693,1,4,900
45323160@N00,6021,1,1210908638,1210908698,1,1,60
45323160@N00,6022,28,1211084355,1211085255,1,1,900
45352977@N05,6023,1,1350778651,1350778711,2,4,60
45352977@N05,6023,29,1350780829,1350781729,2,4,900
45352977@N05,6023,14,1350781930,1350782170,3,4,240
45352977@N05,6023,30,1350785672,1350786752,1,4,1080
45352977@N05,6024,26,1366009128,1366010028,2,1,900
45352977@N05,6025,1,1369179971,1369180031,2,11,60
45352977@N05,6025,28,1369180153,1369180455,2,11,302
45352977@N05,6025,26,1369180455,1369181355,2,11,900
45352977@N05,6025,4,1369181847,1369181948,3,11,101
45352977@N05,6025,7,1369184328,1369184508,2,11,180
45352977@N05,6025,3,1369185355,1369185445,2,11,90
45352977@N05,6025,24,1369188808,1369189588,2,11,780
45352977@N05,6025,18,1369198206,1369198656,3,11,450
45352977@N05,6025,29,1369200995,1369201895,2,11,900
45352977@N05,6025,18,1369203419,1369203869,2,11,450
45352977@N05,6025,14,1369210338,1369210578,1,11,240
45352977@N05,6026,16,1369272923,1369273193,3,5,270
45352977@N05,6026,26,1369275889,1369276789,3,5,900
45352977@N05,6026,25,1369278071,1369278911,2,5,840
45352977@N05,6026,27,1369281642,1369282542,2,5,900
45352977@N05,6026,15,1369283451,1369283721,1,5,270
45352977@N05,6027,1,1381373686,1381373746,2,4,60
45352977@N05,6027,28,1381380695,1381381595,2,4,900
45352977@N05,6027,20,1381382630,1381383170,2,4,540
45352977@N05,6027,24,1381383778,1381384558,1,4,780
45352977@N05,6028,1,1384735461,1384735521,2,9,60
45352977@N05,6028,28,1384736964,1384737864,2,9,900
45352977@N05,6028,1,1384738048,1384738108,2,9,60
45352977@N05,6028,14,1384742332,1384742572,2,9,240
45352977@N05,6028,29,1384746680,1384747580,2,9,900
45352977@N05,6028,7,1384749642,1384749822,3,9,180
45352977@N05,6028,3,1384753082,1384753172,2,9,90
45352977@N05,6028,24,1384753447,1384754227,2,9,780
45352977@N05,6028,1,1384763704,1384763764,1,9,60
45352977@N05,6029,28,1384994992,1384995892,2,3,900
45352977@N05,6029,26,1385007007,1385007907,2,3,900
45352977@N05,6029,13,1385014808,1385015048,1,3,240
45352977@N05,6030,1,1397015798,1397015858,2,3,60
45352977@N05,6030,29,1397023528,1397024428,2,3,900
45352977@N05,6030,30,1397025543,1397026623,1,3,1080
45352977@N05,6031,19,1402966128,1402966668,2,3,540
45352977@N05,6031,20,1402972918,1402973458,2,3,540
45352977@N05,6031,14,1402980355,1402980595,2,3,240
45352977@N05,6032,19,1405483098,1405483638,1,1,540
45352977@N05,6033,19,1409535137,1409535185,2,3,48
45352977@N05,6033,3,1409535185,1409535275,2,3,90
45352977@N05,6033,4,1409548901,1409549002,1,3,101
45352977@N05,6034,19,1414028399,1414028939,3,5,540
45352977@N05,6034,30,1414033837,1414034917,2,5,1080
45352977@N05,6034,23,1414040855,1414040856,2,5,1
45352977@N05,6034,30,1414040856,1414041936,2,5,1080
45352977@N05,6034,19,1414050871,1414051411,1,5,540
45352977@N05,6035,18,1427075180,1427075630,2,1,450
45352977@N05,6036,18,1431395189,1431395639,3,1,450
45352977@N05,6037,18,1434850177,1434850627,2,1,450
45352977@N05,6038,20,1435110402,1435110942,1,1,540
45352977@N05,6039,18,1441603337,1441603787,2,1,450
45352977@N05,6040,18,1441929597,1441930047,2,4,450
45352977@N05,6040,17,1441932313,1441932613,2,4,300
45352977@N05,6040,18,1441938960,1441939077,2,4,117
45352977@N05,6040,29,1441939077,1441939977,1,4,900
45352977@N05,6041,30,1442105158,1442106238,1,1,1080
45423318@N00,6042,28,1227917908,1227918808,2,3,900
45423318@N00,6042,3,1227921560,1227921650,4,3,90
45423318@N00,6042,26,1227936293,1227937193,2,3,900
45423318@N00,6043,1,1465175448,1465175508,2,9,60
45423318@N00,6043,5,1465177194,1465177314,2,9,120
45423318@N00,6043,25,1465178908,1465178920,3,9,12
45423318@N00,6043,21,1465178920,1465179490,3,9,570
45423318@N00,6043,13,1465181759,1465181999,7,9,240
45423318@N00,6043,11,1465183119,1465183359,3,9,240
45423318@N00,6043,29,1465187142,1465188042,4,9,900
45423318@N00,6043,18,1465202252,1465202702,2,9,450
45423318@N00,6043,21,1465207089,1465207659,6,9,570
45462443@N08,6044,26,1278044172,1278045072,1,1,900
45518929@N07,6045,28,1357001883,1357002783,18,1,900
45539802@N03,6046,18,1430125920,1430126370,1,1,450
45539802@N03,6047,18,1449459905,1449460355,1,1,450
45553905@N00,6048,31,1238562642,1238564142,3,4,1500
45553905@N00,6048,24,1238567458,1238568238,2,4,780
45553905@N00,6048,25,1238568881,1238569721,2,4,840
45553905@N00,6048,13,1238572195,1238572435,1,4,240
45553905@N00,6049,16,1243738555,1243738825,2,4,270
45553905@N00,6049,15,1243742660,1243742930,7,4,270
45553905@N00,6049,16,1243765711,1243765981,2,4,270
45553905@N00,6049,18,1243771896,1243772346,1,4,450
45553905@N00,6050,1,1243920473,1243920533,2,1,60
45553905@N00,6051,1,1275436027,1275436087,3,11,60
45553905@N00,6051,16,1275436294,1275436564,2,11,270
45553905@N00,6051,24,1275437600,1275438380,7,11,780
45553905@N00,6051,20,1275441744,1275442284,2,11,540
45553905@N00,6051,24,1275447096,1275447876,2,11,780
45553905@N00,6051,26,1275463810,1275464710,12,11,900
45553905@N00,6051,6,1275465015,1275465135,2,11,120
45553905@N00,6051,3,1275465458,1275465548,7,11,90
45553905@N00,6051,21,1275465685,1275466255,2,11,570
45553905@N00,6051,20,1275475141,1275475681,2,11,540
45553905@N00,6051,29,1275481668,1275482568,6,11,900
45553905@N00,6052,1,1288075406,1288075466,2,1,60
45561435@N00,6053,13,1206147765,1206148005,1,1,240
45571875@N06,6054,25,1368155901,1368156741,1,1,840
45571875@N06,6055,15,1368186730,1368187000,2,3,270
45571875@N06,6055,26,1368197260,1368198160,2,3,900
45571875@N06,6055,27,1368205647,1368206547,2,3,900
45571875@N06,6056,26,1368607140,1368608040,3,2,900
45571875@N06,6056,1,1368631956,1368632016,1,2,60
45577837@N02,6057,16,1363365930,1363366200,1,1,270
45613511@N00,6058,24,1433648835,1433649615,1,1,780
45620944@N07,6059,26,1260953179,1260954079,2,4,900
45620944@N07,6059,29,1260956305,1260957205,4,4,900
45620944@N07,6059,25,1260962406,1260963246,4,4,840
45620944@N07,6059,26,1260963865,1260964765,1,4,900
45692745@N00,6060,29,1209193457,1209194357,1,1,900
45744548@N03,6061,1,1300712400,1300712460,1,1,60
45749280@N00,6062,1,1285745599,1285745659,2,10,60
45749280@N00,6062,28,1285745871,1285746771,4,10,900
45749280@N00,6062,18,1285747395,1285747845,2,10,450
45749280@N00,6062,29,1285751084,1285751318,2,10,234
45749280@N00,6062,20,1285751318,1285751858,15,10,540
45749280@N00,6062,25,1285756226,1285756743,5,10,517
45749280@N00,6062,13,1285756743,1285756983,2,10,240
45749280@N00,6062,12,1285757049,1285757289,6,10,240
45749280@N00,6062,29,1285764336,1285765236,3,10,900
45749280@N00,6062,20,1285779641,1285780181,2,10,540
45749280@N00,6063,28,1285834648,1285835548,2,10,900
45749280@N00,6063,26,1285835614,1285836465,5,10,851
45749280@N00,6063,29,1285836465,1285837365,6,10,900
45749280@N00,6063,20,1285838229,1285838769,2,10,540
45749280@N00,6063,26,1285841361,1285842261,4,10,900
45749280@N00,6063,1,1285845084,1285845144,4,10,60
45749280@N00,6063,28,1285846295,1285847195,2,10,900
45749280@N00,6063,1,1285850524,1285850584,4,10,60
45749280@N00,6063,5,1285853874,1285853994,2,10,120
45749280@N00,6063,28,1285855297,1285856197,1,10,900
45749280@N00,6064,1,1315982408,1315982468,23,1,60
45749280@N00,6065,20,1316140515,1316141055,3,1,540
45749280@N00,6066,29,1316177042,1316177942,28,3,900
45749280@N00,6066,28,1316188854,1316189454,6,3,600
45749280@N00,6066,1,1316189454,1316189514,1,3,60
45749280@N00,6067,28,1316247373,1316248273,2,1,900
45756179@N03,6068,22,1253183133,1253183733,1,1,600
45767882@N08,6069,19,1415588746,1415589286,1,1,540
45775305@N07,6070,28,1363059554,1363060454,1,1,900
45871224@N03,6071,26,1386474450,1386475350,3,1,900
45871224@N03,6072,26,1386581634,1386582534,1,1,900
45871224@N03,6073,26,1393221781,1393222681,3,1,900
45871224@N03,6074,26,1394082162,1394083062,4,1,900
45871224@N03,6075,26,1394605023,1394605923,1,1,900
45871224@N03,6076,26,1414130511,1414131411,2,1,900
45875573@N08,6077,29,1310029318,1310030218,1,1,900
45875573@N08,6078,29,1325914305,1325915205,2,3,900
45875573@N08,6078,12,1325919566,1325919653,2,3,87
45875573@N08,6078,3,1325919653,1325919743,1,3,90
45906008@N00,6079,28,1254352770,1254353670,11,1,900
45906008@N00,6080,28,1254441722,1254442622,1,1,900
45906008@N00,6081,26,1385778878,1385779778,2,4,900
45906008@N00,6081,25,1385781106,1385781946,3,4,840
45906008@N00,6081,13,1385782808,1385783048,2,4,240
45906008@N00,6081,29,1385788080,1385788980,1,4,900
45923298@N00,6082,1,1338432025,1338432085,2,14,60
45923298@N00,6082,28,1338432294,1338433194,2,14,900
45923298@N00,6082,20,1338437478,1338438018,2,14,540
45923298@N00,6082,17,1338445868,1338446168,2,14,300
45923298@N00,6082,24,1338448076,1338448856,2,14,780
45923298@N00,6082,1,1338451166,1338451226,3,14,60
45923298@N00,6082,29,1338452333,1338453233,3,14,900
45923298@N00,6082,27,1338463087,1338463141,2,14,54
45923298@N00,6082,24,1338463141,1338463334,2,14,193
45923298@N00,6082,16,1338463334,1338463604,2,14,270
45923298@N00,6082,30,1338468978,1338470058,2,14,1080
45923298@N00,6082,28,1338472657,1338473160,4,14,503
45923298@N00,6082,29,1338473160,1338474060,2,14,900
45923298@N00,6082,22,1338488215,1338488815,1,14,600
45936466@N05,6083,1,1391386413,1391386473,1,1,60
45936466@N05,6084,1,1392957248,1392957308,1,1,60
45952470@N04,6085,12,1199560579,1199560819,2,1,240
45962202@N05,6086,28,1353465145,1353466045,3,1,900
45978658@N06,6087,26,1341553665,1341554565,1,1,900
46009759@N07,6088,28,1325417641,1325418541,1,1,900
46026530@N04,6089,26,1384163378,1384164278,1,1,900
46027550@N00,6090,15,1187958158,1187958428,1,1,270
46027550@N00,6091,15,1188050400,1188050670,29,1,270
46027550@N00,6092,15,1199011035,1199011305,5,1,270
46027550@N00,6093,15,1199097866,1199098136,3,1,270
46027550@N00,6094,15,1221811554,1221811824,13,1,270
46027550@N00,6095,15,1221899090,1221899360,15,1,270
46027550@N00,6096,15,1223633481,1223633751,2,1,270
46027550@N00,6097,15,1223711366,1223711636,8,1,270
46027550@N00,6098,15,1223795243,1223795513,1,1,270
46027550@N00,6099,27,1227685279,1227686179,2,2,900
46027550@N00,6099,25,1227686329,1227687169,3,2,840
46027550@N00,6100,15,1232182500,1232182770,9,1,270
46027550@N00,6101,25,1233820510,1233821350,1,1,840
46027550@N00,6102,15,1244795183,1244795453,6,1,270
46027550@N00,6103,1,1245034702,1245034762,1,1,60
46027550@N00,6104,15,1246612839,1246613109,3,1,270
46027550@N00,6105,15,1246698756,1246699026,11,1,270
46027550@N00,6106,15,1253790251,1253790521,7,1,270
46027550@N00,6107,15,1253871684,1253871954,5,1,270
46027550@N00,6108,18,1259401464,1259401914,1,1,450
46027550@N00,6109,25,1265446773,1265447613,1,1,840
46027550@N00,6110,17,1267085514,1267085814,2,1,300
46027550@N00,6111,24,1299904885,1299905665,2,1,780
46027550@N00,6112,27,1325313540,1325314440,1,1,900
46027550@N00,6113,15,1415585434,1415585704,1,1,270
46050386@N03,6114,28,1266207242,1266207252,2,3,10
46050386@N03,6114,13,1266207252,1266207255,2,3,3
46050386@N03,6114,20,1266207255,1266207795,1,3,540
46050386@N03,6115,28,1266750513,1266750516,2,3,3
46050386@N03,6115,19,1266750516,1266750521,2,3,5
46050386@N03,6115,25,1266750521,1266751361,1,3,840
46050386@N03,6116,14,1268605229,1268605469,2,21,240
46050386@N03,6116,1,1268607212,1268607272,2,21,60
46050386@N03,6116,28,1268607324,1268607837,4,21,513
46050386@N03,6116,27,1268607837,1268607871,3,21,34
46050386@N03,6116,16,1268607871,1268607880,2,21,9
46050386@N03,6116,27,1268607880,1268607910,2,21,30
46050386@N03,6116,17,1268607910,1268608210,4,21,300
46050386@N03,6116,24,1268609000,1268609780,11,21,780
46050386@N03,6116,4,1268611920,1268612021,2,21,101
46050386@N03,6116,31,1268612602,1268614102,2,21,1500
46050386@N03,6116,20,1268615195,1268615735,12,21,540
46050386@N03,6116,22,1268616847,1268617447,6,21,600
46050386@N03,6116,20,1268618769,1268618989,2,21,220
46050386@N03,6116,19,1268618989,1268619529,11,21,540
46050386@N03,6116,29,1268620272,1268621172,3,21,900
46050386@N03,6116,1,1268627189,1268627249,3,21,60
46050386@N03,6116,28,1268646020,1268646469,2,21,449
46050386@N03,6116,27,1268646469,1268647369,8,21,900
46050386@N03,6116,17,1268649480,1268649780,2,21,300
46050386@N03,6116,23,1268657551,1268658151,2,21,600
46050386@N03,6116,20,1268658359,1268658899,1,21,540
46050386@N03,6117,28,1268698317,1268698546,4,15,229
46050386@N03,6117,26,1268698546,1268698700,10,15,154
46050386@N03,6117,16,1268698700,1268698970,6,15,270
46050386@N03,6117,27,1268699706,1268699775,2,15,69
46050386@N03,6117,15,1268699775,1268700045,2,15,270
46050386@N03,6117,25,1268701216,1268702056,22,15,840
46050386@N03,6117,13,1268702350,1268702590,17,15,240
46050386@N03,6117,5,1268705524,1268705644,6,15,120
46050386@N03,6117,26,1268706082,1268706982,13,15,900
46050386@N03,6117,20,1268708892,1268709432,3,15,540
46050386@N03,6117,22,1268711157,1268711757,4,15,600
46050386@N03,6117,18,1268713177,1268713627,3,15,450
46050386@N03,6117,27,1268718666,1268719144,3,15,478
46050386@N03,6117,28,1268719144,1268719531,5,15,387
46050386@N03,6117,1,1268719531,1268719591,12,15,60
46050386@N03,6118,1,1306307119,1306307179,2,7,60
46050386@N03,6118,25,1306310319,1306310870,2,7,551
46050386@N03,6118,13,1306310870,1306311110,4,7,240
46050386@N03,6118,10,1306311312,1306311552,18,7,240
46050386@N03,6118,22,1306314755,1306315355,2,7,600
46050386@N03,6118,29,1306315704,1306316604,4,7,900
46050386@N03,6118,1,1306319216,1306319276,1,7,60
46050386@N03,6119,27,1306372031,1306372931,4,24,900
46050386@N03,6119,8,1306374919,1306374981,2,24,62
46050386@N03,6119,5,1306374981,1306375045,3,24,64
46050386@N03,6119,8,1306375045,1306375142,2,24,97
46050386@N03,6119,10,1306375142,1306375382,4,24,240
46050386@N03,6119,19,1306377652,1306378192,8,24,540
46050386@N03,6119,26,1306379768,1306380668,2,24,900
46050386@N03,6119,3,1306381075,1306381165,2,24,90
46050386@N03,6119,21,1306381427,1306381997,6,24,570
46050386@N03,6119,11,1306382225,1306382379,13,24,154
46050386@N03,6119,21,1306382379,1306382718,8,24,339
46050386@N03,6119,13,1306382718,1306382958,13,24,240
46050386@N03,6119,26,1306383793,1306384669,2,24,876
46050386@N03,6119,31,1306384669,1306386169,2,24,1500
46050386@N03,6119,13,1306388534,1306388774,3,24,240
46050386@N03,6119,12,1306388946,1306389186,5,24,240
46050386@N03,6119,16,1306391021,1306391291,11,24,270
46050386@N03,6119,28,1306391291,1306391319,2,24,28
46050386@N03,6119,16,1306391319,1306391589,6,24,270
46050386@N03,6119,26,1306393653,1306394553,2,24,900
46050386@N03,6119,18,1306394574,1306395024,7,24,450
46050386@N03,6119,29,1306396187,1306397087,3,24,900
46050386@N03,6119,28,1306399294,1306400194,15,24,900
46050386@N03,6119,26,1306402322,1306403222,1,24,900
46077647@N00,6120,24,1214965285,1214965478,2,6,193
46077647@N00,6120,21,1214965478,1214966048,2,6,570
46077647@N00,6120,29,1214968242,1214968631,2,6,389
46077647@N00,6120,23,1214968631,1214968899,2,6,268
46077647@N00,6120,26,1214968899,1214969799,2,6,900
46077647@N00,6120,1,1214971837,1214971897,2,6,60
46077647@N00,6121,25,1242813197,1242814037,8,2,840
46077647@N00,6121,29,1242817811,1242818711,1,2,900
46097191@N00,6122,26,1276821808,1276822708,40,1,900
46097191@N00,6123,26,1278924647,1278925547,18,1,900
46097854@N00,6124,28,1379668814,1379669714,1,1,900
46097854@N00,6125,1,1381636870,1381636930,2,4,60
46097854@N00,6125,15,1381640346,1381640616,2,4,270
46097854@N00,6125,1,1381661296,1381661356,3,4,60
46097854@N00,6125,28,1381661513,1381662413,1,4,900
46097854@N00,6126,29,1383273273,1383274173,1,1,900
46097854@N00,6127,23,1383441958,1383442558,2,3,600
46097854@N00,6127,15,1383451978,1383452248,2,3,270
46097854@N00,6127,27,1383457374,1383458274,1,3,900
46097854@N00,6128,1,1384473543,1384473603,2,6,60
46097854@N00,6128,27,1384474908,1384475808,2,6,900
46097854@N00,6128,26,1384476820,1384477720,2,6,900
46097854@N00,6128,29,1384479286,1384480186,2,6,900
46097854@N00,6128,19,1384481975,1384482515,2,6,540
46097854@N00,6128,20,1384504243,1384504783,1,6,540
46097854@N00,6129,16,1422426064,1422426334,1,1,270
46097854@N00,6130,18,1443680180,1443680630,2,3,450
46097854@N00,6130,29,1443685231,1443686029,2,3,798
46097854@N00,6130,30,1443686029,1443687109,1,3,1080
46121254@N00,6131,31,1334195349,1334196849,2,1,1500
46196249@N00,6132,7,1402184990,1402185170,1,1,180
46196249@N00,6133,28,1450222868,1450223768,2,2,900
46196249@N00,6133,15,1450225041,1450225311,1,2,270
46277726@N00,6134,28,1223881214,1223882114,2,3,900
46277726@N00,6134,26,1223893472,1223893620,2,3,148
46277726@N00,6134,22,1223893620,1223894220,1,3,600
46283533@N08,6135,14,1204959367,1204959607,1,1,240
46283533@N08,6136,17,1254474579,1254474879,1,1,300
46283533@N08,6137,30,1282998896,1282999976,1,1,1080
46283533@N08,6138,26,1290585196,1290586096,2,1,900
46283533@N08,6139,28,1308897076,1308897976,1,1,900
46283533@N08,6140,20,1312934248,1312934471,2,2,223
46283533@N08,6140,14,1312934471,1312934711,1,2,240
46283533@N08,6141,26,1322379372,1322380272,1,1,900
46283533@N08,6142,26,1331940810,1331941710,1,1,900
46283533@N08,6143,12,1336809528,1336809597,2,3,69
46283533@N08,6143,16,1336809597,1336809867,2,3,270
46283533@N08,6143,12,1336809969,1336810209,1,3,240
46283533@N08,6144,16,1337923183,1337923453,3,1,270
46283533@N08,6145,4,1343303269,1343303370,1,1,101
46283533@N08,6146,29,1351334116,1351335016,1,1,900
46283533@N08,6147,1,1353475970,1353476030,2,1,60
46283533@N08,6148,12,1413531721,1413531961,1,1,240
46283533@N08,6149,24,1415600567,1415601347,1,1,780
46283533@N08,6150,26,1415959607,1415960507,1,1,900
46283533@N08,6151,26,1416368559,1416369459,1,1,900
46283533@N08,6152,24,1417673475,1417674255,1,1,780
46283533@N08,6153,1,1419058607,1419058667,4,1,60
46283533@N08,6154,31,1421561604,1421563104,1,1,1500
46300970@N06,6155,16,1430649036,1430649306,1,1,270
46344160@N07,6156,19,1415576628,1415577168,2,1,540
46344319@N08,6157,26,1382224812,1382225612,2,2,800
46344319@N08,6157,25,1382225612,1382226452,1,2,840
46353666@N03,6158,26,1392952076,1392952291,3,6,215
46353666@N03,6158,10,1392952291,1392952531,2,6,240
46353666@N03,6158,26,1392955733,1392956633,3,6,900
46353666@N03,6158,7,1392957787,1392957967,2,6,180
46353666@N03,6158,28,1392974510,1392975410,2,6,900
46353666@N03,6158,26,1392975834,1392976734,5,6,900
46353666@N03,6159,26,1393051592,1393052492,6,4,900
46353666@N03,6159,7,1393054493,1393054673,2,4,180
46353666@N03,6159,22,1393054825,1393055425,2,4,600
46353666@N03,6159,28,1393060912,1393061812,5,4,900
46453719@N00,6160,16,1388868761,1388869031,2,2,270
46453719@N00,6160,21,1388869306,1388869876,1,2,570
46508645@N00,6161,1,1374806155,1374806215,1,1,60
46542299@N06,6162,20,1385621133,1385621673,1,1,540
46559377@N00,6163,3,1346140176,1346140266,1,1,90
46580267@N08,6164,31,1416211061,1416212561,1,1,1500
46602694@N00,6165,29,1378001588,1378002488,1,1,900
46602694@N00,6166,12,1378034485,1378034725,1,1,240
46631270@N00,6167,28,1262036451,1262037351,1,1,900
46631270@N00,6168,3,1262069835,1262069925,2,1,90
46631270@N00,6169,26,1300249998,1300250898,2,7,900
46631270@N00,6169,3,1300251396,1300251486,2,7,90
46631270@N00,6169,26,1300251500,1300251502,2,7,2
46631270@N00,6169,9,1300251502,1300251515,4,7,13
46631270@N00,6169,3,1300251515,1300251570,9,7,55
46631270@N00,6169,5,1300251570,1300251690,3,7,120
46631270@N00,6169,26,1300256754,1300257654,1,7,900
46649528@N04,6170,26,1316342723,1316343623,1,1,900
46677727@N00,6171,27,1198823044,1198823944,2,1,900
46677727@N00,6172,24,1249261246,1249262026,1,1,780
46688467@N06,6173,29,1328940675,1328941575,2,2,900
46688467@N06,6173,28,1328956403,1328957303,1,2,900
46709051@N03,6174,16,1323258581,1323258851,2,2,270
46709051@N03,6174,28,1323258916,1323259816,1,2,900
46709051@N03,6175,25,1355210871,1355211711,1,1,840
46709051@N03,6176,7,1355312854,1355313034,2,1,180
46781367@N08,6177,29,1263042001,1263042901,7,1,900
46806548@N00,6178,28,1329901693,1329902593,1,1,900
46816976@N08,6179,20,1357180928,1357181468,3,1,540
46816976@N08,6180,20,1357380378,1357380918,1,1,540
46816976@N08,6181,29,1360042618,1360043518,3,6,900
46816976@N08,6181,30,1360043777,1360043998,2,6,221
46816976@N08,6181,6,1360043998,1360044118,2,6,120
46816976@N08,6181,26,1360044146,1360044277,2,6,131
46816976@N08,6181,6,1360044277,1360044397,2,6,120
46816976@N08,6181,28,1360045157,1360046057,1,6,900
46816976@N08,6182,26,1363751782,1363752682,2,1,900
46816976@N08,6183,29,1367390619,1367391519,1,1,900
46816976@N08,6184,28,1367675134,1367676034,1,1,900
46816976@N08,6185,29,1384680918,1384681818,1,1,900
46869391@N00,6186,7,1387892215,1387892395,1,1,180
46879921@N05,6187,21,1357199053,1357199623,2,3,570
46879921@N05,6187,16,1357199650,1357199920,2,3,270
46879921@N05,6187,26,1357200502,1357201402,1,3,900
46901323@N02,6188,16,1262321098,1262321368,1,1,270
46958645@N00,6189,1,1367705523,1367705583,1,1,60
46969058@N08,6190,3,1431941753,1431941843,1,1,90
46999149@N02,6191,29,1236590672,1236591572,2,2,900
46999149@N02,6191,26,1236592609,1236593509,2,2,900
46999149@N02,6192,26,1243758738,1243759638,1,1,900
46999149@N02,6193,29,1263796117,1263797017,2,2,900
46999149@N02,6193,22,1263797109,1263797709,1,2,600
46999149@N02,6194,24,1264911558,1264911913,2,8,355
46999149@N02,6194,16,1264911913,1264912183,4,8,270
46999149@N02,6194,10,1264914675,1264914915,4,8,240
46999149@N02,6194,22,1264916034,1264916249,4,8,215
46999149@N02,6194,14,1264916249,1264916489,2,8,240
46999149@N02,6194,22,1264916884,1264917484,2,8,600
46999149@N02,6194,13,1264930108,1264930348,3,8,240
46999149@N02,6194,17,1264932059,1264932359,1,8,300
46999149@N02,6195,15,1332824677,1332824947,1,1,270
46999149@N02,6196,28,1355295001,1355295901,1,1,900
47081385@N00,6197,1,1202189732,1202189792,2,6,60
47081385@N00,6197,8,1202204342,1202204522,19,6,180
47081385@N00,6197,26,1202212831,1202213166,2,6,335
47081385@N00,6197,18,1202213166,1202213616,2,6,450
47081385@N00,6197,26,1202218671,1202219571,34,6,900
47081385@N00,6197,28,1202220127,1202221027,2,6,900
47081385@N00,6198,1,1202920222,1202920282,1,1,60
47108349@N07,6199,26,1283396641,1283397500,3,10,859
47108349@N07,6199,3,1283397500,1283397590,2,10,90
47108349@N07,6199,13,1283402090,1283402330,2,10,240
47108349@N07,6199,17,1283404890,1283405190,2,10,300
47108349@N07,6199,28,1283407109,1283407590,2,10,481
47108349@N07,6199,16,1283407590,1283407751,3,10,161
47108349@N07,6199,27,1283407751,1283408040,2,10,289
47108349@N07,6199,16,1283408040,1283408188,2,10,148
47108349@N07,6199,26,1283408188,1283409088,2,10,900
47108349@N07,6199,30,1283410751,1283411831,3,10,1080
47145959@N05,6200,15,1320563078,1320563348,2,2,270
47145959@N05,6200,20,1320568689,1320569229,1,2,540
47145959@N05,6201,1,1402650515,1402650575,1,1,60
47205201@N07,6202,1,1343078026,1343078086,37,1,60
47205201@N07,6203,1,1343197175,1343197235,20,1,60
47205201@N07,6204,1,1344671155,1344671215,1,1,60
47211871@N00,6205,30,1297534707,1297535787,12,1,1080
47246716@N06,6206,21,1308308620,1308309190,2,1,570
47246716@N06,6207,26,1308354380,1308354870,2,2,490
47246716@N06,6207,21,1308354870,1308355440,2,2,570
47246716@N06,6208,26,1308450864,1308451764,2,1,900
47246716@N06,6209,28,1309403912,1309404812,1,1,900
47280789@N05,6210,1,1391298182,1391298242,1,1,60
47284527@N03,6211,5,1218789570,1218789690,1,1,120
47294204@N05,6212,26,1381536431,1381537331,1,1,900
47330515@N02,6213,28,1288254341,1288255241,1,1,900
47363316@N08,6214,26,1327635643,1327636116,2,2,473
47363316@N08,6214,28,1327636116,1327637016,2,2,900
47423151@N06,6215,28,1331102597,1331103497,2,4,900
47423151@N06,6215,26,1331105718,1331105803,2,4,85
47423151@N06,6215,20,1331105803,1331106343,2,4,540
47423151@N06,6215,26,1331119855,1331120755,1,4,900
47423151@N06,6216,27,1331275267,1331276167,2,4,900
47423151@N06,6216,25,1331301896,1331302736,2,4,840
47423151@N06,6216,26,1331302864,1331303713,2,4,849
47423151@N06,6216,18,1331303713,1331304163,1,4,450
47423151@N06,6217,20,1409225904,1409226444,2,2,540
47423151@N06,6217,3,1409230443,1409230533,1,2,90
47423151@N06,6218,30,1409549489,1409550569,1,1,1080
47423151@N06,6219,25,1410126598,1410127438,1,1,840
47462072@N00,6220,24,1361511153,1361511933,2,4,780
47462072@N00,6220,29,1361513411,1361514311,3,4,900
47462072@N00,6220,26,1361514753,1361515653,2,4,900
47462072@N00,6220,28,1361517958,1361518858,1,4,900
47462072@N00,6221,28,1386327081,1386327981,4,4,900
47462072@N00,6221,26,1386329168,1386330068,3,4,900
47462072@N00,6221,21,1386331523,1386331847,5,4,324
47462072@N00,6221,25,1386331847,1386332687,1,4,840
47487972@N06,6222,29,1401159877,1401160777,2,1,900
47554402@N00,6223,28,1283826583,1283826853,2,3,270
47554402@N00,6223,26,1283826853,1283827546,2,3,693
47554402@N00,6223,28,1283827546,1283828446,35,3,900
47554402@N00,6224,28,1283924555,1283925455,1,1,900
47576966@N05,6225,28,1193530753,1193530822,2,7,69
47576966@N05,6225,12,1193530822,1193531062,2,7,240
47576966@N05,6225,21,1193532360,1193532930,3,7,570
47576966@N05,6225,19,1193546128,1193546151,2,7,23
47576966@N05,6225,28,1193546151,1193547051,3,7,900
47576966@N05,6225,1,1193552916,1193552976,3,7,60
47576966@N05,6225,28,1193568757,1193569657,2,7,900
47576966@N05,6226,28,1193615333,1193616233,2,2,900
47576966@N05,6226,25,1193622496,1193623336,2,2,840
47576966@N05,6227,28,1269094606,1269095506,1,1,900
47576966@N05,6228,28,1324943851,1324944751,2,1,900
47593397@N06,6229,5,1391296356,1391296476,2,2,120
47593397@N06,6229,20,1391299037,1391299577,2,2,540
47684716@N07,6230,30,1274360297,1274361377,1,1,1080
47694179@N06,6231,15,1471394722,1471394992,4,4,270
47694179@N06,6231,4,1471398373,1471398474,2,4,101
47694179@N06,6231,21,1471398702,1471399272,2,4,570
47694179@N06,6231,15,1471413552,1471413822,2,4,270
47694179@N06,6232,27,1471477714,1471478614,3,3,900
47694179@N06,6232,26,1471488131,1471489031,3,3,900
47694179@N06,6232,28,1471491755,1471492655,3,3,900
47694179@N06,6233,28,1471784407,1471784582,6,2,175
47694179@N06,6233,1,1471784582,1471784642,1,2,60
47696411@N00,6234,15,1297738062,1297738332,3,3,270
47696411@N00,6234,16,1297738743,1297739013,2,3,270
47696411@N00,6234,15,1297742735,1297743005,1,3,270
47728175@N00,6235,18,1213314039,1213314226,2,16,187
47728175@N00,6235,19,1213314226,1213314766,3,16,540
47728175@N00,6235,17,1213317385,1213317685,2,16,300
47728175@N00,6235,23,1213318056,1213318190,2,16,134
47728175@N00,6235,26,1213318190,1213318409,3,16,219
47728175@N00,6235,16,1213318409,1213318679,2,16,270
47728175@N00,6235,26,1213322323,1213323223,2,16,900
47728175@N00,6235,31,1213324893,1213325341,2,16,448
47728175@N00,6235,20,1213325341,1213325881,2,16,540
47728175@N00,6235,10,1213330778,1213331018,4,16,240
47728175@N00,6235,22,1213335645,1213336245,4,16,600
47728175@N00,6235,6,1213338499,1213338619,2,16,120
47728175@N00,6235,7,1213339529,1213339709,2,16,180
47728175@N00,6235,13,1213341280,1213341520,3,16,240
47728175@N00,6235,16,1213355662,1213355932,4,16,270
47728175@N00,6235,24,1213360361,1213361141,1,16,780
47731649@N00,6236,26,1348303696,1348304151,2,5,455
47731649@N00,6236,1,1348304151,1348304211,2,5,60
47731649@N00,6236,28,1348307646,1348308074,4,5,428
47731649@N00,6236,18,1348308074,1348308524,4,5,450
47731649@N00,6236,20,1348312673,1348313213,2,5,540
47731649@N00,6237,11,1348424657,1348424897,1,1,240
47731649@N00,6238,3,1348476140,1348476230,2,6,90
47731649@N00,6238,25,1348476716,1348477556,2,6,840
47731649@N00,6238,13,1348482103,1348482343,2,6,240
47731649@N00,6238,8,1348482893,1348483073,2,6,180
47731649@N00,6238,29,1348494950,1348495850,2,6,900
47731649@N00,6238,22,1348497769,1348498369,1,6,600
47736026@N04,6239,1,1336136354,1336136414,2,8,60
47736026@N04,6239,28,1336137330,1336138230,2,8,900
47736026@N04,6239,31,1336141009,1336141921,2,8,912
47736026@N04,6239,13,1336141921,1336142161,7,8,240
47736026@N04,6239,18,1336153152,1336153602,2,8,450
47736026@N04,6239,16,1336154629,1336154899,3,8,270
47736026@N04,6239,28,1336159613,1336160513,2,8,900
47736026@N04,6239,1,1336163280,1336163340,1,8,60
47747515@N06,6240,20,1283323619,1283324159,1,1,540
47776802@N06,6241,15,1430072436,1430072706,1,1,270
47841296@N07,6242,1,1392715418,1392715478,1,1,60
47845844@N05,6243,1,1375792586,1375792646,2,2,60
47845844@N05,6243,28,1375807140,1375808040,2,2,900
47877526@N04,6244,21,1294351542,1294352112,1,1,570
47894721@N02,6245,24,1333362333,1333363113,3,3,780
47894721@N02,6245,12,1333365301,1333365541,2,3,240
47894721@N02,6245,26,1333366118,1333367018,1,3,900
47894721@N02,6246,29,1334413092,1334413992,1,1,900
47923881@N05,6247,20,1377693123,1377693663,1,1,540
47931061@N08,6248,22,1402730612,1402730682,2,5,70
47931061@N08,6248,25,1402730682,1402731522,2,5,840
47931061@N08,6248,26,1402734470,1402734709,2,5,239
47931061@N08,6248,28,1402734709,1402735074,2,5,365
47931061@N08,6248,27,1402735074,1402735974,1,5,900
48060755@N06,6249,10,1284118640,1284118880,1,1,240
48081748@N00,6250,8,1316828099,1316828279,2,4,180
48081748@N00,6250,18,1316831460,1316831910,2,4,450
48081748@N00,6250,26,1316834707,1316835607,2,4,900
48081748@N00,6250,20,1316854628,1316855168,1,4,540
48081748@N00,6251,1,1379766771,1379766831,1,1,60
48096279@N00,6252,1,1220580350,1220580410,2,13,60
48096279@N00,6252,28,1220580441,1220580585,2,13,144
48096279@N00,6252,16,1220580585,1220580855,2,13,270
48096279@N00,6252,12,1220584342,1220584582,8,13,240
48096279@N00,6252,13,1220588251,1220588491,6,13,240
48096279@N00,6252,4,1220591601,1220591702,2,13,101
48096279@N00,6252,22,1220593009,1220593609,5,13,600
48096279@N00,6252,29,1220596528,1220597428,2,13,900
48096279@N00,6252,18,1220598547,1220598997,2,13,450
48096279@N00,6252,16,1220604221,1220604491,6,13,270
48096279@N00,6252,28,1220605866,1220606766,4,13,900
48096279@N00,6252,4,1220612264,1220612365,2,13,101
48096279@N00,6252,28,1220614448,1220615348,6,13,900
48101006@N02,6253,18,1430732535,1430732985,1,1,450
48101006@N02,6254,27,1433658332,1433659232,1,1,900
48101006@N02,6255,28,1439717674,1439718574,1,1,900
48101006@N02,6256,30,1441593759,1441594839,1,1,1080
48101006@N02,6257,17,1447460970,1447461270,1,1,300
48101006@N02,6258,19,1451018344,1451018884,1,1,540
48101006@N02,6259,18,1452309363,1452309813,1,1,450
48101006@N02,6260,28,1459473926,1459474826,1,1,900
48101006@N02,6261,15,1461397134,1461397404,1,1,270
48101006@N02,6262,16,1463904662,1463904932,1,1,270
48108659@N00,6263,15,1255739765,1255740035,6,9,270
48108659@N00,6263,7,1255749189,1255749369,2,9,180
48108659@N00,6263,16,1255752645,1255752901,3,9,256
48108659@N00,6263,4,1255752901,1255753002,2,9,101
48108659@N00,6263,3,1255753365,1255753455,4,9,90
48108659@N00,6263,10,1255755677,1255755917,2,9,240
48108659@N00,6263,25,1255757185,1255758025,2,9,840
48108659@N00,6263,14,1255769253,1255769493,2,9,240
48108659@N00,6263,26,1255777563,1255778463,1,9,900
48108659@N00,6264,26,1264665364,1264666264,4,1,900
48108659@N00,6265,1,1264723653,1264723713,3,10,60
48108659@N00,6265,28,1264724025,1264724925,2,10,900
48108659@N00,6265,24,1264725233,1264726013,5,10,780
48108659@N00,6265,6,1264729858,1264729978,3,10,120
48108659@N00,6265,21,1264731153,1264731723,3,10,570
48108659@N00,6265,6,1264733024,1264733144,2,10,120
48108659@N00,6265,27,1264734871,1264735354,2,10,483
48108659@N00,6265,25,1264735354,1264736194,7,10,840
48108659@N00,6265,13,1264738554,1264738794,2,10,240
48108659@N00,6265,25,1264746920,1264747760,1,10,840
48108659@N00,6266,24,1267748057,1267748361,2,5,304
48108659@N00,6266,12,1267748361,1267748601,2,5,240
48108659@N00,6266,25,1267750399,1267751239,3,5,840
48108659@N00,6266,24,1267753225,1267754005,2,5,780
48108659@N00,6266,13,1267758481,1267758721,1,5,240
48108659@N00,6267,25,1289877913,1289878753,4,8,840
48108659@N00,6267,4,1289885428,1289885529,6,8,101
48108659@N00,6267,7,1289887717,1289887897,3,8,180
48108659@N00,6267,20,1289894429,1289894969,2,8,540
48108659@N00,6267,25,1289896104,1289896944,4,8,840
48108659@N00,6267,21,1289897873,1289898006,2,8,133
48108659@N00,6267,26,1289898006,1289898045,2,8,39
48108659@N00,6267,3,1289898045,1289898135,1,8,90
48108659@N00,6268,30,1291011947,1291013027,1,1,1080
48108659@N00,6269,3,1294377951,1294378041,2,2,90
48108659@N00,6269,28,1294399919,1294400819,1,2,900
48108659@N00,6270,7,1296090888,1296091068,3,3,180
48108659@N00,6270,12,1296096636,1296096876,2,3,240
48108659@N00,6270,15,1296100597,1296100867,2,3,270
48108659@N00,6271,31,1296192820,1296194320,6,2,1500
48108659@N00,6271,6,1296195501,1296195621,1,2,120
48163256@N02,6272,6,1267679725,1267679845,2,3,120
48163256@N02,6272,7,1267680283,1267680463,2,3,180
48163256@N02,6272,16,1267682566,1267682836,1,3,270
48163256@N02,6273,16,1270202471,1270202741,1,1,270
48163256@N02,6274,15,1278640495,1278640765,1,1,270
48163256@N02,6275,16,1282193805,1282194075,4,2,270
48163256@N02,6275,28,1282194753,1282195653,6,2,900
48163256@N02,6276,16,1290828680,1290828950,2,1,270
48163256@N02,6277,26,1313661209,1313662109,1,1,900
48166800@N00,6278,26,1198241700,1198241702,3,5,2
48166800@N00,6278,25,1198241702,1198241703,2,5,1
48166800@N00,6278,26,1198241703,1198241705,3,5,2
48166800@N00,6278,28,1198241705,1198241710,4,5,5
48166800@N00,6278,29,1198241710,1198242610,1,5,900
48228348@N00,6279,28,1341791804,1341792704,3,1,900
48228348@N00,6280,19,1365835361,1365835901,2,2,540
48228348@N00,6280,13,1365844029,1365844269,1,2,240
48228348@N00,6281,27,1365905267,1365906167,1,1,900
48228348@N00,6282,22,1365940949,1365941549,1,1,600
48238299@N02,6283,26,1364765056,1364765956,27,1,900
48241744@N00,6284,28,1347183599,1347183739,2,4,140
48241744@N00,6284,3,1347183739,1347183829,2,4,90
48241744@N00,6284,26,1347183914,1347184028,2,4,114
48241744@N00,6284,28,1347184028,1347184928,1,4,900
48241744@N00,6285,25,1350818828,1350819668,1,1,840
48271781@N00,6286,29,1354331986,1354332886,2,5,900
48271781@N00,6286,30,1354334244,1354335324,2,5,1080
48271781@N00,6286,5,1354339520,1354339640,2,5,120
48271781@N00,6286,26,1354351700,1354351710,2,5,10
48271781@N00,6286,24,1354351710,1354352490,1,5,780
48271781@N00,6287,24,1354406846,1354407626,2,2,780
48271781@N00,6287,31,1354434112,1354435612,1,2,1500
48274089@N04,6288,21,1327732226,1327732796,2,3,570
48274089@N04,6288,6,1327738507,1327738627,2,3,120
48274089@N04,6288,16,1327743870,1327744140,1,3,270
48275668@N02,6289,26,1351598712,1351599540,3,8,828
48275668@N02,6289,29,1351599540,1351600440,4,8,900
48275668@N02,6289,18,1351604770,1351605220,3,8,450
48275668@N02,6289,30,1351614008,1351615088,2,8,1080
48275668@N02,6289,1,1351617597,1351617657,3,8,60
48275668@N02,6289,29,1351623346,1351624246,3,8,900
48275668@N02,6289,26,1351630896,1351631796,6,8,900
48275668@N02,6289,5,1351651640,1351651760,1,8,120
48288698@N03,6290,26,1302246697,1302247597,4,1,900
48292212@N00,6291,8,1339333444,1339333624,1,1,180
48299681@N05,6292,17,1398604043,1398604343,2,1,300
48326723@N08,6293,15,1359432980,1359433250,1,1,270
48335730@N00,6294,28,1285990743,1285991643,1,1,900
48335730@N00,6295,3,1313988166,1313988256,2,2,90
48335730@N00,6295,30,1313992327,1313993407,1,2,1080
48378686@N04,6296,26,1382175365,1382176265,1,1,900
48384520@N00,6297,15,1257052720,1257052990,1,1,270
48407213@N00,6298,29,1323390363,1323391263,1,1,900
48418487@N02,6299,31,1278658105,1278659515,7,10,1410
48418487@N02,6299,20,1278659515,1278660055,2,10,540
48418487@N02,6299,22,1278660766,1278661366,3,10,600
48418487@N02,6299,26,1278661987,1278662887,3,10,900
48418487@N02,6299,15,1278663969,1278664239,5,10,270
48418487@N02,6299,17,1278664869,1278665169,2,10,300
48418487@N02,6299,26,1278665516,1278666416,8,10,900
48418487@N02,6299,11,1278669752,1278669992,2,10,240
48418487@N02,6299,21,1278670005,1278670575,3,10,570
48418487@N02,6299,25,1278671040,1278671880,7,10,840
48418487@N02,6300,1,1278730479,1278730539,2,7,60
48418487@N02,6300,28,1278730622,1278731522,3,7,900
48418487@N02,6300,26,1278736699,1278737032,4,7,333
48418487@N02,6300,12,1278737032,1278737272,2,7,240
48418487@N02,6300,28,1278745644,1278746544,3,7,900
48418487@N02,6300,26,1278758824,1278759724,2,7,900
48418487@N02,6300,28,1278765303,1278766203,2,7,900
48418487@N02,6301,28,1279029598,1279029723,2,18,125
48418487@N02,6301,31,1279029723,1279030035,3,18,312
48418487@N02,6301,28,1279030035,1279030447,2,18,412
48418487@N02,6301,26,1279030447,1279030605,3,18,158
48418487@N02,6301,28,1279030605,1279030718,2,18,113
48418487@N02,6301,15,1279030718,1279030784,2,18,66
48418487@N02,6301,28,1279030784,1279031092,2,18,308
48418487@N02,6301,1,1279031092,1279031152,2,18,60
48418487@N02,6301,11,1279031231,1279031310,2,18,79
48418487@N02,6301,26,1279031310,1279031378,2,18,68
48418487@N02,6301,11,1279031378,1279031536,2,18,158
48418487@N02,6301,25,1279031536,1279032376,2,18,840
48418487@N02,6301,28,1279032378,1279032467,2,18,89
48418487@N02,6301,31,1279032467,1279032557,2,18,90
48418487@N02,6301,26,1279032557,1279032801,4,18,244
48418487@N02,6301,12,1279032801,1279033041,2,18,240
48418487@N02,6301,31,1279033721,1279034899,3,18,1178
48418487@N02,6301,28,1279034899,1279035799,1,18,900
48418487@N02,6302,28,1279095016,1279095916,1,1,900
48435643@N07,6303,18,1454635464,1454635914,1,1,450
48449302@N05,6304,1,1374544347,1374544407,12,1,60
48456345@N00,6305,17,1270122600,1270122900,1,1,300
48495576@N02,6306,26,1333365219,1333366119,1,1,900
48495576@N02,6307,25,1336844362,1336845202,1,1,840
48495576@N02,6308,29,1344692367,1344693267,1,1,900
48532487@N00,6309,26,1247481565,1247482465,1,1,900
48569388@N00,6310,30,1357635437,1357636517,1,1,1080
48600091327@N01,6311,28,1242458310,1242459210,1,1,900
48600093488@N01,6312,27,1310069471,1310070371,2,1,900
48600113426@N01,6313,15,1235365835,1235366105,2,10,270
48600113426@N01,6313,29,1235369646,1235370546,2,10,900
48600113426@N01,6313,22,1235389810,1235389818,2,10,8
48600113426@N01,6313,25,1235389818,1235389835,4,10,17
48600113426@N01,6313,15,1235389835,1235389850,2,10,15
48600113426@N01,6313,29,1235389850,1235389857,2,10,7
48600113426@N01,6313,25,1235389857,1235389875,4,10,18
48600113426@N01,6313,15,1235389875,1235389932,6,10,57
48600113426@N01,6313,29,1235389932,1235389988,3,10,56
48600113426@N01,6313,20,1235389988,1235390528,1,10,540
48600113426@N01,6314,15,1235536612,1235536882,1,1,270
48630299@N07,6315,20,1310803439,1310803979,1,1,540
48678427@N06,6316,16,1429840990,1429841260,2,12,270
48678427@N06,6316,27,1429842937,1429843837,5,12,900
48678427@N06,6316,17,1429844138,1429844438,2,12,300
48678427@N06,6316,27,1429844858,1429845758,3,12,900
48678427@N06,6316,17,1429850480,1429850780,2,12,300
48678427@N06,6316,19,1429851978,1429851984,2,12,6
48678427@N06,6316,29,1429851984,1429852050,3,12,66
48678427@N06,6316,19,1429852050,1429852081,3,12,31
48678427@N06,6316,18,1429852081,1429852531,7,12,450
48678427@N06,6316,20,1429853520,1429854060,2,12,540
48678427@N06,6316,13,1429857701,1429857941,2,12,240
48678427@N06,6316,29,1429860637,1429861537,8,12,900
48715359@N00,6317,28,1353294554,1353295454,1,1,900
48715359@N00,6318,28,1353400570,1353401432,2,4,862
48715359@N00,6318,26,1353401432,1353401755,2,4,323
48715359@N00,6318,21,1353401755,1353401978,2,4,223
48715359@N00,6318,13,1353401978,1353402218,1,4,240
48715359@N00,6319,1,1353458383,1353458443,2,5,60
48715359@N00,6319,28,1353462808,1353463708,2,5,900
48715359@N00,6319,1,1353468415,1353468475,2,5,60
48715359@N00,6319,24,1353471345,1353471729,4,5,384
48715359@N00,6319,15,1353471729,1353471999,2,5,270
48731805@N02,6320,1,1315652662,1315652709,4,8,47
48731805@N02,6320,27,1315652709,1315652766,4,8,57
48731805@N02,6320,21,1315652766,1315652868,6,8,102
48731805@N02,6320,26,1315652868,1315652925,5,8,57
48731805@N02,6320,7,1315652925,1315653105,4,8,180
48731805@N02,6320,28,1315653276,1315653294,2,8,18
48731805@N02,6320,4,1315653294,1315653324,2,8,30
48731805@N02,6320,8,1315653324,1315653504,1,8,180
48741368@N00,6321,1,1380943206,1380943266,1,1,60
48758984@N03,6322,6,1188555237,1188555357,1,1,120
48805347@N04,6323,10,1287101408,1287101648,45,3,240
48805347@N04,6323,30,1287114381,1287114408,2,3,27
48805347@N04,6323,10,1287114408,1287114648,21,3,240
48805347@N04,6324,30,1299971028,1299972108,2,1,1080
48805347@N04,6325,1,1381187520,1381187580,4,1,60
48812619@N00,6326,14,1266870311,1266870324,2,3,13
48812619@N00,6326,15,1266870324,1266870332,2,3,8
48812619@N00,6326,14,1266870332,1266870572,1,3,240
48813357@N06,6327,5,1299906921,1299907041,1,1,120
48813357@N06,6328,29,1300013524,1300014424,1,1,900
48826873@N08,6329,29,1452078460,1452079360,1,1,900
48826873@N08,6330,1,1452238539,1452238599,1,1,60
48837990@N00,6331,1,1392419241,1392419301,8,3,60
48837990@N00,6331,26,1392420972,1392421872,2,3,900
48837990@N00,6331,21,1392425363,1392425933,3,3,570
48837990@N00,6332,19,1392460907,1392461447,2,1,540
48837990@N00,6333,1,1392502240,1392502300,4,4,60
48837990@N00,6333,19,1392507363,1392507903,2,4,540
48837990@N00,6333,31,1392512896,1392514396,2,4,1500
48837990@N00,6333,30,1392517975,1392519055,1,4,1080
48842746@N04,6334,10,1290555126,1290555366,1,1,240
48871176@N08,6335,12,1253949827,1253950067,1,1,240
48871176@N08,6336,21,1269140004,1269140574,3,1,570
48871176@N08,6337,29,1272783925,1272784825,1,1,900
48871176@N08,6338,29,1273368544,1273369444,3,1,900
48871176@N08,6339,29,1273990039,1273990939,2,1,900
48871176@N08,6340,28,1274572641,1274572829,2,3,188
48871176@N08,6340,1,1274572829,1274572889,3,3,60
48871176@N08,6340,29,1274581792,1274582692,6,3,900
48871176@N08,6341,22,1275092230,1275092830,2,2,600
48871176@N08,6341,29,1275101059,1275101959,2,2,900
48871176@N08,6342,29,1275800642,1275801542,1,1,900
48871176@N08,6343,29,1276399626,1276400526,1,1,900
48871176@N08,6344,29,1277441964,1277442864,1,1,900
48871176@N08,6345,29,1278034289,1278035189,4,1,900
48871176@N08,6346,29,1278379980,1278380880,55,1,900
48871176@N08,6347,23,1278479295,1278479895,2,2,600
48871176@N08,6347,21,1278493537,1278494107,1,2,570
48874222@N02,6348,18,1447788341,1447788791,1,1,450
48889045669@N01,6349,20,1317875924,1317876464,1,1,540
48889052497@N01,6350,1,1407289731,1407289791,3,1,60
48889052497@N01,6351,19,1407550801,1407551341,1,1,540
48889068621@N01,6352,14,1229752841,1229753081,1,1,240
48889068621@N01,6353,22,1237526369,1237526969,7,2,600
48889068621@N01,6353,13,1237529049,1237529289,4,2,240
48889068621@N01,6354,1,1238306331,1238306391,1,1,60
48889068621@N01,6355,22,1238896818,1238896979,3,6,161
48889068621@N01,6355,20,1238896979,1238897519,2,6,540
48889068621@N01,6355,23,1238908103,1238908703,3,6,600
48889068621@N01,6355,31,1238909603,1238910440,4,6,837
48889068621@N01,6355,14,1238910440,1238910471,3,6,31
48889068621@N01,6355,31,1238910471,1238911971,7,6,1500
48889068621@N01,6356,25,1239495455,1239495461,2,2,6
48889068621@N01,6356,4,1239495461,1239495562,2,2,101
48889068621@N01,6357,28,1240121315,1240121320,2,2,5
48889068621@N01,6357,30,1240121320,1240122400,5,2,1080
48889068621@N01,6358,28,1244948545,1244948921,3,8,376
48889068621@N01,6358,16,1244948921,1244949191,3,8,270
48889068621@N01,6358,1,1244951281,1244951287,2,8,6
48889068621@N01,6358,28,1244951287,1244951550,2,8,263
48889068621@N01,6358,16,1244951550,1244951568,2,8,18
48889068621@N01,6358,26,1244951568,1244952394,8,8,826
48889068621@N01,6358,28,1244952394,1244953294,2,8,900
48889068621@N01,6358,29,1244959365,1244960265,1,8,900
48889068621@N01,6359,24,1245566162,1245566942,2,4,780
48889068621@N01,6359,27,1245568276,1245569176,3,4,900
48889068621@N01,6359,28,1245572752,1245573652,2,4,900
48889068621@N01,6359,29,1245587489,1245588389,11,4,900
48889068621@N01,6360,28,1247652064,1247652964,2,2,900
48889068621@N01,6360,16,1247655417,1247655687,2,2,270
48889068621@N01,6361,26,1247984229,1247985129,2,8,900
48889068621@N01,6361,7,1247985347,1247985408,2,8,61
48889068621@N01,6361,4,1247985408,1247985424,4,8,16
48889068621@N01,6361,7,1247985424,1247985442,2,8,18
48889068621@N01,6361,4,1247985442,1247985543,5,8,101
48889068621@N01,6361,7,1247985845,1247986025,2,8,180
48889068621@N01,6361,21,1247986337,1247986530,2,8,193
48889068621@N01,6361,3,1247986530,1247986620,3,8,90
48889068621@N01,6362,30,1251185723,1251186803,2,5,1080
48889068621@N01,6362,15,1251189804,1251190074,2,5,270
48889068621@N01,6362,13,1251190133,1251190373,2,5,240
48889068621@N01,6362,31,1251193984,1251195484,2,5,1500
48889068621@N01,6362,19,1251196623,1251197163,1,5,540
48889068621@N01,6363,13,1258853661,1258853901,3,6,240
48889068621@N01,6363,28,1258854791,1258855370,3,6,579
48889068621@N01,6363,19,1258855370,1258855910,5,6,540
48889068621@N01,6363,29,1258866229,1258867129,4,6,900
48889068621@N01,6363,18,1258867598,1258868048,2,6,450
48889068621@N01,6363,16,1258869291,1258869561,4,6,270
48889068621@N01,6364,28,1261277433,1261278333,2,13,900
48889068621@N01,6364,13,1261279927,1261280167,4,13,240
48889068621@N01,6364,22,1261281099,1261281112,2,13,13
48889068621@N01,6364,13,1261281112,1261281352,6,13,240
48889068621@N01,6364,31,1261283409,1261283875,2,13,466
48889068621@N01,6364,19,1261283875,1261283878,2,13,3
48889068621@N01,6364,31,1261283878,1261284639,5,13,761
48889068621@N01,6364,22,1261284639,1261285239,12,13,600
48889068621@N01,6364,19,1261286965,1261286978,3,13,13
48889068621@N01,6364,29,1261286978,1261286983,3,13,5
48889068621@N01,6364,31,1261286983,1261287372,2,13,389
48889068621@N01,6364,19,1261287372,1261287424,2,13,52
48889068621@N01,6364,31,1261287424,1261288924,19,13,1500
48889068621@N01,6365,3,1262488827,1262488917,1,1,90
48889068621@N01,6366,18,1262998981,1262999017,2,6,36
48889068621@N01,6366,29,1262999017,1262999240,2,6,223
48889068621@N01,6366,22,1262999240,1262999840,3,6,600
48889068621@N01,6366,27,1263009566,1263010466,2,6,900
48889068621@N01,6366,16,1263011412,1263011682,2,6,270
48889068621@N01,6366,4,1263015229,1263015330,2,6,101
48889068621@N01,6367,17,1267317328,1267317628,2,5,300
48889068621@N01,6367,13,1267323395,1267323408,4,5,13
48889068621@N01,6367,7,1267323408,1267323588,4,5,180
48889068621@N01,6367,15,1267325745,1267326015,4,5,270
48889068621@N01,6367,18,1267326127,1267326577,2,5,450
48889068621@N01,6368,12,1267856974,1267857124,2,13,150
48889068621@N01,6368,16,1267857124,1267857130,2,13,6
48889068621@N01,6368,15,1267857130,1267857150,4,13,20
48889068621@N01,6368,24,1267857150,1267857210,5,13,60
48889068621@N01,6368,16,1267857210,1267857480,2,13,270
48889068621@N01,6368,1,1267858909,1267858911,2,13,2
48889068621@N01,6368,15,1267858911,1267859161,4,13,250
48889068621@N01,6368,1,1267859161,1267859165,2,13,4
48889068621@N01,6368,15,1267859165,1267859435,7,13,270
48889068621@N01,6368,6,1267864683,1267864698,2,13,15
48889068621@N01,6368,4,1267864698,1267864712,2,13,14
48889068621@N01,6368,6,1267864712,1267864832,4,13,120
48889068621@N01,6368,7,1267864839,1267865019,4,13,180
48889068621@N01,6369,7,1268391140,1268391320,2,2,180
48889068621@N01,6369,11,1268391876,1268392116,6,2,240
48889068621@N01,6370,22,1268988395,1268988995,2,2,600
48889068621@N01,6370,15,1268994741,1268995011,5,2,270
48889068621@N01,6371,13,1271565585,1271565825,12,1,240
48889068621@N01,6372,26,1272167728,1272167731,2,3,3
48889068621@N01,6372,16,1272167731,1272168001,2,3,270
48889068621@N01,6372,4,1272169455,1272169556,7,3,101
48889068621@N01,6373,13,1275799767,1275800007,5,6,240
48889068621@N01,6373,25,1275800622,1275801462,2,6,840
48889068621@N01,6373,7,1275802060,1275802090,2,6,30
48889068621@N01,6373,11,1275802090,1275802109,3,6,19
48889068621@N01,6373,4,1275802109,1275802210,4,6,101
48889068621@N01,6373,11,1275804558,1275804798,2,6,240
48889068621@N01,6374,20,1284872359,1284872899,3,8,540
48889068621@N01,6374,4,1284874233,1284874334,4,8,101
48889068621@N01,6374,3,1284875200,1284875290,8,8,90
48889068621@N01,6374,7,1284877336,1284877344,2,8,8
48889068621@N01,6374,9,1284877344,1284877379,3,8,35
48889068621@N01,6374,7,1284877379,1284877559,9,8,180
48889068621@N01,6374,24,1284885219,1284885235,2,8,16
48889068621@N01,6374,15,1284885235,1284885505,1,8,270
48889068621@N01,6375,19,1289089778,1289090318,2,12,540
48889068621@N01,6375,11,1289096022,1289096262,3,12,240
48889068621@N01,6375,5,1289097942,1289098062,5,12,120
48889068621@N01,6375,22,1289098793,1289099393,2,12,600
48889068621@N01,6375,20,1289101183,1289101723,2,12,540
48889068621@N01,6375,14,1289102027,1289102267,2,12,240
48889068621@N01,6375,29,1289102533,1289102557,2,12,24
48889068621@N01,6375,22,1289102557,1289103157,3,12,600
48889068621@N01,6375,11,1289110349,1289110358,2,12,9
48889068621@N01,6375,15,1289110358,1289110628,4,12,270
48889068621@N01,6375,11,1289111703,1289111710,3,12,7
48889068621@N01,6375,17,1289111710,1289112010,7,12,300
48889081256@N01,6376,26,1213748927,1213749827,57,1,900
48889113645@N01,6377,19,1407762388,1407762928,1,1,540
48889113645@N01,6378,19,1407798858,1407799058,2,6,200
48889113645@N01,6378,13,1407799058,1407799298,3,6,240
48889113645@N01,6378,19,1407799629,1407800169,2,6,540
48889113645@N01,6378,17,1407808858,1407809158,2,6,300
48889113645@N01,6378,20,1407811258,1407811798,2,6,540
48889113645@N01,6378,19,1407812492,1407813032,2,6,540
48889119704@N01,6379,28,1244166939,1244167681,3,9,742
48889119704@N01,6379,1,1244167681,1244167741,3,9,60
48889119704@N01,6379,28,1244168650,1244169016,2,9,366
48889119704@N01,6379,21,1244169016,1244169586,11,9,570
48889119704@N01,6379,13,1244174133,1244174373,2,9,240
48889119704@N01,6379,16,1244177503,1244177773,3,9,270
48889119704@N01,6379,15,1244181337,1244181607,2,9,270
48889119704@N01,6379,24,1244182038,1244182812,5,9,774
48889119704@N01,6379,27,1244182812,1244183712,1,9,900
48889119704@N01,6380,1,1244212535,1244212595,2,2,60
48889119704@N01,6380,22,1244218857,1244219457,1,2,600
48889119704@N01,6381,24,1244259896,1244260676,8,4,780
48889119704@N01,6381,17,1244263056,1244263356,2,4,300
48889119704@N01,6381,26,1244266679,1244267390,2,4,711
48889119704@N01,6381,24,1244267390,1244268170,2,4,780
48889119704@N01,6382,26,1244296455,1244297355,1,1,900
48889119704@N01,6383,17,1245058877,1245059177,1,1,300
48921737@N00,6384,1,1384999205,1384999265,1,1,60
48949906@N00,6385,1,1385362100,1385362160,8,9,60
48949906@N00,6385,20,1385363233,1385363741,5,9,508
48949906@N00,6385,26,1385363741,1385364025,2,9,284
48949906@N00,6385,23,1385364025,1385364524,3,9,499
48949906@N00,6385,18,1385364524,1385364626,2,9,102
48949906@N00,6385,23,1385364626,1385364658,3,9,32
48949906@N00,6385,18,1385364658,1385364852,4,9,194
48949906@N00,6385,23,1385364852,1385365357,2,9,505
48949906@N00,6385,18,1385365357,1385365807,3,9,450
48949906@N00,6386,17,1385501057,1385501357,7,34,300
48949906@N00,6386,27,1385502740,1385503032,2,34,292
48949906@N00,6386,16,1385503032,1385503209,2,34,177
48949906@N00,6386,27,1385503209,1385504091,6,34,882
48949906@N00,6386,17,1385504091,1385504158,2,34,67
48949906@N00,6386,27,1385504158,1385504398,2,34,240
48949906@N00,6386,24,1385504398,1385505172,3,34,774
48949906@N00,6386,12,1385505172,1385505210,2,34,38
48949906@N00,6386,24,1385505210,1385505517,2,34,307
48949906@N00,6386,12,1385505517,1385505757,2,34,240
48949906@N00,6386,24,1385506055,1385506683,7,34,628
48949906@N00,6386,17,1385506683,1385506983,15,34,300
48949906@N00,6386,12,1385510130,1385510370,23,34,240
48949906@N00,6386,3,1385512146,1385512151,2,34,5
48949906@N00,6386,12,1385512151,1385512391,5,34,240
48949906@N00,6386,5,1385513652,1385513772,5,34,120
48949906@N00,6386,7,1385513904,1385514084,7,34,180
48949906@N00,6386,9,1385514130,1385514155,2,34,25
48949906@N00,6386,5,1385514155,1385514275,2,34,120
48949906@N00,6386,26,1385516026,1385516926,35,34,900
48949906@N00,6386,17,1385517422,1385517722,3,34,300
48949906@N00,6386,15,1385517726,1385517996,2,34,270
48949906@N00,6386,23,1385519125,1385519582,3,34,457
48949906@N00,6386,18,1385519582,1385519829,4,34,247
48949906@N00,6386,23,1385519829,1385519900,3,34,71
48949906@N00,6386,18,1385519900,1385520087,2,34,187
48949906@N00,6386,23,1385520087,1385520486,4,34,399
48949906@N00,6386,18,1385520486,1385520936,5,34,450
48949906@N00,6386,20,1385523754,1385524294,2,34,540
48949906@N00,6386,31,1385526447,1385527429,4,34,982
48949906@N00,6386,20,1385527429,1385527969,4,34,540
48949906@N00,6386,13,1385528282,1385528522,4,34,240
48949906@N00,6386,15,1385532422,1385532692,12,34,270
48949906@N00,6386,29,1385538238,1385539138,2,34,900
48949906@N00,6387,24,1385632261,1385632281,2,4,20
48949906@N00,6387,21,1385632281,1385632851,4,4,570
48949906@N00,6387,18,1385636070,1385636160,2,4,90
48949906@N00,6387,28,1385636160,1385637060,7,4,900
48949906@N00,6388,16,1385679269,1385679285,2,14,16
48949906@N00,6388,26,1385679285,1385679470,3,14,185
48949906@N00,6388,18,1385679470,1385679920,8,14,450
48949906@N00,6388,23,1385681219,1385681819,10,14,600
48949906@N00,6388,18,1385681844,1385681899,3,14,55
48949906@N00,6388,23,1385681899,1385682000,2,14,101
48949906@N00,6388,18,1385682000,1385682004,2,14,4
48949906@N00,6388,23,1385682004,1385682268,4,14,264
48949906@N00,6388,18,1385682268,1385682635,2,14,367
48949906@N00,6388,23,1385682635,1385682674,3,14,39
48949906@N00,6388,18,1385682674,1385682845,3,14,171
48949906@N00,6388,26,1385682845,1385683626,14,14,781
48949906@N00,6388,3,1385683626,1385683716,2,14,90
48949906@N00,6388,11,1385686663,1385686903,1,14,240
48983707@N00,6389,5,1201233494,1201233614,2,1,120
49025781@N00,6390,24,1426750133,1426750913,1,1,780
49025781@N00,6391,26,1433211624,1433212524,1,1,900
49025781@N00,6392,1,1439203460,1439203491,2,3,31
49025781@N00,6392,11,1439203491,1439203731,2,3,240
49025781@N00,6392,26,1439203950,1439204850,1,3,900
49059899@N00,6393,1,1220051712,1220051772,3,1,60
49059899@N00,6394,29,1233347421,1233347429,2,7,8
49059899@N00,6394,30,1233347429,1233348509,4,7,1080
49059899@N00,6394,31,1233352116,1233353616,3,7,1500
49059899@N00,6394,12,1233355400,1233355470,2,7,70
49059899@N00,6394,16,1233355470,1233355740,4,7,270
49059899@N00,6394,1,1233355786,1233355802,2,7,16
49059899@N00,6394,28,1233355802,1233356702,1,7,900
49059899@N00,6395,16,1248487468,1248487738,3,4,270
49059899@N00,6395,1,1248487928,1248487988,6,4,60
49059899@N00,6395,28,1248488093,1248488755,7,4,662
49059899@N00,6395,1,1248488755,1248488815,1,4,60
49059899@N00,6396,18,1249687613,1249687780,3,5,167
49059899@N00,6396,12,1249687780,1249687797,2,5,17
49059899@N00,6396,18,1249687797,1249688247,3,5,450
49059899@N00,6396,23,1249689647,1249690247,5,5,600
49059899@N00,6396,1,1249696014,1249696074,4,5,60
49072197@N02,6397,31,1303015081,1303016581,3,2,1500
49072197@N02,6397,26,1303021442,1303022342,1,2,900
49072197@N02,6398,25,1312365210,1312366050,1,1,840
49072197@N02,6399,28,1312595183,1312595378,2,4,195
49072197@N02,6399,1,1312595378,1312595438,2,4,60
49072197@N02,6399,26,1312596661,1312597561,7,4,900
49072197@N02,6399,1,1312601290,1312601350,1,4,60
49165041@N00,6400,12,1197739615,1197739855,2,4,240
49165041@N00,6400,21,1197741504,1197742074,3,4,570
49165041@N00,6400,30,1197754889,1197755969,8,4,1080
49165041@N00,6400,25,1197757226,1197758066,4,4,840
49165041@N00,6401,30,1232366010,1232366158,5,5,148
49165041@N00,6401,18,1232366158,1232366229,8,5,71
49165041@N00,6401,23,1232366229,1232366286,3,5,57
49165041@N00,6401,18,1232366286,1232366318,2,5,32
49165041@N00,6401,28,1232366318,1232367218,1,5,900
49165041@N00,6402,28,1240390628,1240390849,2,14,221
49165041@N00,6402,23,1240390849,1240390988,2,14,139
49165041@N00,6402,29,1240390988,1240391163,3,14,175
49165041@N00,6402,20,1240391163,1240391376,2,14,213
49165041@N00,6402,29,1240391376,1240391807,2,14,431
49165041@N00,6402,23,1240391807,1240392407,2,14,600
49165041@N00,6402,6,1240393479,1240393599,3,14,120
49165041@N00,6402,21,1240394586,1240395156,2,14,570
49165041@N00,6402,24,1240396053,1240396380,5,14,327
49165041@N00,6402,27,1240396380,1240397031,2,14,651
49165041@N00,6402,12,1240397031,1240397271,2,14,240
49165041@N00,6402,26,1240397555,1240398089,2,14,534
49165041@N00,6402,20,1240398089,1240398629,4,14,540
49165041@N00,6402,31,1240399172,1240400672,1,14,1500
49165041@N00,6403,1,1249464786,1249464846,2,10,60
49165041@N00,6403,28,1249465114,1249466014,4,10,900
49165041@N00,6403,26,1249468350,1249469250,2,10,900
49165041@N00,6403,29,1249469510,1249470410,2,10,900
49165041@N00,6403,23,1249470879,1249471479,10,10,600
49165041@N00,6403,26,1249472441,1249472758,5,10,317
49165041@N00,6403,27,1249472758,1249473658,2,10,900
49165041@N00,6403,16,1249473679,1249473949,5,10,270
49165041@N00,6403,27,1249474901,1249475434,5,10,533
49165041@N00,6403,28,1249475434,1249476334,7,10,900
49165041@N00,6404,26,1251603842,1251604742,4,3,900
49165041@N00,6404,29,1251607037,1251607681,2,3,644
49165041@N00,6404,30,1251607681,1251608761,3,3,1080
49165041@N00,6405,28,1252839780,1252840680,3,1,900
49165041@N00,6406,1,1253002466,1253002526,3,5,60
49165041@N00,6406,22,1253005988,1253006218,2,5,230
49165041@N00,6406,29,1253006218,1253006775,2,5,557
49165041@N00,6406,12,1253006775,1253007015,4,5,240
49165041@N00,6406,24,1253007557,1253008337,1,5,780
49165041@N00,6407,1,1254025297,1254025357,2,5,60
49165041@N00,6407,16,1254025578,1254025848,2,5,270
49165041@N00,6407,17,1254026701,1254027001,6,5,300
49165041@N00,6407,26,1254030076,1254030463,2,5,387
49165041@N00,6407,29,1254030463,1254031363,1,5,900
49165041@N00,6408,1,1254721149,1254721172,2,4,23
49165041@N00,6408,29,1254721172,1254721280,2,4,108
49165041@N00,6408,22,1254721280,1254721307,2,4,27
49165041@N00,6408,6,1254721307,1254721427,1,4,120
49165041@N00,6409,23,1258865142,1258865742,6,6,600
49165041@N00,6409,20,1258868530,1258869070,5,6,540
49165041@N00,6409,21,1258873215,1258873469,2,6,254
49165041@N00,6409,13,1258873469,1258873709,4,6,240
49165041@N00,6409,21,1258874327,1258874850,4,6,523
49165041@N00,6409,28,1258874850,1258875750,4,6,900
49165041@N00,6410,23,1259043586,1259044186,2,6,600
49165041@N00,6410,22,1259047190,1259047790,2,6,600
49165041@N00,6410,23,1259048422,1259049022,2,6,600
49165041@N00,6410,21,1259049314,1259049884,3,6,570
49165041@N00,6410,29,1259063239,1259064107,3,6,868
49165041@N00,6410,23,1259064107,1259064707,1,6,600
49165041@N00,6411,30,1261115654,1261116734,1,1,1080
49165041@N00,6412,6,1263363380,1263363500,5,4,120
49165041@N00,6412,29,1263368564,1263369464,14,4,900
49165041@N00,6412,28,1263371336,1263372236,16,4,900
49165041@N00,6412,6,1263380693,1263380813,3,4,120
49165041@N00,6413,1,1267154266,1267154326,5,6,60
49165041@N00,6413,17,1267155788,1267156088,3,6,300
49165041@N00,6413,26,1267158166,1267158711,6,6,545
49165041@N00,6413,11,1267158711,1267158951,3,6,240
49165041@N00,6413,4,1267158972,1267159073,3,6,101
49165041@N00,6413,23,1267161964,1267162564,3,6,600
49165041@N00,6414,26,1271815423,1271815841,5,3,418
49165041@N00,6414,11,1271815841,1271816081,2,3,240
49165041@N00,6414,30,1271816168,1271817248,2,3,1080
49165041@N00,6415,1,1279005289,1279005349,2,7,60
49165041@N00,6415,23,1279005792,1279006392,2,7,600
49165041@N00,6415,30,1279009119,1279009698,2,7,579
49165041@N00,6415,12,1279009698,1279009938,2,7,240
49165041@N00,6415,15,1279010288,1279010558,2,7,270
49165041@N00,6415,16,1279012414,1279012684,5,7,270
49165041@N00,6415,28,1279015576,1279016476,8,7,900
49165041@N00,6416,24,1286587338,1286588118,4,6,780
49165041@N00,6416,27,1286588675,1286589109,5,6,434
49165041@N00,6416,29,1286589109,1286589337,2,6,228
49165041@N00,6416,30,1286589337,1286590417,2,6,1080
49165041@N00,6416,29,1286590652,1286591552,3,6,900
49165041@N00,6416,16,1286595874,1286596144,3,6,270
49165041@N00,6417,29,1289452895,1289453795,2,2,900
49165041@N00,6417,28,1289454200,1289455100,2,2,900
49165041@N00,6418,24,1293750684,1293751464,16,3,780
49165041@N00,6418,16,1293757788,1293758058,3,3,270
49165041@N00,6418,24,1293758616,1293759396,2,3,780
49165041@N00,6419,28,1301191639,1301191659,2,8,20
49165041@N00,6419,26,1301191659,1301192559,4,8,900
49165041@N00,6419,30,1301193032,1301194112,4,8,1080
49165041@N00,6419,24,1301195358,1301196138,3,8,780
49165041@N00,6419,15,1301196221,1301196491,3,8,270
49165041@N00,6419,29,1301199178,1301200078,6,8,900
49165041@N00,6419,28,1301200079,1301200575,2,8,496
49165041@N00,6419,1,1301200575,1301200635,5,8,60
49165041@N00,6420,16,1302324554,1302324824,2,4,270
49165041@N00,6420,24,1302327407,1302328187,27,4,780
49165041@N00,6420,11,1302332430,1302332670,4,4,240
49165041@N00,6420,24,1302333131,1302333911,1,4,780
49165041@N00,6421,16,1305419491,1305419761,3,4,270
49165041@N00,6421,6,1305441983,1305442103,2,4,120
49165041@N00,6421,26,1305442484,1305443281,3,4,797
49165041@N00,6421,30,1305443281,1305444361,1,4,1080
49165041@N00,6422,16,1306804094,1306804364,2,1,270
49165041@N00,6423,1,1306981998,1306982058,2,4,60
49165041@N00,6423,17,1306983248,1306983548,5,4,300
49165041@N00,6423,24,1306984648,1306985428,4,4,780
49165041@N00,6423,29,1306989029,1306989929,2,4,900
49165041@N00,6424,24,1328770604,1328771384,1,1,780
49169223@N00,6425,28,1342822664,1342823215,2,24,551
49169223@N00,6425,17,1342823215,1342823515,2,24,300
49169223@N00,6425,12,1342824647,1342824887,2,24,240
49169223@N00,6425,21,1342825359,1342825406,3,24,47
49169223@N00,6425,7,1342825406,1342825586,2,24,180
49169223@N00,6425,5,1342825720,1342825840,3,24,120
49169223@N00,6425,21,1342826422,1342826992,13,24,570
49169223@N00,6425,26,1342828166,1342828972,3,24,806
49169223@N00,6425,24,1342828972,1342829752,14,24,780
49169223@N00,6425,17,1342830100,1342830400,2,24,300
49169223@N00,6425,12,1342830788,1342830795,2,24,7
49169223@N00,6425,24,1342830795,1342831575,3,24,780
49169223@N00,6425,30,1342834079,1342834958,3,24,879
49169223@N00,6425,31,1342834958,1342835165,4,24,207
49169223@N00,6425,22,1342835165,1342835476,3,24,311
49169223@N00,6425,31,1342835476,1342836976,3,24,1500
49169223@N00,6425,29,1342837350,1342837373,2,24,23
49169223@N00,6425,30,1342837373,1342837581,2,24,208
49169223@N00,6425,19,1342837581,1342838121,2,24,540
49169223@N00,6425,23,1342838395,1342838995,4,24,600
49169223@N00,6425,20,1342842323,1342842863,3,24,540
49169223@N00,6425,25,1342843712,1342844552,3,24,840
49169223@N00,6425,16,1342845429,1342845699,3,24,270
49169223@N00,6425,29,1342868897,1342869797,2,24,900
49169223@N00,6426,28,1343091571,1343091994,2,7,423
49169223@N00,6426,22,1343091994,1343092594,2,7,600
49169223@N00,6426,28,1343094347,1343095247,3,7,900
49169223@N00,6426,13,1343099490,1343099730,3,7,240
49169223@N00,6426,12,1343103698,1343103938,2,7,240
49169223@N00,6426,28,1343129681,1343130322,2,7,641
49169223@N00,6426,29,1343130322,1343131222,6,7,900
49169223@N00,6427,28,1343174240,1343175140,2,2,900
49169223@N00,6427,6,1343178446,1343178566,1,2,120
49201665@N08,6428,24,1308102247,1308103027,1,1,780
49221400@N00,6429,27,1331416754,1331417654,5,8,900
49221400@N00,6429,16,1331424476,1331424746,2,8,270
49221400@N00,6429,15,1331426837,1331427107,2,8,270
49221400@N00,6429,12,1331428381,1331428621,3,8,240
49221400@N00,6429,22,1331444386,1331444986,2,8,600
49221400@N00,6429,27,1331449433,1331450333,3,8,900
49221400@N00,6429,26,1331454209,1331455109,2,8,900
49221400@N00,6429,22,1331458753,1331459353,4,8,600
49226124@N02,6430,28,1318806363,1318807263,21,1,900
49239262@N00,6431,26,1388921114,1388922014,1,1,900
49268359@N05,6432,26,1337752120,1337753020,1,1,900
49268359@N05,6433,7,1337820897,1337821077,1,1,180
49268359@N05,6434,13,1337904381,1337904621,4,2,240
49268359@N05,6434,28,1337926479,1337927379,1,2,900
49268359@N05,6435,20,1338002983,1338003523,1,1,540
49275237@N00,6436,28,1239494620,1239495520,5,6,900
49275237@N00,6436,16,1239495715,1239495923,2,6,208
49275237@N00,6436,26,1239495923,1239496823,7,6,900
49275237@N00,6436,11,1239497588,1239497828,26,6,240
49275237@N00,6436,30,1239503593,1239504673,12,6,1080
49275237@N00,6436,1,1239535629,1239535689,25,6,60
49304581@N02,6437,20,1292415300,1292415840,3,4,540
49304581@N02,6437,29,1292418240,1292419140,2,4,900
49304581@N02,6437,26,1292420206,1292421106,2,4,900
49304581@N02,6437,28,1292421210,1292422110,1,4,900
49304581@N02,6438,30,1292968040,1292969120,3,2,1080
49304581@N02,6438,26,1292979285,1292980185,1,2,900
49304581@N02,6439,20,1293216993,1293217533,1,1,540
49304581@N02,6440,29,1293254343,1293255243,1,1,900
49304581@N02,6441,26,1293796739,1293797639,1,1,900
49304581@N02,6442,20,1293933247,1293933787,1,1,540
49304581@N02,6443,31,1294592517,1294594017,1,1,1500
49304581@N02,6444,26,1312343588,1312344488,2,1,900
49304581@N02,6445,31,1312376038,1312377538,1,1,1500
49304581@N02,6446,20,1313155739,1313156279,1,1,540
49304581@N02,6447,15,1313239277,1313239547,1,1,270
49304581@N02,6448,20,1316414185,1316414725,1,1,540
49304581@N02,6449,26,1319782306,1319783206,3,2,900
49304581@N02,6449,29,1319789942,1319790842,1,2,900
49304581@N02,6450,29,1322881441,1322882341,2,1,900
49304581@N02,6451,31,1323252610,1323254110,1,1,1500
49304581@N02,6452,19,1324034753,1324035293,1,1,540
49304581@N02,6453,1,1324091182,1324091242,3,5,60
49304581@N02,6453,19,1324096753,1324097293,2,5,540
49304581@N02,6453,24,1324108230,1324109010,2,5,780
49304581@N02,6453,29,1324126044,1324126944,2,5,900
49304581@N02,6453,16,1324132870,1324133140,1,5,270
49304581@N02,6454,19,1325335150,1325335690,1,1,540
49304581@N02,6455,22,1326004127,1326004727,2,2,600
49304581@N02,6455,19,1326021797,1326022337,1,2,540
49304581@N02,6456,26,1330544714,1330545614,2,1,900
49304581@N02,6457,23,1335945639,1335946239,1,1,600
49304581@N02,6458,28,1343985934,1343986379,2,3,445
49304581@N02,6458,30,1343986379,1343987459,2,3,1080
49304581@N02,6458,23,1343998137,1343998737,2,3,600
49304581@N02,6459,18,1348294404,1348294854,1,1,450
49305593@N05,6460,18,1431078085,1431078535,3,1,450
49305593@N05,6461,18,1431149807,1431150257,4,1,450
49305593@N05,6462,18,1431252081,1431252531,2,1,450
49305593@N05,6463,18,1431414145,1431414595,3,1,450
49305593@N05,6464,18,1431697459,1431697909,8,1,450
49340262@N05,6465,26,1437257708,1437258608,1,1,900
49355124@N04,6466,29,1393902720,1393903620,1,1,900
49355871@N00,6467,1,1374585614,1374585674,1,1,60
49362482@N00,6468,19,1349477998,1349478538,2,2,540
49362482@N00,6468,29,1349481036,1349481936,3,2,900
49364971@N04,6469,4,1273916288,1273916389,1,1,101
49425282@N00,6470,20,1259809200,1259809740,39,1,540
49427795@N00,6471,20,1354444488,1354445028,1,1,540
49451382@N00,6472,28,1243655434,1243656334,41,1,900
49471872@N00,6473,1,1291679637,1291679697,2,15,60
49471872@N00,6473,19,1291680910,1291681450,6,15,540
49471872@N00,6473,28,1291683694,1291683929,4,15,235
49471872@N00,6473,23,1291683929,1291684453,2,15,524
49471872@N00,6473,29,1291684453,1291684666,2,15,213
49471872@N00,6473,19,1291684666,1291685206,4,15,540
49471872@N00,6473,29,1291685759,1291686246,2,15,487
49471872@N00,6473,19,1291686246,1291686786,3,15,540
49471872@N00,6473,31,1291689810,1291691310,2,15,1500
49471872@N00,6473,26,1291691908,1291691940,2,15,32
49471872@N00,6473,29,1291691940,1291692840,2,15,900
49471872@N00,6473,24,1291696096,1291696876,7,15,780
49471872@N00,6473,25,1291706199,1291707039,2,15,840
49471872@N00,6473,17,1291714092,1291714392,2,15,300
49471872@N00,6473,26,1291716203,1291717103,1,15,900
49502978053@N01,6474,31,1215669306,1215670142,3,7,836
49502978053@N01,6474,29,1215670142,1215670174,2,7,32
49502978053@N01,6474,31,1215670174,1215670187,2,7,13
49502978053@N01,6474,30,1215670187,1215670287,4,7,100
49502978053@N01,6474,31,1215670287,1215670383,2,7,96
49502978053@N01,6474,22,1215670383,1215670815,2,7,432
49502978053@N01,6474,31,1215670815,1215672315,1,7,1500
49502978053@N01,6475,16,1216049636,1216049906,1,1,270
49502978053@N01,6476,31,1216094130,1216094180,2,2,50
49502978053@N01,6476,30,1216094180,1216095260,1,2,1080
49502995892@N01,6477,18,1199551885,1199552335,2,3,450
49502995892@N01,6477,16,1199561663,1199561933,2,3,270
49502995892@N01,6477,28,1199562415,1199563315,1,3,900
49503008419@N01,6478,1,1381049272,1381049332,1,1,60
49503013198@N01,6479,25,1266726150,1266726990,1,1,840
49503068447@N01,6480,26,1406433683,1406434583,13,3,900
49503068447@N01,6480,25,1406454534,1406455374,2,3,840
49503068447@N01,6480,26,1406455680,1406456580,2,3,900
49503202796@N01,6481,22,1191643001,1191643601,4,5,600
49503202796@N01,6481,11,1191649205,1191649445,2,5,240
49503202796@N01,6481,25,1191650903,1191651743,2,5,840
49503202796@N01,6481,13,1191652838,1191653078,2,5,240
49503202796@N01,6481,28,1191656030,1191656930,1,5,900
49545908@N00,6482,15,1283823310,1283823580,2,4,270
49545908@N00,6482,14,1283824375,1283824381,2,4,6
49545908@N00,6482,24,1283824381,1283825161,4,4,780
49545908@N00,6482,21,1283829522,1283830092,1,4,570
49578007@N05,6483,24,1356103871,1356103879,2,6,8
49578007@N05,6483,25,1356103879,1356103888,2,6,9
49578007@N05,6483,26,1356103888,1356103911,2,6,23
49578007@N05,6483,29,1356103911,1356103918,2,6,7
49578007@N05,6483,20,1356103918,1356103925,2,6,7
49578007@N05,6483,28,1356103925,1356104825,1,6,900
49578007@N05,6484,28,1360654876,1360655776,2,2,900
49578007@N05,6484,26,1360666221,1360667121,1,2,900
49578007@N05,6485,20,1363486991,1363487531,2,3,540
49578007@N05,6485,18,1363489342,1363489792,2,3,450
49578007@N05,6485,27,1363496543,1363497443,1,3,900
49578007@N05,6486,1,1367126913,1367126973,2,3,60
49578007@N05,6486,15,1367131465,1367131735,5,3,270
49578007@N05,6486,26,1367151897,1367152797,2,3,900
49578007@N05,6487,1,1369416970,1369417030,2,3,60
49578007@N05,6487,26,1369418217,1369419117,2,3,900
49578007@N05,6487,27,1369421665,1369422565,1,3,900
49578007@N05,6488,14,1369474424,1369474664,2,3,240
49578007@N05,6488,7,1369479349,1369479529,2,3,180
49578007@N05,6488,27,1369482063,1369482963,1,3,900
49578007@N05,6489,1,1372483335,1372483395,1,1,60
49578007@N05,6490,4,1375621471,1375621572,1,1,101
49578007@N05,6491,17,1378628465,1378628765,1,1,300
49578007@N05,6492,27,1379768668,1379769568,1,1,900
49578007@N05,6493,29,1380358354,1380359254,2,2,900
49578007@N05,6493,27,1380364436,1380365336,1,2,900
49578007@N05,6494,30,1380946716,1380947796,1,1,1080
49578007@N05,6495,29,1380977795,1380978695,1,1,900
49578007@N05,6496,20,1381054160,1381054700,2,1,540
49578007@N05,6497,26,1382187126,1382188026,2,1,900
49578007@N05,6498,15,1382852094,1382852364,1,1,270
49578007@N05,6499,18,1384669055,1384669505,1,1,450
49578007@N05,6500,26,1385652761,1385653661,1,1,900
49578007@N05,6501,28,1385695155,1385696055,1,1,900
49578007@N05,6502,20,1385802439,1385802979,1,1,540
49578007@N05,6503,29,1391870363,1391871263,1,1,900
49578007@N05,6504,27,1393657251,1393658151,2,2,900
49578007@N05,6504,17,1393682947,1393683247,1,2,300
49578007@N05,6505,30,1394859093,1394860173,2,2,1080
49578007@N05,6505,28,1394870776,1394871676,1,2,900
49578007@N05,6506,30,1398415857,1398416937,1,1,1080
49578007@N05,6507,26,1400874432,1400875332,2,3,900
49578007@N05,6507,29,1400875872,1400876772,2,3,900
49578007@N05,6507,1,1400883955,1400884015,1,3,60
49578007@N05,6508,28,1400929607,1400930507,1,1,900
49578007@N05,6509,28,1404462008,1404462908,2,4,900
49578007@N05,6509,29,1404469158,1404470058,2,4,900
49578007@N05,6509,3,1404470778,1404470868,2,4,90
49578007@N05,6509,28,1404486056,1404486956,1,4,900
49578007@N05,6510,29,1405752407,1405753057,2,3,650
49578007@N05,6510,14,1405753057,1405753297,3,3,240
49578007@N05,6510,21,1405757507,1405758077,1,3,570
49578007@N05,6511,29,1408899053,1408899953,1,1,900
49578007@N05,6512,29,1410597613,1410598513,1,1,900
49578007@N05,6513,24,1411643705,1411644485,2,1,780
49578007@N05,6514,26,1411827570,1411828470,1,1,900
49578007@N05,6515,30,1412427181,1412428261,1,1,1080
49578007@N05,6516,27,1412525730,1412526630,1,1,900
49578007@N05,6517,18,1416036333,1416036783,2,2,450
49578007@N05,6517,25,1416051306,1416052146,1,2,840
49578007@N05,6518,25,1416668873,1416669713,1,1,840
49578007@N05,6519,28,1417167898,1417168798,1,1,900
49578007@N05,6520,23,1417941832,1417942432,1,1,600
49578007@N05,6521,26,1420101744,1420102644,1,1,900
49578007@N05,6522,26,1424092383,1424093283,1,1,900
49578007@N05,6523,26,1428329997,1428330897,1,1,900
49578007@N05,6524,29,1432374230,1432375130,1,1,900
49578007@N05,6525,28,1436024134,1436025034,1,1,900
49578007@N05,6526,18,1438489043,1438489493,1,1,450
49578007@N05,6527,28,1441627974,1441628874,1,1,900
49578007@N05,6528,30,1443834504,1443835584,2,2,1080
49578007@N05,6528,18,1443839824,1443840274,1,2,450
49578007@N05,6529,15,1452399319,1452399589,2,1,270
49578007@N05,6530,30,1452936812,1452937892,1,1,1080
49578007@N05,6531,26,1453541122,1453542022,1,1,900
49608965@N07,6532,26,1321537021,1321537921,1,1,900
49657535@N06,6533,6,1271398460,1271398580,1,1,120
49693311@N02,6534,28,1242891123,1242892023,1,1,900
49693311@N02,6535,30,1248925754,1248925826,2,3,72
49693311@N02,6535,31,1248925826,1248925857,2,3,31
49693311@N02,6535,20,1248925857,1248926397,1,3,540
49693311@N02,6536,29,1250515935,1250516835,4,1,900
49693311@N02,6537,29,1259132963,1259133863,2,1,900
49693311@N02,6538,21,1269928936,1269929324,2,3,388
49693311@N02,6538,12,1269929324,1269929564,2,3,240
49693311@N02,6538,17,1269930860,1269931160,1,3,300
49693311@N02,6539,27,1386307934,1386308834,3,1,900
49705600@N06,6540,21,1358467219,1358467789,1,1,570
49705600@N06,6541,13,1358654110,1358654350,2,2,240
49705600@N06,6541,22,1358655656,1358656256,1,2,600
49721577@N00,6542,16,1237595732,1237596002,3,2,270
49721577@N00,6542,21,1237608477,1237609047,1,2,570
49768774@N02,6543,18,1298176607,1298177057,1,1,450
49768774@N02,6544,18,1328919509,1328919959,1,1,450
49771540@N05,6545,16,1280067857,1280068127,1,1,270
49780897@N07,6546,17,1323435025,1323435325,1,1,300
49780897@N07,6547,25,1323474369,1323475209,1,1,840
49780897@N07,6548,1,1331534590,1331534650,1,1,60
49780897@N07,6549,30,1331601009,1331602089,1,1,1080
49782462@N00,6550,19,1419224027,1419224567,1,1,540
49790899@N02,6551,1,1212782400,1212782460,1,1,60
49846427@N00,6552,28,1333333868,1333334768,1,1,900
49850599@N08,6553,26,1339514068,1339514968,34,1,900
49850599@N08,6554,26,1339767787,1339768687,2,1,900
49850599@N08,6555,26,1339813806,1339814706,22,1,900
49850599@N08,6556,26,1339855372,1339856272,16,1,900
49853465@N00,6557,1,1264636007,1264636067,2,3,60
49853465@N00,6557,13,1264645695,1264645935,2,3,240
49853465@N00,6557,30,1264661054,1264662134,1,3,1080
49858236@N04,6558,1,1323300410,1323300470,6,3,60
49858236@N04,6558,28,1323300662,1323301562,12,3,900
49858236@N04,6558,1,1323332978,1323333038,8,3,60
49858236@N04,6559,1,1324440945,1324441005,59,10,60
49858236@N04,6559,28,1324444612,1324445512,8,10,900
49858236@N04,6559,1,1324466925,1324466985,5,10,60
49858236@N04,6559,28,1324467152,1324467519,3,10,367
49858236@N04,6559,26,1324467519,1324467798,5,10,279
49858236@N04,6559,23,1324467798,1324467963,2,10,165
49858236@N04,6559,18,1324467963,1324468413,4,10,450
49858236@N04,6559,19,1324468862,1324469402,4,10,540
49858236@N04,6559,25,1324471402,1324472242,25,10,840
49858236@N04,6559,15,1324476784,1324477054,1,10,270
49858236@N04,6560,28,1331334642,1331334870,2,9,228
49858236@N04,6560,1,1331334870,1331334930,14,9,60
49858236@N04,6560,23,1331337769,1331338276,2,9,507
49858236@N04,6560,31,1331338276,1331339456,5,9,1180
49858236@N04,6560,29,1331339456,1331340356,36,9,900
49858236@N04,6560,16,1331343133,1331343403,5,9,270
49858236@N04,6560,13,1331344280,1331344520,10,9,240
49858236@N04,6560,21,1331355683,1331356253,4,9,570
49858236@N04,6560,27,1331361056,1331361956,13,9,900
49876360@N07,6561,26,1392516723,1392517623,4,2,900
49876360@N07,6561,13,1392517849,1392518089,2,2,240
49876360@N07,6562,1,1393057995,1393058055,4,2,60
49876360@N07,6562,26,1393061036,1393061936,1,2,900
49876360@N07,6563,1,1394268081,1394268141,2,1,60
49876360@N07,6564,28,1394342306,1394343206,6,2,900
49876360@N07,6564,1,1394350492,1394350552,4,2,60
49876360@N07,6565,28,1399078946,1399079846,2,2,900
49876360@N07,6565,30,1399080881,1399081961,1,2,1080
49876360@N07,6566,25,1403316942,1403317636,2,3,694
49876360@N07,6566,26,1403317636,1403318536,2,3,900
49876360@N07,6566,28,1403318561,1403319461,1,3,900
49880056@N05,6567,16,1250536546,1250536816,12,1,270
49887039@N04,6568,1,1313619862,1313619922,2,9,60
49887039@N04,6568,26,1313620236,1313621136,3,9,900
49887039@N04,6568,17,1313622798,1313623098,2,9,300
49887039@N04,6568,26,1313625490,1313625982,2,9,492
49887039@N04,6568,29,1313625982,1313626882,4,9,900
49887039@N04,6568,24,1313644297,1313645077,2,9,780
49887039@N04,6568,6,1313647895,1313648015,2,9,120
49887039@N04,6568,28,1313656648,1313657548,4,9,900
49887039@N04,6568,26,1313673406,1313674306,2,9,900
49887039@N04,6569,1,1313901776,1313901836,2,2,60
49887039@N04,6569,26,1313908931,1313909831,1,2,900
49887039@N04,6570,27,1314062549,1314063449,1,1,900
49887039@N04,6571,1,1340708301,1340708361,1,1,60
49887039@N04,6572,3,1340966361,1340966451,1,1,90
49887039@N04,6573,27,1341334949,1341335849,1,1,900
49887039@N04,6574,26,1342437794,1342438694,1,1,900
49897362@N02,6575,1,1288058930,1288058990,6,7,60
49897362@N02,6575,28,1288059623,1288060523,3,7,900
49897362@N02,6575,29,1288063633,1288063965,2,7,332
49897362@N02,6575,19,1288063965,1288064505,2,7,540
49897362@N02,6575,20,1288065780,1288066320,2,7,540
49897362@N02,6575,29,1288072100,1288073000,3,7,900
49897362@N02,6575,20,1288074877,1288075417,1,7,540
49981519@N07,6576,26,1344259837,1344260737,1,1,900
50037155@N05,6577,30,1291922188,1291923268,1,1,1080
50038815@N08,6578,16,1395775982,1395776252,3,1,270
50038815@N08,6579,26,1400793447,1400793478,2,11,31
50038815@N08,6579,31,1400793478,1400793500,2,11,22
50038815@N08,6579,26,1400793500,1400793746,3,11,246
50038815@N08,6579,7,1400793746,1400793854,2,11,108
50038815@N08,6579,9,1400793854,1400794034,2,11,180
50038815@N08,6579,31,1400794525,1400795081,2,11,556
50038815@N08,6579,30,1400795081,1400796161,5,11,1080
50038815@N08,6579,20,1400798069,1400798609,2,11,540
50038815@N08,6579,31,1400801356,1400801434,2,11,78
50038815@N08,6579,29,1400801434,1400802334,5,11,900
50038815@N08,6579,26,1400809267,1400810167,2,11,900
50045612@N03,6580,11,1288476577,1288476817,3,4,240
50045612@N03,6580,10,1288484267,1288484507,2,4,240
50045612@N03,6580,11,1288489083,1288489323,2,4,240
50045612@N03,6580,10,1288489410,1288489650,1,4,240
50069634@N06,6581,12,1340086574,1340086814,1,1,240
50145710@N05,6582,1,1323224006,1323224066,2,14,60
50145710@N05,6582,17,1323226722,1323227022,6,14,300
50145710@N05,6582,15,1323232385,1323232655,12,14,270
50145710@N05,6582,17,1323234293,1323234593,4,14,300
50145710@N05,6582,26,1323235907,1323236129,3,14,222
50145710@N05,6582,19,1323236129,1323236669,39,14,540
50145710@N05,6582,20,1323240508,1323241048,5,14,540
50145710@N05,6582,22,1323243080,1323243532,2,14,452
50145710@N05,6582,29,1323243532,1323244432,2,14,900
50145710@N05,6582,9,1323245195,1323245375,14,14,180
50145710@N05,6582,4,1323246987,1323247088,3,14,101
50145710@N05,6582,25,1323248879,1323249719,4,14,840
50145710@N05,6582,26,1323249730,1323250630,3,14,900
50145710@N05,6582,28,1323252255,1323253155,1,14,900
50198110@N00,6583,24,1297947600,1297947602,3,5,2
50198110@N00,6583,26,1297947602,1297947619,16,5,17
50198110@N00,6583,12,1297947619,1297947620,2,5,1
50198110@N00,6583,30,1297947620,1297947622,3,5,2
50198110@N00,6583,12,1297947622,1297947862,2,5,240
50267281@N07,6584,26,1372836719,1372837619,23,1,900
50267281@N07,6585,26,1372938915,1372939815,4,1,900
50267281@N07,6586,26,1372976970,1372977870,2,1,900
50267281@N07,6587,23,1429062894,1429063494,1,1,600
50267281@N07,6588,27,1429397896,1429398796,1,1,900
50267281@N07,6589,26,1431648590,1431649490,1,1,900
50267281@N07,6590,18,1437133340,1437133790,1,1,450
50267281@N07,6591,18,1442618213,1442618663,3,2,450
50267281@N07,6591,26,1442618794,1442619694,1,2,900
50267281@N07,6592,18,1442696000,1442696450,1,1,450
50267281@N07,6593,18,1442842197,1442842647,1,1,450
50267281@N07,6594,26,1448435892,1448436792,60,10,900
50267281@N07,6594,15,1448438920,1448438924,2,10,4
50267281@N07,6594,26,1448438924,1448438946,2,10,22
50267281@N07,6594,15,1448438946,1448438964,2,10,18
50267281@N07,6594,26,1448438964,1448439864,27,10,900
50267281@N07,6594,18,1448444847,1448445297,2,10,450
50267281@N07,6594,26,1448445402,1448446302,2,10,900
50267281@N07,6594,18,1448447059,1448447509,2,10,450
50267281@N07,6594,26,1448449365,1448450265,4,10,900
50267281@N07,6594,18,1448453053,1448453503,2,10,450
50267281@N07,6595,26,1448486900,1448487800,5,3,900
50267281@N07,6595,18,1448496912,1448497362,2,3,450
50267281@N07,6595,15,1448497596,1448497866,1,3,270
50267281@N07,6596,26,1448538445,1448539345,1,1,900
50267281@N07,6597,18,1448973571,1448974021,1,1,450
50267281@N07,6598,18,1449146161,1449146611,1,1,450
50267281@N07,6599,18,1449405855,1449406305,1,1,450
50267281@N07,6600,18,1449664857,1449665307,1,1,450
50267281@N07,6601,26,1452921064,1452921964,46,1,900
50267281@N07,6602,18,1452971032,1452971482,2,7,450
50267281@N07,6602,17,1452972283,1452972386,2,7,103
50267281@N07,6602,15,1452972386,1452972561,2,7,175
50267281@N07,6602,21,1452972561,1452972642,2,7,81
50267281@N07,6602,11,1452972642,1452972882,2,7,240
50267281@N07,6602,26,1452973049,1452973167,2,7,118
50267281@N07,6602,3,1452973167,1452973257,1,7,90
50267281@N07,6603,26,1453021754,1453022654,6,1,900
50267281@N07,6604,26,1459419414,1459420314,6,1,900
50267281@N07,6605,26,1459496232,1459497132,55,1,900
50325355@N00,6606,28,1261521448,1261521652,3,4,204
50325355@N00,6606,26,1261521652,1261522552,2,4,900
50325355@N00,6606,6,1261523590,1261523710,3,4,120
50325355@N00,6606,28,1261549344,1261550244,18,4,900
50325355@N00,6607,29,1288141797,1288141892,5,3,95
50325355@N00,6607,11,1288141892,1288141902,2,3,10
50325355@N00,6607,24,1288141902,1288142682,1,3,780
50325355@N00,6608,26,1322347570,1322348470,1,1,900
50325355@N00,6609,21,1333072748,1333073318,1,1,570
50367867@N07,6610,28,1351228871,1351229771,1,1,900
50367867@N07,6611,28,1351287422,1351288322,13,1,900
50367867@N07,6612,28,1351374151,1351375051,2,1,900
50369536@N00,6613,18,1448597512,1448597962,1,1,450
50401006@N08,6614,23,1277960494,1277961094,1,1,600
50401006@N08,6615,29,1278263878,1278263903,3,5,25
50401006@N08,6615,10,1278263903,1278264143,2,5,240
50401006@N08,6615,29,1278287466,1278287475,2,5,9
50401006@N08,6615,27,1278287475,1278287476,2,5,1
50401006@N08,6615,26,1278287476,1278288376,1,5,900
50401006@N08,6616,29,1284887492,1284888392,1,1,900
50448800@N00,6617,26,1364899681,1364900581,1,1,900
50461115@N07,6618,26,1352607142,1352608042,1,1,900
50461532@N03,6619,30,1331986884,1331987964,2,1,1080
50461532@N03,6620,29,1350721948,1350722848,1,1,900
50461532@N03,6621,26,1351074629,1351075529,1,1,900
50461532@N03,6622,1,1366267393,1366267453,2,1,60
50461532@N03,6623,30,1367735355,1367736435,1,1,1080
50500517@N03,6624,1,1275996026,1275996086,1,1,60
50500517@N03,6625,1,1276140604,1276140664,2,5,60
50500517@N03,6625,18,1276140962,1276141214,2,5,252
50500517@N03,6625,28,1276141214,1276141408,2,5,194
50500517@N03,6625,12,1276141408,1276141507,2,5,99
50500517@N03,6625,16,1276141507,1276141777,1,5,270
50507957@N04,6626,17,1376263552,1376263852,2,2,300
50507957@N04,6626,23,1376271783,1376272383,1,2,600
50507957@N04,6627,16,1376397637,1376397907,1,1,270
50514859@N00,6628,24,1229940684,1229941464,1,1,780
50514859@N00,6629,20,1230196401,1230196941,1,1,540
50519631@N03,6630,28,1314926467,1314927367,1,1,900
50576036@N00,6631,21,1361067082,1361067652,1,1,570
50576036@N00,6632,1,1380937249,1380937309,1,1,60
50576036@N00,6633,7,1397878782,1397878962,1,1,180
50616872@N07,6634,18,1441197446,1441197896,4,3,450
50616872@N07,6634,3,1441198553,1441198643,2,3,90
50616872@N07,6634,28,1441198893,1441199793,1,3,900
50616872@N07,6635,4,1441235194,1441235295,1,1,101
50616872@N07,6636,23,1441283774,1441284374,1,1,600
50631360@N00,6637,30,1340770797,1340771877,1,1,1080
50637361@N07,6638,26,1335995500,1335996400,2,4,900
50637361@N07,6638,15,1336000257,1336000527,21,4,270
50637361@N07,6638,16,1336013126,1336013396,2,4,270
50637361@N07,6638,26,1336021352,1336022252,1,4,900
50637361@N07,6639,11,1336109916,1336110156,2,2,240
50637361@N07,6639,12,1336114777,1336115017,1,2,240
50643397@N00,6640,18,1422095142,1422095592,1,1,450
50657579@N06,6641,18,1423689206,1423689656,2,1,450
50661799@N02,6642,1,1394583053,1394583113,3,10,60
50661799@N02,6642,16,1394583369,1394583639,2,10,270
50661799@N02,6642,27,1394586048,1394586948,2,10,900
50661799@N02,6642,15,1394589616,1394589678,2,10,62
50661799@N02,6642,27,1394589678,1394590027,2,10,349
50661799@N02,6642,15,1394590027,1394590297,2,10,270
50661799@N02,6642,18,1394600260,1394600619,2,10,359
50661799@N02,6642,26,1394600619,1394601519,2,10,900
50661799@N02,6642,27,1394602396,1394603296,3,10,900
50661799@N02,6642,17,1394603328,1394603628,1,10,300
50661799@N02,6643,16,1395102530,1395102800,4,3,270
50661799@N02,6643,24,1395106401,1395107181,4,3,780
50661799@N02,6643,16,1395119970,1395120240,3,3,270
50661799@N02,6644,17,1429502041,1429502270,10,17,229
50661799@N02,6644,15,1429502270,1429502540,16,17,270
50661799@N02,6644,17,1429502560,1429502737,11,17,177
50661799@N02,6644,15,1429502737,1429502776,4,17,39
50661799@N02,6644,17,1429502776,1429502792,2,17,16
50661799@N02,6644,15,1429502792,1429502799,2,17,7
50661799@N02,6644,17,1429502799,1429503099,168,17,300
50661799@N02,6644,27,1429507243,1429507361,8,17,118
50661799@N02,6644,17,1429507361,1429507661,6,17,300
50661799@N02,6644,27,1429507867,1429507926,6,17,59
50661799@N02,6644,17,1429507926,1429507981,5,17,55
50661799@N02,6644,27,1429507981,1429508074,4,17,93
50661799@N02,6644,17,1429508074,1429508374,23,17,300
50661799@N02,6644,15,1429517597,1429517867,2,17,270
50661799@N02,6644,17,1429519201,1429519501,3,17,300
50661799@N02,6644,27,1429521525,1429522425,2,17,900
50661799@N02,6644,17,1429524664,1429524964,2,17,300
50679218@N00,6645,1,1371787532,1371787577,2,3,45
50679218@N00,6645,17,1371787577,1371787877,2,3,300
50679218@N00,6645,26,1371806561,1371807461,1,3,900
50728651@N04,6646,1,1427626509,1427626569,1,1,60
50730281@N03,6647,29,1330340199,1330340503,3,2,304
50730281@N03,6647,30,1330340503,1330341583,2,2,1080
50742523@N05,6648,1,1308203642,1308203702,1,1,60
50751757@N00,6649,4,1279664734,1279664835,28,46,101
50751757@N00,6649,7,1279665208,1279665388,21,46,180
50751757@N00,6649,25,1279666944,1279667784,2,46,840
50751757@N00,6649,13,1279668163,1279668403,20,46,240
50751757@N00,6649,24,1279672141,1279672584,14,46,443
50751757@N00,6649,12,1279672584,1279672824,2,46,240
50751757@N00,6649,30,1279673207,1279674287,7,46,1080
50751757@N00,6649,25,1279675195,1279676035,8,46,840
50751757@N00,6649,20,1279676125,1279676665,12,46,540
50751757@N00,6649,30,1279681704,1279682081,8,46,377
50751757@N00,6649,10,1279682081,1279682113,2,46,32
50751757@N00,6649,30,1279682113,1279683193,50,46,1080
50751757@N00,6649,31,1279683232,1279683813,10,46,581
50751757@N00,6649,10,1279683813,1279683994,12,46,181
50751757@N00,6649,31,1279683994,1279684119,7,46,125
50751757@N00,6649,10,1279684119,1279684150,2,46,31
50751757@N00,6649,31,1279684150,1279684449,10,46,299
50751757@N00,6649,10,1279684449,1279684477,3,46,28
50751757@N00,6649,31,1279684477,1279684615,6,46,138
50751757@N00,6649,10,1279684615,1279684855,9,46,240
50751757@N00,6649,30,1279685621,1279685822,5,46,201
50751757@N00,6649,26,1279685822,1279686032,3,46,210
50751757@N00,6649,30,1279686032,1279687112,64,46,1080
50751757@N00,6649,19,1279687816,1279688356,31,46,540
50751757@N00,6649,13,1279688924,1279689164,22,46,240
50751757@N00,6649,29,1279695512,1279696412,5,46,900
50751757@N00,6649,21,1279696765,1279697010,2,46,245
50751757@N00,6649,29,1279697010,1279697192,3,46,182
50751757@N00,6649,21,1279697192,1279697762,32,46,570
50751757@N00,6649,17,1279698248,1279698548,2,46,300
50751757@N00,6649,16,1279698573,1279698706,8,46,133
50751757@N00,6649,17,1279698706,1279698712,2,46,6
50751757@N00,6649,16,1279698712,1279698982,12,46,270
50751757@N00,6649,27,1279700123,1279701023,6,46,900
50751757@N00,6649,12,1279702553,1279702598,2,46,45
50751757@N00,6649,24,1279702598,1279703314,11,46,716
50751757@N00,6649,12,1279703314,1279703554,10,46,240
50751757@N00,6649,26,1279703904,1279704278,7,46,374
50751757@N00,6649,21,1279704278,1279704848,5,46,570
50751757@N00,6649,4,1279706363,1279706464,3,46,101
50751757@N00,6649,13,1279706477,1279706681,11,46,204
50751757@N00,6649,25,1279706681,1279706693,2,46,12
50751757@N00,6649,4,1279706693,1279706794,108,46,101
50751757@N00,6649,26,1279709610,1279710059,2,46,449
50751757@N00,6649,28,1279710059,1279710456,3,46,397
50751757@N00,6649,1,1279710456,1279710516,3,46,60
50751757@N00,6650,13,1279753884,1279754124,1,1,240
50751757@N00,6651,26,1279791890,1279792790,81,2,900
50751757@N00,6651,1,1279799430,1279799490,2,2,60
50751757@N00,6652,28,1280021347,1280022247,91,1,900
50753774@N00,6653,29,1385538003,1385538903,4,1,900
50753774@N00,6654,29,1385638961,1385639861,1,1,900
50755881@N08,6655,17,1326665258,1326665558,5,4,300
50755881@N08,6655,27,1326665682,1326665717,2,4,35
50755881@N08,6655,17,1326665717,1326666017,3,4,300
50755881@N08,6655,11,1326666112,1326666352,1,4,240
50776394@N00,6656,15,1388138947,1388139217,2,2,270
50776394@N00,6656,7,1388140698,1388140878,1,2,180
50892381@N00,6657,4,1290655618,1290655719,1,1,101
50903038@N00,6658,1,1276763071,1276763131,2,6,60
50903038@N00,6658,28,1276764693,1276765065,5,6,372
50903038@N00,6658,26,1276765065,1276765965,3,6,900
50903038@N00,6658,30,1276767275,1276768355,3,6,1080
50903038@N00,6658,24,1276768605,1276768825,2,6,220
50903038@N00,6658,21,1276768825,1276769395,2,6,570
50972822@N08,6659,1,1388262364,1388262424,2,9,60
50972822@N08,6659,26,1388263249,1388263259,2,9,10
50972822@N08,6659,16,1388263259,1388263529,5,9,270
50972822@N08,6659,11,1388266468,1388266708,3,9,240
50972822@N08,6659,31,1388269335,1388269340,2,9,5
50972822@N08,6659,16,1388269340,1388269610,3,9,270
50972822@N08,6659,11,1388269817,1388270057,2,9,240
50972822@N08,6659,29,1388271095,1388271995,2,9,900
50972822@N08,6659,31,1388273339,1388274839,1,9,1500
50972822@N08,6660,31,1388360184,1388361684,2,2,1500
50972822@N08,6660,18,1388361726,1388362176,2,2,450
50972822@N08,6661,28,1388433642,1388433782,5,10,140
50972822@N08,6661,26,1388433782,1388434682,3,10,900
50972822@N08,6661,16,1388435057,1388435327,3,10,270
50972822@N08,6661,21,1388436617,1388436684,2,10,67
50972822@N08,6661,25,1388436684,1388437456,13,10,772
50972822@N08,6661,13,1388437456,1388437696,2,10,240
50972822@N08,6661,9,1388439539,1388439719,3,10,180
50972822@N08,6661,16,1388442224,1388442494,2,10,270
50972822@N08,6661,5,1388443906,1388444026,2,10,120
50972822@N08,6661,13,1388444368,1388444608,1,10,240
50972822@N08,6662,26,1388478883,1388479783,5,1,900
50979393@N00,6663,17,1345848612,1345848912,2,6,300
50979393@N00,6663,18,1345852144,1345852594,2,6,450
50979393@N00,6663,20,1345856260,1345856800,2,6,540
50979393@N00,6663,19,1345859106,1345859646,2,6,540
50979393@N00,6663,24,1345887083,1345887863,2,6,780
50979393@N00,6663,26,1345896000,1345896900,1,6,900
50979393@N00,6664,26,1345941223,1345942123,1,1,900
50980974@N07,6665,30,1276068596,1276069676,1,1,1080
51007277@N08,6666,1,1403347950,1403348010,1,1,60
51021602@N00,6667,11,1267059365,1267059605,1,1,240
51035569202@N01,6668,11,1273383347,1273383587,1,1,240
51035597937@N01,6669,19,1266796917,1266797457,1,1,540
51035602679@N01,6670,26,1356304526,1356305426,1,1,900
51035602679@N01,6671,26,1356346496,1356347396,1,1,900
51035620553@N01,6672,26,1270211005,1270211905,38,1,900
51035626656@N01,6673,29,1252326901,1252327801,32,1,900
51035626656@N01,6674,29,1252497497,1252497882,5,4,385
51035626656@N01,6674,20,1252497882,1252498422,7,4,540
51035626656@N01,6674,31,1252498636,1252499095,3,4,459
51035626656@N01,6674,20,1252499095,1252499635,9,4,540
51035708949@N01,6675,28,1211928335,1211928497,5,13,162
51035708949@N01,6675,16,1211928497,1211928582,2,13,85
51035708949@N01,6675,8,1211928582,1211928762,2,13,180
51035708949@N01,6675,24,1211930539,1211931319,8,13,780
51035708949@N01,6675,12,1211932735,1211932855,6,13,120
51035708949@N01,6675,24,1211932855,1211933635,7,13,780
51035708949@N01,6675,21,1211936575,1211936766,2,13,191
51035708949@N01,6675,24,1211936766,1211937546,4,13,780
51035708949@N01,6675,28,1211953969,1211954215,5,13,246
51035708949@N01,6675,16,1211954215,1211954485,2,13,270
51035708949@N01,6675,17,1211957075,1211957375,5,13,300
51035708949@N01,6675,29,1211961500,1211962400,2,13,900
51035708949@N01,6675,24,1211971499,1211972279,6,13,780
51035708949@N01,6676,28,1395260311,1395261211,2,8,900
51035708949@N01,6676,17,1395261758,1395262058,2,8,300
51035708949@N01,6676,26,1395263422,1395264322,5,8,900
51035708949@N01,6676,19,1395266973,1395267513,9,8,540
51035708949@N01,6676,18,1395269271,1395269721,7,8,450
51035708949@N01,6676,29,1395271325,1395272225,2,8,900
51035708949@N01,6676,24,1395279768,1395280548,2,8,780
51035708949@N01,6676,6,1395283169,1395283289,2,8,120
51035708949@N01,6677,22,1395354005,1395354605,7,8,600
51035708949@N01,6677,17,1395375838,1395376138,3,8,300
51035708949@N01,6677,24,1395376908,1395377688,31,8,780
51035708949@N01,6677,21,1395378358,1395378928,2,8,570
51035708949@N01,6677,13,1395379284,1395379524,13,8,240
51035708949@N01,6677,21,1395382475,1395383045,3,8,570
51035708949@N01,6677,29,1395384430,1395385330,3,8,900
51035708949@N01,6677,28,1395387829,1395388729,5,8,900
51035722899@N01,6678,28,1351383954,1351384854,1,1,900
51035730365@N01,6679,29,1252729021,1252729921,1,1,900
51035734911@N01,6680,28,1245207232,1245208132,2,1,900
51035737861@N01,6681,6,1191653529,1191653649,4,6,120
51035737861@N01,6681,8,1191654068,1191654248,4,6,180
51035737861@N01,6681,21,1191656247,1191656817,13,6,570
51035737861@N01,6681,6,1191659400,1191659520,4,6,120
51035737861@N01,6681,17,1191667190,1191667490,3,6,300
51035737861@N01,6681,26,1191668983,1191669883,4,6,900
51035737861@N01,6682,12,1191747188,1191747428,3,2,240
51035737861@N01,6682,28,1191748126,1191749026,5,2,900
51035738424@N01,6683,17,1334582375,1334582675,2,4,300
51035738424@N01,6683,24,1334582842,1334583622,2,4,780
51035738424@N01,6683,16,1334588071,1334588134,2,4,63
51035738424@N01,6683,18,1334588134,1334588584,1,4,450
51035747872@N01,6684,28,1348036945,1348037845,1,1,900
51035767733@N01,6685,13,1269482429,1269482669,2,3,240
51035767733@N01,6685,27,1269487144,1269488044,2,3,900
51035767733@N01,6685,26,1269499863,1269500763,1,3,900
51037533@N00,6686,26,1341735185,1341735508,2,2,323
51037533@N00,6686,23,1341735508,1341736108,1,2,600
51037533@N00,6687,17,1342600665,1342600965,2,2,300
51037533@N00,6687,19,1342602029,1342602569,1,2,540
51037533@N00,6688,29,1344157507,1344158407,2,2,900
51037533@N00,6688,28,1344166256,1344167156,1,2,900
51037533@N00,6689,30,1372999933,1373001013,1,1,1080
51037533@N00,6690,17,1373184537,1373184837,1,1,300
51037533@N00,6691,26,1416661012,1416661912,1,1,900
51037533@N00,6692,26,1432334037,1432334937,2,1,900
51061791@N08,6693,28,1419459941,1419460280,2,2,339
51061791@N08,6693,26,1419460280,1419461180,2,2,900
51061791@N08,6694,26,1419492639,1419493539,2,1,900
51064846@N07,6695,15,1405497661,1405497931,6,2,270
51064846@N07,6695,13,1405501229,1405501469,1,2,240
51064846@N07,6696,26,1441085702,1441086602,3,2,900
51064846@N07,6696,31,1441096702,1441098202,1,2,1500
51074282@N08,6697,26,1298173915,1298174815,16,1,900
51074282@N08,6698,26,1298373816,1298374716,1,1,900
51075626@N00,6699,16,1401719232,1401719502,3,1,270
51075626@N00,6700,19,1408508299,1408508839,1,1,540
51075626@N00,6701,19,1409582315,1409582855,2,1,540
51075626@N00,6702,19,1410532537,1410533077,2,1,540
51075626@N00,6703,18,1422418864,1422419314,3,1,450
51075626@N00,6704,18,1433045008,1433045458,3,1,450
51075626@N00,6705,18,1434363386,1434363836,1,1,450
51075626@N00,6706,18,1445383406,1445383856,1,1,450
51087250@N05,6707,17,1357179852,1357180152,2,2,300
51087250@N05,6707,1,1357188884,1357188944,2,2,60
51098012@N02,6708,26,1357715741,1357716641,1,1,900
51098012@N02,6709,31,1388299060,1388300560,1,1,1500
51151458@N02,6710,1,1382696732,1382696792,1,1,60
51172115@N00,6711,8,1366932077,1366932257,2,5,180
51172115@N00,6711,13,1366937246,1366937486,2,5,240
51172115@N00,6711,1,1366951838,1366951898,2,5,60
51172115@N00,6711,16,1366953455,1366953725,2,5,270
51172115@N00,6711,26,1366955876,1366956776,1,5,900
51172115@N00,6712,1,1367103799,1367103859,2,2,60
51172115@N00,6712,28,1367106366,1367107266,2,2,900
51172115@N00,6713,22,1367198294,1367198894,2,2,600
51172115@N00,6713,1,1367205875,1367205935,1,2,60
51178640@N00,6714,16,1453760342,1453760345,2,7,3
51178640@N00,6714,26,1453760345,1453760356,2,7,11
51178640@N00,6714,16,1453760356,1453760472,3,7,116
51178640@N00,6714,17,1453760472,1453760772,3,7,300
51178640@N00,6714,15,1453765308,1453765578,8,7,270
51178640@N00,6714,17,1453768077,1453768377,3,7,300
51178640@N00,6714,27,1453768856,1453769756,1,7,900
51205683@N00,6715,16,1297324166,1297324436,1,1,270
51205683@N00,6716,28,1297464044,1297464944,2,2,900
51205683@N00,6716,4,1297468020,1297468121,1,2,101
51205683@N00,6717,26,1361243584,1361244484,2,1,900
51208828@N00,6718,20,1311123426,1311123966,2,5,540
51208828@N00,6718,14,1311125664,1311125904,2,5,240
51208828@N00,6718,29,1311130841,1311131741,2,5,900
51208828@N00,6718,26,1311132838,1311133738,2,5,900
51208828@N00,6718,27,1311139305,1311140205,3,5,900
51311897@N00,6719,14,1295264167,1295264407,1,1,240
51311897@N00,6720,28,1362268327,1362269227,9,10,900
51311897@N00,6720,1,1362270336,1362270344,3,10,8
51311897@N00,6720,28,1362270344,1362271244,8,10,900
51311897@N00,6720,23,1362271706,1362271872,4,10,166
51311897@N00,6720,18,1362271872,1362272322,7,10,450
51311897@N00,6720,16,1362274474,1362274546,2,10,72
51311897@N00,6720,26,1362274546,1362275446,5,10,900
51311897@N00,6720,16,1362283950,1362284219,18,10,269
51311897@N00,6720,28,1362284219,1362285119,13,10,900
51311897@N00,6720,1,1362293624,1362293684,2,10,60
51311897@N00,6721,1,1362872658,1362872718,7,2,60
51311897@N00,6721,27,1362878002,1362878902,2,2,900
51311897@N00,6722,16,1363914393,1363914663,24,1,270
51311897@N00,6723,30,1365325176,1365325946,2,2,770
51311897@N00,6723,16,1365325946,1365326216,4,2,270
51311897@N00,6724,26,1369616675,1369617575,3,9,900
51311897@N00,6724,4,1369618704,1369618805,2,9,101
51311897@N00,6724,28,1369618912,1369619812,3,9,900
51311897@N00,6724,26,1369620745,1369621645,2,9,900
51311897@N00,6724,23,1369623066,1369623666,3,9,600
51311897@N00,6724,26,1369627591,1369628491,7,9,900
51311897@N00,6724,15,1369628772,1369629042,9,9,270
51311897@N00,6724,21,1369631249,1369631819,3,9,570
51311897@N00,6724,1,1369632466,1369632526,2,9,60
51311897@N00,6725,16,1377404194,1377404464,3,5,270
51311897@N00,6725,7,1377414753,1377414933,17,5,180
51311897@N00,6725,6,1377415176,1377415296,8,5,120
51311897@N00,6725,21,1377415571,1377416026,24,5,455
51311897@N00,6725,5,1377416026,1377416146,4,5,120
51311897@N00,6726,1,1399180830,1399180890,5,2,60
51311897@N00,6726,30,1399183362,1399184442,4,2,1080
51311897@N00,6727,7,1402635008,1402635188,9,4,180
51311897@N00,6727,15,1402638564,1402638834,4,4,270
51311897@N00,6727,27,1402638987,1402639887,2,4,900
51311897@N00,6727,29,1402650823,1402651723,30,4,900
51311897@N00,6728,29,1406251353,1406252253,2,7,900
51311897@N00,6728,31,1406252525,1406254025,14,7,1500
51311897@N00,6728,14,1406255633,1406255873,7,7,240
51311897@N00,6728,22,1406256438,1406257038,3,7,600
51311897@N00,6728,27,1406262049,1406262949,2,7,900
51311897@N00,6728,15,1406263963,1406264233,4,7,270
51311897@N00,6728,13,1406276458,1406276698,3,7,240
51311897@N00,6729,28,1409300086,1409300986,8,1,900
51311897@N00,6730,15,1411799992,1411800262,22,2,270
51311897@N00,6730,27,1411802014,1411802914,1,2,900
51311897@N00,6731,24,1414205595,1414206375,5,2,780
51311897@N00,6731,11,1414211638,1414211878,5,2,240
51311897@N00,6732,16,1417826162,1417826432,12,2,270
51311897@N00,6732,10,1417826666,1417826906,7,2,240
51311897@N00,6733,28,1418809033,1418809511,4,3,478
51311897@N00,6733,26,1418809511,1418809958,18,3,447
51311897@N00,6733,21,1418809958,1418810528,2,3,570
51311897@N00,6734,27,1425780585,1425781485,3,1,900
51311897@N00,6735,4,1448239330,1448239431,3,6,101
51311897@N00,6735,13,1448243151,1448243391,12,6,240
51311897@N00,6735,26,1448258237,1448259137,2,6,900
51311897@N00,6735,16,1448259199,1448259469,2,6,270
51311897@N00,6735,27,1448264125,1448265025,2,6,900
51311897@N00,6735,16,1448266044,1448266314,8,6,270
51311897@N00,6736,28,1449969564,1449970464,3,2,900
51311897@N00,6736,14,1449980019,1449980259,19,2,240
51311897@N00,6737,15,1457762842,1457763112,33,3,270
51311897@N00,6737,27,1457765468,1457765500,3,3,32
51311897@N00,6737,15,1457765500,1457765770,24,3,270
51337479@N00,6738,26,1395909176,1395910076,1,1,900
51390829@N07,6739,28,1317590885,1317591114,4,19,229
51390829@N07,6739,26,1317591114,1317591159,2,19,45
51390829@N07,6739,16,1317591159,1317591174,2,19,15
51390829@N07,6739,26,1317591174,1317591401,9,19,227
51390829@N07,6739,23,1317591401,1317592001,2,19,600
51390829@N07,6739,20,1317593407,1317593947,8,19,540
51390829@N07,6739,22,1317594202,1317594802,6,19,600
51390829@N07,6739,30,1317594894,1317594903,2,19,9
51390829@N07,6739,22,1317594903,1317595270,2,19,367
51390829@N07,6739,30,1317595270,1317595990,3,19,720
51390829@N07,6739,7,1317595990,1317596081,3,19,91
51390829@N07,6739,21,1317596081,1317596651,2,19,570
51390829@N07,6739,17,1317597072,1317597372,3,19,300
51390829@N07,6739,26,1317616975,1317617368,3,19,393
51390829@N07,6739,6,1317617368,1317617479,3,19,111
51390829@N07,6739,7,1317617479,1317617659,4,19,180
51390829@N07,6739,13,1317618088,1317618328,5,19,240
51390829@N07,6739,21,1317618688,1317619258,2,19,570
51390829@N07,6739,20,1317619373,1317619913,11,19,540
51390829@N07,6740,28,1317768196,1317769096,1,1,900
51390829@N07,6741,26,1317802615,1317802857,2,2,242
51390829@N07,6741,28,1317802857,1317803757,2,2,900
51427230@N02,6742,1,1284015074,1284015134,4,15,60
51427230@N02,6742,28,1284015305,1284015606,2,15,301
51427230@N02,6742,16,1284015606,1284015876,4,15,270
51427230@N02,6742,27,1284016156,1284017056,2,15,900
51427230@N02,6742,5,1284017349,1284017469,3,15,120
51427230@N02,6742,11,1284017630,1284017635,2,15,5
51427230@N02,6742,31,1284017635,1284019135,2,15,1500
51427230@N02,6742,20,1284020904,1284021272,3,15,368
51427230@N02,6742,31,1284021272,1284021392,3,15,120
51427230@N02,6742,22,1284021392,1284021992,5,15,600
51427230@N02,6742,14,1284022142,1284022339,2,15,197
51427230@N02,6742,22,1284022339,1284022499,2,15,160
51427230@N02,6742,19,1284022499,1284022523,2,15,24
51427230@N02,6742,31,1284022523,1284023851,4,15,1328
51427230@N02,6742,28,1284023851,1284024751,2,15,900
51427230@N02,6743,27,1284082162,1284082969,2,17,807
51427230@N02,6743,1,1284082969,1284083029,3,17,60
51427230@N02,6743,26,1284083550,1284083659,3,17,109
51427230@N02,6743,16,1284083659,1284083929,3,17,270
51427230@N02,6743,18,1284098002,1284098452,11,17,450
51427230@N02,6743,29,1284099570,1284100470,4,17,900
51427230@N02,6743,1,1284116125,1284116185,6,17,60
51427230@N02,6743,28,1284116881,1284117589,3,17,708
51427230@N02,6743,16,1284117589,1284117859,5,17,270
51427230@N02,6743,26,1284119188,1284119811,2,17,623
51427230@N02,6743,6,1284119811,1284119931,2,17,120
51427230@N02,6743,16,1284120146,1284120416,7,17,270
51427230@N02,6743,25,1284121771,1284121901,2,17,130
51427230@N02,6743,13,1284121901,1284122141,2,17,240
51427230@N02,6743,1,1284123010,1284123070,3,17,60
51427230@N02,6743,30,1284123850,1284124930,3,17,1080
51427230@N02,6743,4,1284126293,1284126394,1,17,101
51427230@N02,6744,13,1284174784,1284175024,7,13,240
51427230@N02,6744,11,1284176671,1284176911,2,13,240
51427230@N02,6744,31,1284177130,1284178630,3,13,1500
51427230@N02,6744,30,1284183248,1284184328,2,13,1080
51427230@N02,6744,22,1284186114,1284186714,2,13,600
51427230@N02,6744,6,1284196509,1284196629,6,13,120
51427230@N02,6744,13,1284197487,1284197524,2,13,37
51427230@N02,6744,7,1284197524,1284197593,2,13,69
51427230@N02,6744,6,1284197593,1284197713,3,13,120
51427230@N02,6744,7,1284197849,1284198029,2,13,180
51427230@N02,6744,21,1284199167,1284199737,4,13,570
51427230@N02,6744,13,1284200248,1284200488,21,13,240
51427230@N02,6744,24,1284202509,1284203289,3,13,780
51427230@N02,6745,19,1284260754,1284261294,5,4,540
51427230@N02,6745,12,1284267987,1284268205,2,4,218
51427230@N02,6745,24,1284268205,1284268985,4,4,780
51427230@N02,6745,16,1284286590,1284286860,3,4,270
51427230@N02,6746,31,1284351779,1284353279,3,2,1500
51427230@N02,6746,12,1284358797,1284359037,1,2,240
51446703@N00,6747,1,1393976827,1393976887,2,14,60
51446703@N00,6747,26,1393978338,1393979238,7,14,900
51446703@N00,6747,4,1393984928,1393985029,2,14,101
51446703@N00,6747,3,1393986625,1393986715,2,14,90
51446703@N00,6747,4,1393988624,1393988660,2,14,36
51446703@N00,6747,11,1393988660,1393988900,2,14,240
51446703@N00,6747,25,1393990096,1393990502,2,14,406
51446703@N00,6747,13,1393990502,1393990742,3,14,240
51446703@N00,6747,26,1393995638,1393996538,2,14,900
51446703@N00,6747,18,1393999051,1393999501,2,14,450
51446703@N00,6747,19,1394000223,1394000763,4,14,540
51446703@N00,6747,20,1394000946,1394001486,2,14,540
51446703@N00,6747,29,1394003865,1394004765,2,14,900
51446703@N00,6747,28,1394007532,1394008432,4,14,900
51544832@N06,6748,26,1356818788,1356819688,51,1,900
51559287@N04,6749,29,1298781528,1298782428,2,1,900
51559287@N04,6750,29,1301198702,1301199602,3,6,900
51559287@N04,6750,6,1301203373,1301203493,3,6,120
51559287@N04,6750,22,1301203770,1301204370,7,6,600
51559287@N04,6750,6,1301208618,1301208738,2,6,120
51559287@N04,6750,28,1301210715,1301210767,5,6,52
51559287@N04,6750,8,1301210767,1301210947,6,6,180
51565923@N00,6751,26,1245495278,1245496178,1,1,900
51565923@N00,6752,31,1248114331,1248115831,1,1,1500
51579041@N00,6753,15,1246588066,1246588336,1,1,270
51585012@N06,6754,15,1370225717,1370225987,3,5,270
51585012@N06,6754,12,1370227888,1370228128,2,5,240
51585012@N06,6754,13,1370228474,1370228714,2,5,240
51585012@N06,6754,26,1370235671,1370236571,2,5,900
51585012@N06,6754,28,1370247643,1370248543,1,5,900
51588699@N00,6755,26,1228026805,1228027705,1,1,900
51588699@N00,6756,28,1228217262,1228218162,1,1,900
51588699@N00,6757,28,1228309772,1228310672,1,1,900
51588699@N00,6758,15,1243213522,1243213792,1,1,270
51588699@N00,6759,7,1318636179,1318636359,2,2,180
51588699@N00,6759,24,1318652020,1318652800,1,2,780
51588699@N00,6760,29,1319451062,1319451962,1,1,900
51588699@N00,6761,13,1322096870,1322097110,1,1,240
51588699@N00,6762,4,1322951372,1322951473,2,2,101
51588699@N00,6762,25,1322953836,1322954676,1,2,840
51588699@N00,6763,7,1346501448,1346501628,1,1,180
51588699@N00,6764,8,1347071717,1347071897,1,1,180
51588699@N00,6765,27,1368284279,1368285179,1,1,900
51588699@N00,6766,25,1370658163,1370659003,1,1,840
51588699@N00,6767,1,1371263259,1371263319,1,1,60
51588699@N00,6768,23,1371952076,1371952676,1,1,600
51588699@N00,6769,19,1372894855,1372895395,1,1,540
51588699@N00,6770,29,1373797736,1373798636,1,1,900
51588699@N00,6771,29,1377576456,1377577356,1,1,900
51588699@N00,6772,17,1399702324,1399702593,2,2,269
51588699@N00,6772,27,1399702593,1399703493,1,2,900
51594114@N04,6773,26,1336899093,1336899271,3,5,178
51594114@N04,6773,28,1336899271,1336899289,2,5,18
51594114@N04,6773,26,1336899289,1336900189,2,5,900
51594114@N04,6773,30,1336900987,1336901094,2,5,107
51594114@N04,6773,1,1336901094,1336901154,1,5,60
51652132@N04,6774,1,1391320017,1391320077,2,9,60
51652132@N04,6774,26,1391320524,1391321424,2,9,900
51652132@N04,6774,13,1391322491,1391322731,3,9,240
51652132@N04,6774,19,1391328170,1391328710,5,9,540
51652132@N04,6774,18,1391330142,1391330592,2,9,450
51652132@N04,6774,29,1391332331,1391333231,3,9,900
51652132@N04,6774,30,1391334068,1391335148,73,9,1080
51652132@N04,6774,28,1391339892,1391340792,2,9,900
51652132@N04,6774,1,1391342080,1391342140,1,9,60
51652132@N04,6775,29,1423700609,1423701509,7,5,900
51652132@N04,6775,20,1423707879,1423708419,2,5,540
51652132@N04,6775,19,1423709243,1423709783,2,5,540
51652132@N04,6775,29,1423710505,1423711405,7,5,900
51652132@N04,6775,10,1423717743,1423717983,5,5,240
51652132@N04,6776,28,1423780491,1423781391,2,4,900
51652132@N04,6776,29,1423785065,1423785965,8,4,900
51652132@N04,6776,15,1423797792,1423798062,4,4,270
51652132@N04,6776,24,1423799606,1423800386,1,4,780
51652132@N04,6777,28,1423967751,1423967971,2,9,220
51652132@N04,6777,1,1423967971,1423968031,2,9,60
51652132@N04,6777,26,1423968446,1423969346,2,9,900
51652132@N04,6777,29,1423971099,1423971999,3,9,900
51652132@N04,6777,15,1423973196,1423973466,4,9,270
51652132@N04,6777,12,1423974399,1423974639,2,9,240
51652132@N04,6777,23,1423975686,1423976286,8,9,600
51652132@N04,6777,26,1423976879,1423977779,2,9,900
51652132@N04,6777,29,1423981684,1423982584,6,9,900
51652132@N04,6778,1,1446059108,1446059168,2,14,60
51652132@N04,6778,17,1446066740,1446067040,2,14,300
51652132@N04,6778,20,1446070135,1446070675,2,14,540
51652132@N04,6778,22,1446071122,1446071722,4,14,600
51652132@N04,6778,13,1446099078,1446099318,4,14,240
51652132@N04,6778,31,1446100850,1446102350,3,14,1500
51652132@N04,6778,29,1446104730,1446105359,6,14,629
51652132@N04,6778,30,1446105359,1446105506,5,14,147
51652132@N04,6778,29,1446105506,1446106406,12,14,900
51652132@N04,6778,17,1446106659,1446106800,3,14,141
51652132@N04,6778,26,1446106800,1446106917,3,14,117
51652132@N04,6778,16,1446106917,1446107187,61,14,270
51652132@N04,6778,26,1446112119,1446113019,4,14,900
51652132@N04,6778,28,1446114078,1446114978,1,14,900
51652132@N04,6779,28,1446255160,1446256060,4,2,900
51652132@N04,6779,1,1446260974,1446261034,28,2,60
51652132@N04,6780,20,1446331906,1446332446,7,7,540
51652132@N04,6780,22,1446349110,1446349710,3,7,600
51652132@N04,6780,29,1446377180,1446377260,4,7,80
51652132@N04,6780,10,1446377260,1446377500,2,7,240
51652132@N04,6780,20,1446381284,1446381824,7,7,540
51652132@N04,6780,26,1446381883,1446382154,5,7,271
51652132@N04,6780,28,1446382154,1446383054,2,7,900
51652132@N04,6781,1,1446603607,1446603667,2,1,60
51779105@N04,6782,17,1419319075,1419319375,1,1,300
51824734@N04,6783,28,1364077887,1364078787,2,10,900
51824734@N04,6783,29,1364084063,1364084963,2,10,900
51824734@N04,6783,17,1364085662,1364085962,2,10,300
51824734@N04,6783,15,1364086017,1364086210,2,10,193
51824734@N04,6783,14,1364086210,1364086347,2,10,137
51824734@N04,6783,20,1364086347,1364086529,2,10,182
51824734@N04,6783,19,1364086529,1364086916,2,10,387
51824734@N04,6783,27,1364086916,1364087816,2,10,900
51824734@N04,6783,15,1364087830,1364088100,3,10,270
51824734@N04,6783,12,1364089630,1364089870,1,10,240
51845296@N02,6784,1,1370758642,1370758702,1,1,60
51881015@N02,6785,1,1278578055,1278578115,5,1,60
51881015@N02,6786,1,1283548493,1283548553,1,1,60
51881015@N02,6787,1,1304062000,1304062060,1,1,60
51881015@N02,6788,1,1316932567,1316932627,2,1,60
51903736@N00,6789,28,1272903890,1272904542,5,23,652
51903736@N00,6789,23,1272904542,1272905129,3,23,587
51903736@N00,6789,30,1272905129,1272905329,7,23,200
51903736@N00,6789,29,1272905329,1272906229,35,23,900
51903736@N00,6789,20,1272907103,1272907643,21,23,540
51903736@N00,6789,22,1272908404,1272908582,6,23,178
51903736@N00,6789,14,1272908582,1272908822,15,23,240
51903736@N00,6789,13,1272910227,1272910467,2,23,240
51903736@N00,6789,1,1272910712,1272910772,11,23,60
51903736@N00,6789,16,1272917819,1272918087,3,23,268
51903736@N00,6789,27,1272918087,1272918122,2,23,35
51903736@N00,6789,16,1272918122,1272918392,3,23,270
51903736@N00,6789,12,1272919944,1272920184,2,23,240
51903736@N00,6789,13,1272921561,1272921801,2,23,240
51903736@N00,6789,6,1272924922,1272925042,3,23,120
51903736@N00,6789,5,1272925130,1272925250,4,23,120
51903736@N00,6789,6,1272925484,1272925604,5,23,120
51903736@N00,6789,11,1272927213,1272927388,4,23,175
51903736@N00,6789,21,1272927388,1272927420,2,23,32
51903736@N00,6789,11,1272927420,1272927660,6,23,240
51903736@N00,6789,8,1272928131,1272928147,2,23,16
51903736@N00,6789,26,1272928147,1272928312,3,23,165
51903736@N00,6789,28,1272928312,1272929212,1,23,900
51903736@N00,6790,24,1272982688,1272983468,13,22,780
51903736@N00,6790,27,1272985046,1272985946,4,22,900
51903736@N00,6790,30,1272990268,1272991348,2,22,1080
51903736@N00,6790,28,1273003996,1273004896,2,22,900
51903736@N00,6790,13,1273008734,1273008974,2,22,240
51903736@N00,6790,15,1273009132,1273009402,5,22,270
51903736@N00,6790,12,1273009435,1273009675,14,22,240
51903736@N00,6790,25,1273011035,1273011875,55,22,840
51903736@N00,6790,4,1273012217,1273012275,3,22,58
51903736@N00,6790,3,1273012275,1273012365,5,22,90
51903736@N00,6790,11,1273012368,1273012438,2,22,70
51903736@N00,6790,10,1273012438,1273012581,5,22,143
51903736@N00,6790,31,1273012581,1273012843,7,22,262
51903736@N00,6790,30,1273012843,1273013243,2,22,400
51903736@N00,6790,29,1273013243,1273014143,11,22,900
51903736@N00,6790,14,1273014336,1273014576,3,22,240
51903736@N00,6790,20,1273015340,1273015585,2,22,245
51903736@N00,6790,29,1273015585,1273016174,3,22,589
51903736@N00,6790,26,1273016174,1273016250,4,22,76
51903736@N00,6790,16,1273016250,1273016520,2,22,270
51903736@N00,6790,28,1273018058,1273018300,3,22,242
51903736@N00,6790,1,1273018300,1273018360,1,22,60
51903736@N00,6791,1,1273090660,1273090720,2,1,60
51903736@N00,6792,13,1273154402,1273154642,9,2,240
51903736@N00,6792,28,1273162515,1273163415,45,2,900
51903736@N00,6793,20,1273237116,1273237656,4,11,540
51903736@N00,6793,14,1273242395,1273242635,15,11,240
51903736@N00,6793,31,1273247284,1273247877,4,11,593
51903736@N00,6793,30,1273247877,1273248899,4,11,1022
51903736@N00,6793,22,1273248899,1273249499,3,11,600
51903736@N00,6793,28,1273255977,1273256877,36,11,900
51903736@N00,6793,24,1273260945,1273261725,13,11,780
51903736@N00,6793,12,1273262909,1273263010,3,11,101
51903736@N00,6793,24,1273263010,1273263148,2,11,138
51903736@N00,6793,21,1273263148,1273263718,2,11,570
51903736@N00,6793,13,1273263756,1273263996,3,11,240
51940058@N06,6794,13,1417194725,1417194965,1,1,240
51968610@N05,6795,30,1231116245,1231117325,2,3,1080
51968610@N05,6795,14,1231119525,1231119765,2,3,240
51968610@N05,6795,29,1231120045,1231120945,1,3,900
51968610@N05,6796,30,1231653664,1231654744,1,1,1080
51968610@N05,6797,20,1235960199,1235960739,1,1,540
51968610@N05,6798,16,1241310192,1241310192,2,3,0
51968610@N05,6798,22,1241310192,1241310192,2,3,0
51968610@N05,6798,29,1241310192,1241311092,1,3,900
51968610@N05,6799,26,1281932744,1281933644,1,1,900
51983948@N03,6800,31,1344058989,1344060489,1,1,1500
52015062@N00,6801,17,1204091947,1204092247,32,2,300
52015062@N00,6801,28,1204096896,1204097796,3,2,900
52015062@N00,6802,16,1325495580,1325495850,2,6,270
52015062@N00,6802,27,1325496333,1325497233,4,6,900
52015062@N00,6802,15,1325497881,1325497904,2,6,23
52015062@N00,6802,17,1325497904,1325498204,3,6,300
52015062@N00,6802,16,1325498353,1325498623,6,6,270
52015062@N00,6802,26,1325503757,1325504657,2,6,900
52015062@N00,6803,16,1357103102,1357103372,3,3,270
52015062@N00,6803,25,1357113231,1357114071,2,3,840
52015062@N00,6803,15,1357120330,1357120600,1,3,270
52018940@N02,6804,3,1222699049,1222699139,2,4,90
52018940@N02,6804,7,1222699389,1222699569,2,4,180
52018940@N02,6804,29,1222705183,1222706083,2,4,900
52018940@N02,6804,17,1222707974,1222708274,1,4,300
52018940@N02,6805,26,1251388716,1251389163,3,2,447
52018940@N02,6805,28,1251389163,1251390063,1,2,900
52029589@N02,6806,1,1363453786,1363453846,1,1,60
52111728@N00,6807,26,1438209250,1438210150,2,1,900
52111728@N00,6808,28,1438254420,1438255320,12,2,900
52111728@N00,6808,26,1438257440,1438258340,1,2,900
52111728@N00,6809,17,1461886051,1461886351,1,1,300
52179512@N00,6810,24,1219447334,1219448114,3,2,780
52179512@N00,6810,12,1219448293,1219448533,1,2,240
52192784@N08,6811,11,1284777353,1284777593,83,1,240
52192784@N08,6812,1,1443223397,1443223457,2,5,60
52192784@N08,6812,12,1443231204,1443231444,3,5,240
52192784@N08,6812,3,1443232111,1443232201,2,5,90
52192784@N08,6812,26,1443232830,1443233730,2,5,900
52192784@N08,6812,21,1443254967,1443255537,1,5,570
52227056@N03,6813,17,1381898632,1381898932,1,1,300
52230032@N08,6814,1,1309785831,1309785891,1,1,60
52230032@N08,6815,26,1310301547,1310302447,1,1,900
52245071@N00,6816,28,1348224789,1348225689,2,2,900
52245071@N00,6816,26,1348227872,1348228772,1,2,900
52257090@N00,6817,26,1239669735,1239670635,13,3,900
52257090@N00,6817,17,1239675935,1239676235,2,3,300
52257090@N00,6817,26,1239676316,1239677216,28,3,900
52378595@N06,6818,26,1295751655,1295752555,1,1,900
52378595@N06,6819,7,1295792211,1295792317,2,5,106
52378595@N06,6819,6,1295792317,1295792437,2,5,120
52378595@N06,6819,11,1295792491,1295792731,2,5,240
52378595@N06,6819,26,1295793842,1295794497,4,5,655
52378595@N06,6819,16,1295794497,1295794767,1,5,270
52389201@N07,6820,7,1356507656,1356507836,1,1,180
52418815@N05,6821,28,1375789835,1375790735,2,2,900
52418815@N05,6821,8,1375796150,1375796330,1,2,180
52443338@N05,6822,26,1451258545,1451259445,7,1,900
52447507@N06,6823,20,1415167227,1415167767,1,1,540
52447507@N06,6824,19,1415223694,1415224234,2,7,540
52447507@N06,6824,17,1415226494,1415226794,2,7,300
52447507@N06,6824,5,1415230767,1415230887,2,7,120
52447507@N06,6824,30,1415236186,1415237266,2,7,1080
52447507@N06,6824,17,1415242814,1415243114,2,7,300
52447507@N06,6824,28,1415254511,1415255411,3,7,900
52447507@N06,6824,26,1415256097,1415256997,1,7,900
52447507@N06,6825,1,1415311014,1415311074,2,2,60
52447507@N06,6825,17,1415313354,1415313654,1,2,300
52496627@N03,6826,16,1364020750,1364021020,2,2,270
52496627@N03,6826,18,1364024605,1364025055,1,2,450
52571731@N05,6827,30,1356151341,1356152421,2,3,1080
52571731@N05,6827,26,1356170963,1356171863,2,3,900
52571731@N05,6827,21,1356175905,1356176475,2,3,570
52571731@N05,6828,26,1388186964,1388187864,5,10,900
52571731@N05,6828,30,1388188262,1388189342,2,10,1080
52571731@N05,6828,11,1388193543,1388193783,2,10,240
52571731@N05,6828,26,1388193894,1388194794,3,10,900
52571731@N05,6828,16,1388195591,1388195861,3,10,270
52571731@N05,6828,24,1388199427,1388200207,2,10,780
52571731@N05,6828,16,1388200354,1388200624,2,10,270
52571731@N05,6828,13,1388202702,1388202942,3,10,240
52571731@N05,6828,12,1388224276,1388224516,2,10,240
52571731@N05,6828,13,1388225429,1388225669,1,10,240
52572912@N06,6829,17,1279949394,1279949694,2,3,300
52572912@N06,6829,3,1279970475,1279970565,2,3,90
52572912@N06,6829,28,1279979751,1279980651,1,3,900
52582799@N00,6830,25,1317637349,1317638189,1,1,840
52592482@N03,6831,19,1408259733,1408260273,2,1,540
52615621@N07,6832,4,1467686316,1467686417,2,11,101
52615621@N07,6832,27,1467687185,1467687198,2,11,13
52615621@N07,6832,16,1467687198,1467687216,2,11,18
52615621@N07,6832,27,1467687216,1467688116,10,11,900
52615621@N07,6832,15,1467690785,1467691055,4,11,270
52615621@N07,6832,24,1467694506,1467695286,21,11,780
52615621@N07,6832,25,1467709444,1467710284,3,11,840
52615621@N07,6832,17,1467711103,1467711403,9,11,300
52615621@N07,6832,29,1467718862,1467719762,2,11,900
52615621@N07,6832,26,1467721581,1467722481,6,11,900
52615621@N07,6832,28,1467723157,1467724057,6,11,900
52615621@N07,6833,26,1467842212,1467842481,3,6,269
52615621@N07,6833,1,1467842481,1467842541,2,6,60
52615621@N07,6833,26,1467858200,1467859100,6,6,900
52615621@N07,6833,8,1467861020,1467861200,2,6,180
52615621@N07,6833,26,1467861510,1467861748,3,6,238
52615621@N07,6833,28,1467861748,1467862648,1,6,900
52650694@N06,6834,17,1326767086,1326767386,1,1,300
52654544@N00,6835,19,1197777651,1197778191,3,1,540
52654544@N00,6836,29,1197844759,1197844897,6,5,138
52654544@N00,6836,20,1197844897,1197845437,2,5,540
52654544@N00,6836,30,1197845931,1197846049,2,5,118
52654544@N00,6836,6,1197846049,1197846169,6,5,120
52654544@N00,6836,30,1197849680,1197850760,3,5,1080
52654544@N00,6837,22,1211067818,1211068084,3,11,266
52654544@N00,6837,14,1211068084,1211068263,3,11,179
52654544@N00,6837,22,1211068263,1211068618,2,11,355
52654544@N00,6837,14,1211068618,1211068858,5,11,240
52654544@N00,6837,31,1211070995,1211071198,3,11,203
52654544@N00,6837,19,1211071198,1211071326,2,11,128
52654544@N00,6837,29,1211071326,1211072155,3,11,829
52654544@N00,6837,30,1211072155,1211073235,2,11,1080
52654544@N00,6837,8,1211073756,1211073936,2,11,180
52654544@N00,6837,3,1211077226,1211077316,2,11,90
52654544@N00,6837,29,1211080915,1211081815,1,11,900
52654544@N00,6838,19,1211152484,1211153024,2,1,540
52654544@N00,6839,19,1227415634,1227416174,1,1,540
52654544@N00,6840,19,1227575791,1227576331,10,1,540
52656863@N03,6841,18,1456778607,1456779057,1,1,450
52658090@N06,6842,6,1357380476,1357380596,2,2,120
52658090@N06,6842,28,1357380950,1357381850,1,2,900
52666614@N06,6843,15,1331808093,1331808363,1,1,270
52744036@N06,6844,18,1260760762,1260761212,5,3,450
52744036@N06,6844,22,1260769611,1260770211,11,3,600
52744036@N06,6844,18,1260772305,1260772755,4,3,450
52744036@N06,6845,18,1323311554,1323312004,63,3,450
52744036@N06,6845,29,1323316136,1323317036,37,3,900
52744036@N06,6845,18,1323332501,1323332951,1,3,450
52744036@N06,6846,18,1325058868,1325059318,1,1,450
52744036@N06,6847,18,1325761740,1325762190,2,1,450
52744036@N06,6848,18,1325852429,1325852879,2,1,450
52744036@N06,6849,18,1325901164,1325901614,1,1,450
52812594@N00,6850,13,1320914338,1320914578,1,1,240
52812594@N00,6851,17,1335657239,1335657539,1,1,300
52812594@N00,6852,26,1358551259,1358551266,2,2,7
52812594@N00,6852,17,1358551266,1358551566,2,2,300
52821721@N00,6853,29,1321228651,1321229551,1,1,900
52835300@N00,6854,28,1420777931,1420778831,1,1,900
52892088@N02,6855,21,1353988702,1353989272,2,4,570
52892088@N02,6855,26,1354013559,1354013635,2,4,76
52892088@N02,6855,28,1354013635,1354014535,2,4,900
52892088@N02,6855,29,1354015941,1354016841,1,4,900
52892088@N02,6856,20,1354172854,1354173394,2,2,540
52892088@N02,6856,28,1354178744,1354179644,1,2,900
52892088@N02,6857,20,1354270869,1354271409,2,2,540
52892088@N02,6857,29,1354271825,1354272725,1,2,900
52892088@N02,6858,1,1356307665,1356307725,1,1,60
52931120@N05,6859,28,1293361351,1293362251,1,1,900
52931120@N05,6860,28,1324806439,1324807339,1,1,900
52931120@N05,6861,16,1324895498,1324895768,2,4,270
52931120@N05,6861,26,1324905770,1324906137,2,4,367
52931120@N05,6861,16,1324906137,1324906407,2,4,270
52931120@N05,6861,26,1324906929,1324907829,1,4,900
52931120@N05,6862,29,1324986013,1324986913,1,1,900
52931120@N05,6863,16,1356517828,1356518098,2,2,270
52931120@N05,6863,26,1356529268,1356530168,1,2,900
52931120@N05,6864,27,1356777946,1356778423,2,2,477
52931120@N05,6864,28,1356778423,1356779323,1,2,900
52931120@N05,6865,24,1419861400,1419862180,1,1,780
53054066@N02,6866,26,1404570795,1404571695,1,1,900
53079384@N06,6867,16,1431843003,1431843273,2,5,270
53079384@N06,6867,24,1431845015,1431845795,3,5,780
53079384@N06,6867,15,1431848862,1431849132,3,5,270
53079384@N06,6867,12,1431851480,1431851720,2,5,240
53079384@N06,6867,21,1431860247,1431860817,7,5,570
53079384@N06,6868,28,1432007987,1432008887,1,1,900
53139290@N08,6869,29,1330108774,1330109674,28,2,900
53139290@N08,6869,28,1330116551,1330117451,31,2,900
53139290@N08,6870,13,1330179201,1330179441,18,2,240
53139290@N08,6870,29,1330193292,1330194192,18,2,900
53139290@N08,6871,27,1330265044,1330265944,8,6,900
53139290@N08,6871,1,1330269441,1330269501,3,6,60
53139290@N08,6871,26,1330275727,1330276627,36,6,900
53139290@N08,6871,29,1330278910,1330279810,7,6,900
53139290@N08,6871,16,1330285804,1330286074,4,6,270
53139290@N08,6871,28,1330294555,1330295455,76,6,900
53144287@N08,6872,27,1349061339,1349062239,1,1,900
53144287@N08,6873,16,1349180636,1349180906,1,1,270
53144287@N08,6874,27,1369729246,1369730146,1,1,900
53144287@N08,6875,18,1449889914,1449890364,1,1,450
53210986@N08,6876,19,1414746169,1414746709,1,1,540
53237949@N00,6877,28,1325033520,1325034420,1,1,900
53348255@N06,6878,26,1334538110,1334539010,1,1,900
53348255@N06,6879,29,1334648459,1334649359,1,1,900
53365974@N00,6880,1,1351306450,1351306500,2,25,50
53365974@N00,6880,28,1351306500,1351307045,7,25,545
53365974@N00,6880,23,1351307045,1351307135,2,25,90
53365974@N00,6880,29,1351307135,1351308035,4,25,900
53365974@N00,6880,23,1351308720,1351308863,2,25,143
53365974@N00,6880,30,1351308863,1351308932,3,25,69
53365974@N00,6880,23,1351308932,1351309071,2,25,139
53365974@N00,6880,30,1351309071,1351309082,2,25,11
53365974@N00,6880,31,1351309082,1351309222,2,25,140
53365974@N00,6880,11,1351309222,1351309462,3,25,240
53365974@N00,6880,21,1351310326,1351310340,2,25,14
53365974@N00,6880,28,1351310340,1351310439,2,25,99
53365974@N00,6880,8,1351310439,1351310476,2,25,37
53365974@N00,6880,12,1351310476,1351310716,2,25,240
53365974@N00,6880,24,1351310749,1351311529,3,25,780
53365974@N00,6880,17,1351314000,1351314300,3,25,300
53365974@N00,6880,27,1351315660,1351315839,4,25,179
53365974@N00,6880,16,1351315839,1351316109,2,25,270
53365974@N00,6880,26,1351317411,1351317426,2,25,15
53365974@N00,6880,16,1351317426,1351317696,2,25,270
53365974@N00,6880,20,1351318096,1351318142,2,25,46
53365974@N00,6880,31,1351318142,1351318250,2,25,108
53365974@N00,6880,20,1351318250,1351318790,4,25,540
53365974@N00,6880,18,1351319661,1351320111,2,25,450
53365974@N00,6880,1,1351320293,1351320353,4,25,60
53365974@N00,6881,1,1391225969,1391226029,3,8,60
53365974@N00,6881,29,1391226664,1391227564,2,8,900
53365974@N00,6881,20,1391228062,1391228602,2,8,540
53365974@N00,6881,1,1391239229,1391239289,6,8,60
53365974@N00,6881,23,1391241624,1391242224,3,8,600
53365974@N00,6881,26,1391244232,1391244687,2,8,455
53365974@N00,6881,3,1391244687,1391244777,2,8,90
53365974@N00,6881,28,1391245439,1391246339,2,8,900
53365974@N00,6882,28,1426374576,1426375476,2,8,900
53365974@N00,6882,26,1426377092,1426377992,7,8,900
53365974@N00,6882,30,1426378852,1426379324,2,8,472
53365974@N00,6882,20,1426379324,1426379864,2,8,540
53365974@N00,6882,29,1426385750,1426386650,4,8,900
53365974@N00,6882,4,1426392043,1426392144,2,8,101
53365974@N00,6882,5,1426392148,1426392268,2,8,120
53365974@N00,6882,26,1426392550,1426393450,2,8,900
53412049@N03,6883,28,1363228838,1363229738,2,2,900
53412049@N03,6883,15,1363253070,1363253340,1,2,270
53416084@N02,6884,1,1369318668,1369318728,1,1,60
53463927@N05,6885,3,1279182931,1279183021,1,1,90
53484449@N00,6886,17,1311398324,1311398624,1,1,300
53493629@N00,6887,16,1321425517,1321425787,1,1,270
53500976@N04,6888,28,1349568403,1349569303,1,1,900
53529949@N02,6889,18,1287389105,1287389555,1,1,450
53529949@N02,6890,18,1291701660,1291702110,1,1,450
53530069@N02,6891,18,1453895472,1453895922,1,1,450
53536543@N06,6892,1,1286485071,1286485131,2,35,60
53536543@N06,6892,19,1286486258,1286486798,2,35,540
53536543@N06,6892,29,1286486810,1286487710,3,35,900
53536543@N06,6892,10,1286487990,1286488230,5,35,240
53536543@N06,6892,12,1286489699,1286489939,4,35,240
53536543@N06,6892,31,1286495680,1286495684,2,35,4
53536543@N06,6892,20,1286495684,1286495688,2,35,4
53536543@N06,6892,22,1286495688,1286496288,2,35,600
53536543@N06,6892,29,1286496538,1286497438,2,35,900
53536543@N06,6892,19,1286498176,1286498716,4,35,540
53536543@N06,6892,31,1286500566,1286500935,2,35,369
53536543@N06,6892,19,1286500935,1286501475,2,35,540
53536543@N06,6892,7,1286503073,1286503253,4,35,180
53536543@N06,6892,13,1286504480,1286504720,4,35,240
53536543@N06,6892,4,1286505660,1286505761,6,35,101
53536543@N06,6892,3,1286507994,1286508084,3,35,90
53536543@N06,6892,10,1286509335,1286509575,2,35,240
53536543@N06,6892,29,1286511965,1286512136,2,35,171
53536543@N06,6892,10,1286512136,1286512376,4,35,240
53536543@N06,6892,30,1286513088,1286513790,2,35,702
53536543@N06,6892,31,1286513790,1286514524,3,35,734
53536543@N06,6892,4,1286514524,1286514625,3,35,101
53536543@N06,6892,17,1286515632,1286515922,3,35,290
53536543@N06,6892,24,1286515922,1286516702,3,35,780
53536543@N06,6892,17,1286517130,1286517430,9,35,300
53536543@N06,6892,19,1286522771,1286523311,8,35,540
53536543@N06,6892,28,1286524524,1286524867,4,35,343
53536543@N06,6892,19,1286524867,1286525407,2,35,540
53536543@N06,6892,22,1286526856,1286527456,3,35,600
53536543@N06,6892,3,1286533598,1286533688,2,35,90
53536543@N06,6892,10,1286533979,1286534219,6,35,240
53536543@N06,6892,4,1286539849,1286539950,3,35,101
53536543@N06,6892,24,1286541064,1286541844,2,35,780
53536543@N06,6892,17,1286546892,1286547192,3,35,300
53536543@N06,6892,27,1286548719,1286549619,2,35,900
53536543@N06,6893,1,1286611840,1286611900,2,1,60
53610434@N07,6894,28,1255227479,1255227881,8,22,402
53610434@N07,6894,31,1255227881,1255228505,2,22,624
53610434@N07,6894,28,1255228505,1255229405,3,22,900
53610434@N07,6894,24,1255232873,1255232887,2,22,14
53610434@N07,6894,12,1255232887,1255233061,3,22,174
53610434@N07,6894,22,1255233061,1255233075,2,22,14
53610434@N07,6894,26,1255233075,1255233596,3,22,521
53610434@N07,6894,23,1255233596,1255234196,7,22,600
53610434@N07,6894,31,1255235554,1255235576,3,22,22
53610434@N07,6894,22,1255235576,1255235602,3,22,26
53610434@N07,6894,31,1255235602,1255235735,8,22,133
53610434@N07,6894,30,1255235735,1255235814,2,22,79
53610434@N07,6894,31,1255235814,1255235823,2,22,9
53610434@N07,6894,29,1255235823,1255236723,5,22,900
53610434@N07,6894,31,1255238048,1255238268,3,22,220
53610434@N07,6894,29,1255238268,1255238321,4,22,53
53610434@N07,6894,31,1255238321,1255239821,43,22,1500
53610434@N07,6894,20,1255240229,1255240769,25,22,540
53610434@N07,6894,9,1255244740,1255244907,3,22,167
53610434@N07,6894,26,1255244907,1255245118,7,22,211
53610434@N07,6894,28,1255245118,1255245492,7,22,374
53610434@N07,6894,1,1255245492,1255245552,1,22,60
53610434@N07,6895,27,1379225812,1379226712,1,1,900
53610434@N07,6896,27,1422757461,1422757592,2,2,131
53610434@N07,6896,23,1422757592,1422758192,1,2,600
53610434@N07,6897,22,1435730530,1435730950,2,2,420
53610434@N07,6897,12,1435730950,1435731190,1,2,240
53611294@N00,6898,16,1212487542,1212487812,1,1,270
53611868@N00,6899,3,1310686500,1310686590,2,2,90
53611868@N00,6899,13,1310691139,1310691379,1,2,240
53632001@N02,6900,7,1363083826,1363084006,1,1,180
53687491@N00,6901,26,1199277699,1199278599,1,1,900
53687491@N00,6902,26,1199330642,1199331542,2,6,900
53687491@N00,6902,11,1199331910,1199332150,2,6,240
53687491@N00,6902,13,1199332286,1199332526,5,6,240
53687491@N00,6902,16,1199333866,1199334136,2,6,270
53687491@N00,6902,30,1199336467,1199337547,4,6,1080
53687491@N00,6902,28,1199339541,1199340441,12,6,900
53687491@N00,6903,18,1205621810,1205622260,3,3,450
53687491@N00,6903,30,1205628392,1205629472,2,3,1080
53687491@N00,6903,23,1205629666,1205630266,2,3,600
53687766@N00,6904,25,1262849743,1262850583,1,1,840
53687766@N00,6905,31,1444196363,1444197863,2,1,1500
53697195@N05,6906,1,1283170297,1283170357,2,2,60
53697195@N05,6906,11,1283178209,1283178449,1,2,240
53697195@N05,6907,18,1283214908,1283214916,2,16,8
53697195@N05,6907,29,1283214916,1283215816,5,16,900
53697195@N05,6907,10,1283221117,1283221357,2,16,240
53697195@N05,6907,21,1283223464,1283223469,2,16,5
53697195@N05,6907,4,1283223469,1283223517,3,16,48
53697195@N05,6907,11,1283223517,1283223757,2,16,240
53697195@N05,6907,10,1283224032,1283224272,5,16,240
53697195@N05,6907,25,1283224523,1283225363,8,16,840
53697195@N05,6907,13,1283226032,1283226272,10,16,240
53697195@N05,6907,24,1283230285,1283231065,3,16,780
53697195@N05,6907,17,1283232372,1283232528,3,16,156
53697195@N05,6907,27,1283232528,1283233428,2,16,900
53697195@N05,6907,17,1283233630,1283233930,2,16,300
53697195@N05,6907,28,1283238387,1283239287,2,16,900
53697195@N05,6907,22,1283243931,1283244451,2,16,520
53697195@N05,6907,28,1283244451,1283245351,3,16,900
53697195@N05,6908,13,1284184672,1284184912,1,1,240
53825050@N06,6909,4,1300163969,1300164070,2,3,101
53825050@N06,6909,5,1300183007,1300183043,2,3,36
53825050@N06,6909,4,1300183043,1300183144,1,3,101
53856603@N00,6910,27,1346152580,1346153480,2,1,900
53856603@N00,6911,27,1352520573,1352521473,1,1,900
53856603@N00,6912,28,1358604700,1358604720,2,2,20
53856603@N00,6912,14,1358604720,1358604960,1,2,240
53856603@N00,6913,1,1378001618,1378001678,1,1,60
53879214@N03,6914,28,1379043030,1379043930,1,1,900
53879214@N03,6915,26,1386147774,1386148185,2,2,411
53879214@N03,6915,28,1386148185,1386149085,1,2,900
53879214@N03,6916,29,1386199849,1386200749,1,1,900
53936799@N05,6917,28,1367208367,1367209267,2,2,900
53936799@N05,6917,18,1367218477,1367218927,1,2,450
53936799@N05,6918,21,1367284624,1367285194,1,1,570
53936799@N05,6919,28,1367366412,1367367312,1,1,900
53951892@N03,6920,17,1345544462,1345544762,2,2,300
53951892@N03,6920,20,1345544854,1345545394,1,2,540
53951892@N03,6921,27,1345808020,1345808920,1,1,900
53978655@N00,6922,20,1364864297,1364864837,2,2,540
53978655@N00,6922,18,1364869291,1364869741,1,2,450
53978655@N00,6923,17,1364942140,1364942440,1,1,300
54023470@N03,6924,17,1343540622,1343540922,1,1,300
54055163@N00,6925,7,1226817529,1226817709,38,1,180
54058921@N00,6926,29,1335581364,1335582264,10,1,900
54074878@N00,6927,19,1407072168,1407072708,1,1,540
54083450@N00,6928,4,1229596476,1229596577,1,1,101
54096110@N07,6929,20,1393733397,1393733937,2,5,540
54096110@N07,6929,26,1393743978,1393744878,9,5,900
54096110@N07,6929,16,1393745421,1393745691,2,5,270
54096110@N07,6929,18,1393757186,1393757636,2,5,450
54096110@N07,6929,3,1393762708,1393762798,1,5,90
54096110@N07,6930,18,1393834759,1393835209,1,1,450
54177414@N00,6931,17,1363051242,1363051542,1,1,300
54181771@N02,6932,10,1268952053,1268952293,1,1,240
54199003@N00,6933,26,1354269225,1354270125,2,2,900
54199003@N00,6933,28,1354272082,1354272982,1,2,900
54279502@N00,6934,4,1285933782,1285933883,2,2,101
54279502@N00,6934,24,1285934198,1285934978,1,2,780
54279502@N00,6935,17,1286089029,1286089329,1,1,300
54333779@N00,6936,13,1298609437,1298609677,3,1,240
54333941@N00,6937,17,1329181650,1329181950,4,12,300
54333941@N00,6937,21,1329182330,1329182900,2,12,570
54333941@N00,6937,11,1329183275,1329183515,2,12,240
54333941@N00,6937,24,1329184199,1329184979,2,12,780
54333941@N00,6937,21,1329199430,1329200000,3,12,570
54333941@N00,6937,10,1329200227,1329200256,2,12,29
54333941@N00,6937,26,1329200256,1329201156,2,12,900
54333941@N00,6937,4,1329202611,1329202712,2,12,101
54333941@N00,6937,29,1329207049,1329207949,2,12,900
54333941@N00,6937,16,1329208891,1329209161,2,12,270
54333941@N00,6937,17,1329211753,1329212053,2,12,300
54333941@N00,6937,11,1329213287,1329213527,2,12,240
54373556@N05,6938,26,1375275946,1375276846,1,1,900
54391405@N00,6939,1,1250852240,1250852300,8,3,60
54391405@N00,6939,20,1250853225,1250853765,3,3,540
54391405@N00,6939,28,1250855876,1250856776,4,3,900
54448414@N03,6940,13,1292479197,1292479437,2,2,240
54448414@N03,6940,16,1292491600,1292491870,1,2,270
54567575@N00,6941,24,1361107830,1361108610,2,8,780
54567575@N00,6941,4,1361115941,1361116042,3,8,101
54567575@N00,6941,3,1361140557,1361140647,2,8,90
54567575@N00,6941,27,1361142750,1361143650,3,8,900
54567575@N00,6941,17,1361145604,1361145904,2,8,300
54567575@N00,6941,8,1361150265,1361150445,2,8,180
54567575@N00,6941,20,1361164821,1361165361,2,8,540
54567575@N00,6941,27,1361185772,1361186672,1,8,900
54567575@N00,6942,14,1361229903,1361230143,1,1,240
54567575@N00,6943,26,1361269205,1361270105,1,1,900
54573569@N05,6944,26,1456882521,1456883421,1,1,900
54586304@N00,6945,25,1350551017,1350551857,3,3,840
54586304@N00,6945,16,1350567818,1350568088,2,3,270
54586304@N00,6945,25,1350580893,1350581733,2,3,840
54594385@N04,6946,29,1250665570,1250666470,1,1,900
54594385@N04,6947,24,1308107099,1308107879,3,3,780
54594385@N04,6947,15,1308129956,1308130137,2,3,181
54594385@N04,6947,12,1308130137,1308130377,1,3,240
54594385@N04,6948,28,1308191913,1308192813,2,7,900
54594385@N04,6948,21,1308194804,1308195374,2,7,570
54594385@N04,6948,26,1308197092,1308197992,2,7,900
54594385@N04,6948,28,1308201768,1308202668,2,7,900
54594385@N04,6948,16,1308208828,1308209098,4,7,270
54594385@N04,6948,29,1308209495,1308210395,4,7,900
54594385@N04,6948,18,1308218646,1308219096,1,7,450
54594385@N04,6949,28,1350087894,1350088794,1,1,900
54608057@N02,6950,25,1358058511,1358059351,1,1,840
54608057@N02,6951,15,1379218418,1379218688,1,1,270
54668947@N00,6952,12,1344580997,1344581057,2,3,60
54668947@N00,6952,3,1344581057,1344581147,2,3,90
54668947@N00,6952,5,1344581982,1344582102,1,3,120
54674987@N00,6953,28,1416899097,1416899997,1,1,900
54674987@N00,6954,23,1426699016,1426699616,1,1,600
54674987@N00,6955,18,1434274721,1434275171,1,1,450
54688384@N00,6956,28,1195539531,1195540431,2,2,900
54688384@N00,6956,26,1195542132,1195543032,1,2,900
54688384@N00,6957,24,1196160094,1196160874,1,1,780
54688384@N00,6958,30,1196296535,1196296554,2,3,19
54688384@N00,6958,23,1196296554,1196297154,2,3,600
54688384@N00,6958,18,1196298731,1196299181,2,3,450
54688384@N00,6959,16,1196336248,1196336518,1,1,270
54688384@N00,6960,19,1196430278,1196430818,1,1,540
54688384@N00,6961,29,1197894033,1197894933,1,1,900
54688384@N00,6962,26,1200014090,1200014990,2,2,900
54688384@N00,6962,31,1200016657,1200018157,1,2,1500
54688384@N00,6963,28,1200800083,1200800220,2,2,137
54688384@N00,6963,18,1200800220,1200800670,1,2,450
54699140@N00,6964,28,1315224576,1315225476,1,1,900
54699140@N00,6965,28,1315268225,1315269125,8,1,900
54699140@N00,6966,28,1315464029,1315464929,15,1,900
54717162@N00,6967,26,1199851987,1199852887,34,1,900
54717162@N00,6968,26,1199927674,1199928574,45,1,900
54717162@N00,6969,26,1200365550,1200366450,28,1,900
54754394@N03,6970,26,1261430284,1261431184,3,1,900
54754394@N03,6971,26,1261524977,1261525877,1,1,900
54754394@N03,6972,26,1261591437,1261592337,9,1,900
54754394@N03,6973,26,1299253976,1299254876,112,1,900
54754394@N03,6974,26,1299609314,1299610214,26,1,900
54754394@N03,6975,26,1299777494,1299778394,142,1,900
54756230@N07,6976,28,1345178901,1345178973,2,2,72
54756230@N07,6976,18,1345178973,1345179423,1,2,450
54759987@N02,6977,26,1252300669,1252301569,29,1,900
54842330@N05,6978,28,1438031686,1438032586,3,1,900
54855264@N00,6979,19,1405829402,1405829942,1,1,540
54866014@N02,6980,18,1452412182,1452412632,1,1,450
54902025@N00,6981,18,1305690697,1305691147,2,4,450
54902025@N00,6981,29,1305692092,1305692992,2,4,900
54902025@N00,6981,22,1305695835,1305696435,2,4,600
54902025@N00,6981,29,1305719529,1305720429,1,4,900
54902025@N00,6982,1,1305779969,1305780029,2,5,60
54902025@N00,6982,20,1305786391,1305786931,3,5,540
54902025@N00,6982,29,1305792865,1305793765,4,5,900
54902025@N00,6982,19,1305799250,1305799790,2,5,540
54902025@N00,6982,17,1305803144,1305803444,3,5,300
54902025@N00,6983,3,1305907303,1305907393,2,5,90
54902025@N00,6983,16,1305907699,1305907969,3,5,270
54902025@N00,6983,23,1305908708,1305909012,2,5,304
54902025@N00,6983,18,1305909012,1305909462,2,5,450
54902025@N00,6983,19,1305910054,1305910594,1,5,540
54914189@N06,6984,28,1350173237,1350174137,1,1,900
54956677@N08,6985,1,1281602616,1281602676,2,4,60
54956677@N08,6985,28,1281613079,1281613979,3,4,900
54956677@N08,6985,15,1281616213,1281616483,2,4,270
54956677@N08,6985,28,1281621026,1281621926,1,4,900
54956677@N08,6986,11,1281669610,1281669850,2,7,240
54956677@N08,6986,12,1281670086,1281670326,2,7,240
54956677@N08,6986,1,1281672426,1281672486,2,7,60
54956677@N08,6986,13,1281674291,1281674531,2,7,240
54956677@N08,6986,24,1281675155,1281675935,2,7,780
54956677@N08,6986,26,1281689364,1281690264,2,7,900
54956677@N08,6986,10,1281696041,1281696281,1,7,240
54956677@N08,6987,28,1281943904,1281944804,2,1,900
55008715@N00,6988,1,1247524880,1247524940,2,6,60
55008715@N00,6988,22,1247541184,1247541784,6,6,600
55008715@N00,6988,13,1247557261,1247557501,2,6,240
55008715@N00,6988,19,1247562975,1247563355,4,6,380
55008715@N00,6988,23,1247563355,1247563955,2,6,600
55008715@N00,6988,28,1247572924,1247573824,1,6,900
55028731@N03,6989,28,1355798342,1355799242,2,2,900
55028731@N03,6989,1,1355801701,1355801761,1,2,60
55028731@N03,6990,1,1355881387,1355881447,2,3,60
55028731@N03,6990,28,1355890138,1355891038,3,3,900
55028731@N03,6990,18,1355899347,1355899797,1,3,450
55034659@N02,6991,16,1296819054,1296819324,1,1,270
55059112@N05,6992,26,1321760055,1321760955,1,1,900
55070214@N06,6993,28,1455413717,1455414617,4,22,900
55070214@N06,6993,16,1455414786,1455414922,2,22,136
55070214@N06,6993,26,1455414922,1455415706,3,22,784
55070214@N06,6993,29,1455415706,1455416431,4,22,725
55070214@N06,6993,26,1455416431,1455416636,10,22,205
55070214@N06,6993,16,1455416636,1455416906,5,22,270
55070214@N06,6993,15,1455417375,1455417645,11,22,270
55070214@N06,6993,27,1455422871,1455423124,4,22,253
55070214@N06,6993,15,1455423124,1455423161,4,22,37
55070214@N06,6993,17,1455423161,1455423461,2,22,300
55070214@N06,6993,20,1455433853,1455434393,4,22,540
55070214@N06,6993,26,1455436589,1455436792,3,22,203
55070214@N06,6993,27,1455436792,1455437544,3,22,752
55070214@N06,6993,11,1455437544,1455437784,3,22,240
55070214@N06,6993,21,1455437844,1455437906,2,22,62
55070214@N06,6993,13,1455437906,1455438146,5,22,240
55070214@N06,6993,1,1455451853,1455451913,10,22,60
55070214@N06,6993,26,1455455409,1455455533,3,22,124
55070214@N06,6993,6,1455455533,1455455647,4,22,114
55070214@N06,6993,7,1455455647,1455455739,2,22,92
55070214@N06,6993,4,1455455739,1455455840,2,22,101
55070214@N06,6993,11,1455456240,1455456480,1,22,240
55075594@N03,6994,26,1316242574,1316243474,1,1,900
55132698@N04,6995,10,1375337277,1375337517,2,1,240
55138121@N04,6996,29,1368181367,1368182267,34,1,900
55217458@N00,6997,23,1327730136,1327730736,1,1,600
55217458@N00,6998,28,1327792033,1327792933,1,1,900
55217458@N00,6999,26,1327833057,1327833957,1,1,900
55217458@N00,7000,26,1327907822,1327908722,1,1,900
55217458@N00,7001,27,1327968436,1327969336,2,7,900
55217458@N00,7001,29,1327980730,1327981630,2,7,900
55217458@N00,7001,20,1327990648,1327991188,2,7,540
55217458@N00,7001,13,1327992032,1327992105,2,7,73
55217458@N00,7001,20,1327992105,1327992177,2,7,72
55217458@N00,7001,18,1327992177,1327992261,2,7,84
55217458@N00,7001,28,1327992261,1327993161,1,7,900
55217458@N00,7002,7,1328095758,1328095938,2,2,180
55217458@N00,7002,3,1328097521,1328097611,1,2,90
55217458@N00,7003,14,1341808853,1341809093,1,1,240
55217458@N00,7004,28,1341967597,1341968497,1,1,900
55217458@N00,7005,28,1358587875,1358588775,1,1,900
55217458@N00,7006,28,1358633115,1358634015,2,1,900
55217458@N00,7007,29,1358713747,1358714647,4,5,900
55217458@N00,7007,30,1358742257,1358743337,2,5,1080
55217458@N00,7007,18,1358750743,1358750894,2,5,151
55217458@N00,7007,12,1358750894,1358751134,2,5,240
55217458@N00,7007,17,1358761110,1358761410,2,5,300
55217458@N00,7008,28,1358824053,1358824953,1,1,900
55217458@N00,7009,26,1377846022,1377846922,1,1,900
55217458@N00,7010,1,1377891760,1377891820,2,1,60
55217458@N00,7011,1,1378005831,1378005891,3,3,60
55217458@N00,7011,14,1378008091,1378008331,2,3,240
55217458@N00,7011,23,1378029287,1378029887,1,3,600
55217458@N00,7012,1,1378088888,1378088948,3,7,60
55217458@N00,7012,26,1378092831,1378093731,2,7,900
55217458@N00,7012,15,1378094295,1378094565,2,7,270
55217458@N00,7012,12,1378097177,1378097417,2,7,240
55217458@N00,7012,25,1378098696,1378099536,2,7,840
55217458@N00,7012,13,1378100194,1378100434,2,7,240
55217458@N00,7012,17,1378105906,1378106206,1,7,300
55217458@N00,7013,23,1378177512,1378178112,1,1,600
55217458@N00,7014,26,1389592459,1389593359,1,1,900
55217458@N00,7015,30,1389902645,1389902814,2,2,169
55217458@N00,7015,1,1389902814,1389902874,1,2,60
55217458@N00,7016,23,1389937959,1389938559,2,2,600
55217458@N00,7016,16,1389940616,1389940886,1,2,270
55217458@N00,7017,15,1390016505,1390016775,1,1,270
55217458@N00,7018,1,1390090029,1390090089,1,1,60
55217458@N00,7019,19,1409284953,1409285493,2,2,540
55217458@N00,7019,29,1409294696,1409295596,1,2,900
55217458@N00,7020,14,1416075952,1416076192,4,1,240
55217458@N00,7021,30,1416137581,1416138661,1,1,1080
55217458@N00,7022,17,1416178521,1416178821,1,1,300
55262458@N03,7023,28,1312453669,1312454569,1,1,900
55262458@N03,7024,1,1318745018,1318745078,1,1,60
55262458@N03,7025,20,1328171344,1328171884,1,1,540
55262458@N03,7026,28,1330497667,1330498567,1,1,900
55262458@N03,7027,26,1334283954,1334284854,1,1,900
55262458@N03,7028,1,1338005878,1338005938,1,1,60
55262458@N03,7029,28,1338711079,1338711979,1,1,900
55262458@N03,7030,1,1343374893,1343374953,1,1,60
55262458@N03,7031,29,1344139719,1344140619,1,1,900
55262458@N03,7032,4,1346390004,1346390105,1,1,101
55262458@N03,7033,28,1347966729,1347967629,1,1,900
55262458@N03,7034,17,1348787202,1348787502,1,1,300
55262458@N03,7035,26,1350335447,1350336347,1,1,900
55262458@N03,7036,18,1351383586,1351384036,1,1,450
55262458@N03,7037,28,1352646884,1352647784,1,1,900
55262458@N03,7038,26,1354095919,1354096819,1,1,900
55262458@N03,7039,1,1354693264,1354693324,1,1,60
55262458@N03,7040,21,1360898403,1360898973,2,2,570
55262458@N03,7040,14,1360901563,1360901803,1,2,240
55262458@N03,7041,6,1361445402,1361445522,1,1,120
55262458@N03,7042,26,1361653980,1361654880,1,1,900
55262458@N03,7043,19,1361758761,1361759280,2,2,519
55262458@N03,7043,23,1361759280,1361759880,1,2,600
55262458@N03,7044,29,1361873396,1361874296,2,3,900
55262458@N03,7044,26,1361875885,1361876711,2,3,826
55262458@N03,7044,28,1361876711,1361877611,1,3,900
55262458@N03,7045,26,1362648098,1362648998,1,1,900
55262458@N03,7046,26,1363990599,1363991499,2,1,900
55262458@N03,7047,26,1364683692,1364684592,1,1,900
55262458@N03,7048,28,1366961020,1366961920,1,1,900
55262458@N03,7049,27,1368617572,1368618472,2,2,900
55262458@N03,7049,28,1368619217,1368620117,1,2,900
55262458@N03,7050,26,1371292398,1371293298,1,1,900
55262458@N03,7051,22,1372485511,1372486111,1,1,600
55262458@N03,7052,14,1377774978,1377775218,1,1,240
55262458@N03,7053,28,1390721304,1390722204,1,1,900
55262458@N03,7054,26,1393057565,1393058465,2,2,900
55262458@N03,7054,30,1393059068,1393060148,1,2,1080
55262458@N03,7055,1,1408237698,1408237758,1,1,60
55283967@N03,7056,28,1374381402,1374382302,3,1,900
55284268@N05,7057,30,1360582986,1360583000,2,2,14
55284268@N05,7057,17,1360583000,1360583300,1,2,300
55284268@N05,7058,13,1360751552,1360751792,1,1,240
55292108@N00,7059,17,1408754844,1408755144,1,1,300
55292108@N00,7060,30,1420066388,1420067468,1,1,1080
55299057@N00,7061,18,1453933561,1453934011,1,1,450
55355125@N00,7062,28,1357624820,1357625720,1,1,900
55355125@N00,7063,16,1396658289,1396658559,2,2,270
55355125@N00,7063,1,1396659910,1396659970,1,2,60
55355125@N00,7064,28,1407325960,1407326860,1,1,900
55355125@N00,7065,3,1407540674,1407540764,2,2,90
55355125@N00,7065,31,1407554934,1407556434,1,2,1500
55355125@N00,7066,1,1407912765,1407912825,1,1,60
55355125@N00,7067,20,1419037976,1419038516,1,1,540
55355125@N00,7068,24,1419138657,1419139437,1,1,780
55355125@N00,7069,18,1427000115,1427000565,1,1,450
55355125@N00,7070,18,1446686907,1446687357,1,1,450
55378047@N07,7071,18,1368174686,1368175136,1,1,450
55503365@N04,7072,1,1311756130,1311756190,1,1,60
55503365@N04,7073,29,1362303922,1362304822,3,3,900
55503365@N04,7073,28,1362315733,1362316585,2,3,852
55503365@N04,7073,1,1362316585,1362316645,3,3,60
55532309@N00,7074,12,1392688160,1392688400,2,2,240
55532309@N00,7074,15,1392700229,1392700499,1,2,270
55559255@N00,7075,29,1411605149,1411605602,2,12,453
55559255@N00,7075,1,1411605602,1411605662,4,12,60
55559255@N00,7075,26,1411606580,1411607480,3,12,900
55559255@N00,7075,23,1411607620,1411608220,2,12,600
55559255@N00,7075,30,1411608956,1411609013,2,12,57
55559255@N00,7075,29,1411609013,1411609188,2,12,175
55559255@N00,7075,31,1411609188,1411609740,2,12,552
55559255@N00,7075,22,1411609740,1411610280,2,12,540
55559255@N00,7075,29,1411610280,1411611180,4,12,900
55559255@N00,7075,22,1411615510,1411616110,2,12,600
55559255@N00,7075,29,1411617973,1411618194,2,12,221
55559255@N00,7075,28,1411618194,1411619094,1,12,900
55635429@N04,7076,28,1293087438,1293088338,1,1,900
55658943@N00,7077,29,1212005210,1212006110,1,1,900
55662771@N00,7078,11,1383786069,1383786309,2,3,240
55662771@N00,7078,18,1383787201,1383787651,2,3,450
55662771@N00,7078,29,1383794417,1383795317,1,3,900
55667779@N00,7079,20,1377515198,1377515738,1,1,540
55667779@N00,7080,25,1377582361,1377583201,1,1,840
55761287@N07,7081,26,1206965940,1206966840,4,1,900
55779593@N00,7082,17,1278387549,1278387849,1,1,300
55779593@N00,7083,28,1281316460,1281317360,2,4,900
55779593@N00,7083,29,1281325129,1281326029,2,4,900
55779593@N00,7083,30,1281326663,1281327743,3,4,1080
55779593@N00,7083,12,1281329623,1281329863,1,4,240
55779593@N00,7084,28,1313323048,1313323948,1,1,900
55779593@N00,7085,26,1324290950,1324291850,1,1,900
55918322@N06,7086,20,1289721260,1289721800,1,1,540
56003994@N00,7087,29,1373079040,1373079940,1,1,900
56008930@N00,7088,13,1250479491,1250479731,2,3,240
56008930@N00,7088,29,1250489687,1250489748,2,3,61
56008930@N00,7088,30,1250489748,1250490828,1,3,1080
56030526@N03,7089,28,1299837670,1299838570,1,1,900
56105245@N05,7090,1,1419984352,1419984412,2,1,60
56115748@N00,7091,24,1318668719,1318669499,1,1,780
56127076@N00,7092,13,1355016408,1355016648,1,1,240
56169684@N02,7093,18,1356048997,1356049447,2,1,450
56169684@N02,7094,28,1356088644,1356089544,1,1,900
56197276@N02,7095,28,1306379988,1306380888,2,1,900
56223610@N07,7096,30,1305159903,1305160983,1,1,1080
56223610@N07,7097,30,1391390735,1391391815,1,1,1080
56266937@N05,7098,26,1365905695,1365906595,1,1,900
56279017@N03,7099,6,1334318308,1334318428,1,1,120
56279017@N03,7100,25,1355579618,1355580222,2,2,604
56279017@N03,7100,26,1355580222,1355581122,2,2,900
56279017@N03,7101,28,1360453084,1360453811,2,4,727
56279017@N03,7101,26,1360453811,1360454711,3,4,900
56279017@N03,7101,16,1360476386,1360476656,2,4,270
56279017@N03,7101,26,1360489441,1360490341,2,4,900
56279017@N03,7102,26,1365249604,1365250504,1,1,900
56279017@N03,7103,26,1379836987,1379837887,1,1,900
56279017@N03,7104,24,1380928122,1380928902,1,1,780
56326087@N08,7105,3,1308393935,1308394025,1,1,90
56381376@N07,7106,18,1428214333,1428214783,1,1,450
56384399@N00,7107,3,1247702024,1247702114,1,1,90
56397884@N02,7108,1,1375942247,1375942307,2,2,60
56397884@N02,7108,28,1375948085,1375948985,5,2,900
56404268@N05,7109,29,1368998508,1368999408,1,1,900
56404392@N02,7110,18,1442018938,1442019388,1,1,450
56482238@N06,7111,13,1293514859,1293515099,1,1,240
56673695@N00,7112,7,1368829588,1368829768,2,2,180
56673695@N00,7112,29,1368850614,1368851514,1,2,900
56697934@N03,7113,26,1319858909,1319859809,1,1,900
56697934@N03,7114,26,1325847747,1325848647,2,2,900
56697934@N03,7114,21,1325858196,1325858766,1,2,570
56726532@N06,7115,26,1383103693,1383104593,1,1,900
56731143@N00,7116,26,1260666472,1260667372,1,1,900
56731143@N00,7117,28,1260705212,1260706112,1,1,900
56779606@N04,7118,28,1348382640,1348383540,1,1,900
56789804@N00,7119,1,1465898748,1465898808,1,1,60
56946277@N00,7120,7,1349582374,1349582554,2,3,180
56946277@N00,7120,26,1349582609,1349583509,2,3,900
56946277@N00,7120,18,1349599583,1349600033,1,3,450
56961858@N00,7121,30,1363576099,1363577179,1,1,1080
56972276@N06,7122,31,1213149089,1213150589,1,1,1500
56986641@N03,7123,30,1319339281,1319340361,46,1,1080
56986681@N00,7124,28,1321689501,1321690401,5,3,900
56986681@N00,7124,21,1321690403,1321690973,7,3,570
56986681@N00,7124,28,1321694493,1321695393,10,3,900
56992488@N00,7125,13,1401078918,1401079158,1,1,240
56999509@N00,7126,23,1349417606,1349418206,1,1,600
57012722@N06,7127,30,1222757747,1222758827,11,1,1080
57027565@N00,7128,17,1328829928,1328830228,1,1,300
57027565@N00,7129,28,1328923976,1328924876,1,1,900
57073634@N00,7130,14,1380621619,1380621859,1,1,240
57073634@N00,7131,29,1397978946,1397979846,2,2,900
57073634@N00,7131,1,1397981403,1397981463,1,2,60
57073634@N00,7132,27,1405595599,1405596499,1,1,900
57085766@N00,7133,16,1220758138,1220758408,1,1,270
57085766@N00,7134,29,1316934726,1316935626,1,1,900
57166455@N05,7135,20,1306635500,1306636040,1,1,540
57166455@N05,7136,18,1308392225,1308392675,1,1,450
57166455@N05,7137,26,1324625670,1324626570,1,1,900
57166455@N05,7138,27,1330174379,1330175279,1,1,900
57192250@N07,7139,28,1356094440,1356095340,1,1,900
57214140@N02,7140,28,1340336294,1340337194,1,1,900
57221649@N05,7141,26,1290781170,1290782070,1,1,900
57284198@N08,7142,28,1298328397,1298329297,1,1,900
57284198@N08,7143,17,1317424556,1317424856,3,1,300
57343525@N04,7144,29,1363509743,1363510643,1,1,900
57392952@N00,7145,27,1333702705,1333703605,2,8,900
57392952@N00,7145,15,1333706966,1333707236,3,8,270
57392952@N00,7145,9,1333709553,1333709733,2,8,180
57392952@N00,7145,11,1333709809,1333710049,2,8,240
57392952@N00,7145,6,1333714370,1333714490,2,8,120
57392952@N00,7145,29,1333717995,1333718895,2,8,900
57392952@N00,7145,26,1333720989,1333721523,2,8,534
57392952@N00,7145,1,1333721523,1333721583,1,8,60
57392952@N00,7146,17,1333761134,1333761434,2,7,300
57392952@N00,7146,28,1333761523,1333762423,2,7,900
57392952@N00,7146,16,1333767703,1333767973,2,7,270
57392952@N00,7146,1,1333769645,1333769705,7,7,60
57392952@N00,7146,28,1333771026,1333771926,2,7,900
57392952@N00,7146,29,1333776113,1333777013,2,7,900
57392952@N00,7146,10,1333789136,1333789376,5,7,240
57492486@N00,7147,28,1292977918,1292978245,3,7,327
57492486@N00,7147,26,1292978245,1292979145,2,7,900
57492486@N00,7147,20,1292982479,1292983019,2,7,540
57492486@N00,7147,10,1292983911,1292984151,2,7,240
57492486@N00,7147,18,1292991283,1292991733,2,7,450
57492486@N00,7147,25,1293007857,1293008697,4,7,840
57492486@N00,7147,26,1293012518,1293013418,3,7,900
57507256@N00,7148,27,1322182315,1322183215,2,12,900
57507256@N00,7148,17,1322187923,1322188223,3,12,300
57507256@N00,7148,20,1322195098,1322195638,3,12,540
57507256@N00,7148,15,1322196300,1322196570,2,12,270
57507256@N00,7148,20,1322202115,1322202655,2,12,540
57507256@N00,7148,29,1322202738,1322202809,2,12,71
57507256@N00,7148,16,1322202809,1322203079,2,12,270
57507256@N00,7148,24,1322206687,1322207467,2,12,780
57507256@N00,7148,28,1322210030,1322210930,2,12,900
57507256@N00,7148,23,1322223997,1322224133,2,12,136
57507256@N00,7148,26,1322224133,1322224163,2,12,30
57507256@N00,7148,18,1322224163,1322224613,2,12,450
57553641@N07,7149,10,1394953032,1394953272,1,1,240
57553641@N07,7150,30,1396234619,1396235699,1,1,1080
57573839@N06,7151,20,1388623605,1388624145,2,2,540
57573839@N06,7151,28,1388625349,1388626249,1,2,900
57573839@N06,7152,1,1389164405,1389164465,1,1,60
57623098@N07,7153,30,1284254041,1284255121,1,1,1080
57623780@N04,7154,15,1353663370,1353663640,2,2,270
57623780@N04,7154,4,1353666434,1353666535,2,2,101
57623780@N04,7155,13,1353718982,1353719222,9,3,240
57623780@N04,7155,21,1353720425,1353720995,3,3,570
57623780@N04,7155,16,1353722504,1353722774,4,3,270
57623780@N04,7156,31,1388723802,1388725302,1,1,1500
57639181@N00,7157,10,1237421467,1237421707,6,16,240
57639181@N00,7157,28,1237424922,1237425822,2,16,900
57639181@N00,7157,1,1237426889,1237426949,2,16,60
57639181@N00,7157,10,1237427902,1237428142,110,16,240
57639181@N00,7157,14,1237435202,1237435244,2,16,42
57639181@N00,7157,10,1237435244,1237435484,218,16,240
57639181@N00,7157,25,1237446225,1237446227,2,16,2
57639181@N00,7157,10,1237446227,1237446467,65,16,240
57639181@N00,7157,28,1237449334,1237450234,4,16,900
57639181@N00,7157,10,1237450296,1237450325,3,16,29
57639181@N00,7157,28,1237450325,1237450450,2,16,125
57639181@N00,7157,10,1237450450,1237450690,7,16,240
57639181@N00,7157,31,1237450759,1237451627,2,16,868
57639181@N00,7157,10,1237451627,1237451867,71,16,240
57639181@N00,7157,26,1237459605,1237460231,2,16,626
57639181@N00,7157,14,1237460231,1237460471,1,16,240
57639181@N00,7158,10,1238980941,1238981181,1,1,240
57665635@N00,7159,29,1294202148,1294203048,5,5,900
57665635@N00,7159,31,1294205009,1294206509,2,5,1500
57665635@N00,7159,13,1294207318,1294207558,4,5,240
57665635@N00,7159,22,1294214461,1294215061,2,5,600
57665635@N00,7159,29,1294215332,1294216232,1,5,900
57665635@N00,7160,20,1296099840,1296100380,2,10,540
57665635@N00,7160,29,1296101422,1296102207,2,10,785
57665635@N00,7160,30,1296102207,1296103287,3,10,1080
57665635@N00,7160,17,1296107943,1296108243,2,10,300
57665635@N00,7160,27,1296108677,1296109577,2,10,900
57665635@N00,7160,18,1296110290,1296110740,2,10,450
57665635@N00,7160,26,1296111111,1296112011,2,10,900
57665635@N00,7160,7,1296112095,1296112248,2,10,153
57665635@N00,7160,16,1296112248,1296112518,3,10,270
57665635@N00,7160,7,1296112989,1296113169,1,10,180
57665635@N00,7161,26,1304503799,1304504699,1,1,900
57665635@N00,7162,27,1307229344,1307230244,2,1,900
57665635@N00,7163,20,1319353204,1319353744,6,2,540
57665635@N00,7163,28,1319356135,1319357035,1,2,900
57665635@N00,7164,6,1422826412,1422826532,1,1,120
57667450@N03,7165,13,1415841176,1415841416,3,2,240
57667450@N03,7165,24,1415847238,1415848018,10,2,780
57667450@N03,7166,26,1417410874,1417411774,5,4,900
57667450@N03,7166,23,1417412461,1417412566,5,4,105
57667450@N03,7166,18,1417412566,1417413016,3,4,450
57667450@N03,7166,28,1417416407,1417417307,3,4,900
57731366@N00,7167,19,1402969783,1402970323,3,1,540
57731366@N00,7168,19,1403051068,1403051608,1,1,540
57731366@N00,7169,18,1434497412,1434497862,1,1,450
57731366@N00,7170,18,1456013670,1456014120,3,1,450
57731892@N07,7171,8,1376890164,1376890344,2,1,180
57747305@N00,7172,26,1232538493,1232539393,1,1,900
57794654@N02,7173,14,1378008244,1378008484,1,1,240
57799803@N02,7174,1,1385002012,1385002072,2,2,60
57799803@N02,7174,25,1385024288,1385025128,1,2,840
57799803@N02,7175,1,1396658898,1396658958,1,1,60
57799803@N02,7176,16,1415866972,1415867242,2,2,270
57799803@N02,7176,30,1415871945,1415873025,1,2,1080
57799803@N02,7177,30,1415993527,1415994607,1,1,1080
57799803@N02,7178,19,1417098435,1417098975,1,1,540
57799803@N02,7179,18,1421631095,1421631545,1,1,450
57799803@N02,7180,18,1421663908,1421664358,1,1,450
57799803@N02,7181,18,1441281355,1441281805,1,1,450
57799803@N02,7182,18,1441326799,1441327249,2,1,450
57799803@N02,7183,18,1448714679,1448715129,1,1,450
57799803@N02,7184,6,1462586349,1462586469,1,1,120
57812277@N05,7185,26,1310636216,1310637116,1,1,900
57812277@N05,7186,22,1310858072,1310858672,3,2,600
57812277@N05,7186,26,1310877238,1310878138,1,2,900
57812277@N05,7187,26,1324714602,1324715502,2,2,900
57812277@N05,7187,4,1324716118,1324716219,1,2,101
57812277@N05,7188,22,1325023387,1325023987,1,1,600
57812277@N05,7189,26,1365297115,1365298015,1,1,900
57812277@N05,7190,28,1397103683,1397104583,1,1,900
57812277@N05,7191,22,1397380779,1397381379,3,2,600
57812277@N05,7191,26,1397389292,1397390192,1,2,900
57812277@N05,7192,1,1437383832,1437383892,1,1,60
57813268@N04,7193,25,1452410560,1452411400,2,1,840
57852884@N00,7194,18,1422228755,1422229205,2,2,450
57852884@N00,7194,4,1422233346,1422233447,1,2,101
57852884@N00,7195,16,1422314582,1422314852,1,1,270
57852884@N00,7196,16,1461058989,1461059259,1,1,270
57853113@N00,7197,26,1207890336,1207891236,94,1,900
57856849@N08,7198,1,1302040803,1302040863,1,1,60
57868847@N04,7199,28,1293884494,1293885394,1,1,900
57869748@N00,7200,29,1412559582,1412560482,1,1,900
57869748@N00,7201,19,1412665569,1412666109,1,1,540
57869748@N00,7202,31,1412736540,1412738040,1,1,1500
57885204@N00,7203,14,1367202352,1367202592,4,2,240
57885204@N00,7203,26,1367204781,1367205681,3,2,900
57885204@N00,7204,17,1380765497,1380765797,2,2,300
57885204@N00,7204,14,1380771897,1380772137,1,2,240
57885204@N00,7205,1,1398057498,1398057558,2,2,60
57885204@N00,7205,22,1398062113,1398062713,1,2,600
57938267@N00,7206,28,1205280488,1205281388,2,16,900
57938267@N00,7206,12,1205282728,1205282968,3,16,240
57938267@N00,7206,24,1205284908,1205285688,3,16,780
57938267@N00,7206,27,1205285711,1205286611,2,16,900
57938267@N00,7206,9,1205289377,1205289557,2,16,180
57938267@N00,7206,5,1205293293,1205293413,2,16,120
57938267@N00,7206,26,1205293756,1205294049,2,16,293
57938267@N00,7206,10,1205294049,1205294289,2,16,240
57938267@N00,7206,26,1205301014,1205301914,2,16,900
57938267@N00,7206,15,1205308850,1205309120,2,16,270
57938267@N00,7206,17,1205310949,1205311249,2,16,300
57938267@N00,7206,20,1205315283,1205315823,2,16,540
57938267@N00,7206,22,1205316163,1205316763,2,16,600
57938267@N00,7206,10,1205316896,1205317136,2,16,240
57938267@N00,7206,28,1205318214,1205319037,2,16,823
57938267@N00,7206,1,1205319037,1205319097,2,16,60
57967471@N06,7207,1,1310083271,1310083331,2,7,60
57967471@N06,7207,28,1310083971,1310084871,2,7,900
57967471@N06,7207,22,1310094634,1310095234,2,7,600
57967471@N06,7207,27,1310097948,1310098848,2,7,900
57967471@N06,7207,26,1310104013,1310104913,2,7,900
57967471@N06,7207,14,1310112825,1310113065,3,7,240
57967471@N06,7207,29,1310128406,1310129306,1,7,900
57967471@N06,7208,3,1310217884,1310217974,2,2,90
57967471@N06,7208,17,1310218998,1310219298,1,2,300
57967471@N06,7209,17,1310250289,1310250589,1,1,300
57967471@N06,7210,13,1310365424,1310365664,2,3,240
57967471@N06,7210,26,1310366476,1310367376,2,3,900
57967471@N06,7210,29,1310373578,1310374478,2,3,900
57991930@N07,7211,16,1350195382,1350195652,2,5,270
57991930@N07,7211,27,1350199587,1350200487,2,5,900
57991930@N07,7211,20,1350204369,1350204604,2,5,235
57991930@N07,7211,29,1350204604,1350205504,2,5,900
57991930@N07,7211,26,1350206874,1350207774,1,5,900
57991930@N07,7212,27,1350252067,1350252967,5,2,900
57991930@N07,7212,25,1350261346,1350262186,3,2,840
57991930@N07,7213,27,1350338155,1350339055,2,4,900
57991930@N07,7213,18,1350342225,1350342398,2,4,173
57991930@N07,7213,22,1350342398,1350342998,2,4,600
57991930@N07,7213,5,1350343343,1350343463,1,4,120
57991930@N07,7214,28,1350418303,1350418407,2,2,104
57991930@N07,7214,15,1350418407,1350418677,1,2,270
58007133@N00,7215,8,1188959293,1188959473,19,1,180
58007133@N00,7216,8,1189471559,1189471739,28,1,180
58007133@N00,7217,6,1193707581,1193707701,29,1,120
58007133@N00,7218,6,1209521945,1209522065,43,1,120
58044290@N00,7219,18,1215938703,1215939153,1,1,450
58044290@N00,7220,26,1234076447,1234077347,1,1,900
58044290@N00,7221,1,1234172234,1234172274,2,4,40
58044290@N00,7221,28,1234172274,1234172308,2,4,34
58044290@N00,7221,29,1234172308,1234172335,2,4,27
58044290@N00,7221,30,1234172335,1234173415,1,4,1080
58044290@N00,7222,28,1235722236,1235723136,6,4,900
58044290@N00,7222,31,1235731995,1235732277,2,4,282
58044290@N00,7222,10,1235732277,1235732517,2,4,240
58044290@N00,7222,26,1235733259,1235734159,1,4,900
58044290@N00,7223,28,1237093965,1237094865,2,4,900
58044290@N00,7223,18,1237100270,1237100720,2,4,450
58044290@N00,7223,19,1237102183,1237102699,2,4,516
58044290@N00,7223,10,1237102699,1237102939,1,4,240
58093080@N05,7224,21,1338784519,1338785089,1,1,570
58112562@N00,7225,3,1364849052,1364849142,1,1,90
58147831@N08,7226,12,1438939865,1438940105,2,2,240
58147831@N08,7226,23,1438945856,1438946456,1,2,600
58153317@N08,7227,22,1344249942,1344250542,1,1,600
58161527@N03,7228,3,1310979183,1310979273,1,1,90
58163347@N08,7229,26,1322627268,1322628168,1,1,900
58174503@N02,7230,19,1414557226,1414557766,2,5,540
58174503@N02,7230,20,1414559708,1414560248,2,5,540
58174503@N02,7230,19,1414564152,1414564692,2,5,540
58174503@N02,7230,12,1414575770,1414576010,2,5,240
58174503@N02,7230,27,1414576671,1414577571,1,5,900
58197646@N00,7231,26,1312143378,1312144278,1,1,900
58263353@N06,7232,4,1303620375,1303620476,1,1,101
58276829@N06,7233,26,1302141766,1302141793,2,21,27
58276829@N06,7233,5,1302141793,1302141813,2,21,20
58276829@N06,7233,26,1302141813,1302141935,2,21,122
58276829@N06,7233,12,1302141935,1302142175,2,21,240
58276829@N06,7233,5,1302142675,1302142795,3,21,120
58276829@N06,7233,12,1302143402,1302143642,2,21,240
58276829@N06,7233,25,1302144165,1302145005,7,21,840
58276829@N06,7233,3,1302145428,1302145518,2,21,90
58276829@N06,7233,15,1302147633,1302147891,2,21,258
58276829@N06,7233,17,1302147891,1302148191,2,21,300
58276829@N06,7233,16,1302150169,1302150439,2,21,270
58276829@N06,7233,26,1302151845,1302152562,3,21,717
58276829@N06,7233,11,1302152562,1302152802,2,21,240
58276829@N06,7233,4,1302154168,1302154269,2,21,101
58276829@N06,7233,5,1302154951,1302155071,4,21,120
58276829@N06,7233,25,1302156218,1302157058,4,21,840
58276829@N06,7233,18,1302157559,1302158009,2,21,450
58276829@N06,7233,29,1302163706,1302164606,4,21,900
58276829@N06,7233,22,1302166260,1302166438,2,21,178
58276829@N06,7233,31,1302166438,1302166510,2,21,72
58276829@N06,7233,20,1302166510,1302167050,6,21,540
58327394@N00,7234,26,1239710295,1239711195,1,1,900
58327394@N00,7235,26,1239758751,1239759651,3,1,900
58327394@N00,7236,10,1246954879,1246955119,1,1,240
58345372@N02,7237,24,1294461220,1294462000,5,1,780
58345372@N02,7238,1,1296282531,1296282591,3,3,60
58345372@N02,7238,28,1296282873,1296283773,3,3,900
58345372@N02,7238,1,1296283889,1296283949,1,3,60
58345372@N02,7239,27,1296952982,1296953711,3,2,729
58345372@N02,7239,24,1296953711,1296954491,2,2,780
58345372@N02,7240,1,1297560283,1297560343,2,2,60
58345372@N02,7240,24,1297570829,1297571609,1,2,780
58345372@N02,7241,24,1298263363,1298264143,1,1,780
58345372@N02,7242,29,1298694547,1298695447,29,1,900
58345372@N02,7243,29,1298768885,1298769785,16,1,900
58345372@N02,7244,29,1299368790,1299369690,15,4,900
58345372@N02,7244,16,1299378265,1299378535,4,4,270
58345372@N02,7244,21,1299384708,1299385278,4,4,570
58345372@N02,7244,24,1299386093,1299386873,4,4,780
58345372@N02,7245,26,1299903423,1299904189,8,2,766
58345372@N02,7245,28,1299904189,1299905089,1,2,900
58345372@N02,7246,22,1301786033,1301786633,2,2,600
58345372@N02,7246,28,1301787220,1301788120,1,2,900
58345372@N02,7247,26,1305413195,1305414095,1,1,900
58345372@N02,7248,28,1306388143,1306389043,18,1,900
58345372@N02,7249,28,1306472513,1306473413,7,1,900
58345372@N02,7250,28,1306713095,1306713995,1,1,900
58345372@N02,7251,28,1310876963,1310877863,24,1,900
58345372@N02,7252,28,1315031239,1315032139,2,1,900
58345372@N02,7253,28,1315212293,1315213193,2,1,900
58345372@N02,7254,26,1315722159,1315723059,1,1,900
58345372@N02,7255,24,1316772721,1316773501,4,2,780
58345372@N02,7255,25,1316778466,1316779306,3,2,840
58345372@N02,7256,26,1322349902,1322350802,1,1,900
58345372@N02,7257,26,1323124308,1323125208,1,1,900
58366987@N00,7258,17,1268204645,1268204945,2,9,300
58366987@N00,7258,26,1268216801,1268217701,4,9,900
58366987@N00,7258,3,1268223026,1268223116,2,9,90
58366987@N00,7258,21,1268224240,1268224810,3,9,570
58366987@N00,7258,5,1268224947,1268225067,2,9,120
58366987@N00,7258,4,1268225602,1268225703,2,9,101
58366987@N00,7258,7,1268226090,1268226270,2,9,180
58366987@N00,7258,6,1268226443,1268226563,3,9,120
58366987@N00,7258,26,1268227009,1268227909,1,9,900
58383324@N00,7259,18,1431564788,1431565238,2,3,450
58383324@N00,7259,13,1431566256,1431566496,2,3,240
58383324@N00,7259,18,1431572388,1431572838,5,3,450
58423006@N02,7260,26,1313136977,1313137877,1,1,900
58426797@N08,7261,26,1362802323,1362803223,25,1,900
58426797@N08,7262,29,1370125729,1370126629,21,3,900
58426797@N08,7262,28,1370137494,1370138394,2,3,900
58426797@N08,7262,13,1370149408,1370149648,5,3,240
58436993@N00,7263,28,1459720658,1459720859,3,31,201
58436993@N00,7263,23,1459720859,1459721182,3,31,323
58436993@N00,7263,16,1459721182,1459721452,8,31,270
58436993@N00,7263,12,1459721576,1459721798,2,31,222
58436993@N00,7263,16,1459721798,1459722068,3,31,270
58436993@N00,7263,17,1459722848,1459723148,4,31,300
58436993@N00,7263,16,1459724540,1459724795,6,31,255
58436993@N00,7263,26,1459724795,1459725695,2,31,900
58436993@N00,7263,29,1459726837,1459727172,2,31,335
58436993@N00,7263,19,1459727172,1459727402,3,31,230
58436993@N00,7263,29,1459727402,1459728302,3,31,900
58436993@N00,7263,14,1459731592,1459731832,2,31,240
58436993@N00,7263,30,1459733509,1459734136,2,31,627
58436993@N00,7263,23,1459734136,1459734736,3,31,600
58436993@N00,7263,26,1459736814,1459737343,3,31,529
58436993@N00,7263,6,1459737343,1459737463,2,31,120
58436993@N00,7263,15,1459738601,1459738619,2,31,18
58436993@N00,7263,24,1459738619,1459739178,2,31,559
58436993@N00,7263,21,1459739178,1459739227,2,31,49
58436993@N00,7263,3,1459739227,1459739317,2,31,90
58436993@N00,7263,6,1459740054,1459740174,2,31,120
58436993@N00,7263,13,1459742058,1459742298,3,31,240
58436993@N00,7263,12,1459746048,1459746288,2,31,240
58436993@N00,7263,24,1459747246,1459747470,3,31,224
58436993@N00,7263,12,1459747470,1459747710,4,31,240
58436993@N00,7263,27,1459749614,1459750188,4,31,574
58436993@N00,7263,25,1459750188,1459750667,2,31,479
58436993@N00,7263,27,1459750667,1459751567,4,31,900
58436993@N00,7263,29,1459752367,1459753267,3,31,900
58436993@N00,7263,30,1459754943,1459756023,6,31,1080
58436993@N00,7263,1,1459760025,1459760085,1,31,60
58493771@N00,7264,26,1304045755,1304046655,10,1,900
58512585@N00,7265,12,1299961324,1299961564,2,8,240
58512585@N00,7265,19,1299965420,1299965960,3,8,540
58512585@N00,7265,30,1299966703,1299967783,2,8,1080
58512585@N00,7265,20,1299969067,1299969607,2,8,540
58512585@N00,7265,14,1299969650,1299969890,2,8,240
58512585@N00,7265,1,1299975361,1299975421,2,8,60
58512585@N00,7265,30,1299976075,1299977155,2,8,1080
58512585@N00,7265,15,1300001550,1300001820,1,8,270
58512585@N00,7266,20,1300095937,1300096477,2,3,540
58512585@N00,7266,26,1300099805,1300100705,2,3,900
58512585@N00,7266,1,1300102231,1300102291,1,3,60
58513125@N05,7267,28,1404531210,1404532110,4,4,900
58513125@N05,7267,16,1404549701,1404549971,14,4,270
58513125@N05,7267,1,1404551795,1404551855,2,4,60
58513125@N05,7267,28,1404552765,1404553665,1,4,900
58519896@N00,7268,28,1232754899,1232755799,2,6,900
58519896@N00,7268,24,1232761357,1232762137,4,6,780
58519896@N00,7268,21,1232763058,1232763628,2,6,570
58519896@N00,7268,3,1232764674,1232764764,4,6,90
58519896@N00,7268,26,1232784701,1232785601,3,6,900
58519896@N00,7268,28,1232788154,1232789054,2,6,900
58519896@N00,7269,24,1232876848,1232877628,1,1,780
58522598@N00,7270,21,1406452215,1406452298,2,8,83
58522598@N00,7270,13,1406452298,1406452538,3,8,240
58522598@N00,7270,15,1406453614,1406453884,5,8,270
58522598@N00,7270,29,1406457999,1406458835,2,8,836
58522598@N00,7270,22,1406458835,1406459193,2,8,358
58522598@N00,7270,30,1406459193,1406460273,2,8,1080
58522598@N00,7270,26,1406461135,1406462035,6,8,900
58522598@N00,7270,16,1406470473,1406470743,8,8,270
58588822@N00,7271,29,1437887584,1437888484,1,1,900
58667572@N00,7272,14,1288746353,1288746593,2,6,240
58667572@N00,7272,8,1288748108,1288748288,5,6,180
58667572@N00,7272,30,1288756753,1288757833,3,6,1080
58667572@N00,7272,3,1288758609,1288758699,2,6,90
58667572@N00,7272,18,1288762786,1288763236,6,6,450
58667572@N00,7272,28,1288768104,1288769004,1,6,900
58668786@N00,7273,1,1258846237,1258846297,2,6,60
58668786@N00,7273,26,1258846727,1258847538,2,6,811
58668786@N00,7273,13,1258847538,1258847778,15,6,240
58668786@N00,7273,17,1258859598,1258859898,2,6,300
58668786@N00,7273,30,1258861766,1258862846,11,6,1080
58668786@N00,7273,26,1258868524,1258869424,3,6,900
58668786@N00,7274,26,1445043624,1445043946,2,3,322
58668786@N00,7274,21,1445043946,1445044516,2,3,570
58668786@N00,7274,23,1445052395,1445052995,1,3,600
58694515@N08,7275,28,1353652611,1353653511,1,1,900
58694515@N08,7276,16,1364636686,1364636956,1,1,270
58694515@N08,7277,27,1373695342,1373695668,2,3,326
58694515@N08,7277,15,1373695668,1373695938,3,3,270
58694515@N08,7277,11,1373710940,1373711180,1,3,240
58694515@N08,7278,28,1391219325,1391220225,1,1,900
58720664@N08,7279,24,1353239756,1353240536,1,1,780
58720664@N08,7280,16,1353413071,1353413341,1,1,270
58720664@N08,7281,25,1353832258,1353833098,1,1,840
58720664@N08,7282,27,1354834401,1354835301,1,1,900
58720664@N08,7283,29,1367484453,1367485353,1,1,900
58720664@N08,7284,29,1384646318,1384647218,1,1,900
58753937@N00,7285,30,1251093078,1251094158,2,3,1080
58753937@N00,7285,7,1251096224,1251096404,2,3,180
58753937@N00,7285,26,1251109648,1251110548,1,3,900
58785673@N08,7286,28,1341630868,1341631768,2,4,900
58785673@N08,7286,18,1341634899,1341635349,2,4,450
58785673@N08,7286,28,1341642965,1341642976,2,4,11
58785673@N08,7286,1,1341642976,1341643036,1,4,60
58826624@N00,7287,13,1254627168,1254627408,1,1,240
58837464@N02,7288,12,1313824496,1313824736,1,1,240
58886894@N00,7289,28,1288996133,1288997033,1,1,900
58938024@N03,7290,20,1274572229,1274572769,2,2,540
58938024@N03,7290,28,1274590324,1274591224,1,2,900
58938245@N00,7291,1,1393288604,1393288664,2,5,60
58938245@N00,7291,28,1393289066,1393289070,2,5,4
58938245@N00,7291,1,1393289070,1393289130,4,5,60
58938245@N00,7291,29,1393294581,1393294603,3,5,22
58938245@N00,7291,20,1393294603,1393295143,2,5,540
58964713@N05,7292,12,1256314048,1256314288,1,1,240
58964713@N05,7293,1,1256344243,1256344303,1,1,60
58982814@N07,7294,17,1376127451,1376127751,2,2,300
58982814@N07,7294,16,1376138170,1376138440,1,2,270
58991728@N00,7295,28,1365147995,1365148895,1,1,900
59004662@N00,7296,19,1412467788,1412468328,1,1,540
59028125@N00,7297,13,1321559773,1321560013,1,1,240
59106234@N00,7298,20,1316860316,1316860856,1,1,540
59134168@N07,7299,26,1340254684,1340255584,5,1,900
59184099@N06,7300,10,1274744172,1274744412,1,1,240
59184099@N06,7301,8,1275887693,1275887873,2,3,180
59184099@N06,7301,26,1275888081,1275888981,2,3,900
59184099@N06,7301,30,1275898885,1275899965,1,3,1080
59184099@N06,7302,15,1277118505,1277118775,1,1,270
59184099@N06,7303,26,1311065222,1311066122,10,2,900
59184099@N06,7303,1,1311087389,1311087449,1,2,60
59184099@N06,7304,18,1311511019,1311511469,1,1,450
59184099@N06,7305,3,1311834637,1311834727,1,1,90
59184099@N06,7306,26,1312259672,1312260572,3,3,900
59184099@N06,7306,28,1312265765,1312266657,7,3,892
59184099@N06,7306,1,1312266657,1312266717,1,3,60
59184099@N06,7307,26,1312782225,1312783125,1,1,900
59184099@N06,7308,24,1313075862,1313076642,1,1,780
59184099@N06,7309,24,1313556139,1313556821,2,4,682
59184099@N06,7309,16,1313556821,1313557091,2,4,270
59184099@N06,7309,28,1313562172,1313562227,2,4,55
59184099@N06,7309,1,1313562227,1313562287,1,4,60
59184099@N06,7310,16,1314545857,1314546127,1,1,270
59184099@N06,7311,1,1314858203,1314858263,3,2,60
59184099@N06,7311,16,1314862460,1314862730,3,2,270
59184099@N06,7312,26,1315330440,1315331340,1,1,900
59184099@N06,7313,27,1316749010,1316749910,3,3,900
59184099@N06,7313,26,1316758579,1316759479,5,3,900
59184099@N06,7313,30,1316765442,1316766522,2,3,1080
59184099@N06,7314,28,1316845248,1316846148,2,2,900
59184099@N06,7314,26,1316849209,1316850109,1,2,900
59184099@N06,7315,28,1317451145,1317452045,2,1,900
59184099@N06,7316,20,1317798068,1317798608,1,1,540
59184099@N06,7317,28,1318420757,1318421657,1,1,900
59184099@N06,7318,28,1318607106,1318608006,1,1,900
59184099@N06,7319,26,1318934207,1318935107,1,1,900
59184099@N06,7320,1,1319348001,1319348061,2,3,60
59184099@N06,7320,28,1319352760,1319353660,2,3,900
59184099@N06,7320,26,1319363643,1319364543,1,3,900
59184099@N06,7321,29,1319785907,1319786807,2,2,900
59184099@N06,7321,30,1319788385,1319789465,1,2,1080
59184099@N06,7322,28,1320409780,1320410680,1,1,900
59184099@N06,7323,12,1320494814,1320495054,1,1,240
59184099@N06,7324,29,1320976002,1320976902,2,3,900
59184099@N06,7324,15,1321003752,1321004022,2,3,270
59184099@N06,7324,24,1321008525,1321009305,1,3,780
59184099@N06,7325,29,1321626052,1321626952,2,2,900
59184099@N06,7325,28,1321628580,1321629480,1,2,900
59184099@N06,7326,11,1321931252,1321931492,2,2,240
59184099@N06,7326,30,1321937822,1321938902,1,2,1080
59184099@N06,7327,31,1322231820,1322233320,1,1,1500
59184099@N06,7328,1,1322813819,1322813879,1,1,60
59184099@N06,7329,25,1323440258,1323441098,2,2,840
59184099@N06,7329,26,1323441898,1323442798,1,2,900
59184099@N06,7330,20,1324034549,1324035089,1,1,540
59184099@N06,7331,26,1324647234,1324648134,1,1,900
59184099@N06,7332,29,1325571510,1325572410,2,1,900
59184099@N06,7333,19,1326547219,1326547759,1,1,540
59184099@N06,7334,28,1326908206,1326909106,1,1,900
59184099@N06,7335,15,1328261535,1328261793,2,2,258
59184099@N06,7335,24,1328261793,1328262573,1,2,780
59184099@N06,7336,17,1328793297,1328793597,1,1,300
59184099@N06,7337,26,1329371522,1329372422,1,1,900
59184099@N06,7338,26,1329404851,1329405751,2,1,900
59184099@N06,7339,26,1329493287,1329494187,1,1,900
59184099@N06,7340,16,1330880922,1330881192,1,1,270
59184099@N06,7341,26,1331398392,1331399292,1,1,900
59184099@N06,7342,16,1331569389,1331569659,1,1,270
59184099@N06,7343,26,1331846312,1331847212,1,1,900
59184099@N06,7344,13,1335015747,1335015987,1,1,240
59184099@N06,7345,16,1335102361,1335102631,1,1,270
59184099@N06,7346,15,1336127876,1336128146,2,1,270
59184099@N06,7347,29,1337789282,1337790182,1,1,900
59184099@N06,7348,26,1338028591,1338029491,2,1,900
59184099@N06,7349,21,1338358685,1338359255,1,1,570
59184099@N06,7350,15,1346140440,1346140710,2,3,270
59184099@N06,7350,26,1346141880,1346142780,2,3,900
59184099@N06,7350,30,1346158051,1346159131,1,3,1080
59184099@N06,7351,20,1352002375,1352002915,1,1,540
59184099@N06,7352,16,1355802786,1355803056,2,3,270
59184099@N06,7352,29,1355806210,1355807110,2,3,900
59184099@N06,7352,6,1355811528,1355811648,1,3,120
59184099@N06,7353,28,1371191370,1371192270,1,1,900
59184099@N06,7354,20,1376053408,1376053948,1,1,540
59184099@N06,7355,26,1376544972,1376545872,1,1,900
59184099@N06,7356,29,1376748657,1376749557,1,1,900
59184099@N06,7357,29,1378041715,1378042615,1,1,900
59184099@N06,7358,29,1378189489,1378190389,1,1,900
59184099@N06,7359,29,1378893917,1378894817,1,1,900
59184099@N06,7360,26,1380282342,1380283242,1,1,900
59184099@N06,7361,28,1388415775,1388416675,1,1,900
59184099@N06,7362,16,1388472898,1388473168,1,1,270
59184099@N06,7363,26,1395570660,1395571560,1,1,900
59184099@N06,7364,26,1396297760,1396298660,1,1,900
59184099@N06,7365,26,1398166854,1398167754,1,1,900
59184099@N06,7366,26,1399570003,1399570903,1,1,900
59184099@N06,7367,29,1402860261,1402861161,1,1,900
59184099@N06,7368,20,1403270844,1403271384,2,2,540
59184099@N06,7368,26,1403274392,1403275292,1,2,900
59184099@N06,7369,16,1403533032,1403533302,1,1,270
59184099@N06,7370,20,1403931078,1403931618,1,1,540
59184099@N06,7371,6,1403965021,1403965141,1,1,120
59184099@N06,7372,30,1412064246,1412065326,3,1,1080
59184099@N06,7373,16,1414477615,1414477885,1,1,270
59184099@N06,7374,20,1418103233,1418103773,1,1,540
59184099@N06,7375,6,1421588496,1421588616,1,1,120
59184099@N06,7376,26,1428201286,1428202186,1,1,900
59184099@N06,7377,26,1433510574,1433511474,1,1,900
59184099@N06,7378,7,1435672800,1435672980,1,1,180
59184099@N06,7379,27,1449754364,1449755264,2,2,900
59184099@N06,7379,16,1449758687,1449758957,1,2,270
59184099@N06,7380,26,1457333893,1457334793,1,1,900
59186794@N00,7381,3,1467235549,1467235639,3,1,90
59203613@N04,7382,30,1339642033,1339643113,1,1,1080
59217527@N05,7383,27,1318912515,1318913415,1,1,900
59243952@N04,7384,22,1276660696,1276661296,1,1,600
59263913@N00,7385,1,1329509461,1329509521,2,4,60
59263913@N00,7385,26,1329509787,1329510199,2,4,412
59263913@N00,7385,24,1329510199,1329510979,2,4,780
59263913@N00,7385,29,1329512643,1329513543,3,4,900
59263913@N00,7386,13,1329542151,1329542391,2,3,240
59263913@N00,7386,25,1329544060,1329544900,2,3,840
59263913@N00,7386,27,1329563141,1329564041,1,3,900
59263913@N00,7387,1,1329610836,1329610896,1,1,60
59263913@N00,7388,7,1329726925,1329727105,2,3,180
59263913@N00,7388,26,1329728747,1329728790,3,3,43
59263913@N00,7388,13,1329728790,1329729030,1,3,240
59270652@N04,7389,29,1346507436,1346508336,1,1,900
59323491@N00,7390,1,1380886761,1380886821,2,3,60
59323491@N00,7390,26,1380891848,1380891897,2,3,49
59323491@N00,7390,1,1380891897,1380891957,2,3,60
59323491@N00,7391,1,1380946157,1380946217,1,1,60
59323491@N00,7392,14,1381017066,1381017306,1,1,240
59323491@N00,7393,7,1381363926,1381364106,2,3,180
59323491@N00,7393,1,1381364193,1381364253,2,3,60
59323491@N00,7393,17,1381364402,1381364702,1,3,300
59344479@N02,7394,26,1396914821,1396915721,1,1,900
59350481@N07,7395,28,1306736319,1306737219,4,2,900
59350481@N07,7395,23,1306757196,1306757796,1,2,600
59350481@N07,7396,3,1349323221,1349323311,1,1,90
59390981@N04,7397,1,1229736029,1229736089,1,1,60
59390981@N04,7398,1,1308112540,1308112600,2,4,60
59390981@N04,7398,27,1308117900,1308118800,4,4,900
59390981@N04,7398,16,1308125825,1308126095,2,4,270
59390981@N04,7398,31,1308126286,1308127786,1,4,1500
59390981@N04,7399,28,1325408769,1325409453,9,22,684
59390981@N04,7399,16,1325409453,1325409665,2,22,212
59390981@N04,7399,15,1325409665,1325409738,2,22,73
59390981@N04,7399,17,1325409738,1325410038,3,22,300
59390981@N04,7399,3,1325413179,1325413269,4,22,90
59390981@N04,7399,7,1325413652,1325413811,3,22,159
59390981@N04,7399,5,1325413811,1325413824,2,22,13
59390981@N04,7399,7,1325413824,1325413953,6,22,129
59390981@N04,7399,9,1325413953,1325413967,2,22,14
59390981@N04,7399,8,1325413967,1325414147,2,22,180
59390981@N04,7399,6,1325414329,1325414449,6,22,120
59390981@N04,7399,26,1325414510,1325414522,2,22,12
59390981@N04,7399,6,1325414522,1325414642,2,22,120
59390981@N04,7399,26,1325414852,1325415144,8,22,292
59390981@N04,7399,30,1325415144,1325415504,4,22,360
59390981@N04,7399,31,1325415504,1325416063,2,22,559
59390981@N04,7399,30,1325416063,1325417143,2,22,1080
59390981@N04,7399,20,1325417474,1325418014,16,22,540
59390981@N04,7399,23,1325418532,1325419132,2,22,600
59390981@N04,7399,18,1325419413,1325419863,2,22,450
59390981@N04,7399,29,1325421333,1325422233,2,22,900
59390981@N04,7399,28,1325422788,1325423688,1,22,900
59390981@N04,7400,28,1325460053,1325460953,2,3,900
59390981@N04,7400,6,1325461506,1325461626,2,3,120
59390981@N04,7400,28,1325465613,1325466513,1,3,900
59390981@N04,7401,23,1329044754,1329045354,2,6,600
59390981@N04,7401,18,1329045356,1329045625,2,6,269
59390981@N04,7401,20,1329045625,1329046165,3,6,540
59390981@N04,7401,31,1329047113,1329047119,2,6,6
59390981@N04,7401,20,1329047119,1329047659,3,6,540
59390981@N04,7401,18,1329048764,1329049214,1,6,450
59391018@N07,7402,18,1449530884,1449531334,1,1,450
59392555@N00,7403,8,1194748393,1194748573,21,1,180
59392555@N00,7404,8,1243149850,1243150030,5,3,180
59392555@N00,7404,31,1243160772,1243161185,2,3,413
59392555@N00,7404,8,1243161185,1243161365,12,3,180
59392555@N00,7405,31,1243213690,1243215190,4,1,1500
59392555@N00,7406,31,1273576122,1273577622,9,1,1500
59392555@N00,7407,31,1273627305,1273628805,36,1,1500
59457417@N00,7408,28,1297571710,1297571918,3,2,208
59457417@N00,7408,26,1297571918,1297572818,5,2,900
59457417@N00,7409,28,1297678199,1297679099,4,1,900
59457417@N00,7410,28,1387339332,1387339608,2,5,276
59457417@N00,7410,27,1387339608,1387340064,2,5,456
59457417@N00,7410,15,1387340064,1387340334,7,5,270
59457417@N00,7410,28,1387365170,1387365892,2,5,722
59457417@N00,7410,26,1387365892,1387366792,1,5,900
59479001@N06,7411,28,1360408115,1360409015,1,1,900
59479001@N06,7412,7,1360565671,1360565851,1,1,180
59487718@N00,7413,26,1258871552,1258872325,2,3,773
59487718@N00,7413,16,1258872325,1258872595,2,3,270
59487718@N00,7413,27,1258872919,1258873819,1,3,900
59504839@N06,7414,26,1353504518,1353505418,1,1,900
59508646@N03,7415,26,1324842950,1324843850,1,1,900
59525461@N00,7416,28,1283680754,1283681654,7,1,900
59538487@N00,7417,28,1207105059,1207105959,6,1,900
59538487@N00,7418,30,1325381826,1325382906,1,1,1080
59538487@N00,7419,14,1327721131,1327721371,4,2,240
59538487@N00,7419,20,1327729349,1327729889,1,2,540
59538487@N00,7420,16,1329694457,1329694727,5,2,270
59538487@N00,7420,15,1329698785,1329699055,4,2,270
59538487@N00,7421,1,1349562181,1349562241,5,6,60
59538487@N00,7421,26,1349562860,1349563760,2,6,900
59538487@N00,7421,20,1349563988,1349564528,2,6,540
59538487@N00,7421,29,1349564820,1349565720,25,6,900
59538487@N00,7421,30,1349577819,1349578899,3,6,1080
59538487@N00,7421,24,1349582494,1349583274,1,6,780
59538487@N00,7422,16,1353400506,1353400776,1,1,270
59538487@N00,7423,26,1355028291,1355028340,2,4,49
59538487@N00,7423,16,1355028340,1355028610,4,4,270
59538487@N00,7423,31,1355035518,1355035701,2,4,183
59538487@N00,7423,20,1355035701,1355036241,2,4,540
59538487@N00,7424,26,1355122058,1355122958,1,1,900
59538487@N00,7425,20,1355306704,1355307244,1,1,540
59538487@N00,7426,20,1365426514,1365427054,1,1,540
59538487@N00,7427,28,1365482690,1365483590,1,1,900
59538487@N00,7428,28,1368930915,1368931815,1,1,900
59538487@N00,7429,1,1369613548,1369613608,2,3,60
59538487@N00,7429,29,1369614091,1369614991,2,3,900
59538487@N00,7429,25,1369619795,1369620635,1,3,840
59538487@N00,7430,14,1373763436,1373763676,1,1,240
59538487@N00,7431,26,1373809197,1373810097,1,1,900
59538487@N00,7432,14,1374372897,1374373137,2,2,240
59538487@N00,7432,28,1374388019,1374388919,1,2,900
59538487@N00,7433,28,1374459586,1374460486,1,1,900
59538487@N00,7434,4,1374968834,1374968935,2,2,101
59538487@N00,7434,14,1374991046,1374991286,1,2,240
59538487@N00,7435,28,1376178653,1376179553,1,1,900
59538487@N00,7436,29,1381734246,1381735146,1,1,900
59538487@N00,7437,28,1385763953,1385764585,6,10,632
59538487@N00,7437,1,1385764585,1385764645,24,10,60
59538487@N00,7437,28,1385766216,1385766800,3,10,584
59538487@N00,7437,26,1385766800,1385767700,3,10,900
59538487@N00,7437,15,1385774059,1385774329,8,10,270
59538487@N00,7437,25,1385779266,1385779515,3,10,249
59538487@N00,7437,15,1385779515,1385779785,2,10,270
59538487@N00,7437,25,1385780329,1385781169,2,10,840
59538487@N00,7437,29,1385788846,1385789746,5,10,900
59538487@N00,7437,25,1385809807,1385810647,4,10,840
59538487@N00,7438,25,1385858071,1385858911,1,1,840
59538487@N00,7439,19,1386983283,1386983823,1,1,540
59538487@N00,7440,29,1389408514,1389409414,2,2,900
59538487@N00,7440,28,1389417937,1389418837,1,2,900
59538487@N00,7441,14,1394242174,1394242414,1,1,240
59538487@N00,7442,26,1396742927,1396743060,2,9,133
59538487@N00,7442,28,1396743060,1396743960,2,9,900
59538487@N00,7442,14,1396750242,1396750482,25,9,240
59538487@N00,7442,22,1396751303,1396751521,3,9,218
59538487@N00,7442,31,1396751521,1396751757,4,9,236
59538487@N00,7442,14,1396751757,1396751997,2,9,240
59538487@N00,7442,10,1396754523,1396754599,5,9,76
59538487@N00,7442,30,1396754599,1396755679,4,9,1080
59538487@N00,7442,15,1396759016,1396759286,30,9,270
59538487@N00,7443,1,1400372181,1400372241,4,11,60
59538487@N00,7443,22,1400374957,1400375557,2,11,600
59538487@N00,7443,31,1400375829,1400376073,2,11,244
59538487@N00,7443,29,1400376073,1400376151,2,11,78
59538487@N00,7443,31,1400376151,1400376482,4,11,331
59538487@N00,7443,30,1400376482,1400376637,4,11,155
59538487@N00,7443,31,1400376637,1400378137,5,11,1500
59538487@N00,7443,29,1400378455,1400379355,3,11,900
59538487@N00,7443,22,1400379555,1400380155,6,11,600
59538487@N00,7443,15,1400388741,1400389011,16,11,270
59538487@N00,7443,30,1400391333,1400392413,2,11,1080
59538487@N00,7444,28,1405831215,1405832115,17,10,900
59538487@N00,7444,29,1405832869,1405833769,3,10,900
59538487@N00,7444,19,1405840072,1405840612,8,10,540
59538487@N00,7444,23,1405840924,1405840927,2,10,3
59538487@N00,7444,19,1405840927,1405841467,5,10,540
59538487@N00,7444,14,1405846116,1405846117,2,10,1
59538487@N00,7444,22,1405846117,1405846717,10,10,600
59538487@N00,7444,14,1405846739,1405846979,2,10,240
59538487@N00,7444,16,1405849679,1405849949,4,10,270
59538487@N00,7444,27,1405853433,1405854333,3,10,900
59538487@N00,7445,30,1412482458,1412483538,2,2,1080
59538487@N00,7445,19,1412492793,1412493333,1,2,540
59538487@N00,7446,28,1417500549,1417501449,3,12,900
59538487@N00,7446,20,1417504055,1417504595,2,12,540
59538487@N00,7446,26,1417506533,1417506915,8,12,382
59538487@N00,7446,27,1417506915,1417507082,2,12,167
59538487@N00,7446,17,1417507082,1417507382,2,12,300
59538487@N00,7446,27,1417507524,1417508415,2,12,891
59538487@N00,7446,17,1417508415,1417508715,5,12,300
59538487@N00,7446,21,1417510120,1417510390,4,12,270
59538487@N00,7446,25,1417510390,1417511230,13,12,840
59538487@N00,7446,17,1417513737,1417514037,2,12,300
59538487@N00,7446,16,1417514377,1417514454,3,12,77
59538487@N00,7446,28,1417514454,1417515354,3,12,900
59565042@N08,7447,26,1421485092,1421485992,1,1,900
59572566@N07,7448,1,1404396000,1404396060,1,1,60
59572566@N07,7449,1,1404477982,1404478042,4,1,60
59572566@N07,7450,1,1404515914,1404515974,6,1,60
59572566@N07,7451,1,1419989445,1419989505,16,1,60
59572566@N07,7452,1,1420275270,1420275330,1,1,60
59609425@N08,7453,26,1293539584,1293540484,1,1,900
59642062@N00,7454,22,1355630219,1355630819,5,5,600
59642062@N00,7454,31,1355633259,1355633534,2,5,275
59642062@N00,7454,14,1355633534,1355633774,3,5,240
59642062@N00,7454,26,1355639878,1355640778,5,5,900
59642062@N00,7454,13,1355642066,1355642306,3,5,240
59642062@N00,7455,14,1357433102,1357433342,2,2,240
59642062@N00,7455,3,1357446411,1357446501,1,2,90
59646076@N00,7456,17,1235353469,1235353769,1,1,300
59646076@N00,7457,28,1238336397,1238337297,3,2,900
59646076@N00,7457,22,1238346109,1238346709,1,2,600
59646076@N00,7458,26,1238994672,1238995572,26,1,900
59646076@N00,7459,26,1239139859,1239140759,10,2,900
59646076@N00,7459,29,1239146948,1239147848,4,2,900
59646076@N00,7460,22,1244547399,1244547999,6,1,600
59646076@N00,7461,28,1244757828,1244758728,4,1,900
59646076@N00,7462,28,1244808782,1244809682,2,1,900
59646076@N00,7463,28,1244870823,1244871723,9,1,900
59646076@N00,7464,28,1244940749,1244941649,2,3,900
59646076@N00,7464,6,1244942266,1244942386,17,3,120
59646076@N00,7464,13,1244988676,1244988916,19,3,240
59646076@N00,7465,22,1245058767,1245059367,2,2,600
59646076@N00,7465,6,1245059760,1245059880,1,2,120
59646076@N00,7466,29,1245097462,1245098362,2,1,900
59646076@N00,7467,29,1245150072,1245150972,7,1,900
59646076@N00,7468,17,1245202707,1245203007,1,1,300
59646076@N00,7469,17,1245271152,1245271452,2,1,300
59646076@N00,7470,17,1245358181,1245358481,1,1,300
59646076@N00,7471,17,1245415008,1245415308,3,1,300
59646076@N00,7472,17,1245494403,1245494703,6,1,300
59646076@N00,7473,13,1245526753,1245526993,8,1,240
59646076@N00,7474,13,1245579749,1245579989,2,2,240
59646076@N00,7474,28,1245580975,1245581875,1,2,900
59698703@N05,7475,26,1466226621,1466227521,1,1,900
59710020@N03,7476,1,1425868461,1425868521,1,1,60
59735909@N00,7477,1,1350083254,1350083314,5,1,60
59742495@N00,7478,28,1197722945,1197723218,2,2,273
59742495@N00,7478,26,1197723218,1197724118,1,2,900
59742495@N00,7479,28,1198738897,1198739797,1,1,900
59742495@N00,7480,28,1206331793,1206332693,2,1,900
59742495@N00,7481,1,1212910213,1212910273,2,3,60
59742495@N00,7481,23,1212914479,1212915079,2,3,600
59742495@N00,7481,29,1212919409,1212920309,1,3,900
59742495@N00,7482,30,1213008910,1213009990,1,1,1080
59753021@N00,7483,18,1226360417,1226360867,1,1,450
59753021@N00,7484,26,1228286086,1228286986,1,1,900
59753021@N00,7485,12,1245734199,1245734439,3,5,240
59753021@N00,7485,11,1245735973,1245736213,3,5,240
59753021@N00,7485,18,1245737943,1245738393,2,5,450
59753021@N00,7485,30,1245751983,1245753063,3,5,1080
59753021@N00,7485,17,1245757350,1245757650,1,5,300
59753021@N00,7486,18,1254205925,1254206375,1,1,450
59753021@N00,7487,25,1314502418,1314502476,2,4,58
59753021@N00,7487,18,1314502476,1314502497,2,4,21
59753021@N00,7487,11,1314502497,1314502537,3,4,40
59753021@N00,7487,30,1314502537,1314503617,4,4,1080
59753021@N00,7488,26,1362067327,1362068227,1,1,900
59753021@N00,7489,30,1457410637,1457411717,2,4,1080
59753021@N00,7489,16,1457413655,1457413925,2,4,270
59753021@N00,7489,27,1457414064,1457414964,2,4,900
59753021@N00,7489,26,1457416711,1457417611,1,4,900
59753021@N00,7490,23,1461368985,1461369585,1,1,600
59888866@N00,7491,29,1192178091,1192178991,2,1,900
59888866@N00,7492,26,1235896384,1235897284,6,1,900
59888866@N00,7493,29,1238361862,1238362762,1,1,900
59888866@N00,7494,29,1240298631,1240299531,5,4,900
59888866@N00,7494,21,1240304697,1240305267,3,4,570
59888866@N00,7494,3,1240306441,1240306531,2,4,90
59888866@N00,7494,28,1240306908,1240307808,2,4,900
59888866@N00,7495,10,1274583007,1274583247,22,1,240
59888866@N00,7496,20,1295064150,1295064690,1,1,540
59888866@N00,7497,28,1306547656,1306548556,2,6,900
59888866@N00,7497,10,1306550654,1306550894,2,6,240
59888866@N00,7497,30,1306551142,1306552222,2,6,1080
59888866@N00,7497,29,1306554759,1306555659,3,6,900
59888866@N00,7497,15,1306561819,1306562089,2,6,270
59888866@N00,7497,7,1306572001,1306572181,1,6,180
59888866@N00,7498,26,1322827108,1322828008,1,1,900
59888866@N00,7499,27,1327150018,1327150918,1,1,900
59888866@N00,7500,5,1327382379,1327382499,1,1,120
59888866@N00,7501,3,1330533897,1330533987,2,2,90
59888866@N00,7501,28,1330537516,1330538416,1,2,900
59888866@N00,7502,31,1334210340,1334211840,1,1,1500
59983818@N06,7503,28,1407340578,1407341478,1,1,900
60054626@N00,7504,26,1195549548,1195550448,1,1,900
60054626@N00,7505,26,1279933086,1279933986,6,1,900
60143933@N02,7506,28,1353117888,1353118788,1,1,900
60312008@N00,7507,26,1204243869,1204244769,13,1,900
60319488@N03,7508,28,1294052446,1294052823,2,4,377
60319488@N03,7508,26,1294052823,1294053723,2,4,900
60319488@N03,7508,13,1294053817,1294054057,2,4,240
60319488@N03,7508,23,1294055225,1294055825,2,4,600
60359963@N00,7509,15,1221641594,1221641864,1,1,270
60385541@N00,7510,17,1389672259,1389672559,2,9,300
60385541@N00,7510,27,1389673477,1389674377,2,9,900
60385541@N00,7510,16,1389674385,1389674655,2,9,270
60385541@N00,7510,1,1389676934,1389676994,2,9,60
60385541@N00,7510,26,1389678171,1389678598,3,9,427
60385541@N00,7510,7,1389678598,1389678778,2,9,180
60385541@N00,7510,3,1389679094,1389679184,3,9,90
60385541@N00,7510,28,1389687009,1389687107,2,9,98
60385541@N00,7510,1,1389687107,1389687167,2,9,60
60385541@N00,7511,3,1389942656,1389942746,1,1,90
60385541@N00,7512,14,1409429194,1409429434,3,1,240
60385541@N00,7513,1,1443993985,1443994045,2,10,60
60385541@N00,7513,13,1443995301,1443995541,2,10,240
60385541@N00,7513,26,1443998850,1443999705,3,10,855
60385541@N00,7513,20,1443999705,1444000245,6,10,540
60385541@N00,7513,19,1444005670,1444006210,2,10,540
60385541@N00,7513,23,1444008132,1444008732,2,10,600
60385541@N00,7513,29,1444008760,1444009660,4,10,900
60385541@N00,7513,15,1444016976,1444017246,2,10,270
60385541@N00,7513,31,1444024916,1444026416,2,10,1500
60385541@N00,7513,23,1444026986,1444027586,3,10,600
60448671@N07,7514,26,1307256592,1307257492,104,1,900
60448671@N07,7515,31,1326852552,1326854052,9,2,1500
60448671@N07,7515,22,1326873112,1326873712,6,2,600
60456299@N00,7516,12,1196754053,1196754293,1,1,240
60456299@N00,7517,28,1300001057,1300001957,1,1,900
60456299@N00,7518,13,1316766657,1316766659,2,2,2
60456299@N00,7518,16,1316766659,1316766929,1,2,270
60626506@N00,7519,8,1193719454,1193719634,3,1,180
60657104@N00,7520,28,1458081546,1458082446,3,3,900
60657104@N00,7520,24,1458085007,1458085787,2,3,780
60657104@N00,7520,28,1458087903,1458088803,1,3,900
60687534@N05,7521,28,1314194571,1314195471,1,1,900
60687534@N05,7522,28,1318508533,1318509433,1,1,900
60703488@N00,7523,1,1416784236,1416784296,2,17,60
60703488@N00,7523,20,1416789229,1416789769,6,17,540
60703488@N00,7523,31,1416793336,1416794309,8,17,973
60703488@N00,7523,26,1416794309,1416795209,22,17,900
60703488@N00,7523,9,1416796798,1416796978,3,17,180
60703488@N00,7523,8,1416797705,1416797711,3,17,6
60703488@N00,7523,4,1416797711,1416797812,3,17,101
60703488@N00,7523,5,1416797818,1416797829,2,17,11
60703488@N00,7523,6,1416797829,1416797831,2,17,2
60703488@N00,7523,5,1416797831,1416797840,2,17,9
60703488@N00,7523,7,1416797840,1416797935,2,17,95
60703488@N00,7523,8,1416797935,1416798115,2,17,180
60703488@N00,7523,1,1416800667,1416800727,17,17,60
60703488@N00,7523,4,1416808358,1416808459,10,17,101
60703488@N00,7523,1,1416808625,1416808625,2,17,0
60703488@N00,7523,4,1416808625,1416808714,3,17,89
60703488@N00,7523,1,1416808714,1416808774,21,17,60
60703488@N00,7524,1,1416906110,1416906154,2,15,44
60703488@N00,7524,28,1416906154,1416906599,3,15,445
60703488@N00,7524,26,1416906599,1416907499,7,15,900
60703488@N00,7524,14,1416909231,1416909471,3,15,240
60703488@N00,7524,31,1416912399,1416913899,3,15,1500
60703488@N00,7524,26,1416916130,1416917030,16,15,900
60703488@N00,7524,7,1416917483,1416917505,2,15,22
60703488@N00,7524,6,1416917505,1416917625,2,15,120
60703488@N00,7524,28,1416917968,1416918868,6,15,900
60703488@N00,7524,1,1416922825,1416922885,6,15,60
60703488@N00,7524,4,1416922950,1416922959,2,15,9
60703488@N00,7524,1,1416922959,1416922959,2,15,0
60703488@N00,7524,26,1416922959,1416922966,2,15,7
60703488@N00,7524,1,1416922966,1416922974,2,15,8
60703488@N00,7524,26,1416922974,1416923874,20,15,900
60703488@N00,7525,1,1416967130,1416967133,2,8,3
60703488@N00,7525,16,1416967133,1416967403,7,8,270
60703488@N00,7525,15,1416976133,1416976133,3,8,0
60703488@N00,7525,16,1416976133,1416976134,5,8,1
60703488@N00,7525,15,1416976134,1416976134,3,8,0
60703488@N00,7525,16,1416976134,1416976141,3,8,7
60703488@N00,7525,15,1416976141,1416976142,2,8,1
60703488@N00,7525,16,1416976142,1416976412,6,8,270
60703488@N00,7526,16,1417008528,1417008798,2,1,270
60703488@N00,7527,25,1417261857,1417262697,2,5,840
60703488@N00,7527,12,1417263857,1417264097,2,5,240
60703488@N00,7527,30,1417265170,1417265780,2,5,610
60703488@N00,7527,16,1417265780,1417266050,14,5,270
60703488@N00,7527,25,1417269503,1417270343,9,5,840
60703488@N00,7528,16,1417312580,1417312850,1,1,270
60703488@N00,7529,25,1417644436,1417645276,1,1,840
60703488@N00,7530,1,1418257079,1418257139,1,1,60
60705682@N04,7531,26,1342073104,1342074004,1,1,900
60744963@N02,7532,28,1293442476,1293443376,1,1,900
60744963@N02,7533,15,1293575101,1293575371,1,1,270
60744963@N02,7534,28,1295247712,1295248612,3,5,900
60744963@N02,7534,24,1295253452,1295253463,2,5,11
60744963@N02,7534,15,1295253463,1295253716,2,5,253
60744963@N02,7534,26,1295253716,1295254616,2,5,900
60744963@N02,7534,1,1295257026,1295257086,1,5,60
60744963@N02,7535,25,1296116571,1296117411,1,1,840
60744963@N02,7536,31,1298716104,1298717604,3,10,1500
60744963@N02,7536,29,1298725766,1298725824,2,10,58
60744963@N02,7536,30,1298725824,1298726025,2,10,201
60744963@N02,7536,26,1298726025,1298726196,3,10,171
60744963@N02,7536,16,1298726196,1298726338,2,10,142
60744963@N02,7536,28,1298726338,1298726470,4,10,132
60744963@N02,7536,18,1298726470,1298726487,2,10,17
60744963@N02,7536,28,1298726487,1298727387,25,10,900
60744963@N02,7536,1,1298727567,1298727627,4,10,60
60744963@N02,7536,28,1298727672,1298728572,3,10,900
60744963@N02,7537,25,1299840881,1299841721,49,1,840
60744963@N02,7538,31,1300009810,1300011310,1,1,1500
60744963@N02,7539,26,1300446952,1300447031,3,7,79
60744963@N02,7539,16,1300447031,1300447283,6,7,252
60744963@N02,7539,26,1300447283,1300447437,2,7,154
60744963@N02,7539,16,1300447437,1300447707,2,7,270
60744963@N02,7539,26,1300449635,1300450535,2,7,900
60744963@N02,7539,29,1300450544,1300450822,4,7,278
60744963@N02,7539,31,1300450822,1300452322,3,7,1500
60744963@N02,7540,28,1302359438,1302360338,2,2,900
60744963@N02,7540,1,1302360370,1302360430,1,2,60
60744963@N02,7541,28,1302965103,1302966003,1,1,900
60781728@N00,7542,22,1439610046,1439610646,2,2,600
60781728@N00,7542,17,1439636110,1439636410,1,2,300
60792472@N00,7543,26,1357162899,1357163453,3,6,554
60792472@N00,7543,11,1357163453,1357163461,2,6,8
60792472@N00,7543,4,1357163461,1357163562,2,6,101
60792472@N00,7543,3,1357167037,1357167127,2,6,90
60792472@N00,7543,21,1357170294,1357170864,4,6,570
60792472@N00,7543,13,1357174300,1357174540,1,6,240
60805142@N00,7544,18,1454041258,1454041708,2,1,450
60861613@N00,7545,1,1443753340,1443753400,5,16,60
60861613@N00,7545,15,1443755462,1443755732,4,16,270
60861613@N00,7545,27,1443755930,1443755947,2,16,17
60861613@N00,7545,15,1443755947,1443756217,2,16,270
60861613@N00,7545,24,1443759850,1443760630,5,16,780
60861613@N00,7545,15,1443761767,1443762037,2,16,270
60861613@N00,7545,27,1443765078,1443765978,2,16,900
60861613@N00,7545,12,1443766726,1443766786,2,16,60
60861613@N00,7545,5,1443766786,1443766836,2,16,50
60861613@N00,7545,21,1443766836,1443766875,2,16,39
60861613@N00,7545,3,1443766875,1443766965,2,16,90
60861613@N00,7545,25,1443766996,1443767836,27,16,840
60861613@N00,7545,3,1443770503,1443770585,3,16,82
60861613@N00,7545,5,1443770585,1443770705,2,16,120
60861613@N00,7545,30,1443771273,1443772353,4,16,1080
60861613@N00,7545,28,1443772596,1443773496,1,16,900
60861613@N00,7546,1,1443842896,1443842956,8,13,60
60861613@N00,7546,16,1443847386,1443847656,3,13,270
60861613@N00,7546,26,1443848575,1443849475,3,13,900
60861613@N00,7546,31,1443854727,1443854798,2,13,71
60861613@N00,7546,20,1443854798,1443854815,2,13,17
60861613@N00,7546,31,1443854815,1443854879,2,13,64
60861613@N00,7546,20,1443854879,1443855419,4,13,540
60861613@N00,7546,29,1443858520,1443858669,2,13,149
60861613@N00,7546,31,1443858669,1443858783,2,13,114
60861613@N00,7546,22,1443858783,1443859022,2,13,239
60861613@N00,7546,31,1443859022,1443859332,2,13,310
60861613@N00,7546,30,1443859332,1443859504,2,13,172
60861613@N00,7546,10,1443859504,1443859744,1,13,240
60867422@N07,7547,22,1330178007,1330178607,1,1,600
60867422@N07,7548,30,1367330400,1367331480,2,1,1080
60867422@N07,7549,29,1388124972,1388125872,1,1,900
61023397@N08,7550,1,1371346671,1371346731,1,1,60
61024390@N00,7551,26,1470956235,1470957135,6,1,900
61026350@N06,7552,26,1390805157,1390806057,1,1,900
61027211@N00,7553,26,1305779178,1305780078,1,1,900
61055387@N00,7554,26,1223090657,1223091557,2,1,900
61081616@N04,7555,26,1284806600,1284807500,1,1,900
61102903@N02,7556,1,1376234134,1376234153,2,6,19
61102903@N02,7556,26,1376234153,1376234178,2,6,25
61102903@N02,7556,16,1376234178,1376234189,2,6,11
61102903@N02,7556,26,1376234189,1376234257,2,6,68
61102903@N02,7556,7,1376234257,1376234268,2,6,11
61102903@N02,7556,28,1376234268,1376235168,1,6,900
61102903@N02,7557,23,1454629219,1454629819,1,1,600
61102903@N02,7558,26,1454712997,1454713897,1,1,900
61153157@N00,7559,29,1364377465,1364378365,1,1,900
61198674@N00,7560,17,1262904035,1262904335,1,1,300
61207928@N04,7561,1,1307861804,1307861864,1,1,60
61207928@N04,7562,10,1309225704,1309225944,1,1,240
61207928@N04,7563,17,1309268354,1309268654,1,1,300
61207928@N04,7564,12,1309507700,1309507940,1,1,240
61207928@N04,7565,4,1309695924,1309696025,2,2,101
61207928@N04,7565,25,1309696262,1309697102,1,2,840
61207928@N04,7566,18,1309949377,1309949827,1,1,450
61207928@N04,7567,10,1312020217,1312020457,1,1,240
61207928@N04,7568,26,1354192796,1354193696,1,1,900
61207928@N04,7569,4,1354241884,1354241985,2,2,101
61207928@N04,7569,21,1354248478,1354249048,1,2,570
61207928@N04,7570,10,1404454293,1404454533,1,1,240
61207928@N04,7571,10,1404572640,1404572880,2,1,240
61228464@N03,7572,1,1381108507,1381108567,2,1,60
61228464@N03,7573,1,1381181285,1381181345,2,1,60
61228464@N03,7574,1,1395337662,1395337722,1,1,60
61228464@N03,7575,1,1395428517,1395428577,3,1,60
61237118@N00,7576,23,1317379143,1317379743,1,1,600
61242806@N00,7577,14,1320738016,1320738256,1,1,240
61258745@N03,7578,30,1273285356,1273286436,2,2,1080
61258745@N03,7578,22,1273287102,1273287702,1,2,600
61258745@N03,7579,25,1273989490,1273990330,1,1,840
61258745@N03,7580,23,1274330901,1274331501,1,1,600
61258745@N03,7581,18,1274489937,1274490387,1,1,450
61258745@N03,7582,26,1275194692,1275195592,1,1,900
61258745@N03,7583,11,1275223902,1275224142,1,1,240
61258745@N03,7584,28,1276319531,1276320431,2,3,900
61258745@N03,7584,26,1276321819,1276322719,3,3,900
61258745@N03,7584,3,1276325661,1276325751,1,3,90
61258745@N03,7585,18,1276958558,1276959008,1,1,450
61258745@N03,7586,20,1277427353,1277427893,1,1,540
61258745@N03,7587,26,1277475840,1277476740,1,1,900
61258745@N03,7588,17,1277981920,1277982220,1,1,300
61258745@N03,7589,28,1279334667,1279335567,1,1,900
61258745@N03,7590,28,1279422657,1279423557,2,5,900
61258745@N03,7590,19,1279425336,1279425876,4,5,540
61258745@N03,7590,18,1279437663,1279438113,2,5,450
61258745@N03,7590,29,1279438563,1279439463,2,5,900
61258745@N03,7590,20,1279439553,1279440093,1,5,540
61258745@N03,7591,31,1280123151,1280123832,2,2,681
61258745@N03,7591,22,1280123832,1280124432,1,2,600
61258745@N03,7592,29,1281751819,1281752719,1,1,900
61258745@N03,7593,12,1282438239,1282438479,1,1,240
61258745@N03,7594,18,1284193416,1284193866,2,2,450
61258745@N03,7594,12,1284195439,1284195679,1,2,240
61258745@N03,7595,28,1284762967,1284763867,2,2,900
61258745@N03,7595,14,1284766599,1284766839,1,2,240
61258745@N03,7596,1,1284797212,1284797272,1,1,60
61258745@N03,7597,29,1285723302,1285724202,2,2,900
61258745@N03,7597,17,1285726287,1285726587,1,2,300
61258745@N03,7598,1,1286605782,1286605842,2,4,60
61258745@N03,7598,31,1286628723,1286629647,2,4,924
61258745@N03,7598,29,1286629647,1286630128,2,4,481
61258745@N03,7598,30,1286630128,1286631208,1,4,1080
61258745@N03,7599,3,1289044085,1289044175,2,2,90
61258745@N03,7599,26,1289044237,1289045137,1,2,900
61258745@N03,7600,28,1289613877,1289614777,3,4,900
61258745@N03,7600,20,1289619743,1289620283,2,4,540
61258745@N03,7600,1,1289637403,1289637463,2,4,60
61258745@N03,7600,29,1289652145,1289653045,2,4,900
61258745@N03,7601,25,1289980744,1289981584,2,3,840
61258745@N03,7601,29,1289986338,1289987238,3,3,900
61258745@N03,7601,20,1289988191,1289988731,2,3,540
61258745@N03,7602,13,1291531433,1291531673,2,4,240
61258745@N03,7602,29,1291551232,1291552132,2,4,900
61258745@N03,7602,26,1291555177,1291556077,2,4,900
61258745@N03,7602,28,1291556260,1291557160,1,4,900
61258745@N03,7603,26,1291796672,1291797572,1,1,900
61258745@N03,7604,28,1295657287,1295658187,2,4,900
61258745@N03,7604,8,1295661546,1295661726,2,4,180
61258745@N03,7604,29,1295673684,1295674584,2,4,900
61258745@N03,7604,26,1295675399,1295676299,1,4,900
61258745@N03,7605,26,1296273064,1296273964,2,3,900
61258745@N03,7605,18,1296274318,1296274768,2,3,450
61258745@N03,7605,20,1296299438,1296299978,3,3,540
61258745@N03,7606,28,1298240825,1298241725,2,9,900
61258745@N03,7606,1,1298243642,1298243702,2,9,60
61258745@N03,7606,24,1298244895,1298245403,2,9,508
61258745@N03,7606,12,1298245403,1298245643,2,9,240
61258745@N03,7606,27,1298247347,1298247523,2,9,176
61258745@N03,7606,24,1298247523,1298248303,3,9,780
61258745@N03,7606,12,1298250229,1298250469,2,9,240
61258745@N03,7606,4,1298251467,1298251568,2,9,101
61258745@N03,7606,28,1298273768,1298274668,1,9,900
61258745@N03,7607,28,1298702045,1298702945,2,5,900
61258745@N03,7607,26,1298706236,1298707136,3,5,900
61258745@N03,7607,18,1298710545,1298710995,2,5,450
61258745@N03,7607,30,1298716527,1298717607,2,5,1080
61258745@N03,7607,28,1298731512,1298732412,2,5,900
61258745@N03,7608,29,1300144307,1300145207,7,2,900
61258745@N03,7608,23,1300173482,1300174082,1,2,600
61258745@N03,7609,19,1301117506,1301118046,3,3,540
61258745@N03,7609,7,1301118450,1301118630,2,3,180
61258745@N03,7609,10,1301121475,1301121715,1,3,240
61258745@N03,7610,26,1302331446,1302332346,3,4,900
61258745@N03,7610,15,1302336146,1302336416,2,4,270
61258745@N03,7610,18,1302337538,1302337988,2,4,450
61258745@N03,7610,26,1302341047,1302341947,1,4,900
61258745@N03,7611,20,1303018831,1303019371,3,5,540
61258745@N03,7611,22,1303032866,1303033466,3,5,600
61258745@N03,7611,18,1303038017,1303038467,2,5,450
61258745@N03,7611,20,1303038479,1303039019,2,5,540
61258745@N03,7611,23,1303039162,1303039762,2,5,600
61258745@N03,7612,27,1305359615,1305360515,1,1,900
61258745@N03,7613,27,1305984229,1305985129,3,2,900
61258745@N03,7613,1,1305987107,1305987167,1,2,60
61258745@N03,7614,26,1306742136,1306743036,1,1,900
61258745@N03,7615,29,1306987119,1306987191,2,12,72
61258745@N03,7615,25,1306987191,1306987207,2,12,16
61258745@N03,7615,28,1306987207,1306987216,2,12,9
61258745@N03,7615,26,1306987216,1306987222,2,12,6
61258745@N03,7615,30,1306987222,1306987235,3,12,13
61258745@N03,7615,13,1306987235,1306987243,2,12,8
61258745@N03,7615,26,1306987243,1306987246,2,12,3
61258745@N03,7615,1,1306987246,1306987263,2,12,17
61258745@N03,7615,29,1306987263,1306987276,2,12,13
61258745@N03,7615,5,1306987276,1306987297,2,12,21
61258745@N03,7615,16,1306987297,1306987302,2,12,5
61258745@N03,7615,22,1306987302,1306987902,1,12,600
61258745@N03,7616,12,1311487821,1311488061,1,1,240
61258745@N03,7617,26,1316241239,1316242139,1,1,900
61258745@N03,7618,21,1316848308,1316848878,1,1,570
61261095@N02,7619,26,1330842956,1330843398,2,7,442
61261095@N02,7619,29,1330843398,1330843672,2,7,274
61261095@N02,7619,20,1330843672,1330844212,3,7,540
61261095@N02,7619,18,1330850976,1330851426,5,7,450
61261095@N02,7619,26,1330852556,1330853456,3,7,900
61261095@N02,7619,25,1330857683,1330858523,3,7,840
61261095@N02,7619,30,1330874433,1330875513,2,7,1080
61261095@N02,7620,10,1330922881,1330923121,3,9,240
61261095@N02,7620,30,1330924964,1330926044,2,9,1080
61261095@N02,7620,23,1330926820,1330927313,2,9,493
61261095@N02,7620,20,1330927313,1330927853,2,9,540
61261095@N02,7620,29,1330928070,1330928542,2,9,472
61261095@N02,7620,13,1330928542,1330928782,2,9,240
61261095@N02,7620,21,1330932793,1330932883,2,9,90
61261095@N02,7620,11,1330932883,1330933123,2,9,240
61261095@N02,7620,26,1330933486,1330934386,2,9,900
61261095@N02,7621,8,1331005254,1331005434,2,9,180
61261095@N02,7621,11,1331008073,1331008313,2,9,240
61261095@N02,7621,26,1331009481,1331010381,4,9,900
61261095@N02,7621,31,1331012046,1331012080,2,9,34
61261095@N02,7621,22,1331012080,1331012680,3,9,600
61261095@N02,7621,31,1331015019,1331016519,2,9,1500
61261095@N02,7621,30,1331017560,1331017745,2,9,185
61261095@N02,7621,31,1331017745,1331018328,2,9,583
61261095@N02,7621,22,1331018328,1331018928,1,9,600
61261095@N02,7622,26,1331105553,1331106453,2,4,900
61261095@N02,7622,30,1331112431,1331113511,2,4,1080
61261095@N02,7622,14,1331115205,1331115445,2,4,240
61261095@N02,7622,19,1331117369,1331117909,2,4,540
61282509@N08,7623,20,1277344803,1277345343,1,1,540
61357107@N05,7624,26,1337699471,1337700371,1,1,900
61363312@N00,7625,28,1387100802,1387101702,3,3,900
61363312@N00,7625,20,1387105305,1387105845,4,3,540
61363312@N00,7625,1,1387106439,1387106499,1,3,60
61363312@N00,7626,26,1387182380,1387183280,2,1,900
61363312@N00,7627,18,1431817484,1431817934,1,1,450
61368956@N00,7628,17,1316062556,1316062685,3,2,129
61368956@N00,7628,1,1316062685,1316062745,1,2,60
61403949@N00,7629,26,1239792857,1239793757,2,2,900
61403949@N00,7629,29,1239794006,1239794906,1,2,900
61404390@N00,7630,29,1313623035,1313623935,2,2,900
61404390@N00,7630,25,1313629497,1313630337,1,2,840
61451953@N02,7631,28,1338284111,1338285011,1,1,900
61451953@N02,7632,28,1339666413,1339667313,1,1,900
61459002@N04,7633,1,1365857075,1365857135,1,1,60
61485851@N06,7634,26,1332156195,1332157095,4,2,900
61485851@N06,7634,28,1332166677,1332167577,1,2,900
61510830@N02,7635,28,1333247017,1333247917,1,1,900
61511684@N00,7636,26,1258842324,1258843224,65,1,900
61517165@N00,7637,1,1354173420,1354173480,1,1,60
61601523@N00,7638,26,1450739384,1450740284,2,2,900
61601523@N00,7638,4,1450741248,1450741349,2,2,101
61601523@N00,7639,26,1450784334,1450785234,2,2,900
61601523@N00,7639,28,1450787073,1450787973,1,2,900
61614489@N00,7640,17,1351503072,1351503372,1,1,300
61614489@N00,7641,20,1351656425,1351656965,1,1,540
61644290@N00,7642,26,1283763992,1283764892,1,1,900
61644290@N00,7643,20,1301195161,1301195701,1,1,540
61644290@N00,7644,28,1376264644,1376265544,2,1,900
61644290@N00,7645,1,1390362047,1390362107,1,1,60
61644290@N00,7646,1,1396790515,1396790575,2,2,60
61644290@N00,7646,25,1396790690,1396791530,1,2,840
61644290@N00,7647,19,1409551801,1409552341,2,1,540
61702169@N02,7648,28,1357986142,1357987042,1,1,900
61716210@N07,7649,3,1287051534,1287051624,2,2,90
61716210@N07,7649,26,1287051843,1287052743,1,2,900
61761579@N00,7650,19,1428541284,1428541824,2,3,540
61761579@N00,7650,23,1428565244,1428565844,2,3,600
61761579@N00,7650,18,1428570634,1428571084,3,3,450
61763311@N00,7651,19,1416904135,1416904675,4,13,540
61763311@N00,7651,29,1416916178,1416916394,2,13,216
61763311@N00,7651,19,1416916394,1416916934,4,13,540
61763311@N00,7651,25,1416918700,1416918858,2,13,158
61763311@N00,7651,19,1416918858,1416919025,2,13,167
61763311@N00,7651,25,1416919025,1416919212,2,13,187
61763311@N00,7651,19,1416919212,1416919474,2,13,262
61763311@N00,7651,25,1416919474,1416919508,2,13,34
61763311@N00,7651,19,1416919508,1416919716,2,13,208
61763311@N00,7651,25,1416919716,1416920492,3,13,776
61763311@N00,7651,19,1416920492,1416920662,2,13,170
61763311@N00,7651,25,1416920662,1416921084,3,13,422
61763311@N00,7651,19,1416921084,1416921624,2,13,540
61763311@N00,7652,19,1416950521,1416951061,4,1,540
61827589@N06,7653,28,1349763743,1349764643,3,2,900
61827589@N06,7653,29,1349769425,1349770325,5,2,900
61827589@N06,7654,28,1353150329,1353151229,1,1,900
61827589@N06,7655,14,1356684280,1356684520,2,2,240
61827589@N06,7655,28,1356700499,1356701399,1,2,900
61827589@N06,7656,28,1377420399,1377421299,3,2,900
61827589@N06,7656,6,1377422623,1377422743,1,2,120
61827589@N06,7657,28,1378686360,1378687260,2,2,900
61827589@N06,7657,18,1378687516,1378687966,1,2,450
61838453@N08,7658,18,1449989630,1449990080,1,1,450
61905010@N03,7659,26,1409731849,1409732749,2,1,900
61906163@N00,7660,25,1293838850,1293839690,10,5,840
61906163@N00,7660,26,1293847140,1293847298,4,5,158
61906163@N00,7660,30,1293847298,1293848378,10,5,1080
61906163@N00,7660,26,1293848875,1293849775,2,5,900
61906163@N00,7660,28,1293850183,1293851083,11,5,900
61938758@N08,7661,1,1420364764,1420364824,6,1,60
61938758@N08,7662,1,1420438868,1420438928,1,1,60
61938758@N08,7663,1,1420493217,1420493277,4,5,60
61938758@N08,7663,30,1420499068,1420500148,2,5,1080
61938758@N08,7663,1,1420500290,1420500350,4,5,60
61938758@N08,7663,23,1420506891,1420507491,2,5,600
61938758@N08,7663,1,1420534537,1420534597,4,5,60
61938758@N08,7664,1,1420588964,1420589024,5,1,60
61938758@N08,7665,27,1420673068,1420673968,2,2,900
61938758@N08,7665,26,1420681702,1420682602,1,2,900
61943091@N00,7666,1,1405141105,1405141165,1,1,60
61967208@N07,7667,16,1307746758,1307747028,1,1,270
61971626@N00,7668,11,1291183492,1291183732,1,1,240
62001041@N08,7669,24,1342786668,1342786700,3,6,32
62001041@N08,7669,28,1342786700,1342786933,2,6,233
62001041@N08,7669,12,1342786933,1342787173,2,6,240
62001041@N08,7669,28,1342787659,1342788559,2,6,900
62001041@N08,7669,27,1342788876,1342788897,2,6,21
62001041@N08,7669,19,1342788897,1342789437,1,6,540
62086509@N00,7670,30,1375422385,1375423465,3,1,1080
62102776@N02,7671,3,1299874900,1299874990,1,1,90
62102776@N02,7672,28,1331707731,1331708631,1,1,900
62102776@N02,7673,5,1331768971,1331769091,2,3,120
62102776@N02,7673,11,1331769437,1331769677,2,3,240
62102776@N02,7673,25,1331772366,1331773206,1,3,840
62102776@N02,7674,28,1344317117,1344318017,3,2,900
62102776@N02,7674,29,1344333603,1344334503,1,2,900
62102776@N02,7675,20,1344403185,1344403725,2,2,540
62102776@N02,7675,25,1344421938,1344422778,1,2,840
62102776@N02,7676,17,1344471278,1344471578,2,4,300
62102776@N02,7676,20,1344473489,1344474029,2,4,540
62102776@N02,7676,14,1344479572,1344479812,2,4,240
62102776@N02,7676,26,1344505607,1344506507,1,4,900
62102776@N02,7677,29,1344581767,1344582667,2,2,900
62102776@N02,7677,18,1344599278,1344599728,1,2,450
62102776@N02,7678,8,1344662292,1344662472,1,1,180
62102776@N02,7679,29,1344741393,1344742293,1,1,900
62102776@N02,7680,28,1344824247,1344825147,2,1,900
62102776@N02,7681,30,1345080917,1345081997,1,1,1080
62102776@N02,7682,28,1345259368,1345260268,1,1,900
62102776@N02,7683,29,1345357490,1345358390,1,1,900
62102776@N02,7684,5,1345607016,1345607136,1,1,120
62102776@N02,7685,7,1345774162,1345774342,1,1,180
62102776@N02,7686,12,1346056561,1346056801,1,1,240
62102776@N02,7687,29,1346384747,1346385647,1,1,900
62102776@N02,7688,18,1346475354,1346475804,1,1,450
62102776@N02,7689,29,1346821865,1346822765,1,1,900
62102776@N02,7690,30,1347101072,1347102152,1,1,1080
62102776@N02,7691,26,1362177896,1362178796,2,3,900
62102776@N02,7691,29,1362191208,1362192108,2,3,900
62102776@N02,7691,22,1362216377,1362216977,1,3,600
62102776@N02,7692,17,1362277690,1362277990,1,1,300
62102776@N02,7693,10,1362309624,1362309864,1,1,240
62102776@N02,7694,24,1362383090,1362383870,1,1,780
62102776@N02,7695,7,1362448353,1362448533,2,3,180
62102776@N02,7695,28,1362467988,1362468888,2,3,900
62102776@N02,7695,17,1362483485,1362483785,1,3,300
62111428@N06,7696,26,1280584800,1280585700,1,1,900
62121361@N03,7697,12,1313501875,1313502115,2,3,240
62121361@N03,7697,21,1313502136,1313502706,2,3,570
62121361@N03,7697,24,1313512071,1313512851,2,3,780
62121361@N03,7698,21,1316296060,1316296630,2,2,570
62121361@N03,7698,16,1316296820,1316297090,1,2,270
62121361@N03,7699,25,1321569057,1321569897,2,2,840
62121361@N03,7699,26,1321570599,1321571499,1,2,900
62121361@N03,7700,26,1323408957,1323409156,2,4,199
62121361@N03,7700,28,1323409156,1323410056,2,4,900
62121361@N03,7700,24,1323424949,1323425729,2,4,780
62121361@N03,7700,28,1323428534,1323429434,1,4,900
62121361@N03,7701,26,1324008308,1324009208,2,6,900
62121361@N03,7701,24,1324010680,1324011460,2,6,780
62121361@N03,7701,12,1324012275,1324012515,2,6,240
62121361@N03,7701,6,1324012916,1324013036,2,6,120
62121361@N03,7701,28,1324021901,1324022781,2,6,880
62121361@N03,7701,26,1324022781,1324023681,1,6,900
62121361@N03,7702,24,1325462172,1325462441,2,4,269
62121361@N03,7702,12,1325462441,1325462681,2,4,240
62121361@N03,7702,30,1325464759,1325465839,2,4,1080
62121361@N03,7702,24,1325492210,1325492990,1,4,780
62121361@N03,7703,24,1326172662,1326173379,4,8,717
62121361@N03,7703,15,1326173379,1326173649,2,8,270
62121361@N03,7703,24,1326174008,1326174728,2,8,720
62121361@N03,7703,1,1326174728,1326174788,2,8,60
62121361@N03,7703,16,1326183186,1326183456,2,8,270
62121361@N03,7703,21,1326184717,1326185287,2,8,570
62121361@N03,7703,30,1326186765,1326187845,2,8,1080
62121361@N03,7703,26,1326188109,1326189009,1,8,900
62121361@N03,7704,26,1326766446,1326767346,2,5,900
62121361@N03,7704,1,1326770461,1326770521,2,5,60
62121361@N03,7704,15,1326771230,1326771500,2,5,270
62121361@N03,7704,26,1326779027,1326779927,2,5,900
62121361@N03,7704,30,1326782657,1326783737,1,5,1080
62121361@N03,7705,30,1328335939,1328337019,1,1,1080
62121361@N03,7706,29,1329644879,1329645779,4,1,900
62121361@N03,7707,12,1329961984,1329962224,2,1,240
62121361@N03,7708,31,1330538424,1330539924,2,2,1500
62121361@N03,7708,26,1330541437,1330542337,2,2,900
62121361@N03,7709,24,1332233667,1332234447,2,1,780
62121361@N03,7710,26,1332309135,1332310035,3,3,900
62121361@N03,7710,21,1332310036,1332310606,4,3,570
62121361@N03,7710,26,1332312415,1332313315,1,3,900
62121361@N03,7711,24,1332396010,1332396790,1,1,780
62121361@N03,7712,16,1332752660,1332752660,2,3,0
62121361@N03,7712,26,1332752660,1332753560,5,3,900
62121361@N03,7712,29,1332756163,1332757063,2,3,900
62121361@N03,7713,12,1332985746,1332985986,2,5,240
62121361@N03,7713,21,1332986533,1332987103,2,5,570
62121361@N03,7713,13,1332993903,1332994143,2,5,240
62121361@N03,7713,15,1333005341,1333005611,4,5,270
62121361@N03,7713,30,1333010773,1333011853,4,5,1080
62121361@N03,7714,26,1335350015,1335350915,1,1,900
62121361@N03,7715,1,1336633136,1336633196,2,4,60
62121361@N03,7715,24,1336633211,1336633991,2,4,780
62121361@N03,7715,12,1336634054,1336634294,2,4,240
62121361@N03,7715,26,1336634570,1336635470,3,4,900
62121361@N03,7716,20,1337608695,1337609235,3,2,540
62121361@N03,7716,29,1337609770,1337610670,1,2,900
62121361@N03,7717,12,1338961565,1338961805,2,3,240
62121361@N03,7717,21,1338961885,1338962455,2,3,570
62121361@N03,7717,26,1338963359,1338964259,1,3,900
62121361@N03,7718,24,1339128598,1339129378,2,1,780
62121361@N03,7719,12,1339730292,1339730532,1,1,240
62121361@N03,7720,24,1340082096,1340082876,5,1,780
62121361@N03,7721,21,1342002694,1342003264,1,1,570
62121361@N03,7722,24,1344250271,1344251051,1,1,780
62121361@N03,7723,1,1345003447,1345003507,2,2,60
62121361@N03,7723,24,1345004280,1345005060,3,2,780
62121361@N03,7724,21,1345809607,1345810177,1,1,570
62121361@N03,7725,26,1346422142,1346423042,2,1,900
62121361@N03,7726,30,1349253910,1349254990,1,1,1080
62121361@N03,7727,24,1350170701,1350171481,2,1,780
62121361@N03,7728,21,1354011963,1354012533,2,2,570
62121361@N03,7728,26,1354013146,1354014046,1,2,900
62121361@N03,7729,26,1358160104,1358161004,1,1,900
62121361@N03,7730,26,1386646666,1386647566,1,1,900
62208823@N00,7731,18,1366545122,1366545572,1,1,450
62208823@N00,7732,25,1366606111,1366606951,1,1,840
62213890@N00,7733,16,1229511309,1229511579,1,1,270
62222647@N00,7734,1,1403779954,1403780014,1,1,60
62236593@N04,7735,26,1364098202,1364099102,1,1,900
62236593@N04,7736,26,1393124383,1393125283,2,3,900
62236593@N04,7736,27,1393125650,1393126550,2,3,900
62236593@N04,7736,19,1393133108,1393133648,2,3,540
62236593@N04,7737,18,1440300885,1440301335,1,1,450
62236593@N04,7738,18,1440332026,1440332476,2,2,450
62236593@N04,7738,28,1440345318,1440346218,1,2,900
62236593@N04,7739,23,1440587111,1440587711,1,1,600
62245821@N04,7740,1,1354176685,1354176745,1,1,60
62297532@N00,7741,25,1355898681,1355899521,1,1,840
62297532@N00,7742,25,1356078818,1356079658,1,1,840
62323301@N08,7743,24,1304558876,1304558996,2,3,120
62323301@N08,7743,26,1304558996,1304559896,2,3,900
62323301@N08,7743,4,1304564331,1304564432,1,3,101
62323630@N06,7744,16,1304225718,1304225988,1,1,270
62372928@N03,7745,6,1399341583,1399341703,1,1,120
62392176@N00,7746,26,1227484713,1227485164,3,7,451
62392176@N00,7746,16,1227485164,1227485396,2,7,232
62392176@N00,7746,26,1227485396,1227485451,2,7,55
62392176@N00,7746,7,1227485451,1227485631,3,7,180
62392176@N00,7746,4,1227487542,1227487643,8,7,101
62392176@N00,7746,26,1227488329,1227489229,3,7,900
62392176@N00,7746,11,1227496366,1227496606,7,7,240
62392176@N00,7747,28,1227569300,1227570200,2,9,900
62392176@N00,7747,11,1227574950,1227575190,2,9,240
62392176@N00,7747,4,1227585164,1227585265,4,9,101
62392176@N00,7747,7,1227585593,1227585773,2,9,180
62392176@N00,7747,5,1227585849,1227585969,4,9,120
62392176@N00,7747,6,1227586155,1227586275,4,9,120
62392176@N00,7747,26,1227586466,1227587366,2,9,900
62392176@N00,7747,28,1227597864,1227598764,2,9,900
62392176@N00,7747,26,1227602772,1227603672,5,9,900
62392176@N00,7748,24,1227656660,1227657440,5,3,780
62392176@N00,7748,7,1227662542,1227662722,8,3,180
62392176@N00,7748,4,1227663049,1227663150,1,3,101
62392176@N00,7749,20,1227707716,1227708256,3,1,540
62392176@N00,7750,25,1227784625,1227784935,3,4,310
62392176@N00,7750,21,1227784935,1227785505,6,4,570
62392176@N00,7750,16,1227788688,1227788958,4,4,270
62392176@N00,7750,1,1227790269,1227790329,1,4,60
62392176@N00,7751,26,1281046684,1281047584,2,13,900
62392176@N00,7751,4,1281048170,1281048271,3,13,101
62392176@N00,7751,11,1281051035,1281051275,7,13,240
62392176@N00,7751,13,1281051535,1281051775,5,13,240
62392176@N00,7751,11,1281054272,1281054335,2,13,63
62392176@N00,7751,21,1281054335,1281054365,2,13,30
62392176@N00,7751,11,1281054365,1281054605,2,13,240
62392176@N00,7751,16,1281064001,1281064271,3,13,270
62392176@N00,7751,23,1281066131,1281066731,2,13,600
62392176@N00,7751,19,1281066788,1281067328,2,13,540
62392176@N00,7751,31,1281070266,1281071766,3,13,1500
62392176@N00,7751,29,1281072347,1281073247,4,13,900
62392176@N00,7751,31,1281075532,1281077032,2,13,1500
62392176@N00,7752,16,1281137031,1281137301,3,1,270
62392176@N00,7753,28,1308970006,1308970906,4,1,900
62392176@N00,7754,28,1309044509,1309045409,8,1,900
62392176@N00,7755,28,1309129569,1309130469,22,1,900
62392176@N00,7756,28,1309218197,1309219097,20,1,900
62392176@N00,7757,1,1407831538,1407831598,5,2,60
62392176@N00,7757,12,1407832871,1407833111,3,2,240
62392176@N00,7758,30,1407916095,1407917175,4,3,1080
62392176@N00,7758,25,1407923843,1407924683,5,3,840
62392176@N00,7758,8,1407925117,1407925297,2,3,180
62392176@N00,7759,7,1407969350,1407969530,2,5,180
62392176@N00,7759,17,1407975942,1407976242,2,5,300
62392176@N00,7759,27,1407977591,1407978491,2,5,900
62392176@N00,7759,31,1407981502,1407981599,2,5,97
62392176@N00,7759,22,1407981599,1407982199,4,5,600
62392176@N00,7760,5,1408101831,1408101951,3,3,120
62392176@N00,7760,3,1408101952,1408102035,3,3,83
62392176@N00,7760,5,1408102035,1408102155,1,3,120
62416932@N02,7761,28,1304923245,1304924145,1,1,900
62433076@N00,7762,1,1191259464,1191259524,4,16,60
62433076@N00,7762,28,1191259623,1191260523,6,16,900
62433076@N00,7762,26,1191263732,1191264534,3,16,802
62433076@N00,7762,18,1191264534,1191264984,29,16,450
62433076@N00,7762,23,1191266645,1191267139,5,16,494
62433076@N00,7762,19,1191267139,1191267679,6,16,540
62433076@N00,7762,29,1191268250,1191269150,16,16,900
62433076@N00,7762,22,1191271897,1191272497,8,16,600
62433076@N00,7762,29,1191275703,1191276603,4,16,900
62433076@N00,7762,20,1191280863,1191281016,3,16,153
62433076@N00,7762,22,1191281016,1191281616,2,16,600
62433076@N00,7762,13,1191281665,1191281905,2,16,240
62433076@N00,7762,30,1191282665,1191283745,15,16,1080
62433076@N00,7762,10,1191285414,1191285654,4,16,240
62433076@N00,7762,30,1191287631,1191288711,3,16,1080
62433076@N00,7762,26,1191289576,1191290476,1,16,900
62433076@N00,7763,15,1191343403,1191343673,7,4,270
62433076@N00,7763,16,1191344021,1191344291,2,4,270
62433076@N00,7763,27,1191345245,1191346145,4,4,900
62433076@N00,7763,15,1191346489,1191346759,52,4,270
62443344@N00,7764,28,1240580377,1240581277,2,1,900
62443344@N00,7765,23,1256811377,1256811977,1,1,600
62443344@N00,7766,26,1259834249,1259835149,1,1,900
62443344@N00,7767,26,1265676252,1265676670,3,2,418
62443344@N00,7767,31,1265676670,1265678170,12,2,1500
62443344@N00,7768,1,1288146829,1288146889,2,6,60
62443344@N00,7768,10,1288148231,1288148471,4,6,240
62443344@N00,7768,20,1288149285,1288149825,11,6,540
62443344@N00,7768,29,1288150699,1288151599,3,6,900
62443344@N00,7768,17,1288153656,1288153956,2,6,300
62443344@N00,7768,23,1288159543,1288160143,6,6,600
62443344@N00,7769,10,1298604163,1298604403,2,4,240
62443344@N00,7769,30,1298604615,1298605695,2,4,1080
62443344@N00,7769,1,1298624479,1298624539,3,4,60
62443344@N00,7769,17,1298629273,1298629573,1,4,300
62443344@N00,7770,27,1316748451,1316749262,2,9,811
62443344@N00,7770,24,1316749262,1316750042,2,9,780
62443344@N00,7770,17,1316750436,1316750736,2,9,300
62443344@N00,7770,27,1316754757,1316755657,2,9,900
62443344@N00,7770,1,1316759421,1316759481,22,9,60
62443344@N00,7770,30,1316765183,1316766263,3,9,1080
62443344@N00,7770,13,1316779905,1316780145,2,9,240
62443344@N00,7770,31,1316783131,1316784631,3,9,1500
62443344@N00,7770,24,1316784858,1316785638,1,9,780
62443344@N00,7771,26,1324340122,1324340471,2,6,349
62443344@N00,7771,28,1324340471,1324341371,2,6,900
62443344@N00,7771,23,1324342561,1324343161,13,6,600
62443344@N00,7771,29,1324347711,1324347866,2,6,155
62443344@N00,7771,26,1324347866,1324348766,9,6,900
62443344@N00,7771,25,1324355803,1324356643,11,6,840
62443344@N00,7772,27,1328667804,1328668704,2,4,900
62443344@N00,7772,22,1328673789,1328674389,3,4,600
62443344@N00,7772,30,1328675154,1328675817,3,4,663
62443344@N00,7772,29,1328675817,1328676717,1,4,900
62443344@N00,7773,28,1330487476,1330488376,2,19,900
62443344@N00,7773,20,1330489078,1330489618,2,19,540
62443344@N00,7773,28,1330491847,1330492747,4,19,900
62443344@N00,7773,30,1330494254,1330495334,2,19,1080
62443344@N00,7773,26,1330495467,1330496367,5,19,900
62443344@N00,7773,28,1330497134,1330498034,2,19,900
62443344@N00,7773,18,1330498645,1330499095,2,19,450
62443344@N00,7773,26,1330503096,1330503996,7,19,900
62443344@N00,7773,23,1330506750,1330507350,3,19,600
62443344@N00,7773,20,1330508930,1330509470,3,19,540
62443344@N00,7773,22,1330514103,1330514703,2,19,600
62443344@N00,7773,27,1330518060,1330518960,2,19,900
62443344@N00,7773,26,1330521127,1330522027,2,19,900
62443344@N00,7773,23,1330522768,1330523368,3,19,600
62443344@N00,7773,7,1330531390,1330531570,3,19,180
62443344@N00,7773,23,1330535018,1330535618,3,19,600
62443344@N00,7773,17,1330536839,1330537139,3,19,300
62443344@N00,7773,25,1330537777,1330538617,13,19,840
62443344@N00,7773,26,1330540051,1330540951,4,19,900
62443344@N00,7774,26,1331620930,1331621830,16,1,900
62443344@N00,7775,23,1336954193,1336954793,15,1,600
62443344@N00,7776,26,1350859899,1350860799,17,1,900
62443344@N00,7777,20,1350928501,1350929041,22,3,540
62443344@N00,7777,23,1350931605,1350931691,2,3,86
62443344@N00,7777,20,1350931691,1350932231,24,3,540
62443344@N00,7778,28,1350985218,1350986118,13,1,900
62443344@N00,7779,16,1351151810,1351152080,3,2,270
62443344@N00,7779,6,1351153182,1351153302,1,2,120
62443344@N00,7780,28,1378775238,1378776138,20,1,900
62443344@N00,7781,21,1444899585,1444900155,1,1,570
62460908@N07,7782,16,1305840108,1305840378,1,1,270
62460908@N07,7783,28,1329611692,1329612592,2,1,900
62460908@N07,7784,26,1342498530,1342499430,1,1,900
62460908@N07,7785,26,1357417339,1357418239,1,1,900
62460908@N07,7786,28,1357704860,1357705760,1,1,900
62460908@N07,7787,28,1358557637,1358558537,1,1,900
62460908@N07,7788,28,1358648902,1358649802,1,1,900
62460908@N07,7789,16,1360398054,1360398324,1,1,270
62460908@N07,7790,28,1361074458,1361075358,1,1,900
62460908@N07,7791,24,1361254354,1361255134,1,1,780
62460908@N07,7792,26,1361508286,1361509186,1,1,900
62460908@N07,7793,12,1361602052,1361602292,1,1,240
62460908@N07,7794,26,1361690568,1361691468,1,1,900
62460908@N07,7795,15,1362271950,1362272220,1,1,270
62460908@N07,7796,7,1362873634,1362873814,1,1,180
62460908@N07,7797,1,1364015120,1364015180,1,1,60
62460908@N07,7798,1,1364183486,1364183546,2,1,60
62460908@N07,7799,16,1364621425,1364621695,1,1,270
62460908@N07,7800,1,1364697163,1364697223,1,1,60
62460908@N07,7801,1,1365137386,1365137446,1,1,60
62460908@N07,7802,1,1366618645,1366618705,1,1,60
62460908@N07,7803,1,1366698862,1366698922,1,1,60
62460908@N07,7804,1,1366957881,1366957941,1,1,60
62460908@N07,7805,1,1367044121,1367044181,1,1,60
62460908@N07,7806,1,1367128499,1367128559,1,1,60
62460908@N07,7807,1,1367632033,1367632093,3,1,60
62460908@N07,7808,5,1369545149,1369545269,1,1,120
62460908@N07,7809,1,1370578085,1370578145,1,1,60
62460908@N07,7810,26,1371861055,1371861955,2,2,900
62460908@N07,7810,1,1371880244,1371880304,1,2,60
62460908@N07,7811,1,1372900825,1372900885,1,1,60
62460908@N07,7812,12,1375081435,1375081675,1,1,240
62460908@N07,7813,1,1377390223,1377390283,1,1,60
62460908@N07,7814,30,1377830627,1377831707,1,1,1080
62460908@N07,7815,1,1378263060,1378263120,1,1,60
62460908@N07,7816,1,1379818578,1379818638,1,1,60
62460908@N07,7817,25,1380259599,1380260439,1,1,840
62460908@N07,7818,1,1382234129,1382234189,1,1,60
62460908@N07,7819,20,1382414716,1382415256,1,1,540
62460908@N07,7820,1,1382768170,1382768230,1,1,60
62460908@N07,7821,1,1382830765,1382830825,2,1,60
62460908@N07,7822,1,1382944604,1382944664,1,1,60
62460908@N07,7823,1,1383096453,1383096513,1,1,60
62460908@N07,7824,1,1383208286,1383208346,1,1,60
62460908@N07,7825,12,1383528909,1383529149,1,1,240
62460908@N07,7826,1,1384562248,1384562308,1,1,60
62460908@N07,7827,26,1384672282,1384673182,1,1,900
62460908@N07,7828,26,1385239437,1385240337,1,1,900
62460908@N07,7829,4,1386464190,1386464291,1,1,101
62460908@N07,7830,1,1388200534,1388200594,1,1,60
62460908@N07,7831,1,1388281233,1388281293,1,1,60
62460908@N07,7832,26,1389489807,1389490707,1,1,900
62460908@N07,7833,1,1394934608,1394934668,1,1,60
62460908@N07,7834,1,1395988853,1395988913,1,1,60
62460908@N07,7835,1,1400719229,1400719289,1,1,60
62460908@N07,7836,26,1401497851,1401498751,1,1,900
62460908@N07,7837,19,1403260573,1403261113,1,1,540
62460908@N07,7838,20,1407549721,1407550261,1,1,540
62460908@N07,7839,26,1410066724,1410067624,1,1,900
62460908@N07,7840,19,1411208863,1411209403,1,1,540
62460908@N07,7841,26,1413598906,1413599806,1,1,900
62460908@N07,7842,19,1413771078,1413771618,1,1,540
62460908@N07,7843,19,1415339691,1415340231,1,1,540
62460908@N07,7844,19,1419653714,1419654254,1,1,540
62552018@N06,7845,8,1371772381,1371772561,1,1,180
62552018@N06,7846,20,1379056043,1379056583,1,1,540
62552018@N06,7847,26,1381227909,1381228809,1,1,900
62552018@N06,7848,1,1395880443,1395880503,1,1,60
62552018@N06,7849,13,1395913689,1395913929,1,1,240
62566148@N00,7850,30,1344244227,1344245307,2,1,1080
62566148@N00,7851,30,1344330991,1344332071,7,1,1080
62566148@N00,7852,30,1344450078,1344451158,1,1,1080
62566148@N00,7853,30,1344507015,1344508095,3,1,1080
62566937@N00,7854,26,1392502817,1392503717,3,10,900
62566937@N00,7854,30,1392509250,1392510330,2,10,1080
62566937@N00,7854,4,1392515476,1392515577,2,10,101
62566937@N00,7854,21,1392515795,1392515993,2,10,198
62566937@N00,7854,5,1392515993,1392516113,3,10,120
62566937@N00,7854,21,1392516225,1392516795,2,10,570
62566937@N00,7854,24,1392518648,1392519428,2,10,780
62566937@N00,7854,15,1392520258,1392520528,2,10,270
62566937@N00,7854,16,1392529906,1392529908,2,10,2
62566937@N00,7854,28,1392529908,1392530808,1,10,900
62583568@N00,7855,13,1317457439,1317457679,1,1,240
62632667@N04,7856,18,1349417776,1349418226,1,1,450
62632667@N04,7857,29,1383450676,1383451576,2,1,900
62647068@N00,7858,26,1212310364,1212310635,2,2,271
62647068@N00,7858,23,1212310635,1212311235,6,2,600
62783804@N05,7859,28,1286328952,1286329852,2,4,900
62783804@N05,7859,29,1286332165,1286333065,3,4,900
62783804@N05,7859,30,1286338375,1286339455,3,4,1080
62783804@N05,7859,29,1286342722,1286343622,1,4,900
62783804@N05,7860,21,1305651667,1305652237,1,1,570
62783804@N05,7861,29,1308025163,1308026063,1,1,900
62783804@N05,7862,29,1308300095,1308300995,1,1,900
62783804@N05,7863,1,1309248887,1309248947,1,1,60
62783804@N05,7864,10,1311650844,1311651084,1,1,240
62783804@N05,7865,26,1311833282,1311834182,1,1,900
62783804@N05,7866,20,1312891933,1312892473,1,1,540
62783804@N05,7867,16,1313722223,1313722493,2,1,270
62783804@N05,7868,20,1316669680,1316670220,1,1,540
62783804@N05,7869,30,1317446270,1317447350,1,1,1080
62783804@N05,7870,1,1317789851,1317789911,1,1,60
62783804@N05,7871,6,1322810659,1322810779,1,1,120
62783804@N05,7872,8,1324173926,1324174106,1,1,180
62783804@N05,7873,11,1326632395,1326632635,1,1,240
62783804@N05,7874,16,1339642290,1339642560,1,1,270
62831368@N08,7875,26,1315121099,1315121999,28,1,900
62841817@N05,7876,30,1389011566,1389011574,2,2,8
62841817@N05,7876,23,1389011574,1389012174,1,2,600
62844184@N00,7877,28,1356406185,1356407085,2,1,900
62844184@N00,7878,30,1356500050,1356500441,2,5,391
62844184@N00,7878,28,1356500441,1356500705,2,5,264
62844184@N00,7878,18,1356500705,1356501155,2,5,450
62844184@N00,7878,30,1356504849,1356505088,2,5,239
62844184@N00,7878,20,1356505088,1356505628,1,5,540
62844184@N00,7879,28,1360229457,1360230357,1,1,900
62901115@N00,7880,3,1351077191,1351077205,2,2,14
62901115@N00,7880,25,1351077205,1351078045,1,2,840
62937639@N00,7881,4,1329009487,1329009588,2,5,101
62937639@N00,7881,11,1329014215,1329014455,6,5,240
62937639@N00,7881,26,1329016388,1329016519,2,5,131
62937639@N00,7881,28,1329016519,1329017419,2,5,900
62937639@N00,7881,11,1329020276,1329020516,12,5,240
62947310@N02,7882,28,1311580535,1311581435,2,3,900
62947310@N02,7882,18,1311584639,1311585089,2,3,450
62947310@N02,7882,10,1311588846,1311589086,1,3,240
62947310@N02,7883,10,1311652247,1311652487,1,1,240
62947310@N02,7884,18,1311732061,1311732511,2,2,450
62947310@N02,7884,10,1311737402,1311737642,1,2,240
62947310@N02,7885,28,1311769377,1311769418,2,2,41
62947310@N02,7885,18,1311769418,1311769868,1,2,450
62947310@N02,7886,19,1324183054,1324183594,1,1,540
62983673@N07,7887,24,1283256931,1283257179,2,2,248
62983673@N07,7887,21,1283257179,1283257749,1,2,570
62986558@N05,7888,14,1331295275,1331295515,1,1,240
62986558@N05,7889,21,1332489684,1332490254,1,1,570
62986558@N05,7890,15,1333093710,1333093980,2,2,270
62986558@N05,7890,17,1333100092,1333100392,1,2,300
62986558@N05,7891,14,1333938847,1333939087,2,2,240
62986558@N05,7891,28,1333942080,1333942980,1,2,900
62986558@N05,7892,28,1334729742,1334730642,1,1,900
62986558@N05,7893,26,1335608325,1335609225,1,1,900
62986558@N05,7894,27,1336129881,1336130781,2,2,900
62986558@N05,7894,7,1336137298,1336137478,1,2,180
62986558@N05,7895,5,1336225110,1336225230,2,2,120
62986558@N05,7895,28,1336227132,1336228032,1,2,900
62986558@N05,7896,17,1336992257,1336992557,2,3,300
62986558@N05,7896,23,1336994900,1336995500,2,3,600
62986558@N05,7896,30,1336996753,1336997833,1,3,1080
62986558@N05,7897,28,1337511272,1337512172,1,1,900
62986558@N05,7898,17,1339590262,1339590562,2,1,300
62994159@N06,7899,1,1433575810,1433575870,1,1,60
63014850@N00,7900,5,1403143734,1403143854,2,6,120
63014850@N00,7900,23,1403146209,1403146809,2,6,600
63014850@N00,7900,13,1403147572,1403147812,3,6,240
63014850@N00,7900,30,1403177173,1403178253,3,6,1080
63014850@N00,7900,3,1403196497,1403196587,2,6,90
63014850@N00,7900,26,1403196606,1403197506,1,6,900
63076241@N00,7901,30,1370323936,1370325016,1,1,1080
63096042@N07,7902,28,1319016869,1319017769,2,1,900
63104689@N03,7903,30,1397175961,1397176170,3,2,209
63104689@N03,7903,31,1397176170,1397177670,1,2,1500
63104689@N03,7904,16,1411290592,1411290812,9,2,220
63104689@N03,7904,26,1411290812,1411291712,2,2,900
63104689@N03,7905,29,1414710756,1414711656,4,4,900
63104689@N03,7905,16,1414713207,1414713477,10,4,270
63104689@N03,7905,1,1414718157,1414718217,4,4,60
63104689@N03,7905,20,1414723412,1414723952,15,4,540
63104689@N03,7906,31,1415618385,1415619196,2,3,811
63104689@N03,7906,20,1415619196,1415619736,2,3,540
63104689@N03,7906,28,1415620177,1415621077,2,3,900
63104689@N03,7907,1,1417303104,1417303164,2,2,60
63104689@N03,7907,16,1417303480,1417303750,5,2,270
63104916@N00,7908,26,1339127933,1339128833,1,1,900
63106298@N02,7909,26,1298289545,1298290445,1,1,900
63106298@N02,7910,26,1316763013,1316763913,2,1,900
63106298@N02,7911,21,1316942744,1316943314,2,2,570
63106298@N02,7911,16,1316952127,1316952397,1,2,270
63106298@N02,7912,13,1318583574,1318583754,2,11,180
63106298@N02,7912,4,1318583754,1318583754,2,11,0
63106298@N02,7912,18,1318583754,1318583754,2,11,0
63106298@N02,7912,20,1318583754,1318583754,2,11,0
63106298@N02,7912,28,1318583754,1318583766,2,11,12
63106298@N02,7912,12,1318583766,1318583766,2,11,0
63106298@N02,7912,26,1318583766,1318583766,2,11,0
63106298@N02,7912,30,1318583766,1318583775,2,11,9
63106298@N02,7912,13,1318583775,1318584015,2,11,240
63106298@N02,7912,1,1318590051,1318590051,2,11,0
63106298@N02,7912,20,1318590051,1318590591,1,11,540
63106298@N02,7913,18,1319173235,1319173685,1,1,450
63106298@N02,7914,18,1320314278,1320314383,2,14,105
63106298@N02,7914,4,1320314383,1320314484,2,14,101
63106298@N02,7914,20,1320326493,1320327033,2,14,540
63106298@N02,7914,13,1320327952,1320328192,6,14,240
63106298@N02,7914,26,1320329623,1320330523,6,14,900
63106298@N02,7914,20,1320331747,1320332287,2,14,540
63106298@N02,7914,26,1320333098,1320333412,2,14,314
63106298@N02,7914,20,1320333412,1320333522,2,14,110
63106298@N02,7914,4,1320333522,1320333623,2,14,101
63106298@N02,7914,24,1320333774,1320334090,3,14,316
63106298@N02,7914,27,1320334090,1320334198,2,14,108
63106298@N02,7914,26,1320334198,1320334644,3,14,446
63106298@N02,7914,24,1320334644,1320334749,2,14,105
63106298@N02,7914,4,1320334749,1320334850,2,14,101
63106298@N02,7915,15,1321883444,1321883714,2,2,270
63106298@N02,7915,13,1321886246,1321886486,7,2,240
63106298@N02,7916,30,1321925562,1321926642,4,7,1080
63106298@N02,7916,29,1321943226,1321944126,5,7,900
63106298@N02,7916,20,1321964739,1321965279,4,7,540
63106298@N02,7916,29,1321967841,1321968741,2,7,900
63106298@N02,7916,30,1321969524,1321970451,2,7,927
63106298@N02,7916,16,1321970451,1321970721,3,7,270
63106298@N02,7916,26,1321971257,1321972157,1,7,900
63106298@N02,7917,27,1322010120,1322010852,2,2,732
63106298@N02,7917,28,1322010852,1322011752,2,2,900
63106298@N02,7918,30,1322109885,1322110965,2,3,1080
63106298@N02,7918,6,1322111607,1322111727,4,3,120
63106298@N02,7918,26,1322112030,1322112930,1,3,900
63106298@N02,7919,28,1322526365,1322527265,2,7,900
63106298@N02,7919,1,1322531344,1322531404,2,7,60
63106298@N02,7919,6,1322538817,1322538937,2,7,120
63106298@N02,7919,4,1322541295,1322541396,4,7,101
63106298@N02,7919,29,1322543963,1322544863,2,7,900
63106298@N02,7919,13,1322545090,1322545330,2,7,240
63106298@N02,7919,24,1322545983,1322546763,1,7,780
63106298@N02,7920,28,1322789631,1322790531,1,1,900
63106298@N02,7921,3,1322903513,1322903603,2,3,90
63106298@N02,7921,6,1322907341,1322907461,2,3,120
63106298@N02,7921,27,1322916664,1322917564,1,3,900
63106298@N02,7922,13,1323567401,1323567641,2,1,240
63106298@N02,7923,24,1323601579,1323602359,3,1,780
63106298@N02,7924,24,1323748740,1323749520,7,6,780
63106298@N02,7924,31,1323750517,1323751294,2,6,777
63106298@N02,7924,23,1323751294,1323751676,2,6,382
63106298@N02,7924,20,1323751676,1323752216,3,6,540
63106298@N02,7924,28,1323753560,1323753758,2,6,198
63106298@N02,7924,6,1323753758,1323753878,2,6,120
63106298@N02,7925,15,1325164749,1325165019,2,3,270
63106298@N02,7925,20,1325165636,1325166034,3,3,398
63106298@N02,7925,15,1325166034,1325166304,2,3,270
63106298@N02,7926,15,1325202464,1325202734,9,1,270
63106298@N02,7927,26,1325345067,1325345967,1,1,900
63106298@N02,7928,15,1327024814,1327024853,2,2,39
63106298@N02,7928,13,1327024853,1327025093,1,2,240
63106298@N02,7929,15,1327991864,1327992134,6,1,270
63106298@N02,7930,24,1328089566,1328090346,2,5,780
63106298@N02,7930,20,1328092772,1328093312,2,5,540
63106298@N02,7930,14,1328093973,1328094213,2,5,240
63106298@N02,7930,22,1328094751,1328095351,2,5,600
63106298@N02,7930,3,1328100887,1328100977,1,5,90
63106298@N02,7931,3,1328235592,1328235682,1,1,90
63106298@N02,7932,3,1328275093,1328275183,7,1,90
63106298@N02,7933,1,1329643227,1329643287,2,4,60
63106298@N02,7933,13,1329648081,1329648321,2,4,240
63106298@N02,7933,15,1329648346,1329648610,3,4,264
63106298@N02,7933,8,1329648610,1329648790,1,4,180
63106298@N02,7934,28,1331262469,1331263212,2,3,743
63106298@N02,7934,18,1331263212,1331263662,2,3,450
63106298@N02,7934,15,1331268304,1331268574,2,3,270
63106298@N02,7935,15,1331597950,1331598220,2,1,270
63106298@N02,7936,29,1332979369,1332980269,1,1,900
63106298@N02,7937,24,1333965903,1333965986,2,8,83
63106298@N02,7937,26,1333965986,1333966074,2,8,88
63106298@N02,7937,25,1333966074,1333966914,5,8,840
63106298@N02,7937,26,1333967575,1333968475,3,8,900
63106298@N02,7937,15,1333968512,1333968633,2,8,121
63106298@N02,7937,28,1333968633,1333968734,2,8,101
63106298@N02,7937,15,1333968734,1333969004,2,8,270
63106298@N02,7937,26,1333972862,1333973762,1,8,900
63106298@N02,7938,16,1334020124,1334020394,1,1,270
63106298@N02,7939,13,1334133884,1334134124,2,2,240
63106298@N02,7939,19,1334134398,1334134938,1,2,540
63106298@N02,7940,26,1334193830,1334194730,2,1,900
63106298@N02,7941,12,1334328653,1334328893,2,2,240
63106298@N02,7941,26,1334330716,1334331616,2,2,900
63106298@N02,7942,26,1334535549,1334536449,1,1,900
63106298@N02,7943,26,1335093051,1335093951,2,2,900
63106298@N02,7943,21,1335096823,1335097393,1,2,570
63106298@N02,7944,15,1335278151,1335278421,2,3,270
63106298@N02,7944,16,1335278478,1335278748,2,3,270
63106298@N02,7944,26,1335278770,1335279670,3,3,900
63106298@N02,7945,28,1335371856,1335372756,2,4,900
63106298@N02,7945,15,1335373994,1335374264,2,4,270
63106298@N02,7945,26,1335374288,1335374513,2,4,225
63106298@N02,7945,30,1335374513,1335375593,1,4,1080
63106298@N02,7946,23,1335408985,1335409027,2,3,42
63106298@N02,7946,20,1335409027,1335409567,2,3,540
63106298@N02,7946,16,1335417667,1335417937,1,3,270
63106298@N02,7947,3,1335708350,1335708361,2,9,11
63106298@N02,7947,26,1335708361,1335708405,2,9,44
63106298@N02,7947,28,1335708405,1335708484,2,9,79
63106298@N02,7947,19,1335708484,1335708525,2,9,41
63106298@N02,7947,15,1335708525,1335708566,2,9,41
63106298@N02,7947,24,1335708566,1335708579,2,9,13
63106298@N02,7947,13,1335708579,1335708608,2,9,29
63106298@N02,7947,6,1335708608,1335708728,3,9,120
63106298@N02,7947,13,1335708839,1335709079,1,9,240
63106298@N02,7948,26,1335890262,1335890332,2,5,70
63106298@N02,7948,16,1335890332,1335890363,2,5,31
63106298@N02,7948,28,1335890363,1335890392,2,5,29
63106298@N02,7948,15,1335890392,1335890662,2,5,270
63106298@N02,7948,6,1335891311,1335891431,1,5,120
63106298@N02,7949,15,1335979898,1335979952,3,4,54
63106298@N02,7949,19,1335979952,1335980022,2,4,70
63106298@N02,7949,23,1335980022,1335980072,2,4,50
63106298@N02,7949,27,1335980072,1335980972,1,4,900
63106298@N02,7950,19,1336095408,1336095436,3,2,28
63106298@N02,7950,20,1336095436,1336095976,1,2,540
63106298@N02,7951,31,1340205143,1340205271,2,4,128
63106298@N02,7951,26,1340205271,1340205646,2,4,375
63106298@N02,7951,24,1340205646,1340205846,2,4,200
63106298@N02,7951,16,1340205846,1340206116,1,4,270
63202442@N00,7952,20,1286411264,1286411804,1,1,540
63202442@N00,7953,30,1286450211,1286451291,1,1,1080
63202442@N00,7954,25,1350284714,1350285554,1,1,840
63326305@N04,7955,18,1305932622,1305933072,2,2,450
63326305@N04,7955,10,1305960031,1305960271,1,2,240
63365181@N00,7956,17,1349102401,1349102701,1,1,300
63383881@N07,7957,1,1379817678,1379817738,2,5,60
63383881@N07,7957,29,1379829127,1379830027,2,5,900
63383881@N07,7957,1,1379836659,1379836719,3,5,60
63383881@N07,7957,25,1379847495,1379848335,3,5,840
63383881@N07,7957,4,1379849500,1379849601,1,5,101
63383881@N07,7958,1,1379975757,1379975817,2,9,60
63383881@N07,7958,8,1379978389,1379978569,2,9,180
63383881@N07,7958,5,1379978686,1379978806,3,9,120
63383881@N07,7958,3,1379979456,1379979546,3,9,90
63383881@N07,7958,26,1379982926,1379983826,3,9,900
63383881@N07,7958,30,1379988135,1379988267,2,9,132
63383881@N07,7958,11,1379988267,1379988366,2,9,99
63383881@N07,7958,7,1379988366,1379988546,3,9,180
63383881@N07,7958,20,1379991732,1379992272,1,9,540
63383881@N07,7959,15,1380070748,1380071018,2,4,270
63383881@N07,7959,25,1380074688,1380075528,2,4,840
63383881@N07,7959,15,1380077129,1380077399,2,4,270
63383881@N07,7959,13,1380077508,1380077748,4,4,240
63383881@N07,7960,13,1414192722,1414192962,2,2,240
63383881@N07,7960,20,1414197817,1414198357,1,2,540
63383881@N07,7961,20,1414227989,1414228113,2,2,124
63383881@N07,7961,14,1414228113,1414228353,1,2,240
63437796@N00,7962,25,1291460213,1291461053,1,1,840
63437796@N00,7963,27,1316854906,1316855806,1,1,900
63437796@N00,7964,25,1357974983,1357975823,1,1,840
63437796@N00,7965,1,1391856762,1391856822,1,1,60
63443853@N00,7966,30,1225449629,1225450709,1,1,1080
63443853@N00,7967,26,1299386849,1299387749,1,1,900
63447360@N02,7968,18,1387957979,1387958429,1,1,450
63484364@N05,7969,18,1452227676,1452228126,8,5,450
63484364@N05,7969,25,1452244258,1452245098,3,5,840
63484364@N05,7969,15,1452266164,1452266434,3,5,270
63484364@N05,7969,27,1452267134,1452267549,2,5,415
63484364@N05,7969,18,1452267549,1452267999,1,5,450
63484364@N05,7970,27,1452305238,1452306138,1,1,900
63488513@N00,7971,17,1378275715,1378276015,1,1,300
63511295@N07,7972,27,1309652645,1309653545,2,2,900
63511295@N07,7972,13,1309668570,1309668810,2,2,240
63520495@N08,7973,1,1356472799,1356472859,2,2,60
63520495@N08,7973,28,1356481230,1356482130,1,2,900
63520495@N08,7974,30,1356774373,1356775453,1,1,1080
63520495@N08,7975,28,1358073749,1358074649,1,1,900
63520495@N08,7976,7,1359179697,1359179877,1,1,180
63520495@N08,7977,6,1364963874,1364963982,2,2,108
63520495@N08,7977,26,1364963982,1364964882,1,2,900
63520495@N08,7978,28,1372847799,1372848699,1,1,900
63520495@N08,7979,26,1373785990,1373786890,2,2,900
63520495@N08,7979,1,1373803573,1373803633,2,2,60
63520495@N08,7980,17,1374302829,1374303129,2,2,300
63520495@N08,7980,20,1374306952,1374307492,1,2,540
63520495@N08,7981,1,1376826334,1376826394,1,1,60
63520495@N08,7982,26,1376979113,1376980013,1,1,900
63520495@N08,7983,21,1385163546,1385164116,2,3,570
63520495@N08,7983,28,1385166784,1385166828,2,3,44
63520495@N08,7983,1,1385166828,1385166888,1,3,60
63520495@N08,7984,3,1385200101,1385200191,1,1,90
63520495@N08,7985,1,1385374852,1385374912,1,1,60
63520495@N08,7986,14,1385790803,1385791043,1,1,240
63520495@N08,7987,1,1386068249,1386068309,1,1,60
63520495@N08,7988,3,1405901588,1405901678,1,1,90
63520495@N08,7989,17,1409734052,1409734352,1,1,300
63520495@N08,7990,16,1425708170,1425708440,2,2,270
63520495@N08,7990,28,1425711651,1425712551,1,2,900
63520495@N08,7991,18,1427532846,1427533296,1,1,450
63520495@N08,7992,18,1448704020,1448704470,1,1,450
63520495@N08,7993,15,1459653008,1459653278,1,1,270
63520495@N08,7994,18,1460186781,1460187231,1,1,450
63542807@N00,7995,28,1357987850,1357988750,1,1,900
63542807@N00,7996,29,1412756747,1412757647,1,1,900
63579498@N08,7997,26,1214855891,1214856791,1,1,900
63579498@N08,7998,26,1214912735,1214913635,2,2,900
63579498@N08,7998,31,1214923550,1214925050,1,2,1500
63579498@N08,7999,27,1243402759,1243403659,2,1,900
63631877@N00,8000,17,1219811470,1219811770,1,1,300
63631877@N00,8001,17,1219914929,1219915229,3,1,300
63631877@N00,8002,12,1222847479,1222847719,3,1,240
63631877@N00,8003,14,1223685278,1223685518,2,1,240
63631877@N00,8004,29,1230787446,1230788346,2,1,900
63631877@N00,8005,20,1234743344,1234743884,1,1,540
63631877@N00,8006,25,1237623998,1237624002,2,2,4
63631877@N00,8006,27,1237624002,1237624902,1,2,900
63631877@N00,8007,28,1243159126,1243160026,2,1,900
63631877@N00,8008,17,1243682700,1243683000,1,1,300
63631877@N00,8009,28,1258761907,1258762807,2,1,900
63631877@N00,8010,10,1272259486,1272259489,2,3,3
63631877@N00,8010,20,1272259489,1272259494,3,3,5
63631877@N00,8010,1,1272259494,1272259554,1,3,60
63631877@N00,8011,23,1273230295,1273230302,2,2,7
63631877@N00,8011,17,1273230302,1273230602,1,2,300
63631877@N00,8012,8,1274321366,1274321546,1,1,180
63631877@N00,8013,29,1276404974,1276405874,1,1,900
63631877@N00,8014,13,1290435570,1290435574,2,4,4
63631877@N00,8014,12,1290435574,1290435578,2,4,4
63631877@N00,8014,5,1290435578,1290435581,2,4,3
63631877@N00,8014,3,1290435581,1290435671,2,4,90
63631877@N00,8015,16,1291178092,1291178362,1,1,270
63631877@N00,8016,10,1405825440,1405825680,1,1,240
63631877@N00,8017,26,1443524403,1443525303,1,1,900
63666148@N00,8018,28,1362388787,1362389687,2,2,900
63666148@N00,8018,26,1362392912,1362393812,1,2,900
63683562@N07,8019,1,1370069491,1370069551,1,1,60
63689406@N00,8020,26,1268953859,1268954759,2,2,900
63689406@N00,8020,29,1268967565,1268968465,1,2,900
63689406@N00,8021,28,1269040268,1269041168,2,4,900
63689406@N00,8021,20,1269043864,1269044404,2,4,540
63689406@N00,8021,17,1269061910,1269062210,2,4,300
63689406@N00,8021,20,1269067693,1269068233,1,4,540
63689406@N00,8022,26,1269117378,1269118278,2,10,900
63689406@N00,8022,12,1269118282,1269118522,3,10,240
63689406@N00,8022,21,1269118762,1269119332,2,10,570
63689406@N00,8022,29,1269126039,1269126939,2,10,900
63689406@N00,8022,26,1269127796,1269127998,2,10,202
63689406@N00,8022,21,1269127998,1269128568,2,10,570
63689406@N00,8022,24,1269129461,1269130241,3,10,780
63689406@N00,8022,16,1269134584,1269134854,2,10,270
63689406@N00,8022,24,1269135640,1269135772,2,10,132
63689406@N00,8022,16,1269135772,1269136042,1,10,270
63689406@N00,8023,28,1269171458,1269172358,2,2,900
63689406@N00,8023,16,1269174450,1269174720,1,2,270
63765288@N05,8024,5,1345622307,1345622420,3,15,113
63765288@N05,8024,4,1345622420,1345622521,3,15,101
63765288@N05,8024,1,1345624014,1345624074,3,15,60
63765288@N05,8024,28,1345624227,1345624351,2,15,124
63765288@N05,8024,27,1345624351,1345624391,2,15,40
63765288@N05,8024,26,1345624391,1345625291,8,15,900
63765288@N05,8024,11,1345625881,1345625998,5,15,117
63765288@N05,8024,4,1345625998,1345626099,2,15,101
63765288@N05,8024,18,1345627246,1345627696,2,15,450
63765288@N05,8024,23,1345640451,1345640565,2,15,114
63765288@N05,8024,18,1345640565,1345640758,2,15,193
63765288@N05,8024,28,1345640758,1345641658,2,15,900
63765288@N05,8024,26,1345663240,1345663507,2,15,267
63765288@N05,8024,28,1345663507,1345663751,3,15,244
63765288@N05,8024,1,1345663751,1345663811,1,15,60
63772658@N07,8025,27,1460454561,1460455461,1,1,900
63773896@N03,8026,1,1432237065,1432237125,2,4,60
63773896@N03,8026,18,1432239475,1432239689,2,4,214
63773896@N03,8026,29,1432239689,1432240589,2,4,900
63773896@N03,8026,23,1432258385,1432258985,1,4,600
63773896@N03,8027,26,1432441874,1432442774,3,1,900
63862568@N00,8028,18,1447883628,1447884078,1,1,450
63903138@N00,8029,30,1253272552,1253273632,1,1,1080
63903138@N00,8030,26,1259134134,1259135034,1,1,900
63903226@N06,8031,16,1346118898,1346119168,1,1,270
63903226@N06,8032,20,1398139429,1398139969,1,1,540
63903226@N06,8033,29,1401064065,1401064965,1,1,900
63903226@N06,8034,28,1416866339,1416867239,1,1,900
63948289@N03,8035,28,1388097810,1388098710,2,1,900
63955107@N08,8036,18,1426491899,1426492349,1,1,450
63963077@N03,8037,20,1387423741,1387424281,1,1,540
63968574@N03,8038,30,1345516459,1345517539,2,1,1080
63968574@N03,8039,1,1349147881,1349147941,2,8,60
63968574@N03,8039,28,1349148222,1349148484,2,8,262
63968574@N03,8039,30,1349148484,1349149564,2,8,1080
63968574@N03,8039,14,1349150931,1349151171,2,8,240
63968574@N03,8039,11,1349151825,1349151942,2,8,117
63968574@N03,8039,22,1349151942,1349152542,2,8,600
63968574@N03,8039,13,1349153060,1349153300,3,8,240
63968574@N03,8039,3,1349156193,1349156283,2,8,90
63968574@N03,8040,26,1350940865,1350941765,63,5,900
63968574@N03,8040,30,1350969460,1350970540,4,5,1080
63968574@N03,8040,26,1350973478,1350974378,21,5,900
63968574@N03,8040,30,1350985559,1350986639,2,5,1080
63968574@N03,8040,26,1350990359,1350991259,1,5,900
63968574@N03,8041,21,1353206427,1353206997,1,1,570
63968574@N03,8042,22,1353374179,1353374779,1,1,600
63968574@N03,8043,26,1354000139,1354000139,2,2,0
63968574@N03,8043,30,1354000139,1354001219,1,2,1080
63968574@N03,8044,30,1362029719,1362030799,2,2,1080
63968574@N03,8044,19,1362031444,1362031984,2,2,540
63968574@N03,8045,30,1362441868,1362442948,38,1,1080
63968574@N03,8046,30,1362624158,1362625238,24,1,1080
63968574@N03,8047,30,1365463441,1365464521,2,3,1080
63968574@N03,8047,26,1365464696,1365465596,7,3,900
63968574@N03,8047,30,1365476049,1365477129,10,3,1080
63968574@N03,8048,30,1365656081,1365657161,10,1,1080
63968574@N03,8049,30,1367465763,1367466843,8,1,1080
63968574@N03,8050,26,1369706089,1369706989,7,1,900
63968574@N03,8051,30,1382229485,1382230565,50,1,1080
63968574@N03,8052,26,1416305070,1416305970,24,1,900
63971589@N00,8053,17,1349486560,1349486860,2,2,300
63971589@N00,8053,25,1349503415,1349504255,1,2,840
63971589@N00,8054,7,1349570044,1349570224,1,1,180
63971589@N00,8055,1,1349599176,1349599236,1,1,60
63971589@N00,8056,23,1380866762,1380867362,1,1,600
63971589@N00,8057,20,1380943562,1380944102,1,1,540
63971589@N00,8058,12,1381038959,1381039199,1,1,240
63971589@N00,8059,4,1433405245,1433405346,2,2,101
63971589@N00,8059,18,1433428907,1433429357,1,2,450
63971589@N00,8060,22,1444027225,1444027825,1,1,600
64041142@N00,8061,28,1242793220,1242794120,2,1,900
64047898@N07,8062,1,1389052380,1389052440,15,1,60
64098965@N00,8063,26,1197546418,1197547318,1,1,900
64098965@N00,8064,26,1203681885,1203682785,1,1,900
64098965@N00,8065,26,1205491936,1205491942,2,5,6
64098965@N00,8065,11,1205491942,1205492099,2,5,157
64098965@N00,8065,29,1205492099,1205492164,3,5,65
64098965@N00,8065,11,1205492164,1205492404,2,5,240
64098965@N00,8065,24,1205495059,1205495839,1,5,780
64098965@N00,8066,26,1206788406,1206789306,1,1,900
64111181@N00,8067,17,1278236619,1278236919,2,2,300
64111181@N00,8067,26,1278243373,1278244273,2,2,900
64123610@N00,8068,17,1356408103,1356408403,3,5,300
64123610@N00,8068,21,1356416903,1356417473,3,5,570
64123610@N00,8068,13,1356420123,1356420363,2,5,240
64123610@N00,8068,20,1356431135,1356431675,2,5,540
64123610@N00,8068,28,1356438756,1356439656,1,5,900
64128174@N00,8069,27,1404456599,1404457499,2,1,900
64149590@N00,8070,28,1294250519,1294251419,20,1,900
64202793@N00,8071,1,1393886725,1393886785,3,16,60
64202793@N00,8071,28,1393886985,1393887660,10,16,675
64202793@N00,8071,26,1393887660,1393888380,5,16,720
64202793@N00,8071,11,1393888380,1393888620,3,16,240
64202793@N00,8071,29,1393893781,1393894681,8,16,900
64202793@N00,8071,27,1393903240,1393903369,2,16,129
64202793@N00,8071,1,1393903369,1393903429,2,16,60
64202793@N00,8071,27,1393904823,1393905723,4,16,900
64202793@N00,8071,3,1393908432,1393908436,2,16,4
64202793@N00,8071,21,1393908436,1393909006,2,16,570
64202793@N00,8071,13,1393909928,1393910168,10,16,240
64202793@N00,8071,15,1393911936,1393912206,26,16,270
64202793@N00,8071,17,1393917923,1393918223,2,16,300
64202793@N00,8071,27,1393919274,1393919585,3,16,311
64202793@N00,8071,16,1393919585,1393919754,6,16,169
64202793@N00,8071,17,1393919754,1393920054,8,16,300
64202793@N00,8072,1,1393974721,1393974781,10,1,60
64202793@N00,8073,28,1394069772,1394070672,17,13,900
64202793@N00,8073,19,1394072528,1394073050,13,13,522
64202793@N00,8073,23,1394073050,1394073058,3,13,8
64202793@N00,8073,19,1394073058,1394073598,3,13,540
64202793@N00,8073,22,1394074103,1394074163,2,13,60
64202793@N00,8073,31,1394074163,1394075663,3,13,1500
64202793@N00,8073,27,1394076991,1394077891,3,13,900
64202793@N00,8073,16,1394080797,1394081067,4,13,270
64202793@N00,8073,26,1394081929,1394082829,5,13,900
64202793@N00,8073,11,1394084055,1394084295,5,13,240
64202793@N00,8073,10,1394084503,1394084743,2,13,240
64202793@N00,8073,30,1394086096,1394087176,3,13,1080
64202793@N00,8073,15,1394087355,1394087625,3,13,270
64236163@N00,8074,28,1363821311,1363822211,1,1,900
64286456@N00,8075,29,1345376672,1345377572,1,1,900
64286456@N00,8076,12,1369228847,1369229087,1,1,240
64286456@N00,8077,1,1373037749,1373037809,1,1,60
64286456@N00,8078,1,1380356066,1380356126,1,1,60
64286456@N00,8079,1,1380423998,1380424058,2,4,60
64286456@N00,8079,14,1380424848,1380425088,2,4,240
64286456@N00,8079,1,1380425581,1380425641,2,4,60
64286456@N00,8079,29,1380426232,1380427132,1,4,900
64286456@N00,8080,26,1381323563,1381324463,1,1,900
64286456@N00,8081,28,1387020929,1387021829,1,1,900
64286456@N00,8082,29,1388441909,1388442809,2,2,900
64286456@N00,8082,27,1388448274,1388449174,1,2,900
64338179@N00,8083,18,1455608626,1455609076,1,1,450
64405577@N00,8084,16,1256373641,1256373911,2,2,270
64405577@N00,8084,30,1256377089,1256378169,3,2,1080
64405577@N00,8085,29,1317519159,1317520059,1,1,900
64405577@N00,8086,3,1317558556,1317558646,2,3,90
64405577@N00,8086,11,1317558823,1317559063,2,3,240
64405577@N00,8086,28,1317559316,1317560216,1,3,900
64405577@N00,8087,30,1318142813,1318142873,2,4,60
64405577@N00,8087,29,1318142873,1318142921,2,4,48
64405577@N00,8087,31,1318142921,1318143463,2,4,542
64405577@N00,8087,30,1318143463,1318144543,1,4,1080
64405577@N00,8088,4,1318766098,1318766199,2,3,101
64405577@N00,8088,15,1318769174,1318769255,2,3,81
64405577@N00,8088,24,1318769255,1318770035,1,3,780
64432343@N07,8089,6,1343042152,1343042272,2,3,120
64432343@N07,8089,27,1343047072,1343047972,3,3,900
64432343@N07,8089,26,1343048520,1343049420,1,3,900
64432343@N07,8090,26,1391428221,1391429121,1,1,900
64432343@N07,8091,27,1392252505,1392253405,1,1,900
64472855@N06,8092,8,1330480922,1330481102,1,1,180
64472855@N06,8093,13,1332222902,1332223142,1,1,240
64508904@N07,8094,28,1343811997,1343812897,3,2,900
64508904@N07,8094,3,1343815398,1343815488,1,2,90
64517504@N07,8095,30,1311727141,1311728221,13,1,1080
64553590@N07,8096,17,1309087070,1309087370,5,1,300
64560041@N04,8097,27,1346560193,1346560400,2,2,207
64560041@N04,8097,13,1346560400,1346560640,1,2,240
64560041@N04,8098,30,1356915137,1356916217,2,1,1080
64560041@N04,8099,26,1357076005,1357076905,1,1,900
64569741@N00,8100,25,1308579041,1308579881,1,1,840
64569741@N00,8101,30,1308656305,1308657385,1,1,1080
64569741@N00,8102,27,1309697370,1309698270,1,1,900
64569741@N00,8103,30,1309782894,1309783974,2,2,1080
64569741@N00,8103,1,1309786567,1309786627,3,2,60
64569741@N00,8104,30,1315905832,1315906912,1,1,1080
64569741@N00,8105,26,1324900475,1324901375,1,1,900
64569741@N00,8106,28,1331549297,1331549336,2,6,39
64569741@N00,8106,26,1331549336,1331549561,2,6,225
64569741@N00,8106,7,1331549561,1331549656,3,6,95
64569741@N00,8106,3,1331549656,1331549690,2,6,34
64569741@N00,8106,16,1331549690,1331549960,6,6,270
64569741@N00,8106,29,1331550091,1331550991,1,6,900
64569741@N00,8107,1,1337932554,1337932614,1,1,60
64569741@N00,8108,28,1341929789,1341930689,1,1,900
64569741@N00,8109,29,1344600169,1344601069,6,1,900
64569741@N00,8110,8,1344780081,1344780261,1,1,180
64569741@N00,8111,26,1346506335,1346507235,1,1,900
64569741@N00,8112,28,1347606157,1347607057,2,1,900
64569741@N00,8113,18,1348910738,1348911188,1,1,450
64569741@N00,8114,28,1349419261,1349420161,1,1,900
64569741@N00,8115,1,1353761883,1353761943,2,2,60
64569741@N00,8115,26,1353765016,1353765916,1,2,900
64569741@N00,8116,29,1354704509,1354705409,4,1,900
64569741@N00,8117,29,1355745613,1355746513,1,1,900
64569741@N00,8118,29,1363330904,1363331804,1,1,900
64576282@N00,8119,28,1261190382,1261191282,1,1,900
64576282@N00,8120,1,1278057041,1278057101,2,2,60
64576282@N00,8120,21,1278061564,1278062134,2,2,570
64576282@N00,8121,7,1280638885,1280639065,2,3,180
64576282@N00,8121,24,1280644479,1280645259,2,3,780
64576282@N00,8121,21,1280652673,1280653243,2,3,570
64576282@N00,8122,16,1280754527,1280754797,1,1,270
64576282@N00,8123,27,1283743249,1283744149,2,2,900
64576282@N00,8123,24,1283747394,1283748174,1,2,780
64576282@N00,8124,15,1286162402,1286162672,4,3,270
64576282@N00,8124,26,1286171361,1286172261,3,3,900
64576282@N00,8124,28,1286173788,1286174688,1,3,900
64576282@N00,8125,29,1288068819,1288069719,2,11,900
64576282@N00,8125,31,1288069984,1288070652,4,11,668
64576282@N00,8125,22,1288070652,1288071252,2,11,600
64576282@N00,8125,21,1288074969,1288075156,5,11,187
64576282@N00,8125,3,1288075156,1288075174,2,11,18
64576282@N00,8125,21,1288075174,1288075744,3,11,570
64576282@N00,8125,11,1288081013,1288081253,3,11,240
64576282@N00,8125,30,1288082418,1288083438,2,11,1020
64576282@N00,8125,29,1288083438,1288083448,2,11,10
64576282@N00,8125,30,1288083448,1288084528,4,11,1080
64576282@N00,8125,14,1288084832,1288085072,1,11,240
64576282@N00,8126,11,1288609907,1288610147,1,1,240
64576282@N00,8127,28,1304702956,1304703856,1,1,900
64576282@N00,8128,28,1304752903,1304753803,2,1,900
64576282@N00,8129,19,1319525603,1319526143,2,2,540
64576282@N00,8129,12,1319533133,1319533373,2,2,240
64579523@N02,8130,26,1290847378,1290848278,1,1,900
64579523@N02,8131,26,1294034558,1294035458,1,1,900
64579523@N02,8132,26,1295008102,1295009002,2,1,900
64579523@N02,8133,26,1297393570,1297394470,1,1,900
64591327@N00,8134,18,1424946650,1424947100,2,1,450
64591327@N00,8135,18,1427802983,1427803433,1,1,450
64591327@N00,8136,18,1434161389,1434161839,1,1,450
64591327@N00,8137,18,1435059812,1435060262,2,1,450
64604717@N03,8138,23,1218267387,1218267987,2,7,600
64604717@N03,8138,18,1218268434,1218268577,2,7,143
64604717@N03,8138,30,1218268577,1218269657,2,7,1080
64604717@N03,8138,31,1218270557,1218272057,2,7,1500
64604717@N03,8138,16,1218273566,1218273836,2,7,270
64604717@N03,8138,30,1218274508,1218275383,2,7,875
64604717@N03,8138,29,1218275383,1218276283,1,7,900
64634436@N00,8139,24,1297467967,1297468747,1,1,780
64651023@N00,8140,15,1329211925,1329212195,1,1,270
64658966@N06,8141,26,1329263853,1329264753,1,1,900
64724295@N08,8142,26,1325421477,1325422377,1,1,900
64724295@N08,8143,26,1325464123,1325465023,1,1,900
64724295@N08,8144,26,1326114079,1326114979,4,1,900
64724295@N08,8145,10,1332756861,1332757101,1,1,240
64724295@N08,8146,26,1337612780,1337613680,1,1,900
64724295@N08,8147,30,1338794739,1338795819,1,1,1080
64734640@N06,8148,1,1340412069,1340412129,1,1,60
64748777@N08,8149,25,1309443469,1309444309,1,1,840
64772907@N05,8150,20,1279754704,1279755244,1,1,540
64819638@N03,8151,18,1450051805,1450052255,1,1,450
64822977@N00,8152,26,1333521363,1333521641,5,8,278
64822977@N00,8152,28,1333521641,1333521897,2,8,256
64822977@N00,8152,31,1333521897,1333522527,4,8,630
64822977@N00,8152,20,1333522527,1333523067,4,8,540
64822977@N00,8152,18,1333526488,1333526938,10,8,450
64822977@N00,8152,4,1333528217,1333528318,14,8,101
64822977@N00,8152,22,1333532279,1333532879,12,8,600
64822977@N00,8152,28,1333535195,1333536095,2,8,900
64822977@N00,8153,26,1333598612,1333599512,24,2,900
64822977@N00,8153,1,1333603207,1333603267,3,2,60
64822977@N00,8154,1,1333685544,1333685604,2,5,60
64822977@N00,8154,26,1333686261,1333687161,12,5,900
64822977@N00,8154,9,1333690547,1333690727,55,5,180
64822977@N00,8154,20,1333697018,1333697558,3,5,540
64822977@N00,8154,12,1333698965,1333699205,3,5,240
64822977@N00,8155,27,1333794215,1333795115,16,1,900
64823004@N05,8156,1,1330683863,1330683923,1,1,60
64823004@N05,8157,18,1330730114,1330730564,2,2,450
64823004@N05,8157,31,1330732336,1330733836,1,2,1500
64879525@N08,8158,10,1344249734,1344249974,1,1,240
64890329@N08,8159,29,1323227025,1323227925,1,1,900
64890329@N08,8160,27,1324951604,1324952504,1,1,900
64890329@N08,8161,1,1372421813,1372421873,1,1,60
64956248@N06,8162,17,1377051009,1377051309,1,1,300
64985588@N06,8163,1,1311119526,1311119586,2,4,60
64985588@N06,8163,28,1311120038,1311120938,6,4,900
64985588@N06,8163,27,1311138820,1311139066,2,4,246
64985588@N06,8163,28,1311139066,1311139966,2,4,900
64985588@N06,8164,29,1325511095,1325511847,2,2,752
64985588@N06,8164,30,1325511847,1325512927,1,2,1080
64985588@N06,8165,6,1326691298,1326691418,2,2,120
64985588@N06,8165,15,1326692717,1326692987,1,2,270
64985588@N06,8166,6,1329039942,1329040062,1,1,120
64985588@N06,8167,29,1330838132,1330839032,2,3,900
64985588@N06,8167,25,1330844364,1330845204,3,3,840
64985588@N06,8167,20,1330849327,1330849867,2,3,540
64985588@N06,8168,29,1335179123,1335180023,2,2,900
64985588@N06,8168,24,1335181860,1335182640,1,2,780
64985588@N06,8169,18,1347950607,1347951057,2,1,450
65009074@N07,8170,28,1454145748,1454146648,1,1,900
65009812@N02,8171,1,1429486844,1429486904,2,11,60
65009812@N02,8171,27,1429489768,1429490668,2,11,900
65009812@N02,8171,8,1429492546,1429492726,2,11,180
65009812@N02,8171,28,1429493267,1429494167,2,11,900
65009812@N02,8171,14,1429497363,1429497603,2,11,240
65009812@N02,8171,27,1429498437,1429499337,3,11,900
65009812@N02,8171,18,1429500405,1429500449,3,11,44
65009812@N02,8171,19,1429500449,1429500989,2,11,540
65009812@N02,8171,14,1429506468,1429506708,2,11,240
65009812@N02,8171,25,1429510359,1429511199,3,11,840
65009812@N02,8171,27,1429527448,1429528348,1,11,900
65034792@N04,8172,28,1363055339,1363056239,1,1,900
65034792@N04,8173,28,1363224136,1363225036,2,2,900
65034792@N04,8173,17,1363248369,1363248669,1,2,300
65067917@N00,8174,25,1292149406,1292150246,1,1,840
65067917@N00,8175,25,1292233971,1292234811,2,1,840
65067917@N00,8176,28,1325336308,1325337208,1,1,900
65067917@N00,8177,28,1350638876,1350639776,6,1,900
65067917@N00,8178,28,1350690082,1350690982,1,1,900
65067917@N00,8179,25,1368919796,1368920636,1,1,840
65105672@N00,8180,20,1284596517,1284597057,10,1,540
65105672@N00,8181,20,1284681992,1284682532,6,1,540
65105672@N00,8182,20,1284854202,1284854742,12,1,540
65105672@N00,8183,20,1284894684,1284895224,11,1,540
65105672@N00,8184,20,1284945923,1284946463,9,1,540
65106121@N00,8185,14,1313798842,1313799082,2,3,240
65106121@N00,8185,26,1313805639,1313806539,2,3,900
65106121@N00,8185,15,1313811676,1313811946,4,3,270
65121058@N00,8186,26,1307517286,1307518186,1,1,900
65147136@N00,8187,20,1311652970,1311653510,2,4,540
65147136@N00,8187,15,1311654615,1311654885,2,4,270
65147136@N00,8187,12,1311663666,1311663906,2,4,240
65147136@N00,8187,29,1311670453,1311671353,1,4,900
65148532@N06,8188,8,1391212787,1391212967,2,5,180
65148532@N06,8188,26,1391213213,1391214113,4,5,900
65148532@N06,8188,31,1391220238,1391221738,2,5,1500
65148532@N06,8188,28,1391231342,1391232242,8,5,900
65148532@N06,8188,15,1391235990,1391236260,2,5,270
65196834@N00,8189,26,1328643477,1328644377,35,1,900
65198673@N07,8190,1,1460418870,1460418930,12,1,60
65202446@N05,8191,1,1355893548,1355893608,1,1,60
65219585@N00,8192,11,1397481277,1397481517,1,1,240
65226079@N00,8193,10,1262232968,1262233208,11,3,240
65226079@N00,8193,19,1262254037,1262254577,2,3,540
65226079@N00,8193,10,1262260798,1262261038,1,3,240
65228518@N04,8194,29,1400004908,1400005808,1,1,900
65298649@N00,8195,26,1327191017,1327191917,1,1,900
65321004@N02,8196,23,1325127539,1325128139,2,5,600
65321004@N02,8196,13,1325129201,1325129441,6,5,240
65321004@N02,8196,26,1325131196,1325132096,2,5,900
65321004@N02,8196,14,1325137283,1325137523,3,5,240
65321004@N02,8196,29,1325137594,1325138494,1,5,900
65367662@N00,8197,1,1291817698,1291817758,1,1,60
65367662@N00,8198,1,1313208181,1313208241,4,1,60
65374071@N00,8199,29,1341793832,1341794732,2,15,900
65374071@N00,8199,22,1341802308,1341802908,2,15,600
65374071@N00,8199,16,1341808697,1341808967,4,15,270
65374071@N00,8199,8,1341815784,1341815964,2,15,180
65374071@N00,8199,25,1341830079,1341830919,3,15,840
65374071@N00,8199,26,1341833625,1341834001,2,15,376
65374071@N00,8199,16,1341834001,1341834055,2,15,54
65374071@N00,8199,27,1341834055,1341834955,2,15,900
65374071@N00,8199,11,1341836106,1341836346,2,15,240
65374071@N00,8199,19,1341855032,1341855572,2,15,540
65374071@N00,8199,18,1341866138,1341866588,2,15,450
65374071@N00,8199,24,1341869898,1341870678,2,15,780
65374071@N00,8199,8,1341876783,1341876963,2,15,180
65374071@N00,8199,25,1341891285,1341892125,3,15,840
65374071@N00,8199,16,1341895256,1341895526,1,15,270
65374071@N00,8200,28,1371907939,1371908202,2,2,263
65374071@N00,8200,7,1371908202,1371908382,1,2,180
65404669@N02,8201,20,1347431333,1347431410,2,13,77
65404669@N02,8201,28,1347431410,1347431729,2,13,319
65404669@N02,8201,23,1347431729,1347431809,2,13,80
65404669@N02,8201,18,1347431809,1347432259,4,13,450
65404669@N02,8201,30,1347434725,1347435780,3,13,1055
65404669@N02,8201,23,1347435780,1347436294,4,13,514
65404669@N02,8201,29,1347436294,1347437194,4,13,900
65404669@N02,8201,23,1347438423,1347439023,4,13,600
65404669@N02,8201,18,1347439506,1347439956,3,13,450
65404669@N02,8201,28,1347445175,1347446075,9,13,900
65404669@N02,8201,1,1347446232,1347446247,2,13,15
65404669@N02,8201,28,1347446247,1347447147,4,13,900
65404669@N02,8201,27,1347449732,1347450632,1,13,900
65404669@N02,8202,23,1347487193,1347487793,1,1,600
65404669@N02,8203,30,1347590172,1347591252,2,7,1080
65404669@N02,8203,29,1347592746,1347593646,2,7,900
65404669@N02,8203,15,1347597481,1347597751,6,7,270
65404669@N02,8203,28,1347625716,1347626616,2,7,900
65404669@N02,8203,20,1347626868,1347627408,4,7,540
65404669@N02,8203,14,1347629183,1347629241,2,7,58
65404669@N02,8203,20,1347629241,1347629781,1,7,540
65404669@N02,8204,3,1347670940,1347671030,2,3,90
65404669@N02,8204,28,1347693606,1347694506,3,3,900
65404669@N02,8204,20,1347705123,1347705663,1,3,540
65404669@N02,8205,23,1347758607,1347758609,2,3,2
65404669@N02,8205,18,1347758609,1347759059,2,3,450
65404669@N02,8205,30,1347763680,1347764760,2,3,1080
65404669@N02,8206,28,1355894491,1355895391,1,1,900
65404669@N02,8207,29,1355992375,1355993218,2,2,843
65404669@N02,8207,1,1355993218,1355993278,1,2,60
65404669@N02,8208,4,1356049844,1356049945,2,2,101
65404669@N02,8208,3,1356065499,1356065589,1,2,90
65429311@N03,8209,28,1357171132,1357172032,1,1,900
65437859@N00,8210,26,1282383112,1282384012,12,1,900
65515841@N05,8211,26,1299299560,1299300460,1,1,900
65515841@N05,8212,26,1351067721,1351068621,1,1,900
65515841@N05,8213,18,1372315982,1372316432,2,1,450
65515841@N05,8214,1,1374461212,1374461272,11,6,60
65515841@N05,8214,17,1374476236,1374476536,2,6,300
65515841@N05,8214,3,1374480566,1374480656,2,6,90
65515841@N05,8214,26,1374480694,1374480752,2,6,58
65515841@N05,8214,12,1374480752,1374480992,2,6,240
65515841@N05,8214,3,1374481243,1374481333,1,6,90
65515841@N05,8215,17,1376557371,1376557671,1,1,300
65515841@N05,8216,28,1379307969,1379308869,2,3,900
65515841@N05,8216,14,1379311579,1379311819,2,3,240
65515841@N05,8216,17,1379313967,1379314267,1,3,300
65515841@N05,8217,30,1380095247,1380095534,2,3,287
65515841@N05,8217,26,1380095534,1380096426,2,3,892
65515841@N05,8217,3,1380096426,1380096516,1,3,90
65515841@N05,8218,17,1380948515,1380948815,2,1,300
65515841@N05,8219,16,1382576935,1382577205,2,2,270
65515841@N05,8219,23,1382581823,1382582423,1,2,600
65543500@N00,8220,1,1445982404,1445982464,3,14,60
65543500@N00,8220,28,1445985258,1445985891,3,14,633
65543500@N00,8220,16,1445985891,1445986161,2,14,270
65543500@N00,8220,12,1445988336,1445988576,3,14,240
65543500@N00,8220,25,1445988708,1445989548,3,14,840
65543500@N00,8220,30,1445989970,1445990452,2,14,482
65543500@N00,8220,29,1445990452,1445991352,2,14,900
65543500@N00,8220,13,1445993978,1445994218,5,14,240
65543500@N00,8220,1,1445997450,1445997510,2,14,60
65543500@N00,8220,26,1445999581,1446000481,3,14,900
65543500@N00,8220,20,1446004598,1446005138,2,14,540
65543500@N00,8220,5,1446007295,1446007415,2,14,120
65543500@N00,8220,31,1446009574,1446011074,2,14,1500
65543500@N00,8220,20,1446012803,1446013343,1,14,540
65616340@N03,8221,3,1366174542,1366174632,2,2,90
65616340@N03,8221,7,1366176021,1366176201,2,2,180
65627981@N06,8222,19,1412063734,1412064274,2,3,540
65627981@N06,8222,14,1412069035,1412069275,2,3,240
65627981@N06,8222,19,1412095004,1412095544,1,3,540
65645597@N00,8223,1,1442017519,1442017579,3,7,60
65645597@N00,8223,27,1442019015,1442019915,2,7,900
65645597@N00,8223,25,1442022051,1442022891,4,7,840
65645597@N00,8223,27,1442032598,1442033498,2,7,900
65645597@N00,8223,20,1442043023,1442043563,4,7,540
65645597@N00,8223,16,1442049514,1442049634,3,7,120
65645597@N00,8223,26,1442049634,1442050534,6,7,900
65651806@N00,8224,29,1293527354,1293528254,2,5,900
65651806@N00,8224,17,1293528447,1293528747,3,5,300
65651806@N00,8224,16,1293530910,1293531180,2,5,270
65651806@N00,8224,20,1293537357,1293537897,2,5,540
65651806@N00,8224,26,1293539907,1293540807,1,5,900
65679275@N02,8225,27,1311674050,1311674950,1,1,900
65679275@N02,8226,1,1369295341,1369295401,2,3,60
65679275@N02,8226,13,1369296649,1369296889,4,3,240
65679275@N02,8226,7,1369304234,1369304414,1,3,180
65679275@N02,8227,1,1369334398,1369334458,2,4,60
65679275@N02,8227,26,1369337421,1369338321,2,4,900
65679275@N02,8227,1,1369340176,1369340236,2,4,60
65679275@N02,8227,28,1369341962,1369342862,1,4,900
65679275@N02,8228,26,1369401498,1369402398,2,2,900
65679275@N02,8228,13,1369406261,1369406501,1,2,240
65679275@N02,8229,1,1369439647,1369439707,1,1,60
65679275@N02,8230,1,1369638974,1369639034,1,1,60
65679275@N02,8231,1,1377996104,1377996164,1,1,60
65679275@N02,8232,28,1380077846,1380078746,1,1,900
65717496@N00,8233,18,1443699132,1443699582,1,1,450
65717496@N00,8234,18,1448695130,1448695580,1,1,450
65717496@N00,8235,23,1463702601,1463703201,1,1,600
65784570@N00,8236,5,1336806107,1336806227,1,1,120
65784570@N00,8237,1,1404703107,1404703167,1,1,60
65806304@N05,8238,25,1421117264,1421118104,1,1,840
65806304@N05,8239,18,1421208184,1421208634,1,1,450
65873732@N05,8240,1,1364343666,1364343726,1,1,60
65883612@N08,8241,16,1362267368,1362267638,5,4,270
65883612@N08,8241,19,1362270887,1362271427,2,4,540
65883612@N08,8241,23,1362275400,1362276000,3,4,600
65883612@N08,8241,8,1362279812,1362279992,1,4,180
65883612@N08,8242,12,1362472444,1362472684,1,1,240
65883612@N08,8243,18,1362551847,1362552297,1,1,450
65883612@N08,8244,13,1362618951,1362619191,2,5,240
65883612@N08,8244,22,1362623281,1362623881,3,5,600
65883612@N08,8244,16,1362629191,1362629461,3,5,270
65883612@N08,8244,19,1362632922,1362633462,4,5,540
65883612@N08,8244,25,1362638602,1362639442,1,5,840
65886790@N05,8245,26,1415246901,1415247801,1,1,900
65925308@N02,8246,1,1373406617,1373406677,1,1,60
65925308@N02,8247,13,1374101403,1374101528,2,2,125
65925308@N02,8247,27,1374101528,1374102428,1,2,900
65925308@N02,8248,1,1374439327,1374439387,1,1,60
65925308@N02,8249,1,1374482296,1374482356,1,1,60
65925308@N02,8250,29,1374960034,1374960934,1,1,900
65925308@N02,8251,1,1375955948,1375956008,2,1,60
65925308@N02,8252,13,1376174896,1376175136,1,1,240
65925308@N02,8253,1,1376260193,1376260253,1,1,60
65925308@N02,8254,1,1377985643,1377985703,1,1,60
65925308@N02,8255,14,1378065992,1378066232,1,1,240
65925647@N08,8256,17,1380478144,1380478444,1,1,300
65927504@N05,8257,26,1313981429,1313982329,1,1,900
65932457@N03,8258,30,1314685907,1314686987,1,1,1080
65932457@N03,8259,30,1319433460,1319434540,1,1,1080
65943028@N03,8260,26,1290684663,1290685563,1,1,900
65945527@N00,8261,28,1205134361,1205134367,2,4,6
65945527@N00,8261,26,1205134367,1205134371,2,4,4
65945527@N00,8261,29,1205134371,1205134390,2,4,19
65945527@N00,8261,31,1205134390,1205135890,1,4,1500
65945527@N00,8262,20,1205191155,1205191165,2,4,10
65945527@N00,8262,26,1205191165,1205191170,2,4,5
65945527@N00,8262,28,1205191170,1205191180,2,4,10
65945527@N00,8262,26,1205191180,1205192080,1,4,900
65945527@N00,8263,31,1205288291,1205288312,2,4,21
65945527@N00,8263,20,1205288312,1205288543,2,4,231
65945527@N00,8263,31,1205288543,1205290043,2,4,1500
65945527@N00,8263,26,1205312290,1205313190,1,4,900
65959869@N08,8264,1,1343003125,1343003185,2,4,60
65959869@N08,8264,21,1343004301,1343004871,3,4,570
65959869@N08,8264,13,1343005227,1343005467,2,4,240
65959869@N08,8264,18,1343024381,1343024831,1,4,450
65959869@N08,8265,12,1343266641,1343266881,2,3,240
65959869@N08,8265,11,1343268817,1343269057,2,3,240
65959869@N08,8265,20,1343276119,1343276659,2,3,540
65975121@N07,8266,17,1431250999,1431251299,1,1,300
65977111@N03,8267,31,1351762964,1351764464,2,1,1500
65977111@N03,8268,22,1380001302,1380001902,2,5,600
65977111@N03,8268,16,1380008689,1380008729,2,5,40
65977111@N03,8268,27,1380008729,1380008778,2,5,49
65977111@N03,8268,16,1380008778,1380008780,2,5,2
65977111@N03,8268,27,1380008780,1380009680,3,5,900
65997263@N08,8269,28,1352934230,1352935130,2,2,900
65997263@N08,8269,22,1352935150,1352935750,1,2,600
66008314@N00,8270,28,1216525426,1216526326,1,1,900
66008314@N00,8271,17,1223078105,1223078405,2,3,300
66008314@N00,8271,22,1223093127,1223093727,5,3,600
66008314@N00,8271,28,1223096789,1223097689,3,3,900
66008314@N00,8272,28,1230860982,1230861882,1,1,900
66008314@N00,8273,28,1233453467,1233453663,2,3,196
66008314@N00,8273,26,1233453663,1233454563,3,3,900
66008314@N00,8273,23,1233463235,1233463835,1,3,600
66008314@N00,8274,26,1258179777,1258180677,1,1,900
66008314@N00,8275,30,1275080624,1275081704,4,4,1080
66008314@N00,8275,26,1275085476,1275086376,2,4,900
66008314@N00,8275,28,1275094119,1275095019,2,4,900
66008314@N00,8275,30,1275111481,1275112561,1,4,1080
66008314@N00,8276,30,1275141058,1275142138,1,1,1080
66008314@N00,8277,30,1275179153,1275180233,2,1,1080
66008314@N00,8278,25,1292628001,1292628841,4,10,840
66008314@N00,8278,13,1292629154,1292629392,2,10,238
66008314@N00,8278,25,1292629392,1292630232,2,10,840
66008314@N00,8278,13,1292630485,1292630527,2,10,42
66008314@N00,8278,25,1292630527,1292631367,2,10,840
66008314@N00,8278,13,1292631699,1292631939,2,10,240
66008314@N00,8278,30,1292635763,1292636843,4,10,1080
66008314@N00,8278,26,1292659978,1292660878,2,10,900
66008314@N00,8278,1,1292662953,1292663013,4,10,60
66008314@N00,8278,28,1292666191,1292667091,2,10,900
66008314@N00,8279,28,1314404856,1314405756,2,3,900
66008314@N00,8279,17,1314409904,1314410204,2,3,300
66008314@N00,8279,14,1314416221,1314416461,1,3,240
66008314@N00,8280,26,1319248744,1319249644,2,3,900
66008314@N00,8280,1,1319260479,1319260539,2,3,60
66008314@N00,8280,24,1319261405,1319262185,1,3,780
66008314@N00,8281,17,1321062512,1321062812,1,1,300
66008314@N00,8282,30,1322951844,1322952924,2,1,1080
66008314@N00,8283,14,1342319664,1342319904,2,2,240
66008314@N00,8283,29,1342320139,1342321039,1,2,900
66008314@N00,8284,17,1349472607,1349472907,3,4,300
66008314@N00,8284,3,1349475096,1349475186,3,4,90
66008314@N00,8284,12,1349476124,1349476364,3,4,240
66008314@N00,8284,30,1349484918,1349485998,4,4,1080
66026223@N08,8285,26,1377425422,1377426322,2,1,900
66026223@N08,8286,1,1377959352,1377959412,1,1,60
66026223@N08,8287,3,1378010600,1378010690,2,5,90
66026223@N08,8287,16,1378010803,1378011021,2,5,218
66026223@N08,8287,26,1378011021,1378011921,3,5,900
66026223@N08,8287,16,1378012152,1378012422,2,5,270
66026223@N08,8287,13,1378034342,1378034582,1,5,240
66026223@N08,8288,28,1378087689,1378087987,2,2,298
66026223@N08,8288,13,1378087987,1378088227,1,2,240
66026223@N08,8289,14,1378120265,1378120505,2,4,240
66026223@N08,8289,20,1378121548,1378121730,2,4,182
66026223@N08,8289,29,1378121730,1378121859,2,4,129
66026223@N08,8289,14,1378121859,1378122099,1,4,240
66026223@N08,8290,13,1378393819,1378394059,2,2,240
66026223@N08,8290,24,1378394177,1378394957,2,2,780
66026223@N08,8291,20,1382745213,1382745753,1,1,540
66026223@N08,8292,26,1383051777,1383051977,2,2,200
66026223@N08,8292,20,1383051977,1383052517,1,2,540
66026985@N02,8293,28,1367372999,1367373899,2,6,900
66026985@N02,8293,26,1367374638,1367375538,2,6,900
66026985@N02,8293,28,1367379727,1367380012,6,6,285
66026985@N02,8293,27,1367380012,1367380089,3,6,77
66026985@N02,8293,17,1367380089,1367380134,2,6,45
66026985@N02,8293,27,1367380134,1367381034,1,6,900
66051919@N00,8294,30,1223695980,1223697060,1,1,1080
66056796@N04,8295,1,1418642239,1418642299,1,1,60
66064257@N08,8296,19,1409373141,1409373681,3,1,540
66064257@N08,8297,18,1428914958,1428915408,1,1,450
66087520@N05,8298,23,1375664407,1375665007,1,1,600
66087520@N05,8299,5,1375695003,1375695123,1,1,120
66103198@N07,8300,1,1386830517,1386830577,1,1,60
66234998@N00,8301,28,1292555344,1292556244,1,1,900
66234998@N00,8302,28,1297047072,1297047972,1,1,900
66234998@N00,8303,20,1298350693,1298351233,1,1,540
66234998@N00,8304,29,1305431640,1305432540,1,1,900
66234998@N00,8305,27,1307843974,1307844874,2,1,900
66292766@N05,8306,24,1451614627,1451615407,1,1,780
66304943@N00,8307,17,1196769211,1196769511,1,1,300
66304943@N00,8308,28,1319959089,1319959989,1,1,900
66309654@N00,8309,18,1421499600,1421500050,1,1,450
66313469@N06,8310,27,1310738378,1310739278,2,2,900
66313469@N06,8310,18,1310749836,1310750286,1,2,450
66313469@N06,8311,1,1310816913,1310816973,2,3,60
66313469@N06,8311,28,1310817254,1310818154,3,3,900
66313469@N06,8311,26,1310821463,1310822363,1,3,900
66313469@N06,8312,1,1313123876,1313123936,1,1,60
66313469@N06,8313,15,1314080189,1314080459,1,1,270
66313469@N06,8314,26,1316241682,1316242310,3,2,628
66313469@N06,8314,21,1316242310,1316242880,1,2,570
66313469@N06,8315,26,1317516096,1317516996,1,1,900
66313469@N06,8316,26,1329904390,1329905290,6,3,900
66313469@N06,8316,10,1329908784,1329909024,4,3,240
66313469@N06,8316,26,1329925978,1329926878,1,3,900
66313469@N06,8317,26,1329997521,1329998421,11,1,900
66316766@N06,8318,25,1350104873,1350105713,2,1,840
66316766@N06,8319,28,1350627319,1350627459,4,2,140
66316766@N06,8319,1,1350627459,1350627519,1,2,60
66316766@N06,8320,29,1350800337,1350801237,1,1,900
66316766@N06,8321,14,1351472175,1351472415,2,2,240
66316766@N06,8321,1,1351491063,1351491123,1,2,60
66316766@N06,8322,16,1351899712,1351899982,5,3,270
66316766@N06,8322,1,1351901659,1351901719,10,3,60
66316766@N06,8322,28,1351909368,1351910268,2,3,900
66316766@N06,8323,1,1352533092,1352533152,2,1,60
66316766@N06,8324,25,1352610486,1352611326,2,1,840
66316766@N06,8325,1,1353209058,1353209118,1,1,60
66316766@N06,8326,29,1353812528,1353813428,1,1,900
66316766@N06,8327,29,1354002554,1354003454,1,1,900
66316766@N06,8328,16,1354330046,1354330316,1,1,270
66316766@N06,8329,28,1354404282,1354405182,1,1,900
66316766@N06,8330,1,1354672987,1354672994,3,4,7
66316766@N06,8330,28,1354672994,1354673894,2,4,900
66316766@N06,8330,1,1354674613,1354674673,4,4,60
66316766@N06,8330,28,1354680276,1354681176,3,4,900
66316766@N06,8331,14,1356745019,1356745259,5,3,240
66316766@N06,8331,22,1356752200,1356752800,2,3,600
66316766@N06,8331,1,1356759479,1356759539,1,3,60
66316766@N06,8332,13,1357356771,1357357011,5,1,240
66316766@N06,8333,21,1357868029,1357868599,2,2,570
66316766@N06,8333,31,1357869929,1357871429,1,2,1500
66316766@N06,8334,25,1358150686,1358151526,1,1,840
66316766@N06,8335,29,1358480782,1358481682,1,1,900
66316766@N06,8336,31,1358829981,1358829987,2,3,6
66316766@N06,8336,28,1358829987,1358829989,2,3,2
66316766@N06,8336,18,1358829989,1358830439,1,3,450
66316766@N06,8337,26,1359866405,1359867305,1,1,900
66316766@N06,8338,25,1360052094,1360052934,2,2,840
66316766@N06,8338,28,1360053003,1360053903,5,2,900
66316766@N06,8339,26,1360480590,1360481490,1,1,900
66316766@N06,8340,21,1360644917,1360645487,1,1,570
66316766@N06,8341,20,1360805531,1360805664,2,3,133
66316766@N06,8341,28,1360805664,1360806564,4,3,900
66316766@N06,8341,29,1360823366,1360824266,1,3,900
66316766@N06,8342,11,1364102445,1364102452,2,2,7
66316766@N06,8342,25,1364102452,1364103292,1,2,840
66316766@N06,8343,28,1365060850,1365061750,1,1,900
66316766@N06,8344,31,1365124276,1365125776,1,1,1500
66316766@N06,8345,12,1366347437,1366347677,2,2,240
66316766@N06,8345,11,1366358450,1366358690,1,2,240
66316766@N06,8346,13,1367301750,1367301990,2,1,240
66316766@N06,8347,29,1368315551,1368316451,2,6,900
66316766@N06,8347,16,1368320640,1368320910,2,6,270
66316766@N06,8347,30,1368321679,1368322759,2,6,1080
66316766@N06,8347,11,1368332447,1368332687,2,6,240
66316766@N06,8347,26,1368335320,1368336220,4,6,900
66316766@N06,8347,20,1368345981,1368346521,1,6,540
66316766@N06,8348,11,1369615079,1369615319,3,4,240
66316766@N06,8348,25,1369616508,1369616983,2,4,475
66316766@N06,8348,21,1369616983,1369617553,2,4,570
66316766@N06,8348,11,1369618233,1369618473,1,4,240
66316766@N06,8349,11,1369800545,1369800785,2,2,240
66316766@N06,8349,30,1369809074,1369810154,1,2,1080
66316766@N06,8350,31,1370327594,1370327834,2,2,240
66316766@N06,8350,10,1370327834,1370328074,1,2,240
66316766@N06,8351,11,1370395058,1370395298,1,1,240
66352349@N00,8352,28,1339496012,1339496912,1,1,900
66382450@N08,8353,1,1369419648,1369419708,1,1,60
66390033@N02,8354,1,1283984180,1283984240,1,1,60
66390033@N02,8355,1,1284122749,1284122809,1,1,60
66390033@N02,8356,1,1402221600,1402221660,2,1,60
66406888@N08,8357,29,1257229568,1257230468,1,1,900
66406888@N08,8358,30,1285656129,1285657209,2,2,1080
66406888@N08,8358,31,1285659716,1285661216,1,2,1500
66406888@N08,8359,30,1321670789,1321671869,1,1,1080
66406888@N08,8360,24,1338249862,1338250642,1,1,780
66406888@N08,8361,29,1342767490,1342768390,1,1,900
66406888@N08,8362,1,1344673034,1344673094,1,1,60
66406888@N08,8363,1,1347574157,1347574217,1,1,60
66406888@N08,8364,1,1352969091,1352969151,1,1,60
66406888@N08,8365,1,1369239847,1369239907,1,1,60
66565233@N00,8366,11,1227322832,1227323072,1,1,240
66565233@N00,8367,5,1258793330,1258793450,1,1,120
66626762@N06,8368,1,1418479010,1418479070,1,1,60
66626894@N06,8369,22,1345440216,1345440816,2,2,600
66626894@N06,8369,28,1345462406,1345463306,2,2,900
66729316@N00,8370,28,1253920361,1253921261,2,1,900
66729316@N00,8371,13,1253971027,1253971267,3,1,240
66729316@N00,8372,28,1254179328,1254180228,2,1,900
66729316@N00,8373,13,1254242484,1254242724,7,1,240
66729316@N00,8374,12,1306110357,1306110597,5,3,240
66729316@N00,8374,26,1306114824,1306115724,13,3,900
66729316@N00,8374,13,1306122221,1306122461,4,3,240
66729316@N00,8375,26,1306281186,1306282086,4,4,900
66729316@N00,8375,13,1306283914,1306284154,6,4,240
66729316@N00,8375,26,1306299761,1306300661,2,4,900
66729316@N00,8375,15,1306301842,1306302112,1,4,270
66729316@N00,8376,28,1306364192,1306365092,2,9,900
66729316@N00,8376,26,1306366011,1306366911,2,9,900
66729316@N00,8376,24,1306370777,1306371557,2,9,780
66729316@N00,8376,15,1306372134,1306372404,10,9,270
66729316@N00,8376,26,1306373919,1306374819,2,9,900
66729316@N00,8376,15,1306375830,1306376100,3,9,270
66729316@N00,8376,13,1306379218,1306379458,8,9,240
66729316@N00,8376,12,1306379865,1306380105,3,9,240
66729316@N00,8376,26,1306397938,1306398838,1,9,900
66729316@N00,8377,26,1306454828,1306455728,4,5,900
66729316@N00,8377,16,1306456438,1306456496,2,5,58
66729316@N00,8377,26,1306456496,1306457396,7,5,900
66729316@N00,8377,22,1306472066,1306472666,8,5,600
66729316@N00,8377,26,1306502970,1306503870,2,5,900
66729316@N00,8378,3,1306535995,1306536008,2,5,13
66729316@N00,8378,12,1306536008,1306536248,2,5,240
66729316@N00,8378,13,1306538002,1306538242,29,5,240
66729316@N00,8378,26,1306544451,1306545351,4,5,900
66729316@N00,8378,22,1306549337,1306549937,1,5,600
66729316@N00,8379,26,1306592206,1306593106,5,3,900
66729316@N00,8379,13,1306594856,1306595096,22,3,240
66729316@N00,8379,26,1306612607,1306613507,1,3,900
66729316@N00,8380,1,1343976860,1343976920,2,2,60
66729316@N00,8380,27,1343980070,1343980970,1,2,900
66729316@N00,8381,1,1344037453,1344037513,4,8,60
66729316@N00,8381,24,1344040577,1344040673,2,8,96
66729316@N00,8381,15,1344040673,1344040943,10,8,270
66729316@N00,8381,24,1344042912,1344043060,2,8,148
66729316@N00,8381,15,1344043060,1344043124,4,8,64
66729316@N00,8381,24,1344043124,1344043904,2,8,780
66729316@N00,8381,17,1344052083,1344052383,2,8,300
66729316@N00,8381,11,1344071972,1344072212,2,8,240
66729316@N00,8382,14,1344143019,1344143259,1,1,240
66736603@N00,8383,15,1390611244,1390611514,1,1,270
66787548@N00,8384,20,1298162601,1298163141,2,2,540
66787548@N00,8384,26,1298167248,1298168148,1,2,900
66787548@N00,8385,18,1299027141,1299027591,2,9,450
66787548@N00,8385,23,1299031048,1299031648,2,9,600
66787548@N00,8385,20,1299032233,1299032773,2,9,540
66787548@N00,8385,3,1299039681,1299039771,3,9,90
66787548@N00,8385,17,1299044042,1299044342,2,9,300
66787548@N00,8385,12,1299045390,1299045630,2,9,240
66787548@N00,8385,13,1299047559,1299047799,3,9,240
66787548@N00,8385,25,1299049518,1299050358,3,9,840
66787548@N00,8385,15,1299050521,1299050791,1,9,270
66787548@N00,8386,12,1306026038,1306026278,1,1,240
66787548@N00,8387,28,1355547943,1355548843,2,3,900
66787548@N00,8387,18,1355549536,1355549986,2,3,450
66787548@N00,8387,28,1355553542,1355554442,1,3,900
66787548@N00,8388,28,1356662459,1356663359,2,3,900
66787548@N00,8388,7,1356673082,1356673262,2,3,180
66787548@N00,8388,25,1356680521,1356681361,1,3,840
66787548@N00,8389,1,1358123456,1358123516,2,7,60
66787548@N00,8389,26,1358125495,1358126395,2,7,900
66787548@N00,8389,18,1358127934,1358128384,2,7,450
66787548@N00,8389,26,1358132151,1358133051,2,7,900
66787548@N00,8389,30,1358141056,1358142136,2,7,1080
66787548@N00,8389,7,1358148419,1358148599,2,7,180
66787548@N00,8389,15,1358152806,1358153076,1,7,270
66787548@N00,8390,28,1361424342,1361425242,2,3,900
66787548@N00,8390,20,1361428720,1361429260,2,3,540
66787548@N00,8390,29,1361431134,1361432034,1,3,900
66787548@N00,8391,1,1368178817,1368178877,2,3,60
66787548@N00,8391,28,1368185368,1368186268,2,3,900
66787548@N00,8391,10,1368186945,1368187185,1,3,240
66801522@N00,8392,28,1248169703,1248170603,1,1,900
66854904@N06,8393,19,1346417620,1346418160,1,1,540
66905940@N00,8394,15,1359074046,1359074316,2,3,270
66905940@N00,8394,29,1359075463,1359076363,2,3,900
66905940@N00,8394,23,1359100063,1359100663,1,3,600
66905940@N00,8395,29,1359160105,1359161005,2,3,900
66905940@N00,8395,15,1359171526,1359171796,3,3,270
66905940@N00,8395,26,1359189589,1359190489,2,3,900
66905940@N00,8396,13,1359247564,1359247804,1,1,240
66915962@N00,8397,3,1345747483,1345747573,1,1,90
66926478@N00,8398,28,1237331641,1237332541,8,1,900
66926478@N00,8399,28,1252280822,1252281722,3,1,900
66926478@N00,8400,28,1256167579,1256168479,4,1,900
66976172@N00,8401,30,1376435181,1376436261,2,2,1080
66976172@N00,8401,13,1376458312,1376458552,1,2,240
66994870@N00,8402,1,1236823969,1236824029,2,6,60
66994870@N00,8402,26,1236824535,1236825435,5,6,900
66994870@N00,8402,7,1236831579,1236831759,3,6,180
66994870@N00,8402,1,1236836387,1236836447,6,6,60
66994870@N00,8402,28,1236838356,1236839256,3,6,900
66994870@N00,8402,26,1236848353,1236849253,8,6,900
66994870@N00,8403,1,1256686228,1256686288,6,13,60
66994870@N00,8403,23,1256687292,1256687892,3,13,600
66994870@N00,8403,29,1256688533,1256689433,2,13,900
66994870@N00,8403,20,1256693026,1256693566,3,13,540
66994870@N00,8403,11,1256696925,1256697165,3,13,240
66994870@N00,8403,8,1256698127,1256698307,2,13,180
66994870@N00,8403,3,1256698356,1256698446,3,13,90
66994870@N00,8403,8,1256702450,1256702630,2,13,180
66994870@N00,8403,1,1256702707,1256702767,2,13,60
66994870@N00,8403,28,1256702837,1256703737,2,13,900
66994870@N00,8403,1,1256704004,1256704064,2,13,60
66994870@N00,8403,28,1256708056,1256708956,4,13,900
66994870@N00,8403,1,1256712252,1256712312,3,13,60
67011795@N00,8404,13,1364176502,1364176742,2,2,240
67011795@N00,8404,4,1364200424,1364200525,1,2,101
67011795@N00,8405,17,1364298342,1364298642,1,1,300
67011795@N00,8406,3,1364366795,1364366885,2,2,90
67011795@N00,8406,26,1364387870,1364388770,1,2,900
67066894@N00,8407,18,1450306680,1450307130,1,1,450
67093054@N00,8408,1,1367115883,1367115943,4,20,60
67093054@N00,8408,28,1367116078,1367116646,3,20,568
67093054@N00,8408,16,1367116646,1367116713,2,20,67
67093054@N00,8408,23,1367116713,1367117313,7,20,600
67093054@N00,8408,26,1367119068,1367119968,3,20,900
67093054@N00,8408,16,1367120192,1367120462,3,20,270
67093054@N00,8408,26,1367121132,1367121264,4,20,132
67093054@N00,8408,6,1367121264,1367121384,3,20,120
67093054@N00,8408,11,1367122013,1367122253,2,20,240
67093054@N00,8408,31,1367122342,1367122451,2,20,109
67093054@N00,8408,30,1367122451,1367123531,3,20,1080
67093054@N00,8408,29,1367123917,1367124817,8,20,900
67093054@N00,8408,20,1367128081,1367128621,4,20,540
67093054@N00,8408,26,1367129810,1367130187,2,20,377
67093054@N00,8408,5,1367130187,1367130215,2,20,28
67093054@N00,8408,21,1367130215,1367130391,2,20,176
67093054@N00,8408,12,1367130391,1367130604,4,20,213
67093054@N00,8408,16,1367130604,1367130874,2,20,270
67093054@N00,8408,17,1367132319,1367132619,4,20,300
67093054@N00,8408,1,1367135875,1367135935,2,20,60
67093054@N00,8409,1,1367209935,1367209995,1,1,60
67093054@N00,8410,28,1394336660,1394336902,5,29,242
67093054@N00,8410,16,1394336902,1394337172,6,29,270
67093054@N00,8410,3,1394337861,1394337951,2,29,90
67093054@N00,8410,26,1394338120,1394339020,6,29,900
67093054@N00,8410,23,1394339279,1394339879,5,29,600
67093054@N00,8410,18,1394340066,1394340516,2,29,450
67093054@N00,8410,23,1394340548,1394340604,3,29,56
67093054@N00,8410,18,1394340604,1394341054,2,29,450
67093054@N00,8410,29,1394341362,1394342262,22,29,900
67093054@N00,8410,20,1394347374,1394347914,11,29,540
67093054@N00,8410,31,1394349383,1394350444,6,29,1061
67093054@N00,8410,30,1394350444,1394350663,4,29,219
67093054@N00,8410,26,1394350663,1394350840,3,29,177
67093054@N00,8410,27,1394350840,1394351678,4,29,838
67093054@N00,8410,16,1394351678,1394351721,4,29,43
67093054@N00,8410,27,1394351721,1394351728,2,29,7
67093054@N00,8410,16,1394351728,1394351998,2,29,270
67093054@N00,8410,27,1394352234,1394353104,5,29,870
67093054@N00,8410,17,1394353104,1394353331,4,29,227
67093054@N00,8410,16,1394353331,1394353368,2,29,37
67093054@N00,8410,26,1394353368,1394353430,4,29,62
67093054@N00,8410,23,1394353430,1394354030,2,29,600
67093054@N00,8410,16,1394355966,1394356128,2,29,162
67093054@N00,8410,28,1394356128,1394357028,10,29,900
67093054@N00,8410,29,1394364022,1394364922,5,29,900
67093054@N00,8410,14,1394366353,1394366593,2,29,240
67093054@N00,8410,31,1394366881,1394367096,2,29,215
67093054@N00,8410,19,1394367096,1394367557,4,29,461
67093054@N00,8410,26,1394367557,1394368457,3,29,900
67123974@N05,8411,30,1350029036,1350030116,1,1,1080
67156975@N00,8412,28,1292301175,1292301342,2,2,167
67156975@N00,8412,22,1292301342,1292301942,1,2,600
67232196@N07,8413,12,1361572386,1361572626,2,2,240
67232196@N07,8413,22,1361581927,1361582527,1,2,600
67232196@N07,8414,25,1387528760,1387529600,1,1,840
67234205@N05,8415,18,1311507250,1311507700,1,1,450
67246822@N00,8416,16,1211411316,1211411330,2,7,14
67246822@N00,8416,12,1211411330,1211411570,2,7,240
67246822@N00,8416,3,1211412293,1211412383,2,7,90
67246822@N00,8416,10,1211415208,1211415448,2,7,240
67246822@N00,8416,20,1211416448,1211416988,3,7,540
67246822@N00,8416,29,1211419711,1211420611,2,7,900
67246822@N00,8416,26,1211424891,1211425791,2,7,900
67246822@N00,8417,26,1211518917,1211519817,3,4,900
67246822@N00,8417,28,1211521270,1211521932,2,4,662
67246822@N00,8417,19,1211521932,1211522100,2,4,168
67246822@N00,8417,29,1211522100,1211523000,1,4,900
67246822@N00,8418,1,1237846959,1237847019,2,13,60
67246822@N00,8418,23,1237848423,1237849023,2,13,600
67246822@N00,8418,29,1237850668,1237851568,5,13,900
67246822@N00,8418,20,1237863007,1237863547,6,13,540
67246822@N00,8418,30,1237865122,1237866202,2,13,1080
67246822@N00,8418,1,1237874260,1237874320,2,13,60
67246822@N00,8418,26,1237874561,1237875461,7,13,900
67246822@N00,8418,10,1237875824,1237876064,2,13,240
67246822@N00,8418,25,1237876920,1237877760,4,13,840
67246822@N00,8418,3,1237878743,1237878833,2,13,90
67246822@N00,8418,7,1237879739,1237879919,3,13,180
67246822@N00,8418,26,1237880364,1237881264,3,13,900
67246822@N00,8418,30,1237885187,1237886267,2,13,1080
67246822@N00,8419,17,1237954432,1237954732,2,7,300
67246822@N00,8419,12,1237958660,1237958900,2,7,240
67246822@N00,8419,24,1237958972,1237959752,2,7,780
67246822@N00,8419,12,1237960005,1237960245,3,7,240
67246822@N00,8419,5,1237960303,1237960423,3,7,120
67246822@N00,8419,26,1237961399,1237961500,2,7,101
67246822@N00,8419,28,1237961500,1237962400,1,7,900
67246822@N00,8420,3,1238059433,1238059523,2,3,90
67246822@N00,8420,20,1238062197,1238062737,2,3,540
67246822@N00,8420,28,1238063494,1238064394,1,3,900
67246822@N00,8421,20,1238113498,1238114038,6,5,540
67246822@N00,8421,10,1238115967,1238116207,2,5,240
67246822@N00,8421,22,1238117502,1238118102,3,5,600
67246822@N00,8421,8,1238120778,1238120958,3,5,180
67246822@N00,8421,5,1238121445,1238121565,1,5,120
67246822@N00,8422,23,1238372912,1238373512,1,1,600
67246822@N00,8423,28,1355109025,1355109925,1,1,900
67246822@N00,8424,26,1355183190,1355184090,2,2,900
67246822@N00,8424,29,1355190841,1355191741,1,2,900
67246822@N00,8425,20,1355291318,1355291645,2,3,327
67246822@N00,8425,29,1355291645,1355292545,3,3,900
67246822@N00,8425,26,1355292664,1355293564,2,3,900
67246822@N00,8426,17,1355373823,1355374123,2,2,300
67246822@N00,8426,28,1355374949,1355375849,1,2,900
67252708@N03,8427,1,1277170199,1277170259,1,1,60
67260043@N04,8428,1,1324724606,1324724666,2,3,60
67260043@N04,8428,28,1324724684,1324725519,7,3,835
67260043@N04,8428,1,1324725519,1324725579,1,3,60
67260043@N04,8429,1,1324772861,1324772921,6,15,60
67260043@N04,8429,18,1324775448,1324775898,2,15,450
67260043@N04,8429,20,1324776593,1324777133,4,15,540
67260043@N04,8429,29,1324777263,1324778163,3,15,900
67260043@N04,8429,20,1324780323,1324780863,2,15,540
67260043@N04,8429,10,1324784298,1324784538,2,15,240
67260043@N04,8429,6,1324785171,1324785245,2,15,74
67260043@N04,8429,8,1324785245,1324785425,2,15,180
67260043@N04,8429,26,1324785471,1324786206,4,15,735
67260043@N04,8429,23,1324786206,1324786237,2,15,31
67260043@N04,8429,18,1324786237,1324786259,2,15,22
67260043@N04,8429,23,1324786259,1324786427,4,15,168
67260043@N04,8429,30,1324786427,1324787187,2,15,760
67260043@N04,8429,23,1324787187,1324787787,3,15,600
67260043@N04,8429,30,1324789159,1324790239,2,15,1080
67260043@N04,8430,26,1324865468,1324866368,2,10,900
67260043@N04,8430,24,1324867669,1324868449,3,10,780
67260043@N04,8430,5,1324891926,1324892046,2,10,120
67260043@N04,8430,8,1324892073,1324892253,3,10,180
67260043@N04,8430,25,1324895263,1324896103,3,10,840
67260043@N04,8430,26,1324900794,1324901694,7,10,900
67260043@N04,8430,16,1324902249,1324902412,3,10,163
67260043@N04,8430,27,1324902412,1324902924,5,10,512
67260043@N04,8430,26,1324902924,1324903824,3,10,900
67260043@N04,8430,28,1324903856,1324904756,3,10,900
67341227@N00,8431,24,1198287277,1198288057,8,6,780
67341227@N00,8431,23,1198301050,1198301650,3,6,600
67341227@N00,8431,16,1198301890,1198302160,2,6,270
67341227@N00,8431,26,1198302375,1198303275,11,6,900
67341227@N00,8431,25,1198311209,1198311831,3,6,622
67341227@N00,8431,4,1198311831,1198311932,1,6,101
67406704@N00,8432,26,1291160432,1291161332,2,4,900
67406704@N00,8432,7,1291165219,1291165399,2,4,180
67406704@N00,8432,28,1291183544,1291183824,4,4,280
67406704@N00,8432,16,1291183824,1291184094,1,4,270
67414260@N04,8433,15,1359866354,1359866624,2,3,270
67414260@N04,8433,26,1359893853,1359893878,2,3,25
67414260@N04,8433,17,1359893878,1359894178,3,3,300
67429254@N08,8434,1,1451019555,1451019615,1,1,60
67457152@N03,8435,22,1324725489,1324726089,2,1,600
67485853@N00,8436,26,1305510996,1305511896,20,1,900
67506747@N00,8437,13,1239089219,1239089459,5,2,240
67506747@N00,8437,17,1239093642,1239093942,1,2,300
67506747@N00,8438,24,1262259027,1262259807,1,1,780
67507070@N00,8439,28,1311681754,1311682654,2,1,900
67511235@N04,8440,11,1341013865,1341014105,1,1,240
67527114@N03,8441,22,1350667950,1350668550,1,1,600
67582642@N00,8442,26,1251801704,1251802604,1,1,900
67601202@N00,8443,10,1189824686,1189824926,2,2,240
67601202@N00,8443,31,1189825234,1189826734,3,2,1500
67621043@N00,8444,28,1314151205,1314151760,2,4,555
67621043@N00,8444,26,1314151760,1314152660,2,4,900
67621043@N00,8444,29,1314157048,1314157948,3,4,900
67621043@N00,8444,20,1314160834,1314161374,1,4,540
67621043@N00,8445,28,1438260042,1438260942,1,1,900
67621043@N00,8446,18,1438404317,1438404767,1,1,450
67671102@N00,8447,29,1351904019,1351904919,1,1,900
67694478@N02,8448,26,1356508190,1356509090,2,1,900
67694478@N02,8449,26,1356639956,1356640856,1,1,900
67694478@N02,8450,26,1356772021,1356772921,2,1,900
67764891@N00,8451,25,1259547315,1259548155,3,1,840
67839741@N06,8452,1,1401851091,1401851151,1,1,60
67839741@N06,8453,27,1403142997,1403143897,1,1,900
67839741@N06,8454,19,1415576458,1415576928,2,2,470
67839741@N06,8454,18,1415576928,1415577378,1,2,450
67839741@N06,8455,13,1418866529,1418866769,1,1,240
67839741@N06,8456,18,1420236996,1420237446,1,1,450
67839741@N06,8457,31,1423110851,1423112351,1,1,1500
67839741@N06,8458,29,1425363045,1425363945,1,1,900
67839741@N06,8459,13,1430210729,1430210969,1,1,240
67892147@N00,8460,16,1324534371,1324534641,1,1,270
67892147@N00,8461,16,1324594064,1324594088,2,3,24
67892147@N00,8461,29,1324594088,1324594123,2,3,35
67892147@N00,8461,24,1324594123,1324594903,1,3,780
67892147@N00,8462,15,1325463694,1325463718,2,4,24
67892147@N00,8462,23,1325463718,1325463755,2,4,37
67892147@N00,8462,1,1325463755,1325463763,2,4,8
67892147@N00,8462,16,1325463763,1325464033,2,4,270
67954857@N00,8463,1,1306303820,1306303880,1,1,60
67979847@N04,8464,1,1399697671,1399697731,6,1,60
67994320@N00,8465,26,1270950949,1270951849,1,1,900
68002062@N06,8466,26,1337767517,1337768417,1,1,900
68016701@N04,8467,26,1357377880,1357378780,1,1,900
68092559@N06,8468,1,1381607370,1381607430,1,1,60
68092559@N06,8469,1,1381675601,1381675661,2,1,60
68092559@N06,8470,20,1381974426,1381974698,2,4,272
68092559@N06,8470,31,1381974698,1381976198,2,4,1500
68092559@N06,8470,28,1381977020,1381977920,2,4,900
68092559@N06,8470,1,1381987520,1381987580,1,4,60
68092559@N06,8471,1,1382949591,1382949651,1,1,60
68092559@N06,8472,30,1395094614,1395095694,1,1,1080
68092559@N06,8473,26,1399881844,1399882744,3,1,900
68092559@N06,8474,19,1406089770,1406090310,1,1,540
68092559@N06,8475,18,1432298266,1432298716,2,1,450
68111040@N00,8476,18,1214273538,1214273988,2,5,450
68111040@N00,8476,16,1214300647,1214300917,3,5,270
68111040@N00,8476,17,1214304745,1214304763,2,5,18
68111040@N00,8476,27,1214304763,1214305598,2,5,835
68111040@N00,8476,16,1214305598,1214305868,1,5,270
68111040@N00,8477,15,1216202604,1216202874,3,2,270
68111040@N00,8477,27,1216214770,1216215670,1,2,900
68111040@N00,8478,15,1247046971,1247047241,1,1,270
68126271@N03,8479,3,1388124892,1388124982,1,1,90
68126271@N03,8480,14,1388449846,1388450086,2,5,240
68126271@N03,8480,20,1388465959,1388466499,2,5,540
68126271@N03,8480,29,1388469478,1388470378,2,5,900
68126271@N03,8480,21,1388472899,1388473469,2,5,570
68126271@N03,8480,25,1388473999,1388474839,4,5,840
68126271@N03,8481,26,1419979813,1419980713,2,10,900
68126271@N03,8481,3,1419982940,1419983030,3,10,90
68126271@N03,8481,28,1419994834,1419995734,2,10,900
68126271@N03,8481,29,1419997287,1419998187,2,10,900
68126271@N03,8481,16,1420015866,1420016136,2,10,270
68126271@N03,8481,29,1420016800,1420017700,2,10,900
68126271@N03,8481,31,1420018982,1420020482,2,10,1500
68126271@N03,8481,25,1420027164,1420028004,3,10,840
68126271@N03,8481,18,1420030354,1420030804,2,10,450
68126271@N03,8481,28,1420031090,1420031990,1,10,900
68126271@N03,8482,28,1431734609,1431735509,1,1,900
68154176@N00,8483,27,1337509470,1337510370,1,1,900
68154176@N00,8484,17,1367745729,1367746029,1,1,300
68154176@N00,8485,17,1379292998,1379293298,1,1,300
68181852@N07,8486,30,1317391200,1317392280,1,1,1080
68181852@N07,8487,30,1318917291,1318918371,2,1,1080
68181852@N07,8488,30,1320546712,1320547792,1,1,1080
68208220@N08,8489,28,1322061104,1322062004,4,1,900
68217111@N00,8490,1,1322007276,1322007336,11,23,60
68217111@N00,8490,30,1322008680,1322008693,2,23,13
68217111@N00,8490,1,1322008693,1322008753,2,23,60
68217111@N00,8490,16,1322009040,1322009310,2,23,270
68217111@N00,8490,27,1322010299,1322010669,2,23,370
68217111@N00,8490,16,1322010669,1322010939,2,23,270
68217111@N00,8490,24,1322013370,1322013377,3,23,7
68217111@N00,8490,15,1322013377,1322013647,2,23,270
68217111@N00,8490,13,1322014144,1322014150,2,23,6
68217111@N00,8490,4,1322014150,1322014251,6,23,101
68217111@N00,8490,11,1322014262,1322014279,2,23,17
68217111@N00,8490,4,1322014279,1322014380,5,23,101
68217111@N00,8490,13,1322016495,1322016735,16,23,240
68217111@N00,8490,21,1322019934,1322020030,5,23,96
68217111@N00,8490,24,1322020030,1322020333,7,23,303
68217111@N00,8490,15,1322020333,1322020603,5,23,270
68217111@N00,8490,13,1322022025,1322022265,2,23,240
68217111@N00,8490,21,1322023557,1322023580,3,23,23
68217111@N00,8490,3,1322023580,1322023670,6,23,90
68217111@N00,8490,21,1322023733,1322024303,4,23,570
68217111@N00,8490,7,1322025401,1322025581,2,23,180
68217111@N00,8490,6,1322025651,1322025771,2,23,120
68217111@N00,8490,26,1322031645,1322032545,1,23,900
68217111@N00,8491,26,1326501204,1326502104,2,8,900
68217111@N00,8491,27,1326505927,1326505950,2,8,23
68217111@N00,8491,17,1326505950,1326506021,3,8,71
68217111@N00,8491,15,1326506021,1326506291,2,8,270
68217111@N00,8491,17,1326508276,1326508576,2,8,300
68217111@N00,8491,27,1326508931,1326509831,2,8,900
68217111@N00,8491,28,1326509968,1326510868,4,8,900
68217111@N00,8491,16,1326511943,1326512213,13,8,270
68217111@N00,8492,1,1330209598,1330209658,2,8,60
68217111@N00,8492,18,1330211715,1330212165,2,8,450
68217111@N00,8492,13,1330214646,1330214886,17,8,240
68217111@N00,8492,4,1330217823,1330217923,9,8,100
68217111@N00,8492,11,1330217923,1330217929,3,8,6
68217111@N00,8492,4,1330217929,1330217935,2,8,6
68217111@N00,8492,11,1330217935,1330218175,2,8,240
68217111@N00,8492,4,1330218582,1330218683,6,8,101
68217111@N00,8493,14,1333237899,1333238139,1,1,240
68255606@N00,8494,28,1358747424,1358748324,1,1,900
68276252@N06,8495,28,1337471737,1337472222,2,18,485
68276252@N06,8495,16,1337472222,1337472492,2,18,270
68276252@N06,8495,26,1337472781,1337473681,2,18,900
68276252@N06,8495,28,1337476008,1337476908,3,18,900
68276252@N06,8495,1,1337477805,1337477856,2,18,51
68276252@N06,8495,28,1337477856,1337478276,3,18,420
68276252@N06,8495,1,1337478276,1337478336,2,18,60
68276252@N06,8495,28,1337478418,1337478639,2,18,221
68276252@N06,8495,1,1337478639,1337478646,2,18,7
68276252@N06,8495,28,1337478646,1337479546,5,18,900
68276252@N06,8495,27,1337479635,1337479731,2,18,96
68276252@N06,8495,28,1337479731,1337480631,5,18,900
68276252@N06,8495,1,1337484750,1337484810,2,18,60
68276252@N06,8495,28,1337484923,1337485823,6,18,900
68276252@N06,8495,4,1337512321,1337512422,2,18,101
68276252@N06,8495,28,1337512986,1337513886,6,18,900
68276252@N06,8495,1,1337517089,1337517149,2,18,60
68276252@N06,8495,26,1337517168,1337518068,1,18,900
68276252@N06,8496,28,1337569949,1337570849,1,1,900
68276252@N06,8497,28,1337601410,1337602310,4,2,900
68276252@N06,8497,17,1337603912,1337604212,1,2,300
68276252@N06,8498,28,1337647795,1337648695,3,5,900
68276252@N06,8498,21,1337649036,1337649606,2,5,570
68276252@N06,8498,28,1337651818,1337652718,4,5,900
68276252@N06,8498,4,1337672384,1337672485,2,5,101
68276252@N06,8498,28,1337673728,1337674628,2,5,900
68276252@N06,8499,13,1337743337,1337743577,2,1,240
68276252@N06,8500,16,1345707227,1345707363,2,4,136
68276252@N06,8500,28,1345707363,1345707859,4,4,496
68276252@N06,8500,17,1345707859,1345708013,2,4,154
68276252@N06,8500,28,1345708013,1345708913,1,4,900
68276252@N06,8501,28,1349818623,1349819523,1,1,900
68313075@N02,8502,26,1342914583,1342915483,1,1,900
68324071@N07,8503,27,1328667405,1328668305,2,3,900
68324071@N07,8503,26,1328673902,1328674802,2,3,900
68324071@N07,8503,29,1328675209,1328676109,1,3,900
68356861@N03,8504,30,1324183375,1324184455,1,1,1080
68398783@N00,8505,30,1261714360,1261715440,1,1,1080
68431505@N00,8506,28,1281939281,1281940181,1,1,900
68431505@N00,8507,26,1283694487,1283695387,1,1,900
68619290@N02,8508,6,1318489164,1318489284,1,1,120
68753746@N00,8509,28,1451279445,1451280345,2,2,900
68753746@N00,8509,15,1451288754,1451289024,1,2,270
68769844@N07,8510,1,1429060396,1429060456,2,12,60
68769844@N07,8510,27,1429061403,1429062129,3,12,726
68769844@N07,8510,1,1429062129,1429062189,2,12,60
68769844@N07,8510,23,1429064586,1429064789,2,12,203
68769844@N07,8510,29,1429064789,1429065689,2,12,900
68769844@N07,8510,30,1429069188,1429070268,2,12,1080
68769844@N07,8510,26,1429072744,1429073644,2,12,900
68769844@N07,8510,25,1429075881,1429076721,2,12,840
68769844@N07,8510,27,1429076961,1429077345,2,12,384
68769844@N07,8510,1,1429077345,1429077405,2,12,60
68769844@N07,8510,29,1429080638,1429081538,2,12,900
68769844@N07,8510,16,1429082246,1429082516,1,12,270
68826320@N00,8511,26,1251435600,1251436500,3,1,900
68839278@N07,8512,16,1337134440,1337134710,1,1,270
68839278@N07,8513,14,1351650995,1351651235,1,1,240
68847360@N04,8514,18,1343856178,1343856628,1,1,450
68851654@N08,8515,16,1309688359,1309688629,2,2,270
68851654@N08,8515,26,1309694414,1309695314,1,2,900
68896886@N05,8516,13,1356604919,1356605159,2,2,240
68896886@N05,8516,10,1356610466,1356610706,1,2,240
68896886@N05,8517,29,1360294487,1360295387,2,2,900
68896886@N05,8517,10,1360299463,1360299703,2,2,240
68926559@N00,8518,17,1254029582,1254029882,1,1,300
68926559@N00,8519,28,1327803623,1327804523,2,2,900
68926559@N00,8519,3,1327806986,1327807076,1,2,90
68931954@N00,8520,28,1344291080,1344291980,2,21,900
68931954@N00,8520,17,1344294928,1344295228,3,21,300
68931954@N00,8520,18,1344297694,1344298144,2,21,450
68931954@N00,8520,29,1344298291,1344299156,4,21,865
68931954@N00,8520,20,1344299156,1344299696,8,21,540
68931954@N00,8520,13,1344301330,1344301570,4,21,240
68931954@N00,8520,1,1344301935,1344301995,4,21,60
68931954@N00,8520,21,1344303132,1344303702,3,21,570
68931954@N00,8520,25,1344303709,1344304549,5,21,840
68931954@N00,8520,15,1344306345,1344306615,5,21,270
68931954@N00,8520,12,1344306617,1344306857,2,21,240
68931954@N00,8520,18,1344308600,1344309050,5,21,450
68931954@N00,8520,24,1344310650,1344311150,3,21,500
68931954@N00,8520,12,1344311150,1344311390,2,21,240
68931954@N00,8520,24,1344312510,1344312578,2,21,68
68931954@N00,8520,12,1344312578,1344312818,3,21,240
68931954@N00,8520,26,1344313633,1344313989,3,21,356
68931954@N00,8520,30,1344313989,1344314582,5,21,593
68931954@N00,8520,22,1344314582,1344315182,5,21,600
68931954@N00,8520,31,1344316160,1344316537,3,21,377
68931954@N00,8520,28,1344316537,1344317437,1,21,900
68946319@N00,8521,29,1297657416,1297658316,1,1,900
68947259@N00,8522,18,1299889992,1299890442,1,1,450
68947259@N00,8523,27,1366187902,1366188802,2,2,900
68947259@N00,8523,28,1366190595,1366191495,9,2,900
68957137@N00,8524,16,1457243066,1457243336,1,1,270
68989113@N00,8525,31,1229044460,1229045960,12,1,1500
68989113@N00,8526,1,1252811232,1252811292,1,1,60
68989113@N00,8527,31,1272326143,1272327643,3,1,1500
68989113@N00,8528,28,1291324852,1291325752,2,1,900
68989113@N00,8529,29,1303609847,1303610747,1,1,900
68989113@N00,8530,20,1320998147,1320998687,1,1,540
68989113@N00,8531,25,1323772247,1323772380,2,2,133
68989113@N00,8531,28,1323772380,1323773280,1,2,900
68989113@N00,8532,28,1325627123,1325628023,2,2,900
68989113@N00,8532,25,1325630093,1325630933,2,2,840
68989113@N00,8533,28,1362468220,1362469120,2,1,900
68989113@N00,8534,29,1380159798,1380160698,1,1,900
68989113@N00,8535,28,1383255149,1383256049,1,1,900
69014672@N00,8536,30,1287640025,1287640059,2,5,34
69014672@N00,8536,29,1287640059,1287640959,2,5,900
69014672@N00,8536,1,1287642916,1287642976,2,5,60
69014672@N00,8536,17,1287643352,1287643652,2,5,300
69014672@N00,8536,28,1287646291,1287647191,1,5,900
69024677@N00,8537,13,1202096889,1202097129,5,2,240
69024677@N00,8537,26,1202104919,1202105819,1,2,900
69024677@N00,8538,29,1202185450,1202186139,4,5,689
69024677@N00,8538,28,1202186139,1202187039,2,5,900
69024677@N00,8538,1,1202203157,1202203217,2,5,60
69024677@N00,8538,19,1202204314,1202204854,3,5,540
69024677@N00,8538,28,1202210111,1202211011,3,5,900
69026149@N00,8539,30,1298094009,1298095089,1,1,1080
69026149@N00,8540,30,1298162320,1298163400,18,1,1080
69026149@N00,8541,30,1298247448,1298248528,29,1,1080
69031754@N06,8542,23,1446260686,1446261286,1,1,600
69031754@N06,8543,17,1446296863,1446297163,1,1,300
69036873@N00,8544,10,1303710360,1303710600,7,1,240
69036873@N00,8545,10,1310487214,1310487454,2,1,240
69074591@N00,8546,26,1444309584,1444310484,1,1,900
69111988@N07,8547,27,1366798299,1366799199,1,1,900
69114926@N00,8548,3,1321563354,1321563444,29,10,90
69114926@N00,8548,16,1321574308,1321574578,9,10,270
69114926@N00,8548,20,1321581360,1321581900,2,10,540
69114926@N00,8548,7,1321585660,1321585840,11,10,180
69114926@N00,8548,21,1321588516,1321589086,5,10,570
69114926@N00,8548,25,1321590100,1321590193,3,10,93
69114926@N00,8548,21,1321590193,1321590763,2,10,570
69114926@N00,8548,5,1321592110,1321592230,13,10,120
69114926@N00,8548,3,1321595952,1321596042,2,10,90
69114926@N00,8548,16,1321597601,1321597871,4,10,270
69114926@N00,8549,16,1321656182,1321656452,2,10,270
69114926@N00,8549,8,1321657734,1321657914,8,10,180
69114926@N00,8549,5,1321657978,1321658098,5,10,120
69114926@N00,8549,3,1321658320,1321658410,2,10,90
69114926@N00,8549,21,1321658525,1321659015,2,10,490
69114926@N00,8549,3,1321659015,1321659105,6,10,90
69114926@N00,8549,23,1321661587,1321662187,3,10,600
69114926@N00,8549,1,1321678930,1321678990,2,10,60
69114926@N00,8549,3,1321682668,1321682758,4,10,90
69114926@N00,8549,28,1321695312,1321696212,1,10,900
69138343@N00,8550,26,1329118823,1329119723,1,1,900
69181973@N05,8551,1,1397027490,1397027550,13,1,60
69271250@N00,8552,17,1333102835,1333103135,1,1,300
69271250@N00,8553,1,1364603400,1364603460,2,2,60
69271250@N00,8553,25,1364608328,1364609168,1,2,840
69271250@N00,8554,26,1364965139,1364966039,1,1,900
69271250@N00,8555,28,1395885255,1395886155,2,4,900
69271250@N00,8555,20,1395892051,1395892591,2,4,540
69271250@N00,8555,28,1395902284,1395903184,2,4,900
69271250@N00,8555,15,1395906549,1395906819,3,4,270
69271250@N00,8556,17,1396355722,1396356022,1,1,300
69271250@N00,8557,30,1396513550,1396514630,2,3,1080
69271250@N00,8557,14,1396521669,1396521909,2,3,240
69271250@N00,8557,28,1396530098,1396530998,2,3,900
69272110@N05,8558,19,1402790730,1402791270,1,1,540
69301930@N03,8559,16,1381961564,1381961834,2,5,270
69301930@N03,8559,13,1381969697,1381969937,2,5,240
69301930@N03,8559,30,1381982837,1381983917,2,5,1080
69301930@N03,8559,31,1381983987,1381985487,2,5,1500
69301930@N03,8559,29,1381985526,1381986426,1,5,900
69302803@N06,8560,16,1361524938,1361525208,1,1,270
69487366@N02,8561,18,1425333060,1425333510,1,1,450
69487366@N02,8562,18,1425365506,1425365956,1,1,450
69487366@N02,8563,18,1425539950,1425540400,1,1,450
69574134@N00,8564,12,1270015894,1270015978,3,6,84
69574134@N00,8564,4,1270015978,1270015984,2,6,6
69574134@N00,8564,16,1270015984,1270016254,5,6,270
69574134@N00,8564,17,1270016498,1270016798,3,6,300
69574134@N00,8564,27,1270017692,1270018592,6,6,900
69574134@N00,8564,28,1270019306,1270020206,3,6,900
69574134@N00,8565,27,1270199058,1270199958,2,14,900
69574134@N00,8565,26,1270201629,1270201884,3,14,255
69574134@N00,8565,4,1270201884,1270201985,3,14,101
69574134@N00,8565,22,1270203239,1270203839,5,14,600
69574134@N00,8565,30,1270210535,1270211615,2,14,1080
69574134@N00,8565,29,1270214126,1270214431,5,14,305
69574134@N00,8565,30,1270214431,1270214643,2,14,212
69574134@N00,8565,29,1270214643,1270215543,2,14,900
69574134@N00,8565,23,1270219548,1270220148,2,14,600
69574134@N00,8565,10,1270220206,1270220446,3,14,240
69574134@N00,8565,20,1270222266,1270222806,5,14,540
69574134@N00,8565,22,1270225023,1270225623,4,14,600
69574134@N00,8565,29,1270227739,1270228639,2,14,900
69574134@N00,8565,24,1270234524,1270235304,10,14,780
69739859@N06,8566,26,1350534274,1350535174,1,1,900
69872582@N00,8567,14,1338678777,1338679017,2,2,240
69872582@N00,8567,31,1338680230,1338681730,2,2,1500
69872582@N00,8568,6,1338714027,1338714147,1,1,120
69872582@N00,8569,14,1338770309,1338770549,2,9,240
69872582@N00,8569,22,1338773834,1338774434,2,9,600
69872582@N00,8569,20,1338782407,1338782947,2,9,540
69872582@N00,8569,30,1338784292,1338784544,3,9,252
69872582@N00,8569,31,1338784544,1338786044,3,9,1500
69872582@N00,8569,26,1338787817,1338788177,2,9,360
69872582@N00,8569,23,1338788177,1338788777,2,9,600
69872582@N00,8569,22,1338789346,1338789885,2,9,539
69872582@N00,8569,14,1338789885,1338790125,1,9,240
69883003@N00,8570,10,1300423341,1300423581,1,1,240
69883003@N00,8571,26,1301657475,1301658375,3,1,900
69883003@N00,8572,23,1304154283,1304154883,2,2,600
69883003@N00,8572,30,1304167885,1304168965,1,2,1080
69883003@N00,8573,17,1316839813,1316840113,2,3,300
69883003@N00,8573,18,1316846670,1316847067,2,3,397
69883003@N00,8573,23,1316847067,1316847667,1,3,600
69883003@N00,8574,27,1318415730,1318416630,2,3,900
69883003@N00,8574,4,1318421917,1318422018,2,3,101
69883003@N00,8574,27,1318423226,1318424126,1,3,900
69883003@N00,8575,25,1323688203,1323689043,1,1,840
69883003@N00,8576,28,1325376231,1325377131,1,1,900
69883003@N00,8577,28,1325410677,1325411577,2,1,900
69883003@N00,8578,12,1326005738,1326005978,1,1,240
69883003@N00,8579,18,1354426701,1354427151,2,2,450
69883003@N00,8579,26,1354438153,1354439053,2,2,900
69883003@N00,8580,28,1357438257,1357439157,2,3,900
69883003@N00,8580,18,1357444648,1357444838,2,3,190
69883003@N00,8580,29,1357444838,1357445738,1,3,900
69899432@N00,8581,22,1219631499,1219632099,9,1,600
69962528@N08,8582,28,1359590874,1359591092,3,3,218
69962528@N08,8582,18,1359591092,1359591274,2,3,182
69962528@N08,8582,30,1359591274,1359592354,1,3,1080
70025073@N00,8583,28,1242427401,1242428301,1,1,900
70059755@N00,8584,24,1224192391,1224193171,3,3,780
70059755@N00,8584,7,1224196376,1224196556,2,3,180
70059755@N00,8584,4,1224199841,1224199942,1,3,101
70059755@N00,8585,1,1224243732,1224243792,2,18,60
70059755@N00,8585,28,1224243862,1224244126,2,18,264
70059755@N00,8585,26,1224244126,1224244153,2,18,27
70059755@N00,8585,28,1224244153,1224244304,2,18,151
70059755@N00,8585,6,1224244304,1224244424,2,18,120
70059755@N00,8585,26,1224244578,1224245005,4,18,427
70059755@N00,8585,16,1224245005,1224245078,3,18,73
70059755@N00,8585,27,1224245078,1224245459,2,18,381
70059755@N00,8585,17,1224245459,1224245759,3,18,300
70059755@N00,8585,12,1224245831,1224246071,4,18,240
70059755@N00,8585,3,1224246422,1224246512,2,18,90
70059755@N00,8585,4,1224246620,1224246721,2,18,101
70059755@N00,8585,10,1224246954,1224247136,2,18,182
70059755@N00,8585,30,1224247136,1224247317,2,18,181
70059755@N00,8585,20,1224247317,1224247600,4,18,283
70059755@N00,8585,29,1224247600,1224248040,3,18,440
70059755@N00,8585,28,1224248040,1224248569,6,18,529
70059755@N00,8585,1,1224248569,1224248629,2,18,60
70059755@N00,8586,8,1224279186,1224279366,1,1,180
70059755@N00,8587,20,1224320974,1224321514,1,1,540
70059755@N00,8588,24,1380514931,1380514949,2,3,18
70059755@N00,8588,12,1380514949,1380515189,2,3,240
70059755@N00,8588,27,1380515615,1380516515,1,3,900
70059755@N00,8589,1,1413001319,1413001379,1,1,60
70084804@N00,8590,1,1393423724,1393423784,1,1,60
70084804@N00,8591,26,1465775756,1465776656,2,1,900
70126701@N06,8592,1,1322994829,1322994889,1,1,60
70142236@N04,8593,23,1321848661,1321849261,1,1,600
70142236@N04,8594,28,1339863195,1339864095,2,1,900
70154861@N00,8595,26,1257219832,1257220732,1,1,900
70229871@N06,8596,18,1431844020,1431844470,1,1,450
70229871@N06,8597,18,1433653186,1433653636,1,1,450
70314287@N07,8598,30,1288689249,1288690329,1,1,1080
70319699@N05,8599,29,1328413779,1328414679,2,6,900
70319699@N05,8599,19,1328416107,1328416204,2,6,97
70319699@N05,8599,23,1328416204,1328416804,2,6,600
70319699@N05,8599,26,1328418214,1328419114,6,6,900
70319699@N05,8599,23,1328425133,1328425733,3,6,600
70319699@N05,8599,29,1328429764,1328430664,1,6,900
70319699@N05,8600,29,1328794852,1328794868,2,2,16
70319699@N05,8600,26,1328794868,1328795768,1,2,900
70319699@N05,8601,31,1328937873,1328939373,2,4,1500
70319699@N05,8601,6,1328940064,1328940172,4,4,108
70319699@N05,8601,26,1328940172,1328940959,2,4,787
70319699@N05,8601,28,1328940959,1328941859,1,4,900
70319699@N05,8602,29,1329629494,1329629789,2,2,295
70319699@N05,8602,31,1329629789,1329631289,1,2,1500
70319699@N05,8603,1,1330695082,1330695142,1,1,60
70319699@N05,8604,22,1334041341,1334041941,2,1,600
70319699@N05,8605,28,1334294621,1334295448,2,5,827
70319699@N05,8605,26,1334295448,1334296348,4,5,900
70319699@N05,8605,6,1334296471,1334296591,3,5,120
70319699@N05,8605,21,1334296874,1334297444,2,5,570
70319699@N05,8605,26,1334298979,1334299879,1,5,900
70319699@N05,8606,29,1335012131,1335013031,2,1,900
70319699@N05,8607,19,1337413269,1337413809,1,1,540
70319699@N05,8608,11,1337928243,1337928483,1,1,240
70319699@N05,8609,29,1341059972,1341060872,3,1,900
70341093@N00,8610,17,1292057637,1292057937,1,1,300
70382627@N00,8611,28,1243648979,1243649879,32,1,900
70382627@N00,8612,28,1243731210,1243732110,19,1,900
70382627@N00,8613,28,1244008626,1244009526,10,1,900
70382627@N00,8614,1,1357166674,1357166734,2,8,60
70382627@N00,8614,26,1357167994,1357168894,2,8,900
70382627@N00,8614,8,1357172427,1357172434,2,8,7
70382627@N00,8614,26,1357172434,1357173334,2,8,900
70382627@N00,8614,15,1357177272,1357177542,2,8,270
70382627@N00,8614,20,1357196546,1357197086,3,8,540
70382627@N00,8614,25,1357197951,1357198791,8,8,840
70382627@N00,8614,28,1357212636,1357213536,2,8,900
70584662@N00,8615,21,1379991868,1379992438,2,2,570
70584662@N00,8615,29,1379998118,1379999018,1,2,900
70584662@N00,8616,5,1380157225,1380157345,1,1,120
70618035@N00,8617,18,1440320480,1440320930,2,1,450
70698203@N00,8618,12,1447715592,1447715832,2,14,240
70698203@N00,8618,16,1447717822,1447718092,2,14,270
70698203@N00,8618,26,1447718988,1447719228,2,14,240
70698203@N00,8618,6,1447719228,1447719300,2,14,72
70698203@N00,8618,9,1447719300,1447719480,2,14,180
70698203@N00,8618,4,1447721538,1447721639,2,14,101
70698203@N00,8618,28,1447722464,1447723364,2,14,900
70698203@N00,8618,14,1447723794,1447724034,2,14,240
70698203@N00,8618,30,1447729866,1447730203,2,14,337
70698203@N00,8618,28,1447730203,1447731103,2,14,900
70698203@N00,8618,17,1447733315,1447733615,2,14,300
70698203@N00,8618,4,1447733999,1447734100,2,14,101
70698203@N00,8618,28,1447740411,1447741311,7,14,900
70698203@N00,8618,26,1447745210,1447746110,1,14,900
70698203@N00,8619,26,1447808016,1447808916,3,2,900
70698203@N00,8619,16,1447832401,1447832671,1,2,270
70698203@N00,8620,20,1447896789,1447897329,2,7,540
70698203@N00,8620,1,1447910967,1447911027,2,7,60
70698203@N00,8620,31,1447912672,1447913234,2,7,562
70698203@N00,8620,30,1447913234,1447913307,2,7,73
70698203@N00,8620,26,1447913307,1447914207,2,7,900
70698203@N00,8620,14,1447917654,1447917894,4,7,240
70698203@N00,8620,27,1447922037,1447922937,1,7,900
70731501@N00,8621,24,1340874388,1340875168,2,1,780
70731501@N00,8622,24,1351140309,1351141089,4,1,780
70767289@N00,8623,26,1470563073,1470563973,1,1,900
70779799@N00,8624,22,1385864240,1385864840,2,3,600
70779799@N00,8624,31,1385880017,1385880044,2,3,27
70779799@N00,8624,22,1385880044,1385880644,1,3,600
70786875@N00,8625,26,1335498733,1335499633,1,1,900
70827934@N08,8626,14,1306666817,1306667057,1,1,240
70862502@N00,8627,20,1322152367,1322152907,1,1,540
70862502@N00,8628,28,1322199540,1322200440,2,2,900
70862502@N00,8628,18,1322219012,1322219462,1,2,450
70862502@N00,8629,26,1322255226,1322256126,1,1,900
70862502@N00,8630,15,1322286765,1322287035,1,1,270
70862502@N00,8631,28,1327680064,1327680451,2,2,387
70862502@N00,8631,20,1327680451,1327680991,1,2,540
70862502@N00,8632,28,1351951805,1351952705,2,1,900
70862502@N00,8633,16,1352055324,1352055594,1,1,270
70862502@N00,8634,14,1352104819,1352105059,1,1,240
70862502@N00,8635,20,1353099289,1353099829,2,2,540
70862502@N00,8635,26,1353100295,1353101195,1,2,900
70862502@N00,8636,27,1353137810,1353138710,2,2,900
70862502@N00,8636,26,1353152140,1353153040,1,2,900
70862502@N00,8637,28,1358527344,1358528172,2,3,828
70862502@N00,8637,20,1358528172,1358528712,2,3,540
70862502@N00,8637,28,1358530350,1358531250,1,3,900
70862502@N00,8638,27,1358693898,1358694798,1,1,900
70862502@N00,8639,20,1367585052,1367585592,1,1,540
70862502@N00,8640,27,1367632654,1367633554,4,1,900
70862502@N00,8641,1,1367731589,1367731649,1,1,60
70862502@N00,8642,15,1367812876,1367813146,1,1,270
70862502@N00,8643,19,1415932590,1415933130,1,1,540
70862502@N00,8644,27,1416004126,1416005026,1,1,900
70862502@N00,8645,14,1416076034,1416076274,2,1,240
70862502@N00,8646,23,1416194636,1416195236,1,1,600
70862502@N00,8647,21,1421441005,1421441575,2,2,570
70862502@N00,8647,27,1421443632,1421444532,1,2,900
70862502@N00,8648,14,1431218427,1431218667,1,1,240
70862502@N00,8649,18,1446856351,1446856801,1,1,450
70862502@N00,8650,27,1446930288,1446931188,1,1,900
70862502@N00,8651,20,1462527693,1462528233,1,1,540
70891215@N05,8652,26,1238495455,1238496355,1,1,900
70891215@N05,8653,26,1238531422,1238532322,1,1,900
70891215@N05,8654,26,1238613450,1238614350,1,1,900
70966699@N02,8655,26,1322441273,1322442173,72,1,900
70969739@N00,8656,26,1309220727,1309221627,1,1,900
70969739@N00,8657,1,1309326761,1309326821,2,2,60
70969739@N00,8657,25,1309333479,1309334319,1,2,840
71048666@N00,8658,1,1220478093,1220478153,1,1,60
71048666@N00,8659,8,1227125192,1227125372,1,1,180
71048666@N00,8660,28,1253846438,1253846861,2,2,423
71048666@N00,8660,26,1253846861,1253847761,1,2,900
71048666@N00,8661,30,1255993307,1255994387,1,1,1080
71048666@N00,8662,20,1265024256,1265024796,2,2,540
71048666@N00,8662,1,1265031105,1265031165,2,2,60
71079304@N04,8663,10,1262149363,1262149603,2,5,240
71079304@N04,8663,16,1262152702,1262152832,2,5,130
71079304@N04,8663,26,1262152832,1262153024,3,5,192
71079304@N04,8663,18,1262153024,1262153474,2,5,450
71079304@N04,8663,1,1262154596,1262154656,1,5,60
71079304@N04,8664,24,1373897693,1373897869,2,13,176
71079304@N04,8664,16,1373897869,1373898139,2,13,270
71079304@N04,8664,15,1373898591,1373898861,2,13,270
71079304@N04,8664,12,1373911120,1373911360,2,13,240
71079304@N04,8664,16,1373914084,1373914190,2,13,106
71079304@N04,8664,12,1373914190,1373914415,2,13,225
71079304@N04,8664,24,1373914415,1373914540,2,13,125
71079304@N04,8664,12,1373914540,1373914596,2,13,56
71079304@N04,8664,16,1373914596,1373914866,2,13,270
71079304@N04,8664,6,1373917348,1373917468,2,13,120
71079304@N04,8664,9,1373917572,1373917752,2,13,180
71079304@N04,8664,23,1373918071,1373918671,4,13,600
71079304@N04,8664,29,1373919881,1373920781,1,13,900
71103764@N00,8665,16,1394316042,1394316312,1,1,270
71103764@N00,8666,16,1394490619,1394490889,2,2,270
71103764@N00,8666,14,1394492266,1394492506,2,2,240
71103764@N00,8667,15,1394604620,1394604660,2,2,40
71103764@N00,8667,24,1394604660,1394605440,1,2,780
71103764@N00,8668,28,1394661072,1394661972,2,6,900
71103764@N00,8668,14,1394666403,1394666643,2,6,240
71103764@N00,8668,28,1394669452,1394670352,2,6,900
71103764@N00,8668,26,1394688129,1394689029,2,6,900
71103764@N00,8668,4,1394692373,1394692474,2,6,101
71103764@N00,8668,7,1394695401,1394695581,1,6,180
71121295@N00,8669,17,1205007692,1205007992,1,1,300
71121295@N00,8670,4,1233355550,1233355651,2,4,101
71121295@N00,8670,6,1233356417,1233356537,2,4,120
71121295@N00,8670,24,1233364228,1233365008,2,4,780
71121295@N00,8670,12,1233386310,1233386550,1,4,240
71121295@N00,8671,10,1259991725,1259991965,2,1,240
71121295@N00,8672,10,1260051542,1260051782,1,1,240
71121295@N00,8673,3,1272749280,1272749370,2,4,90
71121295@N00,8673,26,1272749720,1272750620,4,4,900
71121295@N00,8673,18,1272759673,1272760123,2,4,450
71121295@N00,8673,26,1272760463,1272761363,4,4,900
71121295@N00,8674,1,1339276056,1339276116,4,6,60
71121295@N00,8674,28,1339276164,1339277064,3,6,900
71121295@N00,8674,1,1339277499,1339277559,2,6,60
71121295@N00,8674,28,1339277564,1339277621,3,6,57
71121295@N00,8674,1,1339277621,1339277681,2,6,60
71121295@N00,8674,28,1339278137,1339279037,2,6,900
71185155@N02,8675,17,1332458263,1332458563,2,2,300
71185155@N02,8675,28,1332486981,1332487881,1,2,900
71214537@N00,8676,6,1441924884,1441925004,3,5,120
71214537@N00,8676,4,1441926657,1441926758,3,5,101
71214537@N00,8676,26,1441935983,1441936093,2,5,110
71214537@N00,8676,23,1441936093,1441936693,2,5,600
71214537@N00,8676,22,1441944276,1441944876,2,5,600
71300344@N04,8677,29,1349769060,1349769960,1,1,900
71300344@N04,8678,29,1350021536,1350022436,1,1,900
71344135@N00,8679,16,1260611969,1260612239,3,2,270
71344135@N00,8679,21,1260616345,1260616915,1,2,570
71356371@N00,8680,27,1315128261,1315129161,1,1,900
71356371@N00,8681,8,1337563696,1337563876,2,2,180
71356371@N00,8681,23,1337577340,1337577940,3,2,600
71356371@N00,8682,13,1363749804,1363750044,1,1,240
71416221@N02,8683,12,1435192001,1435192241,1,1,240
71455873@N00,8684,1,1382132581,1382132641,3,8,60
71455873@N00,8684,29,1382135714,1382136614,2,8,900
71455873@N00,8684,14,1382139585,1382139825,2,8,240
71455873@N00,8684,13,1382147526,1382147766,8,8,240
71455873@N00,8684,25,1382148071,1382148911,4,8,840
71455873@N00,8684,26,1382152787,1382153687,2,8,900
71455873@N00,8684,17,1382162433,1382162733,2,8,300
71455873@N00,8684,24,1382163288,1382164068,2,8,780
71486434@N00,8685,1,1215568708,1215568768,2,12,60
71486434@N00,8685,28,1215568878,1215568908,2,12,30
71486434@N00,8685,1,1215568908,1215568968,2,12,60
71486434@N00,8685,28,1215568969,1215569171,4,12,202
71486434@N00,8685,26,1215569171,1215569539,5,12,368
71486434@N00,8685,29,1215569539,1215569740,2,12,201
71486434@N00,8685,20,1215569740,1215570280,3,12,540
71486434@N00,8685,28,1215577831,1215578183,2,12,352
71486434@N00,8685,10,1215578183,1215578423,7,12,240
71486434@N00,8685,30,1215579088,1215579613,3,12,525
71486434@N00,8685,1,1215579613,1215579673,7,12,60
71486434@N00,8685,28,1215586337,1215587237,1,12,900
71486434@N00,8686,1,1215670555,1215670615,6,12,60
71486434@N00,8686,26,1215670674,1215671574,3,12,900
71486434@N00,8686,24,1215673033,1215673813,15,12,780
71486434@N00,8686,27,1215682259,1215683159,2,12,900
71486434@N00,8686,3,1215684909,1215684999,12,12,90
71486434@N00,8686,13,1215688929,1215689169,2,12,240
71486434@N00,8686,17,1215689452,1215689752,8,12,300
71486434@N00,8686,31,1215693602,1215695003,14,12,1401
71486434@N00,8686,29,1215695003,1215695903,4,12,900
71486434@N00,8686,19,1215696160,1215696700,5,12,540
71486434@N00,8686,26,1215697652,1215698552,3,12,900
71486434@N00,8686,28,1215698558,1215699458,2,12,900
71486434@N00,8687,29,1223015445,1223016345,2,3,900
71486434@N00,8687,28,1223018717,1223019617,4,3,900
71486434@N00,8687,20,1223019644,1223020184,8,3,540
71486434@N00,8688,28,1223086418,1223086735,3,6,317
71486434@N00,8688,26,1223086735,1223087635,5,6,900
71486434@N00,8688,24,1223088575,1223089355,8,6,780
71486434@N00,8688,22,1223091620,1223092220,3,6,600
71486434@N00,8688,23,1223096733,1223097333,7,6,600
71486434@N00,8688,28,1223107459,1223108359,2,6,900
71486434@N00,8689,22,1223173334,1223173934,1,1,600
71486434@N00,8690,1,1236736741,1236736766,2,25,25
71486434@N00,8690,28,1236736766,1236737666,8,25,900
71486434@N00,8690,16,1236737881,1236738151,2,25,270
71486434@N00,8690,15,1236739989,1236740259,2,25,270
71486434@N00,8690,29,1236741320,1236742220,6,25,900
71486434@N00,8690,26,1236743653,1236744242,2,25,589
71486434@N00,8690,17,1236744242,1236744542,5,25,300
71486434@N00,8690,26,1236747292,1236747332,5,25,40
71486434@N00,8690,28,1236747332,1236748026,13,25,694
71486434@N00,8690,23,1236748026,1236748218,4,25,192
71486434@N00,8690,19,1236748218,1236748281,2,25,63
71486434@N00,8690,29,1236748281,1236748393,2,25,112
71486434@N00,8690,20,1236748393,1236748933,9,25,540
71486434@N00,8690,31,1236749756,1236751138,23,25,1382
71486434@N00,8690,22,1236751138,1236751257,2,25,119
71486434@N00,8690,31,1236751257,1236751459,2,25,202
71486434@N00,8690,22,1236751459,1236751720,4,25,261
71486434@N00,8690,31,1236751720,1236753220,8,25,1500
71486434@N00,8690,28,1236753667,1236753823,2,25,156
71486434@N00,8690,3,1236753823,1236753913,4,25,90
71486434@N00,8690,25,1236754579,1236755419,13,25,840
71486434@N00,8690,16,1236755852,1236756122,2,25,270
71486434@N00,8690,10,1236757227,1236757467,3,25,240
71486434@N00,8690,29,1236763427,1236764327,3,25,900
71486434@N00,8690,26,1236764785,1236765685,4,25,900
71486434@N00,8691,24,1236814611,1236815391,12,5,780
71486434@N00,8691,23,1236816762,1236817362,2,5,600
71486434@N00,8691,22,1236819154,1236819754,12,5,600
71486434@N00,8691,29,1236819984,1236820884,5,5,900
71486434@N00,8691,1,1236823487,1236823547,8,5,60
71486434@N00,8692,17,1237194780,1237195034,2,2,254
71486434@N00,8692,22,1237195034,1237195634,2,2,600
71486434@N00,8693,1,1254455454,1254455514,2,14,60
71486434@N00,8693,28,1254455630,1254456530,3,14,900
71486434@N00,8693,17,1254458290,1254458590,2,14,300
71486434@N00,8693,24,1254459794,1254460574,2,14,780
71486434@N00,8693,28,1254460685,1254461207,2,14,522
71486434@N00,8693,1,1254461207,1254461267,12,14,60
71486434@N00,8693,14,1254463000,1254463240,2,14,240
71486434@N00,8693,28,1254464428,1254465134,3,14,706
71486434@N00,8693,29,1254465134,1254465900,2,14,766
71486434@N00,8693,19,1254465900,1254466440,8,14,540
71486434@N00,8693,18,1254466872,1254467322,8,14,450
71486434@N00,8693,23,1254467708,1254468308,6,14,600
71486434@N00,8693,16,1254471728,1254471998,2,14,270
71486434@N00,8693,22,1254472755,1254473355,1,14,600
71486434@N00,8694,26,1254551525,1254552425,6,5,900
71486434@N00,8694,3,1254552562,1254552652,5,5,90
71486434@N00,8694,25,1254553241,1254554081,6,5,840
71486434@N00,8694,4,1254556165,1254556266,10,5,101
71486434@N00,8694,20,1254558992,1254559532,4,5,540
71486434@N00,8695,1,1254622169,1254622229,3,11,60
71486434@N00,8695,28,1254622393,1254622814,2,11,421
71486434@N00,8695,1,1254622814,1254622874,6,11,60
71486434@N00,8695,30,1254623534,1254624614,2,11,1080
71486434@N00,8695,24,1254625495,1254626275,3,11,780
71486434@N00,8695,29,1254633950,1254634850,3,11,900
71486434@N00,8695,30,1254636161,1254637241,26,11,1080
71486434@N00,8695,27,1254644544,1254644716,2,11,172
71486434@N00,8695,28,1254644716,1254645616,7,11,900
71486434@N00,8695,29,1254650352,1254651252,2,11,900
71486434@N00,8695,28,1254651618,1254652518,1,11,900
71486434@N00,8696,22,1255762179,1255762564,3,2,385
71486434@N00,8696,17,1255762564,1255762864,1,2,300
71486434@N00,8697,11,1286093201,1286093441,6,1,240
71502979@N00,8698,17,1231347085,1231347385,1,1,300
71502979@N00,8699,17,1232037228,1232037528,11,1,300
71502979@N00,8700,18,1247027191,1247027641,2,1,450
71502979@N00,8701,16,1264134146,1264134308,2,2,162
71502979@N00,8701,27,1264134308,1264135208,2,2,900
71502979@N00,8702,17,1264404306,1264404606,2,1,300
71502979@N00,8703,31,1266817683,1266818355,3,2,672
71502979@N00,8703,13,1266818355,1266818595,2,2,240
71502979@N00,8704,16,1268025999,1268026269,4,4,270
71502979@N00,8704,6,1268029496,1268029616,4,4,120
71502979@N00,8704,11,1268031385,1268031625,6,4,240
71502979@N00,8704,3,1268033347,1268033437,1,4,90
71502979@N00,8705,12,1274344041,1274344281,2,1,240
71502979@N00,8706,9,1292317786,1292317966,1,1,180
71502979@N00,8707,20,1299898121,1299898661,3,2,540
71502979@N00,8707,30,1299911836,1299912916,4,2,1080
71502979@N00,8708,29,1300147125,1300148025,2,2,900
71502979@N00,8708,17,1300167955,1300168255,7,2,300
7154330@N03,8709,26,1255309327,1255310227,1,1,900
71574801@N00,8710,24,1296955610,1296956390,4,1,780
71597211@N00,8711,26,1200681342,1200682242,1,1,900
71597211@N00,8712,31,1239750180,1239750719,2,4,539
71597211@N00,8712,22,1239750719,1239751319,2,4,600
71597211@N00,8712,11,1239760225,1239760465,2,4,240
71597211@N00,8712,25,1239768781,1239769621,1,4,840
71597211@N00,8713,1,1287359783,1287359843,2,4,60
71597211@N00,8713,13,1287366720,1287366960,2,4,240
71597211@N00,8713,27,1287370628,1287371528,2,4,900
71597211@N00,8713,28,1287390734,1287391634,1,4,900
71597211@N00,8714,27,1377405394,1377406294,2,2,900
71597211@N00,8714,31,1377418559,1377420059,1,2,1500
71769353@N00,8715,8,1194564535,1194564715,3,1,180
71781509@N00,8716,15,1418593318,1418593588,3,7,270
71781509@N00,8716,3,1418595492,1418595545,2,7,53
71781509@N00,8716,21,1418595545,1418596115,3,7,570
71781509@N00,8716,25,1418596925,1418597612,3,7,687
71781509@N00,8716,12,1418597612,1418597852,2,7,240
71781509@N00,8716,4,1418600531,1418600534,2,7,3
71781509@N00,8716,16,1418600534,1418600804,1,7,270
71781509@N00,8717,26,1418643185,1418644085,1,1,900
71781509@N00,8718,26,1418702009,1418702909,2,5,900
71781509@N00,8718,7,1418703304,1418703311,2,5,7
71781509@N00,8718,6,1418703311,1418703431,2,5,120
71781509@N00,8718,13,1418704301,1418704541,4,5,240
71781509@N00,8718,4,1418708054,1418708155,3,5,101
71821256@N00,8719,7,1192510186,1192510366,7,4,180
71821256@N00,8719,5,1192511208,1192511328,3,4,120
71821256@N00,8719,17,1192512014,1192512314,2,4,300
71821256@N00,8719,26,1192523785,1192524685,1,4,900
71821256@N00,8720,26,1198491303,1198492203,1,1,900
71821256@N00,8721,7,1198538200,1198538380,6,3,180
71821256@N00,8721,3,1198552630,1198552720,2,3,90
71821256@N00,8721,8,1198562091,1198562271,2,3,180
71821256@N00,8722,24,1204858364,1204859144,4,3,780
71821256@N00,8722,13,1204864552,1204864792,7,3,240
71821256@N00,8722,3,1204875533,1204875623,1,3,90
71821256@N00,8723,13,1210483090,1210483330,13,2,240
71821256@N00,8723,7,1210485777,1210485957,7,2,180
71875258@N00,8724,4,1369273797,1369273898,1,1,101
71915105@N07,8725,26,1383370945,1383371845,1,1,900
71957979@N00,8726,31,1277790546,1277792046,2,1,1500
71957979@N00,8727,24,1300600997,1300601777,1,1,780
71969256@N00,8728,26,1351911061,1351911427,2,12,366
71969256@N00,8728,30,1351911427,1351911558,6,12,131
71969256@N00,8728,26,1351911558,1351911569,2,12,11
71969256@N00,8728,18,1351911569,1351911615,4,12,46
71969256@N00,8728,26,1351911615,1351911637,2,12,22
71969256@N00,8728,18,1351911637,1351912087,4,12,450
71969256@N00,8728,23,1351917316,1351917365,3,12,49
71969256@N00,8728,18,1351917365,1351917384,2,12,19
71969256@N00,8728,23,1351917384,1351917442,3,12,58
71969256@N00,8728,26,1351917442,1351917472,2,12,30
71969256@N00,8728,18,1351917472,1351917508,2,12,36
71969256@N00,8728,26,1351917508,1351918408,1,12,900
71982069@N07,8729,28,1341881479,1341882379,3,1,900
71988189@N00,8730,28,1439247868,1439248768,1,1,900
7202153@N03,8731,13,1281073244,1281073484,2,2,240
7202153@N03,8731,12,1281074787,1281075027,3,2,240
72043907@N00,8732,15,1373943606,1373943876,2,4,270
72043907@N00,8732,29,1373954568,1373955468,2,4,900
72043907@N00,8732,28,1373966641,1373967541,2,4,900
72043907@N00,8732,24,1373970301,1373971081,1,4,780
72171460@N00,8733,28,1386204167,1386205067,2,5,900
72171460@N00,8733,7,1386207928,1386208108,2,5,180
72171460@N00,8733,13,1386211044,1386211284,2,5,240
72171460@N00,8733,31,1386215476,1386215482,2,5,6
72171460@N00,8733,22,1386215482,1386216082,1,5,600
72171460@N00,8734,14,1392957803,1392958043,1,1,240
72171460@N00,8735,14,1393376909,1393377149,1,1,240
72171460@N00,8736,16,1412322467,1412322737,1,1,270
72204768@N08,8737,3,1325524647,1325524737,1,1,90
72269863@N00,8738,17,1460868430,1460868730,2,3,300
72269863@N00,8738,29,1460879107,1460880007,2,3,900
72269863@N00,8738,27,1460885166,1460886066,1,3,900
7231700@N07,8739,7,1295259593,1295259773,3,2,180
7231700@N07,8739,16,1295275627,1295275897,1,2,270
72333664@N00,8740,10,1188373121,1188373126,2,2,5
72333664@N00,8740,24,1188373126,1188373906,1,2,780
7235065@N08,8741,1,1369962016,1369962076,4,1,60
7235065@N08,8742,1,1370164322,1370164382,1,1,60
72381155@N00,8743,26,1195205939,1195206839,14,1,900
72409673@N00,8744,28,1294956156,1294957056,1,1,900
72409673@N00,8745,27,1304076955,1304077855,1,1,900
72409673@N00,8746,29,1310987746,1310988646,2,1,900
72409673@N00,8747,28,1319073546,1319074446,2,1,900
72409673@N00,8748,28,1330517254,1330518154,1,1,900
72409673@N00,8749,26,1355740693,1355741593,1,1,900
72432542@N00,8750,22,1276022671,1276023271,1,1,600
72439928@N00,8751,26,1259490283,1259491183,1,1,900
7246234@N07,8752,16,1280919057,1280919327,1,1,270
72507824@N00,8753,12,1217089204,1217089444,1,1,240
72547598@N00,8754,29,1385516838,1385517738,2,21,900
72547598@N00,8754,20,1385518099,1385518639,2,21,540
72547598@N00,8754,26,1385522283,1385522611,2,21,328
72547598@N00,8754,3,1385522611,1385522701,3,21,90
72547598@N00,8754,21,1385523504,1385524074,2,21,570
72547598@N00,8754,12,1385528485,1385528725,2,21,240
72547598@N00,8754,26,1385529038,1385529352,2,21,314
72547598@N00,8754,12,1385529352,1385529451,2,21,99
72547598@N00,8754,26,1385529451,1385530351,2,21,900
72547598@N00,8754,30,1385531764,1385531922,2,21,158
72547598@N00,8754,31,1385531922,1385532453,2,21,531
72547598@N00,8754,30,1385532453,1385533533,2,21,1080
72547598@N00,8754,18,1385536111,1385536561,2,21,450
72547598@N00,8754,23,1385536801,1385537292,3,21,491
72547598@N00,8754,18,1385537292,1385537742,3,21,450
72547598@N00,8754,14,1385539524,1385539764,2,21,240
72547598@N00,8754,26,1385542678,1385542831,4,21,153
72547598@N00,8754,16,1385542831,1385543101,2,21,270
72547598@N00,8754,27,1385543537,1385544437,2,21,900
72547598@N00,8754,17,1385547451,1385547751,2,21,300
72547598@N00,8754,28,1385548746,1385549646,2,21,900
7256454@N05,8755,21,1263368202,1263368772,20,3,570
7256454@N05,8755,25,1263369247,1263370067,12,3,820
7256454@N05,8755,3,1263370067,1263370157,1,3,90
7256454@N05,8756,25,1263464462,1263465302,45,2,840
7256454@N05,8756,26,1263466273,1263467173,1,2,900
7256454@N05,8757,26,1263600756,1263601656,2,2,900
7256454@N05,8757,21,1263603036,1263603606,10,2,570
7256454@N05,8758,26,1303255708,1303256608,10,4,900
7256454@N05,8758,29,1303257546,1303258446,32,4,900
7256454@N05,8758,1,1303280051,1303280111,6,4,60
7256454@N05,8758,29,1303283080,1303283980,28,4,900
7256454@N05,8759,3,1303446533,1303446623,5,1,90
7256454@N05,8760,1,1303475774,1303475834,3,2,60
7256454@N05,8760,14,1303477813,1303478053,7,2,240
72589879@N00,8761,16,1320797444,1320797714,2,7,270
72589879@N00,8761,25,1320798684,1320798857,2,7,173
72589879@N00,8761,12,1320798857,1320799097,2,7,240
72589879@N00,8761,18,1320805939,1320806389,2,7,450
72589879@N00,8761,20,1320807069,1320807358,2,7,289
72589879@N00,8761,22,1320807358,1320807958,2,7,600
72589879@N00,8761,26,1320808510,1320809410,2,7,900
72589879@N00,8762,26,1444767532,1444768432,17,7,900
72589879@N00,8762,20,1444778132,1444778672,2,7,540
72589879@N00,8762,26,1444779196,1444779545,5,7,349
72589879@N00,8762,29,1444779545,1444780445,3,7,900
72589879@N00,8762,18,1444781439,1444781833,3,7,394
72589879@N00,8762,29,1444781833,1444782370,2,7,537
72589879@N00,8762,26,1444782370,1444783270,8,7,900
72658777@N07,8763,26,1357064807,1357065707,3,1,900
72658777@N07,8764,28,1364059921,1364060821,1,1,900
72720461@N02,8765,28,1316257856,1316258756,1,1,900
72755761@N00,8766,8,1333150466,1333150646,2,2,180
72755761@N00,8766,26,1333150906,1333151806,1,2,900
72774400@N00,8767,26,1352980954,1352981854,1,1,900
72774400@N00,8768,13,1353019402,1353019642,4,3,240
72774400@N00,8768,27,1353030907,1353031807,2,3,900
72774400@N00,8768,20,1353036606,1353037146,1,3,540
72792293@N00,8769,19,1189352883,1189353423,8,1,540
72792293@N00,8770,19,1203675697,1203676237,4,1,540
72792293@N00,8771,19,1204051002,1204051542,15,1,540
72792293@N00,8772,19,1204209443,1204209983,5,1,540
72792293@N00,8773,19,1210770800,1210771340,2,1,540
72792293@N00,8774,19,1211023870,1211024410,6,1,540
72792293@N00,8775,19,1219146568,1219147108,11,1,540
72792293@N00,8776,19,1220446959,1220447499,6,1,540
72792293@N00,8777,19,1221002367,1221002907,7,1,540
72792293@N00,8778,19,1221070471,1221071011,17,1,540
72792293@N00,8779,19,1222199167,1222199707,3,1,540
72792293@N00,8780,19,1225568929,1225569469,3,1,540
72792293@N00,8781,19,1225652267,1225652807,23,1,540
72792293@N00,8782,19,1227110393,1227110933,8,1,540
72792293@N00,8783,19,1228586498,1228587038,5,1,540
72792293@N00,8784,19,1229355445,1229355985,6,1,540
72792293@N00,8785,19,1229445609,1229446149,11,1,540
72792293@N00,8786,19,1230894599,1230895139,5,1,540
72792293@N00,8787,19,1234479144,1234479684,5,1,540
72792293@N00,8788,19,1235110913,1235111453,4,1,540
72792293@N00,8789,19,1237143014,1237143554,5,1,540
72792293@N00,8790,19,1238563113,1238563653,1,1,540
72792293@N00,8791,19,1238591979,1238592519,2,1,540
72792293@N00,8792,19,1240383054,1240383594,8,1,540
72792293@N00,8793,19,1240827883,1240828423,5,1,540
72792293@N00,8794,19,1241655948,1241656488,3,1,540
72792293@N00,8795,19,1244495627,1244496167,15,1,540
72792293@N00,8796,19,1245583403,1245583943,1,1,540
72792293@N00,8797,19,1249019659,1249020199,5,1,540
72792293@N00,8798,19,1250549007,1250549547,6,1,540
72792293@N00,8799,19,1253626722,1253627262,5,1,540
72792293@N00,8800,19,1255048782,1255049322,13,1,540
72792293@N00,8801,19,1257512700,1257513240,1,1,540
72792293@N00,8802,19,1257927485,1257928025,7,1,540
72792293@N00,8803,19,1261097797,1261098337,3,1,540
72792293@N00,8804,19,1261204996,1261205536,8,1,540
72792293@N00,8805,19,1261817390,1261817930,12,1,540
72792293@N00,8806,19,1262773224,1262773764,4,1,540
72792293@N00,8807,19,1262868152,1262868692,1,1,540
72792293@N00,8808,18,1265966075,1265966525,3,2,450
72792293@N00,8808,19,1265967336,1265967876,3,2,540
72792293@N00,8809,19,1271205341,1271205881,11,1,540
72792293@N00,8810,19,1272607116,1272607656,1,1,540
72792293@N00,8811,19,1272650878,1272651418,8,1,540
72792293@N00,8812,19,1281158324,1281158864,1,1,540
72792293@N00,8813,19,1283661491,1283662031,3,1,540
72792293@N00,8814,19,1296008838,1296009378,2,1,540
72792293@N00,8815,19,1304314228,1304314768,3,1,540
72792293@N00,8816,19,1314879439,1314879979,2,1,540
72792293@N00,8817,19,1317467124,1317467664,4,1,540
72792293@N00,8818,19,1317585382,1317585922,1,1,540
72792293@N00,8819,19,1318643140,1318643680,7,1,540
72792293@N00,8820,19,1318879500,1318880040,4,1,540
72792293@N00,8821,19,1319020986,1319021526,1,1,540
72792293@N00,8822,19,1319167529,1319168069,11,1,540
72792293@N00,8823,19,1319254515,1319255055,3,1,540
72792293@N00,8824,19,1319333847,1319334387,2,1,540
72792293@N00,8825,19,1319477825,1319478365,20,1,540
72792293@N00,8826,19,1320039626,1320040166,5,1,540
72792293@N00,8827,19,1320453188,1320453728,12,1,540
72792293@N00,8828,19,1320548053,1320548593,5,1,540
72792293@N00,8829,19,1321601970,1321602510,14,1,540
72792293@N00,8830,19,1328837472,1328838012,5,1,540
72792293@N00,8831,19,1337304720,1337305260,11,1,540
72792293@N00,8832,19,1339889677,1339890217,12,1,540
72792293@N00,8833,19,1345792343,1345792883,8,1,540
72792293@N00,8834,19,1346219661,1346220201,2,1,540
72792293@N00,8835,19,1347151592,1347152132,20,1,540
72792293@N00,8836,19,1378998360,1378998900,17,1,540
72792293@N00,8837,19,1410561852,1410562392,35,1,540
72792293@N00,8838,1,1431419229,1431419289,1,1,60
72792293@N00,8839,19,1438302919,1438303459,19,1,540
72792293@N00,8840,19,1440322094,1440322634,1,1,540
7282277@N07,8841,26,1404189512,1404190412,10,8,900
7282277@N07,8841,12,1404198634,1404198733,2,8,99
7282277@N07,8841,16,1404198733,1404199003,2,8,270
7282277@N07,8841,1,1404209865,1404209925,2,8,60
7282277@N07,8841,28,1404212551,1404213451,15,8,900
7282277@N07,8841,23,1404218970,1404219113,4,8,143
7282277@N07,8841,29,1404219113,1404220013,2,8,900
7282277@N07,8841,1,1404220088,1404220148,1,8,60
7282277@N07,8842,1,1404263743,1404263803,2,27,60
7282277@N07,8842,15,1404265636,1404265906,5,27,270
7282277@N07,8842,4,1404266628,1404266729,2,27,101
7282277@N07,8842,5,1404267390,1404267510,4,27,120
7282277@N07,8842,7,1404267588,1404267676,2,27,88
7282277@N07,8842,5,1404267676,1404267796,2,27,120
7282277@N07,8842,7,1404267935,1404268115,3,27,180
7282277@N07,8842,6,1404268803,1404268818,3,27,15
7282277@N07,8842,7,1404268818,1404268880,4,27,62
7282277@N07,8842,6,1404268880,1404269000,2,27,120
7282277@N07,8842,11,1404269130,1404269370,4,27,240
7282277@N07,8842,7,1404270997,1404271177,2,27,180
7282277@N07,8842,17,1404272748,1404273048,3,27,300
7282277@N07,8842,28,1404274290,1404274539,7,27,249
7282277@N07,8842,1,1404274539,1404274599,6,27,60
7282277@N07,8842,28,1404275765,1404275783,3,27,18
7282277@N07,8842,1,1404275783,1404275843,2,27,60
7282277@N07,8842,28,1404275848,1404276061,2,27,213
7282277@N07,8842,1,1404276061,1404276121,2,27,60
7282277@N07,8842,20,1404276433,1404276973,6,27,540
7282277@N07,8842,13,1404277079,1404277319,2,27,240
7282277@N07,8842,21,1404277340,1404277342,2,27,2
7282277@N07,8842,13,1404277342,1404277355,3,27,13
7282277@N07,8842,25,1404277355,1404277440,3,27,85
7282277@N07,8842,15,1404277440,1404277697,8,27,257
7282277@N07,8842,17,1404277697,1404277781,7,27,84
7282277@N07,8842,1,1404277781,1404277841,1,27,60
72844756@N00,8843,29,1259307283,1259308183,2,1,900
72844756@N00,8844,3,1268375096,1268375186,2,3,90
72844756@N00,8844,20,1268381780,1268382320,3,3,540
72844756@N00,8844,18,1268388475,1268388925,1,3,450
72844756@N00,8845,28,1269207163,1269207807,2,7,644
72844756@N00,8845,26,1269207807,1269208104,2,7,297
72844756@N00,8845,6,1269208104,1269208224,2,7,120
72844756@N00,8845,26,1269208992,1269209892,2,7,900
72844756@N00,8845,20,1269211834,1269212374,2,7,540
72844756@N00,8845,17,1269215978,1269216278,2,7,300
72844756@N00,8845,29,1269217295,1269218195,1,7,900
72844756@N00,8846,1,1272406822,1272406882,3,3,60
72844756@N00,8846,28,1272414083,1272414798,2,3,715
72844756@N00,8846,1,1272414798,1272414858,1,3,60
72844756@N00,8847,15,1274438393,1274438663,2,2,270
72844756@N00,8847,25,1274441361,1274442201,1,2,840
72844756@N00,8848,29,1274533861,1274534761,1,1,900
72844756@N00,8849,23,1285401900,1285402500,1,1,600
72872155@N00,8850,26,1194554590,1194555490,5,1,900
72872155@N00,8851,26,1196514368,1196515268,17,1,900
72872155@N00,8852,20,1289528847,1289529387,2,1,540
72872155@N00,8853,26,1291979949,1291980849,1,1,900
72872155@N00,8854,28,1325724606,1325725506,1,1,900
72872155@N00,8855,20,1325755206,1325755746,1,1,540
72872155@N00,8856,28,1327203571,1327204471,2,1,900
72872155@N00,8857,19,1332591547,1332592087,1,1,540
72872155@N00,8858,5,1344130581,1344130701,1,1,120
72872155@N00,8859,18,1356686084,1356686534,1,1,450
72915363@N00,8860,5,1298100700,1298100820,1,1,120
72915363@N00,8861,27,1355190177,1355191077,2,2,900
72915363@N00,8861,18,1355195581,1355196031,1,2,450
72915363@N00,8862,28,1355311335,1355312235,1,1,900
72926310@N00,8863,24,1221218663,1221218668,2,2,5
72926310@N00,8863,10,1221218668,1221218908,1,2,240
72926310@N00,8864,28,1366066358,1366067258,3,11,900
72926310@N00,8864,12,1366067410,1366067650,7,11,240
72926310@N00,8864,27,1366067976,1366068876,3,11,900
72926310@N00,8864,12,1366069405,1366069614,4,11,209
72926310@N00,8864,21,1366069614,1366070184,3,11,570
72926310@N00,8864,3,1366070493,1366070583,3,11,90
72926310@N00,8864,29,1366072187,1366072759,2,11,572
72926310@N00,8864,19,1366072759,1366073299,2,11,540
72926310@N00,8864,12,1366076025,1366076208,3,11,183
72926310@N00,8864,24,1366076208,1366076988,11,11,780
72926310@N00,8864,31,1366090385,1366091885,2,11,1500
7296328@N07,8865,7,1310785470,1310785650,2,7,180
7296328@N07,8865,31,1310797865,1310799365,2,7,1500
7296328@N07,8865,29,1310799483,1310800383,2,7,900
7296328@N07,8865,1,1310804516,1310804576,2,7,60
7296328@N07,8865,26,1310805026,1310805926,2,7,900
7296328@N07,8865,28,1310815743,1310816643,2,7,900
7296328@N07,8865,1,1310822177,1310822237,2,7,60
73043483@N06,8866,24,1325153813,1325154593,1,1,780
73051591@N00,8867,19,1403760114,1403760654,1,1,540
73105116@N00,8868,29,1212760394,1212761294,1,1,900
73105116@N00,8869,26,1213019201,1213020101,1,1,900
73105116@N00,8870,24,1244175299,1244176079,2,6,780
73105116@N00,8870,25,1244186263,1244187103,2,6,840
73105116@N00,8870,31,1244188579,1244190079,2,6,1500
73105116@N00,8870,20,1244212774,1244213314,2,6,540
73105116@N00,8870,18,1244220326,1244220551,2,6,225
73105116@N00,8870,28,1244220551,1244221451,1,6,900
73105116@N00,8871,8,1244439459,1244439639,1,1,180
73105116@N00,8872,6,1253433719,1253433805,2,2,86
73105116@N00,8872,26,1253433805,1253434705,1,2,900
73105116@N00,8873,29,1254192705,1254193605,2,3,900
73105116@N00,8873,30,1254202734,1254203814,2,3,1080
73105116@N00,8873,28,1254215954,1254216854,2,3,900
73105116@N00,8874,28,1353573267,1353574167,1,1,900
73105116@N00,8875,28,1353882202,1353883102,1,1,900
73164011@N00,8876,26,1243894253,1243895153,24,1,900
73164011@N00,8877,16,1308283105,1308283375,1,1,270
73279190@N00,8878,17,1365142507,1365142807,1,1,300
73293249@N00,8879,1,1221037459,1221037519,10,36,60
73293249@N00,8879,25,1221039408,1221039981,3,36,573
73293249@N00,8879,1,1221039981,1221040032,2,36,51
73293249@N00,8879,28,1221040032,1221040932,8,36,900
73293249@N00,8879,18,1221041815,1221042265,2,36,450
73293249@N00,8879,30,1221042364,1221043121,8,36,757
73293249@N00,8879,23,1221043121,1221043721,2,36,600
73293249@N00,8879,29,1221044448,1221044906,5,36,458
73293249@N00,8879,22,1221044906,1221045506,2,36,600
73293249@N00,8879,14,1221045881,1221046121,5,36,240
73293249@N00,8879,29,1221046970,1221047870,4,36,900
73293249@N00,8879,19,1221050833,1221051182,6,36,349
73293249@N00,8879,29,1221051182,1221052082,2,36,900
73293249@N00,8879,19,1221052103,1221052220,3,36,117
73293249@N00,8879,18,1221052220,1221052346,2,36,126
73293249@N00,8879,28,1221052346,1221053246,2,36,900
73293249@N00,8879,26,1221053598,1221053858,8,36,260
73293249@N00,8879,16,1221053858,1221054128,2,36,270
73293249@N00,8879,24,1221054777,1221055557,2,36,780
73293249@N00,8879,21,1221055821,1221056391,2,36,570
73293249@N00,8879,15,1221057305,1221057575,17,36,270
73293249@N00,8879,17,1221061629,1221061929,2,36,300
73293249@N00,8879,26,1221063195,1221063269,2,36,74
73293249@N00,8879,6,1221063269,1221063389,4,36,120
73293249@N00,8879,7,1221063422,1221063602,4,36,180
73293249@N00,8879,21,1221063671,1221064074,4,36,403
73293249@N00,8879,12,1221064074,1221064314,3,36,240
73293249@N00,8879,3,1221064369,1221064459,6,36,90
73293249@N00,8879,26,1221065447,1221066347,4,36,900
73293249@N00,8879,23,1221067057,1221067657,2,36,600
73293249@N00,8879,18,1221068101,1221068551,2,36,450
73293249@N00,8879,29,1221070146,1221071046,3,36,900
73293249@N00,8879,13,1221071727,1221071967,12,36,240
73293249@N00,8879,26,1221073957,1221074205,2,36,248
73293249@N00,8879,28,1221074205,1221074590,3,36,385
73293249@N00,8879,1,1221074590,1221074650,1,36,60
7330503@N04,8880,18,1454378758,1454379208,4,1,450
7330503@N04,8881,18,1454478933,1454479383,2,1,450
73310709@N05,8882,30,1356659085,1356660165,2,2,1080
73310709@N05,8882,26,1356677642,1356678542,1,2,900
7337318@N05,8883,28,1316235637,1316236537,2,1,900
7337318@N05,8884,27,1353892125,1353893025,2,2,900
7337318@N05,8884,28,1353917763,1353918663,2,2,900
73392257@N00,8885,24,1354251835,1354252047,2,2,212
73392257@N00,8885,25,1354252047,1354252887,1,2,840
73392257@N00,8886,19,1407632643,1407633183,2,3,540
73392257@N00,8886,26,1407644241,1407645141,2,3,900
73392257@N00,8886,17,1407650633,1407650933,1,3,300
7340027@N06,8887,28,1344290393,1344291293,2,3,900
7340027@N06,8887,16,1344294403,1344294673,2,3,270
7340027@N06,8887,26,1344295645,1344296545,1,3,900
7340027@N06,8888,28,1344328725,1344329625,1,1,900
7340027@N06,8889,28,1352017931,1352018603,2,3,672
7340027@N06,8889,15,1352018603,1352018873,2,3,270
7340027@N06,8889,20,1352021430,1352021970,1,3,540
7340027@N06,8890,27,1352964440,1352965340,1,1,900
7340027@N06,8891,28,1353753223,1353754123,1,1,900
7340027@N06,8892,28,1355386228,1355387128,4,1,900
7340027@N06,8893,1,1365150216,1365150276,1,1,60
7340027@N06,8894,12,1365977729,1365977965,2,3,236
7340027@N06,8894,29,1365977965,1365978361,2,3,396
7340027@N06,8894,27,1365978361,1365979261,1,3,900
7340027@N06,8895,26,1370346361,1370347261,1,1,900
7340027@N06,8896,1,1372069069,1372069129,2,3,60
7340027@N06,8896,20,1372070500,1372071040,2,3,540
7340027@N06,8896,17,1372077027,1372077327,1,3,300
7340027@N06,8897,26,1372240714,1372241614,1,1,900
7340027@N06,8898,1,1384714722,1384714782,1,1,60
7340027@N06,8899,1,1384755829,1384755889,2,1,60
73436623@N05,8900,14,1398849467,1398849707,2,3,240
73436623@N05,8900,22,1398852066,1398852355,2,3,289
73436623@N05,8900,18,1398852355,1398852805,1,3,450
73436623@N05,8901,22,1408329261,1408329861,1,1,600
73436623@N05,8902,28,1420165200,1420166100,2,3,900
73436623@N05,8902,26,1420180933,1420181833,2,3,900
73436623@N05,8902,24,1420203230,1420204010,1,3,780
73451901@N00,8903,18,1260427839,1260428289,1,1,450
7346406@N06,8904,26,1286533883,1286534783,1,1,900
7346406@N06,8905,29,1295761153,1295762053,2,1,900
73565146@N00,8906,1,1296749349,1296749409,2,2,60
73565146@N00,8906,11,1296757604,1296757844,3,2,240
73565702@N00,8907,1,1351214800,1351214860,2,6,60
73565702@N00,8907,3,1351217672,1351217762,2,6,90
73565702@N00,8907,21,1351219808,1351220378,2,6,570
73565702@N00,8907,23,1351222409,1351223009,2,6,600
73565702@N00,8907,29,1351235374,1351235807,2,6,433
73565702@N00,8907,26,1351235807,1351236707,1,6,900
73565702@N00,8908,26,1364259730,1364260630,2,5,900
73565702@N00,8908,21,1364263024,1364263299,2,5,275
73565702@N00,8908,3,1364263299,1364263389,3,5,90
73565702@N00,8908,25,1364269124,1364269964,3,5,840
73565702@N00,8908,29,1364277337,1364278237,1,5,900
73565702@N00,8909,27,1374462400,1374463300,2,3,900
73565702@N00,8909,17,1374463650,1374463950,3,3,300
73565702@N00,8909,29,1374467572,1374468472,1,3,900
73565702@N00,8910,20,1374796898,1374797438,1,1,540
73613627@N06,8911,11,1403251559,1403251799,1,1,240
73614576@N08,8912,23,1280152801,1280153401,1,1,600
73621375@N00,8913,1,1214032694,1214032754,3,6,60
73621375@N00,8913,23,1214033165,1214033765,12,6,600
73621375@N00,8913,29,1214035167,1214036067,3,6,900
73621375@N00,8913,20,1214038780,1214039320,3,6,540
73621375@N00,8913,22,1214039930,1214040530,2,6,600
73621375@N00,8913,31,1214051716,1214053216,6,6,1500
73621375@N00,8914,26,1214092998,1214093103,3,6,105
73621375@N00,8914,24,1214093103,1214093149,2,6,46
73621375@N00,8914,16,1214093149,1214093419,3,6,270
73621375@N00,8914,17,1214097203,1214097503,2,6,300
73621375@N00,8914,26,1214102067,1214102259,4,6,192
73621375@N00,8914,6,1214102259,1214102379,2,6,120
73621375@N00,8915,28,1214190973,1214191873,5,1,900
73621375@N00,8916,28,1228450640,1228451033,4,7,393
73621375@N00,8916,26,1228451033,1228451121,2,7,88
73621375@N00,8916,23,1228451121,1228451721,10,7,600
73621375@N00,8916,18,1228452909,1228453359,2,7,450
73621375@N00,8916,19,1228454074,1228454614,4,7,540
73621375@N00,8916,29,1228459380,1228460280,7,7,900
73621375@N00,8916,26,1228461464,1228462364,11,7,900
73621375@N00,8917,24,1228543706,1228544486,6,8,780
73621375@N00,8917,28,1228555418,1228556318,6,8,900
73621375@N00,8917,16,1228557454,1228557724,4,8,270
73621375@N00,8917,26,1228561422,1228561589,2,8,167
73621375@N00,8917,3,1228561589,1228561679,4,8,90
73621375@N00,8917,16,1228561870,1228561973,2,8,103
73621375@N00,8917,25,1228561973,1228562813,11,8,840
73621375@N00,8917,26,1228565278,1228566178,2,8,900
73621375@N00,8918,26,1228600968,1228601868,26,10,900
73621375@N00,8918,28,1228603163,1228604063,7,10,900
73621375@N00,8918,26,1228607959,1228608844,3,10,885
73621375@N00,8918,30,1228608844,1228609163,2,10,319
73621375@N00,8918,29,1228609163,1228610063,17,10,900
73621375@N00,8918,25,1228612498,1228613338,6,10,840
73621375@N00,8918,13,1228613849,1228614089,3,10,240
73621375@N00,8918,25,1228614657,1228615497,73,10,840
73621375@N00,8918,15,1228618330,1228618600,3,10,270
73621375@N00,8918,1,1228619903,1228619963,2,10,60
73621375@N00,8919,29,1292023880,1292024780,6,8,900
73621375@N00,8919,30,1292026880,1292027861,4,8,981
73621375@N00,8919,23,1292027861,1292028461,13,8,600
73621375@N00,8919,17,1292029560,1292029860,2,8,300
73621375@N00,8919,25,1292032738,1292033578,7,8,840
73621375@N00,8919,26,1292046635,1292046931,9,8,296
73621375@N00,8919,6,1292046931,1292047051,9,8,120
73621375@N00,8919,17,1292050121,1292050421,4,8,300
73621375@N00,8920,30,1292133718,1292134798,4,3,1080
73621375@N00,8920,23,1292136126,1292136726,23,3,600
73621375@N00,8920,28,1292148401,1292149301,2,3,900
73621375@N00,8921,26,1292202682,1292203239,6,4,557
73621375@N00,8921,30,1292203239,1292203466,2,4,227
73621375@N00,8921,29,1292203466,1292204366,23,4,900
73621375@N00,8921,23,1292207657,1292208257,2,4,600
7363441@N07,8922,26,1354587921,1354588821,2,6,900
7363441@N07,8922,1,1354600940,1354601000,11,6,60
7363441@N07,8922,21,1354605079,1354605515,3,6,436
7363441@N07,8922,9,1354605515,1354605695,2,6,180
7363441@N07,8922,26,1354605715,1354605889,2,6,174
7363441@N07,8922,1,1354605889,1354605949,3,6,60
73666782@N00,8923,28,1361585261,1361586161,3,1,900
73666782@N00,8924,1,1393070244,1393070304,1,1,60
73666782@N00,8925,1,1393123096,1393123156,1,1,60
73666782@N00,8926,7,1393307749,1393307929,1,1,180
73694110@N00,8927,28,1349515633,1349516533,1,1,900
73746571@N00,8928,21,1380280927,1380281497,1,1,570
7377220@N07,8929,26,1239680488,1239681388,1,1,900
73779712@N00,8930,28,1237869249,1237870149,1,1,900
7378372@N02,8931,30,1357368299,1357369379,2,1,1080
73802184@N00,8932,16,1355527596,1355527866,2,5,270
73802184@N00,8932,20,1355529460,1355530000,2,5,540
73802184@N00,8932,1,1355550735,1355550795,6,5,60
73802184@N00,8932,21,1355561073,1355561643,3,5,570
73802184@N00,8932,26,1355571976,1355572876,1,5,900
73802184@N00,8933,17,1361604983,1361605283,3,4,300
73802184@N00,8933,28,1361605908,1361606155,3,4,247
73802184@N00,8933,15,1361606155,1361606425,5,4,270
73802184@N00,8933,27,1361612120,1361613020,2,4,900
73802184@N00,8934,16,1394693028,1394693298,2,5,270
73802184@N00,8934,15,1394695768,1394696038,5,5,270
73802184@N00,8934,30,1394697672,1394698752,2,5,1080
73802184@N00,8934,23,1394704325,1394704925,4,5,600
73802184@N00,8934,18,1394707249,1394707699,1,5,450
73802184@N00,8935,30,1394777692,1394778772,1,1,1080
73802184@N00,8936,23,1394922172,1394922772,3,3,600
73802184@N00,8936,9,1394924497,1394924677,2,3,180
73802184@N00,8936,13,1394930451,1394930691,1,3,240
73802184@N00,8937,28,1395009652,1395010552,22,1,900
73802184@N00,8938,28,1395147299,1395148199,1,1,900
73843632@N04,8939,28,1335610891,1335610939,2,2,48
73843632@N04,8939,18,1335610939,1335611389,1,2,450
7387461@N02,8940,3,1282009927,1282010017,1,1,90
73883362@N00,8941,1,1385316264,1385316324,2,4,60
73883362@N00,8941,16,1385325239,1385325509,2,4,270
73883362@N00,8941,29,1385345394,1385346294,2,4,900
73883362@N00,8941,1,1385358772,1385358832,1,4,60
73883362@N00,8942,28,1385443790,1385444690,1,1,900
73883362@N00,8943,19,1418921964,1418922504,1,1,540
73883362@N00,8944,14,1419047042,1419047282,1,1,240
73889777@N00,8945,18,1432278931,1432279381,2,1,450
73889777@N00,8946,18,1432430992,1432431442,1,1,450
7396528@N02,8947,16,1293755289,1293755559,2,9,270
7396528@N02,8947,27,1293756041,1293756941,2,9,900
7396528@N02,8947,1,1293762042,1293762102,3,9,60
7396528@N02,8947,28,1293768775,1293769675,3,9,900
7396528@N02,8947,16,1293770884,1293771154,3,9,270
7396528@N02,8947,20,1293778153,1293778693,2,9,540
7396528@N02,8947,26,1293792449,1293793349,4,9,900
7396528@N02,8947,16,1293793820,1293794090,2,9,270
7396528@N02,8947,28,1293805444,1293806344,1,9,900
7396528@N02,8948,13,1293853264,1293853504,4,2,240
7396528@N02,8948,1,1293861396,1293861456,1,2,60
7397017@N04,8949,16,1206842373,1206842643,1,1,270
7397017@N04,8950,16,1206879179,1206879449,1,1,270
7398381@N04,8951,20,1291322784,1291323324,1,1,540
7401887@N02,8952,18,1450136494,1450136944,1,1,450
7401887@N02,8953,18,1450185715,1450186165,1,1,450
7401887@N02,8954,18,1459806601,1459807051,2,1,450
7406966@N05,8955,27,1253866340,1253867240,2,2,900
7406966@N05,8955,16,1253876718,1253876988,1,2,270
7408156@N05,8956,26,1288836528,1288837428,161,1,900
74122389@N07,8957,1,1399440462,1399440465,2,6,3
74122389@N07,8957,26,1399440465,1399440468,2,6,3
74122389@N07,8957,30,1399440468,1399440509,3,6,41
74122389@N07,8957,17,1399440509,1399440515,3,6,6
74122389@N07,8957,21,1399440515,1399440591,9,6,76
74122389@N07,8957,13,1399440591,1399440831,1,6,240
74164239@N00,8958,30,1245753034,1245754114,1,1,1080
74193050@N00,8959,28,1329794706,1329795606,2,1,900
74215305@N00,8960,20,1199241594,1199242134,2,4,540
74215305@N00,8960,18,1199243951,1199244401,2,4,450
74215305@N00,8960,27,1199250698,1199251040,2,4,342
74215305@N00,8960,16,1199251040,1199251310,1,4,270
74236522@N00,8961,29,1233175103,1233176003,1,1,900
74236522@N00,8962,28,1233261225,1233262125,1,1,900
74236522@N00,8963,29,1233347277,1233348177,1,1,900
74236522@N00,8964,25,1234571094,1234571934,1,1,840
74236522@N00,8965,13,1236289649,1236289889,1,1,240
74236522@N00,8966,16,1251902165,1251902435,1,1,270
74236522@N00,8967,26,1260762439,1260763339,1,1,900
74269575@N03,8968,4,1326080017,1326080118,1,1,101
74269575@N03,8969,16,1326159502,1326159772,2,2,270
74269575@N03,8969,30,1326168150,1326169230,1,2,1080
74285955@N00,8970,19,1335085193,1335085733,2,4,540
74285955@N00,8970,29,1335086735,1335087635,2,4,900
74285955@N00,8970,13,1335092018,1335092258,2,4,240
74285955@N00,8970,23,1335112696,1335113296,1,4,600
74285955@N00,8971,18,1345948867,1345949317,2,1,450
74285955@N00,8972,15,1347780750,1347781020,2,1,270
74285955@N00,8973,31,1364867709,1364869209,1,1,1500
74285955@N00,8974,7,1365321003,1365321183,1,1,180
74285955@N00,8975,30,1366518861,1366519941,1,1,1080
74285955@N00,8976,26,1368320217,1368321117,1,1,900
74285955@N00,8977,15,1377391523,1377391793,1,1,270
74285955@N00,8978,1,1381633027,1381633087,2,2,60
74285955@N00,8978,28,1381635246,1381636146,1,2,900
7434666@N07,8979,28,1188186697,1188187597,28,1,900
74354559@N05,8980,15,1426128482,1426128752,4,4,270
74354559@N05,8980,16,1426133251,1426133521,2,4,270
74354559@N05,8980,15,1426135537,1426135807,2,4,270
74354559@N05,8980,26,1426140966,1426141866,3,4,900
74382902@N00,8981,31,1360992455,1360993955,2,4,1500
74382902@N00,8981,23,1360994760,1360995360,2,4,600
74382902@N00,8981,24,1360998156,1360998936,2,4,780
74382902@N00,8981,12,1361010763,1361011003,2,4,240
74403697@N02,8982,17,1418334771,1418335071,4,6,300
74403697@N02,8982,1,1418338422,1418338482,8,6,60
74403697@N02,8982,17,1418340024,1418340324,3,6,300
74403697@N02,8982,30,1418345151,1418345171,3,6,20
74403697@N02,8982,20,1418345171,1418345711,8,6,540
74403697@N02,8982,26,1418366473,1418367373,1,6,900
74403697@N02,8983,1,1418418644,1418418644,8,15,0
74403697@N02,8983,17,1418418644,1418418644,6,15,0
74403697@N02,8983,20,1418418644,1418418644,8,15,0
74403697@N02,8983,26,1418418644,1418418644,2,15,0
74403697@N02,8983,30,1418418644,1418419724,3,15,1080
74403697@N02,8983,12,1418446820,1418447060,2,15,240
74403697@N02,8983,24,1418449451,1418450231,12,15,780
74403697@N02,8983,26,1418465446,1418466346,2,15,900
74403697@N02,8983,21,1418467712,1418468282,2,15,570
74403697@N02,8983,25,1418469202,1418470042,3,15,840
74403697@N02,8983,13,1418470073,1418470313,2,15,240
74403697@N02,8983,21,1418475331,1418475901,2,15,570
74403697@N02,8983,24,1418481864,1418482644,8,15,780
74403697@N02,8983,12,1418488420,1418488420,2,15,0
74403697@N02,8983,24,1418488420,1418489200,1,15,780
7442675@N08,8984,15,1344349700,1344349970,1,1,270
7442719@N04,8985,18,1439142379,1439142829,1,1,450
74471986@N00,8986,1,1402118954,1402119014,1,1,60
74478949@N02,8987,28,1345158261,1345159161,1,1,900
7449712@N02,8988,26,1377865213,1377866113,1,1,900
74501739@N05,8989,30,1463448678,1463449758,1,1,1080
74501739@N05,8990,4,1463483640,1463483741,1,1,101
74501739@N05,8991,31,1463618943,1463620443,1,1,1500
74501739@N05,8992,30,1463656361,1463657441,2,3,1080
74501739@N05,8992,26,1463659312,1463660212,2,3,900
74501739@N05,8992,1,1463660508,1463660568,1,3,60
7451795@N03,8993,23,1397554307,1397554907,1,1,600
7451795@N03,8994,11,1397637463,1397637703,1,1,240
7459168@N04,8995,17,1256520402,1256520702,2,6,300
7459168@N04,8995,12,1256522981,1256523221,2,6,240
7459168@N04,8995,16,1256523904,1256524174,5,6,270
7459168@N04,8995,26,1256525293,1256526193,3,6,900
7459168@N04,8995,10,1256530134,1256530374,3,6,240
7459168@N04,8995,30,1256531022,1256532102,2,6,1080
7459168@N04,8996,1,1379256134,1379256194,1,1,60
74594655@N00,8997,20,1199593813,1199594353,4,12,540
74594655@N00,8997,17,1199595904,1199596204,2,12,300
74594655@N00,8997,1,1199596243,1199596303,2,12,60
74594655@N00,8997,15,1199599559,1199599829,3,12,270
74594655@N00,8997,24,1199602852,1199603003,2,12,151
74594655@N00,8997,15,1199603003,1199603273,5,12,270
74594655@N00,8997,16,1199605916,1199606100,2,12,184
74594655@N00,8997,27,1199606100,1199606274,2,12,174
74594655@N00,8997,16,1199606274,1199606544,2,12,270
74594655@N00,8997,18,1199611790,1199612240,4,12,450
74594655@N00,8997,28,1199616224,1199616609,5,12,385
74594655@N00,8997,1,1199616609,1199616669,1,12,60
74594655@N00,8998,26,1199668874,1199669774,1,1,900
74594655@N00,8999,31,1245984694,1245986108,2,4,1414
74594655@N00,8999,18,1245986108,1245986558,3,4,450
74594655@N00,8999,5,1246006874,1246006994,2,4,120
74594655@N00,8999,23,1246017391,1246017991,2,4,600
74594655@N00,9000,24,1258159744,1258160524,2,3,780
74594655@N00,9000,15,1258161842,1258162112,2,3,270
74594655@N00,9000,12,1258165298,1258165538,1,3,240
74616830@N00,9001,18,1199418697,1199419147,2,2,450
74616830@N00,9001,19,1199420495,1199421035,3,2,540
74616830@N00,9002,26,1327017705,1327018605,3,3,900
74616830@N00,9002,8,1327018716,1327018896,3,3,180
74616830@N00,9002,24,1327022330,1327023110,1,3,780
74616830@N00,9003,29,1327124839,1327125739,4,3,900
74616830@N00,9003,23,1327143632,1327144232,2,3,600
74616830@N00,9003,21,1327146535,1327147105,2,3,570
74616830@N00,9004,23,1327196908,1327197508,1,1,600
74644696@N00,9005,10,1193644867,1193645107,6,1,240
74644696@N00,9006,10,1193693505,1193693745,28,1,240
74712199@N00,9007,27,1259623526,1259624426,1,1,900
74712199@N00,9008,17,1302394004,1302394304,3,2,300
74712199@N00,9008,23,1302410939,1302411539,1,2,600
74712199@N00,9009,1,1317356526,1317356586,1,1,60
74712199@N00,9010,27,1317431561,1317432461,1,1,900
74712199@N00,9011,12,1317511988,1317512228,1,1,240
74712199@N00,9012,27,1319855718,1319856023,2,2,305
74712199@N00,9012,16,1319856023,1319856293,1,2,270
74712199@N00,9013,24,1319946005,1319946785,1,1,780
74712199@N00,9014,16,1322885402,1322885672,1,1,270
74712199@N00,9015,25,1322963424,1322964264,1,1,840
74712199@N00,9016,18,1336864369,1336864819,1,1,450
74712199@N00,9017,28,1345860630,1345861530,2,2,900
74712199@N00,9017,12,1345862362,1345862602,1,2,240
74712199@N00,9018,30,1349600980,1349602060,1,1,1080
74712199@N00,9019,17,1349654382,1349654682,1,1,300
74712199@N00,9020,17,1354333987,1354334287,2,1,300
74712199@N00,9021,1,1370670130,1370670190,1,1,60
74712199@N00,9022,30,1370741758,1370742838,1,1,1080
74712199@N00,9023,26,1370776459,1370777359,1,1,900
74712199@N00,9024,17,1373585666,1373585966,2,2,300
74712199@N00,9024,18,1373601150,1373601600,1,2,450
74712199@N00,9025,20,1380865518,1380866058,1,1,540
74712199@N00,9026,1,1386407522,1386407582,1,1,60
74712199@N00,9027,1,1395611365,1395611425,1,1,60
74712199@N00,9028,19,1405290539,1405291079,2,2,540
74712199@N00,9028,17,1405295277,1405295577,1,2,300
74712199@N00,9029,20,1412324134,1412324674,1,1,540
74712199@N00,9030,25,1417944586,1417945426,2,2,840
74712199@N00,9030,26,1417946789,1417947689,1,2,900
74712199@N00,9031,17,1424479060,1424479360,1,1,300
7474477@N08,9032,30,1203339600,1203339607,2,8,7
7474477@N08,9032,28,1203339607,1203339610,3,8,3
7474477@N08,9032,12,1203339610,1203339611,2,8,1
7474477@N08,9032,4,1203339611,1203339632,3,8,21
7474477@N08,9032,28,1203339632,1203339633,2,8,1
7474477@N08,9032,26,1203339633,1203339634,2,8,1
7474477@N08,9032,17,1203339634,1203339636,2,8,2
7474477@N08,9032,30,1203339636,1203340716,2,8,1080
74754977@N03,9033,19,1403936336,1403936876,4,1,540
74813143@N05,9034,28,1328402265,1328403165,2,4,900
74813143@N05,9034,17,1328404553,1328404853,4,4,300
74813143@N05,9034,24,1328406880,1328407660,2,4,780
74813143@N05,9034,25,1328414307,1328415147,7,4,840
74836867@N00,9035,26,1468547054,1468547954,5,1,900
74836867@N00,9036,26,1468854188,1468855088,5,1,900
74839311@N00,9037,1,1276235217,1276235277,1,1,60
7485909@N03,9038,19,1416964850,1416965390,1,1,540
7490457@N07,9039,29,1337388774,1337389674,2,3,900
7490457@N07,9039,15,1337394204,1337394474,2,3,270
7490457@N07,9039,28,1337416557,1337417457,1,3,900
7490457@N07,9040,15,1362184397,1362184667,2,2,270
7490457@N07,9040,28,1362190914,1362191814,1,2,900
75014282@N08,9041,28,1394965631,1394966531,1,1,900
75113182@N08,9042,17,1272027763,1272028063,1,1,300
75229645@N00,9043,29,1317430131,1317430179,4,3,48
75229645@N00,9043,31,1317430179,1317431530,2,3,1351
75229645@N00,9043,29,1317431530,1317432430,2,3,900
75229645@N00,9044,20,1443827310,1443827850,4,8,540
75229645@N00,9044,22,1443834686,1443834786,2,8,100
75229645@N00,9044,14,1443834786,1443835026,2,8,240
75229645@N00,9044,22,1443835414,1443836014,2,8,600
75229645@N00,9044,21,1443854035,1443854605,4,8,570
75229645@N00,9044,27,1443859630,1443860143,2,8,513
75229645@N00,9044,26,1443860143,1443861043,2,8,900
75229645@N00,9044,27,1443872027,1443872927,1,8,900
75255210@N00,9045,26,1303043056,1303043956,1,1,900
75268070@N00,9046,23,1272100213,1272100813,1,1,600
75274024@N00,9047,17,1373244868,1373245168,2,2,300
75274024@N00,9047,20,1373268603,1373269143,1,2,540
75345140@N00,9048,22,1317271995,1317272595,1,1,600
75367347@N07,9049,16,1313526204,1313526474,1,1,270
7537305@N05,9050,29,1341377559,1341378459,1,1,900
75427019@N00,9051,13,1344221876,1344222116,1,1,240
75427019@N00,9052,17,1405168571,1405168871,1,1,300
75433066@N00,9053,17,1238803576,1238803876,3,1,300
75447720@N02,9054,17,1340679751,1340680051,2,1,300
75494748@N08,9055,26,1435221973,1435222873,2,1,900
75494748@N08,9056,14,1435361340,1435361580,1,1,240
75494748@N08,9057,26,1435397570,1435398470,1,1,900
75509382@N07,9058,19,1406377604,1406378144,1,1,540
75558245@N00,9059,1,1243566106,1243566166,2,11,60
75558245@N00,9059,28,1243566300,1243567200,5,11,900
75558245@N00,9059,26,1243567406,1243568306,3,11,900
75558245@N00,9059,31,1243570947,1243571247,2,11,300
75558245@N00,9059,29,1243571247,1243572147,5,11,900
75558245@N00,9059,20,1243579417,1243579957,2,11,540
75558245@N00,9059,10,1243586733,1243586973,2,11,240
75558245@N00,9059,4,1243591094,1243591195,2,11,101
75558245@N00,9059,3,1243591413,1243591503,2,11,90
75558245@N00,9059,26,1243592033,1243592564,2,11,531
75558245@N00,9059,28,1243592564,1243593464,3,11,900
75558245@N00,9060,20,1243784030,1243784570,2,2,540
75558245@N00,9060,12,1243786760,1243787000,1,2,240
75605227@N04,9061,7,1466932963,1466933143,1,1,180
75617537@N03,9062,1,1368785764,1368785824,1,1,60
75649425@N07,9063,28,1336132659,1336133559,1,1,900
75666721@N08,9064,22,1388460502,1388461102,2,2,600
75666721@N08,9064,20,1388463752,1388464292,1,2,540
75666721@N08,9065,28,1388492749,1388493649,2,1,900
75666721@N08,9066,16,1399186653,1399186923,2,2,270
75666721@N08,9066,17,1399203103,1399203403,1,2,300
75666721@N08,9067,28,1399282151,1399283051,1,1,900
75666721@N08,9068,1,1402283773,1402283833,1,1,60
75666721@N08,9069,19,1413700407,1413700947,1,1,540
75666721@N08,9070,18,1423987017,1423987467,1,1,450
75667634@N00,9071,5,1420853957,1420854077,2,1,120
75674173@N00,9072,31,1316083598,1316085098,1,1,1500
75674173@N00,9073,29,1316172382,1316172781,2,4,399
75674173@N00,9073,20,1316172781,1316173321,3,4,540
75674173@N00,9073,23,1316177505,1316178105,2,4,600
75674173@N00,9073,24,1316181185,1316181965,1,4,780
75683070@N00,9074,1,1326723796,1326723856,6,48,60
75683070@N00,9074,28,1326725828,1326726728,21,48,900
75683070@N00,9074,16,1326726730,1326727000,7,48,270
75683070@N00,9074,27,1326727469,1326728091,5,48,622
75683070@N00,9074,15,1326728091,1326728361,2,48,270
75683070@N00,9074,16,1326728503,1326728773,2,48,270
75683070@N00,9074,26,1326728779,1326728949,3,48,170
75683070@N00,9074,16,1326728949,1326729132,7,48,183
75683070@N00,9074,26,1326729132,1326729267,5,48,135
75683070@N00,9074,6,1326729267,1326729359,4,48,92
75683070@N00,9074,21,1326729359,1326729929,3,48,570
75683070@N00,9074,13,1326731522,1326731536,2,48,14
75683070@N00,9074,21,1326731536,1326731695,2,48,159
75683070@N00,9074,3,1326731695,1326731785,13,48,90
75683070@N00,9074,21,1326732826,1326732938,2,48,112
75683070@N00,9074,7,1326732938,1326733118,7,48,180
75683070@N00,9074,6,1326733343,1326733463,9,48,120
75683070@N00,9074,8,1326734269,1326734449,3,48,180
75683070@N00,9074,24,1326735851,1326736483,7,48,632
75683070@N00,9074,12,1326736483,1326736723,6,48,240
75683070@N00,9074,4,1326736867,1326736944,2,48,77
75683070@N00,9074,10,1326736944,1326737184,2,48,240
75683070@N00,9074,30,1326737295,1326737467,6,48,172
75683070@N00,9074,26,1326737467,1326737896,3,48,429
75683070@N00,9074,4,1326737896,1326737997,4,48,101
75683070@N00,9074,10,1326738267,1326738507,13,48,240
75683070@N00,9074,4,1326740734,1326740835,19,48,101
75683070@N00,9074,10,1326742667,1326742907,12,48,240
75683070@N00,9074,30,1326744131,1326744376,5,48,245
75683070@N00,9074,19,1326744376,1326744445,3,48,69
75683070@N00,9074,29,1326744445,1326745345,15,48,900
75683070@N00,9074,22,1326746159,1326746759,7,48,600
75683070@N00,9074,20,1326746912,1326747089,2,48,177
75683070@N00,9074,29,1326747089,1326747141,2,48,52
75683070@N00,9074,30,1326747141,1326747211,2,48,70
75683070@N00,9074,26,1326747211,1326748111,12,48,900
75683070@N00,9074,25,1326748467,1326749307,39,48,840
75683070@N00,9074,24,1326750482,1326751262,12,48,780
75683070@N00,9074,15,1326751546,1326751726,2,48,180
75683070@N00,9074,27,1326751726,1326752626,3,48,900
75683070@N00,9074,28,1326753759,1326754659,7,48,900
75683070@N00,9074,26,1326755291,1326755384,4,48,93
75683070@N00,9074,6,1326755384,1326755504,2,48,120
75683070@N00,9074,10,1326755894,1326756134,2,48,240
75683070@N00,9074,25,1326756739,1326756873,3,48,134
75683070@N00,9074,3,1326756873,1326756963,2,48,90
75683070@N00,9074,16,1326759339,1326759609,21,48,270
75683070@N00,9074,25,1326760659,1326761499,7,48,840
75683070@N00,9075,1,1430691527,1430691587,4,76,60
75683070@N00,9075,28,1430693376,1430693568,6,76,192
75683070@N00,9075,16,1430693568,1430693838,5,76,270
75683070@N00,9075,27,1430694313,1430695213,14,76,900
75683070@N00,9075,16,1430696443,1430696713,2,76,270
75683070@N00,9075,17,1430697079,1430697379,7,76,300
75683070@N00,9075,27,1430697398,1430697502,4,76,104
75683070@N00,9075,24,1430697502,1430697630,8,76,128
75683070@N00,9075,12,1430697630,1430697870,11,76,240
75683070@N00,9075,3,1430697988,1430698078,3,76,90
75683070@N00,9075,7,1430698086,1430698103,2,76,17
75683070@N00,9075,5,1430698103,1430698116,2,76,13
75683070@N00,9075,7,1430698116,1430698173,4,76,57
75683070@N00,9075,6,1430698173,1430698293,6,76,120
75683070@N00,9075,26,1430698296,1430698542,10,76,246
75683070@N00,9075,16,1430698542,1430698622,4,76,80
75683070@N00,9075,27,1430698622,1430699515,2,76,893
75683070@N00,9075,18,1430699515,1430699965,5,76,450
75683070@N00,9075,23,1430700669,1430701186,2,76,517
75683070@N00,9075,18,1430701186,1430701636,8,76,450
75683070@N00,9075,23,1430702174,1430702282,2,76,108
75683070@N00,9075,18,1430702282,1430702294,2,76,12
75683070@N00,9075,23,1430702294,1430702671,10,76,377
75683070@N00,9075,18,1430702671,1430702775,2,76,104
75683070@N00,9075,19,1430702775,1430703302,15,76,527
75683070@N00,9075,29,1430703302,1430704202,24,76,900
75683070@N00,9075,23,1430705885,1430705919,2,76,34
75683070@N00,9075,20,1430705919,1430705938,2,76,19
75683070@N00,9075,30,1430705938,1430706556,2,76,618
75683070@N00,9075,20,1430706556,1430706676,3,76,120
75683070@N00,9075,29,1430706676,1430706979,13,76,303
75683070@N00,9075,10,1430706979,1430707043,2,76,64
75683070@N00,9075,29,1430707043,1430707069,2,76,26
75683070@N00,9075,31,1430707069,1430707101,2,76,32
75683070@N00,9075,30,1430707101,1430707563,2,76,462
75683070@N00,9075,31,1430707563,1430707665,2,76,102
75683070@N00,9075,22,1430707665,1430708145,4,76,480
75683070@N00,9075,14,1430708145,1430708385,8,76,240
75683070@N00,9075,22,1430709240,1430709840,6,76,600
75683070@N00,9075,14,1430709889,1430710129,3,76,240
75683070@N00,9075,29,1430711117,1430711548,2,76,431
75683070@N00,9075,20,1430711548,1430711595,2,76,47
75683070@N00,9075,29,1430711595,1430711823,3,76,228
75683070@N00,9075,22,1430711823,1430712286,2,76,463
75683070@N00,9075,13,1430712286,1430712435,3,76,149
75683070@N00,9075,25,1430712435,1430712558,8,76,123
75683070@N00,9075,12,1430712558,1430712719,2,76,161
75683070@N00,9075,15,1430712719,1430712989,3,76,270
75683070@N00,9075,24,1430713757,1430714537,15,76,780
75683070@N00,9075,15,1430715670,1430715683,2,76,13
75683070@N00,9075,24,1430715683,1430716463,5,76,780
75683070@N00,9075,15,1430716755,1430717025,3,76,270
75683070@N00,9075,12,1430717237,1430717298,3,76,61
75683070@N00,9075,24,1430717298,1430717606,5,76,308
75683070@N00,9075,12,1430717606,1430717844,2,76,238
75683070@N00,9075,21,1430717844,1430717922,2,76,78
75683070@N00,9075,25,1430717922,1430718762,20,76,840
75683070@N00,9075,13,1430719632,1430719872,2,76,240
75683070@N00,9075,21,1430720630,1430720826,3,76,196
75683070@N00,9075,3,1430720826,1430720916,4,76,90
75683070@N00,9075,7,1430722591,1430722771,2,76,180
75683070@N00,9075,9,1430723360,1430723540,4,76,180
75683070@N00,9075,6,1430723722,1430723793,2,76,71
75683070@N00,9075,26,1430723793,1430724063,6,76,270
75683070@N00,9075,23,1430724063,1430724663,3,76,600
75683070@N00,9075,30,1430724976,1430725328,3,76,352
75683070@N00,9075,18,1430725328,1430725778,9,76,450
75683070@N00,9075,19,1430725923,1430725957,2,76,34
75683070@N00,9075,29,1430725957,1430726094,3,76,137
75683070@N00,9075,18,1430726094,1430726544,4,76,450
75683070@N00,9075,26,1430726742,1430727642,6,76,900
75683070@N00,9075,15,1430728138,1430728281,2,76,143
75683070@N00,9075,27,1430728281,1430728971,2,76,690
75683070@N00,9075,13,1430728971,1430729211,22,76,240
75683070@N00,9075,26,1430732990,1430733890,3,76,900
75683070@N00,9075,1,1430734024,1430734084,1,76,60
75722661@N00,9076,16,1220743611,1220743881,1,1,270
75722661@N00,9077,15,1281089995,1281090265,1,1,270
75722661@N00,9078,26,1298857674,1298858187,2,2,513
75722661@N00,9078,23,1298858187,1298858787,1,2,600
75722661@N00,9079,30,1317430774,1317431854,1,1,1080
75755096@N02,9080,1,1414742395,1414742455,1,1,60
75755096@N02,9081,25,1414841840,1414842680,1,1,840
75755096@N02,9082,29,1415164251,1415165151,1,1,900
75755096@N02,9083,20,1415701328,1415701868,1,1,540
7575958@N02,9084,26,1221962157,1221963057,1,1,900
75797390@N00,9085,14,1404811445,1404811685,2,2,240
75797390@N00,9085,28,1404813796,1404814696,1,2,900
75806696@N00,9086,19,1290922006,1290922546,2,2,540
75806696@N00,9086,12,1290924001,1290924241,1,2,240
7585404@N05,9087,26,1458777898,1458778798,1,1,900
7593170@N07,9088,4,1217512800,1217512800,2,4,0
7593170@N07,9088,12,1217512800,1217512800,2,4,0
7593170@N07,9088,16,1217512800,1217512800,2,4,0
7593170@N07,9088,30,1217512800,1217513880,1,4,1080
75941851@N00,9089,19,1226360752,1226361292,3,9,540
75941851@N00,9089,29,1226364530,1226364597,2,9,67
75941851@N00,9089,20,1226364597,1226365137,4,9,540
75941851@N00,9089,22,1226366082,1226366682,5,9,600
75941851@N00,9089,16,1226373743,1226374013,2,9,270
75941851@N00,9089,3,1226375556,1226375646,2,9,90
75941851@N00,9089,21,1226375813,1226376383,3,9,570
75941851@N00,9089,13,1226377054,1226377294,19,9,240
75941851@N00,9089,1,1226380655,1226380715,1,9,60
75941851@N00,9090,20,1254441948,1254442488,2,13,540
75941851@N00,9090,14,1254445679,1254445705,2,13,26
75941851@N00,9090,22,1254445705,1254445733,2,13,28
75941851@N00,9090,14,1254445733,1254445973,2,13,240
75941851@N00,9090,19,1254447009,1254447549,4,13,540
75941851@N00,9090,30,1254448441,1254448609,2,13,168
75941851@N00,9090,18,1254448609,1254448849,2,13,240
75941851@N00,9090,23,1254448849,1254449449,3,13,600
75941851@N00,9090,21,1254454255,1254454769,2,13,514
75941851@N00,9090,13,1254454769,1254455009,3,13,240
75941851@N00,9090,12,1254455012,1254455252,2,13,240
75941851@N00,9090,15,1254459121,1254459391,3,13,270
75941851@N00,9090,26,1254462013,1254462913,5,13,900
75941851@N00,9091,22,1268377347,1268377947,1,1,600
75987989@N03,9092,5,1339305177,1339305297,1,1,120
75992475@N02,9093,28,1434762955,1434763855,2,5,900
75992475@N02,9093,27,1434765880,1434766780,2,5,900
75992475@N02,9093,15,1434793933,1434794203,2,5,270
75992475@N02,9093,26,1434803610,1434804510,2,5,900
75992475@N02,9093,15,1434809583,1434809853,1,5,270
75992475@N02,9094,26,1434863215,1434864115,2,2,900
75992475@N02,9094,30,1434872118,1434873198,1,2,1080
75992475@N02,9095,1,1434930852,1434930912,2,6,60
75992475@N02,9095,28,1434931921,1434932821,2,6,900
75992475@N02,9095,1,1434932859,1434932919,4,6,60
75992475@N02,9095,28,1434933833,1434934733,2,6,900
75992475@N02,9095,24,1434937767,1434938547,2,6,780
75992475@N02,9095,13,1434944511,1434944751,1,6,240
76024515@N07,9096,27,1333805942,1333806842,1,1,900
76024515@N07,9097,29,1354938926,1354939826,2,2,900
76024515@N07,9097,26,1354957740,1354958640,1,2,900
76024515@N07,9098,24,1363856729,1363857280,2,2,551
76024515@N07,9098,12,1363857280,1363857520,1,2,240
76024515@N07,9099,12,1423711390,1423711630,1,1,240
76033853@N00,9100,12,1365304537,1365304777,1,1,240
7606077@N02,9101,15,1457773961,1457774231,1,1,270
76101503@N00,9102,18,1437730262,1437730712,1,1,450
76112547@N00,9103,27,1316050136,1316051036,2,2,900
76112547@N00,9103,14,1316062099,1316062339,1,2,240
7613980@N06,9104,23,1286847091,1286847691,1,1,600
76151808@N00,9105,1,1203035498,1203035558,2,17,60
76151808@N00,9105,24,1203036718,1203036966,2,17,248
76151808@N00,9105,15,1203036966,1203037236,2,17,270
76151808@N00,9105,12,1203037657,1203037897,2,17,240
76151808@N00,9105,17,1203038371,1203038671,2,17,300
76151808@N00,9105,21,1203038802,1203039372,2,17,570
76151808@N00,9105,11,1203039945,1203040185,3,17,240
76151808@N00,9105,21,1203040222,1203040263,2,17,41
76151808@N00,9105,5,1203040263,1203040383,2,17,120
76151808@N00,9105,9,1203041013,1203041031,2,17,18
76151808@N00,9105,6,1203041031,1203041151,2,17,120
76151808@N00,9105,31,1203044978,1203046478,2,17,1500
76151808@N00,9105,24,1203046664,1203047444,2,17,780
76151808@N00,9105,16,1203050736,1203051006,6,17,270
76151808@N00,9105,19,1203052881,1203053421,2,17,540
76151808@N00,9105,21,1203059562,1203060132,2,17,570
76151808@N00,9105,3,1203062177,1203062267,1,17,90
76151808@N00,9106,28,1203371981,1203372587,2,2,606
76151808@N00,9106,17,1203372587,1203372887,1,2,300
76151808@N00,9107,24,1203463617,1203464397,2,5,780
76151808@N00,9107,26,1203469666,1203470566,3,5,900
76151808@N00,9107,24,1203478835,1203479615,3,5,780
76151808@N00,9107,27,1203497480,1203498380,2,5,900
76151808@N00,9107,23,1203499937,1203500537,1,5,600
76151808@N00,9108,29,1203635627,1203636527,2,9,900
76151808@N00,9108,25,1203638199,1203639039,2,9,840
76151808@N00,9108,13,1203640568,1203640808,4,9,240
76151808@N00,9108,6,1203647446,1203647566,2,9,120
76151808@N00,9108,30,1203647964,1203649044,3,9,1080
76151808@N00,9108,15,1203659284,1203659518,2,9,234
76151808@N00,9108,24,1203659518,1203660247,2,9,729
76151808@N00,9108,27,1203660247,1203661011,2,9,764
76151808@N00,9108,19,1203661011,1203661551,1,9,540
76151808@N00,9109,26,1203723305,1203724205,2,5,900
76151808@N00,9109,18,1203724570,1203725020,2,5,450
76151808@N00,9109,31,1203725085,1203726585,4,5,1500
76151808@N00,9109,28,1203741769,1203742669,2,5,900
76151808@N00,9109,13,1203744890,1203745130,1,5,240
76151808@N00,9110,26,1276862154,1276863054,3,8,900
76151808@N00,9110,23,1276863124,1276863724,3,8,600
76151808@N00,9110,29,1276870174,1276871074,6,8,900
76151808@N00,9110,16,1276878364,1276878634,2,8,270
76151808@N00,9110,15,1276879004,1276879274,2,8,270
76151808@N00,9110,3,1276879708,1276879798,2,8,90
76151808@N00,9110,29,1276881033,1276881933,2,8,900
76151808@N00,9110,28,1276883356,1276884256,1,8,900
76151808@N00,9111,26,1276928031,1276928163,2,6,132
76151808@N00,9111,7,1276928163,1276928343,2,6,180
76151808@N00,9111,25,1276929494,1276930240,3,6,746
76151808@N00,9111,13,1276930240,1276930480,4,6,240
76151808@N00,9111,28,1276943339,1276944239,2,6,900
76151808@N00,9111,1,1276944604,1276944664,1,6,60
76151808@N00,9112,29,1376959551,1376960451,2,4,900
76151808@N00,9112,26,1376965828,1376966728,2,4,900
76151808@N00,9112,25,1376983816,1376984656,2,4,840
76151808@N00,9112,15,1377000408,1377000678,1,4,270
76151808@N00,9113,29,1377136366,1377137266,2,3,900
76151808@N00,9113,27,1377164063,1377164963,2,3,900
76151808@N00,9113,31,1377177737,1377179237,1,3,1500
76151808@N00,9114,13,1436857599,1436857839,3,2,240
76151808@N00,9114,4,1436862858,1436862959,1,2,101
76151808@N00,9115,28,1436915630,1436916530,2,2,900
76151808@N00,9115,26,1436918995,1436919895,1,2,900
76151808@N00,9116,28,1437052126,1437053026,2,1,900
76188625@N00,9117,6,1219752670,1219752790,2,1,120
76198248@N05,9118,28,1293691988,1293692888,2,1,900
76198248@N05,9119,26,1331935892,1331936792,1,1,900
76213266@N00,9120,1,1224202010,1224202070,2,5,60
76213266@N00,9120,16,1224205677,1224205947,2,5,270
76213266@N00,9120,15,1224209724,1224209994,3,5,270
76213266@N00,9120,13,1224230589,1224230829,2,5,240
76213266@N00,9120,26,1224240121,1224241021,2,5,900
76225887@N00,9121,26,1275849056,1275849956,4,1,900
76225887@N00,9122,26,1275899555,1275900455,2,1,900
76225887@N00,9123,26,1276021806,1276022706,8,1,900
76237104@N05,9124,26,1312766171,1312767071,4,1,900
76242871@N03,9125,4,1354938799,1354938900,1,1,101
76300083@N02,9126,15,1335580556,1335580826,1,1,270
7630487@N08,9127,7,1373598104,1373598284,2,3,180
7630487@N08,9127,17,1373600532,1373600832,2,3,300
7630487@N08,9127,15,1373602885,1373603155,1,3,270
7630487@N08,9128,30,1379739906,1379740986,3,3,1080
7630487@N08,9128,18,1379743002,1379743452,2,3,450
7630487@N08,9128,28,1379743965,1379744865,1,3,900
7630487@N08,9129,30,1379830002,1379830845,3,2,843
7630487@N08,9129,29,1379830845,1379831745,1,2,900
7630487@N08,9130,26,1386725058,1386725958,2,6,900
7630487@N08,9130,20,1386731238,1386731778,3,6,540
7630487@N08,9130,21,1386737982,1386738552,2,6,570
7630487@N08,9130,29,1386742254,1386742427,2,6,173
7630487@N08,9130,30,1386742427,1386742625,2,6,198
7630487@N08,9130,18,1386742625,1386743075,1,6,450
7630487@N08,9131,30,1417073522,1417073951,2,6,429
7630487@N08,9131,19,1417073951,1417074238,2,6,287
7630487@N08,9131,30,1417074238,1417074644,2,6,406
7630487@N08,9131,25,1417074644,1417075484,3,6,840
7630487@N08,9131,17,1417075494,1417075652,2,6,158
7630487@N08,9131,20,1417075652,1417076192,2,6,540
7630487@N08,9132,3,1418641887,1418641977,1,1,90
7630487@N08,9133,28,1418746390,1418747290,1,1,900
7635377@N05,9134,22,1207318585,1207319185,1,1,600
76364672@N08,9135,28,1328765967,1328766867,1,1,900
76372974@N08,9136,13,1340019493,1340019733,2,4,240
76372974@N08,9136,30,1340019759,1340020839,2,4,1080
76372974@N08,9136,13,1340021364,1340021604,2,4,240
76372974@N08,9136,7,1340022749,1340022929,1,4,180
7642077@N04,9137,1,1370734389,1370734449,1,1,60
7642077@N04,9138,1,1370833541,1370833601,3,4,60
7642077@N04,9138,14,1370834624,1370834864,13,4,240
7642077@N04,9138,22,1370835803,1370836403,7,4,600
7642077@N04,9138,1,1370861436,1370861496,18,4,60
7642077@N04,9139,1,1370909029,1370909089,22,1,60
7642077@N04,9140,1,1370990384,1370990444,42,1,60
7642077@N04,9141,1,1372364199,1372364259,1,1,60
76425102@N00,9142,1,1364876383,1364876443,1,1,60
7642964@N03,9143,26,1241830902,1241831802,1,1,900
76459280@N06,9144,20,1375096302,1375096842,11,1,540
76500745@N03,9145,19,1340515685,1340516225,1,1,540
76508379@N07,9146,29,1342743486,1342744386,1,1,900
76508379@N07,9147,26,1342783968,1342784868,1,1,900
76619232@N00,9148,1,1362011260,1362011320,1,1,60
76619232@N00,9149,1,1362095339,1362095399,4,3,60
76619232@N00,9149,17,1362107128,1362107428,3,3,300
76619232@N00,9149,27,1362110125,1362111025,1,3,900
76665138@N00,9150,3,1240009244,1240009334,4,24,90
76665138@N00,9150,26,1240018693,1240019308,13,24,615
76665138@N00,9150,5,1240019308,1240019428,8,24,120
76665138@N00,9150,3,1240019846,1240019936,7,24,90
76665138@N00,9150,5,1240019980,1240020100,2,24,120
76665138@N00,9150,3,1240020108,1240020198,9,24,90
76665138@N00,9150,17,1240021311,1240021427,6,24,116
76665138@N00,9150,16,1240021427,1240021431,2,24,4
76665138@N00,9150,27,1240021431,1240021486,2,24,55
76665138@N00,9150,16,1240021486,1240021756,13,24,270
76665138@N00,9150,28,1240022582,1240023482,11,24,900
76665138@N00,9150,16,1240024410,1240024680,13,24,270
76665138@N00,9150,24,1240026146,1240026926,36,24,780
76665138@N00,9150,17,1240027633,1240027933,5,24,300
76665138@N00,9150,24,1240028049,1240028829,6,24,780
76665138@N00,9150,3,1240029169,1240029259,2,24,90
76665138@N00,9150,25,1240029560,1240030400,22,24,840
76665138@N00,9150,13,1240030602,1240030842,19,24,240
76665138@N00,9150,17,1240033060,1240033360,2,24,300
76665138@N00,9150,23,1240034340,1240034940,10,24,600
76665138@N00,9150,16,1240051165,1240051435,3,24,270
76665138@N00,9150,29,1240055232,1240056132,8,24,900
76665138@N00,9150,28,1240060030,1240060930,2,24,900
76665138@N00,9150,26,1240062298,1240063198,1,24,900
76665138@N00,9151,28,1240197023,1240197923,3,13,900
76665138@N00,9151,26,1240199975,1240200875,29,13,900
76665138@N00,9151,17,1240203929,1240204229,4,13,300
76665138@N00,9151,16,1240205780,1240206050,2,13,270
76665138@N00,9151,10,1240206757,1240206762,2,13,5
76665138@N00,9151,28,1240206762,1240206797,2,13,35
76665138@N00,9151,29,1240206797,1240207697,10,13,900
76665138@N00,9151,16,1240211256,1240211526,2,13,270
76665138@N00,9151,28,1240214004,1240214483,9,13,479
76665138@N00,9151,26,1240214483,1240214533,2,13,50
76665138@N00,9151,3,1240214533,1240214623,6,13,90
76665138@N00,9151,24,1240216500,1240217280,27,13,780
76665138@N00,9151,3,1240219712,1240219802,1,13,90
76665138@N00,9152,28,1240279578,1240280478,14,4,900
76665138@N00,9152,26,1240280546,1240281036,3,4,490
76665138@N00,9152,17,1240281036,1240281336,3,4,300
76665138@N00,9152,26,1240285937,1240286837,1,4,900
76701708@N00,9153,14,1418084341,1418084581,3,1,240
76749155@N06,9154,29,1373029758,1373030658,4,1,900
76749155@N06,9155,26,1373093966,1373094866,2,1,900
7677428@N07,9156,1,1380198459,1380198519,1,1,60
7680756@N08,9157,21,1228294155,1228294725,3,5,570
7680756@N08,9157,26,1228296656,1228297478,6,5,822
7680756@N08,9157,28,1228297478,1228297595,2,5,117
7680756@N08,9157,18,1228297595,1228297714,2,5,119
7680756@N08,9157,1,1228297714,1228297774,2,5,60
76825970@N02,9158,17,1394204669,1394204969,1,1,300
7682712@N04,9159,1,1366545344,1366545404,1,1,60
76830337@N07,9160,5,1368103271,1368103391,2,2,120
76830337@N07,9160,16,1368103435,1368103705,1,2,270
76944731@N00,9161,26,1306111195,1306112095,2,2,900
76944731@N00,9161,8,1306133250,1306133430,1,2,180
76944731@N00,9162,28,1325983381,1325984281,2,2,900
76944731@N00,9162,15,1325985340,1325985610,1,2,270
76944731@N00,9163,29,1353294699,1353295599,2,1,900
76944731@N00,9164,26,1471645192,1471646092,2,3,900
76944731@N00,9164,20,1471662422,1471662962,3,3,540
76944731@N00,9164,26,1471691490,1471692390,1,3,900
76959737@N00,9165,26,1325766809,1325767709,1,1,900
76959737@N00,9166,26,1329718047,1329718947,1,1,900
76959737@N00,9167,23,1340617825,1340618425,1,1,600
7702423@N04,9168,16,1342057517,1342057787,182,1,270
77084926@N06,9169,27,1379363149,1379364049,1,1,900
77108445@N00,9170,26,1264845336,1264846236,1,1,900
77120147@N06,9171,30,1319834819,1319835899,1,1,1080
77120147@N06,9172,28,1324895965,1324896865,1,1,900
77120147@N06,9173,28,1326433305,1326434205,2,3,900
77120147@N06,9173,23,1326440662,1326441262,2,3,600
77120147@N06,9173,6,1326442408,1326442528,1,3,120
77120147@N06,9174,30,1327151272,1327152352,1,1,1080
77120147@N06,9175,13,1327889565,1327889805,3,3,240
77120147@N06,9175,20,1327892806,1327893265,3,3,459
77120147@N06,9175,19,1327893265,1327893805,1,3,540
77120147@N06,9176,28,1328856722,1328857622,2,2,900
77120147@N06,9176,10,1328858577,1328858817,1,2,240
77120147@N06,9177,20,1330144366,1330144906,2,6,540
77120147@N06,9177,26,1330145851,1330146214,3,6,363
77120147@N06,9177,8,1330146214,1330146394,3,6,180
77120147@N06,9177,5,1330146427,1330146547,2,6,120
77120147@N06,9177,15,1330149199,1330149469,3,6,270
77120147@N06,9177,18,1330171541,1330171991,1,6,450
77120147@N06,9178,26,1331244182,1331245082,4,9,900
77120147@N06,9178,29,1331246624,1331247094,2,9,470
77120147@N06,9178,20,1331247094,1331247634,7,9,540
77120147@N06,9178,22,1331248957,1331249557,2,9,600
77120147@N06,9178,29,1331250103,1331251003,2,9,900
77120147@N06,9178,11,1331251784,1331252024,2,9,240
77120147@N06,9178,3,1331252435,1331252525,2,9,90
77120147@N06,9178,26,1331255703,1331256603,2,9,900
77120147@N06,9178,1,1331257438,1331257498,1,9,60
77120147@N06,9179,20,1331369692,1331370232,2,1,540
77120147@N06,9180,26,1332284507,1332285407,3,4,900
77120147@N06,9180,22,1332287572,1332288172,2,4,600
77120147@N06,9180,30,1332288376,1332289456,2,4,1080
77120147@N06,9180,28,1332290766,1332291666,2,4,900
77120147@N06,9181,12,1332579400,1332579640,1,1,240
77120147@N06,9182,28,1333408317,1333409217,1,1,900
77120147@N06,9183,16,1333633170,1333633440,1,1,270
77120147@N06,9184,26,1334384493,1334385393,2,4,900
77120147@N06,9184,20,1334392277,1334392817,2,4,540
77120147@N06,9184,12,1334395413,1334395653,2,4,240
77120147@N06,9184,15,1334396013,1334396283,3,4,270
77120147@N06,9185,20,1336405884,1336406424,2,2,540
77120147@N06,9185,26,1336410363,1336411263,1,2,900
77120147@N06,9186,26,1336605659,1336606559,2,8,900
77120147@N06,9186,22,1336607728,1336608328,2,8,600
77120147@N06,9186,23,1336609022,1336609389,4,8,367
77120147@N06,9186,26,1336609389,1336609976,4,8,587
77120147@N06,9186,16,1336609976,1336610151,2,8,175
77120147@N06,9186,12,1336610151,1336610391,3,8,240
77120147@N06,9186,15,1336611107,1336611377,2,8,270
77120147@N06,9186,1,1336612076,1336612136,1,8,60
77120147@N06,9187,18,1338024938,1338025388,2,3,450
77120147@N06,9187,5,1338039852,1338039972,2,3,120
77120147@N06,9187,26,1338041286,1338042186,1,3,900
77120147@N06,9188,10,1340431273,1340431513,1,1,240
77120147@N06,9189,26,1340917826,1340918068,2,6,242
77120147@N06,9189,5,1340918068,1340918188,2,6,120
77120147@N06,9189,12,1340919489,1340919729,2,6,240
77120147@N06,9189,30,1340921107,1340921636,3,6,529
77120147@N06,9189,22,1340921636,1340922236,5,6,600
77120147@N06,9189,1,1340924489,1340924549,2,6,60
77120147@N06,9190,20,1341315117,1341315657,1,1,540
77120147@N06,9191,26,1343521504,1343522404,1,1,900
77154962@N00,9192,1,1274053071,1274053131,2,4,60
77154962@N00,9192,28,1274053497,1274054397,2,4,900
77154962@N00,9192,26,1274055237,1274056137,2,4,900
77154962@N00,9192,1,1274064716,1274064776,1,4,60
77154962@N00,9193,1,1274094610,1274094670,2,4,60
77154962@N00,9193,17,1274096927,1274097227,2,4,300
77154962@N00,9193,12,1274099842,1274100082,2,4,240
77154962@N00,9193,26,1274100180,1274101080,1,4,900
77154962@N00,9194,20,1274225321,1274225861,2,5,540
77154962@N00,9194,25,1274231552,1274232392,2,5,840
77154962@N00,9194,26,1274232983,1274233883,2,5,900
77154962@N00,9194,5,1274239427,1274239547,2,5,120
77154962@N00,9194,7,1274247697,1274247877,2,5,180
77179348@N00,9195,14,1340234474,1340234714,2,50,240
77179348@N00,9195,1,1340237640,1340237700,6,50,60
77179348@N00,9195,28,1340237853,1340238613,5,50,760
77179348@N00,9195,26,1340238613,1340239513,5,50,900
77179348@N00,9195,24,1340241331,1340241370,3,50,39
77179348@N00,9195,12,1340241370,1340241610,4,50,240
77179348@N00,9195,21,1340241638,1340242208,4,50,570
77179348@N00,9195,29,1340242998,1340243312,3,50,314
77179348@N00,9195,31,1340243312,1340243537,4,50,225
77179348@N00,9195,22,1340243537,1340243626,3,50,89
77179348@N00,9195,20,1340243626,1340244166,8,50,540
77179348@N00,9195,29,1340244653,1340245196,9,50,543
77179348@N00,9195,19,1340245196,1340245252,2,50,56
77179348@N00,9195,29,1340245252,1340245391,2,50,139
77179348@N00,9195,30,1340245391,1340245735,3,50,344
77179348@N00,9195,27,1340245735,1340245900,2,50,165
77179348@N00,9195,29,1340245900,1340246800,9,50,900
77179348@N00,9195,22,1340246988,1340247012,2,50,24
77179348@N00,9195,14,1340247012,1340247252,5,50,240
77179348@N00,9195,20,1340247948,1340248018,5,50,70
77179348@N00,9195,14,1340248018,1340248258,5,50,240
77179348@N00,9195,22,1340248410,1340248593,2,50,183
77179348@N00,9195,14,1340248593,1340248598,2,50,5
77179348@N00,9195,22,1340248598,1340248618,3,50,20
77179348@N00,9195,14,1340248618,1340248688,7,50,70
77179348@N00,9195,22,1340248688,1340248724,6,50,36
77179348@N00,9195,14,1340248724,1340248964,6,50,240
77179348@N00,9195,22,1340249052,1340249652,8,50,600
77179348@N00,9195,29,1340251779,1340252106,3,50,327
77179348@N00,9195,30,1340252106,1340253186,9,50,1080
77179348@N00,9195,19,1340253424,1340253593,4,50,169
77179348@N00,9195,18,1340253593,1340253926,5,50,333
77179348@N00,9195,19,1340253926,1340254466,9,50,540
77179348@N00,9195,29,1340255031,1340255697,3,50,666
77179348@N00,9195,19,1340255697,1340256237,7,50,540
77179348@N00,9195,18,1340257001,1340257451,12,50,450
77179348@N00,9195,19,1340257949,1340257984,3,50,35
77179348@N00,9195,29,1340257984,1340258057,6,50,73
77179348@N00,9195,19,1340258057,1340258088,4,50,31
77179348@N00,9195,18,1340258088,1340258115,3,50,27
77179348@N00,9195,19,1340258115,1340258323,7,50,208
77179348@N00,9195,18,1340258323,1340258696,5,50,373
77179348@N00,9195,26,1340258696,1340258706,2,50,10
77179348@N00,9195,16,1340258706,1340258976,17,50,270
77179348@N00,9195,15,1340260905,1340261175,12,50,270
77179348@N00,9195,17,1340261671,1340261971,12,50,300
77179348@N00,9195,24,1340263108,1340263888,14,50,780
77179348@N00,9195,12,1340265262,1340265348,10,50,86
77179348@N00,9195,24,1340265348,1340266128,35,50,780
77179348@N00,9195,15,1340267004,1340267274,1,50,270
77179348@N00,9196,1,1344648943,1344649003,3,34,60
77179348@N00,9196,23,1344649247,1344649847,4,34,600
77179348@N00,9196,18,1344650002,1344650452,10,34,450
77179348@N00,9196,23,1344653939,1344654276,2,34,337
77179348@N00,9196,18,1344654276,1344654726,2,34,450
77179348@N00,9196,19,1344655034,1344655143,2,34,109
77179348@N00,9196,18,1344655143,1344655450,5,34,307
77179348@N00,9196,19,1344655450,1344655876,8,34,426
77179348@N00,9196,30,1344655876,1344656250,2,34,374
77179348@N00,9196,23,1344656250,1344656850,2,34,600
77179348@N00,9196,30,1344657654,1344658734,4,34,1080
77179348@N00,9196,22,1344658798,1344659398,5,34,600
77179348@N00,9196,14,1344659711,1344659951,2,34,240
77179348@N00,9196,22,1344660499,1344660512,3,34,13
77179348@N00,9196,14,1344660512,1344660752,3,34,240
77179348@N00,9196,22,1344660775,1344660853,12,34,78
77179348@N00,9196,14,1344660853,1344661093,6,34,240
77179348@N00,9196,23,1344664304,1344664774,3,34,470
77179348@N00,9196,29,1344664774,1344665166,2,34,392
77179348@N00,9196,31,1344665166,1344665171,2,34,5
77179348@N00,9196,30,1344665171,1344665181,2,34,10
77179348@N00,9196,31,1344665181,1344666681,10,34,1500
77179348@N00,9196,29,1344666923,1344667823,3,34,900
77179348@N00,9196,20,1344668128,1344668668,3,34,540
77179348@N00,9196,29,1344669596,1344670496,2,34,900
77179348@N00,9196,30,1344671299,1344672379,12,34,1080
77179348@N00,9196,24,1344677594,1344678374,10,34,780
77179348@N00,9196,12,1344682982,1344683222,3,34,240
77179348@N00,9196,16,1344684337,1344684607,59,34,270
77179348@N00,9196,15,1344686618,1344686888,2,34,270
77179348@N00,9196,29,1344688405,1344689305,36,34,900
77179348@N00,9196,24,1344692672,1344692869,4,34,197
77179348@N00,9196,15,1344692869,1344693139,3,34,270
77179348@N00,9196,17,1344693244,1344693544,1,34,300
77179348@N00,9197,1,1344737772,1344737832,2,15,60
77179348@N00,9197,20,1344738061,1344738265,2,15,204
77179348@N00,9197,22,1344738265,1344738470,4,15,205
77179348@N00,9197,13,1344738470,1344738710,4,15,240
77179348@N00,9197,21,1344739324,1344739486,3,15,162
77179348@N00,9197,4,1344739486,1344739514,6,15,28
77179348@N00,9197,11,1344739514,1344739667,8,15,153
77179348@N00,9197,4,1344739667,1344739711,5,15,44
77179348@N00,9197,21,1344739711,1344740281,6,15,570
77179348@N00,9197,15,1344740753,1344741023,19,15,270
77179348@N00,9197,17,1344741271,1344741341,3,15,70
77179348@N00,9197,15,1344741341,1344741611,13,15,270
77179348@N00,9197,17,1344742546,1344742634,4,15,88
77179348@N00,9197,1,1344742634,1344742694,21,15,60
77179348@N00,9197,28,1344743376,1344744276,2,15,900
77179348@N00,9198,12,1405763194,1405763434,6,1,240
77179348@N00,9199,27,1405836904,1405837804,3,1,900
77187971@N00,9200,28,1350993929,1350994829,1,1,900
77194376@N05,9201,26,1376394236,1376395136,1,1,900
77197718@N06,9202,30,1374897827,1374898907,1,1,1080
77217620@N08,9203,26,1329828775,1329829675,1,1,900
77217620@N08,9204,28,1330857516,1330858416,1,1,900
77217620@N08,9205,18,1332066461,1332066911,1,1,450
77217620@N08,9206,28,1332302354,1332303254,1,1,900
77217620@N08,9207,28,1333357697,1333358597,1,1,900
77217620@N08,9208,28,1333517279,1333518179,2,1,900
77217620@N08,9209,18,1333614092,1333614542,1,1,450
77217620@N08,9210,26,1333774535,1333775435,1,1,900
77217620@N08,9211,28,1333852684,1333853584,1,1,900
77217620@N08,9212,28,1334203253,1334204153,1,1,900
77217620@N08,9213,28,1334820991,1334821891,1,1,900
77217620@N08,9214,28,1338367305,1338368205,2,2,900
77217620@N08,9214,18,1338380219,1338380669,1,2,450
77217620@N08,9215,29,1338955883,1338956506,2,3,623
77217620@N08,9215,26,1338956506,1338956920,2,3,414
77217620@N08,9215,12,1338956920,1338957160,1,3,240
77217620@N08,9216,28,1339581095,1339581995,1,1,900
77217620@N08,9217,28,1340776374,1340777274,1,1,900
77217620@N08,9218,23,1340849692,1340850189,2,2,497
77217620@N08,9218,22,1340850189,1340850789,3,2,600
77217620@N08,9219,28,1342477663,1342478563,1,1,900
77237839@N07,9220,29,1393735817,1393736717,2,4,900
77237839@N07,9220,23,1393739310,1393739910,7,4,600
77237839@N07,9220,29,1393749222,1393749226,2,4,4
77237839@N07,9220,28,1393749226,1393750126,4,4,900
77249045@N07,9221,27,1314945399,1314946299,2,2,900
77249045@N07,9221,28,1314953350,1314954250,3,2,900
77249045@N07,9222,1,1316125033,1316125093,3,4,60
77249045@N07,9222,21,1316130409,1316130979,3,4,570
77249045@N07,9222,16,1316134999,1316135269,7,4,270
77249045@N07,9222,28,1316135568,1316136468,1,4,900
77249045@N07,9223,21,1317955217,1317955787,7,5,570
77249045@N07,9223,23,1317958418,1317959018,2,5,600
77249045@N07,9223,28,1317961314,1317961517,4,5,203
77249045@N07,9223,26,1317961517,1317961637,2,5,120
77249045@N07,9223,28,1317961637,1317962537,6,5,900
77249045@N07,9224,21,1318415680,1318416250,10,8,570
77249045@N07,9224,3,1318417804,1318417894,3,8,90
77249045@N07,9224,28,1318419726,1318420200,4,8,474
77249045@N07,9224,1,1318420200,1318420260,2,8,60
77249045@N07,9224,28,1318421760,1318422485,2,8,725
77249045@N07,9224,1,1318422485,1318422545,2,8,60
77249045@N07,9224,26,1318423493,1318423938,2,8,445
77249045@N07,9224,28,1318423938,1318424838,1,8,900
77249045@N07,9225,21,1319356314,1319356884,4,3,570
77249045@N07,9225,28,1319358072,1319358972,2,3,900
77249045@N07,9225,20,1319366318,1319366858,1,3,540
77249045@N07,9226,26,1320366678,1320367578,2,3,900
77249045@N07,9226,16,1320368112,1320368382,5,3,270
77249045@N07,9226,20,1320378439,1320378979,5,3,540
77249045@N07,9227,27,1321760144,1321761044,2,2,900
77249045@N07,9227,26,1321776842,1321777742,6,2,900
77249045@N07,9228,28,1323392773,1323393026,4,5,253
77249045@N07,9228,18,1323393026,1323393184,2,5,158
77249045@N07,9228,28,1323393184,1323394084,2,5,900
77249045@N07,9228,21,1323405661,1323406231,9,5,570
77249045@N07,9228,13,1323406782,1323407022,1,5,240
77249045@N07,9229,22,1324184321,1324184921,3,1,600
77249045@N07,9230,24,1325818312,1325819092,7,4,780
77249045@N07,9230,26,1325819151,1325820051,6,4,900
77249045@N07,9230,1,1325826360,1325826420,2,4,60
77249045@N07,9230,28,1325826554,1325827454,2,4,900
77249045@N07,9231,16,1325867948,1325868218,1,1,270
77249045@N07,9232,26,1325925821,1325926721,1,1,900
77249045@N07,9233,16,1326329454,1326329724,3,4,270
77249045@N07,9233,26,1326329956,1326330856,2,4,900
77249045@N07,9233,24,1326332822,1326333602,22,4,780
77249045@N07,9233,16,1326336580,1326336850,1,4,270
77249045@N07,9234,24,1326433565,1326434345,16,1,780
77249045@N07,9235,26,1328420893,1328421793,2,3,900
77249045@N07,9235,5,1328422553,1328422673,4,3,120
77249045@N07,9235,1,1328424306,1328424366,7,3,60
77249045@N07,9236,25,1328937869,1328938709,22,4,840
77249045@N07,9236,24,1328942238,1328943018,6,4,780
77249045@N07,9236,30,1328968141,1328969106,2,4,965
77249045@N07,9236,5,1328969106,1328969226,3,4,120
77249045@N07,9237,6,1330465218,1330465305,2,11,87
77249045@N07,9237,16,1330465305,1330465502,2,11,197
77249045@N07,9237,26,1330465502,1330466050,4,11,548
77249045@N07,9237,13,1330466050,1330466290,2,11,240
77249045@N07,9237,28,1330469353,1330470253,3,11,900
77249045@N07,9237,1,1330471577,1330471637,5,11,60
77249045@N07,9237,24,1330483877,1330484657,19,11,780
77249045@N07,9237,26,1330484899,1330485799,7,11,900
77249045@N07,9237,1,1330491550,1330491610,6,11,60
77249045@N07,9237,23,1330507565,1330508165,2,11,600
77249045@N07,9237,26,1330513876,1330514776,2,11,900
77249045@N07,9238,21,1331348921,1331349491,6,6,570
77249045@N07,9238,23,1331352280,1331352880,2,6,600
77249045@N07,9238,29,1331354031,1331354931,13,6,900
77249045@N07,9238,25,1331359264,1331360104,17,6,840
77249045@N07,9238,20,1331377932,1331378472,2,6,540
77249045@N07,9238,28,1331381629,1331382529,2,6,900
77249045@N07,9239,26,1332484149,1332485049,2,2,900
77249045@N07,9239,31,1332501979,1332503479,21,2,1500
77249045@N07,9240,28,1334902792,1334903692,2,3,900
77249045@N07,9240,1,1334907944,1334908004,2,3,60
77249045@N07,9240,31,1334925367,1334926867,2,3,1500
77249045@N07,9241,28,1338538404,1338539304,1,1,900
77249045@N07,9242,28,1344315764,1344316664,3,1,900
77249045@N07,9243,24,1346287290,1346288070,5,4,780
77249045@N07,9243,3,1346293414,1346293504,2,4,90
77249045@N07,9243,28,1346297393,1346298293,2,4,900
77249045@N07,9243,26,1346310547,1346311447,1,4,900
77249045@N07,9244,20,1348809381,1348809921,3,4,540
77249045@N07,9244,16,1348813906,1348814176,3,4,270
77249045@N07,9244,9,1348817490,1348817670,3,4,180
77249045@N07,9244,21,1348818708,1348819278,7,4,570
77249045@N07,9245,21,1354597431,1354597575,3,9,144
77249045@N07,9245,26,1354597575,1354597608,2,9,33
77249045@N07,9245,21,1354597608,1354597621,2,9,13
77249045@N07,9245,26,1354597621,1354598134,2,9,513
77249045@N07,9245,16,1354598134,1354598404,4,9,270
77249045@N07,9245,28,1354606367,1354606581,2,9,214
77249045@N07,9245,1,1354606581,1354606641,2,9,60
77249045@N07,9245,28,1354606811,1354606953,2,9,142
77249045@N07,9245,1,1354606953,1354607013,6,9,60
77249045@N07,9246,28,1355713676,1355714576,17,2,900
77249045@N07,9246,29,1355722540,1355723440,2,2,900
77249045@N07,9247,1,1357864506,1357864566,3,10,60
77249045@N07,9247,21,1357866149,1357866279,3,10,130
77249045@N07,9247,25,1357866279,1357866717,3,10,438
77249045@N07,9247,3,1357866717,1357866807,2,10,90
77249045@N07,9247,16,1357867424,1357867694,2,10,270
77249045@N07,9247,26,1357867805,1357867960,7,10,155
77249045@N07,9247,21,1357867960,1357868530,2,10,570
77249045@N07,9247,24,1357868931,1357869711,5,10,780
77249045@N07,9247,25,1357884139,1357884979,12,10,840
77249045@N07,9247,21,1357886169,1357886739,1,10,570
77249045@N07,9248,25,1358044637,1358045477,1,1,840
7730953@N08,9249,17,1399440128,1399440428,2,1,300
7730953@N08,9250,28,1418119333,1418120233,1,1,900
7730953@N08,9251,26,1418158530,1418158531,2,8,1
7730953@N08,9251,13,1418158531,1418158531,2,8,0
7730953@N08,9251,20,1418158531,1418158531,2,8,0
7730953@N08,9251,29,1418158531,1418158532,2,8,1
7730953@N08,9251,18,1418158532,1418158532,3,8,0
7730953@N08,9251,31,1418158532,1418158533,2,8,1
7730953@N08,9251,28,1418158533,1418158533,2,8,0
7730953@N08,9251,29,1418158533,1418159433,1,8,900
7730953@N08,9252,7,1445910491,1445910671,2,4,180
7730953@N08,9252,24,1445915479,1445915551,3,4,72
7730953@N08,9252,12,1445915551,1445915791,2,4,240
7730953@N08,9252,15,1445919345,1445919615,1,4,270
7732814@N08,9253,26,1304156457,1304157357,1,1,900
7732814@N08,9254,28,1323783376,1323784276,1,1,900
77339363@N00,9255,26,1314861222,1314862122,1,1,900
77403773@N08,9256,21,1333159141,1333159711,2,1,570
77403773@N08,9257,16,1333661743,1333662013,1,1,270
77439734@N00,9258,1,1246768794,1246768854,23,10,60
77439734@N00,9258,28,1246769148,1246769346,9,10,198
77439734@N00,9258,16,1246769346,1246769616,12,10,270
77439734@N00,9258,27,1246769654,1246770554,2,10,900
77439734@N00,9258,15,1246772078,1246772220,4,10,142
77439734@N00,9258,24,1246772220,1246772364,2,10,144
77439734@N00,9258,27,1246772364,1246772654,2,10,290
77439734@N00,9258,24,1246772654,1246773434,34,10,780
77439734@N00,9258,26,1246775370,1246776112,6,10,742
77439734@N00,9258,28,1246776112,1246777012,7,10,900
77466107@N00,9259,21,1353136411,1353136981,2,2,570
77466107@N00,9259,7,1353137942,1353138122,1,2,180
7751128@N02,9260,26,1219550755,1219551655,23,1,900
7751128@N02,9261,26,1236296937,1236297837,37,1,900
7751128@N02,9262,26,1258869406,1258870306,6,1,900
77526212@N08,9263,1,1379746299,1379746359,12,1,60
7756282@N04,9264,1,1192176892,1192176952,52,1,60
7756282@N04,9265,1,1192701693,1192701753,1,1,60
7756282@N04,9266,1,1193557437,1193557497,1,1,60
77586464@N08,9267,28,1334659140,1334660040,1,1,900
77586464@N08,9268,8,1335005509,1335005689,1,1,180
7771611@N06,9269,29,1317827642,1317827945,2,6,303
7771611@N06,9269,23,1317827945,1317828545,2,6,600
7771611@N06,9269,28,1317830051,1317830257,2,6,206
7771611@N06,9269,29,1317830257,1317830525,2,6,268
7771611@N06,9269,28,1317830525,1317830683,2,6,158
7771611@N06,9269,23,1317830683,1317831283,1,6,600
7771611@N06,9270,29,1317903048,1317903948,2,3,900
7771611@N06,9270,1,1317919172,1317919232,2,3,60
7771611@N06,9270,28,1317919491,1317920391,1,3,900
7771611@N06,9271,1,1317982905,1317982965,1,1,60
7772341@N06,9272,16,1358684661,1358684931,1,1,270
77723504@N00,9273,28,1289002339,1289003239,2,4,900
77723504@N00,9273,30,1289005370,1289006450,2,4,1080
77723504@N00,9273,5,1289017315,1289017435,2,4,120
77723504@N00,9273,13,1289019971,1289020211,1,4,240
77736600@N00,9274,6,1248171052,1248171172,1,1,120
77736600@N00,9275,26,1292387838,1292388738,1,1,900
77796709@N06,9276,28,1333798594,1333799494,1,1,900
77796709@N06,9277,1,1345123624,1345123684,1,1,60
7784816@N03,9278,22,1334456745,1334456864,2,2,119
7784816@N03,9278,27,1334456864,1334457764,1,2,900
7784816@N03,9279,27,1334640746,1334641646,1,1,900
7787707@N04,9280,19,1413255071,1413255611,1,1,540
77893517@N02,9281,18,1459388703,1459389153,2,1,450
77893517@N02,9282,18,1459420520,1459420970,3,1,450
77906206@N00,9283,1,1206662720,1206662780,5,1,60
77906206@N00,9284,26,1206741873,1206742247,2,2,374
77906206@N00,9284,30,1206742247,1206743327,2,2,1080
77906206@N00,9285,1,1206832441,1206832501,2,4,60
77906206@N00,9285,29,1206833285,1206834185,9,4,900
77906206@N00,9285,22,1206837011,1206837611,19,4,600
77906206@N00,9285,30,1206841561,1206842641,5,4,1080
77906206@N00,9286,26,1295922524,1295923424,1,1,900
7793758@N06,9287,26,1246235177,1246236077,8,1,900
7793758@N06,9288,26,1246307736,1246308636,4,1,900
7793758@N06,9289,26,1246348251,1246349151,11,1,900
7793758@N06,9290,26,1246400207,1246401107,4,1,900
7793758@N06,9291,26,1246487197,1246488097,3,1,900
7793758@N06,9292,26,1246573837,1246574737,9,1,900
7794405@N05,9293,30,1329074544,1329075624,1,1,1080
7794405@N05,9294,4,1331078541,1331078642,2,2,101
7794405@N05,9294,26,1331097151,1331098051,2,2,900
77945684@N00,9295,1,1190331196,1190331256,3,29,60
77945684@N00,9295,18,1190332219,1190332669,3,29,450
77945684@N00,9295,20,1190337701,1190338241,2,29,540
77945684@N00,9295,30,1190340154,1190341234,3,29,1080
77945684@N00,9295,22,1190343184,1190343784,2,29,600
77945684@N00,9295,26,1190345935,1190345963,2,29,28
77945684@N00,9295,16,1190345963,1190346233,2,29,270
77945684@N00,9295,17,1190347061,1190347361,3,29,300
77945684@N00,9295,15,1190348391,1190348653,2,29,262
77945684@N00,9295,24,1190348653,1190349433,2,29,780
77945684@N00,9295,12,1190352158,1190352398,2,29,240
77945684@N00,9295,24,1190352475,1190352975,2,29,500
77945684@N00,9295,12,1190352975,1190353215,2,29,240
77945684@N00,9295,21,1190353406,1190353976,3,29,570
77945684@N00,9295,28,1190356316,1190357216,3,29,900
77945684@N00,9295,18,1190357778,1190358228,2,29,450
77945684@N00,9295,10,1190358710,1190358950,2,29,240
77945684@N00,9295,25,1190360339,1190361179,3,29,840
77945684@N00,9295,7,1190363184,1190363364,2,29,180
77945684@N00,9295,4,1190364125,1190364226,2,29,101
77945684@N00,9295,3,1190364617,1190364707,2,29,90
77945684@N00,9295,28,1190364968,1190365511,4,29,543
77945684@N00,9295,12,1190365511,1190365751,2,29,240
77945684@N00,9295,3,1190365783,1190365873,2,29,90
77945684@N00,9295,26,1190366162,1190367062,2,29,900
77945684@N00,9295,5,1190367584,1190367704,2,29,120
77945684@N00,9295,26,1190374230,1190375130,8,29,900
77945684@N00,9295,17,1190375500,1190375800,3,29,300
77945684@N00,9295,16,1190378184,1190378454,2,29,270
77953371@N03,9296,18,1398227925,1398228375,1,1,450
77967578@N00,9297,26,1198769241,1198770141,2,7,900
77967578@N00,9297,1,1198777755,1198777815,2,7,60
77967578@N00,9297,18,1198780589,1198781039,3,7,450
77967578@N00,9297,24,1198784822,1198785602,2,7,780
77967578@N00,9297,20,1198786545,1198787085,5,7,540
77967578@N00,9297,26,1198792723,1198793623,2,7,900
77967578@N00,9297,20,1198797240,1198797780,1,7,540
77967578@N00,9298,28,1213608459,1213609359,1,1,900
77967578@N00,9299,20,1213649361,1213649901,3,5,540
77967578@N00,9299,26,1213650514,1213651222,2,5,708
77967578@N00,9299,17,1213651222,1213651522,5,5,300
77967578@N00,9299,16,1213652606,1213652876,5,5,270
77967578@N00,9299,28,1213653729,1213654629,2,5,900
77967578@N00,9300,20,1214075160,1214075700,2,5,540
77967578@N00,9300,27,1214080456,1214081356,2,5,900
77967578@N00,9300,16,1214081365,1214081635,2,5,270
77967578@N00,9300,26,1214083613,1214084513,2,5,900
77967578@N00,9300,18,1214086498,1214086948,2,5,450
77967578@N00,9301,24,1215081567,1215082347,2,5,780
77967578@N00,9301,3,1215098556,1215098646,2,5,90
77967578@N00,9301,26,1215100380,1215101280,2,5,900
77967578@N00,9301,22,1215109827,1215110427,2,5,600
77967578@N00,9301,18,1215124065,1215124515,2,5,450
77967578@N00,9302,20,1230387187,1230387727,3,3,540
77967578@N00,9302,26,1230393411,1230394311,2,3,900
77967578@N00,9302,20,1230412862,1230413402,1,3,540
77967578@N00,9303,3,1252623312,1252623402,2,2,90
77967578@N00,9303,26,1252634883,1252635783,1,2,900
77967578@N00,9304,26,1257883775,1257884675,1,1,900
78013771@N00,9305,30,1352315577,1352316657,2,1,1080
78013771@N00,9306,30,1352604496,1352605576,3,3,1080
78013771@N00,9306,19,1352629875,1352630415,2,3,540
78013771@N00,9306,30,1352631442,1352632522,2,3,1080
78013771@N00,9307,30,1352686438,1352687518,2,2,1080
78013771@N00,9307,13,1352707601,1352707841,3,2,240
78013771@N00,9308,13,1352760469,1352760709,2,6,240
78013771@N00,9308,11,1352761102,1352761342,3,6,240
78013771@N00,9308,13,1352762589,1352762829,3,6,240
78013771@N00,9308,30,1352766658,1352767738,2,6,1080
78013771@N00,9308,29,1352768624,1352769524,2,6,900
78013771@N00,9308,30,1352774066,1352775146,1,6,1080
78013771@N00,9309,30,1352931941,1352932143,3,8,202
78013771@N00,9309,28,1352932143,1352933043,3,8,900
78013771@N00,9309,21,1352933988,1352934558,2,8,570
78013771@N00,9309,7,1352935080,1352935181,3,8,101
78013771@N00,9309,6,1352935181,1352935301,2,8,120
78013771@N00,9309,26,1352935690,1352935873,3,8,183
78013771@N00,9309,16,1352935873,1352936143,3,8,270
78013771@N00,9309,14,1352938247,1352938487,17,8,240
78013771@N00,9310,30,1353037954,1353039034,1,1,1080
78025158@N00,9311,27,1238117433,1238118333,1,1,900
78025158@N00,9312,28,1238156928,1238157828,13,1,900
78025158@N00,9313,27,1238668200,1238669100,1,1,900
78025158@N00,9314,27,1238759100,1238760000,1,1,900
78025158@N00,9315,21,1240480506,1240481076,3,2,570
78025158@N00,9315,27,1240486200,1240487100,2,2,900
78025158@N00,9316,28,1240573539,1240574439,3,1,900
78025158@N00,9317,20,1242556745,1242557285,5,2,540
78025158@N00,9317,17,1242564309,1242564609,1,2,300
78025158@N00,9318,27,1244464680,1244465580,1,1,900
78025158@N00,9319,24,1246859025,1246859805,2,3,780
78025158@N00,9319,4,1246861307,1246861408,2,3,101
78025158@N00,9319,13,1246865841,1246866081,1,3,240
78025158@N00,9320,27,1249910100,1249911000,2,2,900
78025158@N00,9320,28,1249912691,1249913591,1,2,900
78025158@N00,9321,16,1249990478,1249990748,2,2,270
78025158@N00,9321,27,1249995360,1249996260,1,2,900
78025158@N00,9322,27,1250171160,1250172060,1,1,900
78025158@N00,9323,20,1250908272,1250908812,6,1,540
78025158@N00,9324,12,1255513200,1255513440,1,1,240
78025158@N00,9325,27,1255677195,1255678095,1,1,900
78025158@N00,9326,27,1257582660,1257583560,1,1,900
78025158@N00,9327,11,1260531698,1260531938,2,4,240
78025158@N00,9327,27,1260534360,1260535260,3,4,900
78025158@N00,9327,17,1260536490,1260536790,2,4,300
78025158@N00,9327,28,1260537137,1260538037,9,4,900
78025158@N00,9328,3,1261396955,1261397045,2,2,90
78025158@N00,9328,27,1261398540,1261399440,2,2,900
78025158@N00,9329,12,1267961640,1267961880,1,1,240
78025158@N00,9330,12,1285327252,1285327492,1,1,240
78025158@N00,9331,12,1288959000,1288959240,2,1,240
78025158@N00,9332,28,1296983696,1296984596,1,1,900
78025158@N00,9333,28,1325340877,1325341777,1,1,900
78025158@N00,9334,26,1357448400,1357449300,1,1,900
78027754@N00,9335,29,1437916497,1437917397,36,1,900
78027754@N00,9336,28,1462719004,1462719904,130,1,900
78091495@N02,9337,16,1279577844,1279578114,2,27,270
78091495@N02,9337,14,1279578176,1279578416,2,27,240
78091495@N02,9337,24,1279581035,1279581815,11,27,780
78091495@N02,9337,16,1279585953,1279586047,4,27,94
78091495@N02,9337,28,1279586047,1279586048,2,27,1
78091495@N02,9337,16,1279586048,1279586053,3,27,5
78091495@N02,9337,27,1279586053,1279586230,5,27,177
78091495@N02,9337,28,1279586230,1279586540,3,27,310
78091495@N02,9337,27,1279586540,1279586682,2,27,142
78091495@N02,9337,28,1279586682,1279587582,4,27,900
78091495@N02,9337,3,1279595257,1279595347,2,27,90
78091495@N02,9337,13,1279595718,1279595773,2,27,55
78091495@N02,9337,14,1279595773,1279595834,2,27,61
78091495@N02,9337,13,1279595834,1279596074,9,27,240
78091495@N02,9337,7,1279596694,1279596874,2,27,180
78091495@N02,9337,14,1279596878,1279597118,4,27,240
78091495@N02,9337,19,1279601172,1279601712,5,27,540
78091495@N02,9337,30,1279603784,1279604864,4,27,1080
78091495@N02,9337,28,1279614825,1279615725,2,27,900
78091495@N02,9337,16,1279624824,1279625094,6,27,270
78091495@N02,9337,26,1279625478,1279625758,2,27,280
78091495@N02,9337,28,1279625758,1279625812,2,27,54
78091495@N02,9337,26,1279625812,1279626712,3,27,900
78091495@N02,9337,30,1279629732,1279630318,2,27,586
78091495@N02,9337,26,1279630318,1279630683,3,27,365
78091495@N02,9337,3,1279630683,1279630773,3,27,90
78091495@N02,9337,1,1279632378,1279632438,5,27,60
78097662@N00,9338,28,1243117863,1243118763,4,8,900
78097662@N00,9338,24,1243119975,1243120755,4,8,780
78097662@N00,9338,4,1243121973,1243122074,5,8,101
78097662@N00,9338,11,1243124172,1243124412,2,8,240
78097662@N00,9338,29,1243127091,1243127991,2,8,900
78097662@N00,9338,4,1243131903,1243132004,3,8,101
78097662@N00,9338,13,1243132130,1243132370,4,8,240
78097662@N00,9338,25,1243136564,1243137404,2,8,840
78137955@N00,9339,24,1324765861,1324766008,2,7,147
78137955@N00,9339,15,1324766008,1324766278,2,7,270
78137955@N00,9339,28,1324766536,1324766806,2,7,270
78137955@N00,9339,1,1324766806,1324766866,3,7,60
78137955@N00,9339,26,1324768583,1324769483,2,7,900
78137955@N00,9339,21,1324769557,1324769935,2,7,378
78137955@N00,9339,3,1324769935,1324770025,2,7,90
78137955@N00,9340,31,1324851920,1324852852,5,4,932
78137955@N00,9340,20,1324852852,1324853391,3,4,539
78137955@N00,9340,25,1324853391,1324854231,15,4,840
78137955@N00,9340,13,1324855273,1324855513,8,4,240
78175333@N00,9341,1,1238364009,1238364069,2,10,60
78175333@N00,9341,28,1238364561,1238365084,2,10,523
78175333@N00,9341,26,1238365084,1238365968,3,10,884
78175333@N00,9341,7,1238365968,1238366148,6,10,180
78175333@N00,9341,13,1238368438,1238368678,3,10,240
78175333@N00,9341,24,1238373506,1238374286,2,10,780
78175333@N00,9341,18,1238380085,1238380535,3,10,450
78175333@N00,9341,27,1238384845,1238385745,2,10,900
78175333@N00,9341,15,1238386722,1238386992,2,10,270
78175333@N00,9341,17,1238388077,1238388377,2,10,300
7827476@N06,9342,23,1375071960,1375072560,1,1,600
78309767@N00,9343,8,1195875830,1195876010,1,1,180
78611100@N00,9344,28,1340544936,1340544952,3,23,16
78611100@N00,9344,15,1340544952,1340544958,2,23,6
78611100@N00,9344,26,1340544958,1340544994,7,23,36
78611100@N00,9344,24,1340544994,1340545070,17,23,76
78611100@N00,9344,25,1340545070,1340545102,6,23,32
78611100@N00,9344,13,1340545102,1340545161,11,23,59
78611100@N00,9344,20,1340545161,1340545189,4,23,28
78611100@N00,9344,29,1340545189,1340545226,7,23,37
78611100@N00,9344,31,1340545226,1340545254,5,23,28
78611100@N00,9344,30,1340545254,1340545267,3,23,13
78611100@N00,9344,29,1340545267,1340545275,2,23,8
78611100@N00,9344,30,1340545275,1340545283,2,23,8
78611100@N00,9344,18,1340545283,1340545290,2,23,7
78611100@N00,9344,26,1340545290,1340545297,2,23,7
78611100@N00,9344,5,1340545297,1340545302,2,23,5
78611100@N00,9344,16,1340545302,1340545307,2,23,5
78611100@N00,9344,26,1340545307,1340545339,6,23,32
78611100@N00,9344,16,1340545339,1340545349,2,23,10
78611100@N00,9344,26,1340545349,1340545614,34,23,265
78611100@N00,9344,7,1340545614,1340545620,2,23,6
78611100@N00,9344,26,1340545620,1340545632,3,23,12
78611100@N00,9344,27,1340545632,1340545635,2,23,3
78611100@N00,9344,28,1340545635,1340546535,8,23,900
78647421@N00,9345,5,1305171495,1305171615,1,1,120
78647934@N06,9346,19,1409616834,1409617374,1,1,540
78647934@N06,9347,19,1409674358,1409674898,1,1,540
78672040@N00,9348,1,1210036031,1210036091,1,1,60
78672040@N00,9349,22,1272552229,1272552829,1,1,600
78672040@N00,9350,1,1272691587,1272691647,3,1,60
78672040@N00,9351,1,1272751448,1272751508,14,9,60
78672040@N00,9351,26,1272758198,1272758390,4,9,192
78672040@N00,9351,1,1272758390,1272758450,2,9,60
78672040@N00,9351,26,1272758648,1272759358,11,9,710
78672040@N00,9351,1,1272759358,1272759418,2,9,60
78672040@N00,9351,26,1272759498,1272760081,6,9,583
78672040@N00,9351,1,1272760081,1272760141,2,9,60
78672040@N00,9351,26,1272760159,1272761059,2,9,900
78672040@N00,9351,1,1272761729,1272761789,47,9,60
78720487@N02,9352,1,1416188043,1416188103,6,23,60
78720487@N02,9352,28,1416188291,1416188403,2,23,112
78720487@N02,9352,29,1416188403,1416188469,2,23,66
78720487@N02,9352,16,1416188469,1416188739,3,23,270
78720487@N02,9352,21,1416190348,1416190835,2,23,487
78720487@N02,9352,29,1416190835,1416191056,2,23,221
78720487@N02,9352,21,1416191056,1416191058,2,23,2
78720487@N02,9352,27,1416191058,1416191958,2,23,900
78720487@N02,9352,15,1416192330,1416192600,3,23,270
78720487@N02,9352,24,1416193241,1416194021,5,23,780
78720487@N02,9352,21,1416198029,1416198599,4,23,570
78720487@N02,9352,25,1416199734,1416200456,30,23,722
78720487@N02,9352,13,1416200456,1416200696,6,23,240
78720487@N02,9352,22,1416204971,1416204978,2,23,7
78720487@N02,9352,13,1416204978,1416205218,12,23,240
78720487@N02,9352,25,1416205569,1416205684,2,23,115
78720487@N02,9352,21,1416205684,1416205737,2,23,53
78720487@N02,9352,3,1416205737,1416205827,2,23,90
78720487@N02,9352,18,1416207608,1416207657,2,23,49
78720487@N02,9352,28,1416207657,1416208557,35,23,900
78720487@N02,9352,26,1416209954,1416210854,6,23,900
78720487@N02,9352,20,1416214194,1416214299,2,23,105
78720487@N02,9352,28,1416214299,1416215199,2,23,900
7874766@N02,9353,31,1356577057,1356578557,1,1,1500
7874766@N02,9354,31,1357084602,1357084641,2,9,39
7874766@N02,9354,1,1357084641,1357084701,4,9,60
7874766@N02,9354,28,1357085030,1357085507,6,9,477
7874766@N02,9354,26,1357085507,1357086407,4,9,900
7874766@N02,9354,31,1357105543,1357107043,3,9,1500
7874766@N02,9354,24,1357120143,1357120923,2,9,780
7874766@N02,9354,31,1357132190,1357132299,3,9,109
7874766@N02,9354,28,1357132299,1357132795,13,9,496
7874766@N02,9354,1,1357132795,1357132855,1,9,60
78750974@N06,9355,29,1339498908,1339499808,35,1,900
78750974@N06,9356,11,1339625151,1339625246,3,2,95
78750974@N06,9356,21,1339625246,1339625816,1,2,570
78750974@N06,9357,29,1339735270,1339736170,3,1,900
78792726@N00,9358,13,1223710169,1223710409,2,1,240
78832226@N00,9359,26,1211108991,1211109891,3,1,900
78832226@N00,9360,17,1211156214,1211156514,2,15,300
78832226@N00,9360,27,1211156966,1211157866,2,15,900
78832226@N00,9360,24,1211158775,1211159555,2,15,780
78832226@N00,9360,1,1211160986,1211161046,2,15,60
78832226@N00,9360,13,1211161720,1211161960,2,15,240
78832226@N00,9360,17,1211162654,1211162954,4,15,300
78832226@N00,9360,16,1211166227,1211166497,2,15,270
78832226@N00,9360,30,1211166756,1211167836,5,15,1080
78832226@N00,9360,20,1211175182,1211175722,2,15,540
78832226@N00,9360,16,1211179297,1211179534,2,15,237
78832226@N00,9360,26,1211179534,1211180434,3,15,900
78832226@N00,9360,8,1211181341,1211181521,3,15,180
78832226@N00,9360,11,1211182071,1211182311,2,15,240
78832226@N00,9360,29,1211185404,1211186304,2,15,900
78832226@N00,9360,24,1211188805,1211189585,4,15,780
78832226@N00,9361,1,1211240459,1211240519,3,8,60
78832226@N00,9361,17,1211266625,1211266925,3,8,300
78832226@N00,9361,12,1211269373,1211269613,2,8,240
78832226@N00,9361,21,1211269762,1211270332,2,8,570
78832226@N00,9361,19,1211272710,1211273250,2,8,540
78832226@N00,9361,29,1211273283,1211274183,2,8,900
78832226@N00,9361,23,1211276453,1211276670,2,8,217
78832226@N00,9361,26,1211276670,1211277570,1,8,900
78832226@N00,9362,7,1211331820,1211332000,2,3,180
78832226@N00,9362,28,1211332552,1211333452,4,3,900
78832226@N00,9362,1,1211333755,1211333815,1,3,60
78832226@N00,9363,28,1224123614,1224124514,3,10,900
78832226@N00,9363,12,1224125678,1224125918,2,10,240
78832226@N00,9363,17,1224131336,1224131636,3,10,300
78832226@N00,9363,12,1224136139,1224136379,2,10,240
78832226@N00,9363,27,1224136779,1224137679,4,10,900
78832226@N00,9363,16,1224139001,1224139271,3,10,270
78832226@N00,9363,29,1224141800,1224142700,15,10,900
78832226@N00,9363,20,1224144818,1224145323,2,10,505
78832226@N00,9363,30,1224145323,1224146403,2,10,1080
78832226@N00,9363,26,1224151587,1224152487,1,10,900
78832226@N00,9364,28,1224192751,1224193651,2,12,900
78832226@N00,9364,17,1224196736,1224197036,2,12,300
78832226@N00,9364,1,1224213967,1224214027,2,12,60
78832226@N00,9364,13,1224220110,1224220350,2,12,240
78832226@N00,9364,6,1224221498,1224221618,2,12,120
78832226@N00,9364,26,1224221737,1224222637,2,12,900
78832226@N00,9364,18,1224224300,1224224750,2,12,450
78832226@N00,9364,30,1224226939,1224228019,2,12,1080
78832226@N00,9364,24,1224230025,1224230805,4,12,780
78832226@N00,9364,21,1224235400,1224235970,2,12,570
78832226@N00,9364,1,1224243516,1224243576,2,12,60
78832226@N00,9364,28,1224243635,1224244535,2,12,900
78832226@N00,9365,28,1235520144,1235521044,3,3,900
78832226@N00,9365,29,1235525432,1235526332,5,3,900
78832226@N00,9365,17,1235539028,1235539328,2,3,300
78832226@N00,9366,28,1242018377,1242019277,2,11,900
78832226@N00,9366,12,1242020108,1242020348,2,11,240
78832226@N00,9366,30,1242020895,1242021975,4,11,1080
78832226@N00,9366,27,1242025573,1242026473,3,11,900
78832226@N00,9366,16,1242027825,1242028095,2,11,270
78832226@N00,9366,15,1242029507,1242029777,3,11,270
78832226@N00,9366,13,1242031498,1242031738,5,11,240
78832226@N00,9366,25,1242035574,1242036414,3,11,840
78832226@N00,9366,5,1242036526,1242036635,2,11,109
78832226@N00,9366,7,1242036635,1242036758,2,11,123
78832226@N00,9366,5,1242036758,1242036878,1,11,120
78832226@N00,9367,1,1242108983,1242109043,2,3,60
78832226@N00,9367,18,1242116823,1242117273,2,3,450
78832226@N00,9367,20,1242122880,1242123420,1,3,540
78832226@N00,9368,24,1242171669,1242172449,3,6,780
78832226@N00,9368,17,1242174663,1242174963,2,6,300
78832226@N00,9368,12,1242176369,1242176609,2,6,240
78832226@N00,9368,3,1242177931,1242178021,2,6,90
78832226@N00,9368,23,1242181598,1242182198,2,6,600
78832226@N00,9368,19,1242183230,1242183770,2,6,540
78832226@N00,9369,27,1322789249,1322790149,2,10,900
78832226@N00,9369,17,1322796404,1322796704,2,10,300
78832226@N00,9369,25,1322797951,1322798791,2,10,840
78832226@N00,9369,29,1322806227,1322807127,2,10,900
78832226@N00,9369,20,1322808686,1322809226,2,10,540
78832226@N00,9369,30,1322810046,1322811126,2,10,1080
78832226@N00,9369,9,1322812639,1322812819,2,10,180
78832226@N00,9369,5,1322813816,1322813936,2,10,120
78832226@N00,9369,18,1322826409,1322826859,2,10,450
78832226@N00,9369,8,1322830041,1322830221,1,10,180
78832226@N00,9370,30,1322878504,1322879584,2,2,1080
78832226@N00,9370,23,1322880602,1322881202,1,2,600
78927690@N02,9371,28,1361111855,1361112755,2,1,900
78957591@N00,9372,20,1348536898,1348537438,2,4,540
78957591@N00,9372,28,1348541903,1348542803,2,4,900
78957591@N00,9372,25,1348545336,1348546176,2,4,840
78957591@N00,9372,28,1348549933,1348550833,2,4,900
78957591@N00,9373,28,1348648120,1348649020,1,1,900
78957591@N00,9374,28,1447024471,1447025371,2,2,900
78957591@N00,9374,25,1447052092,1447052932,1,2,840
78958621@N04,9375,28,1385816400,1385817300,2,1,900
79016114@N04,9376,28,1414206776,1414207676,2,1,900
79016114@N04,9377,28,1414298524,1414299424,1,1,900
79016114@N04,9378,28,1414379440,1414380340,2,1,900
79023626@N00,9379,18,1460036971,1460037421,1,1,450
79056206@N00,9380,24,1230967680,1230968460,1,1,780
7906627@N04,9381,28,1345855317,1345855864,2,7,547
7906627@N04,9381,16,1345855864,1345856134,2,7,270
7906627@N04,9381,27,1345857590,1345858490,4,7,900
7906627@N04,9381,12,1345865270,1345865510,2,7,240
7906627@N04,9381,13,1345868546,1345868786,2,7,240
7906627@N04,9381,23,1345871411,1345871635,3,7,224
7906627@N04,9381,28,1345871635,1345872535,1,7,900
7906627@N04,9382,1,1365551895,1365551955,2,3,60
7906627@N04,9382,27,1365555285,1365556185,2,3,900
7906627@N04,9382,18,1365572629,1365573079,1,3,450
7906627@N04,9383,27,1375574379,1375575279,2,3,900
7906627@N04,9383,29,1375585516,1375586416,2,3,900
7906627@N04,9383,15,1375609764,1375610034,1,3,270
7906627@N04,9384,1,1378343586,1378343646,2,2,60
7906627@N04,9384,27,1378349158,1378350058,1,2,900
7906627@N04,9385,25,1390347291,1390348131,1,1,840
7906627@N04,9386,27,1396918051,1396918951,3,3,900
7906627@N04,9386,15,1396931218,1396931488,2,3,270
7906627@N04,9386,1,1396954144,1396954204,1,3,60
7906627@N04,9387,19,1402788160,1402788700,2,3,540
7906627@N04,9387,13,1402796374,1402796614,2,3,240
7906627@N04,9387,20,1402806362,1402806902,1,3,540
7906627@N04,9388,19,1403758345,1403758885,1,1,540
7906627@N04,9389,18,1430651383,1430651833,1,1,450
7906627@N04,9390,18,1453613898,1453614348,1,1,450
7906939@N04,9391,28,1261528403,1261529303,2,2,900
7906939@N04,9391,26,1261529322,1261530222,1,2,900
7906939@N04,9392,26,1261561329,1261562229,1,1,900
7914705@N02,9393,17,1314255505,1314255805,1,1,300
79167230@N00,9394,26,1312356824,1312357657,2,2,833
79167230@N00,9394,16,1312357657,1312357927,1,2,270
79172203@N00,9395,28,1198836446,1198837346,1,1,900
79172203@N00,9396,28,1234653662,1234654562,3,6,900
79172203@N00,9396,31,1234658643,1234660143,5,6,1500
79172203@N00,9396,22,1234663766,1234664366,3,6,600
79172203@N00,9396,26,1234666680,1234667580,7,6,900
79172203@N00,9396,28,1234668479,1234669379,10,6,900
79172203@N00,9396,26,1234691672,1234692572,12,6,900
79172203@N00,9397,25,1234749256,1234749646,6,5,390
79172203@N00,9397,12,1234749646,1234749886,2,5,240
79172203@N00,9397,22,1234756216,1234756816,2,5,600
79172203@N00,9397,1,1234757790,1234757850,3,5,60
79172203@N00,9397,28,1234768737,1234769637,3,5,900
79172203@N00,9398,25,1250205631,1250206471,6,2,840
79172203@N00,9398,13,1250207823,1250208063,1,2,240
79172203@N00,9399,26,1250259020,1250259920,2,1,900
79172203@N00,9400,7,1250466693,1250466873,2,6,180
79172203@N00,9400,3,1250467600,1250467690,6,6,90
79172203@N00,9400,5,1250469194,1250469314,2,6,120
79172203@N00,9400,26,1250469537,1250470437,3,6,900
79172203@N00,9400,23,1250483207,1250483807,2,6,600
79172203@N00,9400,26,1250483957,1250484857,6,6,900
79172203@N00,9401,20,1255218657,1255219197,4,12,540
79172203@N00,9401,26,1255227123,1255228023,7,12,900
79172203@N00,9401,28,1255246824,1255247478,7,12,654
79172203@N00,9401,26,1255247478,1255248378,6,12,900
79172203@N00,9401,30,1255252111,1255253191,2,12,1080
79172203@N00,9401,26,1255256685,1255257585,22,12,900
79172203@N00,9401,16,1255261284,1255261554,3,12,270
79172203@N00,9401,3,1255264021,1255264111,3,12,90
79172203@N00,9401,25,1255264525,1255265365,3,12,840
79172203@N00,9401,20,1255266600,1255267140,4,12,540
79172203@N00,9401,28,1255267243,1255267405,4,12,162
79172203@N00,9401,1,1255267405,1255267465,2,12,60
79172203@N00,9402,29,1255342725,1255343625,3,2,900
79172203@N00,9402,20,1255347475,1255348015,2,2,540
79172203@N00,9403,26,1261145094,1261145994,2,1,900
79172203@N00,9404,20,1261178559,1261179099,11,9,540
79172203@N00,9404,26,1261183290,1261184190,3,9,900
79172203@N00,9404,25,1261184307,1261185147,16,9,840
79172203@N00,9404,7,1261192293,1261192473,2,9,180
79172203@N00,9404,29,1261193909,1261194809,33,9,900
79172203@N00,9404,28,1261199882,1261200221,4,9,339
79172203@N00,9404,1,1261200221,1261200281,2,9,60
79172203@N00,9404,28,1261214844,1261215744,2,9,900
79172203@N00,9404,26,1261219832,1261220732,9,9,900
79172203@N00,9405,20,1261284343,1261284883,29,9,540
79172203@N00,9405,28,1261287687,1261288587,49,9,900
79172203@N00,9405,29,1261300633,1261301533,3,9,900
79172203@N00,9405,25,1261303119,1261303959,17,9,840
79172203@N00,9405,16,1261304533,1261304803,2,9,270
79172203@N00,9405,3,1261306032,1261306122,2,9,90
79172203@N00,9405,27,1261308689,1261309589,13,9,900
79172203@N00,9405,25,1261310925,1261311765,14,9,840
79172203@N00,9405,28,1261315304,1261316204,1,9,900
79172203@N00,9406,29,1261350467,1261351367,2,5,900
79172203@N00,9406,3,1261351844,1261351934,3,5,90
79172203@N00,9406,13,1261354075,1261354315,5,5,240
79172203@N00,9406,29,1261358019,1261358919,12,5,900
79172203@N00,9406,26,1261371785,1261372685,2,5,900
79172203@N00,9407,29,1270866825,1270867725,3,7,900
79172203@N00,9407,11,1270869669,1270869826,3,7,157
79172203@N00,9407,3,1270869826,1270869916,2,7,90
79172203@N00,9407,17,1270870083,1270870383,2,7,300
79172203@N00,9407,16,1270871929,1270871981,2,7,52
79172203@N00,9407,26,1270871981,1270872881,2,7,900
79172203@N00,9407,23,1270873577,1270874177,7,7,600
79172203@N00,9408,23,1271036289,1271036889,8,6,600
79172203@N00,9408,29,1271042320,1271043220,2,6,900
79172203@N00,9408,3,1271046763,1271046853,2,6,90
79172203@N00,9408,25,1271047362,1271048202,14,6,840
79172203@N00,9408,21,1271049408,1271049557,2,6,149
79172203@N00,9408,13,1271049557,1271049797,17,6,240
79172203@N00,9409,25,1278673395,1278674235,4,1,840
79172203@N00,9410,29,1278722551,1278723451,5,6,900
79172203@N00,9410,26,1278731509,1278732008,2,6,499
79172203@N00,9410,25,1278732008,1278732848,3,6,840
79172203@N00,9410,13,1278735485,1278735725,4,6,240
79172203@N00,9410,6,1278735967,1278736087,7,6,120
79172203@N00,9410,26,1278736219,1278737119,8,6,900
79172203@N00,9411,29,1278899028,1278899928,2,6,900
79172203@N00,9411,20,1278906289,1278906564,2,6,275
79172203@N00,9411,18,1278906564,1278906682,2,6,118
79172203@N00,9411,26,1278906682,1278907582,27,6,900
79172203@N00,9411,18,1278908134,1278908584,8,6,450
79172203@N00,9411,28,1278910305,1278911205,9,6,900
79172203@N00,9412,5,1281744127,1281744247,8,3,120
79172203@N00,9412,25,1281745351,1281746191,6,3,840
79172203@N00,9412,8,1281746745,1281746925,1,3,180
79172203@N00,9413,17,1281829560,1281829860,6,5,300
79172203@N00,9413,23,1281831967,1281832567,6,5,600
79172203@N00,9413,29,1281833881,1281834781,2,5,900
79172203@N00,9413,20,1281835598,1281836138,8,5,540
79172203@N00,9413,28,1281840891,1281841791,2,5,900
79172203@N00,9414,29,1297469470,1297470370,4,12,900
79172203@N00,9414,20,1297470689,1297471229,4,12,540
79172203@N00,9414,18,1297473341,1297473636,2,12,295
79172203@N00,9414,26,1297473636,1297474227,2,12,591
79172203@N00,9414,25,1297474227,1297475067,19,12,840
79172203@N00,9414,26,1297475633,1297476075,2,12,442
79172203@N00,9414,23,1297476075,1297476675,14,12,600
79172203@N00,9414,30,1297478969,1297480049,2,12,1080
79172203@N00,9414,11,1297484014,1297484238,2,12,224
79172203@N00,9414,6,1297484238,1297484351,3,12,113
79172203@N00,9414,26,1297484351,1297484901,6,12,550
79172203@N00,9414,28,1297484901,1297485801,3,12,900
79172203@N00,9415,29,1297598096,1297598996,19,4,900
79172203@N00,9415,20,1297601034,1297601574,5,4,540
79172203@N00,9415,30,1297602305,1297603385,2,4,1080
79172203@N00,9415,28,1297606380,1297607280,1,4,900
79172203@N00,9416,18,1302319678,1302320128,2,5,450
79172203@N00,9416,30,1302322697,1302323777,10,5,1080
79172203@N00,9416,16,1302326012,1302326282,3,5,270
79172203@N00,9416,15,1302329233,1302329503,3,5,270
79172203@N00,9416,27,1302331677,1302332577,1,5,900
79172203@N00,9417,12,1302397204,1302397444,12,8,240
79172203@N00,9417,8,1302398670,1302398850,4,8,180
79172203@N00,9417,30,1302398910,1302399307,2,8,397
79172203@N00,9417,28,1302399307,1302400207,2,8,900
79172203@N00,9417,1,1302402826,1302402886,9,8,60
79172203@N00,9417,26,1302415776,1302416676,2,8,900
79172203@N00,9417,17,1302416995,1302417295,2,8,300
79172203@N00,9417,22,1302420192,1302420792,1,8,600
79172203@N00,9418,28,1302479317,1302480217,2,16,900
79172203@N00,9418,16,1302484884,1302485008,3,16,124
79172203@N00,9418,26,1302485008,1302485133,2,16,125
79172203@N00,9418,30,1302485133,1302485421,3,16,288
79172203@N00,9418,29,1302485421,1302485467,2,16,46
79172203@N00,9418,31,1302485467,1302486967,11,16,1500
79172203@N00,9418,30,1302488004,1302489084,16,16,1080
79172203@N00,9418,29,1302500071,1302500118,3,16,47
79172203@N00,9418,31,1302500118,1302500320,3,16,202
79172203@N00,9418,30,1302500320,1302500356,3,16,36
79172203@N00,9418,22,1302500356,1302500411,3,16,55
79172203@N00,9418,30,1302500411,1302500423,2,16,12
79172203@N00,9418,22,1302500423,1302500769,8,16,346
79172203@N00,9418,30,1302500769,1302501849,9,16,1080
79172203@N00,9418,20,1302508246,1302508786,2,16,540
79172203@N00,9418,30,1302515997,1302517077,1,16,1080
79172203@N00,9419,27,1305953877,1305954777,25,8,900
79172203@N00,9419,15,1305958056,1305958326,2,8,270
79172203@N00,9419,22,1305960597,1305961197,5,8,600
79172203@N00,9419,1,1305964850,1305964910,4,8,60
79172203@N00,9419,18,1305970435,1305970885,2,8,450
79172203@N00,9419,29,1305982848,1305983254,2,8,406
79172203@N00,9419,20,1305983254,1305983794,2,8,540
79172203@N00,9419,28,1305990907,1305991807,1,8,900
79172203@N00,9420,11,1306028311,1306028551,2,11,240
79172203@N00,9420,1,1306047910,1306047970,3,11,60
79172203@N00,9420,28,1306048042,1306048244,2,11,202
79172203@N00,9420,26,1306048244,1306048566,12,11,322
79172203@N00,9420,8,1306048566,1306048746,4,11,180
79172203@N00,9420,6,1306049164,1306049216,3,11,52
79172203@N00,9420,26,1306049216,1306050116,13,11,900
79172203@N00,9420,20,1306054067,1306054607,4,11,540
79172203@N00,9420,25,1306057620,1306058460,2,11,840
79172203@N00,9420,27,1306072461,1306073361,2,11,900
79172203@N00,9420,26,1306077538,1306078438,2,11,900
79172203@N00,9421,29,1313146500,1313147400,2,4,900
79172203@N00,9421,20,1313148261,1313148801,2,4,540
79172203@N00,9421,25,1313152264,1313153104,21,4,840
79172203@N00,9421,26,1313154836,1313155736,2,4,900
79172203@N00,9422,27,1313197159,1313198059,3,2,900
79172203@N00,9422,28,1313220171,1313221071,58,2,900
79172203@N00,9423,1,1313370648,1313370708,2,7,60
79172203@N00,9423,26,1313371366,1313371749,4,7,383
79172203@N00,9423,23,1313371749,1313372349,6,7,600
79172203@N00,9423,29,1313373334,1313374234,7,7,900
79172203@N00,9423,30,1313375312,1313376392,8,7,1080
79172203@N00,9423,26,1313378307,1313378646,3,7,339
79172203@N00,9423,28,1313378646,1313379546,1,7,900
79172203@N00,9424,20,1325229665,1325230205,9,6,540
79172203@N00,9424,29,1325231858,1325232758,3,6,900
79172203@N00,9424,20,1325233268,1325233808,5,6,540
79172203@N00,9424,25,1325240105,1325240945,36,6,840
79172203@N00,9424,27,1325245169,1325246069,4,6,900
79172203@N00,9424,28,1325247609,1325248509,1,6,900
79172203@N00,9425,16,1325289211,1325289481,2,19,270
79172203@N00,9425,7,1325290542,1325290722,3,19,180
79172203@N00,9425,5,1325290803,1325290923,8,19,120
79172203@N00,9425,10,1325291989,1325292229,2,19,240
79172203@N00,9425,21,1325292397,1325292691,2,19,294
79172203@N00,9425,25,1325292691,1325293531,28,19,840
79172203@N00,9425,13,1325294085,1325294325,19,19,240
79172203@N00,9425,3,1325300996,1325301086,2,19,90
79172203@N00,9425,26,1325301117,1325302017,3,19,900
79172203@N00,9425,23,1325302378,1325302978,6,19,600
79172203@N00,9425,18,1325303586,1325304036,3,19,450
79172203@N00,9425,28,1325306443,1325306495,2,19,52
79172203@N00,9425,1,1325306495,1325306555,11,19,60
79172203@N00,9425,28,1325309411,1325310311,2,19,900
79172203@N00,9425,15,1325313119,1325313389,4,19,270
79172203@N00,9425,22,1325317654,1325318254,4,19,600
79172203@N00,9425,29,1325339794,1325340694,3,19,900
79172203@N00,9425,12,1325346999,1325347239,2,19,240
79172203@N00,9425,26,1325347285,1325348185,1,19,900
79172203@N00,9426,1,1325464407,1325464467,3,43,60
79172203@N00,9426,15,1325465654,1325465924,2,43,270
79172203@N00,9426,20,1325466568,1325466615,2,43,47
79172203@N00,9426,14,1325466615,1325466770,2,43,155
79172203@N00,9426,13,1325466770,1325467010,2,43,240
79172203@N00,9426,15,1325467144,1325467414,2,43,270
79172203@N00,9426,26,1325467626,1325468041,2,43,415
79172203@N00,9426,18,1325468041,1325468491,3,43,450
79172203@N00,9426,23,1325468876,1325469283,2,43,407
79172203@N00,9426,30,1325469283,1325469998,9,43,715
79172203@N00,9426,31,1325469998,1325470057,2,43,59
79172203@N00,9426,22,1325470057,1325470657,13,43,600
79172203@N00,9426,30,1325470747,1325471638,9,43,891
79172203@N00,9426,23,1325471638,1325472238,7,43,600
79172203@N00,9426,29,1325473957,1325474065,2,43,108
79172203@N00,9426,22,1325474065,1325474665,8,43,600
79172203@N00,9426,20,1325475542,1325475695,2,43,153
79172203@N00,9426,29,1325475695,1325476096,5,43,401
79172203@N00,9426,26,1325476096,1325476199,4,43,103
79172203@N00,9426,6,1325476199,1325476319,2,43,120
79172203@N00,9426,25,1325476380,1325476565,9,43,185
79172203@N00,9426,13,1325476565,1325476805,11,43,240
79172203@N00,9426,25,1325477075,1325477200,7,43,125
79172203@N00,9426,21,1325477200,1325477313,2,43,113
79172203@N00,9426,6,1325477313,1325477342,2,43,29
79172203@N00,9426,10,1325477342,1325477408,2,43,66
79172203@N00,9426,11,1325477408,1325477490,2,43,82
79172203@N00,9426,9,1325477490,1325477528,2,43,38
79172203@N00,9426,6,1325477528,1325477644,7,43,116
79172203@N00,9426,26,1325477644,1325478286,23,43,642
79172203@N00,9426,23,1325478286,1325478810,4,43,524
79172203@N00,9426,18,1325478810,1325479108,5,43,298
79172203@N00,9426,23,1325479108,1325479145,2,43,37
79172203@N00,9426,18,1325479145,1325479267,2,43,122
79172203@N00,9426,28,1325479267,1325480167,112,43,900
79172203@N00,9426,20,1325488119,1325488659,2,43,540
79172203@N00,9426,28,1325501705,1325502112,4,43,407
79172203@N00,9426,27,1325502112,1325503012,3,43,900
79172203@N00,9426,20,1325504854,1325505394,6,43,540
79172203@N00,9426,29,1325508236,1325508512,2,43,276
79172203@N00,9426,26,1325508512,1325509030,10,43,518
79172203@N00,9426,25,1325509030,1325509870,8,43,840
79172203@N00,9426,28,1325511526,1325512426,1,43,900
79172203@N00,9427,20,1330475988,1330476528,3,4,540
79172203@N00,9427,18,1330478672,1330479122,2,4,450
79172203@N00,9427,23,1330479746,1330480346,3,4,600
79172203@N00,9427,1,1330483422,1330483482,1,4,60
79172203@N00,9428,1,1330650373,1330650433,2,11,60
79172203@N00,9428,20,1330650594,1330651134,4,11,540
79172203@N00,9428,25,1330651226,1330652066,17,11,840
79172203@N00,9428,21,1330655439,1330656009,20,11,570
79172203@N00,9428,18,1330656082,1330656532,13,11,450
79172203@N00,9428,20,1330657505,1330658045,3,11,540
79172203@N00,9428,29,1330659745,1330660645,8,11,900
79172203@N00,9428,22,1330669225,1330669423,2,11,198
79172203@N00,9428,13,1330669423,1330669663,2,11,240
79172203@N00,9428,28,1330670979,1330671879,25,11,900
79172203@N00,9428,29,1330694065,1330694965,15,11,900
79172203@N00,9429,26,1330746387,1330747287,6,1,900
79172203@N00,9430,16,1334877920,1334878022,2,15,102
79172203@N00,9430,26,1334878022,1334878194,6,15,172
79172203@N00,9430,23,1334878194,1334878206,2,15,12
79172203@N00,9430,26,1334878206,1334878988,2,15,782
79172203@N00,9430,29,1334878988,1334879888,3,15,900
79172203@N00,9430,20,1334880186,1334880726,5,15,540
79172203@N00,9430,22,1334881075,1334881137,3,15,62
79172203@N00,9430,20,1334881137,1334881541,3,15,404
79172203@N00,9430,30,1334881541,1334882621,3,15,1080
79172203@N00,9430,5,1334883286,1334883406,3,15,120
79172203@N00,9430,10,1334884184,1334884424,3,15,240
79172203@N00,9430,3,1334885285,1334885375,7,15,90
79172203@N00,9430,25,1334887588,1334888428,26,15,840
79172203@N00,9430,15,1334888873,1334889143,4,15,270
79172203@N00,9430,27,1334890071,1334890971,1,15,900
79172203@N00,9431,27,1334985760,1334986660,7,2,900
79172203@N00,9431,18,1334987828,1334988278,2,2,450
79172203@N00,9432,23,1335083593,1335084193,19,6,600
79172203@N00,9432,18,1335084478,1335084928,7,6,450
79172203@N00,9432,26,1335088362,1335089004,3,6,642
79172203@N00,9432,29,1335089004,1335089904,12,6,900
79172203@N00,9432,20,1335091329,1335091710,2,6,381
79172203@N00,9432,22,1335091710,1335092310,1,6,600
79172203@N00,9433,11,1339228288,1339228528,2,9,240
79172203@N00,9433,25,1339228670,1339229510,28,9,840
79172203@N00,9433,21,1339230031,1339230601,32,9,570
79172203@N00,9433,5,1339233898,1339234018,2,9,120
79172203@N00,9433,26,1339234847,1339235267,7,9,420
79172203@N00,9433,19,1339235267,1339235807,7,9,540
79172203@N00,9433,23,1339236189,1339236789,10,9,600
79172203@N00,9433,29,1339242237,1339243137,16,9,900
79172203@N00,9433,28,1339248446,1339249346,1,9,900
79172203@N00,9434,12,1339372513,1339372753,8,31,240
79172203@N00,9434,25,1339373137,1339373977,4,31,840
79172203@N00,9434,13,1339376393,1339376633,3,31,240
79172203@N00,9434,26,1339380162,1339380545,7,31,383
79172203@N00,9434,28,1339380545,1339381206,8,31,661
79172203@N00,9434,1,1339381206,1339381266,17,31,60
79172203@N00,9434,26,1339383831,1339384731,2,31,900
79172203@N00,9434,15,1339386131,1339386335,3,31,204
79172203@N00,9434,24,1339386335,1339387115,4,31,780
79172203@N00,9434,1,1339398991,1339399051,5,31,60
79172203@N00,9434,26,1339400905,1339401578,21,31,673
79172203@N00,9434,6,1339401578,1339401698,15,31,120
79172203@N00,9434,7,1339401905,1339401992,7,31,87
79172203@N00,9434,6,1339401992,1339402063,5,31,71
79172203@N00,9434,5,1339402063,1339402183,5,31,120
79172203@N00,9434,11,1339402245,1339402485,13,31,240
79172203@N00,9434,3,1339402552,1339402642,6,31,90
79172203@N00,9434,21,1339402791,1339402901,2,31,110
79172203@N00,9434,3,1339402901,1339402942,2,31,41
79172203@N00,9434,8,1339402942,1339402954,2,31,12
79172203@N00,9434,3,1339402954,1339403044,2,31,90
79172203@N00,9434,18,1339403420,1339403513,2,31,93
79172203@N00,9434,23,1339403513,1339403547,3,31,34
79172203@N00,9434,18,1339403547,1339403584,2,31,37
79172203@N00,9434,19,1339403584,1339403673,2,31,89
79172203@N00,9434,29,1339403673,1339403978,10,31,305
79172203@N00,9434,20,1339403978,1339404518,6,31,540
79172203@N00,9434,29,1339404710,1339405003,3,31,293
79172203@N00,9434,30,1339405003,1339406083,13,31,1080
79172203@N00,9434,20,1339406820,1339407360,2,31,540
79172203@N00,9434,29,1339412945,1339413845,14,31,900
79172203@N00,9435,21,1345853842,1345854412,14,4,570
79172203@N00,9435,25,1345854449,1345855289,7,4,840
79172203@N00,9435,21,1345859448,1345860018,2,4,570
79172203@N00,9435,27,1345860115,1345861015,1,4,900
79172203@N00,9436,29,1346040639,1346041539,7,9,900
79172203@N00,9436,23,1346046117,1346046717,4,9,600
79172203@N00,9436,13,1346050843,1346051083,5,9,240
79172203@N00,9436,21,1346052486,1346052497,2,9,11
79172203@N00,9436,3,1346052497,1346052587,2,9,90
79172203@N00,9436,6,1346052640,1346052760,3,9,120
79172203@N00,9436,26,1346052810,1346053710,7,9,900
79172203@N00,9436,28,1346055687,1346056587,54,9,900
79172203@N00,9436,1,1346058706,1346058766,3,9,60
79172203@N00,9437,28,1348782645,1348782805,2,16,160
79172203@N00,9437,26,1348782805,1348783705,2,16,900
79172203@N00,9437,22,1348793144,1348793192,3,16,48
79172203@N00,9437,20,1348793192,1348793732,7,16,540
79172203@N00,9437,25,1348796906,1348797746,13,16,840
79172203@N00,9437,13,1348822404,1348822644,2,16,240
79172203@N00,9437,20,1348827260,1348827800,11,16,540
79172203@N00,9437,28,1348835383,1348836283,31,16,900
79172203@N00,9437,26,1348836391,1348836874,12,16,483
79172203@N00,9437,30,1348836874,1348837061,4,16,187
79172203@N00,9437,29,1348837061,1348837176,2,16,115
79172203@N00,9437,20,1348837176,1348837668,9,16,492
79172203@N00,9437,29,1348837668,1348838342,15,16,674
79172203@N00,9437,26,1348838342,1348839242,8,16,900
79172203@N00,9437,28,1348839964,1348840003,2,16,39
79172203@N00,9437,1,1348840003,1348840063,20,16,60
79172203@N00,9438,25,1355279306,1355280146,40,4,840
79172203@N00,9438,13,1355280507,1355280747,26,4,240
79172203@N00,9438,20,1355283497,1355284037,15,4,540
79172203@N00,9438,29,1355284844,1355285744,1,4,900
79172203@N00,9439,28,1355396655,1355397268,5,12,613
79172203@N00,9439,16,1355397268,1355397538,3,12,270
79172203@N00,9439,12,1355397556,1355397796,3,12,240
79172203@N00,9439,25,1355398046,1355398886,40,12,840
79172203@N00,9439,3,1355400979,1355401069,3,12,90
79172203@N00,9439,26,1355401200,1355401747,14,12,547
79172203@N00,9439,6,1355401747,1355401867,4,12,120
79172203@N00,9439,26,1355401952,1355402191,4,12,239
79172203@N00,9439,28,1355402191,1355402496,6,12,305
79172203@N00,9439,1,1355402496,1355402514,2,12,18
79172203@N00,9439,28,1355402514,1355402638,2,12,124
79172203@N00,9439,1,1355402638,1355402698,4,12,60
79172203@N00,9440,26,1355437719,1355438619,2,7,900
79172203@N00,9440,27,1355438673,1355439573,6,7,900
79172203@N00,9440,20,1355449011,1355449551,3,7,540
79172203@N00,9440,25,1355454270,1355455110,111,7,840
79172203@N00,9440,28,1355461380,1355462280,2,7,900
79172203@N00,9440,20,1355471575,1355472115,5,7,540
79172203@N00,9440,29,1355475369,1355476269,10,7,900
79172203@N00,9441,1,1355548674,1355548734,6,10,60
79172203@N00,9441,28,1355548902,1355549300,4,10,398
79172203@N00,9441,26,1355549300,1355550200,23,10,900
79172203@N00,9441,30,1355550218,1355550437,3,10,219
79172203@N00,9441,29,1355550437,1355551337,32,10,900
79172203@N00,9441,20,1355551450,1355551755,7,10,305
79172203@N00,9441,22,1355551755,1355552355,18,10,600
79172203@N00,9441,1,1355556024,1355556084,5,10,60
79172203@N00,9441,20,1355573709,1355574249,11,10,540
79172203@N00,9441,25,1355579285,1355580125,8,10,840
79172203@N00,9442,20,1362099886,1362100426,3,1,540
79172203@N00,9443,25,1362186838,1362187678,8,6,840
79172203@N00,9443,29,1362201303,1362201530,4,6,227
79172203@N00,9443,30,1362201530,1362202365,2,6,835
79172203@N00,9443,26,1362202365,1362202985,23,6,620
79172203@N00,9443,16,1362202985,1362203255,4,6,270
79172203@N00,9443,29,1362218864,1362219764,45,6,900
79172203@N00,9444,26,1367017457,1367018357,3,8,900
79172203@N00,9444,6,1367018702,1367018822,4,8,120
79172203@N00,9444,25,1367021139,1367021979,34,8,840
79172203@N00,9444,26,1367028696,1367029596,20,8,900
79172203@N00,9444,15,1367036381,1367036651,12,8,270
79172203@N00,9444,18,1367054829,1367055279,5,8,450
79172203@N00,9444,26,1367057144,1367058044,74,8,900
79172203@N00,9444,29,1367066328,1367067228,40,8,900
79172203@N00,9445,26,1367197370,1367198270,25,12,900
79172203@N00,9445,18,1367198270,1367198488,5,12,218
79172203@N00,9445,23,1367198488,1367198534,5,12,46
79172203@N00,9445,18,1367198534,1367198689,2,12,155
79172203@N00,9445,19,1367198689,1367199229,39,12,540
79172203@N00,9445,30,1367200080,1367201160,38,12,1080
79172203@N00,9445,29,1367201599,1367201684,2,12,85
79172203@N00,9445,31,1367201684,1367201903,9,12,219
79172203@N00,9445,22,1367201903,1367202408,18,12,505
79172203@N00,9445,30,1367202408,1367203488,5,12,1080
79172203@N00,9445,10,1367206964,1367207204,16,12,240
79172203@N00,9445,23,1367211719,1367212319,16,12,600
79172203@N00,9446,8,1376451773,1376451953,2,1,180
79172203@N00,9447,20,1376526174,1376526714,4,3,540
79172203@N00,9447,28,1376531765,1376532267,4,3,502
79172203@N00,9447,1,1376532267,1376532327,3,3,60
79172203@N00,9448,26,1376572261,1376573161,21,3,900
79172203@N00,9448,28,1376577151,1376577332,6,3,181
79172203@N00,9448,1,1376577332,1376577392,2,3,60
79172203@N00,9449,29,1376613238,1376614138,6,3,900
79172203@N00,9449,18,1376619654,1376620104,4,3,450
79172203@N00,9449,26,1376624441,1376625341,64,3,900
79172203@N00,9450,25,1376715855,1376716695,22,1,840
79172203@N00,9451,28,1388357533,1388358433,3,4,900
79172203@N00,9451,23,1388367888,1388368488,11,4,600
79172203@N00,9451,18,1388369030,1388369480,3,4,450
79172203@N00,9451,24,1388372252,1388373032,9,4,780
79172203@N00,9452,26,1388547300,1388548200,3,22,900
79172203@N00,9452,6,1388548973,1388549093,4,22,120
79172203@N00,9452,13,1388549633,1388549873,59,22,240
79172203@N00,9452,15,1388554005,1388554275,5,22,270
79172203@N00,9452,26,1388554619,1388554942,12,22,323
79172203@N00,9452,28,1388554942,1388555842,10,22,900
79172203@N00,9452,25,1388575038,1388575363,7,22,325
79172203@N00,9452,21,1388575363,1388575387,2,22,24
79172203@N00,9452,25,1388575387,1388575421,2,22,34
79172203@N00,9452,21,1388575421,1388575700,13,22,279
79172203@N00,9452,25,1388575700,1388575947,9,22,247
79172203@N00,9452,21,1388575947,1388576014,3,22,67
79172203@N00,9452,25,1388576014,1388576657,2,22,643
79172203@N00,9452,21,1388576657,1388576970,2,22,313
79172203@N00,9452,25,1388576970,1388577106,2,22,136
79172203@N00,9452,21,1388577106,1388577676,2,22,570
79172203@N00,9452,25,1388578294,1388579134,46,22,840
79172203@N00,9452,20,1388583500,1388584040,21,22,540
79172203@N00,9452,29,1388584213,1388585012,20,22,799
79172203@N00,9452,26,1388585012,1388585885,15,22,873
79172203@N00,9452,28,1388585885,1388586217,8,22,332
79172203@N00,9452,1,1388586217,1388586277,1,22,60
79172203@N00,9453,26,1388702766,1388703322,2,18,556
79172203@N00,9453,18,1388703322,1388703772,10,18,450
79172203@N00,9453,20,1388705547,1388706087,10,18,540
79172203@N00,9453,1,1388712137,1388712197,3,18,60
79172203@N00,9453,20,1388712410,1388712896,2,18,486
79172203@N00,9453,13,1388712896,1388713136,3,18,240
79172203@N00,9453,15,1388713700,1388713970,2,18,270
79172203@N00,9453,6,1388718746,1388718866,4,18,120
79172203@N00,9453,29,1388721139,1388722039,4,18,900
79172203@N00,9453,18,1388723669,1388724119,3,18,450
79172203@N00,9453,28,1388724688,1388725588,10,18,900
79172203@N00,9453,26,1388744287,1388744526,4,18,239
79172203@N00,9453,3,1388744526,1388744616,3,18,90
79172203@N00,9453,17,1388747417,1388747717,17,18,300
79172203@N00,9453,29,1388751753,1388752653,3,18,900
79172203@N00,9453,28,1388755200,1388756100,2,18,900
79172203@N00,9453,25,1388757665,1388758505,9,18,840
79172203@N00,9453,28,1388759245,1388760145,5,18,900
79172203@N00,9454,6,1392415340,1392415460,2,3,120
79172203@N00,9454,18,1392426191,1392426641,2,3,450
79172203@N00,9454,26,1392435961,1392436861,26,3,900
79172203@N00,9455,1,1392534696,1392534756,13,4,60
79172203@N00,9455,28,1392535523,1392535851,8,4,328
79172203@N00,9455,26,1392535851,1392536751,18,4,900
79172203@N00,9455,28,1392540718,1392541618,29,4,900
79172203@N00,9456,6,1392605418,1392605538,3,1,120
79172203@N00,9457,20,1397354762,1397355302,2,7,540
79172203@N00,9457,1,1397355885,1397355945,3,7,60
79172203@N00,9457,28,1397356040,1397356139,8,7,99
79172203@N00,9457,16,1397356139,1397356409,2,7,270
79172203@N00,9457,15,1397358847,1397359117,3,7,270
79172203@N00,9457,24,1397360155,1397360935,2,7,780
79172203@N00,9457,12,1397361526,1397361766,1,7,240
79172203@N00,9458,1,1407817858,1407817918,1,1,60
79172203@N00,9459,18,1407911161,1407911611,3,5,450
79172203@N00,9459,3,1407913546,1407913636,3,5,90
79172203@N00,9459,26,1407913687,1407914587,4,5,900
79172203@N00,9459,16,1407927970,1407928240,2,5,270
79172203@N00,9459,29,1407932320,1407933220,25,5,900
79172203@N00,9460,26,1408017834,1408018106,2,2,272
79172203@N00,9460,3,1408018106,1408018196,1,2,90
79172203@N00,9461,20,1412895176,1412895716,1,1,540
79172203@N00,9462,13,1412925922,1412926162,5,9,240
79172203@N00,9462,30,1412929858,1412930938,7,9,1080
79172203@N00,9462,29,1412935904,1412936804,9,9,900
79172203@N00,9462,18,1412938316,1412938766,6,9,450
79172203@N00,9462,1,1412939311,1412939371,5,9,60
79172203@N00,9462,28,1412941254,1412942154,25,9,900
79172203@N00,9462,26,1412945091,1412945991,4,9,900
79172203@N00,9462,28,1412946756,1412947093,2,9,337
79172203@N00,9462,1,1412947093,1412947153,1,9,60
79172203@N00,9463,1,1412987399,1412987459,26,6,60
79172203@N00,9463,28,1412987846,1412988746,101,6,900
79172203@N00,9463,26,1412990019,1412990397,11,6,378
79172203@N00,9463,30,1412990397,1412991477,39,6,1080
79172203@N00,9463,20,1412993210,1412993750,9,6,540
79172203@N00,9463,26,1412994277,1412995177,16,6,900
79172203@N00,9464,26,1413056828,1413057672,3,5,844
79172203@N00,9464,30,1413057672,1413058381,2,5,709
79172203@N00,9464,6,1413058381,1413058501,2,5,120
79172203@N00,9464,15,1413059148,1413059376,4,5,228
79172203@N00,9464,1,1413059376,1413059436,1,5,60
79172203@N00,9465,28,1413158713,1413159613,4,7,900
79172203@N00,9465,20,1413162449,1413162989,61,7,540
79172203@N00,9465,22,1413164636,1413165236,8,7,600
79172203@N00,9465,23,1413166259,1413166859,10,7,600
79172203@N00,9465,25,1413170096,1413170936,22,7,840
79172203@N00,9465,30,1413173109,1413174189,2,7,1080
79172203@N00,9465,1,1413179085,1413179145,2,7,60
79172203@N00,9466,25,1416443314,1416444154,28,1,840
79172203@N00,9467,26,1416612532,1416613432,2,11,900
79172203@N00,9467,18,1416613564,1416614014,19,11,450
79172203@N00,9467,26,1416618222,1416619122,3,11,900
79172203@N00,9467,30,1416621415,1416621610,2,11,195
79172203@N00,9467,29,1416621610,1416622510,46,11,900
79172203@N00,9467,18,1416622650,1416622811,6,11,161
79172203@N00,9467,26,1416622811,1416623217,16,11,406
79172203@N00,9467,28,1416623217,1416623574,17,11,357
79172203@N00,9467,1,1416623574,1416623634,5,11,60
79172203@N00,9467,28,1416643829,1416644729,31,11,900
79172203@N00,9467,25,1416655110,1416655950,6,11,840
79172203@N00,9468,29,1423904783,1423905683,5,1,900
79172203@N00,9469,30,1423952428,1423953508,2,4,1080
79172203@N00,9469,18,1423966836,1423967286,8,4,450
79172203@N00,9469,29,1423994113,1423995013,7,4,900
79172203@N00,9469,28,1424002277,1424003177,1,4,900
79172203@N00,9470,20,1424046351,1424046891,11,5,540
79172203@N00,9470,29,1424048138,1424048726,4,5,588
79172203@N00,9470,26,1424048726,1424049626,28,5,900
79172203@N00,9470,6,1424049706,1424049826,6,5,120
79172203@N00,9470,3,1424050184,1424050274,2,5,90
79172203@N00,9471,21,1427580161,1427580545,12,21,384
79172203@N00,9471,8,1427580545,1427580725,6,21,180
79172203@N00,9471,26,1427580838,1427581738,14,21,900
79172203@N00,9471,29,1427582174,1427583074,12,21,900
79172203@N00,9471,15,1427587001,1427587029,2,21,28
79172203@N00,9471,17,1427587029,1427587088,3,21,59
79172203@N00,9471,27,1427587088,1427587393,2,21,305
79172203@N00,9471,16,1427587393,1427587403,2,21,10
79172203@N00,9471,27,1427587403,1427587410,2,21,7
79172203@N00,9471,16,1427587410,1427587680,14,21,270
79172203@N00,9471,28,1427587696,1427588181,15,21,485
79172203@N00,9471,1,1427588181,1427588241,2,21,60
79172203@N00,9471,28,1427588942,1427589842,8,21,900
79172203@N00,9471,8,1427591101,1427591281,2,21,180
79172203@N00,9471,11,1427591468,1427591708,3,21,240
79172203@N00,9471,26,1427591863,1427592763,54,21,900
79172203@N00,9471,23,1427594589,1427595149,3,21,560
79172203@N00,9471,20,1427595149,1427595689,6,21,540
79172203@N00,9471,29,1427597045,1427597945,2,21,900
79172203@N00,9471,21,1427599723,1427600293,2,21,570
79172203@N00,9471,23,1427601303,1427601903,1,21,600
79172203@N00,9472,22,1427680434,1427680745,11,6,311
79172203@N00,9472,31,1427680745,1427680807,2,6,62
79172203@N00,9472,22,1427680807,1427681407,4,6,600
79172203@N00,9472,26,1427684577,1427685477,7,6,900
79172203@N00,9472,20,1427690011,1427690551,2,6,540
79172203@N00,9472,29,1427697615,1427698515,36,6,900
79172203@N00,9473,27,1432310136,1432311036,2,5,900
79172203@N00,9473,26,1432313414,1432314314,6,5,900
79172203@N00,9473,22,1432314677,1432315277,3,5,600
79172203@N00,9473,16,1432319245,1432319323,2,5,78
79172203@N00,9473,26,1432319323,1432320223,30,5,900
79172203@N00,9474,3,1432360349,1432360439,2,5,90
79172203@N00,9474,25,1432362026,1432362866,28,5,840
79172203@N00,9474,23,1432368153,1432368753,14,5,600
79172203@N00,9474,28,1432375646,1432376546,119,5,900
79172203@N00,9474,29,1432383646,1432384546,4,5,900
79172203@N00,9475,1,1432435801,1432435861,14,5,60
79172203@N00,9475,28,1432436426,1432437326,19,5,900
79172203@N00,9475,26,1432437653,1432438553,29,5,900
79172203@N00,9475,31,1432444380,1432445880,17,5,1500
79172203@N00,9475,26,1432449501,1432450401,10,5,900
79172203@N00,9476,21,1439448891,1439449461,30,3,570
79172203@N00,9476,20,1439455097,1439455637,4,3,540
79172203@N00,9476,19,1439459409,1439459949,2,3,540
79172203@N00,9477,1,1439500932,1439500992,3,2,60
79172203@N00,9477,26,1439502652,1439503552,3,2,900
79172203@N00,9478,29,1439537208,1439538108,8,4,900
79172203@N00,9478,21,1439542670,1439543240,7,4,570
79172203@N00,9478,25,1439543618,1439544458,7,4,840
79172203@N00,9478,29,1439550173,1439551073,36,4,900
79172203@N00,9479,23,1439629235,1439629835,2,5,600
79172203@N00,9479,20,1439643333,1439643873,5,5,540
79172203@N00,9479,29,1439644899,1439645799,9,5,900
79172203@N00,9479,26,1439648504,1439649404,9,5,900
79172203@N00,9479,28,1439649737,1439650637,4,5,900
79172203@N00,9480,28,1441851628,1441852528,1,1,900
79172203@N00,9481,1,1441922389,1441922449,5,11,60
79172203@N00,9481,28,1441922535,1441922821,6,11,286
79172203@N00,9481,26,1441922821,1441923721,20,11,900
79172203@N00,9481,30,1441924036,1441924383,17,11,347
79172203@N00,9481,20,1441924383,1441924634,13,11,251
79172203@N00,9481,29,1441924634,1441924963,9,11,329
79172203@N00,9481,19,1441924963,1441924991,4,11,28
79172203@N00,9481,23,1441924991,1441925025,3,11,34
79172203@N00,9481,18,1441925025,1441925475,2,11,450
79172203@N00,9481,20,1441927337,1441927877,33,11,540
79172203@N00,9481,29,1441932713,1441933613,7,11,900
79172203@N00,9482,21,1441976714,1441977284,53,2,570
79172203@N00,9482,26,1441979260,1441980160,9,2,900
79172203@N00,9483,1,1442039069,1442039129,18,11,60
79172203@N00,9483,28,1442039670,1442040570,17,11,900
79172203@N00,9483,7,1442042142,1442042244,3,11,102
79172203@N00,9483,6,1442042244,1442042328,4,11,84
79172203@N00,9483,26,1442042328,1442043228,7,11,900
79172203@N00,9483,27,1442047171,1442048071,4,11,900
79172203@N00,9483,12,1442048464,1442048704,3,11,240
79172203@N00,9483,25,1442048861,1442049701,10,11,840
79172203@N00,9483,20,1442062493,1442063033,3,11,540
79172203@N00,9483,30,1442064796,1442065876,3,11,1080
79172203@N00,9483,28,1442066737,1442067637,1,11,900
79172203@N00,9484,23,1442107316,1442107916,3,2,600
79172203@N00,9484,24,1442115605,1442116385,4,2,780
79172203@N00,9485,25,1444378743,1444379361,3,10,618
79172203@N00,9485,11,1444379361,1444379601,3,10,240
79172203@N00,9485,26,1444379679,1444379841,2,10,162
79172203@N00,9485,28,1444379841,1444380741,4,10,900
79172203@N00,9485,1,1444382396,1444382456,4,10,60
79172203@N00,9485,28,1444384018,1444384918,4,10,900
79172203@N00,9485,16,1444387108,1444387378,9,10,270
79172203@N00,9485,22,1444389844,1444390444,2,10,600
79172203@N00,9485,30,1444390519,1444391599,2,10,1080
79172203@N00,9485,26,1444396469,1444397369,10,10,900
79172203@N00,9486,1,1444446679,1444446739,2,3,60
79172203@N00,9486,28,1444447226,1444448126,6,3,900
79172203@N00,9486,20,1444450760,1444451300,3,3,540
79172203@N00,9487,28,1444503979,1444504879,3,3,900
79172203@N00,9487,26,1444505943,1444506533,2,3,590
79172203@N00,9487,21,1444506533,1444507103,1,3,570
79172203@N00,9488,1,1444597843,1444597903,6,12,60
79172203@N00,9488,28,1444598717,1444599054,13,12,337
79172203@N00,9488,16,1444599054,1444599324,3,12,270
79172203@N00,9488,26,1444599539,1444599873,9,12,334
79172203@N00,9488,16,1444599873,1444599954,6,12,81
79172203@N00,9488,27,1444599954,1444600076,3,12,122
79172203@N00,9488,17,1444600076,1444600376,5,12,300
79172203@N00,9488,29,1444606417,1444607317,3,12,900
79172203@N00,9488,23,1444607845,1444608445,7,12,600
79172203@N00,9488,27,1444609228,1444610128,4,12,900
79172203@N00,9488,25,1444612119,1444612948,11,12,829
79172203@N00,9488,13,1444612948,1444613188,2,12,240
79172203@N00,9489,20,1451613921,1451614446,11,29,525
79172203@N00,9489,18,1451614446,1451614636,2,29,190
79172203@N00,9489,20,1451614636,1451615176,9,29,540
79172203@N00,9489,29,1451636354,1451637254,34,29,900
79172203@N00,9489,25,1451650814,1451651654,34,29,840
79172203@N00,9489,13,1451652159,1451652399,11,29,240
79172203@N00,9489,26,1451652534,1451653187,9,29,653
79172203@N00,9489,18,1451653187,1451653315,3,29,128
79172203@N00,9489,23,1451653315,1451653485,4,29,170
79172203@N00,9489,29,1451653485,1451654385,6,29,900
79172203@N00,9489,28,1451654886,1451655786,9,29,900
79172203@N00,9489,1,1451655999,1451656059,10,29,60
79172203@N00,9489,28,1451683304,1451683984,29,29,680
79172203@N00,9489,26,1451683984,1451684884,21,29,900
79172203@N00,9489,28,1451686793,1451687693,2,29,900
79172203@N00,9489,25,1451689114,1451689954,10,29,840
79172203@N00,9489,15,1451694187,1451694457,15,29,270
79172203@N00,9489,23,1451696164,1451696764,35,29,600
79172203@N00,9489,26,1451700938,1451701838,6,29,900
79172203@N00,9489,30,1451708077,1451708225,3,29,148
79172203@N00,9489,28,1451708225,1451709125,6,29,900
79172203@N00,9489,17,1451728667,1451728697,2,29,30
79172203@N00,9489,15,1451728697,1451728719,2,29,22
79172203@N00,9489,27,1451728719,1451728952,2,29,233
79172203@N00,9489,16,1451728952,1451729222,4,29,270
79172203@N00,9489,28,1451729432,1451730332,2,29,900
79172203@N00,9489,20,1451740076,1451740616,11,29,540
79172203@N00,9489,25,1451742956,1451743796,20,29,840
79172203@N00,9489,26,1451744616,1451745516,7,29,900
79172203@N00,9490,20,1455404170,1455404710,2,7,540
79172203@N00,9490,25,1455413939,1455414779,8,7,840
79172203@N00,9490,30,1455428216,1455429296,8,7,1080
79172203@N00,9490,20,1455430782,1455431322,19,7,540
79172203@N00,9490,29,1455433525,1455434425,3,7,900
79172203@N00,9490,3,1455440974,1455441064,2,7,90
79172203@N00,9490,15,1455442857,1455443127,3,7,270
79172203@N00,9491,23,1455502616,1455503216,2,4,600
79172203@N00,9491,21,1455530544,1455531114,47,4,570
79172203@N00,9491,27,1455535951,1455536851,2,4,900
79172203@N00,9491,1,1455545789,1455545849,2,4,60
79172203@N00,9492,23,1455593079,1455593679,3,1,600
79172203@N00,9493,1,1459390985,1459391045,2,11,60
79172203@N00,9493,28,1459391437,1459392136,3,11,699
79172203@N00,9493,18,1459392136,1459392586,2,11,450
79172203@N00,9493,23,1459392928,1459393376,4,11,448
79172203@N00,9493,29,1459393376,1459393736,2,11,360
79172203@N00,9493,14,1459393736,1459393976,2,11,240
79172203@N00,9493,30,1459394982,1459395454,5,11,472
79172203@N00,9493,7,1459395454,1459395634,4,11,180
79172203@N00,9493,24,1459396371,1459396431,2,11,60
79172203@N00,9493,27,1459396431,1459397331,2,11,900
79172203@N00,9493,28,1459398613,1459399513,2,11,900
79172203@N00,9494,27,1459473997,1459474287,13,5,290
79172203@N00,9494,24,1459474287,1459474369,3,5,82
79172203@N00,9494,15,1459474369,1459474499,6,5,130
79172203@N00,9494,17,1459474499,1459474799,3,5,300
79172203@N00,9494,15,1459474904,1459475174,1,5,270
79172203@N00,9495,20,1459506232,1459506772,3,1,540
79172203@N00,9496,18,1459554229,1459554280,2,5,51
79172203@N00,9496,28,1459554280,1459554470,6,5,190
79172203@N00,9496,1,1459554470,1459554530,17,5,60
79172203@N00,9496,28,1459555865,1459556765,31,5,900
79172203@N00,9496,24,1459558589,1459559369,9,5,780
79172203@N00,9497,20,1459593851,1459594391,1,1,540
79172203@N00,9498,18,1465694223,1465694673,3,2,450
79172203@N00,9498,26,1465710448,1465711348,6,2,900
79172203@N00,9499,16,1465779328,1465779598,1,1,270
79172203@N00,9500,28,1465816407,1465817307,14,2,900
79172203@N00,9500,26,1465821427,1465822327,1,2,900
79172203@N00,9501,18,1468239879,1468240329,1,1,450
79172203@N00,9502,1,1470974168,1470974228,4,6,60
79172203@N00,9502,23,1470980894,1470981494,3,6,600
79172203@N00,9502,27,1470996610,1470997510,2,6,900
79172203@N00,9502,26,1471002089,1471002989,4,6,900
79172203@N00,9502,25,1471004339,1471005179,9,6,840
79172203@N00,9502,26,1471006962,1471007862,2,6,900
79172203@N00,9503,16,1471063059,1471063137,4,4,78
79172203@N00,9503,26,1471063137,1471063513,10,4,376
79172203@N00,9503,1,1471063513,1471063573,2,4,60
79172203@N00,9503,21,1471085383,1471085953,33,4,570
79172203@N00,9504,18,1471137117,1471137567,1,1,450
79209019@N00,9505,26,1356036589,1356037489,1,1,900
79209019@N00,9506,26,1394879732,1394880632,1,1,900
79209019@N00,9507,26,1438889878,1438890778,1,1,900
79209421@N00,9508,5,1274086124,1274086244,3,2,120
79209421@N00,9508,7,1274086506,1274086686,1,2,180
79254752@N08,9509,28,1368255225,1368256125,2,2,900
79254752@N08,9509,1,1368263343,1368263403,1,2,60
7927897@N02,9510,18,1449096457,1449096907,1,1,450
7927897@N02,9511,18,1457314159,1457314609,1,1,450
7933322@N08,9512,1,1381197697,1381197757,2,2,60
7933322@N08,9512,15,1381209915,1381210185,1,2,270
7933322@N08,9513,7,1381723302,1381723482,2,5,180
7933322@N08,9513,16,1381732657,1381732764,2,5,107
7933322@N08,9513,27,1381732764,1381732872,2,5,108
7933322@N08,9513,16,1381732872,1381733142,2,5,270
7933322@N08,9513,7,1381736320,1381736500,1,5,180
7933322@N08,9514,24,1450782356,1450782802,2,6,446
7933322@N08,9514,26,1450782802,1450783050,2,6,248
7933322@N08,9514,30,1450783050,1450783266,2,6,216
7933322@N08,9514,14,1450783266,1450783429,2,6,163
7933322@N08,9514,15,1450783429,1450783634,2,6,205
7933322@N08,9514,18,1450783634,1450784084,1,6,450
79349162@N00,9515,30,1253366411,1253366417,2,4,6
79349162@N00,9515,24,1253366417,1253366425,2,4,8
79349162@N00,9515,22,1253366425,1253366428,2,4,3
79349162@N00,9515,28,1253366428,1253367328,1,4,900
79382601@N05,9516,17,1332567416,1332567716,1,1,300
79387229@N00,9517,26,1225908909,1225909809,20,1,900
79405715@N00,9518,14,1362833921,1362834161,1,1,240
79405715@N00,9519,22,1364725061,1364725661,1,1,600
79416801@N03,9520,27,1384055300,1384056200,2,3,900
79416801@N03,9520,29,1384065054,1384065954,2,3,900
79416801@N03,9520,20,1384069986,1384070526,1,3,540
79416801@N03,9521,7,1384217200,1384217380,1,1,180
79416801@N03,9522,28,1411289838,1411290738,1,1,900
79426194@N06,9523,22,1341740909,1341741509,1,1,600
79426194@N06,9524,28,1341894792,1341895692,1,1,900
79439374@N04,9525,11,1413541318,1413541558,1,1,240
7945637@N07,9526,28,1192692264,1192693093,2,3,829
7945637@N07,9526,12,1192693093,1192693333,3,3,240
7945637@N07,9526,27,1192695231,1192696131,2,3,900
7945637@N07,9527,23,1192752896,1192753496,3,4,600
7945637@N07,9527,31,1192757237,1192758737,2,4,1500
7945637@N07,9527,26,1192762644,1192763544,2,4,900
7945637@N07,9527,13,1192770172,1192770412,2,4,240
7945637@N07,9528,26,1242444438,1242445338,3,4,900
7945637@N07,9528,31,1242447233,1242448733,2,4,1500
7945637@N07,9528,11,1242449094,1242449334,2,4,240
7945637@N07,9528,31,1242458645,1242460145,1,4,1500
7945637@N07,9529,27,1242547226,1242548126,2,3,900
7945637@N07,9529,12,1242551974,1242552214,4,3,240
7945637@N07,9529,31,1242574366,1242575866,1,3,1500
7945637@N07,9530,27,1252487705,1252488605,2,2,900
7945637@N07,9530,26,1252490502,1252491402,1,2,900
7945637@N07,9531,12,1252651248,1252651488,1,1,240
7945637@N07,9532,26,1314848379,1314849279,1,1,900
7945637@N07,9533,31,1315042410,1315043910,1,1,1500
7945637@N07,9534,21,1315230964,1315231534,1,1,570
7945637@N07,9535,31,1385972638,1385974138,1,1,1500
7945637@N07,9536,16,1441592585,1441592855,1,1,270
79486179@N00,9537,30,1295231706,1295232786,1,1,1080
79524349@N00,9538,29,1363161335,1363162235,2,1,900
79529489@N00,9539,28,1350298006,1350298906,1,1,900
79551604@N00,9540,27,1275295961,1275296861,1,1,900
79551604@N00,9541,1,1369455396,1369455456,4,5,60
79551604@N00,9541,22,1369457832,1369457857,2,5,25
79551604@N00,9541,27,1369457857,1369458757,2,5,900
79551604@N00,9541,15,1369459894,1369460164,3,5,270
79551604@N00,9541,17,1369461019,1369461319,1,5,300
79551604@N00,9542,28,1369547080,1369547980,2,4,900
79551604@N00,9542,23,1369548826,1369549426,3,4,600
79551604@N00,9542,30,1369553564,1369554644,4,4,1080
79551604@N00,9542,18,1369561978,1369562428,1,4,450
7956802@N02,9543,1,1342563354,1342563414,1,1,60
7956802@N02,9544,28,1345594667,1345595567,1,1,900
79624377@N06,9545,13,1374287721,1374287961,1,1,240
79761301@N00,9546,15,1188123925,1188124195,1,1,270
79761301@N00,9547,23,1191511763,1191512089,2,6,326
79761301@N00,9547,29,1191512089,1191512911,7,6,822
79761301@N00,9547,31,1191512911,1191514411,4,6,1500
79761301@N00,9547,20,1191515290,1191515830,2,6,540
79761301@N00,9547,30,1191516317,1191517397,2,6,1080
79761301@N00,9547,28,1191518647,1191519547,4,6,900
79761301@N00,9548,25,1191597631,1191598471,15,2,840
79761301@N00,9548,20,1191600308,1191600848,1,2,540
79761301@N00,9549,28,1192711318,1192712218,3,7,900
79761301@N00,9549,29,1192721604,1192722110,5,7,506
79761301@N00,9549,23,1192722110,1192722710,3,7,600
79761301@N00,9549,6,1192725625,1192725745,3,7,120
79761301@N00,9549,11,1192725879,1192726119,3,7,240
79761301@N00,9549,25,1192726423,1192727263,7,7,840
79761301@N00,9549,30,1192728684,1192729764,1,7,1080
79761301@N00,9550,20,1197054555,1197055095,2,2,540
79761301@N00,9550,25,1197069448,1197070288,1,2,840
79761301@N00,9551,29,1200086170,1200087070,1,1,900
79761301@N00,9552,23,1201969833,1201970154,2,6,321
79761301@N00,9552,5,1201970154,1201970274,3,6,120
79761301@N00,9552,29,1201998761,1201999661,3,6,900
79761301@N00,9552,20,1201999988,1202000126,2,6,138
79761301@N00,9552,29,1202000126,1202000634,4,6,508
79761301@N00,9552,23,1202000634,1202001234,3,6,600
79761301@N00,9553,28,1204386339,1204387239,5,5,900
79761301@N00,9553,13,1204387888,1204388128,2,5,240
79761301@N00,9553,26,1204388417,1204388553,2,5,136
79761301@N00,9553,30,1204388553,1204389633,2,5,1080
79761301@N00,9553,28,1204390429,1204391329,1,5,900
79761301@N00,9554,28,1207082242,1207083142,2,3,900
79761301@N00,9554,30,1207088065,1207088354,2,3,289
79761301@N00,9554,23,1207088354,1207088954,1,3,600
79761301@N00,9555,28,1219265844,1219266744,1,1,900
79761301@N00,9556,23,1219694617,1219695217,4,2,600
79761301@N00,9556,20,1219695274,1219695814,2,2,540
79761301@N00,9557,28,1224603169,1224604069,2,6,900
79761301@N00,9557,29,1224611237,1224612122,2,6,885
79761301@N00,9557,31,1224612122,1224612149,2,6,27
79761301@N00,9557,20,1224612149,1224612689,8,6,540
79761301@N00,9557,30,1224617480,1224618560,2,6,1080
79761301@N00,9557,20,1224620400,1224620940,4,6,540
79761301@N00,9558,13,1236384011,1236384251,1,1,240
79761301@N00,9559,30,1293986338,1293986582,2,3,244
79761301@N00,9559,5,1293986582,1293986702,2,3,120
79761301@N00,9559,28,1293987958,1293988858,3,3,900
7977582@N06,9560,28,1397512121,1397513021,1,1,900
7977582@N06,9561,3,1397560319,1397560409,1,1,90
79781814@N00,9562,28,1352517078,1352517978,2,2,900
79781814@N00,9562,26,1352521551,1352522451,1,2,900
79842767@N00,9563,17,1259480702,1259481002,2,1,300
7988769@N08,9564,29,1425693272,1425693298,2,5,26
7988769@N08,9564,3,1425693298,1425693359,2,5,61
7988769@N08,9564,12,1425693359,1425693599,2,5,240
7988769@N08,9564,26,1425693685,1425693978,3,5,293
7988769@N08,9564,29,1425693978,1425694878,1,5,900
7988769@N08,9565,30,1426048211,1426049291,1,1,1080
7988769@N08,9566,16,1426246009,1426246279,1,1,270
7988769@N08,9567,27,1426337215,1426338115,1,1,900
7988769@N08,9568,11,1426420500,1426420740,1,1,240
7988769@N08,9569,12,1426462550,1426462790,1,1,240
7988769@N08,9570,18,1426634636,1426635086,1,1,450
7988769@N08,9571,19,1427064557,1427065097,1,1,540
7988769@N08,9572,5,1427334375,1427334495,1,1,120
7988769@N08,9573,13,1427673252,1427673492,1,1,240
7988769@N08,9574,30,1427847944,1427849024,1,1,1080
7988769@N08,9575,30,1427963039,1427964119,1,1,1080
7988769@N08,9576,1,1428983538,1428983598,1,1,60
7988769@N08,9577,1,1429156339,1429156399,1,1,60
7988769@N08,9578,13,1429276852,1429277092,1,1,240
7988769@N08,9579,18,1429487623,1429488073,1,1,450
7988769@N08,9580,13,1429572142,1429572382,1,1,240
7988769@N08,9581,12,1432451875,1432452115,2,2,240
7988769@N08,9581,28,1432455988,1432456888,1,2,900
7988769@N08,9582,20,1432715698,1432716238,1,1,540
7988769@N08,9583,12,1433125488,1433125728,2,2,240
7988769@N08,9583,29,1433135411,1433136311,1,2,900
7988769@N08,9584,30,1434069467,1434070547,1,1,1080
7988769@N08,9585,16,1438751367,1438751637,1,1,270
79894532@N03,9586,20,1308013376,1308013916,2,1,540
79894532@N03,9587,20,1326947882,1326948422,3,1,540
79941846@N08,9588,19,1329698346,1329698886,1,1,540
79941846@N08,9589,17,1346635631,1346635931,1,1,300
79978100@N04,9590,16,1427489713,1427489983,8,4,270
79978100@N04,9590,26,1427495531,1427496431,2,4,900
79978100@N04,9590,13,1427508384,1427508430,2,4,46
79978100@N04,9590,25,1427508430,1427509270,1,4,840
79978100@N04,9591,20,1427579797,1427580337,1,1,540
79978100@N04,9592,19,1427692597,1427693137,8,2,540
79978100@N04,9592,28,1427700115,1427701015,8,2,900
80028591@N00,9593,26,1209519239,1209520139,1,1,900
80028591@N00,9594,25,1212140080,1212140920,1,1,840
80028591@N00,9595,3,1237207424,1237207462,2,2,38
80028591@N00,9595,26,1237207462,1237208362,1,2,900
80028591@N00,9596,28,1356044438,1356045338,1,1,900
80028591@N00,9597,20,1426041786,1426042326,1,1,540
80028591@N00,9598,18,1439298061,1439298511,1,1,450
80030448@N02,9599,28,1336439494,1336440394,1,1,900
8021465@N08,9600,25,1246107626,1246108466,1,1,840
8021465@N08,9601,20,1274337235,1274337775,1,1,540
8021465@N08,9602,1,1274412994,1274413054,1,1,60
8021465@N08,9603,28,1274444257,1274445157,2,4,900
8021465@N08,9603,13,1274452256,1274452496,2,4,240
8021465@N08,9603,26,1274456597,1274457370,2,4,773
8021465@N08,9603,7,1274457370,1274457550,2,4,180
8021465@N08,9604,26,1274496944,1274497844,2,3,900
8021465@N08,9604,1,1274524082,1274524142,2,3,60
8021465@N08,9604,26,1274531002,1274531902,3,3,900
8021465@N08,9605,26,1274584812,1274585712,5,1,900
8022297@N02,9606,1,1297911756,1297911816,3,4,60
8022297@N02,9606,26,1297912014,1297912752,2,4,738
8022297@N02,9606,8,1297912752,1297912932,2,4,180
8022297@N02,9606,26,1297920860,1297921760,1,4,900
8022297@N02,9607,30,1302748722,1302749802,2,4,1080
8022297@N02,9607,19,1302753501,1302754041,2,4,540
8022297@N02,9607,28,1302755912,1302756188,2,4,276
8022297@N02,9607,1,1302756188,1302756248,1,4,60
80237899@N00,9608,13,1264559502,1264559742,2,6,240
80237899@N00,9608,30,1264561114,1264562194,2,6,1080
80237899@N00,9608,26,1264570261,1264571161,2,6,900
80237899@N00,9608,29,1264572226,1264573126,2,6,900
80237899@N00,9608,17,1264579453,1264579753,2,6,300
80237899@N00,9608,26,1264584726,1264585626,1,6,900
8026214@N07,9609,21,1322817607,1322818177,1,1,570
80286151@N07,9610,14,1395539161,1395539401,1,1,240
80292103@N00,9611,15,1322088251,1322088521,3,3,270
80292103@N00,9611,16,1322092462,1322092732,3,3,270
80292103@N00,9611,26,1322093010,1322093910,1,3,900
80292103@N00,9612,30,1323685010,1323686090,1,1,1080
80292103@N00,9613,8,1323743117,1323743297,3,1,180
80292103@N00,9614,17,1324858896,1324859196,1,1,300
80292103@N00,9615,1,1332042261,1332042321,2,4,60
80292103@N00,9615,25,1332045633,1332046394,7,4,761
80292103@N00,9615,11,1332046394,1332046634,2,4,240
80292103@N00,9615,26,1332053034,1332053934,2,4,900
80292103@N00,9616,4,1332110243,1332110344,2,2,101
80292103@N00,9616,21,1332112201,1332112771,2,2,570
80292103@N00,9617,28,1333004694,1333005594,3,1,900
80292103@N00,9618,3,1338686318,1338686408,1,1,90
80292103@N00,9619,27,1353640791,1353641691,7,1,900
80312567@N06,9620,1,1335746704,1335746764,2,1,60
8034015@N04,9621,1,1207323638,1207323698,1,1,60
8034015@N04,9622,1,1207362655,1207362715,2,1,60
8034015@N04,9623,1,1207506876,1207506936,59,1,60
8034015@N04,9624,27,1324325807,1324326707,3,2,900
8034015@N04,9624,25,1324331321,1324332161,1,2,840
8034015@N04,9625,27,1383973352,1383974252,2,2,900
8034015@N04,9625,28,1383999211,1384000111,1,2,900
80371340@N00,9626,29,1308181816,1308182716,1,1,900
80371340@N00,9627,17,1349659631,1349659931,1,1,300
80371340@N00,9628,30,1349761190,1349762270,2,2,1080
80371340@N00,9628,28,1349771913,1349772813,2,2,900
80371340@N00,9629,30,1350016356,1350017436,1,1,1080
80371340@N00,9630,18,1350208459,1350208909,1,1,450
8039966@N05,9631,28,1353843950,1353844850,1,1,900
8039966@N05,9632,13,1360890685,1360890925,1,1,240
8039966@N05,9633,28,1367655008,1367655908,2,2,900
8039966@N05,9633,16,1367665202,1367665472,1,2,270
8039966@N05,9634,15,1385176597,1385176867,4,5,270
8039966@N05,9634,14,1385185248,1385185488,2,5,240
8039966@N05,9634,23,1385192049,1385192649,2,5,600
8039966@N05,9634,17,1385196178,1385196478,2,5,300
8039966@N05,9634,16,1385196613,1385196883,1,5,270
8039966@N05,9635,17,1388362416,1388362716,1,1,300
8039966@N05,9636,14,1390102706,1390102946,1,1,240
8039966@N05,9637,23,1445729861,1445730461,1,1,600
80402035@N00,9638,1,1387014042,1387014102,1,1,60
80412496@N07,9639,1,1377962883,1377962943,1,1,60
80412496@N07,9640,1,1400836792,1400836852,1,1,60
8046157@N06,9641,15,1424137573,1424137843,1,1,270
80468618@N00,9642,24,1421457406,1421458186,1,1,780
80499359@N04,9643,28,1376982250,1376983150,2,2,900
80499359@N04,9643,29,1376987906,1376988806,2,2,900
80499359@N04,9644,26,1408524535,1408525435,1,1,900
80499359@N04,9645,29,1408553993,1408554893,2,3,900
80499359@N04,9645,30,1408567506,1408568586,2,3,1080
80499359@N04,9645,1,1408569904,1408569964,1,3,60
80499359@N04,9646,1,1414383547,1414383607,1,1,60
80505420@N00,9647,17,1241320763,1241321063,7,1,300
8054996@N07,9648,28,1259981559,1259982459,6,7,900
8054996@N07,9648,26,1259984257,1259985157,3,7,900
8054996@N07,9648,29,1259985359,1259985491,3,7,132
8054996@N07,9648,30,1259985491,1259985623,2,7,132
8054996@N07,9648,20,1259985623,1259986163,10,7,540
8054996@N07,9648,25,1259987574,1259988414,24,7,840
8054996@N07,9648,1,1259999611,1259999671,4,7,60
80639660@N00,9649,26,1384868275,1384869175,27,1,900
80639660@N00,9650,26,1385073657,1385074557,1,1,900
80639660@N00,9651,26,1385115468,1385116368,9,1,900
80646560@N00,9652,18,1423292757,1423293207,1,1,450
80658772@N00,9653,1,1428625871,1428625931,2,17,60
80658772@N00,9653,20,1428626017,1428626557,2,17,540
80658772@N00,9653,25,1428626699,1428627322,2,17,623
80658772@N00,9653,26,1428627322,1428628222,3,17,900
80658772@N00,9653,10,1428630178,1428630418,3,17,240
80658772@N00,9653,7,1428631370,1428631550,2,17,180
80658772@N00,9653,21,1428636948,1428637016,2,17,68
80658772@N00,9653,4,1428637016,1428637052,4,17,36
80658772@N00,9653,11,1428637052,1428637292,3,17,240
80658772@N00,9653,21,1428637454,1428638024,2,17,570
80658772@N00,9653,26,1428638389,1428638482,2,17,93
80658772@N00,9653,16,1428638482,1428638681,2,17,199
80658772@N00,9653,28,1428638681,1428639581,2,17,900
80658772@N00,9653,22,1428647794,1428648394,3,17,600
80658772@N00,9653,26,1428653374,1428654274,3,17,900
80658772@N00,9653,10,1428654650,1428654662,3,17,12
80658772@N00,9653,26,1428654662,1428655562,36,17,900
8068421@N07,9654,20,1237717735,1237718275,1,1,540
80685608@N00,9655,30,1293234492,1293235572,3,4,1080
80685608@N00,9655,28,1293236870,1293237770,3,4,900
80685608@N00,9655,29,1293256940,1293257840,2,4,900
80685608@N00,9655,26,1293263877,1293264777,3,4,900
80687988@N00,9656,12,1217027913,1217028153,2,3,240
80687988@N00,9656,28,1217029497,1217029785,2,3,288
80687988@N00,9656,26,1217029785,1217030685,1,3,900
80687988@N00,9657,4,1217257115,1217257216,4,3,101
80687988@N00,9657,18,1217263442,1217263892,2,3,450
80687988@N00,9657,17,1217277841,1217278141,3,3,300
80775532@N06,9658,1,1399939157,1399939217,2,24,60
80775532@N06,9658,28,1399939296,1399940196,2,24,900
80775532@N06,9658,26,1399944304,1399945204,3,24,900
80775532@N06,9658,20,1399945962,1399946343,3,24,381
80775532@N06,9658,31,1399946343,1399947843,2,24,1500
80775532@N06,9658,21,1399951100,1399951448,3,24,348
80775532@N06,9658,13,1399951448,1399951688,3,24,240
80775532@N06,9658,21,1399956419,1399956989,2,24,570
80775532@N06,9658,4,1399957400,1399957501,2,24,101
80775532@N06,9658,18,1399959263,1399959713,2,24,450
80775532@N06,9658,28,1399960694,1399961594,2,24,900
80775532@N06,9658,17,1399961992,1399962292,2,24,300
80775532@N06,9658,15,1399964237,1399964507,3,24,270
80775532@N06,9658,14,1399973679,1399973919,2,24,240
80775532@N06,9658,31,1399974426,1399974448,2,24,22
80775532@N06,9658,22,1399974448,1399974542,4,24,94
80775532@N06,9658,29,1399974542,1399974548,2,24,6
80775532@N06,9658,31,1399974548,1399974657,2,24,109
80775532@N06,9658,29,1399974657,1399974859,5,24,202
80775532@N06,9658,23,1399974859,1399974900,2,24,41
80775532@N06,9658,30,1399974900,1399975247,2,24,347
80775532@N06,9658,28,1399975247,1399975666,6,24,419
80775532@N06,9658,1,1399975666,1399975726,2,24,60
80775532@N06,9658,20,1399976623,1399977163,1,24,540
8088503@N03,9659,28,1345613971,1345614871,2,1,900
8088503@N03,9660,26,1355120714,1355121614,1,1,900
8088503@N03,9661,9,1387415848,1387416028,1,1,180
8090409@N08,9662,1,1364417796,1364417856,2,14,60
8090409@N08,9662,28,1364418784,1364419684,4,14,900
8090409@N08,9662,17,1364421899,1364422199,3,14,300
8090409@N08,9662,29,1364426195,1364427095,3,14,900
8090409@N08,9662,26,1364430454,1364431354,3,14,900
8090409@N08,9662,29,1364432918,1364433818,5,14,900
8090409@N08,9662,17,1364436061,1364436361,2,14,300
8090409@N08,9662,28,1364437381,1364438281,2,14,900
8090409@N08,9662,1,1364446397,1364446457,4,14,60
8090409@N08,9662,19,1364447310,1364447850,2,14,540
8090409@N08,9662,18,1364452225,1364452675,2,14,450
8090409@N08,9662,15,1364456180,1364456450,4,14,270
8090409@N08,9662,22,1364459351,1364459951,3,14,600
8090409@N08,9662,17,1364462316,1364462616,4,14,300
8090769@N06,9663,29,1360285981,1360286881,2,1,900
8090769@N06,9664,20,1360384794,1360385334,2,2,540
8090769@N06,9664,28,1360400807,1360401707,1,2,900
80907784@N00,9665,16,1224327140,1224327410,2,2,270
80907784@N00,9665,27,1224329573,1224330473,2,2,900
80907784@N00,9666,3,1230371493,1230371583,1,1,90
80973446@N02,9667,1,1385968529,1385968589,2,2,60
80973446@N02,9667,26,1385971854,1385972754,1,2,900
80975886@N00,9668,10,1246177123,1246177363,138,1,240
80975886@N00,9669,26,1295255175,1295256075,2,2,900
80975886@N00,9669,28,1295264305,1295265205,1,2,900
80975886@N00,9670,28,1305470523,1305471423,3,1,900
80977395@N00,9671,28,1230972618,1230973518,3,2,900
80977395@N00,9671,26,1230974003,1230974903,3,2,900
8100317@N02,9672,27,1371844102,1371845002,2,2,900
8100317@N02,9672,16,1371845748,1371846018,1,2,270
8100317@N02,9673,17,1377182806,1377183106,1,1,300
8100317@N02,9674,1,1386846193,1386846253,1,1,60
8100317@N02,9675,12,1398857453,1398857693,1,1,240
8100317@N02,9676,31,1415267960,1415269460,1,1,1500
8101809@N08,9677,10,1329604148,1329604388,2,4,240
8101809@N08,9677,13,1329605278,1329605518,3,4,240
8101809@N08,9677,21,1329606188,1329606758,2,4,570
8101809@N08,9677,1,1329608365,1329608425,1,4,60
8101809@N08,9678,1,1329692886,1329692946,6,3,60
8101809@N08,9678,8,1329697127,1329697307,2,3,180
8101809@N08,9678,30,1329704121,1329705201,1,3,1080
8101809@N08,9679,28,1356927951,1356928208,7,5,257
8101809@N08,9679,1,1356928208,1356928268,23,5,60
8101809@N08,9679,28,1356929058,1356929185,7,5,127
8101809@N08,9679,1,1356929185,1356929245,7,5,60
8101809@N08,9679,28,1356929314,1356930214,1,5,900
8101809@N08,9680,21,1356991854,1356992424,3,2,570
8101809@N08,9680,27,1357009168,1357010068,3,2,900
81039954@N05,9681,29,1373958774,1373959674,3,4,900
81039954@N05,9681,12,1373965375,1373965615,2,4,240
81039954@N05,9681,27,1373967631,1373968531,2,4,900
81039954@N05,9681,28,1373971864,1373972764,1,4,900
81039954@N05,9682,23,1374036664,1374037264,2,6,600
81039954@N05,9682,12,1374037593,1374037833,2,6,240
81039954@N05,9682,27,1374038248,1374038933,2,6,685
81039954@N05,9682,17,1374038933,1374039233,2,6,300
81039954@N05,9682,1,1374039649,1374039709,2,6,60
81039954@N05,9682,15,1374043942,1374044212,1,6,270
81068258@N02,9683,21,1330495457,1330496027,1,1,570
81068258@N02,9684,23,1335943331,1335943931,1,1,600
8109836@N08,9685,21,1310691884,1310692454,2,2,570
8109836@N08,9685,25,1310701286,1310702126,1,2,840
8117728@N07,9686,23,1328915368,1328915968,14,5,600
8117728@N07,9686,29,1328916130,1328916246,3,5,116
8117728@N07,9686,23,1328916246,1328916340,3,5,94
8117728@N07,9686,19,1328916340,1328916880,5,5,540
8117728@N07,9686,23,1328916893,1328917493,13,5,600
81183458@N00,9687,1,1348269701,1348269761,2,3,60
81183458@N00,9687,26,1348270209,1348271109,2,3,900
81183458@N00,9687,3,1348277133,1348277223,1,3,90
81197180@N00,9688,20,1353660838,1353661378,1,1,540
81197180@N00,9689,26,1353770940,1353771840,1,1,900
81197180@N00,9690,28,1354007864,1354008764,1,1,900
81197180@N00,9691,31,1422753466,1422754966,2,8,1500
81197180@N00,9691,1,1422761318,1422761378,2,8,60
81197180@N00,9691,16,1422764173,1422764443,2,8,270
81197180@N00,9691,17,1422766069,1422766369,3,8,300
81197180@N00,9691,7,1422771786,1422771966,2,8,180
81197180@N00,9691,9,1422772212,1422772392,2,8,180
81197180@N00,9691,30,1422772802,1422773882,2,8,1080
81197180@N00,9691,19,1422775079,1422775619,1,8,540
81232363@N00,9692,26,1251541705,1251542605,3,1,900
81232363@N00,9693,1,1251578664,1251578724,2,8,60
81232363@N00,9693,28,1251578759,1251578957,3,8,198
81232363@N00,9693,26,1251578957,1251579857,3,8,900
81232363@N00,9693,29,1251580895,1251581795,2,8,900
81232363@N00,9693,25,1251588164,1251589004,2,8,840
81232363@N00,9693,13,1251589217,1251589457,2,8,240
81232363@N00,9693,28,1251594545,1251595445,2,8,900
81232363@N00,9693,26,1251618666,1251619566,1,8,900
81232363@N00,9694,28,1299358889,1299359789,2,5,900
81232363@N00,9694,29,1299376580,1299377480,2,5,900
81232363@N00,9694,28,1299380385,1299381285,2,5,900
81232363@N00,9694,12,1299382884,1299383124,2,5,240
81232363@N00,9694,26,1299388765,1299389665,3,5,900
81281582@N07,9695,26,1278903426,1278904326,9,1,900
81281582@N07,9696,26,1291122000,1291122900,14,1,900
81281582@N07,9697,26,1307882225,1307883125,2,1,900
81281582@N07,9698,26,1314405513,1314406413,1,1,900
81281582@N07,9699,26,1320417841,1320418741,20,1,900
81281582@N07,9700,23,1321539053,1321539063,2,4,10
81281582@N07,9700,26,1321539063,1321539963,23,4,900
81281582@N07,9700,23,1321553469,1321553608,2,4,139
81281582@N07,9700,26,1321553608,1321554508,7,4,900
81281582@N07,9701,26,1325458785,1325459685,1,1,900
81281582@N07,9702,26,1325961871,1325962771,4,2,900
81281582@N07,9702,23,1325964458,1325965058,2,2,600
81281582@N07,9703,26,1327034231,1327035131,17,1,900
81281582@N07,9704,21,1330598295,1330598301,2,2,6
81281582@N07,9704,26,1330598301,1330599201,2,2,900
81281582@N07,9705,26,1331370313,1331371213,4,1,900
81281582@N07,9706,23,1340634508,1340635108,10,3,600
81281582@N07,9706,26,1340637258,1340638158,2,3,900
81281582@N07,9706,23,1340641927,1340642527,6,3,600
81281582@N07,9707,26,1340755651,1340756551,1,1,900
81281582@N07,9708,26,1340847786,1340848686,1,1,900
81281582@N07,9709,26,1340927429,1340928329,1,1,900
81281582@N07,9710,26,1342045310,1342046210,2,1,900
81281582@N07,9711,26,1342433621,1342434521,1,1,900
81281582@N07,9712,26,1350683253,1350684153,1,1,900
81281582@N07,9713,26,1350735366,1350736266,1,1,900
81281582@N07,9714,26,1357348170,1357349070,1,1,900
81281582@N07,9715,26,1360846998,1360847898,13,1,900
81281582@N07,9716,26,1360924809,1360925709,16,1,900
81281582@N07,9717,26,1361624478,1361625378,3,1,900
81281582@N07,9718,26,1361692011,1361692911,44,1,900
81281582@N07,9719,26,1363314898,1363315798,38,1,900
81281582@N07,9720,26,1365742127,1365743027,32,1,900
81281582@N07,9721,10,1370476718,1370476958,2,16,240
81281582@N07,9721,25,1370480570,1370481410,2,16,840
81281582@N07,9721,26,1370481563,1370481815,2,16,252
81281582@N07,9721,1,1370481815,1370481875,3,16,60
81281582@N07,9721,26,1370482689,1370483589,2,16,900
81281582@N07,9721,30,1370483975,1370484071,2,16,96
81281582@N07,9721,26,1370484071,1370484783,2,16,712
81281582@N07,9721,23,1370484783,1370485383,2,16,600
81281582@N07,9721,30,1370486513,1370487212,3,16,699
81281582@N07,9721,26,1370487212,1370488112,5,16,900
81281582@N07,9721,30,1370491056,1370491066,2,16,10
81281582@N07,9721,10,1370491066,1370491306,2,16,240
81281582@N07,9721,5,1370492205,1370492325,2,16,120
81281582@N07,9721,26,1370494241,1370494289,3,16,48
81281582@N07,9721,10,1370494289,1370494529,2,16,240
81281582@N07,9721,26,1370497252,1370498152,8,16,900
81291546@N02,9722,28,1372181251,1372182151,1,1,900
81292745@N00,9723,30,1252913796,1252914876,2,3,1080
81292745@N00,9723,26,1252924389,1252925289,3,3,900
81292745@N00,9723,28,1252934930,1252935830,1,3,900
81322238@N00,9724,28,1257457749,1257458649,2,18,900
81322238@N00,9724,31,1257461150,1257461194,4,18,44
81322238@N00,9724,20,1257461194,1257461527,11,18,333
81322238@N00,9724,31,1257461527,1257462023,4,18,496
81322238@N00,9724,22,1257462023,1257462497,8,18,474
81322238@N00,9724,20,1257462497,1257462756,11,18,259
81322238@N00,9724,22,1257462756,1257462918,6,18,162
81322238@N00,9724,14,1257462918,1257463158,5,18,240
81322238@N00,9724,22,1257463459,1257463562,8,18,103
81322238@N00,9724,20,1257463562,1257464102,25,18,540
81322238@N00,9724,31,1257464996,1257465119,3,18,123
81322238@N00,9724,22,1257465119,1257465376,2,18,257
81322238@N00,9724,31,1257465376,1257465811,4,18,435
81322238@N00,9724,30,1257465811,1257466083,10,18,272
81322238@N00,9724,31,1257466083,1257466969,2,18,886
81322238@N00,9724,29,1257466969,1257467869,20,18,900
81322238@N00,9724,28,1257468215,1257468383,2,18,168
81322238@N00,9724,1,1257468383,1257468443,3,18,60
81348276@N05,9725,1,1449699105,1449699165,2,3,60
81348276@N05,9725,28,1449699167,1449700067,2,3,900
81348276@N05,9725,29,1449705239,1449706139,1,3,900
81348276@N05,9726,29,1459913348,1459914248,2,2,900
81348276@N05,9726,30,1459919518,1459920598,2,2,1080
81348276@N05,9727,26,1462147668,1462148568,2,4,900
81348276@N05,9727,29,1462154707,1462155607,4,4,900
81348276@N05,9727,19,1462159357,1462159897,2,4,540
81348276@N05,9727,17,1462163742,1462164042,1,4,300
81348276@N05,9728,23,1464256781,1464257381,2,2,600
81348276@N05,9728,30,1464262714,1464263794,1,2,1080
81348276@N05,9729,1,1465186299,1465186359,1,1,60
81428527@N00,9730,28,1267845301,1267846201,1,1,900
81549686@N02,9731,18,1341883961,1341884289,2,2,328
81549686@N02,9731,26,1341884289,1341885189,1,2,900
81549686@N02,9732,28,1342348853,1342349753,2,3,900
81549686@N02,9732,11,1342351421,1342351558,2,3,137
81549686@N02,9732,12,1342351558,1342351798,1,3,240
81587683@N00,9733,7,1350795523,1350795703,1,1,180
81587683@N00,9734,7,1350903843,1350904023,2,2,180
81587683@N00,9734,13,1350910292,1350910532,1,2,240
8164738@N04,9735,21,1293756354,1293756924,1,1,570
81704044@N06,9736,30,1352700118,1352701198,1,1,1080
81704044@N06,9737,29,1362042579,1362043479,1,1,900
81704044@N06,9738,26,1365591538,1365592438,1,1,900
81704044@N06,9739,30,1366720379,1366721459,1,1,1080
81704044@N06,9740,12,1367136864,1367137104,1,1,240
81704044@N06,9741,15,1367675195,1367675465,1,1,270
81704044@N06,9742,15,1367707968,1367708238,1,1,270
81704044@N06,9743,30,1369521439,1369522519,1,1,1080
81704044@N06,9744,18,1371730478,1371730928,3,1,450
81704044@N06,9745,18,1374056743,1374057193,1,1,450
81704044@N06,9746,20,1375601231,1375601771,1,1,540
81704044@N06,9747,25,1377386430,1377387270,1,1,840
81704044@N06,9748,15,1379196167,1379196437,1,1,270
81704044@N06,9749,29,1380608855,1380609755,1,1,900
81704044@N06,9750,28,1385357314,1385358214,1,1,900
81704044@N06,9751,20,1386047990,1386048530,1,1,540
81704044@N06,9752,30,1387882780,1387883860,1,1,1080
81704044@N06,9753,29,1391407181,1391408081,1,1,900
81706316@N00,9754,8,1195212066,1195212246,4,1,180
81706316@N00,9755,8,1195253292,1195253472,19,1,180
81711337@N00,9756,29,1337840233,1337841133,3,6,900
81711337@N00,9756,6,1337845497,1337845617,2,6,120
81711337@N00,9756,8,1337846944,1337846955,2,6,11
81711337@N00,9756,6,1337846955,1337847075,3,6,120
81711337@N00,9756,26,1337848396,1337849296,2,6,900
81711337@N00,9756,16,1337855019,1337855289,2,6,270
8171888@N03,9757,28,1374834541,1374834600,3,2,59
8171888@N03,9757,25,1374834600,1374835440,2,2,840
8174873@N02,9758,26,1239249388,1239250052,3,11,664
8174873@N02,9758,27,1239250052,1239250952,7,11,900
8174873@N02,9758,26,1239252118,1239253018,4,11,900
8174873@N02,9758,17,1239253075,1239253375,8,11,300
8174873@N02,9758,12,1239256810,1239257050,6,11,240
8174873@N02,9758,22,1239261088,1239261688,4,11,600
8174873@N02,9758,30,1239262774,1239263854,3,11,1080
8174873@N02,9758,10,1239265801,1239266041,6,11,240
8174873@N02,9758,30,1239266939,1239267096,2,11,157
8174873@N02,9758,15,1239267096,1239267366,3,11,270
8174873@N02,9758,12,1239269560,1239269800,1,11,240
8176893@N08,9759,13,1371270034,1371270274,1,1,240
81771394@N02,9760,26,1377131386,1377132286,1,1,900
81812513@N00,9761,26,1274916613,1274917513,3,1,900
81827168@N00,9762,11,1333926317,1333926557,3,4,240
81827168@N00,9762,24,1333937305,1333938085,2,4,780
81827168@N00,9762,18,1333957180,1333957630,2,4,450
81827168@N00,9762,26,1333966896,1333967796,1,4,900
81855582@N00,9763,19,1213786605,1213787145,1,1,540
8188436@N08,9764,24,1245542282,1245543062,3,2,780
8188436@N08,9764,28,1245546734,1245547634,3,2,900
8188436@N08,9765,26,1245627143,1245628043,5,7,900
8188436@N08,9765,25,1245629545,1245630385,4,7,840
8188436@N08,9765,4,1245630780,1245630881,2,7,101
8188436@N08,9765,19,1245633685,1245634225,4,7,540
8188436@N08,9765,29,1245643252,1245644152,3,7,900
8188436@N08,9765,24,1245650631,1245651411,2,7,780
8188436@N08,9765,28,1245654870,1245655770,1,7,900
8188436@N08,9766,23,1245756613,1245757213,3,1,600
8188436@N08,9767,12,1245802646,1245802886,3,1,240
8188436@N08,9768,16,1359091664,1359091934,1,1,270
8188436@N08,9769,28,1359153930,1359154830,4,4,900
8188436@N08,9769,29,1359164370,1359165270,2,4,900
8188436@N08,9769,15,1359176700,1359176722,2,4,22
8188436@N08,9769,24,1359176722,1359177502,1,4,780
8192409@N06,9770,28,1331289935,1331290835,1,1,900
8192409@N06,9771,13,1334909975,1334910215,1,1,240
8192409@N06,9772,28,1336643088,1336643988,1,1,900
8192409@N06,9773,7,1336904779,1336904959,2,1,180
8192409@N06,9774,1,1350748715,1350748775,1,1,60
8192409@N06,9775,18,1358142346,1358142796,1,1,450
8192409@N06,9776,28,1359626284,1359627184,1,1,900
8192409@N06,9777,14,1367877039,1367877279,1,1,240
8192409@N06,9778,11,1381379479,1381379719,1,1,240
8192409@N06,9779,1,1386406555,1386406615,1,1,60
8192409@N06,9780,1,1389070821,1389070881,2,1,60
8192409@N06,9781,1,1389775450,1389775510,2,1,60
8192409@N06,9782,19,1408954614,1408955154,2,1,540
8192409@N06,9783,28,1409626197,1409627097,2,2,900
8192409@N06,9783,19,1409645574,1409646114,2,2,540
8192409@N06,9784,3,1412652838,1412652928,1,1,90
82022162@N05,9785,1,1370154951,1370155011,2,1,60
82046952@N00,9786,17,1348194256,1348194556,33,1,300
82064146@N00,9787,18,1224145683,1224146133,1,1,450
82072659@N00,9788,12,1231667837,1231668077,1,1,240
82072659@N00,9789,12,1231752246,1231752486,1,1,240
82122838@N00,9790,28,1252492373,1252493273,1,1,900
82207382@N00,9791,15,1280550498,1280550768,2,2,270
82207382@N00,9791,23,1280561837,1280562437,1,2,600
8227117@N08,9792,30,1196963111,1196964191,1,1,1080
82297923@N00,9793,17,1369890473,1369890773,1,1,300
82316004@N00,9794,29,1287117370,1287118270,3,2,900
82316004@N00,9794,3,1287136166,1287136256,1,2,90
82339538@N00,9795,26,1333106681,1333107581,1,1,900
82418556@N00,9796,28,1289643259,1289644159,3,4,900
82418556@N00,9796,25,1289645986,1289646826,2,4,840
82418556@N00,9796,20,1289647037,1289647577,3,4,540
82418556@N00,9796,28,1289650933,1289651833,2,4,900
82418556@N00,9797,23,1307353370,1307353970,3,4,600
82418556@N00,9797,18,1307356551,1307357001,2,4,450
82418556@N00,9797,5,1307358692,1307358812,3,4,120
82418556@N00,9797,28,1307367253,1307368153,2,4,900
82418556@N00,9798,5,1307877872,1307877977,2,6,105
82418556@N00,9798,28,1307877977,1307878877,2,6,900
82418556@N00,9798,27,1307879617,1307880517,8,6,900
82418556@N00,9798,26,1307882825,1307883725,2,6,900
82418556@N00,9798,8,1307884476,1307884656,3,6,180
82418556@N00,9798,28,1307885112,1307886012,1,6,900
82418556@N00,9799,1,1310467222,1310467282,4,6,60
82418556@N00,9799,27,1310468675,1310469226,4,6,551
82418556@N00,9799,15,1310469226,1310469496,2,6,270
82418556@N00,9799,27,1310470017,1310470917,5,6,900
82418556@N00,9799,15,1310472035,1310472305,2,6,270
82418556@N00,9799,28,1310474349,1310475249,2,6,900
82418556@N00,9800,1,1328340573,1328340577,2,6,4
82418556@N00,9800,27,1328340577,1328341477,2,6,900
82418556@N00,9800,6,1328345248,1328345368,4,6,120
82418556@N00,9800,9,1328345935,1328346115,2,6,180
82418556@N00,9800,4,1328347785,1328347886,2,6,101
82418556@N00,9800,29,1328355463,1328356363,1,6,900
82418556@N00,9801,28,1330518607,1330519507,2,1,900
82418556@N00,9802,26,1337488073,1337488973,2,4,900
82418556@N00,9802,28,1337489350,1337490250,2,4,900
82418556@N00,9802,26,1337492393,1337492438,2,4,45
82418556@N00,9802,27,1337492438,1337493338,1,4,900
82418556@N00,9803,28,1342086004,1342086904,1,1,900
82418556@N00,9804,28,1346498228,1346499128,4,6,900
82418556@N00,9804,7,1346532882,1346532967,2,6,85
82418556@N00,9804,26,1346532967,1346533235,2,6,268
82418556@N00,9804,15,1346533235,1346533505,3,6,270
82418556@N00,9804,13,1346533787,1346534027,2,6,240
82418556@N00,9804,28,1346543120,1346544020,1,6,900
82418556@N00,9805,28,1361071003,1361071903,2,2,900
82418556@N00,9805,26,1361072277,1361073177,1,2,900
82418556@N00,9806,1,1364704779,1364704839,3,5,60
82418556@N00,9806,7,1364719323,1364719503,2,5,180
82418556@N00,9806,27,1364719865,1364720765,2,5,900
82418556@N00,9806,17,1364730594,1364730894,2,5,300
82418556@N00,9806,26,1364733028,1364733928,1,5,900
82418556@N00,9807,28,1364801024,1364801924,1,1,900
82418556@N00,9808,1,1369407317,1369407377,2,12,60
82418556@N00,9808,28,1369407576,1369407899,2,12,323
82418556@N00,9808,26,1369407899,1369408799,2,12,900
82418556@N00,9808,24,1369409173,1369409668,2,12,495
82418556@N00,9808,3,1369409668,1369409758,2,12,90
82418556@N00,9808,26,1369410209,1369411109,2,12,900
82418556@N00,9808,1,1369414442,1369414502,2,12,60
82418556@N00,9808,20,1369416906,1369417446,2,12,540
82418556@N00,9808,29,1369417896,1369418796,2,12,900
82418556@N00,9808,17,1369420070,1369420370,2,12,300
82418556@N00,9808,26,1369424026,1369424926,2,12,900
82418556@N00,9808,1,1369425759,1369425819,1,12,60
82418556@N00,9809,5,1371979660,1371979780,3,3,120
82418556@N00,9809,23,1371982972,1371983572,2,3,600
82418556@N00,9809,28,1371987903,1371988803,1,3,900
82418556@N00,9810,28,1377896860,1377897626,2,6,766
82418556@N00,9810,13,1377897626,1377897686,2,6,60
82418556@N00,9810,3,1377897686,1377897776,3,6,90
82418556@N00,9810,26,1377898578,1377898636,2,6,58
82418556@N00,9810,30,1377898636,1377899716,2,6,1080
82418556@N00,9810,26,1377900847,1377901747,1,6,900
82418556@N00,9811,15,1377980156,1377980199,2,2,43
82418556@N00,9811,7,1377980199,1377980379,1,2,180
82418556@N00,9812,28,1379076241,1379077141,3,5,900
82418556@N00,9812,20,1379081683,1379081873,2,5,190
82418556@N00,9812,26,1379081873,1379082773,2,5,900
82418556@N00,9812,30,1379082968,1379084048,2,5,1080
82418556@N00,9812,1,1379085190,1379085250,1,5,60
82418556@N00,9813,26,1393911216,1393911604,2,5,388
82418556@N00,9813,15,1393911604,1393911874,3,5,270
82418556@N00,9813,29,1393914173,1393915073,2,5,900
82418556@N00,9813,15,1393919564,1393919834,2,5,270
82418556@N00,9813,27,1393925577,1393926477,1,5,900
82418556@N00,9814,26,1397037924,1397038824,2,2,900
82418556@N00,9814,27,1397051004,1397051904,1,2,900
82418556@N00,9815,15,1400242761,1400243031,1,1,270
82418556@N00,9816,20,1400388976,1400389516,2,2,540
82418556@N00,9816,1,1400400438,1400400498,1,2,60
82418556@N00,9817,23,1400867979,1400868579,2,3,600
82418556@N00,9817,27,1400872689,1400873589,2,3,900
82418556@N00,9817,1,1400875691,1400875751,1,3,60
82418556@N00,9818,28,1400999722,1401000622,2,4,900
82418556@N00,9818,15,1401004870,1401005140,4,4,270
82418556@N00,9818,20,1401013243,1401013783,3,4,540
82418556@N00,9818,28,1401014566,1401015466,1,4,900
82418556@N00,9819,20,1401110874,1401111035,3,3,161
82418556@N00,9819,26,1401111035,1401111935,2,3,900
82418556@N00,9819,28,1401114099,1401114999,1,3,900
82418556@N00,9820,7,1401630381,1401630561,3,2,180
82418556@N00,9820,26,1401633382,1401634282,1,2,900
82418556@N00,9821,14,1402042766,1402043006,3,3,240
82418556@N00,9821,6,1402065011,1402065131,2,3,120
82418556@N00,9821,26,1402065242,1402066142,1,3,900
82418556@N00,9822,28,1403355740,1403356640,2,1,900
82418556@N00,9823,30,1403425647,1403426727,1,1,1080
82418556@N00,9824,15,1404029571,1404029841,1,1,270
82418556@N00,9825,19,1405227316,1405227856,2,4,540
82418556@N00,9825,30,1405230044,1405231124,2,4,1080
82418556@N00,9825,17,1405232531,1405232831,2,4,300
82418556@N00,9825,26,1405233232,1405234132,1,4,900
82418556@N00,9826,26,1405577802,1405578702,2,2,900
82418556@N00,9826,17,1405600373,1405600673,2,2,300
82418556@N00,9827,26,1405842300,1405843200,2,2,900
82418556@N00,9827,19,1405865871,1405866411,1,2,540
82418556@N00,9828,19,1406428194,1406428734,2,4,540
82418556@N00,9828,3,1406433365,1406433455,2,4,90
82418556@N00,9828,16,1406449082,1406449352,2,4,270
82418556@N00,9828,26,1406449370,1406450270,1,4,900
82418556@N00,9829,27,1406721564,1406722464,1,1,900
82418556@N00,9830,28,1407043509,1407044409,2,2,900
82418556@N00,9830,4,1407044528,1407044629,1,2,101
82418556@N00,9831,18,1408011866,1408012316,2,2,450
82418556@N00,9831,28,1408032603,1408033503,1,2,900
82418556@N00,9832,19,1408843610,1408844150,2,7,540
82418556@N00,9832,13,1408851264,1408851504,2,7,240
82418556@N00,9832,20,1408869675,1408870215,2,7,540
82418556@N00,9832,14,1408870245,1408870485,3,7,240
82418556@N00,9832,20,1408881908,1408882448,2,7,540
82418556@N00,9832,16,1408883935,1408884205,2,7,270
82418556@N00,9832,13,1408885232,1408885472,1,7,240
82418556@N00,9833,23,1409256256,1409256856,2,2,600
82418556@N00,9833,19,1409257519,1409258059,1,2,540
82418556@N00,9834,25,1409343624,1409344464,1,1,840
82418556@N00,9835,15,1409429252,1409429522,3,5,270
82418556@N00,9835,21,1409429993,1409430392,2,5,399
82418556@N00,9835,25,1409430392,1409431232,2,5,840
82418556@N00,9835,28,1409444950,1409445268,2,5,318
82418556@N00,9835,19,1409445268,1409445808,1,5,540
82418556@N00,9836,27,1410087248,1410088148,2,2,900
82418556@N00,9836,1,1410091260,1410091320,1,2,60
82418556@N00,9837,20,1410679958,1410680498,3,4,540
82418556@N00,9837,17,1410686940,1410687083,2,4,143
82418556@N00,9837,28,1410687083,1410687983,2,4,900
82418556@N00,9837,20,1410705103,1410705643,1,4,540
82418556@N00,9838,30,1411273037,1411274117,1,1,1080
82418556@N00,9839,3,1411913877,1411913967,1,1,90
82418556@N00,9840,28,1412325823,1412326723,1,1,900
82418556@N00,9841,19,1412395186,1412395726,2,5,540
82418556@N00,9841,28,1412395795,1412396695,2,5,900
82418556@N00,9841,26,1412396697,1412397597,2,5,900
82418556@N00,9841,20,1412399958,1412400498,2,5,540
82418556@N00,9841,26,1412406946,1412407846,1,5,900
82418556@N00,9842,15,1412491031,1412491301,2,2,270
82418556@N00,9842,29,1412511662,1412512562,1,2,900
82418556@N00,9843,26,1412550085,1412550985,1,1,900
82418556@N00,9844,19,1412643843,1412644383,1,1,540
82418556@N00,9845,3,1412680176,1412680266,1,1,90
82418556@N00,9846,27,1413185714,1413186614,2,3,900
82418556@N00,9846,30,1413189191,1413190271,2,3,1080
82418556@N00,9846,28,1413198285,1413199185,1,3,900
82418556@N00,9847,27,1413722692,1413722876,2,3,184
82418556@N00,9847,30,1413722876,1413723031,2,3,155
82418556@N00,9847,28,1413723031,1413723931,1,3,900
82418556@N00,9848,15,1418562884,1418563154,1,1,270
82418556@N00,9849,3,1420541679,1420541769,1,1,90
82418556@N00,9850,27,1421319962,1421320862,1,1,900
82418556@N00,9851,18,1425193235,1425193685,1,1,450
82418556@N00,9852,28,1425818192,1425819092,1,1,900
82418556@N00,9853,27,1427022423,1427023323,1,1,900
82418556@N00,9854,18,1433081557,1433082007,1,1,450
82418556@N00,9855,18,1435456731,1435457181,1,1,450
82418556@N00,9856,23,1436080296,1436080896,1,1,600
82418556@N00,9857,28,1437083499,1437084399,1,1,900
82418556@N00,9858,26,1437114673,1437115573,1,1,900
82418556@N00,9859,18,1437292874,1437293324,1,1,450
82418556@N00,9860,18,1439094996,1439095446,2,2,450
82418556@N00,9860,6,1439102267,1439102387,1,2,120
82418556@N00,9861,18,1440913290,1440913740,1,1,450
82418556@N00,9862,20,1441984426,1441984966,1,1,540
82418556@N00,9863,18,1443084592,1443085042,1,1,450
82418556@N00,9864,26,1445150197,1445151097,1,1,900
82418556@N00,9865,18,1446942462,1446942912,1,1,450
82418556@N00,9866,26,1447540095,1447540995,1,1,900
82418556@N00,9867,15,1447625630,1447625900,2,2,270
82418556@N00,9867,24,1447648951,1447649731,1,2,780
82418556@N00,9868,15,1449402380,1449402650,1,1,270
8245538@N06,9869,28,1289619473,1289619839,2,4,366
8245538@N06,9869,16,1289619839,1289620109,4,4,270
8245538@N06,9869,4,1289622642,1289622743,3,4,101
8245538@N06,9869,25,1289624171,1289625011,1,4,840
82467308@N06,9870,17,1376978862,1376979162,2,2,300
82467308@N06,9870,15,1376983774,1376984044,2,2,270
82467308@N06,9871,1,1377092118,1377092178,1,1,60
8251903@N03,9872,29,1204696058,1204696958,55,1,900
8251903@N03,9873,11,1340855175,1340855415,1,1,240
8251903@N03,9874,28,1352974068,1352974968,2,1,900
8251903@N03,9875,1,1354980371,1354980431,1,1,60
82522210@N03,9876,29,1357495406,1357496306,1,1,900
82588563@N04,9877,29,1412071084,1412071984,1,1,900
82590360@N05,9878,26,1364295094,1364295994,1,1,900
82646317@N00,9879,19,1406944617,1406945157,2,3,540
82646317@N00,9879,30,1406949226,1406950306,2,3,1080
82646317@N00,9879,19,1406950554,1406951094,2,3,540
82646317@N00,9880,19,1420072704,1420073244,5,1,540
82646317@N00,9881,18,1435396811,1435397261,1,1,450
82744213@N00,9882,28,1345959693,1345960593,1,1,900
82779205@N00,9883,26,1395977995,1395978895,2,2,900
82779205@N00,9883,28,1395996987,1395997887,2,2,900
82779205@N00,9884,26,1396140123,1396140615,2,2,492
82779205@N00,9884,3,1396140615,1396140705,1,2,90
82792996@N07,9885,26,1405146747,1405147647,1,1,900
82841979@N04,9886,18,1457931701,1457932151,1,1,450
8284264@N04,9887,27,1301095792,1301096692,1,1,900
82878973@N08,9888,13,1361499779,1361500019,1,1,240
82878973@N08,9889,29,1365732049,1365732949,1,1,900
82878973@N08,9890,16,1371296416,1371296503,2,3,87
82878973@N08,9890,27,1371296503,1371296605,5,3,102
82878973@N08,9890,16,1371296605,1371296875,3,3,270
82878973@N08,9891,27,1371357899,1371358799,1,1,900
82878973@N08,9892,27,1374930447,1374930539,2,2,92
82878973@N08,9892,16,1374930539,1374930809,1,2,270
82878973@N08,9893,30,1391391741,1391392821,1,1,1080
82878973@N08,9894,21,1415317926,1415318396,2,4,470
82878973@N08,9894,30,1415318396,1415319476,3,4,1080
82878973@N08,9894,31,1415319853,1415319911,4,4,58
82878973@N08,9894,29,1415319911,1415320811,1,4,900
82878973@N08,9895,16,1415581651,1415581673,2,2,22
82878973@N08,9895,1,1415581673,1415581733,1,2,60
82878973@N08,9896,1,1420519709,1420519769,1,1,60
82878973@N08,9897,19,1434938231,1434938771,1,1,540
82878973@N08,9898,28,1454824490,1454825390,2,1,900
82878973@N08,9899,26,1465714392,1465715292,1,1,900
82895447@N08,9900,28,1348637867,1348638767,2,1,900
8289999@N07,9901,18,1262002207,1262002657,1,1,450
8289999@N07,9902,25,1410398492,1410399332,2,2,840
8289999@N07,9902,19,1410400087,1410400627,3,2,540
8289999@N07,9903,18,1442880356,1442880806,2,3,450
8289999@N07,9903,13,1442882078,1442882318,2,3,240
8289999@N07,9903,18,1442884255,1442884705,1,3,450
8289999@N07,9904,18,1458781390,1458781840,1,1,450
82919069@N04,9905,21,1434065980,1434066550,2,6,570
82919069@N04,9905,26,1434070298,1434071198,2,6,900
82919069@N04,9905,14,1434078053,1434078293,2,6,240
82919069@N04,9905,16,1434084821,1434085091,3,6,270
82919069@N04,9905,15,1434087399,1434087669,2,6,270
82919069@N04,9905,26,1434096503,1434097403,1,6,900
8298711@N08,9906,1,1223076203,1223076263,2,10,60
8298711@N08,9906,28,1223076293,1223077193,2,10,900
8298711@N08,9906,20,1223080803,1223081343,3,10,540
8298711@N08,9906,18,1223085264,1223085714,2,10,450
8298711@N08,9906,28,1223086198,1223087098,2,10,900
8298711@N08,9906,22,1223089976,1223090576,9,10,600
8298711@N08,9906,24,1223092788,1223093181,7,10,393
8298711@N08,9906,15,1223093181,1223093451,2,10,270
8298711@N08,9906,24,1223095097,1223095877,2,10,780
8298711@N08,9906,28,1223097955,1223098855,1,10,900
8298711@N08,9907,28,1223171666,1223172566,3,1,900
8298711@N08,9908,12,1254523238,1254523478,2,3,240
8298711@N08,9908,25,1254531577,1254532417,3,3,840
8298711@N08,9908,26,1254540982,1254541882,1,3,900
8305696@N06,9909,23,1299901931,1299902531,1,1,600
8307506@N03,9910,10,1191673351,1191673591,1,1,240
83081410@N05,9911,29,1342754302,1342755202,1,1,900
83081410@N05,9912,29,1343439646,1343440546,1,1,900
83104438@N02,9913,19,1407234484,1407235024,1,1,540
8312262@N03,9914,1,1451263538,1451263598,2,10,60
8312262@N03,9914,16,1451264373,1451264643,2,10,270
8312262@N03,9914,26,1451264660,1451265504,3,10,844
8312262@N03,9914,13,1451265504,1451265744,20,10,240
8312262@N03,9914,25,1451268551,1451268561,2,10,10
8312262@N03,9914,21,1451268561,1451269131,2,10,570
8312262@N03,9914,11,1451270127,1451270262,4,10,135
8312262@N03,9914,4,1451270262,1451270292,3,10,30
8312262@N03,9914,11,1451270292,1451270389,3,10,97
8312262@N03,9914,4,1451270389,1451270490,1,10,101
8312262@N03,9915,7,1451335318,1451335498,2,10,180
8312262@N03,9915,20,1451337466,1451338006,2,10,540
8312262@N03,9915,19,1451338646,1451338684,2,10,38
8312262@N03,9915,29,1451338684,1451339584,2,10,900
8312262@N03,9915,25,1451340408,1451341248,23,10,840
8312262@N03,9915,13,1451342679,1451342919,2,10,240
8312262@N03,9915,3,1451344190,1451344280,6,10,90
8312262@N03,9915,18,1451347691,1451348141,3,10,450
8312262@N03,9915,19,1451348273,1451348595,3,10,322
8312262@N03,9915,18,1451348595,1451349045,2,10,450
8312262@N03,9916,15,1451425091,1451425361,3,6,270
8312262@N03,9916,24,1451425805,1451426585,5,6,780
8312262@N03,9916,12,1451427185,1451427309,6,6,124
8312262@N03,9916,24,1451427309,1451428089,2,6,780
8312262@N03,9916,4,1451430425,1451430526,3,6,101
8312262@N03,9916,13,1451434140,1451434380,4,6,240
83166333@N00,9917,28,1325404694,1325405594,1,1,900
83166333@N00,9918,26,1350897061,1350897961,1,1,900
83209367@N00,9919,26,1207792801,1207792802,2,16,1
83209367@N00,9919,27,1207792802,1207792803,2,16,1
83209367@N00,9919,10,1207792803,1207792804,2,16,1
83209367@N00,9919,22,1207792804,1207792805,2,16,1
83209367@N00,9919,31,1207792805,1207792806,2,16,1
83209367@N00,9919,14,1207792806,1207792807,2,16,1
83209367@N00,9919,31,1207792807,1207792808,2,16,1
83209367@N00,9919,29,1207792808,1207792809,2,16,1
83209367@N00,9919,1,1207792809,1207792810,2,16,1
83209367@N00,9919,16,1207792810,1207792811,2,16,1
83209367@N00,9919,22,1207792811,1207792812,2,16,1
83209367@N00,9919,13,1207792812,1207792813,2,16,1
83209367@N00,9919,26,1207792813,1207792814,2,16,1
83209367@N00,9919,28,1207792814,1207792815,2,16,1
83209367@N00,9919,26,1207792815,1207792817,3,16,2
83209367@N00,9919,28,1207792817,1207793717,2,16,900
83209367@N00,9920,26,1225151606,1225152506,3,6,900
83209367@N00,9920,17,1225153635,1225153935,3,6,300
83209367@N00,9920,26,1225153998,1225154069,2,6,71
83209367@N00,9920,31,1225154069,1225154189,2,6,120
83209367@N00,9920,22,1225154189,1225154357,3,6,168
83209367@N00,9920,29,1225154357,1225155257,2,6,900
83286805@N00,9921,30,1217117473,1217118553,1,1,1080
83286805@N00,9922,29,1223527439,1223527702,2,3,263
83286805@N00,9922,28,1223527702,1223528602,2,3,900
83286805@N00,9922,30,1223531366,1223532446,1,3,1080
83286805@N00,9923,21,1228001540,1228002110,2,3,570
83286805@N00,9923,25,1228005012,1228005852,2,3,840
83286805@N00,9923,29,1228007754,1228008654,1,3,900
83286805@N00,9924,13,1235818923,1235819163,2,2,240
83286805@N00,9924,23,1235822369,1235822969,1,2,600
83286805@N00,9925,28,1237695022,1237695922,1,1,900
83286805@N00,9926,18,1242394523,1242394973,1,1,450
83286805@N00,9927,12,1244436540,1244436780,1,1,240
83286805@N00,9928,6,1244942021,1244942141,3,4,120
83286805@N00,9928,1,1244947560,1244947620,2,4,60
83286805@N00,9928,28,1244950302,1244951202,2,4,900
83286805@N00,9928,29,1244952331,1244953231,1,4,900
83286805@N00,9929,28,1249100175,1249101075,3,6,900
83286805@N00,9929,18,1249105449,1249105649,2,6,200
83286805@N00,9929,23,1249105649,1249106249,2,6,600
83286805@N00,9929,26,1249106278,1249107178,2,6,900
83286805@N00,9929,17,1249107975,1249108111,2,6,136
83286805@N00,9929,15,1249108111,1249108381,1,6,270
83286805@N00,9930,28,1249775718,1249776618,2,1,900
83286805@N00,9931,28,1252146665,1252147565,1,1,900
83286805@N00,9932,26,1256465925,1256466825,1,1,900
83286805@N00,9933,28,1257387562,1257388462,1,1,900
83286805@N00,9934,12,1264311825,1264312065,1,1,240
83286805@N00,9935,23,1270290934,1270291534,1,1,600
83286805@N00,9936,23,1277559179,1277559779,2,2,600
83286805@N00,9936,28,1277560819,1277561719,1,2,900
83286805@N00,9937,23,1279324534,1279325134,2,5,600
83286805@N00,9937,30,1279326507,1279327587,3,5,1080
83286805@N00,9937,4,1279328521,1279328621,2,5,100
83286805@N00,9937,3,1279328621,1279328711,3,5,90
83286805@N00,9937,13,1279336708,1279336948,3,5,240
83286805@N00,9938,4,1279367771,1279367872,2,1,101
83286805@N00,9939,26,1281146262,1281147162,1,1,900
83286805@N00,9940,1,1283060385,1283060445,1,1,60
83286805@N00,9941,28,1284866306,1284867206,1,1,900
83286805@N00,9942,23,1286062515,1286063115,1,1,600
83286805@N00,9943,17,1287192490,1287192790,1,1,300
83286805@N00,9944,21,1289705121,1289705171,2,4,50
83286805@N00,9944,12,1289705171,1289705411,2,4,240
83286805@N00,9944,20,1289706452,1289706992,2,4,540
83286805@N00,9944,30,1289707317,1289708397,1,4,1080
83286805@N00,9945,13,1298251987,1298252227,1,1,240
83286805@N00,9946,12,1311375630,1311375870,2,3,240
83286805@N00,9946,31,1311376631,1311377779,2,3,1148
83286805@N00,9946,19,1311377779,1311378319,1,3,540
83286805@N00,9947,28,1323658251,1323659151,1,1,900
83286805@N00,9948,18,1346507833,1346508283,1,1,450
83286805@N00,9949,18,1366454123,1366454573,1,1,450
83286805@N00,9950,23,1371945456,1371946056,1,1,600
83297140@N00,9951,16,1409621319,1409621589,2,2,270
83297140@N00,9951,13,1409635431,1409635671,2,2,240
8331103@N07,9952,3,1318138082,1318138172,1,1,90
8331103@N07,9953,28,1322396158,1322397058,1,1,900
8331103@N07,9954,24,1348371617,1348372397,1,1,780
8336246@N06,9955,1,1397861062,1397861122,27,1,60
83434203@N00,9956,18,1195624222,1195624672,4,5,450
83434203@N00,9956,26,1195625375,1195626059,2,5,684
83434203@N00,9956,19,1195626059,1195626599,14,5,540
83434203@N00,9956,30,1195630146,1195631226,14,5,1080
83434203@N00,9956,17,1195633890,1195634190,1,5,300
8347765@N06,9957,28,1351467908,1351468044,2,8,136
8347765@N06,9957,23,1351468044,1351468644,3,8,600
8347765@N06,9957,20,1351469594,1351470134,3,8,540
8347765@N06,9957,7,1351480400,1351480580,2,8,180
8347765@N06,9957,23,1351482331,1351482931,2,8,600
8347765@N06,9957,26,1351485121,1351485162,2,8,41
8347765@N06,9957,16,1351485162,1351485432,2,8,270
8347765@N06,9957,27,1351486550,1351487450,1,8,900
8347765@N06,9958,23,1385504116,1385504263,2,19,147
8347765@N06,9958,18,1385504263,1385504713,4,19,450
8347765@N06,9958,20,1385506389,1385506929,3,19,540
8347765@N06,9958,31,1385507245,1385508745,2,19,1500
8347765@N06,9958,7,1385509555,1385509601,2,19,46
8347765@N06,9958,5,1385509601,1385509721,2,19,120
8347765@N06,9958,4,1385509952,1385509972,2,19,20
8347765@N06,9958,5,1385509972,1385510092,6,19,120
8347765@N06,9958,21,1385510872,1385511442,3,19,570
8347765@N06,9958,1,1385532396,1385532442,2,19,46
8347765@N06,9958,28,1385532442,1385532781,2,19,339
8347765@N06,9958,26,1385532781,1385533681,3,19,900
8347765@N06,9958,21,1385537224,1385537794,2,19,570
8347765@N06,9958,13,1385538467,1385538707,4,19,240
8347765@N06,9958,16,1385540146,1385540416,8,19,270
8347765@N06,9958,15,1385543317,1385543587,2,19,270
8347765@N06,9958,26,1385546522,1385546839,3,19,317
8347765@N06,9958,16,1385546839,1385547109,3,19,270
8347765@N06,9958,28,1385551268,1385552168,3,19,900
8347765@N06,9959,28,1395465008,1395465908,2,2,900
8347765@N06,9959,18,1395468569,1395469019,1,2,450
8347765@N06,9960,28,1398045947,1398046847,1,1,900
8347765@N06,9961,30,1403912363,1403913443,2,2,1080
8347765@N06,9961,25,1403915823,1403916663,1,2,840
8347765@N06,9962,19,1404003851,1404004391,1,1,540
8347765@N06,9963,30,1407032732,1407033812,1,1,1080
8347765@N06,9964,1,1407107248,1407107308,2,2,60
8347765@N06,9964,25,1407134795,1407135635,1,2,840
8347765@N06,9965,19,1414201368,1414201908,1,1,540
8347765@N06,9966,18,1423258498,1423258730,3,12,232
8347765@N06,9966,19,1423258730,1423259270,5,12,540
8347765@N06,9966,29,1423260712,1423261612,2,12,900
8347765@N06,9966,31,1423264502,1423264714,4,12,212
8347765@N06,9966,30,1423264714,1423264725,2,12,11
8347765@N06,9966,31,1423264725,1423264757,2,12,32
8347765@N06,9966,22,1423264757,1423265168,3,12,411
8347765@N06,9966,31,1423265168,1423266668,2,12,1500
8347765@N06,9966,10,1423269324,1423269564,2,12,240
8347765@N06,9966,30,1423269628,1423270708,2,12,1080
8347765@N06,9966,21,1423272898,1423273468,2,12,570
8347765@N06,9966,29,1423300315,1423301215,5,12,900
8347765@N06,9967,30,1426906384,1426906583,12,5,199
8347765@N06,9967,29,1426906583,1426906637,3,5,54
8347765@N06,9967,31,1426906637,1426906759,4,5,122
8347765@N06,9967,22,1426906759,1426907225,3,5,466
8347765@N06,9967,31,1426907225,1426908725,1,5,1500
8347765@N06,9968,1,1443769982,1443770042,2,7,60
8347765@N06,9968,26,1443771076,1443771976,2,7,900
8347765@N06,9968,18,1443773562,1443774012,2,7,450
8347765@N06,9968,22,1443774873,1443775473,3,7,600
8347765@N06,9968,20,1443776284,1443776824,13,7,540
8347765@N06,9968,24,1443783001,1443783781,7,7,780
8347765@N06,9968,30,1443785794,1443786874,5,7,1080
8348059@N02,9969,1,1307604274,1307604334,2,14,60
8348059@N02,9969,28,1307615161,1307615207,2,14,46
8348059@N02,9969,1,1307615207,1307615267,7,14,60
8348059@N02,9969,29,1307616058,1307616958,2,14,900
8348059@N02,9969,1,1307617507,1307617567,4,14,60
8348059@N02,9969,28,1307617631,1307618531,88,14,900
8348059@N02,9969,26,1307620568,1307620665,2,14,97
8348059@N02,9969,23,1307620665,1307620737,2,14,72
8348059@N02,9969,30,1307620737,1307620761,2,14,24
8348059@N02,9969,29,1307620761,1307621661,9,14,900
8348059@N02,9969,20,1307624593,1307625133,4,14,540
8348059@N02,9969,29,1307627554,1307628442,4,14,888
8348059@N02,9969,26,1307628442,1307628622,2,14,180
8348059@N02,9969,28,1307628622,1307629522,1,14,900
8348059@N02,9970,1,1307669892,1307669952,2,36,60
8348059@N02,9970,28,1307669988,1307670888,4,36,900
8348059@N02,9970,23,1307671558,1307671783,2,36,225
8348059@N02,9970,18,1307671783,1307671825,2,36,42
8348059@N02,9970,29,1307671825,1307671917,4,36,92
8348059@N02,9970,19,1307671917,1307671993,3,36,76
8348059@N02,9970,18,1307671993,1307672152,3,36,159
8348059@N02,9970,23,1307672152,1307672312,3,36,160
8348059@N02,9970,29,1307672312,1307673212,6,36,900
8348059@N02,9970,22,1307674401,1307674456,2,36,55
8348059@N02,9970,20,1307674456,1307674605,2,36,149
8348059@N02,9970,29,1307674605,1307675505,3,36,900
8348059@N02,9970,30,1307676176,1307676375,3,36,199
8348059@N02,9970,23,1307676375,1307676975,10,36,600
8348059@N02,9970,30,1307678133,1307679213,9,36,1080
8348059@N02,9970,10,1307681374,1307681614,2,36,240
8348059@N02,9970,11,1307681658,1307681898,2,36,240
8348059@N02,9970,9,1307682027,1307682207,2,36,180
8348059@N02,9970,4,1307682610,1307682711,2,36,101
8348059@N02,9970,13,1307682728,1307682957,3,36,229
8348059@N02,9970,25,1307682957,1307683797,29,36,840
8348059@N02,9970,13,1307684705,1307684945,15,36,240
8348059@N02,9970,3,1307688313,1307688403,3,36,90
8348059@N02,9970,9,1307688693,1307688773,2,36,80
8348059@N02,9970,6,1307688773,1307688893,4,36,120
8348059@N02,9970,26,1307689074,1307689256,4,36,182
8348059@N02,9970,28,1307689256,1307690156,7,36,900
8348059@N02,9970,1,1307691508,1307691568,10,36,60
8348059@N02,9970,28,1307694280,1307695180,6,36,900
8348059@N02,9970,29,1307700456,1307701356,28,36,900
8348059@N02,9970,16,1307707910,1307708091,2,36,181
8348059@N02,9970,27,1307708091,1307708459,2,36,368
8348059@N02,9970,16,1307708459,1307708729,5,36,270
8348059@N02,9970,26,1307709803,1307710153,3,36,350
8348059@N02,9970,28,1307710153,1307710356,3,36,203
8348059@N02,9970,1,1307710356,1307710416,1,36,60
8348059@N02,9971,5,1307740612,1307740732,7,11,120
8348059@N02,9971,9,1307741194,1307741374,4,11,180
8348059@N02,9971,5,1307741398,1307741518,3,11,120
8348059@N02,9971,12,1307741542,1307741782,4,11,240
8348059@N02,9971,3,1307742786,1307742876,2,11,90
8348059@N02,9971,9,1307742938,1307743118,2,11,180
8348059@N02,9971,30,1307743622,1307744378,4,11,756
8348059@N02,9971,23,1307744378,1307744825,3,11,447
8348059@N02,9971,19,1307744825,1307745325,3,11,500
8348059@N02,9971,29,1307745325,1307746225,7,11,900
8348059@N02,9971,1,1307747076,1307747136,2,11,60
8348059@N02,9972,28,1370814531,1370815431,3,24,900
8348059@N02,9972,29,1370815716,1370816616,2,24,900
8348059@N02,9972,19,1370816688,1370817228,2,24,540
8348059@N02,9972,18,1370817333,1370817783,2,24,450
8348059@N02,9972,29,1370817923,1370818823,2,24,900
8348059@N02,9972,20,1370818831,1370819371,4,24,540
8348059@N02,9972,22,1370819659,1370820259,2,24,600
8348059@N02,9972,30,1370820904,1370821086,2,24,182
8348059@N02,9972,26,1370821086,1370821777,3,24,691
8348059@N02,9972,21,1370821777,1370822347,3,24,570
8348059@N02,9972,25,1370822358,1370823198,4,24,840
8348059@N02,9972,21,1370823591,1370823741,2,24,150
8348059@N02,9972,16,1370823741,1370824011,2,24,270
8348059@N02,9972,27,1370824119,1370825019,4,24,900
8348059@N02,9972,26,1370826163,1370826246,3,24,83
8348059@N02,9972,30,1370826246,1370827326,4,24,1080
8348059@N02,9972,1,1370835727,1370835787,2,24,60
8348059@N02,9972,29,1370857915,1370858815,3,24,900
8348059@N02,9972,1,1370865462,1370865522,3,24,60
8348059@N02,9972,16,1370866507,1370866719,2,24,212
8348059@N02,9972,30,1370866719,1370867106,2,24,387
8348059@N02,9972,29,1370867106,1370868006,4,24,900
8348059@N02,9972,26,1370873215,1370874115,9,24,900
8348059@N02,9972,23,1370875423,1370876023,11,24,600
8348059@N02,9973,1,1370909383,1370909443,2,25,60
8348059@N02,9973,5,1370911960,1370912080,2,25,120
8348059@N02,9973,21,1370912290,1370912539,2,25,249
8348059@N02,9973,8,1370912539,1370912719,2,25,180
8348059@N02,9973,27,1370912929,1370913829,5,25,900
8348059@N02,9973,16,1370914856,1370915126,2,25,270
8348059@N02,9973,24,1370915489,1370916269,5,25,780
8348059@N02,9973,15,1370916878,1370917075,2,25,197
8348059@N02,9973,24,1370917075,1370917258,2,25,183
8348059@N02,9973,17,1370917258,1370917358,2,25,100
8348059@N02,9973,1,1370917358,1370917418,3,25,60
8348059@N02,9973,29,1370917749,1370918261,4,25,512
8348059@N02,9973,13,1370918261,1370918276,3,25,15
8348059@N02,9973,25,1370918276,1370918283,3,25,7
8348059@N02,9973,13,1370918283,1370918523,2,25,240
8348059@N02,9973,17,1370918644,1370918706,2,25,62
8348059@N02,9973,1,1370918706,1370918766,3,25,60
8348059@N02,9973,28,1370918951,1370919851,62,25,900
8348059@N02,9973,29,1370941457,1370941498,2,25,41
8348059@N02,9973,28,1370941498,1370941919,2,25,421
8348059@N02,9973,29,1370941919,1370942425,2,25,506
8348059@N02,9973,20,1370942425,1370942836,2,25,411
8348059@N02,9973,29,1370942836,1370943736,2,25,900
8348059@N02,9973,20,1370943926,1370944466,3,25,540
8348059@N02,9973,1,1370948094,1370948154,1,25,60
8348059@N02,9974,29,1402267062,1402267774,2,18,712
8348059@N02,9974,23,1402267774,1402268216,2,18,442
8348059@N02,9974,19,1402268216,1402268595,5,18,379
8348059@N02,9974,18,1402268595,1402269045,2,18,450
8348059@N02,9974,29,1402269186,1402270086,3,18,900
8348059@N02,9974,20,1402271433,1402271676,2,18,243
8348059@N02,9974,22,1402271676,1402272276,2,18,600
8348059@N02,9974,30,1402272957,1402274037,5,18,1080
8348059@N02,9974,6,1402274490,1402274587,2,18,97
8348059@N02,9974,8,1402274587,1402274767,2,18,180
8348059@N02,9974,22,1402275905,1402276505,9,18,600
8348059@N02,9974,29,1402280658,1402281061,3,18,403
8348059@N02,9974,22,1402281061,1402281464,2,18,403
8348059@N02,9974,31,1402281464,1402282964,2,18,1500
8348059@N02,9974,28,1402284213,1402285113,9,18,900
8348059@N02,9974,23,1402297387,1402297987,3,18,600
8348059@N02,9974,29,1402298621,1402299521,2,18,900
8348059@N02,9974,28,1402300098,1402300998,50,18,900
8348059@N02,9975,1,1402347399,1402347459,2,7,60
8348059@N02,9975,6,1402350075,1402350195,2,7,120
8348059@N02,9975,25,1402354054,1402354894,7,7,840
8348059@N02,9975,11,1402356000,1402356119,2,7,119
8348059@N02,9975,30,1402356119,1402357199,2,7,1080
8348059@N02,9975,29,1402359220,1402360120,10,7,900
8348059@N02,9975,28,1402366224,1402367124,3,7,900
8348059@N02,9976,1,1402488770,1402488830,3,2,60
8348059@N02,9976,28,1402491017,1402491917,1,2,900
83505636@N03,9977,14,1363006466,1363006706,1,1,240
83518369@N00,9978,17,1310178860,1310179160,1,1,300
83518369@N00,9979,28,1313558411,1313558664,2,2,253
83518369@N00,9979,1,1313558664,1313558724,1,2,60
8353257@N07,9980,11,1291766040,1291766280,1,1,240
83551957@N08,9981,19,1419508892,1419509432,1,1,540
83612144@N00,9982,30,1252819291,1252820371,1,1,1080
83612144@N00,9983,11,1254881680,1254881920,2,2,240
83612144@N00,9983,13,1254883540,1254883780,1,2,240
83612144@N00,9984,27,1270975073,1270975973,1,1,900
83612144@N00,9985,16,1278671088,1278671358,1,1,270
83612144@N00,9986,21,1280630834,1280631392,2,3,558
83612144@N00,9986,4,1280631392,1280631493,2,3,101
83612144@N00,9986,15,1280632753,1280633023,2,3,270
83612144@N00,9987,13,1281861901,1281862141,1,1,240
83612144@N00,9988,28,1293011228,1293012128,1,1,900
83612144@N00,9989,3,1295770899,1295770989,1,1,90
83612144@N00,9990,7,1304670059,1304670239,1,1,180
83612144@N00,9991,25,1306467595,1306468435,2,1,840
83612144@N00,9992,25,1306735436,1306736276,3,2,840
83612144@N00,9992,13,1306738267,1306738507,1,2,240
83612144@N00,9993,21,1311930165,1311930735,2,2,570
83612144@N00,9993,24,1311932855,1311933635,1,2,780
83612144@N00,9994,29,1312416034,1312416569,2,2,535
83612144@N00,9994,31,1312416569,1312418069,2,2,1500
83612144@N00,9995,12,1313311715,1313311955,1,1,240
83612144@N00,9996,28,1314998948,1314999848,1,1,900
83612144@N00,9997,13,1319934702,1319934942,2,2,240
83612144@N00,9997,1,1319937115,1319937175,1,2,60
83612144@N00,9998,28,1320448863,1320449763,1,1,900
83612144@N00,9999,6,1321135590,1321135710,2,2,120
83612144@N00,9999,12,1321139391,1321139631,1,2,240
83612144@N00,10000,25,1323935817,1323936657,2,2,840
83612144@N00,10000,21,1323937507,1323938077,1,2,570
83612144@N00,10001,24,1325807923,1325808703,1,1,780
83612144@N00,10002,16,1327810769,1327811039,2,1,270
83612144@N00,10003,3,1331450151,1331450241,1,1,90
83612144@N00,10004,1,1334125434,1334125494,1,1,60
83612144@N00,10005,15,1337135291,1337135561,2,1,270
83612144@N00,10006,21,1337729804,1337730374,3,4,570
83612144@N00,10006,25,1337733534,1337734374,5,4,840
83612144@N00,10006,11,1337734800,1337735040,2,4,240
83612144@N00,10006,18,1337737905,1337738355,1,4,450
83612144@N00,10007,27,1340490167,1340491067,1,1,900
83612144@N00,10008,18,1342946963,1342947413,2,4,450
83612144@N00,10008,29,1342949889,1342950398,2,4,509
83612144@N00,10008,20,1342950398,1342950670,2,4,272
83612144@N00,10008,29,1342950670,1342951570,1,4,900
83612144@N00,10009,16,1345800877,1345801147,2,3,270
83612144@N00,10009,26,1345802170,1345803070,2,3,900
83612144@N00,10009,14,1345804204,1345804444,1,3,240
83612144@N00,10010,28,1351147774,1351148674,1,1,900
83612144@N00,10011,21,1357426286,1357426856,3,2,570
83612144@N00,10011,29,1357431666,1357432566,1,2,900
83612144@N00,10012,15,1357796431,1357796636,3,2,205
83612144@N00,10012,24,1357796636,1357797416,1,2,780
83612144@N00,10013,26,1360828670,1360829570,1,1,900
83612144@N00,10014,31,1362264605,1362266105,2,1,1500
83612144@N00,10015,7,1365300080,1365300260,2,2,180
83612144@N00,10015,13,1365301923,1365302163,2,2,240
83612144@N00,10016,21,1369352469,1369353039,2,2,570
83612144@N00,10016,13,1369354736,1369354976,1,2,240
83612144@N00,10017,13,1380415128,1380415368,1,1,240
83612144@N00,10018,14,1384652926,1384653166,1,1,240
83612144@N00,10019,16,1386053131,1386053401,1,1,270
83612144@N00,10020,1,1393117513,1393117573,1,1,60
83612144@N00,10021,30,1394929006,1394930086,2,2,1080
83612144@N00,10021,22,1394930614,1394931214,2,2,600
83612144@N00,10022,3,1398645911,1398646001,1,1,90
83612144@N00,10023,13,1403395585,1403395825,2,1,240
83612144@N00,10024,25,1417417848,1417418688,1,1,840
83612144@N00,10025,19,1417749392,1417749932,2,3,540
83612144@N00,10025,14,1417755820,1417756060,2,3,240
83612144@N00,10025,28,1417767810,1417768710,2,3,900
83612144@N00,10026,25,1431218485,1431218532,2,2,47
83612144@N00,10026,13,1431218532,1431218772,1,2,240
83638430@N00,10027,20,1366591078,1366591618,1,1,540
83638430@N00,10028,20,1366707509,1366708049,1,1,540
83659902@N00,10029,18,1447996374,1447996824,1,1,450
83711900@N00,10030,18,1390780886,1390781084,2,6,198
83711900@N00,10030,31,1390781084,1390782584,2,6,1500
83711900@N00,10030,20,1390783429,1390783969,4,6,540
83711900@N00,10030,26,1390785478,1390785725,2,6,247
83711900@N00,10030,4,1390785725,1390785826,2,6,101
83711900@N00,10030,28,1390796182,1390797082,3,6,900
83711900@N00,10031,28,1390876136,1390877036,6,1,900
83722986@N00,10032,15,1436848564,1436848592,3,3,28
83722986@N00,10032,24,1436848592,1436848728,2,3,136
83722986@N00,10032,15,1436848728,1436848998,9,3,270
8379824@N07,10033,29,1324997512,1324998412,3,2,900
8379824@N07,10033,13,1325000102,1325000342,1,2,240
8386875@N06,10034,18,1187939870,1187940320,145,1,450
8386875@N06,10035,18,1188285496,1188285946,134,1,450
8386875@N06,10036,18,1188544863,1188545313,19,1,450
8386875@N06,10037,18,1188800863,1188801313,117,1,450
8386875@N06,10038,18,1192346207,1192346657,6,1,450
8386875@N06,10039,18,1195789370,1195789820,173,1,450
8386875@N06,10040,18,1196649814,1196650264,42,3,450
8386875@N06,10040,26,1196652189,1196652198,2,3,9
8386875@N06,10040,18,1196652198,1196652648,56,3,450
8386875@N06,10041,18,1204955247,1204955697,1,1,450
8386875@N06,10042,18,1207030899,1207031349,91,1,450
8386875@N06,10043,18,1207201879,1207202329,84,1,450
8386875@N06,10044,18,1207618780,1207619230,87,1,450
8386875@N06,10045,18,1209622726,1209623176,7,1,450
8386875@N06,10046,18,1209707750,1209708200,5,7,450
8386875@N06,10046,30,1209709421,1209709484,2,7,63
8386875@N06,10046,18,1209709484,1209709934,49,7,450
8386875@N06,10046,16,1209711920,1209711920,2,7,0
8386875@N06,10046,18,1209711920,1209712370,4,7,450
8386875@N06,10046,3,1209712687,1209712687,2,7,0
8386875@N06,10046,18,1209712687,1209713137,89,7,450
8386875@N06,10047,18,1209945908,1209945908,2,23,0
8386875@N06,10047,28,1209945908,1209945919,2,23,11
8386875@N06,10047,18,1209945919,1209946369,6,23,450
8386875@N06,10047,26,1209946544,1209946691,2,23,147
8386875@N06,10047,18,1209946691,1209947141,5,23,450
8386875@N06,10047,4,1209947426,1209947444,2,23,18
8386875@N06,10047,18,1209947444,1209947674,3,23,230
8386875@N06,10047,3,1209947674,1209947764,2,23,90
8386875@N06,10047,18,1209947773,1209948223,47,23,450
8386875@N06,10047,13,1209951451,1209951451,2,23,0
8386875@N06,10047,18,1209951451,1209951901,15,23,450
8386875@N06,10047,13,1209954560,1209954560,2,23,0
8386875@N06,10047,18,1209954560,1209955010,7,23,450
8386875@N06,10047,3,1209955334,1209955424,2,23,90
8386875@N06,10047,18,1209955471,1209955683,4,23,212
8386875@N06,10047,3,1209955683,1209955683,2,23,0
8386875@N06,10047,18,1209955683,1209956133,14,23,450
8386875@N06,10047,3,1209956361,1209956385,2,23,24
8386875@N06,10047,18,1209956385,1209956835,12,23,450
8386875@N06,10047,16,1209956840,1209956840,2,23,0
8386875@N06,10047,18,1209956840,1209957218,7,23,378
8386875@N06,10047,16,1209957218,1209957259,2,23,41
8386875@N06,10047,18,1209957259,1209957709,18,23,450
8386875@N06,10048,18,1210057113,1210057563,154,5,450
8386875@N06,10048,16,1210065652,1210065652,2,5,0
8386875@N06,10048,18,1210065652,1210065688,4,5,36
8386875@N06,10048,16,1210065688,1210065688,2,5,0
8386875@N06,10048,18,1210065688,1210066138,20,5,450
8386875@N06,10049,18,1210140662,1210141112,32,1,450
8386875@N06,10050,18,1210231188,1210231638,165,1,450
8386875@N06,10051,18,1210316885,1210317335,140,1,450
8386875@N06,10052,18,1210550453,1210550903,16,1,450
8386875@N06,10053,18,1211077072,1211077522,12,9,450
8386875@N06,10053,11,1211077554,1211077554,2,9,0
8386875@N06,10053,18,1211077554,1211078004,197,9,450
8386875@N06,10053,26,1211089391,1211089394,2,9,3
8386875@N06,10053,18,1211089394,1211089844,153,9,450
8386875@N06,10053,23,1211090812,1211090820,2,9,8
8386875@N06,10053,18,1211090820,1211090820,2,9,0
8386875@N06,10053,23,1211090820,1211090920,2,9,100
8386875@N06,10053,18,1211090920,1211091370,4,9,450
8386875@N06,10054,18,1211869286,1211869736,213,1,450
8386875@N06,10055,18,1212473690,1212474140,7,3,450
8386875@N06,10055,29,1212474330,1212474421,2,3,91
8386875@N06,10055,18,1212474421,1212474871,62,3,450
8386875@N06,10056,18,1212826150,1212826600,31,3,450
8386875@N06,10056,1,1212827425,1212827425,2,3,0
8386875@N06,10056,18,1212827425,1212827875,51,3,450
8386875@N06,10057,18,1213080196,1213080491,6,15,295
8386875@N06,10057,11,1213080491,1213080491,2,15,0
8386875@N06,10057,18,1213080491,1213080941,9,15,450
8386875@N06,10057,11,1213082547,1213082547,2,15,0
8386875@N06,10057,18,1213082547,1213082997,34,15,450
8386875@N06,10057,26,1213089119,1213089125,2,15,6
8386875@N06,10057,18,1213089125,1213089125,2,15,0
8386875@N06,10057,26,1213089125,1213089135,2,15,10
8386875@N06,10057,18,1213089135,1213089222,8,15,87
8386875@N06,10057,26,1213089222,1213089265,2,15,43
8386875@N06,10057,18,1213089265,1213089285,3,15,20
8386875@N06,10057,26,1213089285,1213089560,2,15,275
8386875@N06,10057,18,1213089560,1213089687,4,15,127
8386875@N06,10057,26,1213089687,1213089729,2,15,42
8386875@N06,10057,18,1213089729,1213090179,3,15,450
8386875@N06,10058,18,1213165766,1213166216,2,1,450
8386875@N06,10059,18,1213261608,1213261622,2,5,14
8386875@N06,10059,16,1213261622,1213261687,2,5,65
8386875@N06,10059,18,1213261687,1213261906,7,5,219
8386875@N06,10059,12,1213261906,1213261906,2,5,0
8386875@N06,10059,18,1213261906,1213262356,25,5,450
8386875@N06,10060,18,1213574719,1213575169,86,15,450
8386875@N06,10060,16,1213594678,1213594678,2,15,0
8386875@N06,10060,18,1213594678,1213594932,13,15,254
8386875@N06,10060,21,1213594932,1213594945,2,15,13
8386875@N06,10060,18,1213594945,1213595023,17,15,78
8386875@N06,10060,16,1213595023,1213595023,2,15,0
8386875@N06,10060,18,1213595023,1213595194,15,15,171
8386875@N06,10060,16,1213595194,1213595194,2,15,0
8386875@N06,10060,18,1213595194,1213595214,2,15,20
8386875@N06,10060,16,1213595214,1213595214,2,15,0
8386875@N06,10060,18,1213595214,1213595270,7,15,56
8386875@N06,10060,16,1213595270,1213595295,2,15,25
8386875@N06,10060,18,1213595295,1213595427,5,15,132
8386875@N06,10060,16,1213595427,1213595427,2,15,0
8386875@N06,10060,18,1213595427,1213595877,7,15,450
8386875@N06,10061,18,1213943064,1213943514,71,5,450
8386875@N06,10061,1,1213950636,1213950636,2,5,0
8386875@N06,10061,18,1213950636,1213950637,2,5,1
8386875@N06,10061,1,1213950637,1213950637,2,5,0
8386875@N06,10061,18,1213950637,1213951087,44,5,450
8386875@N06,10062,18,1214289698,1214290148,67,1,450
8386875@N06,10063,18,1214468956,1214469406,41,1,450
8386875@N06,10064,18,1214554162,1214554612,44,1,450
8386875@N06,10065,18,1215499476,1215499926,21,5,450
8386875@N06,10065,1,1215505136,1215505136,2,5,0
8386875@N06,10065,18,1215505136,1215505586,34,5,450
8386875@N06,10065,1,1215505922,1215505922,2,5,0
8386875@N06,10065,18,1215505922,1215506372,15,5,450
8386875@N06,10066,28,1215647553,1215648453,2,2,900
8386875@N06,10066,18,1215674401,1215674851,80,2,450
8386875@N06,10067,18,1215760797,1215761247,79,1,450
8386875@N06,10068,11,1219300384,1219300624,3,4,240
8386875@N06,10068,28,1219301196,1219302096,2,4,900
8386875@N06,10068,11,1219303173,1219303413,2,4,240
8386875@N06,10068,28,1219307339,1219308239,32,4,900
8386875@N06,10069,6,1219820092,1219820212,1,1,120
8386875@N06,10070,26,1219904757,1219905657,2,7,900
8386875@N06,10070,6,1219907369,1219907489,2,7,120
8386875@N06,10070,28,1219907792,1219908692,5,7,900
8386875@N06,10070,1,1219911383,1219911443,11,7,60
8386875@N06,10070,28,1219912325,1219912758,12,7,433
8386875@N06,10070,1,1219912758,1219912818,2,7,60
8386875@N06,10070,28,1219912905,1219913805,1,7,900
8386875@N06,10071,1,1221813431,1221813491,2,1,60
8386875@N06,10072,26,1222075255,1222076155,1,1,900
8386875@N06,10073,12,1222664847,1222665087,2,5,240
8386875@N06,10073,24,1222668220,1222669000,2,5,780
8386875@N06,10073,13,1222671093,1222671333,3,5,240
8386875@N06,10073,29,1222673682,1222674582,3,5,900
8386875@N06,10073,1,1222675466,1222675526,1,5,60
8386875@N06,10074,29,1224742655,1224743555,3,2,900
8386875@N06,10074,20,1224744103,1224744643,4,2,540
8386875@N06,10075,3,1226385299,1226385389,6,5,90
8386875@N06,10075,16,1226385789,1226385792,2,5,3
8386875@N06,10075,3,1226385792,1226385792,2,5,0
8386875@N06,10075,16,1226385792,1226385799,2,5,7
8386875@N06,10075,3,1226385799,1226385889,24,5,90
8386875@N06,10076,16,1228022661,1228022931,135,1,270
8386875@N06,10077,28,1228377194,1228378094,102,1,900
8386875@N06,10078,25,1228822742,1228823582,27,1,840
8386875@N06,10079,28,1236297900,1236298253,9,11,353
8386875@N06,10079,26,1236298253,1236299153,12,11,900
8386875@N06,10079,16,1236299564,1236299834,7,11,270
8386875@N06,10079,12,1236302413,1236302634,3,11,221
8386875@N06,10079,8,1236302634,1236302814,6,11,180
8386875@N06,10079,21,1236303102,1236303407,3,11,305
8386875@N06,10079,25,1236303407,1236304247,36,11,840
8386875@N06,10079,3,1236305099,1236305189,3,11,90
8386875@N06,10079,16,1236308032,1236308302,11,11,270
8386875@N06,10079,21,1236308867,1236309437,8,11,570
8386875@N06,10079,25,1236311894,1236312734,5,11,840
8386875@N06,10080,16,1238716305,1238716575,98,1,270
8386875@N06,10081,24,1263357983,1263358763,1,1,780
8386875@N06,10082,28,1267504699,1267505599,3,4,900
8386875@N06,10082,1,1267505988,1267506048,2,4,60
8386875@N06,10082,28,1267506096,1267506996,2,4,900
8386875@N06,10082,26,1267508048,1267508948,1,4,900
8386875@N06,10083,23,1275266413,1275267013,3,3,600
8386875@N06,10083,19,1275267149,1275267432,2,3,283
8386875@N06,10083,29,1275267432,1275268332,1,3,900
8386875@N06,10084,25,1275627163,1275628003,1,1,840
8386875@N06,10085,1,1276211354,1276211414,3,3,60
8386875@N06,10085,20,1276212154,1276212694,2,3,540
8386875@N06,10085,11,1276215674,1276215914,2,3,240
8386875@N06,10086,28,1276503764,1276504664,1,1,900
8386875@N06,10087,11,1276743214,1276743454,1,1,240
8386875@N06,10088,11,1276843880,1276844120,2,1,240
8386875@N06,10089,23,1277988771,1277989371,1,1,600
8386875@N06,10090,24,1279789729,1279790509,2,2,780
8386875@N06,10090,30,1279797006,1279798086,4,2,1080
8386875@N06,10091,18,1279867477,1279867927,4,2,450
8386875@N06,10091,23,1279884346,1279884946,2,2,600
8386875@N06,10092,28,1282976272,1282977172,1,1,900
8386875@N06,10093,16,1283555807,1283556077,7,5,270
8386875@N06,10093,10,1283563530,1283563770,2,5,240
8386875@N06,10093,26,1283568212,1283569112,2,5,900
8386875@N06,10093,16,1283570866,1283571136,10,5,270
8386875@N06,10093,26,1283573593,1283574493,1,5,900
8386875@N06,10094,7,1284009174,1284009354,1,1,180
8386875@N06,10095,28,1289454081,1289454981,5,1,900
8386875@N06,10096,28,1289537570,1289538470,50,1,900
8386875@N06,10097,26,1289885513,1289886413,3,2,900
8386875@N06,10097,28,1289894164,1289895064,1,2,900
8386875@N06,10098,28,1290315749,1290316649,4,1,900
8386875@N06,10099,28,1290401502,1290402402,3,2,900
8386875@N06,10099,1,1290411580,1290411640,1,2,60
8386875@N06,10100,28,1290920331,1290921231,4,1,900
8386875@N06,10101,28,1291519571,1291520471,5,1,900
8386875@N06,10102,28,1292130475,1292131375,4,1,900
8386875@N06,10103,26,1293850965,1293851865,2,1,900
8386875@N06,10104,16,1293891833,1293892103,2,1,270
8386875@N06,10105,29,1296773894,1296774794,6,2,900
8386875@N06,10105,16,1296799392,1296799662,1,2,270
8386875@N06,10106,13,1296971648,1296971888,1,1,240
8386875@N06,10107,28,1297139713,1297140430,2,5,717
8386875@N06,10107,1,1297140430,1297140473,4,5,43
8386875@N06,10107,28,1297140473,1297140991,2,5,518
8386875@N06,10107,1,1297140991,1297141051,2,5,60
8386875@N06,10107,28,1297141459,1297142359,1,5,900
8386875@N06,10108,16,1298268008,1298268278,1,1,270
8386875@N06,10109,11,1298772263,1298772503,2,1,240
8386875@N06,10110,28,1306819399,1306820299,31,1,900
8386875@N06,10111,15,1306990177,1306990447,2,3,270
8386875@N06,10111,27,1306994082,1306994084,2,3,2
8386875@N06,10111,15,1306994084,1306994354,1,3,270
8386875@N06,10112,9,1307164455,1307164635,1,1,180
8386875@N06,10113,28,1307514198,1307515098,114,1,900
8386875@N06,10114,26,1308021824,1308022724,7,5,900
8386875@N06,10114,11,1308026874,1308027114,2,5,240
8386875@N06,10114,9,1308027200,1308027380,3,5,180
8386875@N06,10114,11,1308027651,1308027891,5,5,240
8386875@N06,10114,16,1308032200,1308032470,72,5,270
8386875@N06,10115,25,1308809047,1308809887,96,2,840
8386875@N06,10115,28,1308810623,1308811523,110,2,900
8386875@N06,10116,28,1308982948,1308983848,70,1,900
8386875@N06,10117,1,1309156146,1309156206,1,1,60
8386875@N06,10118,16,1309387108,1309387378,3,2,270
8386875@N06,10118,28,1309415789,1309416689,1,2,900
8386875@N06,10119,28,1311302714,1311303614,2,1,900
8386875@N06,10120,1,1313044611,1313044671,1,1,60
83871406@N00,10121,1,1387697140,1387697200,2,2,60
83871406@N00,10121,28,1387702212,1387703112,2,2,900
83871406@N00,10122,29,1387756661,1387757561,2,15,900
83871406@N00,10122,26,1387758148,1387759048,3,15,900
83871406@N00,10122,19,1387762873,1387763413,2,15,540
83871406@N00,10122,18,1387766389,1387766839,2,15,450
83871406@N00,10122,29,1387767685,1387768585,2,15,900
83871406@N00,10122,21,1387776947,1387777517,2,15,570
83871406@N00,10122,25,1387782693,1387783533,2,15,840
83871406@N00,10122,15,1387786872,1387787142,2,15,270
83871406@N00,10122,24,1387789519,1387790299,4,15,780
83871406@N00,10122,15,1387791607,1387791877,3,15,270
83871406@N00,10122,4,1387795300,1387795401,2,15,101
83871406@N00,10122,7,1387800508,1387800688,2,15,180
83871406@N00,10122,25,1387801854,1387802694,2,15,840
83871406@N00,10122,26,1387804334,1387804638,3,15,304
83871406@N00,10122,28,1387804638,1387805538,1,15,900
83894580@N06,10123,26,1440544713,1440545613,2,2,900
83894580@N06,10123,13,1440555661,1440555901,1,2,240
83894580@N06,10124,28,1440760225,1440761125,1,1,900
83894580@N06,10125,13,1440900601,1440900841,1,1,240
8392824@N04,10126,29,1250506980,1250507880,1,1,900
83950218@N03,10127,26,1366415711,1366416611,2,4,900
83950218@N03,10127,7,1366418822,1366418934,2,4,112
83950218@N03,10127,5,1366418934,1366419054,2,4,120
83950218@N03,10127,25,1366419951,1366420791,1,4,840
83950218@N03,10128,26,1366456377,1366457277,23,1,900
83959210@N02,10129,22,1430613685,1430614285,2,4,600
83959210@N02,10129,14,1430614409,1430614649,4,4,240
83959210@N02,10129,22,1430616875,1430617475,2,4,600
83959210@N02,10129,30,1430618466,1430619546,1,4,1080
83959210@N02,10130,24,1430876031,1430876811,1,1,780
83959210@N02,10131,26,1430960861,1430961761,3,1,900
83959210@N02,10132,1,1431043874,1431043934,2,5,60
83959210@N02,10132,28,1431044627,1431045527,2,5,900
83959210@N02,10132,16,1431048126,1431048396,2,5,270
83959210@N02,10132,18,1431049773,1431050223,2,5,450
83959210@N02,10132,1,1431073653,1431073713,2,5,60
83959210@N02,10133,16,1456876405,1456876675,1,1,270
83959210@N02,10134,21,1457048127,1457048697,2,2,570
83959210@N02,10134,8,1457051373,1457051553,1,2,180
8398190@N02,10135,19,1203116415,1203116955,2,2,540
8398190@N02,10135,16,1203138716,1203138986,1,2,270
8398190@N02,10136,24,1270961324,1270962104,2,2,780
8398190@N02,10136,13,1270964679,1270964919,1,2,240
8398190@N02,10137,24,1271054748,1271054894,2,2,146
8398190@N02,10137,13,1271054894,1271055134,1,2,240
8398190@N02,10138,16,1272898954,1272899224,1,1,270
8398190@N02,10139,13,1274114475,1274114715,1,1,240
8398190@N02,10140,27,1287920240,1287921140,2,3,900
8398190@N02,10140,17,1287924767,1287925067,2,3,300
8398190@N02,10140,28,1287926742,1287927642,1,3,900
84013956@N00,10141,23,1212242400,1212243000,1,1,600
8402359@N03,10142,13,1285633083,1285633323,1,1,240
8404411@N05,10143,31,1189308744,1189310244,38,3,1500
8404411@N05,10143,23,1189313979,1189314579,2,3,600
8404411@N05,10143,16,1189314931,1189315201,2,3,270
84057311@N04,10144,21,1432516120,1432516565,2,2,445
84057311@N04,10144,3,1432516565,1432516655,1,2,90
84057311@N04,10145,3,1432636648,1432636738,2,2,90
84057311@N04,10145,28,1432653916,1432654816,1,2,900
84057763@N00,10146,17,1357348301,1357348601,1,1,300
84057763@N00,10147,21,1357446245,1357446815,1,1,570
84057763@N00,10148,28,1368512433,1368513333,2,1,900
84057763@N00,10149,17,1382331005,1382331305,1,1,300
84057763@N00,10150,29,1386045516,1386046416,2,3,900
84057763@N00,10150,1,1386050164,1386050224,2,3,60
84057763@N00,10150,28,1386059826,1386060726,1,3,900
84059696@N00,10151,26,1188581879,1188582779,93,1,900
84096356@N03,10152,30,1342265701,1342266781,1,1,1080
84110444@N05,10153,28,1425974858,1425975758,1,1,900
84116656@N00,10154,23,1203311251,1203311851,1,1,600
84116656@N00,10155,20,1249529802,1249530342,8,1,540
84116656@N00,10156,23,1306297178,1306297778,11,1,600
84116656@N00,10157,20,1327369192,1327369732,2,3,540
84116656@N00,10157,23,1327370870,1327371470,6,3,600
84116656@N00,10157,20,1327372090,1327372630,52,3,540
84116656@N00,10158,23,1328423595,1328424195,4,12,600
84116656@N00,10158,20,1328424422,1328424550,8,12,128
84116656@N00,10158,29,1328424550,1328425450,2,12,900
84116656@N00,10158,3,1328427206,1328427296,22,12,90
84116656@N00,10158,4,1328428781,1328428882,3,12,101
84116656@N00,10158,7,1328429396,1328429413,3,12,17
84116656@N00,10158,5,1328429413,1328429516,4,12,103
84116656@N00,10158,4,1328429516,1328429617,3,12,101
84116656@N00,10158,5,1328430102,1328430222,20,12,120
84116656@N00,10158,9,1328431049,1328431229,3,12,180
84116656@N00,10158,23,1328437897,1328438497,68,12,600
84116656@N00,10158,20,1328441469,1328442009,33,12,540
84116656@N00,10159,28,1347254359,1347254836,2,3,477
84116656@N00,10159,18,1347254836,1347255286,2,3,450
84116656@N00,10159,15,1347260289,1347260559,1,3,270
84116656@N00,10160,20,1352872031,1352872571,1,1,540
84116656@N00,10161,28,1358909734,1358910634,1,1,900
84200004@N02,10162,26,1377883262,1377884162,1,1,900
84213819@N00,10163,10,1280829358,1280829598,2,1,240
8423871@N06,10164,29,1397710397,1397711297,1,1,900
84266989@N04,10165,30,1374046415,1374047495,5,6,1080
84266989@N04,10165,28,1374050329,1374050332,2,6,3
84266989@N04,10165,30,1374050332,1374050347,2,6,15
84266989@N04,10165,22,1374050347,1374050365,3,6,18
84266989@N04,10165,28,1374050365,1374050375,2,6,10
84266989@N04,10165,6,1374050375,1374050495,2,6,120
8426916@N04,10166,4,1314710007,1314710108,1,1,101
8426916@N04,10167,30,1334318988,1334320068,1,1,1080
84269601@N00,10168,26,1196957622,1196958522,1,1,900
84269601@N00,10169,17,1206980749,1206981049,1,1,300
84269601@N00,10170,25,1211229557,1211230397,1,1,840
84269601@N00,10171,1,1211653730,1211653790,1,1,60
84269601@N00,10172,1,1212051916,1212051976,1,1,60
84269601@N00,10173,29,1226597764,1226598664,1,1,900
84269601@N00,10174,26,1277172780,1277173680,1,1,900
84304983@N08,10175,7,1306024281,1306024461,3,4,180
84304983@N08,10175,29,1306034846,1306035746,3,4,900
84304983@N08,10175,31,1306035936,1306037237,4,4,1301
84304983@N08,10175,30,1306037237,1306038317,1,4,1080
84304983@N08,10176,26,1353404652,1353405552,1,1,900
84322304@N07,10177,21,1421131037,1421131607,1,1,570
84345058@N00,10178,18,1437919589,1437920039,1,1,450
8437808@N05,10179,18,1231546120,1231546570,2,2,450
8437808@N05,10179,10,1231556509,1231556749,1,2,240
8440951@N06,10180,16,1373558689,1373558959,1,1,270
8440951@N06,10181,25,1387022145,1387022985,1,1,840
8446863@N03,10182,28,1230423582,1230424482,1,1,900
8446863@N03,10183,26,1230634910,1230635810,2,1,900
84481364@N05,10184,29,1362193383,1362194283,9,1,900
84496208@N00,10185,26,1190944974,1190945874,1,1,900
84496208@N00,10186,26,1191023613,1191024513,82,1,900
84496208@N00,10187,26,1191661271,1191662171,1,1,900
84496208@N00,10188,26,1193429372,1193430272,9,1,900
84496208@N00,10189,26,1194566707,1194567607,1,1,900
84496208@N00,10190,26,1194652765,1194653665,2,1,900
84496208@N00,10191,26,1196711498,1196712398,1,1,900
84496208@N00,10192,26,1198195371,1198196271,1,1,900
84496208@N00,10193,26,1199402377,1199403277,7,1,900
84496208@N00,10194,26,1199751878,1199752778,24,1,900
84496208@N00,10195,26,1201905582,1201906482,58,1,900
84496208@N00,10196,26,1202598513,1202599413,37,1,900
84496208@N00,10197,26,1204106028,1204106928,28,1,900
84496208@N00,10198,26,1205048517,1205049417,1,1,900
84496208@N00,10199,26,1205618886,1205619786,48,5,900
84496208@N00,10199,29,1205639860,1205639866,2,5,6
84496208@N00,10199,26,1205639866,1205640766,11,5,900
84496208@N00,10199,29,1205643586,1205643906,2,5,320
84496208@N00,10199,26,1205643906,1205644806,62,5,900
84496208@N00,10200,29,1205964463,1205965363,2,1,900
84496208@N00,10201,29,1208480203,1208481103,2,1,900
84496208@N00,10202,29,1208728601,1208729501,81,1,900
84496208@N00,10203,29,1208823328,1208824228,7,1,900
84496208@N00,10204,26,1210948513,1210949413,1,1,900
84496208@N00,10205,26,1211061262,1211062162,1,1,900
84496208@N00,10206,26,1220211144,1220212044,1,1,900
84531937@N00,10207,15,1264815092,1264815362,1,1,270
8458618@N05,10208,20,1241757885,1241758425,2,6,540
8458618@N05,10208,30,1241758949,1241760029,6,6,1080
8458618@N05,10208,20,1241762712,1241763252,18,6,540
8458618@N05,10208,26,1241767419,1241767955,2,6,536
8458618@N05,10208,17,1241767955,1241768255,7,6,300
8458618@N05,10208,25,1241780497,1241781337,5,6,840
84598981@N00,10209,30,1288926103,1288927183,1,1,1080
84601962@N00,10210,1,1388190657,1388190717,1,1,60
84601962@N00,10211,26,1396053455,1396054355,1,1,900
84601962@N00,10212,26,1401499785,1401500685,1,1,900
84601962@N00,10213,27,1420167753,1420168653,4,1,900
84601962@N00,10214,28,1420240375,1420241275,2,9,900
84601962@N00,10214,30,1420242834,1420242960,2,9,126
84601962@N00,10214,18,1420242960,1420243410,4,9,450
84601962@N00,10214,28,1420243607,1420244507,2,9,900
84601962@N00,10214,19,1420255409,1420255949,4,9,540
84601962@N00,10214,27,1420260056,1420260061,3,9,5
84601962@N00,10214,17,1420260061,1420260361,2,9,300
84601962@N00,10214,26,1420274771,1420274902,2,9,131
84601962@N00,10214,16,1420274902,1420275172,2,9,270
84601962@N00,10215,25,1452894545,1452895385,2,15,840
84601962@N00,10215,27,1452900272,1452901172,12,15,900
84601962@N00,10215,15,1452904975,1452905245,2,15,270
84601962@N00,10215,4,1452905316,1452905317,2,15,1
84601962@N00,10215,24,1452905317,1452906097,2,15,780
84601962@N00,10215,16,1452907312,1452907582,5,15,270
84601962@N00,10215,27,1452908698,1452909598,4,15,900
84601962@N00,10215,16,1452909993,1452910008,2,15,15
84601962@N00,10215,30,1452910008,1452911088,2,15,1080
84601962@N00,10215,12,1452913607,1452913847,2,15,240
84601962@N00,10215,25,1452914206,1452915046,7,15,840
84601962@N00,10215,11,1452917600,1452917840,2,15,240
84601962@N00,10215,13,1452917903,1452918143,3,15,240
84601962@N00,10215,19,1452920594,1452921134,2,15,540
84601962@N00,10215,28,1452924634,1452925534,4,15,900
84652765@N00,10216,16,1419033555,1419033825,2,9,270
84652765@N00,10216,3,1419034673,1419034763,5,9,90
84652765@N00,10216,27,1419037335,1419038235,2,9,900
84652765@N00,10216,16,1419038476,1419038746,4,9,270
84652765@N00,10216,27,1419042108,1419043008,2,9,900
84652765@N00,10216,3,1419067079,1419067094,2,9,15
84652765@N00,10216,12,1419067094,1419067334,5,9,240
84652765@N00,10216,6,1419067816,1419067936,6,9,120
84652765@N00,10216,26,1419075321,1419076221,1,9,900
84658322@N02,10217,17,1449898430,1449898730,1,1,300
84738389@N00,10218,28,1375964355,1375965255,2,1,900
84765974@N00,10219,19,1404453105,1404453645,1,1,540
84765974@N00,10220,15,1404623492,1404623762,1,1,270
84765974@N00,10221,7,1409375697,1409375877,1,1,180
84765974@N00,10222,16,1409469362,1409469632,1,1,270
84765974@N00,10223,18,1442236757,1442237207,1,1,450
84765974@N00,10224,18,1455867036,1455867486,1,1,450
84768005@N00,10225,26,1278506259,1278507159,1,1,900
8480533@N07,10226,18,1425885178,1425885628,1,1,450
84807303@N08,10227,16,1369671497,1369671767,1,1,270
8493453@N08,10228,29,1356123172,1356124072,1,1,900
84951093@N00,10229,26,1248696440,1248697340,1,1,900
84951093@N00,10230,16,1249348306,1249348576,1,1,270
8497732@N03,10231,27,1306574835,1306575735,3,1,900
84984744@N00,10232,26,1240623023,1240623923,1,1,900
8502118@N08,10233,18,1375863516,1375863966,23,8,450
8502118@N08,10233,19,1375865672,1375866212,7,8,540
8502118@N08,10233,26,1375866955,1375867855,3,8,900
8502118@N08,10233,11,1375868235,1375868475,2,8,240
8502118@N08,10233,26,1375875066,1375875966,87,8,900
8502118@N08,10233,27,1375877210,1375878110,3,8,900
8502118@N08,10233,16,1375879157,1375879427,2,8,270
8502118@N08,10233,1,1375881917,1375881977,1,8,60
8502118@N08,10234,1,1376211264,1376211324,2,16,60
8502118@N08,10234,28,1376211470,1376211803,2,16,333
8502118@N08,10234,17,1376211803,1376212103,2,16,300
8502118@N08,10234,27,1376212458,1376213358,2,16,900
8502118@N08,10234,25,1376214186,1376215026,39,16,840
8502118@N08,10234,6,1376217341,1376217461,2,16,120
8502118@N08,10234,26,1376220663,1376221050,58,16,387
8502118@N08,10234,16,1376221050,1376221140,13,16,90
8502118@N08,10234,26,1376221140,1376221320,32,16,180
8502118@N08,10234,16,1376221320,1376221445,37,16,125
8502118@N08,10234,26,1376221445,1376222345,16,16,900
8502118@N08,10234,19,1376222897,1376223437,3,16,540
8502118@N08,10234,29,1376223635,1376224535,20,16,900
8502118@N08,10234,23,1376225305,1376225516,11,16,211
8502118@N08,10234,30,1376225516,1376225695,2,16,179
8502118@N08,10234,28,1376225695,1376226595,4,16,900
8502118@N08,10235,28,1439638698,1439639598,87,1,900
8514057@N08,10236,26,1252019877,1252019908,2,17,31
8514057@N08,10236,16,1252019908,1252020156,2,17,248
8514057@N08,10236,15,1252020156,1252020339,3,17,183
8514057@N08,10236,16,1252020339,1252020609,2,17,270
8514057@N08,10236,12,1252021287,1252021468,2,17,181
8514057@N08,10236,25,1252021468,1252022146,2,17,678
8514057@N08,10236,28,1252022146,1252022512,2,17,366
8514057@N08,10236,26,1252022512,1252023412,2,17,900
8514057@N08,10236,30,1252024074,1252025154,10,17,1080
8514057@N08,10236,22,1252025166,1252025392,2,17,226
8514057@N08,10236,31,1252025392,1252025408,3,17,16
8514057@N08,10236,10,1252025408,1252025648,11,17,240
8514057@N08,10236,28,1252026496,1252027396,2,17,900
8514057@N08,10236,13,1252039014,1252039254,2,17,240
8514057@N08,10236,18,1252043375,1252043825,2,17,450
8514057@N08,10236,25,1252053083,1252053923,2,17,840
8514057@N08,10236,26,1252063788,1252064688,22,17,900
85169502@N00,10237,26,1235713458,1235714358,2,1,900
85218196@N00,10238,28,1197822383,1197823283,22,1,900
85218196@N00,10239,28,1197927588,1197928488,11,1,900
85218196@N00,10240,28,1198078547,1198079447,7,1,900
85218196@N00,10241,26,1305686813,1305687713,1,1,900
85218196@N00,10242,3,1305944306,1305944396,1,1,90
85218196@N00,10243,27,1362030072,1362030972,1,1,900
85218196@N00,10244,17,1362130677,1362130977,1,1,300
85218196@N00,10245,12,1362438182,1362438422,2,2,240
85218196@N00,10245,26,1362444643,1362445543,1,2,900
85256056@N00,10246,13,1264864335,1264864575,1,1,240
85318305@N00,10247,1,1291940708,1291940768,3,5,60
85318305@N00,10247,28,1291941067,1291941967,2,5,900
85318305@N00,10247,13,1291955764,1291956004,3,5,240
85318305@N00,10247,26,1291958260,1291958900,3,5,640
85318305@N00,10247,28,1291958900,1291959800,1,5,900
85416212@N02,10248,18,1454569416,1454569866,1,1,450
85428086@N00,10249,1,1237589649,1237589709,3,19,60
85428086@N00,10249,28,1237591847,1237591985,2,19,138
85428086@N00,10249,1,1237591985,1237592045,5,19,60
85428086@N00,10249,29,1237592642,1237593542,2,19,900
85428086@N00,10249,28,1237593886,1237594786,3,19,900
85428086@N00,10249,26,1237595289,1237596189,4,19,900
85428086@N00,10249,10,1237596209,1237596449,2,19,240
85428086@N00,10249,11,1237596474,1237596714,3,19,240
85428086@N00,10249,21,1237597370,1237597812,3,19,442
85428086@N00,10249,11,1237597812,1237597906,2,19,94
85428086@N00,10249,4,1237597906,1237598007,2,19,101
85428086@N00,10249,21,1237598016,1237598209,9,19,193
85428086@N00,10249,12,1237598209,1237598449,2,19,240
85428086@N00,10249,24,1237601652,1237602432,5,19,780
85428086@N00,10249,1,1237612023,1237612083,2,19,60
85428086@N00,10249,30,1237616929,1237618009,6,19,1080
85428086@N00,10249,29,1237618981,1237619881,2,19,900
85428086@N00,10249,22,1237620285,1237620885,6,19,600
85428086@N00,10249,3,1237628376,1237628466,1,19,90
85428086@N00,10250,30,1237685173,1237686253,2,3,1080
85428086@N00,10250,25,1237686495,1237687335,6,3,840
85428086@N00,10250,13,1237688433,1237688673,14,3,240
85583013@N04,10251,26,1386540991,1386541891,3,12,900
85583013@N04,10251,25,1386541984,1386542026,2,12,42
85583013@N04,10251,13,1386542026,1386542266,2,12,240
85583013@N04,10251,24,1386553662,1386553909,2,12,247
85583013@N04,10251,12,1386553909,1386554149,2,12,240
85583013@N04,10251,4,1386560890,1386560991,2,12,101
85583013@N04,10251,13,1386565216,1386565456,2,12,240
85583013@N04,10251,23,1386569101,1386569116,2,12,15
85583013@N04,10251,18,1386569116,1386569566,3,12,450
85583013@N04,10251,31,1386571743,1386571765,2,12,22
85583013@N04,10251,11,1386571765,1386572005,2,12,240
85583013@N04,10251,26,1386581763,1386582663,3,12,900
85583013@N04,10252,23,1386723641,1386724241,2,11,600
85583013@N04,10252,29,1386726279,1386727179,3,11,900
85583013@N04,10252,16,1386744371,1386744641,14,11,270
85583013@N04,10252,26,1386746347,1386747247,3,11,900
85583013@N04,10252,16,1386749033,1386749303,18,11,270
85583013@N04,10252,20,1386752136,1386752676,2,11,540
85583013@N04,10252,29,1386752889,1386752978,3,11,89
85583013@N04,10252,20,1386752978,1386753063,2,11,85
85583013@N04,10252,22,1386753063,1386753606,2,11,543
85583013@N04,10252,19,1386753606,1386754146,2,11,540
85583013@N04,10252,28,1386755705,1386756605,3,11,900
85583013@N04,10253,11,1386796751,1386796778,2,15,27
85583013@N04,10253,27,1386796778,1386796847,6,15,69
85583013@N04,10253,16,1386796847,1386796960,3,15,113
85583013@N04,10253,27,1386796960,1386797860,3,15,900
85583013@N04,10253,16,1386798070,1386798074,2,15,4
85583013@N04,10253,27,1386798074,1386798218,3,15,144
85583013@N04,10253,11,1386798218,1386798220,2,15,2
85583013@N04,10253,16,1386798220,1386798490,2,15,270
85583013@N04,10253,11,1386800581,1386800821,2,15,240
85583013@N04,10253,24,1386806498,1386806653,3,15,155
85583013@N04,10253,15,1386806653,1386806923,2,15,270
85583013@N04,10253,3,1386807414,1386807504,2,15,90
85583013@N04,10253,30,1386809495,1386810575,3,15,1080
85583013@N04,10253,26,1386818148,1386819048,2,15,900
85583013@N04,10253,31,1386819257,1386820757,1,15,1500
85583013@N04,10254,16,1394533507,1394533511,2,2,4
85583013@N04,10254,26,1394533511,1394534411,1,2,900
8565602@N03,10255,1,1194235701,1194235761,9,7,60
8565602@N03,10255,29,1194235998,1194236898,13,7,900
8565602@N03,10255,13,1194237402,1194237642,5,7,240
8565602@N03,10255,24,1194252250,1194252676,4,7,426
8565602@N03,10255,16,1194252676,1194252946,2,7,270
8565602@N03,10255,15,1194254082,1194254352,2,7,270
8565602@N03,10255,17,1194257362,1194257662,2,7,300
8565602@N03,10256,21,1194314944,1194315514,5,6,570
8565602@N03,10256,10,1194316201,1194316441,2,6,240
8565602@N03,10256,30,1194316625,1194317548,2,6,923
8565602@N03,10256,19,1194317548,1194318088,3,6,540
8565602@N03,10256,10,1194320200,1194320440,19,6,240
8565602@N03,10256,12,1194343980,1194344220,5,6,240
8565602@N03,10257,18,1194404102,1194404300,2,10,198
8565602@N03,10257,23,1194404300,1194404900,2,10,600
8565602@N03,10257,30,1194423176,1194423219,5,10,43
8565602@N03,10257,23,1194423219,1194423819,5,10,600
8565602@N03,10257,30,1194423961,1194424859,2,10,898
8565602@N03,10257,22,1194424859,1194425459,2,10,600
8565602@N03,10257,16,1194426204,1194426217,2,10,13
8565602@N03,10257,27,1194426217,1194427117,2,10,900
8565602@N03,10257,24,1194429697,1194430477,3,10,780
8565602@N03,10257,1,1194433045,1194433105,1,10,60
85665489@N00,10258,1,1364417809,1364417869,2,8,60
85665489@N00,10258,28,1364419182,1364420082,3,8,900
85665489@N00,10258,17,1364421918,1364422218,3,8,300
85665489@N00,10258,29,1364432919,1364433819,3,8,900
85665489@N00,10258,17,1364436055,1364436355,2,8,300
85665489@N00,10258,28,1364437387,1364438287,3,8,900
85665489@N00,10258,22,1364459373,1364459973,2,8,600
85665489@N00,10258,17,1364464172,1364464472,1,8,300
85665489@N00,10259,5,1408779637,1408779757,1,1,120
85669531@N00,10260,26,1375678492,1375678643,4,2,151
85669531@N00,10260,18,1375678643,1375679093,1,2,450
85669531@N00,10261,13,1375709683,1375709923,1,1,240
85720390@N03,10262,28,1236219079,1236219979,1,1,900
85793123@N00,10263,8,1317459258,1317459438,1,1,180
85793123@N00,10264,26,1330232775,1330233675,1,1,900
85793123@N00,10265,4,1330463481,1330463582,3,2,101
85793123@N00,10265,9,1330464451,1330464631,1,2,180
85793123@N00,10266,28,1357453851,1357454751,7,1,900
85793123@N00,10267,28,1369370402,1369371302,1,1,900
85793123@N00,10268,1,1374985805,1374985865,5,1,60
85824217@N00,10269,10,1200714087,1200714327,6,1,240
85824217@N00,10270,10,1201236749,1201236989,38,1,240
85864407@N08,10271,28,1347153877,1347154777,3,26,900
85864407@N08,10271,18,1347154850,1347155300,2,26,450
85864407@N08,10271,29,1347160982,1347161882,4,26,900
85864407@N08,10271,14,1347164930,1347165170,3,26,240
85864407@N08,10271,30,1347166502,1347167582,2,26,1080
85864407@N08,10271,26,1347169533,1347170433,2,26,900
85864407@N08,10271,5,1347171905,1347172025,3,26,120
85864407@N08,10271,12,1347172227,1347172467,2,26,240
85864407@N08,10271,24,1347174891,1347175671,3,26,780
85864407@N08,10271,17,1347178073,1347178373,2,26,300
85864407@N08,10271,1,1347180964,1347181024,4,26,60
85864407@N08,10271,28,1347189707,1347190607,2,26,900
85864407@N08,10271,23,1347191234,1347191834,2,26,600
85864407@N08,10271,22,1347192690,1347193290,3,26,600
85864407@N08,10271,10,1347194171,1347194411,2,26,240
85864407@N08,10271,16,1347199882,1347200070,2,26,188
85864407@N08,10271,12,1347200070,1347200310,2,26,240
85864407@N08,10271,27,1347200315,1347201215,2,26,900
85864407@N08,10271,25,1347202358,1347203198,2,26,840
85864407@N08,10271,13,1347203520,1347203748,2,26,228
85864407@N08,10271,3,1347203748,1347203838,3,26,90
85864407@N08,10271,5,1347204168,1347204234,2,26,66
85864407@N08,10271,6,1347204234,1347204354,3,26,120
85864407@N08,10271,26,1347204676,1347205275,3,26,599
85864407@N08,10271,28,1347205275,1347206175,6,26,900
85864407@N08,10271,1,1347206558,1347206618,1,26,60
85864407@N08,10272,24,1347246632,1347247412,3,7,780
85864407@N08,10272,6,1347251720,1347251840,3,7,120
85864407@N08,10272,11,1347255680,1347255920,2,7,240
85864407@N08,10272,26,1347275902,1347276802,12,7,900
85864407@N08,10272,13,1347277082,1347277322,9,7,240
85864407@N08,10272,3,1347279295,1347279385,2,7,90
85864407@N08,10272,1,1347283343,1347283403,1,7,60
85864407@N08,10273,8,1349084503,1349084618,2,2,115
85864407@N08,10273,5,1349084618,1349084738,1,2,120
85864407@N08,10274,3,1356774568,1356774658,1,1,90
85864407@N08,10275,26,1361358599,1361359499,1,1,900
85882671@N00,10276,26,1257558442,1257559342,3,4,900
85882671@N00,10276,30,1257559374,1257560454,2,4,1080
85882671@N00,10276,14,1257562047,1257562287,4,4,240
85882671@N00,10276,24,1257582020,1257582800,1,4,780
85882671@N00,10277,1,1257645310,1257645370,2,15,60
85882671@N00,10277,28,1257645758,1257646658,6,15,900
85882671@N00,10277,16,1257647725,1257647995,2,15,270
85882671@N00,10277,24,1257648989,1257649769,7,15,780
85882671@N00,10277,11,1257651816,1257652056,2,15,240
85882671@N00,10277,23,1257652422,1257653022,5,15,600
85882671@N00,10277,29,1257653070,1257653970,3,15,900
85882671@N00,10277,20,1257656871,1257657411,18,15,540
85882671@N00,10277,29,1257658239,1257659139,3,15,900
85882671@N00,10277,30,1257660880,1257661592,8,15,712
85882671@N00,10277,31,1257661592,1257662037,5,15,445
85882671@N00,10277,7,1257662037,1257662217,3,15,180
85882671@N00,10277,3,1257663787,1257663877,3,15,90
85882671@N00,10277,13,1257664481,1257664721,4,15,240
85882671@N00,10277,29,1257678886,1257679786,1,15,900
85882671@N00,10278,3,1258159933,1258160023,1,1,90
8589880@N03,10279,26,1385543961,1385544861,1,1,900
85903600@N00,10280,18,1392682819,1392683269,2,2,450
85903600@N00,10280,1,1392711141,1392711201,1,2,60
85977134@N00,10281,28,1293831673,1293832573,5,1,900
85977134@N00,10282,26,1302308649,1302309549,5,1,900
85977134@N00,10283,17,1309474124,1309474424,2,5,300
85977134@N00,10283,12,1309475688,1309475928,2,5,240
85977134@N00,10283,25,1309477918,1309478758,2,5,840
85977134@N00,10283,26,1309493255,1309494155,2,5,900
85977134@N00,10283,29,1309505150,1309506050,1,5,900
85977134@N00,10284,13,1325374201,1325374441,3,5,240
85977134@N00,10284,5,1325380096,1325380216,2,5,120
85977134@N00,10284,12,1325380904,1325381144,2,5,240
85977134@N00,10284,7,1325396578,1325396758,2,5,180
85977134@N00,10284,26,1325398551,1325399451,1,5,900
85977134@N00,10285,28,1341022837,1341023737,1,1,900
85977134@N00,10286,28,1350084353,1350085253,1,1,900
85977134@N00,10287,12,1385771091,1385771331,1,1,240
85977134@N00,10288,12,1388535110,1388535350,1,1,240
85977134@N00,10289,3,1396051079,1396051169,1,1,90
85977134@N00,10290,3,1404259962,1404260052,1,1,90
85977134@N00,10291,19,1420067353,1420067893,1,1,540
85979850@N00,10292,17,1302953849,1302954149,1,1,300
8601478@N02,10293,25,1311640641,1311641481,1,1,840
86063712@N00,10294,1,1274054838,1274054898,2,3,60
86063712@N00,10294,29,1274058887,1274059787,3,3,900
86063712@N00,10294,27,1274071818,1274072718,2,3,900
86063712@N00,10295,22,1274165766,1274166366,1,1,600
86063712@N00,10296,13,1274230253,1274230493,1,1,240
86078640@N00,10297,30,1285978002,1285979082,4,1,1080
86078640@N00,10298,30,1286063936,1286065016,3,1,1080
86078640@N00,10299,30,1286180904,1286181984,3,1,1080
86078640@N00,10300,30,1286267259,1286268339,3,1,1080
86111910@N03,10301,28,1309938133,1309939033,1,1,900
86111910@N03,10302,25,1384584937,1384585777,1,1,840
86215268@N02,10303,29,1351155889,1351156789,1,1,900
86249551@N00,10304,26,1371866036,1371866936,2,2,900
86249551@N00,10304,17,1371868848,1371869148,1,2,300
86278660@N00,10305,17,1351308686,1351308986,2,4,300
86278660@N00,10305,1,1351317785,1351317845,3,4,60
86278660@N00,10305,26,1351318284,1351319184,8,4,900
86278660@N00,10305,28,1351320962,1351321862,5,4,900
86333958@N00,10306,26,1287831796,1287831850,4,2,54
86333958@N00,10306,30,1287831850,1287832930,1,2,1080
86333958@N00,10307,31,1288512476,1288513330,3,2,854
86333958@N00,10307,18,1288513330,1288513780,11,2,450
86333958@N00,10308,1,1289630559,1289630619,5,3,60
86333958@N00,10308,26,1289639808,1289640708,18,3,900
86333958@N00,10308,28,1289644091,1289644991,4,3,900
86333958@N00,10309,26,1290672468,1290672968,2,2,500
86333958@N00,10309,25,1290672968,1290673808,2,2,840
86333958@N00,10310,1,1291518726,1291518786,4,2,60
86333958@N00,10310,30,1291521654,1291522734,2,2,1080
86333958@N00,10311,28,1292648959,1292649859,6,1,900
86333958@N00,10312,30,1303898285,1303899365,1,1,1080
86333958@N00,10313,27,1335180657,1335181557,2,2,900
86333958@N00,10313,23,1335192501,1335193101,2,2,600
86333958@N00,10314,29,1337714831,1337715731,1,1,900
86333958@N00,10315,1,1355328592,1355328652,1,1,60
86342787@N00,10316,28,1216950792,1216951692,1,1,900
86363911@N00,10317,16,1293725839,1293726109,1,1,270
86383576@N00,10318,28,1400999477,1401000377,4,6,900
86383576@N00,10318,26,1401007829,1401007919,2,6,90
86383576@N00,10318,28,1401007919,1401007990,2,6,71
86383576@N00,10318,21,1401007990,1401008560,9,6,570
86383576@N00,10318,28,1401012332,1401013232,2,6,900
86383576@N00,10318,26,1401017200,1401018100,90,6,900
86387045@N04,10319,14,1351829457,1351829697,2,1,240
86387045@N04,10320,28,1354614546,1354615446,2,1,900
86392872@N00,10321,3,1207241786,1207241876,3,2,90
86392872@N00,10321,24,1207244833,1207245613,4,2,780
86392872@N00,10322,28,1207273925,1207274825,4,3,900
86392872@N00,10322,30,1207283450,1207284530,2,3,1080
86392872@N00,10322,3,1207285011,1207285101,2,3,90
86392872@N00,10323,22,1207355803,1207356037,2,2,234
86392872@N00,10323,17,1207356037,1207356337,1,2,300
86420008@N02,10324,19,1403860696,1403861236,1,1,540
86446605@N00,10325,8,1386204760,1386204845,2,2,85
86446605@N00,10325,15,1386204845,1386205115,3,2,270
8645545@N02,10326,28,1240527973,1240528860,2,8,887
8645545@N02,10326,31,1240528860,1240529346,2,8,486
8645545@N02,10326,14,1240529346,1240529586,3,8,240
8645545@N02,10326,26,1240531363,1240532242,12,8,879
8645545@N02,10326,6,1240532242,1240532362,2,8,120
8645545@N02,10326,9,1240532635,1240532815,2,8,180
8645545@N02,10326,21,1240534459,1240535029,2,8,570
8645545@N02,10326,13,1240535464,1240535704,22,8,240
86456516@N00,10327,16,1234328098,1234328368,1,1,270
86459399@N00,10328,15,1286682730,1286683000,1,1,270
86459399@N00,10329,21,1286711763,1286712333,2,3,570
86459399@N00,10329,25,1286712953,1286713793,3,3,840
86459399@N00,10329,26,1286714920,1286715820,1,3,900
86459399@N00,10330,1,1286762262,1286762322,2,5,60
86459399@N00,10330,28,1286765210,1286766110,4,5,900
86459399@N00,10330,5,1286766995,1286767115,9,5,120
86459399@N00,10330,16,1286780465,1286780735,3,5,270
86459399@N00,10330,26,1286791140,1286792040,2,5,900
86459399@N00,10331,31,1339380009,1339381509,1,1,1500
86459399@N00,10332,7,1339476351,1339476531,2,3,180
86459399@N00,10332,4,1339478216,1339478317,2,3,101
86459399@N00,10332,24,1339498934,1339499714,3,3,780
86459399@N00,10333,14,1339558958,1339559198,1,1,240
86476099@N00,10334,16,1396642227,1396642497,1,1,270
86542064@N00,10335,1,1361531648,1361531708,1,1,60
8657240@N02,10336,7,1313210027,1313210207,3,2,180
8657240@N02,10336,30,1313211156,1313212236,2,2,1080
86587932@N00,10337,17,1413452110,1413452410,2,2,300
86587932@N00,10337,13,1413458565,1413458805,2,2,240
8658893@N04,10338,29,1383981117,1383982017,1,1,900
86604283@N00,10339,1,1225579827,1225579887,3,19,60
86604283@N00,10339,28,1225580047,1225580638,4,19,591
86604283@N00,10339,29,1225580638,1225581538,5,19,900
86604283@N00,10339,20,1225581843,1225582383,5,19,540
86604283@N00,10339,22,1225583511,1225584111,4,19,600
86604283@N00,10339,30,1225585171,1225586251,14,19,1080
86604283@N00,10339,26,1225597516,1225598416,2,19,900
86604283@N00,10339,27,1225599752,1225600652,3,19,900
86604283@N00,10339,15,1225601284,1225601554,4,19,270
86604283@N00,10339,17,1225603462,1225603762,2,19,300
86604283@N00,10339,16,1225604378,1225604648,2,19,270
86604283@N00,10339,1,1225604705,1225604765,2,19,60
86604283@N00,10339,28,1225615906,1225616806,4,19,900
86604283@N00,10339,3,1225617219,1225617309,11,19,90
86604283@N00,10339,23,1225618557,1225619157,3,19,600
86604283@N00,10339,29,1225620107,1225621007,7,19,900
86604283@N00,10339,27,1225623563,1225624463,2,19,900
86604283@N00,10339,12,1225625378,1225625618,9,19,240
86604283@N00,10339,28,1225629453,1225630353,4,19,900
86604283@N00,10340,22,1236985924,1236986524,3,8,600
86604283@N00,10340,18,1236992996,1236993446,3,8,450
86604283@N00,10340,16,1236995762,1236996032,2,8,270
86604283@N00,10340,12,1236998001,1236998241,2,8,240
86604283@N00,10340,25,1237002610,1237003450,28,8,840
86604283@N00,10340,26,1237006565,1237007086,2,8,521
86604283@N00,10340,28,1237007086,1237007986,2,8,900
86604283@N00,10340,1,1237008076,1237008136,1,8,60
86618086@N02,10341,4,1312415258,1312415359,13,4,101
86618086@N02,10341,7,1312421797,1312421977,2,4,180
86618086@N02,10341,16,1312428536,1312428806,5,4,270
86618086@N02,10341,13,1312440533,1312440773,14,4,240
86672131@N04,10342,17,1433459205,1433459505,5,6,300
86672131@N04,10342,27,1433460609,1433461062,3,6,453
86672131@N04,10342,30,1433461062,1433461965,2,6,903
86672131@N04,10342,20,1433461965,1433462505,2,6,540
86672131@N04,10342,31,1433474339,1433475839,2,6,1500
86672131@N04,10342,23,1433482289,1433482889,1,6,600
86684445@N00,10343,1,1263857394,1263857454,2,2,60
86684445@N00,10343,28,1263857678,1263858578,1,2,900
86684445@N00,10344,22,1263948125,1263948725,2,3,600
86684445@N00,10344,12,1263950764,1263950858,2,3,94
86684445@N00,10344,24,1263950858,1263951638,1,3,780
86686519@N00,10345,26,1205705392,1205706292,5,1,900
86686519@N00,10346,26,1205795943,1205796843,6,1,900
86686519@N00,10347,26,1205825116,1205826016,4,1,900
8674970@N04,10348,8,1216635874,1216636054,1,1,180
8674970@N04,10349,10,1223171082,1223171322,1,1,240
8674970@N04,10350,11,1223773154,1223773394,1,1,240
8674970@N04,10351,28,1224982013,1224982913,1,1,900
8674970@N04,10352,6,1227834697,1227834817,1,1,120
8674970@N04,10353,26,1233371307,1233372207,1,1,900
8674970@N04,10354,7,1233447449,1233447629,2,2,180
8674970@N04,10354,28,1233456559,1233457459,1,2,900
8674970@N04,10355,28,1234244307,1234245207,1,1,900
8674970@N04,10356,5,1246059823,1246059943,1,1,120
8674970@N04,10357,8,1252807240,1252807420,2,2,180
8674970@N04,10357,26,1252819248,1252820148,1,2,900
8674970@N04,10358,28,1256430940,1256430943,2,2,3
8674970@N04,10358,26,1256430943,1256431843,1,2,900
8674970@N04,10359,8,1257989848,1257989871,2,2,23
8674970@N04,10359,7,1257989871,1257990051,1,2,180
8674970@N04,10360,26,1269642751,1269642768,2,3,17
8674970@N04,10360,28,1269642768,1269643668,2,3,900
8674970@N04,10360,26,1269645375,1269646275,1,3,900
8674970@N04,10361,11,1276906202,1276906442,1,1,240
8674970@N04,10362,26,1281681884,1281682784,1,1,900
8674970@N04,10363,28,1284768707,1284769607,2,3,900
8674970@N04,10363,18,1284783739,1284784189,2,3,450
8674970@N04,10363,26,1284791485,1284792385,1,3,900
8674970@N04,10364,6,1287103119,1287103239,1,1,120
8674970@N04,10365,26,1289953055,1289953955,2,2,900
8674970@N04,10365,16,1289960905,1289961175,1,2,270
8674970@N04,10366,26,1295051609,1295052509,1,1,900
8674970@N04,10367,26,1296266585,1296267485,2,1,900
8674970@N04,10368,26,1302047576,1302048476,1,1,900
8674970@N04,10369,26,1306119227,1306120127,3,1,900
8674970@N04,10370,26,1326413475,1326414375,22,1,900
8674970@N04,10371,26,1330739782,1330740682,1,1,900
8674970@N04,10372,26,1334447539,1334448439,56,1,900
8674970@N04,10373,30,1358486550,1358487630,1,1,1080
8674970@N04,10374,11,1384483103,1384483343,1,1,240
8674970@N04,10375,1,1399594060,1399594120,2,2,60
8674970@N04,10375,18,1399611969,1399612419,2,2,450
8674970@N04,10376,31,1410483530,1410485030,2,1,1500
8674970@N04,10377,12,1422150780,1422151020,2,4,240
8674970@N04,10377,26,1422155826,1422156726,2,4,900
8674970@N04,10377,1,1422157263,1422157323,17,4,60
8674970@N04,10377,28,1422167221,1422168121,4,4,900
8674970@N04,10378,26,1435197938,1435198838,1,1,900
8674970@N04,10379,26,1451781489,1451782389,1,1,900
8674970@N04,10380,26,1454032398,1454033298,1,1,900
86765221@N00,10381,30,1345785564,1345786644,1,1,1080
8677608@N07,10382,28,1347108332,1347109232,1,1,900
8684356@N02,10383,28,1348197425,1348198325,1,1,900
86908163@N08,10384,26,1369889244,1369890144,1,1,900
8691238@N02,10385,26,1206489773,1206490673,71,1,900
8692132@N05,10386,30,1316905303,1316906383,28,1,1080
8692132@N05,10387,30,1317625052,1317626132,1,1,1080
86931317@N00,10388,12,1344048561,1344048801,2,1,240
86931317@N00,10389,28,1350622773,1350623673,2,1,900
87028943@N00,10390,18,1452841609,1452842059,1,1,450
87059281@N00,10391,26,1221574943,1221575843,1,1,900
87067940@N00,10392,28,1195598637,1195599537,2,6,900
87067940@N00,10392,24,1195602238,1195603018,2,6,780
87067940@N00,10392,12,1195607207,1195607447,2,6,240
87067940@N00,10392,29,1195608824,1195609724,3,6,900
87067940@N00,10392,28,1195626090,1195626990,3,6,900
87067940@N00,10392,26,1195627285,1195628185,2,6,900
87067940@N00,10393,28,1201070373,1201071273,1,1,900
87067940@N00,10394,23,1204426326,1204426926,2,5,600
87067940@N00,10394,21,1204432612,1204433182,2,5,570
87067940@N00,10394,4,1204433632,1204433733,2,5,101
87067940@N00,10394,23,1204444053,1204444653,2,5,600
87067940@N00,10394,28,1204447375,1204448275,1,5,900
87067940@N00,10395,16,1204537201,1204537471,1,1,270
87067940@N00,10396,24,1254545934,1254546714,2,1,780
87076987@N05,10397,13,1352604308,1352604548,1,1,240
87076987@N05,10398,18,1352636397,1352636847,2,2,450
87076987@N05,10398,12,1352639164,1352639404,1,2,240
87076987@N05,10399,1,1352697326,1352697386,1,1,60
87076987@N05,10400,20,1352727623,1352728163,3,2,540
87076987@N05,10400,15,1352732078,1352732348,1,2,270
87107768@N00,10401,17,1289861213,1289861513,1,1,300
87107768@N00,10402,15,1363331582,1363331852,1,1,270
87112387@N00,10403,28,1402623471,1402624371,25,1,900
87136546@N08,10404,10,1343172615,1343172855,10,1,240
87136546@N08,10405,10,1391898368,1391898608,18,1,240
8720599@N08,10406,28,1208320662,1208321383,2,6,721
8720599@N08,10406,29,1208321383,1208322283,2,6,900
8720599@N08,10406,12,1208326208,1208326448,2,6,240
8720599@N08,10406,18,1208326739,1208327189,2,6,450
8720599@N08,10406,17,1208328246,1208328546,2,6,300
8720599@N08,10406,11,1208334370,1208334610,1,6,240
87304876@N00,10407,1,1233444198,1233444258,3,10,60
87304876@N00,10407,28,1233444376,1233445176,2,10,800
87304876@N00,10407,18,1233445176,1233445352,2,10,176
87304876@N00,10407,26,1233445352,1233446252,3,10,900
87304876@N00,10407,7,1233446793,1233446973,3,10,180
87304876@N00,10407,6,1233447766,1233447886,2,10,120
87304876@N00,10407,13,1233450453,1233450693,2,10,240
87304876@N00,10407,17,1233450823,1233451123,3,10,300
87304876@N00,10407,28,1233451136,1233452036,3,10,900
87304876@N00,10407,24,1233453456,1233454236,2,10,780
8733295@N08,10408,1,1366426015,1366426075,1,1,60
87337984@N06,10409,20,1346653921,1346654461,2,2,540
87337984@N06,10409,19,1346665966,1346666506,2,2,540
8735775@N04,10410,25,1301634776,1301635345,2,2,569
8735775@N04,10410,26,1301635345,1301636245,1,2,900
87358743@N00,10411,29,1356737852,1356738752,2,7,900
87358743@N00,10411,20,1356745818,1356746358,2,7,540
87358743@N00,10411,29,1356747053,1356747285,2,7,232
87358743@N00,10411,7,1356747285,1356747332,2,7,47
87358743@N00,10411,3,1356747332,1356747422,2,7,90
87358743@N00,10411,27,1356756117,1356757017,8,7,900
87358743@N00,10411,28,1356761057,1356761957,1,7,900
87358743@N00,10412,29,1366944631,1366945531,5,3,900
87358743@N00,10412,18,1366964849,1366965299,2,3,450
87358743@N00,10412,29,1366974183,1366975083,1,3,900
87358743@N00,10413,28,1379917498,1379918398,2,3,900
87358743@N00,10413,17,1379927740,1379928040,2,3,300
87358743@N00,10413,20,1379931386,1379931926,1,3,540
87358743@N00,10414,16,1389595289,1389595559,3,4,270
87358743@N00,10414,1,1389599014,1389599074,2,4,60
87358743@N00,10414,18,1389599421,1389599871,2,4,450
87358743@N00,10414,25,1389605998,1389606838,1,4,840
87358743@N00,10415,27,1390735484,1390735661,2,2,177
87358743@N00,10415,17,1390735661,1390735961,1,2,300
87358743@N00,10416,26,1392112750,1392113650,1,1,900
87358743@N00,10417,30,1393125317,1393126397,8,2,1080
87358743@N00,10417,24,1393141441,1393142221,1,2,780
87358743@N00,10418,29,1446802984,1446803884,6,1,900
87411567@N08,10419,1,1408319230,1408319290,1,1,60
87411567@N08,10420,28,1412512727,1412513627,1,1,900
8741255@N04,10421,30,1257646353,1257646359,2,5,6
8741255@N04,10421,14,1257646359,1257646599,2,5,240
8741255@N04,10421,30,1257648071,1257649151,2,5,1080
8741255@N04,10421,16,1257652128,1257652215,2,5,87
8741255@N04,10421,26,1257652215,1257653115,1,5,900
87418912@N00,10422,26,1205325451,1205326351,3,1,900
8743807@N07,10423,30,1197719441,1197720521,1,1,1080
87447493@N00,10424,18,1423349704,1423350154,1,1,450
87478675@N00,10425,16,1362179788,1362179875,2,4,87
87478675@N00,10425,15,1362179875,1362179981,2,4,106
87478675@N00,10425,28,1362179981,1362180250,2,4,269
87478675@N00,10425,27,1362180250,1362181150,1,4,900
87505833@N08,10426,19,1407287293,1407287833,4,6,540
87505833@N08,10426,18,1407293828,1407294278,2,6,450
87505833@N08,10426,23,1407294408,1407295008,2,6,600
87505833@N08,10426,29,1407301235,1407302135,3,6,900
87505833@N08,10426,26,1407314447,1407315347,2,6,900
87505833@N08,10426,13,1407316699,1407316939,1,6,240
87527417@N04,10427,1,1395486425,1395486485,1,1,60
87566499@N03,10428,26,1410668749,1410669649,11,1,900
87604302@N07,10429,25,1348695761,1348695762,2,7,1
87604302@N07,10429,15,1348695762,1348695764,2,7,2
87604302@N07,10429,12,1348695764,1348695769,2,7,5
87604302@N07,10429,13,1348695769,1348695772,2,7,3
87604302@N07,10429,26,1348695772,1348695776,2,7,4
87604302@N07,10429,13,1348695776,1348695780,2,7,4
87604302@N07,10429,16,1348695780,1348696050,1,7,270
87612985@N04,10430,28,1348473103,1348474003,1,1,900
87621759@N05,10431,26,1387253721,1387254490,2,4,769
87621759@N05,10431,23,1387254490,1387255090,2,4,600
87621759@N05,10431,30,1387258944,1387260024,2,4,1080
87621759@N05,10431,27,1387277438,1387278338,1,4,900
87639371@N00,10432,21,1306123389,1306123959,1,1,570
87639371@N00,10433,29,1306280959,1306281859,1,1,900
87639371@N00,10434,1,1438687209,1438687269,4,1,60
87657273@N00,10435,28,1291852569,1291852965,5,12,396
87657273@N00,10435,23,1291852965,1291853224,11,12,259
87657273@N00,10435,18,1291853224,1291853674,41,12,450
87657273@N00,10435,29,1291857231,1291858131,32,12,900
87657273@N00,10435,22,1291861715,1291862315,25,12,600
87657273@N00,10435,12,1291871143,1291871383,7,12,240
87657273@N00,10435,28,1291875041,1291875580,5,12,539
87657273@N00,10435,13,1291875580,1291875820,5,12,240
87657273@N00,10435,17,1291886423,1291886723,2,12,300
87657273@N00,10435,16,1291887014,1291887284,4,12,270
87657273@N00,10435,26,1291887948,1291888390,13,12,442
87657273@N00,10435,28,1291888390,1291889290,11,12,900
87657273@N00,10436,16,1292454123,1292454393,1,1,270
87657273@N00,10437,22,1315217529,1315218129,1,1,600
8780153@N02,10438,26,1367810565,1367811465,100,1,900
87839404@N00,10439,20,1459043355,1459043895,2,2,540
87839404@N00,10439,29,1459070321,1459071221,1,2,900
87839593@N07,10440,31,1313542618,1313544118,1,1,1500
87854506@N04,10441,1,1351219320,1351219380,1,1,60
8786056@N07,10442,29,1394540184,1394541084,1,1,900
87889801@N00,10443,10,1198541060,1198541300,2,5,240
87889801@N00,10443,3,1198542538,1198542628,2,5,90
87889801@N00,10443,13,1198544321,1198544561,2,5,240
87889801@N00,10443,16,1198547140,1198547266,2,5,126
87889801@N00,10443,26,1198547266,1198548166,1,5,900
87895332@N08,10444,1,1358992777,1358992837,2,4,60
87895332@N08,10444,26,1358995748,1358995972,2,4,224
87895332@N08,10444,28,1358995972,1358996872,4,4,900
87895332@N08,10444,26,1359009429,1359010329,1,4,900
87895332@N08,10445,30,1359061148,1359061412,3,4,264
87895332@N08,10445,29,1359061412,1359061891,3,4,479
87895332@N08,10445,20,1359061891,1359062093,2,4,202
87895332@N08,10445,14,1359062093,1359062333,2,4,240
87895332@N08,10446,29,1359106865,1359106991,2,2,126
87895332@N08,10446,18,1359106991,1359107441,3,2,450
87895332@N08,10447,26,1362300176,1362301076,1,1,900
87895332@N08,10448,13,1371720042,1371720282,2,2,240
87895332@N08,10448,28,1371730718,1371731618,1,2,900
87895332@N08,10449,28,1373801096,1373801996,2,1,900
87895332@N08,10450,26,1390127517,1390128417,2,4,900
87895332@N08,10450,18,1390131572,1390131897,3,4,325
87895332@N08,10450,25,1390131897,1390132495,2,4,598
87895332@N08,10450,26,1390132495,1390133395,1,4,900
87895332@N08,10451,28,1391932993,1391933893,2,2,900
87895332@N08,10451,13,1391949771,1391950011,1,2,240
87895332@N08,10452,19,1392016984,1392017524,1,1,540
87895332@N08,10453,1,1400796835,1400796895,1,1,60
87895332@N08,10454,29,1403171198,1403172098,1,1,900
87895332@N08,10455,19,1405650252,1405650792,1,1,540
87895332@N08,10456,19,1407653266,1407653806,1,1,540
87895332@N08,10457,27,1428396708,1428397608,1,1,900
87935891@N08,10458,10,1332762034,1332762037,2,3,3
87935891@N08,10458,26,1332762037,1332762038,2,3,1
87935891@N08,10458,8,1332762038,1332762218,1,3,180
87935891@N08,10459,23,1347155370,1347155970,1,1,600
87935891@N08,10460,18,1363089552,1363090002,1,1,450
87935891@N08,10461,26,1381819353,1381820253,2,2,900
87935891@N08,10461,29,1381834472,1381835372,1,2,900
87942779@N00,10462,20,1200562548,1200563088,1,1,540
87942779@N00,10463,27,1201912370,1201913270,4,7,900
87942779@N00,10463,15,1201917693,1201917963,2,7,270
87942779@N00,10463,26,1201918248,1201919148,4,7,900
87942779@N00,10463,14,1201934102,1201934342,2,7,240
87942779@N00,10463,28,1201945404,1201946304,2,7,900
87942779@N00,10463,14,1201949771,1201949894,2,7,123
87942779@N00,10463,28,1201949894,1201950794,1,7,900
87942779@N00,10464,16,1202119528,1202119798,1,1,270
87942779@N00,10465,18,1202603566,1202604016,2,3,450
87942779@N00,10465,26,1202604190,1202604674,4,3,484
87942779@N00,10465,29,1202604674,1202605574,1,3,900
87942779@N00,10466,22,1202904193,1202904793,1,1,600
87942779@N00,10467,28,1207571091,1207571991,1,1,900
87942779@N00,10468,28,1209638379,1209639279,1,1,900
87942779@N00,10469,17,1210852963,1210853263,1,1,300
87942779@N00,10470,15,1246776987,1246777257,1,1,270
87942779@N00,10471,26,1285329200,1285330100,3,1,900
87942779@N00,10472,23,1285393741,1285394341,2,1,600
87974483@N02,10473,10,1283727649,1283727889,280,1,240
87974483@N02,10474,27,1378685253,1378686153,153,1,900
88013957@N07,10475,28,1354889610,1354890510,1,1,900
8802344@N03,10476,28,1307055745,1307056308,2,7,563
8802344@N03,10476,1,1307056308,1307056368,2,7,60
8802344@N03,10476,13,1307063283,1307063523,2,7,240
8802344@N03,10476,29,1307073673,1307074573,2,7,900
8802344@N03,10476,19,1307079335,1307079875,3,7,540
8802344@N03,10476,18,1307080616,1307081066,2,7,450
8802344@N03,10476,1,1307085978,1307086038,5,7,60
88042436@N02,10477,26,1400383485,1400384385,1,1,900
88073012@N00,10478,28,1277890581,1277891481,1,1,900
88073012@N00,10479,29,1301388349,1301389249,1,1,900
88073012@N00,10480,27,1305448425,1305449325,1,1,900
88074728@N02,10481,28,1349914014,1349914914,1,1,900
88074728@N02,10482,15,1349950447,1349950717,1,1,270
88074728@N02,10483,28,1349989755,1349990655,1,1,900
88074728@N02,10484,28,1350164694,1350165594,1,1,900
88074728@N02,10485,28,1350214289,1350215189,1,1,900
8807942@N05,10486,13,1290736881,1290737121,3,1,240
88129361@N05,10487,26,1465872237,1465873137,2,1,900
88158593@N00,10488,28,1302593266,1302594166,3,6,900
88158593@N00,10488,27,1302596041,1302596941,2,6,900
88158593@N00,10488,22,1302603188,1302603788,2,6,600
88158593@N00,10488,15,1302606342,1302606612,2,6,270
88158593@N00,10488,18,1302611136,1302611586,2,6,450
88158593@N00,10488,21,1302621453,1302622023,1,6,570
88211437@N04,10489,3,1351991786,1351991876,2,1,90
88238443@N04,10490,15,1372494348,1372494618,1,1,270
88242284@N03,10491,1,1364339635,1364339695,2,8,60
88242284@N03,10491,26,1364339910,1364340810,3,8,900
88242284@N03,10491,19,1364353571,1364353747,3,8,176
88242284@N03,10491,18,1364353747,1364353781,2,8,34
88242284@N03,10491,19,1364353781,1364354321,2,8,540
88242284@N03,10491,16,1364356524,1364356794,9,8,270
88242284@N03,10491,12,1364365129,1364365369,2,8,240
88242284@N03,10491,21,1364365675,1364366245,4,8,570
88242284@N03,10492,17,1395981843,1395982143,2,4,300
88242284@N03,10492,7,1395986560,1395986740,2,4,180
88242284@N03,10492,26,1395987547,1395988447,2,4,900
88242284@N03,10492,24,1395991830,1395992610,1,4,780
88242284@N03,10493,5,1457739880,1457740000,2,7,120
88242284@N03,10493,4,1457746422,1457746523,2,7,101
88242284@N03,10493,17,1457751229,1457751529,2,7,300
88242284@N03,10493,16,1457761479,1457761749,2,7,270
88242284@N03,10493,13,1457765531,1457765771,3,7,240
88242284@N03,10493,21,1457775269,1457775839,2,7,570
88242284@N03,10493,25,1457775846,1457776686,2,7,840
88254333@N00,10494,31,1241078685,1241080185,2,3,1500
88254333@N00,10494,6,1241083778,1241083898,2,3,120
88254333@N00,10494,28,1241084282,1241085182,1,3,900
88294868@N00,10495,1,1317720471,1317720531,2,2,60
88294868@N00,10495,27,1317727667,1317728567,1,2,900
88328627@N00,10496,18,1425371328,1425371778,1,1,450
8838280@N07,10497,6,1235780824,1235780944,2,4,120
8838280@N07,10497,21,1235789107,1235789107,2,4,0
8838280@N07,10497,25,1235789107,1235789947,2,4,840
8838280@N07,10497,29,1235801292,1235802192,1,4,900
88401211@N06,10498,1,1434085147,1434085207,35,1,60
88411530@N00,10499,3,1204500142,1204500148,2,2,6
88411530@N00,10499,16,1204500148,1204500418,1,2,270
8848099@N03,10500,16,1356488182,1356488452,3,2,270
8848099@N03,10500,25,1356505399,1356506239,2,2,840
8848099@N03,10501,25,1364540089,1364540274,2,2,185
8848099@N03,10501,11,1364540274,1364540514,1,2,240
88494442@N00,10502,19,1410395631,1410396171,2,2,540
88494442@N00,10502,4,1410418164,1410418265,1,2,101
88494442@N00,10503,6,1410495814,1410495934,2,2,120
88494442@N00,10503,14,1410496120,1410496360,3,2,240
88494442@N00,10504,27,1410677472,1410677546,2,3,74
88494442@N00,10504,13,1410677546,1410677786,4,3,240
88494442@N00,10504,19,1410678331,1410678871,1,3,540
88494442@N00,10505,26,1410762548,1410762882,3,2,334
88494442@N00,10505,19,1410762882,1410763422,1,2,540
88511321@N00,10506,26,1377912648,1377913548,1,1,900
88533186@N07,10507,27,1369685193,1369686093,1,1,900
88537228@N00,10508,24,1216954699,1216955479,1,1,780
88537228@N00,10509,28,1216985359,1216986259,2,1,900
88537228@N00,10510,5,1300751958,1300752078,3,5,120
88537228@N00,10510,8,1300755518,1300755698,3,5,180
88537228@N00,10510,13,1300760340,1300760580,2,5,240
88537228@N00,10510,1,1300766938,1300766998,5,5,60
88537228@N00,10510,26,1300769505,1300770405,2,5,900
88537228@N00,10511,1,1300926030,1300926090,4,4,60
88537228@N00,10511,19,1300927169,1300927709,4,4,540
88537228@N00,10511,30,1300929042,1300930122,8,4,1080
88537228@N00,10511,4,1300931864,1300931965,1,4,101
88537228@N00,10512,5,1300966573,1300966693,2,2,120
88537228@N00,10512,26,1300966772,1300967672,1,2,900
88537228@N00,10513,24,1413855621,1413856401,2,2,780
88537228@N00,10513,14,1413865665,1413865905,1,2,240
8854023@N06,10514,1,1322173942,1322174002,2,14,60
8854023@N06,10514,27,1322174429,1322175329,4,14,900
8854023@N06,10514,16,1322175535,1322175805,3,14,270
8854023@N06,10514,6,1322182308,1322182428,2,14,120
8854023@N06,10514,11,1322187907,1322188147,5,14,240
8854023@N06,10514,21,1322189635,1322190205,2,14,570
8854023@N06,10514,25,1322191387,1322192227,2,14,840
8854023@N06,10514,26,1322192828,1322193728,3,14,900
8854023@N06,10514,13,1322195750,1322195990,2,14,240
8854023@N06,10514,26,1322199936,1322200836,3,14,900
8854023@N06,10514,16,1322203878,1322204148,15,14,270
8854023@N06,10514,5,1322205567,1322205687,2,14,120
8854023@N06,10514,29,1322207906,1322208806,2,14,900
8854023@N06,10514,28,1322226298,1322227198,2,14,900
88649709@N00,10515,30,1389504376,1389505456,25,1,1080
88664007@N06,10516,28,1355742137,1355743037,1,1,900
88664007@N06,10517,28,1355909332,1355910232,1,1,900
88664007@N06,10518,13,1463545578,1463545818,1,1,240
88711965@N00,10519,19,1407073804,1407074344,1,1,540
88719648@N00,10520,1,1393815436,1393815457,2,5,21
88719648@N00,10520,19,1393815457,1393815997,2,5,540
88719648@N00,10520,4,1393820825,1393820926,5,5,101
88719648@N00,10520,13,1393836955,1393837195,8,5,240
88719648@N00,10520,16,1393841604,1393841874,1,5,270
88719648@N00,10521,28,1393902453,1393903353,4,6,900
88719648@N00,10521,3,1393903678,1393903768,4,6,90
88719648@N00,10521,7,1393904674,1393904854,3,6,180
88719648@N00,10521,21,1393905300,1393905310,2,6,10
88719648@N00,10521,5,1393905310,1393905430,3,6,120
88719648@N00,10521,28,1393931997,1393932897,4,6,900
88719648@N00,10522,1,1394074640,1394074700,5,4,60
88719648@N00,10522,6,1394076557,1394076677,5,4,120
88719648@N00,10522,7,1394076873,1394077053,4,4,180
88719648@N00,10522,5,1394077665,1394077785,4,4,120
88719648@N00,10523,16,1394111891,1394112161,7,2,270
88719648@N00,10523,1,1394112405,1394112465,1,2,60
88773568@N00,10524,17,1200172498,1200172798,2,2,300
88773568@N00,10524,24,1200186098,1200186878,1,2,780
88773568@N00,10525,30,1210469010,1210470090,3,1,1080
88776513@N00,10526,26,1230261278,1230262178,3,1,900
88787599@N00,10527,22,1189306307,1189306907,1,1,600
88787599@N00,10528,30,1244862308,1244863388,2,1,1080
88787599@N00,10529,29,1244894168,1244895068,3,1,900
88787599@N00,10530,28,1252725828,1252726728,1,1,900
88787599@N00,10531,29,1257554607,1257555507,1,1,900
88787599@N00,10532,28,1258625584,1258626305,2,3,721
88787599@N00,10532,12,1258626305,1258626545,2,3,240
88787599@N00,10532,16,1258635810,1258636080,1,3,270
88787599@N00,10533,1,1267241498,1267241558,4,2,60
88787599@N00,10533,27,1267245172,1267246072,1,2,900
88787599@N00,10534,1,1359505747,1359505807,17,1,60
88790526@N05,10535,1,1365241031,1365241091,1,1,60
88850477@N03,10536,1,1374393841,1374393901,3,1,60
88859913@N00,10537,12,1366528549,1366528789,2,5,240
88859913@N00,10537,3,1366529420,1366529510,2,5,90
88859913@N00,10537,25,1366532497,1366533282,2,5,785
88859913@N00,10537,13,1366533282,1366533522,2,5,240
88859913@N00,10537,1,1366536411,1366536471,2,5,60
88859913@N00,10538,26,1366588459,1366589196,2,19,737
88859913@N00,10538,16,1366589196,1366589466,3,19,270
88859913@N00,10538,26,1366592510,1366593410,2,19,900
88859913@N00,10538,16,1366593594,1366593864,2,19,270
88859913@N00,10538,25,1366595664,1366596317,2,19,653
88859913@N00,10538,16,1366596317,1366596587,2,19,270
88859913@N00,10538,24,1366598480,1366599260,2,19,780
88859913@N00,10538,27,1366599442,1366600342,2,19,900
88859913@N00,10538,17,1366600619,1366600919,2,19,300
88859913@N00,10538,8,1366604299,1366604479,2,19,180
88859913@N00,10538,19,1366607538,1366608078,4,19,540
88859913@N00,10538,29,1366608830,1366609730,2,19,900
88859913@N00,10538,31,1366610398,1366610924,2,19,526
88859913@N00,10538,22,1366610924,1366611135,4,19,211
88859913@N00,10538,31,1366611135,1366612635,2,19,1500
88859913@N00,10538,18,1366625882,1366626031,2,19,149
88859913@N00,10538,26,1366626031,1366626498,3,19,467
88859913@N00,10538,27,1366626498,1366626593,3,19,95
88859913@N00,10538,16,1366626593,1366626863,1,19,270
88861583@N06,10539,19,1346218957,1346219497,1,1,540
88891730@N00,10540,23,1313032579,1313033179,9,1,600
88891730@N00,10541,23,1313122868,1313123468,3,1,600
88891730@N00,10542,23,1313211993,1313212593,6,1,600
88935086@N05,10543,28,1356389259,1356390159,2,1,900
88935086@N05,10544,28,1356427748,1356428648,4,1,900
88937309@N00,10545,18,1434953956,1434954406,1,1,450
88955553@N00,10546,28,1412543011,1412543118,2,15,107
88955553@N00,10546,26,1412543118,1412543248,2,15,130
88955553@N00,10546,6,1412543248,1412543368,3,15,120
88955553@N00,10546,5,1412544100,1412544220,2,15,120
88955553@N00,10546,7,1412544241,1412544313,2,15,72
88955553@N00,10546,5,1412544313,1412544433,2,15,120
88955553@N00,10546,21,1412544634,1412544724,2,15,90
88955553@N00,10546,3,1412544724,1412544768,2,15,44
88955553@N00,10546,21,1412544768,1412545338,6,15,570
88955553@N00,10546,13,1412546237,1412546477,9,15,240
88955553@N00,10546,16,1412547979,1412548249,2,15,270
88955553@N00,10546,27,1412548917,1412549817,2,15,900
88955553@N00,10546,29,1412552694,1412553594,3,15,900
88955553@N00,10546,14,1412554768,1412555008,3,15,240
88955553@N00,10546,28,1412572821,1412573721,2,15,900
88984016@N00,10547,28,1313541933,1313542833,3,3,900
88984016@N00,10547,26,1313550403,1313551303,2,3,900
88984016@N00,10547,27,1313561558,1313562458,1,3,900
88984016@N00,10548,1,1313644761,1313644821,1,1,60
88984016@N00,10549,28,1313706965,1313707865,2,3,900
88984016@N00,10549,26,1313708310,1313709210,2,3,900
88984016@N00,10549,28,1313714296,1313715196,1,3,900
88984016@N00,10550,26,1314035154,1314036054,2,2,900
88984016@N00,10550,23,1314039742,1314040342,2,2,600
89072528@N00,10551,17,1393727941,1393728241,2,2,300
89072528@N00,10551,28,1393732930,1393733830,5,2,900
89072528@N00,10552,19,1404552289,1404552829,1,1,540
89087405@N00,10553,22,1356138261,1356138861,1,1,600
89091370@N03,10554,11,1375749945,1375749949,2,7,4
89091370@N03,10554,24,1375749949,1375750021,7,7,72
89091370@N03,10554,12,1375750021,1375750174,4,7,153
89091370@N03,10554,24,1375750174,1375750954,2,7,780
89091370@N03,10554,23,1375752092,1375752692,3,7,600
89091370@N03,10554,6,1375755608,1375755728,2,7,120
89091370@N03,10554,4,1375765944,1375766045,1,7,101
89095907@N00,10555,6,1360045586,1360045706,1,1,120
89095907@N00,10556,3,1397738320,1397738410,2,2,90
89095907@N00,10556,4,1397739597,1397739698,2,2,101
89095907@N00,10557,14,1397872250,1397872490,1,1,240
89095907@N00,10558,29,1397906400,1397907300,1,1,900
8910343@N04,10559,1,1370515640,1370515700,1,1,60
8913581@N06,10560,16,1366251376,1366251646,1,1,270
89234062@N00,10561,7,1396132312,1396132492,1,1,180
89234062@N00,10562,26,1396296386,1396297286,1,1,900
89253026@N00,10563,26,1305371703,1305372603,1,1,900
8926016@N04,10564,28,1332146724,1332147624,8,1,900
89286166@N02,10565,20,1345924607,1345925147,2,1,540
89286166@N02,10566,20,1350397589,1350398129,1,1,540
89286166@N02,10567,20,1363548703,1363549243,1,1,540
89286166@N02,10568,26,1364071958,1364072858,1,1,900
89286166@N02,10569,30,1365440053,1365441133,1,1,1080
8928810@N02,10570,10,1315375027,1315375267,1,1,240
8928810@N02,10571,30,1316670678,1316670712,2,5,34
8928810@N02,10571,19,1316670712,1316671252,2,5,540
8928810@N02,10571,11,1316673412,1316673652,2,5,240
8928810@N02,10571,26,1316678042,1316678864,3,5,822
8928810@N02,10571,21,1316678864,1316679434,1,5,570
89379256@N08,10572,30,1356827987,1356829067,12,1,1080
89379256@N08,10573,30,1356912129,1356913209,14,1,1080
89379256@N08,10574,30,1357085606,1357086686,21,1,1080
89388079@N07,10575,30,1299743336,1299744416,2,1,1080
89388079@N07,10576,30,1306380834,1306381914,3,1,1080
89388079@N07,10577,30,1325843719,1325844799,2,3,1080
89388079@N07,10577,20,1325848577,1325849117,3,3,540
89388079@N07,10577,28,1325852721,1325853621,1,3,900
89388079@N07,10578,5,1330512093,1330512111,2,3,18
89388079@N07,10578,3,1330512111,1330512201,2,3,90
89388079@N07,10578,7,1330512389,1330512569,1,3,180
89388079@N07,10579,26,1331012069,1331012969,3,1,900
89388079@N07,10580,29,1391319316,1391320216,1,1,900
89388079@N07,10581,7,1396349468,1396349648,1,1,180
89388079@N07,10582,28,1403008737,1403009637,2,2,900
89388079@N07,10582,22,1403009766,1403010366,1,2,600
89388079@N07,10583,1,1459668445,1459668505,1,1,60
89399113@N00,10584,13,1354560045,1354560075,2,2,30
89399113@N00,10584,28,1354560075,1354560975,4,2,900
89414761@N00,10585,28,1305410891,1305411791,2,5,900
89414761@N00,10585,25,1305416270,1305417110,2,5,840
89414761@N00,10585,13,1305421424,1305421664,3,5,240
89414761@N00,10585,29,1305427794,1305428694,2,5,900
89414761@N00,10585,22,1305434114,1305434714,1,5,600
89414761@N00,10586,17,1305674326,1305674626,2,3,300
89414761@N00,10586,15,1305676006,1305676276,2,3,270
89414761@N00,10586,3,1305682941,1305683031,1,3,90
89414761@N00,10587,22,1305855130,1305855730,2,2,600
89414761@N00,10587,31,1305855839,1305857339,1,2,1500
89414761@N00,10588,21,1306193821,1306194391,1,1,570
89414761@N00,10589,17,1306407094,1306407394,1,1,300
8949620@N08,10590,13,1199639951,1199639987,2,6,36
8949620@N08,10590,31,1199639987,1199640022,2,6,35
8949620@N08,10590,13,1199640022,1199640096,2,6,74
8949620@N08,10590,12,1199640096,1199640177,3,6,81
8949620@N08,10590,23,1199640177,1199640223,3,6,46
8949620@N08,10590,29,1199640223,1199641123,1,6,900
8949620@N08,10591,30,1220968800,1220968801,2,6,1
8949620@N08,10591,1,1220968801,1220968808,2,6,7
8949620@N08,10591,13,1220968808,1220968817,2,6,9
8949620@N08,10591,1,1220968817,1220968818,2,6,1
8949620@N08,10591,28,1220968818,1220968824,4,6,6
8949620@N08,10591,20,1220968824,1220969364,4,6,540
8949620@N08,10592,22,1221013747,1221014347,1,1,600
8949620@N08,10593,13,1241419587,1241419699,2,2,112
8949620@N08,10593,25,1241419699,1241420539,1,2,840
8949620@N08,10594,25,1241506486,1241507326,1,1,840
89564686@N00,10595,17,1257922802,1257923102,1,1,300
89564686@N00,10596,17,1259128980,1259129280,1,1,300
89564686@N00,10597,17,1261050001,1261050301,1,1,300
89564686@N00,10598,17,1274620382,1274620682,1,1,300
89564686@N00,10599,17,1280658842,1280659142,1,1,300
89564686@N00,10600,17,1287648063,1287648363,2,1,300
8956474@N05,10601,17,1328021260,1328021560,2,1,300
89608302@N03,10602,1,1358554887,1358554947,1,1,60
89696810@N00,10603,1,1218620503,1218620563,2,7,60
89696810@N00,10603,18,1218622173,1218622623,3,7,450
89696810@N00,10603,29,1218624681,1218625581,3,7,900
89696810@N00,10603,19,1218630571,1218631111,2,7,540
89696810@N00,10603,20,1218631153,1218631693,5,7,540
89696810@N00,10603,28,1218640037,1218640937,2,7,900
89696810@N00,10603,17,1218641113,1218641413,2,7,300
89713825@N00,10604,10,1246515531,1246515771,1,1,240
89804841@N00,10605,16,1296779316,1296779586,8,4,270
89804841@N00,10605,27,1296791118,1296792018,7,4,900
89804841@N00,10605,16,1296792200,1296792470,3,4,270
89804841@N00,10605,13,1296801797,1296802037,17,4,240
89804841@N00,10606,27,1296873279,1296874179,2,3,900
89804841@N00,10606,16,1296874249,1296874519,11,3,270
89804841@N00,10606,28,1296875301,1296876201,3,3,900
89804841@N00,10607,28,1296906120,1296907020,8,1,900
89804841@N00,10608,13,1296957489,1296957729,29,7,240
89804841@N00,10608,16,1296960257,1296960527,4,7,270
89804841@N00,10608,27,1296963900,1296964408,9,7,508
89804841@N00,10608,16,1296964408,1296964678,3,7,270
89804841@N00,10608,27,1296964849,1296965749,7,7,900
89804841@N00,10608,6,1296968687,1296968807,20,7,120
89804841@N00,10608,19,1296970927,1296971467,16,7,540
89857381@N04,10609,20,1377916629,1377916871,2,3,242
89857381@N04,10609,1,1377916871,1377916931,5,3,60
89857381@N04,10609,11,1377917588,1377917828,3,3,240
89857381@N04,10610,30,1379053716,1379054067,2,2,351
89857381@N04,10610,28,1379054067,1379054967,5,2,900
89857381@N04,10611,28,1379574284,1379575184,2,6,900
89857381@N04,10611,30,1379578882,1379579962,2,6,1080
89857381@N04,10611,11,1379580181,1379580421,2,6,240
89857381@N04,10611,7,1379580706,1379580886,4,6,180
89857381@N04,10611,8,1379581428,1379581558,2,6,130
89857381@N04,10611,26,1379581558,1379582458,1,6,900
89857381@N04,10612,28,1379723924,1379724783,2,4,859
89857381@N04,10612,26,1379724783,1379725360,2,4,577
89857381@N04,10612,30,1379725360,1379725518,2,4,158
89857381@N04,10612,29,1379725518,1379726418,1,4,900
89857381@N04,10613,1,1380867077,1380867137,3,1,60
89857381@N04,10614,28,1382737388,1382738120,3,6,732
89857381@N04,10614,26,1382738120,1382738543,2,6,423
89857381@N04,10614,1,1382738543,1382738603,2,6,60
89857381@N04,10614,28,1382738867,1382739767,4,6,900
89857381@N04,10614,15,1382743955,1382744225,2,6,270
89857381@N04,10614,1,1382744583,1382744643,1,6,60
89857381@N04,10615,1,1383944971,1383945031,2,6,60
89857381@N04,10615,26,1383947545,1383948445,2,6,900
89857381@N04,10615,29,1383956443,1383957343,6,6,900
89857381@N04,10615,20,1383959114,1383959367,2,6,253
89857381@N04,10615,29,1383959367,1383959490,2,6,123
89857381@N04,10615,20,1383959490,1383960030,2,6,540
89857381@N04,10616,1,1384233752,1384233812,2,6,60
89857381@N04,10616,28,1384234097,1384234349,2,6,252
89857381@N04,10616,1,1384234349,1384234409,2,6,60
89857381@N04,10616,30,1384242782,1384243862,3,6,1080
89857381@N04,10616,3,1384247360,1384247450,2,6,90
89857381@N04,10616,26,1384247855,1384248755,2,6,900
89857381@N04,10617,28,1384552504,1384553404,2,1,900
89857381@N04,10618,15,1384725655,1384725808,2,2,153
89857381@N04,10618,28,1384725808,1384726708,1,2,900
89857381@N04,10619,23,1385163519,1385163712,2,5,193
89857381@N04,10619,28,1385163712,1385164612,2,5,900
89857381@N04,10619,11,1385166304,1385166544,2,5,240
89857381@N04,10619,7,1385167149,1385167329,2,5,180
89857381@N04,10619,27,1385168492,1385169392,2,5,900
89857381@N04,10620,28,1385199264,1385200164,1,1,900
89857381@N04,10621,1,1385601544,1385601604,2,3,60
89857381@N04,10621,29,1385607485,1385608161,2,3,676
89857381@N04,10621,20,1385608161,1385608701,2,3,540
89857381@N04,10622,28,1385678440,1385679340,2,4,900
89857381@N04,10622,25,1385682665,1385683505,3,4,840
89857381@N04,10622,13,1385684248,1385684488,4,4,240
89857381@N04,10622,30,1385688874,1385689954,3,4,1080
89857381@N04,10623,26,1385802840,1385803740,4,2,900
89857381@N04,10623,24,1385807421,1385808201,1,2,780
89857381@N04,10624,29,1386238893,1386239793,1,1,900
89857381@N04,10625,28,1386388957,1386389857,2,5,900
89857381@N04,10625,1,1386392076,1386392136,2,5,60
89857381@N04,10625,7,1386392890,1386393070,2,5,180
89857381@N04,10625,28,1386396133,1386397033,3,5,900
89857381@N04,10625,1,1386405451,1386405511,1,5,60
89857381@N04,10626,29,1386477033,1386477933,3,1,900
89857381@N04,10627,29,1389521814,1389521910,2,6,96
89857381@N04,10627,31,1389521910,1389522005,2,6,95
89857381@N04,10627,30,1389522005,1389522096,2,6,91
89857381@N04,10627,20,1389522096,1389522304,3,6,208
89857381@N04,10627,29,1389522304,1389522417,2,6,113
89857381@N04,10627,13,1389522417,1389522657,1,6,240
89857381@N04,10628,1,1389850752,1389850812,2,3,60
89857381@N04,10628,30,1389850876,1389851956,4,3,1080
89857381@N04,10628,28,1389861503,1389862403,1,3,900
89857381@N04,10629,1,1390545705,1390545765,2,2,60
89857381@N04,10629,30,1390551308,1390552388,2,2,1080
89857381@N04,10630,28,1390601927,1390602827,4,2,900
89857381@N04,10630,1,1390605098,1390605158,1,2,60
89857381@N04,10631,29,1390976255,1390976712,4,7,457
89857381@N04,10631,20,1390976712,1390977141,2,7,429
89857381@N04,10631,29,1390977141,1390978041,2,7,900
89857381@N04,10631,28,1390984980,1390985880,2,7,900
89857381@N04,10631,4,1390985945,1390986046,2,7,101
89857381@N04,10631,11,1390987724,1390987964,2,7,240
89857381@N04,10631,7,1390988215,1390988395,1,7,180
89857381@N04,10632,28,1391292337,1391292494,2,3,157
89857381@N04,10632,12,1391292494,1391292655,2,3,161
89857381@N04,10632,28,1391292655,1391293555,2,3,900
89857381@N04,10633,24,1391740152,1391740932,2,2,780
89857381@N04,10633,30,1391741176,1391742256,3,2,1080
89857381@N04,10634,15,1392594173,1392594443,2,1,270
89857381@N04,10635,20,1392708981,1392709521,1,1,540
89857381@N04,10636,15,1392883997,1392884267,2,1,270
89857381@N04,10637,30,1392961586,1392962666,1,1,1080
89857381@N04,10638,1,1393654156,1393654216,1,1,60
89857381@N04,10639,30,1394620525,1394621605,1,1,1080
89857381@N04,10640,30,1394774967,1394776047,1,1,1080
89857381@N04,10641,27,1398160381,1398161281,1,1,900
89857381@N04,10642,28,1399362673,1399363573,1,1,900
89857381@N04,10643,19,1406329261,1406329801,1,1,540
89857381@N04,10644,30,1406793995,1406795075,2,3,1080
89857381@N04,10644,20,1406796524,1406797064,2,3,540
89857381@N04,10644,1,1406798516,1406798576,1,3,60
89857381@N04,10645,28,1408142948,1408143848,1,1,900
89857381@N04,10646,1,1408272688,1408272748,1,1,60
89857381@N04,10647,28,1409902894,1409903794,1,1,900
89857381@N04,10648,20,1410223846,1410224386,1,1,540
89857381@N04,10649,28,1411173107,1411174007,1,1,900
89857381@N04,10650,19,1411282694,1411283234,1,1,540
89857381@N04,10651,30,1412843714,1412844794,1,1,1080
89857381@N04,10652,19,1412926261,1412926801,1,1,540
89857381@N04,10653,19,1415402009,1415402549,1,1,540
89857381@N04,10654,3,1415856433,1415856523,2,3,90
89857381@N04,10654,25,1415856744,1415857584,2,3,840
89857381@N04,10654,19,1415870076,1415870616,1,3,540
89857381@N04,10655,28,1416378362,1416379262,1,1,900
89857381@N04,10656,19,1417844453,1417844993,1,1,540
89857381@N04,10657,28,1418425364,1418426264,1,1,900
89857381@N04,10658,18,1427093422,1427093872,1,1,450
89857381@N04,10659,26,1466247630,1466248530,1,1,900
89873814@N00,10660,15,1202470936,1202471206,1,1,270
89873814@N00,10661,31,1203842947,1203844447,1,1,1500
89873814@N00,10662,12,1415080069,1415080309,1,1,240
89898604@N00,10663,11,1395788797,1395789037,1,1,240
89898604@N00,10664,25,1395882351,1395883191,2,2,840
89898604@N00,10664,26,1395891234,1395892134,2,2,900
89901660@N00,10665,27,1326593371,1326594271,1,1,900
8996989@N02,10666,16,1215603151,1215603421,2,2,270
8996989@N02,10666,26,1215603786,1215604686,1,2,900
8996989@N02,10667,31,1215667989,1215669489,1,1,1500
90008840@N00,10668,16,1350955134,1350955404,2,3,270
90008840@N00,10668,29,1350959203,1350959579,3,3,376
90008840@N00,10668,20,1350959579,1350960119,2,3,540
90008840@N00,10669,18,1449494453,1449494903,1,1,450
90008840@N00,10670,25,1449628692,1449629532,7,11,840
90008840@N00,10670,13,1449630056,1449630296,2,11,240
90008840@N00,10670,5,1449632814,1449632934,3,11,120
90008840@N00,10670,23,1449638062,1449638662,2,11,600
90008840@N00,10670,26,1449639021,1449639921,2,11,900
90008840@N00,10670,16,1449640231,1449640265,2,11,34
90008840@N00,10670,26,1449640265,1449641165,2,11,900
90008840@N00,10670,3,1449641566,1449641656,2,11,90
90008840@N00,10670,12,1449642588,1449642828,2,11,240
90008840@N00,10670,18,1449642913,1449643363,2,11,450
90008840@N00,10670,24,1449643393,1449644173,1,11,780
90008840@N00,10671,15,1449730185,1449730455,3,2,270
90008840@N00,10671,26,1449734486,1449735386,1,2,900
90008840@N00,10672,18,1449796327,1449796777,2,4,450
90008840@N00,10672,19,1449798726,1449799266,2,4,540
90008840@N00,10672,17,1449802159,1449802459,2,4,300
90008840@N00,10672,26,1449805814,1449806714,2,4,900
90015401@N00,10673,26,1367626438,1367627338,2,1,900
90016486@N05,10674,26,1377689793,1377690693,2,1,900
90055788@N00,10675,30,1276476156,1276477236,2,4,1080
90055788@N00,10675,20,1276479562,1276480102,2,4,540
90055788@N00,10675,24,1276490274,1276491054,2,4,780
90055788@N00,10675,10,1276502187,1276502427,1,4,240
90093093@N08,10676,29,1367986964,1367987864,3,2,900
90093093@N08,10676,18,1367988035,1367988485,1,2,450
90093093@N08,10677,1,1369201930,1369201990,1,1,60
90146022@N00,10678,25,1391173200,1391173200,2,2,0
90146022@N00,10678,26,1391173200,1391174100,1,2,900
90214320@N00,10679,22,1200027532,1200028132,2,2,600
90214320@N00,10679,27,1200046965,1200047865,1,2,900
90246252@N06,10680,28,1361654396,1361655296,1,1,900
9025385@N07,10681,28,1292841983,1292842883,1,1,900
90269418@N00,10682,1,1382670032,1382670092,20,1,60
90269418@N00,10683,1,1382741936,1382741996,13,1,60
90269418@N00,10684,1,1382795885,1382795945,2,1,60
90269418@N00,10685,1,1382837970,1382838030,3,1,60
90272587@N00,10686,31,1338357564,1338359064,2,1,1500
90289831@N00,10687,26,1241218239,1241218609,2,21,370
90289831@N00,10687,25,1241218609,1241219449,11,21,840
90289831@N00,10687,13,1241219715,1241219955,14,21,240
90289831@N00,10687,3,1241222602,1241222692,2,21,90
90289831@N00,10687,21,1241226070,1241226278,3,21,208
90289831@N00,10687,4,1241226278,1241226379,7,21,101
90289831@N00,10687,11,1241229075,1241229315,4,21,240
90289831@N00,10687,7,1241229470,1241229650,4,21,180
90289831@N00,10687,5,1241229838,1241229958,2,21,120
90289831@N00,10687,13,1241230475,1241230715,22,21,240
90289831@N00,10687,30,1241238962,1241240042,13,21,1080
90289831@N00,10687,20,1241240220,1241240311,2,21,91
90289831@N00,10687,29,1241240311,1241240614,8,21,303
90289831@N00,10687,19,1241240614,1241240757,2,21,143
90289831@N00,10687,28,1241240757,1241241657,42,21,900
90289831@N00,10687,16,1241245876,1241246146,4,21,270
90289831@N00,10687,27,1241247381,1241248281,2,21,900
90289831@N00,10687,22,1241250366,1241250966,4,21,600
90289831@N00,10687,28,1241251208,1241252108,11,21,900
90289831@N00,10687,15,1241266440,1241266710,3,21,270
90289831@N00,10687,1,1241268265,1241268325,1,21,60
90289831@N00,10688,26,1280916539,1280917439,11,1,900
90289831@N00,10689,26,1280966166,1280967066,67,1,900
90296333@N04,10690,22,1364520762,1364521362,1,1,600
90300985@N05,10691,15,1375057248,1375057518,1,1,270
90328132@N00,10692,5,1290250035,1290250155,2,2,120
90328132@N00,10692,25,1290258665,1290259505,2,2,840
90328132@N00,10693,12,1391233362,1391233439,2,4,77
90328132@N00,10693,30,1391233439,1391233762,2,4,323
90328132@N00,10693,20,1391233762,1391234302,2,4,540
90328132@N00,10693,29,1391245440,1391246340,1,4,900
90328132@N00,10694,17,1411785200,1411785500,2,5,300
90328132@N00,10694,3,1411788703,1411788793,2,5,90
90328132@N00,10694,20,1411790788,1411791328,5,5,540
90328132@N00,10694,30,1411793249,1411794329,2,5,1080
90328132@N00,10694,19,1411794628,1411795168,1,5,540
90328132@N00,10695,19,1412408376,1412408916,2,1,540
90328132@N00,10696,19,1412471951,1412472491,1,1,540
90328132@N00,10697,28,1419223263,1419224163,1,1,900
90328132@N00,10698,29,1422241279,1422241315,2,5,36
90328132@N00,10698,28,1422241315,1422241347,2,5,32
90328132@N00,10698,29,1422241347,1422241382,2,5,35
90328132@N00,10698,17,1422241382,1422241436,2,5,54
90328132@N00,10698,29,1422241436,1422242336,1,5,900
90344777@N06,10699,26,1379398345,1379399245,1,1,900
9036889@N06,10700,4,1385693229,1385693330,2,4,101
9036889@N06,10700,11,1385693417,1385693657,8,4,240
9036889@N06,10700,17,1385701236,1385701536,2,4,300
9036889@N06,10700,28,1385704379,1385705279,1,4,900
9036889@N06,10701,1,1447386494,1447386554,8,19,60
9036889@N06,10701,30,1447387249,1447387255,2,19,6
9036889@N06,10701,23,1447387255,1447387310,2,19,55
9036889@N06,10701,29,1447387310,1447387331,4,19,21
9036889@N06,10701,31,1447387331,1447388831,13,19,1500
9036889@N06,10701,25,1447389169,1447389348,4,19,179
9036889@N06,10701,21,1447389348,1447389918,2,19,570
9036889@N06,10701,25,1447390692,1447391532,43,19,840
9036889@N06,10701,12,1447392569,1447392809,10,19,240
9036889@N06,10701,24,1447394019,1447394799,6,19,780
9036889@N06,10701,1,1447396312,1447396372,3,19,60
9036889@N06,10701,25,1447397901,1447398741,3,19,840
9036889@N06,10701,26,1447398906,1447399205,2,19,299
9036889@N06,10701,21,1447399205,1447399740,5,19,535
9036889@N06,10701,13,1447399740,1447399980,2,19,240
9036889@N06,10701,29,1447405138,1447406038,16,19,900
9036889@N06,10701,26,1447416034,1447416934,72,19,900
9036889@N06,10701,20,1447417707,1447418247,3,19,540
9036889@N06,10701,1,1447422624,1447422684,1,19,60
90394757@N00,10702,28,1232760186,1232761086,1,1,900
90394757@N00,10703,25,1260272845,1260273685,1,1,840
90394757@N00,10704,13,1323148786,1323149026,1,1,240
90405256@N00,10705,25,1227391929,1227392769,6,1,840
90427028@N00,10706,1,1201649148,1201649208,4,6,60
90427028@N00,10706,21,1201657816,1201658386,2,6,570
90427028@N00,10706,31,1201666495,1201667995,2,6,1500
90427028@N00,10706,11,1201672146,1201672386,2,6,240
90427028@N00,10706,19,1201673269,1201673809,2,6,540
90427028@N00,10706,28,1201676727,1201677627,3,6,900
90427028@N00,10707,30,1201747258,1201748338,2,4,1080
90427028@N00,10707,6,1201748458,1201748578,2,4,120
90427028@N00,10707,21,1201764459,1201764977,2,4,518
90427028@N00,10707,28,1201764977,1201765877,3,4,900
90436343@N04,10708,1,1354019732,1354019792,1,1,60
90494751@N00,10709,1,1188563665,1188563725,1,1,60
90494751@N00,10710,1,1189045260,1189045320,20,1,60
90494751@N00,10711,1,1195093291,1195093351,1,1,60
90494751@N00,10712,1,1195288601,1195288661,3,1,60
90494751@N00,10713,1,1196763311,1196763371,4,1,60
90494751@N00,10714,1,1197114574,1197114634,11,1,60
90494751@N00,10715,1,1220611427,1220611487,2,1,60
9053157@N02,10716,5,1198230031,1198230151,2,2,120
9053157@N02,10716,26,1198235812,1198236712,1,2,900
9053157@N02,10717,17,1200712219,1200712519,1,1,300
9053157@N02,10718,16,1201931246,1201931516,3,1,270
9053157@N02,10719,3,1204324471,1204324561,6,3,90
9053157@N02,10719,30,1204325204,1204326284,2,3,1080
9053157@N02,10719,14,1204326542,1204326782,2,3,240
9053157@N02,10720,29,1204864680,1204865580,2,3,900
9053157@N02,10720,16,1204867095,1204867365,3,3,270
9053157@N02,10720,30,1204869042,1204870122,8,3,1080
9053157@N02,10721,31,1205531310,1205532810,1,1,1500
9053157@N02,10722,5,1205577148,1205577268,1,1,120
9053157@N02,10723,29,1211706892,1211707792,2,2,900
9053157@N02,10723,28,1211723274,1211724174,1,2,900
9053157@N02,10724,1,1215157292,1215157352,3,4,60
9053157@N02,10724,16,1215176400,1215176580,2,4,180
9053157@N02,10724,26,1215176580,1215177480,2,4,900
9053157@N02,10724,1,1215177660,1215177720,4,4,60
9053157@N02,10725,24,1216267946,1216268726,1,1,780
9053157@N02,10726,28,1229711904,1229712804,1,1,900
9053157@N02,10727,20,1229771624,1229772164,1,1,540
9053157@N02,10728,4,1230020018,1230020119,1,1,101
9053157@N02,10729,21,1230719829,1230720399,1,1,570
9053157@N02,10730,20,1262213930,1262214409,2,5,479
9053157@N02,10730,14,1262214409,1262214649,2,5,240
9053157@N02,10730,25,1262216324,1262217164,2,5,840
9053157@N02,10730,13,1262217431,1262217671,2,5,240
9053157@N02,10730,28,1262231627,1262232527,1,5,900
9053157@N02,10731,10,1308736756,1308736996,1,1,240
9053157@N02,10732,28,1325345952,1325346852,1,1,900
9053157@N02,10733,10,1328755661,1328755901,1,1,240
9053157@N02,10734,12,1328836170,1328836410,1,1,240
9053157@N02,10735,30,1338295434,1338296514,1,1,1080
9053157@N02,10736,31,1338952754,1338954254,1,1,1500
9053157@N02,10737,24,1349326717,1349327497,1,1,780
9053157@N02,10738,12,1361936410,1361936650,1,1,240
90547236@N00,10739,25,1343992392,1343993232,1,1,840
90621377@N00,10740,28,1273791575,1273792475,2,2,900
90621377@N00,10740,14,1273802509,1273802749,1,2,240
90621377@N00,10741,28,1273882114,1273883014,3,2,900
90621377@N00,10741,25,1273891453,1273892293,1,2,840
90621377@N00,10742,28,1273921914,1273922814,2,3,900
90621377@N00,10742,26,1273925902,1273926802,2,3,900
90621377@N00,10742,24,1273926913,1273927693,1,3,780
90673013@N06,10743,1,1370966783,1370966843,2,3,60
90673013@N06,10743,28,1370967469,1370968369,6,3,900
90673013@N06,10743,1,1370986252,1370986312,2,3,60
9068914@N02,10744,6,1454650536,1454650656,1,1,120
9069058@N02,10745,16,1294552466,1294552736,3,2,270
9069058@N02,10745,29,1294559809,1294560709,1,2,900
90696399@N07,10746,20,1380431644,1380432184,5,1,540
90696399@N07,10747,20,1380510130,1380510670,6,1,540
90696399@N07,10748,20,1380587299,1380587839,17,1,540
90696399@N07,10749,20,1380680025,1380680565,11,1,540
90696399@N07,10750,20,1380761535,1380762075,17,1,540
90696399@N07,10751,20,1469263359,1469263899,16,1,540
90727846@N00,10752,25,1335720587,1335721427,1,1,840
90727846@N00,10753,31,1335766508,1335768008,2,2,1500
90727846@N00,10753,15,1335792583,1335792853,1,2,270
90755543@N00,10754,29,1371775095,1371775995,2,9,900
90755543@N00,10754,26,1371792543,1371793443,3,9,900
90755543@N00,10754,21,1371799881,1371799983,2,9,102
90755543@N00,10754,13,1371799983,1371800223,4,9,240
90755543@N00,10754,30,1371801733,1371801752,3,9,19
90755543@N00,10754,25,1371801752,1371802592,4,9,840
90755543@N00,10754,28,1371806160,1371807060,2,9,900
90755543@N00,10754,26,1371812317,1371813217,2,9,900
90755543@N00,10754,29,1371814210,1371815110,1,9,900
90761069@N08,10755,1,1385935117,1385935177,2,3,60
90761069@N08,10755,20,1385935762,1385936302,3,3,540
90761069@N08,10755,13,1385952311,1385952551,1,3,240
90761069@N08,10756,18,1386052392,1386052842,2,2,450
90761069@N08,10756,30,1386053237,1386054317,1,2,1080
90798029@N02,10757,1,1430748636,1430748696,1,1,60
90810256@N08,10758,17,1362192125,1362192425,1,1,300
90832417@N00,10759,23,1375664571,1375665171,2,2,600
90832417@N00,10759,15,1375680916,1375681186,1,2,270
90832417@N00,10760,29,1375745903,1375746803,1,1,900
90896070@N04,10761,18,1376040998,1376041448,4,2,450
90896070@N04,10761,28,1376048694,1376049594,2,2,900
90933198@N02,10762,26,1389413304,1389414204,1,1,900
90987666@N00,10763,1,1343962269,1343962329,1,1,60
91033481@N00,10764,24,1295577450,1295578230,2,2,780
91033481@N00,10764,28,1295604490,1295605390,2,2,900
91033481@N00,10765,26,1295739393,1295740293,1,1,900
91033481@N00,10766,26,1305073455,1305074355,2,6,900
91033481@N00,10766,29,1305082857,1305083757,2,6,900
91033481@N00,10766,20,1305087339,1305087879,2,6,540
91033481@N00,10766,25,1305090423,1305091263,2,6,840
91033481@N00,10766,18,1305096751,1305097201,2,6,450
91033481@N00,10766,16,1305098508,1305098778,1,6,270
91033481@N00,10767,26,1305160728,1305161628,2,2,900
91033481@N00,10767,25,1305180260,1305181100,1,2,840
91033481@N00,10768,14,1319960296,1319960536,2,2,240
91033481@N00,10768,28,1319968294,1319969194,1,2,900
91033481@N00,10769,20,1320041975,1320042515,1,1,540
91033481@N00,10770,7,1320118483,1320118663,2,4,180
91033481@N00,10770,3,1320119962,1320120052,2,4,90
91033481@N00,10770,30,1320121697,1320122777,2,4,1080
91033481@N00,10770,20,1320127948,1320128488,1,4,540
91035898@N00,10771,27,1324337624,1324338524,2,2,900
91035898@N00,10771,29,1324346179,1324347079,2,2,900
91087719@N08,10772,14,1375888012,1375888252,2,2,240
91087719@N08,10772,22,1375888698,1375889298,1,2,600
91087719@N08,10773,26,1375928157,1375929057,2,2,900
91087719@N08,10773,8,1375931439,1375931619,1,2,180
91087719@N08,10774,26,1398737778,1398738678,1,1,900
9110121@N02,10775,15,1303032671,1303032941,1,1,270
91103189@N00,10776,1,1411728396,1411728456,7,1,60
91132276@N07,10777,27,1290764282,1290765182,2,4,900
91132276@N07,10777,3,1290766858,1290766948,2,4,90
91132276@N07,10777,26,1290768057,1290768957,3,4,900
91132276@N07,10777,28,1290770102,1290771002,1,4,900
91132276@N07,10778,1,1294739442,1294739502,2,2,60
91132276@N07,10778,26,1294741805,1294742705,2,2,900
91132276@N07,10779,12,1294790462,1294790538,2,12,76
91132276@N07,10779,24,1294790538,1294791318,3,12,780
91132276@N07,10779,18,1294791476,1294791484,2,12,8
91132276@N07,10779,29,1294791484,1294791510,2,12,26
91132276@N07,10779,11,1294791510,1294791750,2,12,240
91132276@N07,10779,17,1294791823,1294791986,3,12,163
91132276@N07,10779,6,1294791986,1294792106,2,12,120
91132276@N07,10779,11,1294792408,1294792461,2,12,53
91132276@N07,10779,26,1294792461,1294792486,2,12,25
91132276@N07,10779,30,1294792486,1294792962,2,12,476
91132276@N07,10779,28,1294792962,1294793032,2,12,70
91132276@N07,10779,3,1294793032,1294793122,2,12,90
91132276@N07,10780,4,1357959543,1357959644,1,1,101
91132276@N07,10781,30,1359280748,1359280752,2,7,4
91132276@N07,10781,17,1359280752,1359280756,2,7,4
91132276@N07,10781,6,1359280756,1359280759,2,7,3
91132276@N07,10781,26,1359280759,1359280772,3,7,13
91132276@N07,10781,8,1359280772,1359280952,2,7,180
91132276@N07,10781,24,1359287617,1359287760,2,7,143
91132276@N07,10781,11,1359287760,1359288000,1,7,240
91132276@N07,10782,21,1363001553,1363001563,2,2,10
91132276@N07,10782,14,1363001563,1363001803,1,2,240
91132276@N07,10783,8,1386104801,1386104805,2,3,4
91132276@N07,10783,12,1386104805,1386104810,2,3,5
91132276@N07,10783,29,1386104810,1386105710,1,3,900
91132276@N07,10784,28,1388973749,1388974649,1,1,900
91132404@N00,10785,28,1331988200,1331989100,2,1,900
91196251@N05,10786,31,1360032235,1360033735,2,2,1500
91196251@N05,10786,3,1360039958,1360040048,1,2,90
91209514@N06,10787,26,1363501007,1363501907,1,1,900
91218125@N07,10788,19,1414914156,1414914696,1,1,540
91218125@N07,10789,14,1416096042,1416096282,1,1,240
91218125@N07,10790,18,1441501010,1441501460,1,1,450
91219241@N05,10791,20,1368329167,1368329707,1,1,540
91219241@N05,10792,17,1368416844,1368417144,1,1,300
91219241@N05,10793,24,1391289211,1391289991,5,1,780
91219241@N05,10794,24,1394308460,1394309240,8,1,780
91219241@N05,10795,20,1394419460,1394420000,3,2,540
91219241@N05,10795,24,1394422748,1394423528,1,2,780
91219241@N05,10796,24,1399764032,1399764812,4,1,780
91219241@N05,10797,24,1399869826,1399870606,1,1,780
91227166@N06,10798,26,1357120931,1357120950,2,2,19
91227166@N06,10798,11,1357120950,1357121190,1,2,240
91227166@N06,10799,20,1381132999,1381133539,1,1,540
91227166@N06,10800,26,1381191155,1381192055,2,6,900
91227166@N06,10800,18,1381193697,1381194147,2,6,450
91227166@N06,10800,26,1381194997,1381195897,2,6,900
91227166@N06,10800,12,1381196485,1381196725,2,6,240
91227166@N06,10800,13,1381196777,1381197017,2,6,240
91227166@N06,10800,21,1381197947,1381198517,1,6,570
91227166@N06,10801,26,1381236060,1381236164,2,3,104
91227166@N06,10801,28,1381236164,1381236250,2,3,86
91227166@N06,10801,26,1381236250,1381237150,1,3,900
91227166@N06,10802,23,1381287653,1381288253,1,1,600
91227166@N06,10803,30,1381484520,1381485600,1,1,1080
91227166@N06,10804,1,1381954462,1381954522,1,1,60
91230196@N02,10805,26,1365472877,1365473777,1,1,900
91230196@N02,10806,15,1367806576,1367806846,1,1,270
91234299@N07,10807,18,1441156207,1441156657,2,1,450
9123577@N06,10808,26,1258889896,1258890796,2,1,900
91262748@N08,10809,15,1391650330,1391650600,2,2,270
91262748@N08,10809,29,1391673434,1391674334,1,2,900
91293550@N08,10810,1,1433375666,1433375726,2,3,60
91293550@N08,10810,8,1433376905,1433377085,2,3,180
91293550@N08,10810,31,1433377350,1433378850,1,3,1500
91316948@N08,10811,1,1392440861,1392440921,1,1,60
91377499@N06,10812,14,1361320967,1361321207,1,1,240
91395298@N03,10813,28,1356422973,1356423873,1,1,900
9139667@N06,10814,1,1387582480,1387582540,3,3,60
9139667@N06,10814,16,1387588093,1387588363,2,3,270
9139667@N06,10814,28,1387610045,1387610945,1,3,900
91398168@N02,10815,1,1372653409,1372653469,1,1,60
91398168@N02,10816,27,1372728507,1372729407,1,1,900
91398168@N02,10817,1,1372851588,1372851648,1,1,60
91405598@N02,10818,25,1356418662,1356419502,2,3,840
91405598@N02,10818,28,1356430151,1356431051,4,3,900
91405598@N02,10818,16,1356431699,1356431969,6,3,270
91405970@N00,10819,28,1264151363,1264152263,4,1,900
91405970@N00,10820,29,1295263718,1295264618,3,2,900
91405970@N00,10820,14,1295266196,1295266436,2,2,240
91405970@N00,10821,18,1303547541,1303547991,1,1,450
91405970@N00,10822,7,1310908879,1310909059,1,1,180
91405970@N00,10823,28,1325341218,1325342118,2,2,900
91405970@N00,10823,14,1325343290,1325343530,1,2,240
91405970@N00,10824,28,1330533875,1330534775,2,4,900
91405970@N00,10824,29,1330534981,1330535061,2,4,80
91405970@N00,10824,7,1330535061,1330535241,2,4,180
91405970@N00,10824,28,1330543356,1330544256,1,4,900
91407458@N00,10825,22,1370916413,1370917013,1,1,600
91428589@N00,10826,12,1206613382,1206613622,1,1,240
91428589@N00,10827,12,1299752583,1299752590,2,2,7
91428589@N00,10827,25,1299752590,1299753430,4,2,840
91439732@N06,10828,24,1386145950,1386146730,1,1,780
91456744@N00,10829,28,1193804179,1193805079,1,1,900
91456744@N00,10830,17,1256774955,1256775255,25,1,300
91466877@N00,10831,6,1388123903,1388124023,1,1,120
91466877@N00,10832,4,1388831507,1388831608,1,1,101
91470130@N02,10833,1,1382606916,1382606976,1,1,60
91488079@N06,10834,26,1260603669,1260604569,2,2,900
91488079@N06,10834,28,1260608007,1260608907,1,2,900
91509272@N00,10835,17,1218929298,1218929598,1,1,300
91509272@N00,10836,28,1284371006,1284371906,1,1,900
91509272@N00,10837,28,1297576573,1297577473,1,1,900
91509272@N00,10838,26,1304808893,1304809793,2,2,900
91509272@N00,10838,30,1304817829,1304818909,1,2,1080
91525158@N00,10839,14,1369567374,1369567614,1,1,240
91535662@N06,10840,1,1361318289,1361318349,3,7,60
91535662@N06,10840,26,1361320798,1361320852,2,7,54
91535662@N06,10840,16,1361320852,1361321122,2,7,270
91535662@N06,10840,23,1361321185,1361321785,2,7,600
91535662@N06,10840,15,1361328080,1361328350,2,7,270
91535662@N06,10840,9,1361329631,1361329811,2,7,180
91535662@N06,10840,24,1361341839,1361342619,1,7,780
91550294@N08,10841,1,1406287530,1406287590,3,2,60
91550294@N08,10841,18,1406289778,1406290228,1,2,450
91550294@N08,10842,28,1406340771,1406341671,2,2,900
91550294@N08,10842,14,1406347023,1406347263,3,2,240
91563382@N00,10843,1,1451345564,1451345624,3,3,60
91563382@N00,10843,28,1451348203,1451349103,2,3,900
91563382@N00,10843,25,1451352520,1451353360,2,3,840
91604003@N02,10844,24,1444287075,1444287855,2,3,780
91604003@N02,10844,11,1444288871,1444289111,2,3,240
91604003@N02,10844,30,1444289285,1444290365,2,3,1080
91604003@N02,10845,27,1444353957,1444354857,2,1,900
91604003@N02,10846,28,1444456096,1444456996,2,3,900
91604003@N02,10846,19,1444462224,1444462764,2,3,540
91604003@N02,10846,31,1444479226,1444480726,1,3,1500
91646799@N06,10847,29,1380359488,1380360388,2,2,900
91646799@N06,10847,1,1380373458,1380373518,1,2,60
91673635@N00,10848,11,1243913153,1243913393,1,1,240
91675105@N02,10849,1,1356846189,1356846249,2,13,60
91675105@N02,10849,13,1356848208,1356848327,2,13,119
91675105@N02,10849,25,1356848327,1356849167,4,13,840
91675105@N02,10849,15,1356850483,1356850753,6,13,270
91675105@N02,10849,17,1356852235,1356852535,4,13,300
91675105@N02,10849,29,1356854755,1356855655,2,13,900
91675105@N02,10849,31,1356857707,1356857739,2,13,32
91675105@N02,10849,29,1356857739,1356857790,3,13,51
91675105@N02,10849,19,1356857790,1356857832,2,13,42
91675105@N02,10849,18,1356857832,1356858282,2,13,450
91675105@N02,10849,27,1356859260,1356860160,2,13,900
91675105@N02,10849,16,1356864164,1356864434,2,13,270
91675105@N02,10849,28,1356866027,1356866927,2,13,900
9171499@N02,10850,1,1221698365,1221698425,3,7,60
9171499@N02,10850,16,1221700900,1221701117,2,7,217
9171499@N02,10850,26,1221701117,1221702017,3,7,900
9171499@N02,10850,10,1221703465,1221703570,3,7,105
9171499@N02,10850,22,1221703570,1221704170,7,7,600
9171499@N02,10850,20,1221720834,1221721374,7,7,540
9171499@N02,10850,10,1221721443,1221721683,2,7,240
91730208@N02,10851,20,1357447861,1357448401,1,1,540
91731661@N06,10852,3,1346051060,1346051150,1,1,90
9173558@N05,10853,7,1395615504,1395615513,3,22,9
9173558@N05,10853,4,1395615513,1395615614,11,22,101
9173558@N05,10853,7,1395617958,1395617964,2,22,6
9173558@N05,10853,5,1395617964,1395618084,2,22,120
9173558@N05,10853,7,1395619124,1395619304,2,22,180
9173558@N05,10853,5,1395619632,1395619719,3,22,87
9173558@N05,10853,4,1395619719,1395619820,3,22,101
9173558@N05,10853,21,1395619909,1395620479,3,22,570
9173558@N05,10853,13,1395621705,1395621945,3,22,240
9173558@N05,10853,4,1395623208,1395623309,2,22,101
9173558@N05,10853,16,1395635650,1395635724,3,22,74
9173558@N05,10853,30,1395635724,1395635727,2,22,3
9173558@N05,10853,16,1395635727,1395635942,2,22,215
9173558@N05,10853,26,1395635942,1395636199,8,22,257
9173558@N05,10853,31,1395636199,1395636246,2,22,47
9173558@N05,10853,8,1395636246,1395636426,3,22,180
9173558@N05,10853,18,1395638570,1395639020,3,22,450
9173558@N05,10853,22,1395643403,1395643873,2,22,470
9173558@N05,10853,19,1395643873,1395644413,2,22,540
9173558@N05,10853,20,1395646033,1395646573,3,22,540
9173558@N05,10853,30,1395648916,1395648982,6,22,66
9173558@N05,10853,23,1395648982,1395649582,2,22,600
9173558@N05,10854,29,1395884711,1395885611,4,1,900
91746475@N06,10855,26,1379039625,1379040525,1,1,900
91746475@N06,10856,15,1383699533,1383699803,1,1,270
91746475@N06,10857,21,1387424461,1387425031,2,2,570
91746475@N06,10857,17,1387435555,1387435855,1,2,300
91773836@N03,10858,27,1359937594,1359938494,1,1,900
91773836@N03,10859,7,1360557393,1360557573,1,1,180
91773836@N03,10860,27,1363212433,1363213333,1,1,900
91773836@N03,10861,27,1363323664,1363324564,1,1,900
91773836@N03,10862,27,1363430027,1363430927,1,1,900
91773836@N03,10863,12,1366702562,1366702802,1,1,240
91773836@N03,10864,15,1367310987,1367311257,1,1,270
91773836@N03,10865,27,1371341256,1371342156,1,1,900
91785048@N00,10866,25,1336744130,1336744970,1,1,840
91802513@N07,10867,18,1365751441,1365751891,1,1,450
9180370@N05,10868,30,1342273833,1342274913,1,1,1080
9180370@N05,10869,30,1368847193,1368848273,1,1,1080
91805633@N04,10870,1,1382153868,1382153928,2,12,60
91805633@N04,10870,28,1382155037,1382155373,4,12,336
91805633@N04,10870,16,1382155373,1382155643,2,12,270
91805633@N04,10870,15,1382155773,1382156043,11,12,270
91805633@N04,10870,24,1382156926,1382157183,2,12,257
91805633@N04,10870,21,1382157183,1382157753,2,12,570
91805633@N04,10870,10,1382158464,1382158704,5,12,240
91805633@N04,10870,26,1382158857,1382159757,2,12,900
91805633@N04,10870,13,1382165247,1382165487,9,12,240
91805633@N04,10870,21,1382169764,1382170334,4,12,570
91805633@N04,10870,29,1382185228,1382186128,2,12,900
91805633@N04,10870,16,1382187100,1382187370,1,12,270
91805633@N04,10871,16,1425790299,1425790569,6,1,270
91805633@N04,10872,16,1427775079,1427775349,8,1,270
91805633@N04,10873,16,1432523855,1432524125,5,1,270
91805633@N04,10874,16,1433308243,1433308513,2,1,270
91824565@N00,10875,16,1250722943,1250723213,4,1,270
91828361@N00,10876,28,1356905129,1356906029,2,2,900
91828361@N00,10876,27,1356914123,1356915023,2,2,900
91828361@N00,10877,26,1357114704,1357115604,3,1,900
91852742@N00,10878,1,1208475168,1208475228,2,6,60
91852742@N00,10878,19,1208476069,1208476609,2,6,540
91852742@N00,10878,30,1208485940,1208487020,2,6,1080
91852742@N00,10878,14,1208487973,1208488213,2,6,240
91852742@N00,10878,1,1208498766,1208498826,2,6,60
91852742@N00,10878,20,1208522929,1208523469,1,6,540
91852742@N00,10879,26,1211793775,1211794675,1,1,900
91852742@N00,10880,26,1212148717,1212149617,1,1,900
91852742@N00,10881,26,1212234324,1212235224,1,1,900
91852742@N00,10882,23,1215134207,1215134807,2,2,600
91852742@N00,10882,11,1215146037,1215146277,1,2,240
91852742@N00,10883,21,1215239896,1215240466,1,1,570
91852742@N00,10884,24,1243819396,1243820176,2,4,780
91852742@N00,10884,26,1243834212,1243835112,2,4,900
91852742@N00,10884,28,1243851011,1243851911,2,4,900
91852742@N00,10884,23,1243855102,1243855702,1,4,600
91852742@N00,10885,28,1243947136,1243948036,2,2,900
91852742@N00,10885,29,1243951533,1243952433,1,2,900
9187766@N05,10886,10,1408353190,1408353430,5,3,240
9187766@N05,10886,25,1408354570,1408355410,2,3,840
9187766@N05,10886,24,1408359252,1408360032,1,3,780
9187766@N05,10887,1,1408439635,1408439695,2,3,60
9187766@N05,10887,26,1408449542,1408449840,2,3,298
9187766@N05,10887,1,1408449840,1408449900,1,3,60
91889496@N02,10888,13,1364443796,1364444036,2,7,240
91889496@N02,10888,11,1364453238,1364453478,2,7,240
91889496@N02,10888,12,1364454747,1364454987,2,7,240
91889496@N02,10888,15,1364455196,1364455466,2,7,270
91889496@N02,10888,23,1364457097,1364457697,2,7,600
91889496@N02,10888,28,1364460608,1364461508,3,7,900
91889496@N02,10888,29,1364465637,1364466537,1,7,900
91889496@N02,10889,23,1384076678,1384077278,2,4,600
91889496@N02,10889,22,1384082061,1384082661,2,4,600
91889496@N02,10889,26,1384085612,1384086512,3,4,900
91889496@N02,10889,24,1384086868,1384087648,1,4,780
91889496@N02,10890,15,1387286144,1387286414,2,3,270
91889496@N02,10890,6,1387287092,1387287212,2,3,120
91889496@N02,10890,26,1387287852,1387288752,2,3,900
91889496@N02,10891,29,1387361923,1387362823,1,1,900
91889496@N02,10892,1,1391152013,1391152073,1,1,60
91889496@N02,10893,18,1391267780,1391268230,1,1,450
91889496@N02,10894,17,1391762203,1391762503,2,2,300
91889496@N02,10894,29,1391778530,1391779430,1,2,900
91889496@N02,10895,26,1412640911,1412641811,1,1,900
91889496@N02,10896,26,1418038679,1418039579,1,1,900
91889496@N02,10897,23,1420443297,1420443897,1,1,600
91889496@N02,10898,28,1421227951,1421228851,1,1,900
91889496@N02,10899,20,1422398558,1422399098,3,3,540
91889496@N02,10899,19,1422426974,1422427514,2,3,540
91889496@N02,10899,28,1422430337,1422431237,1,3,900
91889496@N02,10900,29,1422500706,1422501606,2,1,900
91920885@N07,10901,30,1370145643,1370146723,1,1,1080
91925628@N02,10902,1,1368229629,1368229689,1,1,60
91929871@N05,10903,19,1406016803,1406017343,1,1,540
91937493@N00,10904,29,1227254006,1227254906,1,1,900
91937493@N00,10905,29,1227283135,1227284035,2,2,900
91937493@N00,10905,26,1227284432,1227285332,1,2,900
9195858@N03,10906,23,1381658710,1381659310,1,1,600
9195858@N03,10907,28,1381899758,1381900658,1,1,900
92025065@N00,10908,22,1347248328,1347248928,1,1,600
92073805@N00,10909,28,1361752544,1361753444,2,3,900
92073805@N00,10909,23,1361754001,1361754108,2,3,107
92073805@N00,10909,28,1361754108,1361755008,20,3,900
92073805@N00,10910,28,1361840429,1361841329,13,1,900
92087764@N02,10911,1,1366786340,1366786400,5,1,60
92166021@N04,10912,18,1399872323,1399872773,1,1,450
92171126@N00,10913,20,1340784153,1340784693,1,1,540
92171126@N00,10914,27,1370041939,1370042839,3,6,900
92171126@N00,10914,11,1370044657,1370044897,2,6,240
92171126@N00,10914,21,1370048999,1370049079,2,6,80
92171126@N00,10914,25,1370049079,1370049445,7,6,366
92171126@N00,10914,22,1370049445,1370049458,2,6,13
92171126@N00,10914,25,1370049458,1370050298,3,6,840
92171126@N00,10915,29,1370082904,1370083804,2,2,900
92171126@N00,10915,30,1370084764,1370085844,1,2,1080
92227871@N00,10916,26,1198222643,1198223543,1,1,900
92227871@N00,10917,26,1198289459,1198290359,1,1,900
92237387@N00,10918,17,1235952972,1235953272,5,1,300
92237387@N00,10919,28,1268453421,1268454321,1,1,900
92237387@N00,10920,26,1317854191,1317855091,2,5,900
92237387@N00,10920,30,1317855393,1317856473,3,5,1080
92237387@N00,10920,20,1317863667,1317864207,2,5,540
92237387@N00,10920,23,1317866366,1317866966,2,5,600
92237387@N00,10920,25,1317870531,1317871371,1,5,840
92237387@N00,10921,16,1318208403,1318208673,2,3,270
92237387@N00,10921,13,1318210808,1318211048,2,3,240
92237387@N00,10921,26,1318216557,1318217457,1,3,900
92237387@N00,10922,19,1336779785,1336780325,2,4,540
92237387@N00,10922,22,1336785843,1336786443,2,4,600
92237387@N00,10922,28,1336794345,1336795245,4,4,900
92237387@N00,10922,26,1336823658,1336824558,1,4,900
92237387@N00,10923,30,1336872754,1336873834,1,1,1080
92237387@N00,10924,28,1363402956,1363403856,1,1,900
92248782@N00,10925,1,1412893336,1412893396,3,10,60
92248782@N00,10925,11,1412896043,1412896283,2,10,240
92248782@N00,10925,7,1412896626,1412896806,2,10,180
92248782@N00,10925,3,1412897948,1412898038,2,10,90
92248782@N00,10925,13,1412901384,1412901624,8,10,240
92248782@N00,10925,15,1412908492,1412908762,2,10,270
92248782@N00,10925,27,1412908996,1412909896,2,10,900
92248782@N00,10925,15,1412913498,1412913768,2,10,270
92248782@N00,10925,24,1412915456,1412916236,2,10,780
92248782@N00,10925,16,1412918360,1412918630,1,10,270
92248782@N00,10926,14,1413153547,1413153787,2,15,240
92248782@N00,10926,24,1413163701,1413163886,2,15,185
92248782@N00,10926,12,1413163886,1413163895,3,15,9
92248782@N00,10926,24,1413163895,1413164675,2,15,780
92248782@N00,10926,17,1413165684,1413165984,3,15,300
92248782@N00,10926,26,1413175683,1413175687,2,15,4
92248782@N00,10926,30,1413175687,1413176767,7,15,1080
92248782@N00,10926,27,1413177093,1413177107,2,15,14
92248782@N00,10926,16,1413177107,1413177197,3,15,90
92248782@N00,10926,27,1413177197,1413178097,2,15,900
92248782@N00,10926,17,1413178305,1413178605,6,15,300
92248782@N00,10926,27,1413180332,1413181232,3,15,900
92248782@N00,10926,14,1413187214,1413187454,2,15,240
92248782@N00,10926,28,1413187851,1413188751,2,15,900
92248782@N00,10926,16,1413196412,1413196682,4,15,270
92307895@N05,10927,18,1448243333,1448243783,1,1,450
92316033@N06,10928,25,1380533139,1380533979,1,1,840
92328493@N00,10929,13,1437971632,1437971872,2,1,240
92328493@N00,10930,27,1438048539,1438048565,2,2,26
92328493@N00,10930,17,1438048565,1438048865,2,2,300
92328493@N00,10931,13,1438144174,1438144414,1,1,240
92334226@N00,10932,18,1438129801,1438129860,2,4,59
92334226@N00,10932,13,1438129860,1438130100,2,4,240
92334226@N00,10932,18,1438154330,1438154780,2,4,450
92334226@N00,10932,17,1438167308,1438167608,1,4,300
92334226@N00,10933,29,1438205188,1438205230,2,8,42
92334226@N00,10933,18,1438205230,1438205303,2,8,73
92334226@N00,10933,13,1438205303,1438205428,2,8,125
92334226@N00,10933,18,1438205428,1438205878,2,8,450
92334226@N00,10933,19,1438210449,1438210989,3,8,540
92334226@N00,10933,30,1438212874,1438213954,2,8,1080
92334226@N00,10933,1,1438228293,1438228301,2,8,8
92334226@N00,10933,30,1438228301,1438229381,1,8,1080
92334226@N00,10934,29,1438296525,1438297425,1,1,900
92334226@N00,10935,16,1438390208,1438390478,1,1,270
92391434@N05,10936,28,1377683863,1377684173,2,2,310
92391434@N05,10936,27,1377684173,1377685073,1,2,900
92405885@N00,10937,26,1370772271,1370773171,1,1,900
92461652@N07,10938,15,1418947706,1418947976,1,1,270
92495052@N05,10939,18,1359028675,1359029125,1,1,450
92533979@N00,10940,28,1324587113,1324588013,2,7,900
92533979@N00,10940,17,1324589251,1324589551,2,7,300
92533979@N00,10940,27,1324589903,1324590803,2,7,900
92533979@N00,10940,21,1324605627,1324606197,2,7,570
92533979@N00,10940,24,1324614066,1324614846,2,7,780
92533979@N00,10940,26,1324615257,1324616157,3,7,900
92533979@N00,10940,7,1324622228,1324622408,1,7,180
92536703@N02,10941,17,1361076051,1361076351,2,2,300
92536703@N02,10941,28,1361077805,1361078705,1,2,900
92543707@N00,10942,27,1224167069,1224167969,1,1,900
9255029@N04,10943,26,1313380649,1313381549,36,1,900
9255029@N04,10944,26,1315556598,1315557498,1,1,900
9255029@N04,10945,26,1316792674,1316793574,1,1,900
92582562@N00,10946,25,1402979886,1402980726,1,1,840
92599451@N08,10947,12,1234401159,1234401399,4,6,240
92599451@N08,10947,25,1234403326,1234404166,3,6,840
92599451@N08,10947,31,1234404219,1234405719,2,6,1500
92599451@N08,10947,13,1234408008,1234408248,3,6,240
92599451@N08,10947,5,1234411317,1234411437,4,6,120
92599451@N08,10947,11,1234413381,1234413621,1,6,240
92599451@N08,10948,19,1234484517,1234485057,2,4,540
92599451@N08,10948,29,1234485201,1234486101,2,4,900
92599451@N08,10948,19,1234486316,1234486856,2,4,540
92599451@N08,10948,31,1234487820,1234489320,2,4,1500
92599451@N08,10949,12,1234830472,1234830712,2,8,240
92599451@N08,10949,26,1234830739,1234831065,8,8,326
92599451@N08,10949,10,1234831065,1234831305,2,8,240
92599451@N08,10949,29,1234831312,1234831708,2,8,396
92599451@N08,10949,20,1234831708,1234832248,3,8,540
92599451@N08,10949,10,1234834680,1234834920,2,8,240
92599451@N08,10949,15,1234836910,1234837180,3,8,270
92599451@N08,10949,25,1234848534,1234849374,1,8,840
92599451@N08,10950,1,1312499149,1312499209,3,3,60
92599451@N08,10950,28,1312499473,1312500373,3,3,900
92599451@N08,10950,13,1312512165,1312512405,4,3,240
92599451@N08,10951,15,1312591559,1312591829,2,5,270
92599451@N08,10951,14,1312604545,1312604785,2,5,240
92599451@N08,10951,20,1312605700,1312606240,2,5,540
92599451@N08,10951,12,1312607015,1312607255,2,5,240
92599451@N08,10951,28,1312607880,1312608780,1,5,900
92599451@N08,10952,28,1312673726,1312674626,3,1,900
92599451@N08,10953,28,1312756004,1312756904,5,7,900
92599451@N08,10953,29,1312763547,1312763893,3,7,346
92599451@N08,10953,20,1312763893,1312764433,3,7,540
92599451@N08,10953,26,1312766064,1312766964,8,7,900
92599451@N08,10953,28,1312775222,1312775388,2,7,166
92599451@N08,10953,31,1312775388,1312776888,2,7,1500
92599451@N08,10953,28,1312779417,1312780317,2,7,900
92599451@N08,10954,1,1312944537,1312944597,2,10,60
92599451@N08,10954,28,1312950607,1312950718,2,10,111
92599451@N08,10954,31,1312950718,1312952218,5,10,1500
92599451@N08,10954,1,1312956288,1312956348,2,10,60
92599451@N08,10954,26,1312957500,1312957598,2,10,98
92599451@N08,10954,1,1312957598,1312957598,2,10,0
92599451@N08,10954,26,1312957598,1312958015,4,10,417
92599451@N08,10954,1,1312958015,1312958062,3,10,47
92599451@N08,10954,26,1312958062,1312958962,3,10,900
92599451@N08,10954,1,1312961031,1312961091,1,10,60
92599451@N08,10955,28,1356165288,1356166188,2,1,900
92599451@N08,10956,28,1356217383,1356218283,4,6,900
92599451@N08,10956,26,1356218522,1356219422,6,6,900
92599451@N08,10956,28,1356223075,1356223975,3,6,900
92599451@N08,10956,26,1356226308,1356227208,4,6,900
92599451@N08,10956,28,1356240004,1356240904,2,6,900
92599451@N08,10956,26,1356245219,1356246119,2,6,900
92599451@N08,10957,28,1356306354,1356307254,5,19,900
92599451@N08,10957,26,1356314731,1356314886,2,19,155
92599451@N08,10957,28,1356314886,1356314939,2,19,53
92599451@N08,10957,26,1356314939,1356315839,4,19,900
92599451@N08,10957,30,1356317784,1356317988,2,19,204
92599451@N08,10957,26,1356317988,1356318810,3,19,822
92599451@N08,10957,28,1356318810,1356319355,2,19,545
92599451@N08,10957,26,1356319355,1356319494,2,19,139
92599451@N08,10957,29,1356319494,1356320394,2,19,900
92599451@N08,10957,26,1356321193,1356322093,2,19,900
92599451@N08,10957,14,1356324001,1356324241,4,19,240
92599451@N08,10957,28,1356325343,1356326243,2,19,900
92599451@N08,10957,25,1356334036,1356334876,2,19,840
92599451@N08,10957,28,1356335088,1356335988,2,19,900
92599451@N08,10957,26,1356340452,1356340816,5,19,364
92599451@N08,10957,16,1356340816,1356340903,2,19,87
92599451@N08,10957,26,1356340903,1356340939,2,19,36
92599451@N08,10957,8,1356340939,1356341119,2,19,180
92599451@N08,10957,26,1356343146,1356344046,1,19,900
92599451@N08,10958,18,1356398266,1356398716,2,8,450
92599451@N08,10958,28,1356399343,1356399594,2,8,251
92599451@N08,10958,10,1356399594,1356399601,2,8,7
92599451@N08,10958,20,1356399601,1356399771,2,8,170
92599451@N08,10958,29,1356399771,1356400063,2,8,292
92599451@N08,10958,18,1356400063,1356400513,2,8,450
92599451@N08,10958,31,1356401089,1356402589,2,8,1500
92599451@N08,10958,30,1356402802,1356403882,1,8,1080
92599451@N08,10959,21,1356653685,1356654255,2,2,570
92599451@N08,10959,13,1356656712,1356656952,2,2,240
92599451@N08,10960,28,1356694531,1356695431,1,1,900
92599451@N08,10961,27,1356742463,1356743363,2,2,900
92599451@N08,10961,13,1356752927,1356753167,2,2,240
92662849@N00,10962,15,1199005392,1199005662,2,2,270
92662849@N00,10962,20,1199009557,1199010097,1,2,540
92662849@N00,10963,26,1203214139,1203215039,2,1,900
92662849@N00,10964,27,1217763953,1217764853,2,2,900
92662849@N00,10964,4,1217767055,1217767156,2,2,101
92688599@N00,10965,26,1256607839,1256608739,25,3,900
92688599@N00,10965,17,1256627763,1256627783,2,3,20
92688599@N00,10965,26,1256627783,1256628683,1,3,900
92692548@N02,10966,25,1437806105,1437806945,2,3,840
92692548@N02,10966,8,1437809382,1437809452,2,3,70
92692548@N02,10966,26,1437809452,1437810352,1,3,900
92692548@N02,10967,6,1437869348,1437869468,2,6,120
92692548@N02,10967,19,1437874831,1437875371,2,6,540
92692548@N02,10967,22,1437878726,1437879326,2,6,600
92692548@N02,10967,24,1437892849,1437893629,2,6,780
92692548@N02,10967,16,1437903130,1437903400,3,6,270
92692548@N02,10967,13,1437903880,1437904120,2,6,240
92692548@N02,10968,26,1438050177,1438051077,2,7,900
92692548@N02,10968,11,1438051860,1438052100,2,7,240
92692548@N02,10968,21,1438052810,1438053380,2,7,570
92692548@N02,10968,4,1438055203,1438055252,2,7,49
92692548@N02,10968,21,1438055252,1438055822,2,7,570
92692548@N02,10968,20,1438070518,1438071058,3,7,540
92692548@N02,10968,21,1438075537,1438076107,3,7,570
92692548@N02,10969,16,1438139099,1438139369,2,5,270
92692548@N02,10969,24,1438141108,1438141888,2,5,780
92692548@N02,10969,12,1438142993,1438143167,2,5,174
92692548@N02,10969,24,1438143167,1438143947,2,5,780
92692548@N02,10969,22,1438149195,1438149795,1,5,600
92695692@N00,10970,27,1384653528,1384654428,2,4,900
92695692@N00,10970,16,1384658355,1384658625,2,4,270
92695692@N00,10970,17,1384674629,1384674929,3,4,300
92695692@N00,10970,16,1384675445,1384675715,1,4,270
92806841@N00,10971,29,1348791013,1348791016,2,4,3
92806841@N00,10971,20,1348791016,1348791556,3,4,540
92806841@N00,10971,18,1348798395,1348798845,4,4,450
92806841@N00,10971,28,1348799280,1348800180,2,4,900
92859439@N06,10972,7,1315199540,1315199720,1,1,180
92859439@N06,10973,17,1346273669,1346273969,1,1,300
92859439@N06,10974,16,1346425735,1346426005,1,1,270
92859439@N06,10975,30,1350653513,1350654593,1,1,1080
92859439@N06,10976,1,1352644276,1352644336,1,1,60
92859439@N06,10977,17,1354297134,1354297434,2,3,300
92859439@N06,10977,23,1354298635,1354299235,2,3,600
92859439@N06,10977,30,1354304768,1354305848,1,3,1080
92859439@N06,10978,18,1357395144,1357395594,3,1,450
92859439@N06,10979,30,1358507309,1358508389,1,1,1080
92859439@N06,10980,28,1358703495,1358704395,1,1,900
92859439@N06,10981,28,1359202208,1359202627,2,8,419
92859439@N06,10981,26,1359202627,1359203527,2,8,900
92859439@N06,10981,13,1359206168,1359206408,2,8,240
92859439@N06,10981,26,1359207484,1359208384,2,8,900
92859439@N06,10981,12,1359209539,1359209779,2,8,240
92859439@N06,10981,26,1359209838,1359210738,2,8,900
92859439@N06,10981,28,1359213106,1359213522,2,8,416
92859439@N06,10981,21,1359213522,1359214092,1,8,570
92859439@N06,10982,7,1359706593,1359706773,2,4,180
92859439@N06,10982,30,1359711288,1359712368,3,4,1080
92859439@N06,10982,28,1359720495,1359721395,2,4,900
92859439@N06,10982,29,1359745325,1359746225,1,4,900
92859439@N06,10983,13,1359895097,1359895337,2,3,240
92859439@N06,10983,24,1359898286,1359899066,2,3,780
92859439@N06,10983,15,1359904664,1359904934,1,3,270
92859439@N06,10984,28,1360307269,1360308169,2,6,900
92859439@N06,10984,19,1360308677,1360309217,2,6,540
92859439@N06,10984,28,1360310808,1360311708,2,6,900
92859439@N06,10984,13,1360313443,1360313683,2,6,240
92859439@N06,10984,23,1360317285,1360317885,2,6,600
92859439@N06,10984,20,1360320279,1360320819,1,6,540
92859439@N06,10985,26,1360431707,1360432607,1,1,900
92859439@N06,10986,26,1360757798,1360758698,1,1,900
92885634@N00,10987,30,1317900806,1317901886,1,1,1080
92885634@N00,10988,20,1318502354,1318502894,1,1,540
92919323@N00,10989,1,1405063065,1405063125,2,2,60
92919323@N00,10989,11,1405067835,1405068075,2,2,240
92942546@N03,10990,26,1381477163,1381478063,1,1,900
92942546@N03,10991,26,1381531748,1381532648,13,1,900
92942546@N03,10992,26,1381620690,1381621590,7,1,900
92942546@N03,10993,26,1401172429,1401173329,5,1,900
92942546@N03,10994,26,1401235224,1401236124,8,1,900
92942546@N03,10995,26,1401327793,1401328693,1,1,900
92942546@N03,10996,26,1401510468,1401511368,2,1,900
92942546@N03,10997,26,1401586913,1401587813,2,1,900
92942546@N03,10998,26,1401687456,1401688356,2,1,900
92942546@N03,10999,26,1401798587,1401799487,4,1,900
92942546@N03,11000,26,1401930769,1401931669,1,1,900
92942546@N03,11001,26,1402457624,1402458524,3,1,900
92942546@N03,11002,26,1408749433,1408750333,2,1,900
92942546@N03,11003,26,1409731461,1409732361,9,1,900
92942546@N03,11004,26,1409829358,1409830258,1,1,900
92942546@N03,11005,26,1410141537,1410142437,5,1,900
92942546@N03,11006,26,1416645134,1416646034,27,1,900
92942546@N03,11007,26,1418103321,1418104221,15,1,900
92942546@N03,11008,26,1423362277,1423363177,5,1,900
92942546@N03,11009,26,1428050666,1428051566,1,1,900
92942546@N03,11010,26,1428140438,1428141338,6,1,900
92942546@N03,11011,26,1429430014,1429430914,2,1,900
92942546@N03,11012,26,1429591568,1429592468,4,1,900
92942546@N03,11013,26,1430303276,1430304176,3,1,900
92942546@N03,11014,26,1430540388,1430541288,1,1,900
92942546@N03,11015,26,1432638558,1432639458,6,1,900
92942546@N03,11016,26,1432904777,1432905677,12,1,900
92942546@N03,11017,26,1432991202,1432992102,2,1,900
92942546@N03,11018,26,1436009245,1436010145,21,1,900
92942546@N03,11019,26,1437142554,1437143454,3,1,900
92942546@N03,11020,26,1439973267,1439974167,5,1,900
92942546@N03,11021,26,1440120961,1440121861,5,1,900
92942546@N03,11022,26,1442025884,1442026784,3,1,900
92942546@N03,11023,26,1442140342,1442141242,1,1,900
92942546@N03,11024,26,1442195727,1442196627,4,1,900
92942546@N03,11025,26,1445065455,1445066355,8,1,900
92942546@N03,11026,26,1447152835,1447153735,1,1,900
93042417@N04,11027,17,1454461208,1454461508,2,2,300
93042417@N04,11027,13,1454463422,1454463662,2,2,240
93098533@N08,11028,26,1390643744,1390644644,1,1,900
93098533@N08,11029,1,1390692550,1390692610,1,1,60
93098533@N08,11030,17,1390737535,1390737835,2,3,300
93098533@N08,11030,24,1390738080,1390738860,2,3,780
93098533@N08,11030,1,1390741001,1390741061,1,3,60
93140563@N05,11031,28,1308700036,1308700936,1,1,900
93155627@N00,11032,20,1340446666,1340447206,1,1,540
93174687@N06,11033,1,1424554841,1424554901,1,1,60
93174687@N06,11034,1,1424729422,1424729482,1,1,60
93273046@N00,11035,20,1443949734,1443950274,1,1,540
93273458@N00,11036,29,1297992025,1297992925,2,1,900
93273458@N00,11037,26,1299818032,1299818727,7,5,695
93273458@N00,11037,29,1299818727,1299819627,4,5,900
93273458@N00,11037,20,1299821586,1299822126,3,5,540
93273458@N00,11037,11,1299823723,1299823906,3,5,183
93273458@N00,11037,21,1299823906,1299824476,1,5,570
93273458@N00,11038,17,1345865517,1345865817,2,2,300
93273458@N00,11038,18,1345866396,1345866846,1,2,450
93273458@N00,11039,13,1345962339,1345962579,2,3,240
93273458@N00,11039,14,1345969892,1345970132,2,3,240
93273458@N00,11039,29,1345976618,1345977518,1,3,900
93273458@N00,11040,18,1346036286,1346036736,2,4,450
93273458@N00,11040,24,1346039644,1346040424,2,4,780
93273458@N00,11040,30,1346054935,1346056015,2,4,1080
93273458@N00,11040,29,1346056782,1346057682,4,4,900
93273458@N00,11041,28,1357171757,1357172657,2,4,900
93273458@N00,11041,20,1357175838,1357176378,2,4,540
93273458@N00,11041,29,1357177313,1357178213,2,4,900
93273458@N00,11041,20,1357181004,1357181544,1,4,540
93273458@N00,11042,18,1357216231,1357216681,2,3,450
93273458@N00,11042,27,1357216708,1357217608,2,3,900
93273458@N00,11042,28,1357219849,1357220749,1,3,900
93273458@N00,11043,17,1357250815,1357251115,2,4,300
93273458@N00,11043,8,1357254252,1357254432,2,4,180
93273458@N00,11043,25,1357255795,1357256635,2,4,840
93273458@N00,11043,26,1357266787,1357267687,1,4,900
93273458@N00,11044,27,1357298343,1357299243,2,5,900
93273458@N00,11044,29,1357300398,1357301298,2,5,900
93273458@N00,11044,30,1357301475,1357302555,2,5,1080
93273458@N00,11044,14,1357303448,1357303688,2,5,240
93273458@N00,11044,26,1357305670,1357306570,1,5,900
93273458@N00,11045,29,1357349732,1357350632,1,1,900
93273458@N00,11046,1,1357416608,1357416668,2,3,60
93273458@N00,11046,12,1357418511,1357418751,2,3,240
93273458@N00,11046,26,1357441501,1357442401,1,3,900
93273458@N00,11047,29,1371340429,1371341329,2,3,900
93273458@N00,11047,30,1371347313,1371348393,2,3,1080
93273458@N00,11047,20,1371352758,1371353298,1,3,540
93273458@N00,11048,1,1371484325,1371484385,1,1,60
93273458@N00,11049,29,1371522758,1371523658,1,1,900
93273458@N00,11050,13,1378031244,1378031484,2,3,240
93273458@N00,11050,26,1378034296,1378035196,2,3,900
93273458@N00,11050,12,1378038885,1378039125,1,3,240
93294881@N00,11051,19,1413599217,1413599757,1,1,540
93294881@N00,11052,23,1427016227,1427016827,1,1,600
93294881@N00,11053,18,1431241996,1431242446,1,1,450
9329852@N08,11054,22,1193820262,1193820862,4,1,600
9329852@N08,11055,30,1245474709,1245475631,4,5,922
9329852@N08,11055,22,1245475631,1245475651,2,5,20
9329852@N08,11055,30,1245475651,1245476731,4,5,1080
9329852@N08,11055,29,1245479005,1245479905,2,5,900
9329852@N08,11055,16,1245490425,1245490695,3,5,270
93384689@N08,11056,1,1446939589,1446939649,3,7,60
93384689@N08,11056,28,1446939716,1446940616,2,7,900
93384689@N08,11056,20,1446944636,1446945176,4,7,540
93384689@N08,11056,25,1446951465,1446952305,3,7,840
93384689@N08,11056,15,1446955323,1446955593,2,7,270
93384689@N08,11056,16,1446956294,1446956564,2,7,270
93384689@N08,11056,13,1446960849,1446961089,2,7,240
93456955@N00,11057,28,1203291041,1203291941,1,1,900
93456955@N00,11058,3,1203321103,1203321193,2,1,90
93467796@N03,11059,28,1377074307,1377075207,12,4,900
93467796@N03,11059,15,1377077992,1377078262,3,4,270
93467796@N03,11059,26,1377083087,1377083362,2,4,275
93467796@N03,11059,16,1377083362,1377083632,1,4,270
93467796@N03,11060,5,1377135250,1377135370,3,7,120
93467796@N03,11060,4,1377137011,1377137112,2,7,101
93467796@N03,11060,13,1377137600,1377137840,3,7,240
93467796@N03,11060,1,1377149559,1377149619,2,7,60
93467796@N03,11060,19,1377151381,1377151921,2,7,540
93467796@N03,11060,16,1377157650,1377157920,2,7,270
93467796@N03,11060,27,1377158150,1377159050,1,7,900
93472335@N02,11061,1,1434268968,1434269028,10,4,60
93472335@N02,11061,26,1434269682,1434270582,6,4,900
93472335@N02,11061,4,1434271629,1434271730,5,4,101
93472335@N02,11061,28,1434282200,1434283100,13,4,900
93472335@N02,11062,1,1450167268,1450167328,3,2,60
93472335@N02,11062,28,1450167397,1450168297,8,2,900
93472335@N02,11063,7,1465373067,1465373138,2,4,71
93472335@N02,11063,6,1465373138,1465373258,2,4,120
93472335@N02,11063,25,1465375245,1465376085,6,4,840
93472335@N02,11063,27,1465384533,1465385433,2,4,900
93509642@N04,11064,21,1388595015,1388595585,2,2,570
93509642@N04,11064,28,1388599183,1388600083,1,2,900
93525156@N00,11065,28,1354669830,1354670730,2,9,900
93525156@N00,11065,21,1354674564,1354675134,2,9,570
93525156@N00,11065,7,1354676515,1354676695,2,9,180
93525156@N00,11065,30,1354677399,1354678479,3,9,1080
93525156@N00,11065,26,1354682670,1354683361,4,9,691
93525156@N00,11065,3,1354683361,1354683451,2,9,90
93525156@N00,11065,12,1354683549,1354683789,2,9,240
93525156@N00,11065,21,1354686050,1354686290,2,9,240
93525156@N00,11065,3,1354686290,1354686380,2,9,90
93525156@N00,11066,24,1354772868,1354773077,2,4,209
93525156@N00,11066,25,1354773077,1354773548,2,4,471
93525156@N00,11066,12,1354773548,1354773579,2,4,31
93525156@N00,11066,21,1354773579,1354774149,1,4,570
93538039@N06,11067,20,1364602539,1364603079,1,1,540
93538039@N06,11068,20,1364850600,1364851140,2,1,540
93538039@N06,11069,29,1365068387,1365069287,1,1,900
93538039@N06,11070,26,1365723551,1365724451,1,1,900
93538039@N06,11071,28,1365859371,1365860271,3,2,900
93538039@N06,11071,17,1365860496,1365860796,1,2,300
93538039@N06,11072,28,1365990599,1365991499,2,1,900
93538039@N06,11073,12,1367562448,1367562688,2,1,240
93538039@N06,11074,12,1367615533,1367615773,2,4,240
93538039@N06,11074,14,1367616078,1367616318,2,4,240
93538039@N06,11074,12,1367616794,1367617033,2,4,239
93538039@N06,11074,28,1367617033,1367617933,1,4,900
93538039@N06,11075,12,1367842968,1367843208,2,1,240
93538039@N06,11076,31,1368064225,1368065261,3,13,1036
93538039@N06,11076,20,1368065261,1368065492,2,13,231
93538039@N06,11076,29,1368065492,1368066392,4,13,900
93538039@N06,11076,26,1368067931,1368068136,2,13,205
93538039@N06,11076,6,1368068136,1368068256,2,13,120
93538039@N06,11076,21,1368068805,1368069136,2,13,331
93538039@N06,11076,3,1368069136,1368069226,3,13,90
93538039@N06,11076,15,1368073077,1368073347,6,13,270
93538039@N06,11076,28,1368076982,1368077882,5,13,900
93538039@N06,11076,29,1368096792,1368097692,2,13,900
93538039@N06,11076,28,1368104587,1368104720,2,13,133
93538039@N06,11076,27,1368104720,1368105620,3,13,900
93538039@N06,11076,15,1368107622,1368107892,1,13,270
93538039@N06,11077,15,1368263881,1368263992,2,2,111
93538039@N06,11077,27,1368263992,1368264892,1,2,900
93538039@N06,11078,20,1370170582,1370171122,3,3,540
93538039@N06,11078,17,1370171346,1370171590,2,3,244
93538039@N06,11078,28,1370171590,1370172490,1,3,900
93538039@N06,11079,28,1383809051,1383809951,1,1,900
93595313@N07,11080,27,1428660503,1428660947,3,2,444
93595313@N07,11080,16,1428660947,1428661217,5,2,270
93629101@N05,11081,1,1432356799,1432356859,6,22,60
93629101@N05,11081,28,1432357127,1432357489,2,22,362
93629101@N05,11081,26,1432357489,1432357923,3,22,434
93629101@N05,11081,30,1432357923,1432358868,2,22,945
93629101@N05,11081,20,1432358868,1432359408,14,22,540
93629101@N05,11081,29,1432360774,1432361256,2,22,482
93629101@N05,11081,19,1432361256,1432361259,2,22,3
93629101@N05,11081,29,1432361259,1432362159,7,22,900
93629101@N05,11081,21,1432363635,1432363644,2,22,9
93629101@N05,11081,3,1432363644,1432363734,22,22,90
93629101@N05,11081,8,1432364779,1432364797,4,22,18
93629101@N05,11081,3,1432364797,1432364832,3,22,35
93629101@N05,11081,8,1432364832,1432364911,3,22,79
93629101@N05,11081,3,1432364911,1432365001,3,22,90
93629101@N05,11081,15,1432365432,1432365629,2,22,197
93629101@N05,11081,17,1432365629,1432365929,2,22,300
93629101@N05,11081,28,1432368797,1432368972,2,22,175
93629101@N05,11081,17,1432368972,1432369118,10,22,146
93629101@N05,11081,27,1432369118,1432369173,3,22,55
93629101@N05,11081,17,1432369173,1432369464,4,22,291
93629101@N05,11081,26,1432369464,1432370364,2,22,900
93629101@N05,11081,28,1432374122,1432375022,68,22,900
93629101@N05,11082,28,1432530593,1432531493,1,1,900
93649382@N00,11083,26,1427667249,1427668074,2,11,825
93649382@N00,11083,4,1427668074,1427668175,4,11,101
93649382@N00,11083,3,1427669302,1427669392,2,11,90
93649382@N00,11083,25,1427673120,1427673960,5,11,840
93649382@N00,11083,13,1427678360,1427678600,2,11,240
93649382@N00,11083,1,1427686255,1427686315,2,11,60
93649382@N00,11083,20,1427687467,1427687925,2,11,458
93649382@N00,11083,1,1427687925,1427687985,3,11,60
93649382@N00,11083,13,1427688705,1427688945,2,11,240
93649382@N00,11083,24,1427688954,1427689528,2,11,574
93649382@N00,11083,1,1427689528,1427689588,3,11,60
93649382@N00,11084,17,1427750166,1427750466,2,7,300
93649382@N00,11084,16,1427751974,1427752244,2,7,270
93649382@N00,11084,24,1427752792,1427753572,5,7,780
93649382@N00,11084,15,1427769410,1427769680,9,7,270
93649382@N00,11084,8,1427773606,1427773626,3,7,20
93649382@N00,11084,26,1427773626,1427774526,5,7,900
93649382@N00,11084,20,1427777424,1427777964,6,7,540
93652979@N00,11085,31,1321167627,1321167723,2,4,96
93652979@N00,11085,29,1321167723,1321168623,3,4,900
93652979@N00,11085,20,1321172561,1321173101,2,4,540
93652979@N00,11085,28,1321178052,1321178952,1,4,900
93677566@N00,11086,1,1364183716,1364183776,2,2,60
93677566@N00,11086,31,1364198587,1364200087,3,2,1500
93677566@N00,11087,17,1385089939,1385090239,2,2,300
93677566@N00,11087,27,1385093978,1385094878,2,2,900
93677566@N00,11088,18,1445497636,1445498086,2,1,450
93752018@N00,11089,28,1222987549,1222987661,3,24,112
93752018@N00,11089,16,1222987661,1222987739,2,24,78
93752018@N00,11089,18,1222987739,1222988147,2,24,408
93752018@N00,11089,19,1222988147,1222988687,3,24,540
93752018@N00,11089,18,1222990169,1222990619,8,24,450
93752018@N00,11089,19,1222991254,1222991568,2,24,314
93752018@N00,11089,29,1222991568,1222992468,5,24,900
93752018@N00,11089,22,1222994804,1222995404,8,24,600
93752018@N00,11089,11,1222997918,1222998158,2,24,240
93752018@N00,11089,30,1222998389,1222999313,2,24,924
93752018@N00,11089,10,1222999313,1222999553,3,24,240
93752018@N00,11089,8,1223001116,1223001296,2,24,180
93752018@N00,11089,5,1223003795,1223003915,3,24,120
93752018@N00,11089,4,1223004204,1223004217,2,24,13
93752018@N00,11089,11,1223004217,1223004457,2,24,240
93752018@N00,11089,3,1223004509,1223004599,4,24,90
93752018@N00,11089,5,1223005506,1223005626,2,24,120
93752018@N00,11089,22,1223007234,1223007834,4,24,600
93752018@N00,11089,12,1223010028,1223010268,2,24,240
93752018@N00,11089,4,1223010676,1223010777,7,24,101
93752018@N00,11089,11,1223011218,1223011458,2,24,240
93752018@N00,11089,12,1223013215,1223013455,2,24,240
93752018@N00,11089,17,1223021717,1223022017,2,24,300
93752018@N00,11089,28,1223034478,1223035378,1,24,900
93762817@N08,11090,26,1390797726,1390798626,1,1,900
93842606@N05,11091,13,1302314575,1302314815,3,1,240
93842606@N05,11092,13,1302567981,1302568221,1,1,240
93867122@N05,11093,14,1380698910,1380699150,1,1,240
93884582@N00,11094,3,1293578947,1293579037,1,1,90
93886527@N06,11095,19,1415855014,1415855554,1,1,540
93900075@N03,11096,1,1363943289,1363943349,1,1,60
93925784@N00,11097,28,1356999843,1357000743,1,1,900
93929791@N08,11098,1,1429067610,1429067670,2,9,60
93929791@N08,11098,19,1429069727,1429070267,2,9,540
93929791@N08,11098,14,1429073603,1429073843,2,9,240
93929791@N08,11098,1,1429073959,1429074019,3,9,60
93929791@N08,11098,19,1429074501,1429075041,3,9,540
93929791@N08,11098,29,1429075566,1429076466,15,9,900
93929791@N08,11098,1,1429078684,1429078744,2,9,60
93929791@N08,11098,17,1429078997,1429079297,3,9,300
93929791@N08,11098,1,1429086755,1429086815,1,9,60
93951343@N00,11099,22,1336968904,1336969504,1,1,600
93973823@N06,11100,20,1345370631,1345371171,2,2,540
93973823@N06,11100,17,1345385135,1345385435,2,2,300
94037364@N04,11101,27,1362784989,1362785889,1,1,900
94063583@N03,11102,1,1382331594,1382331654,1,1,60
94063583@N03,11103,1,1388800313,1388800373,3,1,60
94107540@N00,11104,13,1369787511,1369787751,1,1,240
9414486@N03,11105,30,1396141446,1396141680,2,4,234
9414486@N03,11105,31,1396141680,1396141983,2,4,303
9414486@N03,11105,22,1396141983,1396142583,3,4,600
9414486@N03,11105,30,1396143073,1396144153,1,4,1080
9414677@N06,11106,17,1200220004,1200220304,4,4,300
9414677@N06,11106,26,1200227361,1200227731,6,4,370
9414677@N06,11106,7,1200227731,1200227911,7,4,180
9414677@N06,11106,10,1200229579,1200229819,1,4,240
9414677@N06,11107,17,1205651145,1205651445,5,5,300
9414677@N06,11107,22,1205662650,1205663250,4,5,600
9414677@N06,11107,7,1205665216,1205665396,12,5,180
9414677@N06,11107,17,1205668321,1205668389,4,5,68
9414677@N06,11107,24,1205668389,1205669169,4,5,780
9414677@N06,11108,15,1205718285,1205718555,6,4,270
9414677@N06,11108,22,1205734713,1205735313,7,4,600
9414677@N06,11108,18,1205753838,1205754288,3,4,450
9414677@N06,11108,28,1205758143,1205759043,2,4,900
94165326@N08,11109,19,1409453816,1409454356,1,1,540
94211311@N06,11110,28,1349095001,1349095901,1,1,900
9428455@N03,11111,1,1376180084,1376180115,2,9,31
9428455@N03,11111,28,1376180115,1376181015,13,9,900
9428455@N03,11111,7,1376181580,1376181760,3,9,180
9428455@N03,11111,16,1376191210,1376191480,2,9,270
9428455@N03,11111,13,1376205360,1376205600,20,9,240
9428455@N03,11111,21,1376207617,1376208187,2,9,570
9428455@N03,11111,26,1376213890,1376214790,6,9,900
9428455@N03,11111,1,1376224782,1376224842,2,9,60
9428455@N03,11111,28,1376224954,1376225854,4,9,900
94291835@N00,11112,1,1202169617,1202169677,2,6,60
94291835@N00,11112,16,1202170507,1202170777,2,6,270
94291835@N00,11112,22,1202175491,1202176091,2,6,600
94291835@N00,11112,26,1202178544,1202179444,2,6,900
94291835@N00,11112,3,1202185414,1202185504,3,6,90
94291835@N00,11112,26,1202206481,1202207381,11,6,900
94321013@N00,11113,28,1324342875,1324343775,2,1,900
94363051@N00,11114,1,1266619744,1266619804,5,11,60
94363051@N00,11114,3,1266622049,1266622139,7,11,90
94363051@N00,11114,21,1266622302,1266622872,8,11,570
94363051@N00,11114,4,1266623377,1266623405,2,11,28
94363051@N00,11114,21,1266623405,1266623918,2,11,513
94363051@N00,11114,3,1266623918,1266624008,2,11,90
94363051@N00,11114,15,1266625829,1266626099,4,11,270
94363051@N00,11114,24,1266626555,1266627335,2,11,780
94363051@N00,11114,15,1266630329,1266630599,3,11,270
94363051@N00,11114,10,1266635027,1266635267,2,11,240
94363051@N00,11114,13,1266635829,1266636069,8,11,240
94439354@N00,11115,27,1320302141,1320303041,1,1,900
94483507@N04,11116,1,1382484850,1382484910,14,1,60
94518441@N00,11117,16,1223453891,1223454161,14,1,270
94528619@N00,11118,27,1360016684,1360017429,2,21,745
94528619@N00,11118,16,1360017429,1360017434,2,21,5
94528619@N00,11118,26,1360017434,1360017648,2,21,214
94528619@N00,11118,16,1360017648,1360017918,3,21,270
94528619@N00,11118,26,1360021464,1360022364,2,21,900
94528619@N00,11118,11,1360026361,1360026601,4,21,240
94528619@N00,11118,7,1360026642,1360026730,2,21,88
94528619@N00,11118,11,1360026730,1360026769,3,21,39
94528619@N00,11118,4,1360026769,1360026861,2,21,92
94528619@N00,11118,11,1360026861,1360027101,3,21,240
94528619@N00,11118,5,1360027763,1360027883,2,21,120
94528619@N00,11118,3,1360027978,1360028068,2,21,90
94528619@N00,11118,23,1360028316,1360028916,3,21,600
94528619@N00,11118,29,1360030572,1360031472,2,21,900
94528619@N00,11118,20,1360032467,1360033007,2,21,540
94528619@N00,11118,28,1360033560,1360034460,28,21,900
94528619@N00,11118,26,1360042549,1360043449,2,21,900
94528619@N00,11118,24,1360045322,1360046102,2,21,780
94528619@N00,11118,18,1360068414,1360068617,2,21,203
94528619@N00,11118,3,1360068617,1360068707,2,21,90
94528619@N00,11118,15,1360069085,1360069355,1,21,270
94528619@N00,11119,4,1360146145,1360146246,2,2,101
94528619@N00,11119,28,1360146547,1360147447,1,2,900
94528619@N00,11120,11,1360237769,1360238009,1,1,240
94528619@N00,11121,25,1360315747,1360316587,1,1,840
94528619@N00,11122,18,1444100844,1444101294,1,1,450
94528619@N00,11123,18,1444343398,1444343848,1,1,450
94528619@N00,11124,21,1444391431,1444392001,1,1,570
94528619@N00,11125,18,1444432249,1444432699,1,1,450
94528619@N00,11126,27,1444478286,1444479186,1,1,900
94528619@N00,11127,15,1444528481,1444528751,1,1,270
94528619@N00,11128,18,1444628850,1444629300,1,1,450
94528619@N00,11129,6,1444699535,1444699655,1,1,120
94528619@N00,11130,27,1445432754,1445433654,1,1,900
94528619@N00,11131,25,1457369508,1457370348,1,1,840
9454157@N08,11132,26,1298649328,1298650228,1,1,900
9454157@N08,11133,30,1298710056,1298711136,1,1,1080
9454157@N08,11134,29,1298741190,1298742090,2,3,900
9454157@N08,11134,1,1298749083,1298749143,2,3,60
9454157@N08,11134,26,1298772247,1298773147,1,3,900
94588149@N00,11135,26,1261191201,1261192101,41,3,900
94588149@N00,11135,10,1261223668,1261223908,2,3,240
94588149@N00,11135,28,1261225407,1261226307,10,3,900
94608516@N07,11136,11,1400971492,1400971732,4,6,240
94608516@N07,11136,12,1400980291,1400980531,3,6,240
94608516@N07,11136,25,1400982753,1400983593,2,6,840
94608516@N07,11136,21,1400987231,1400987801,2,6,570
94608516@N07,11136,28,1401007028,1401007928,5,6,900
94608516@N07,11136,19,1401009776,1401010316,1,6,540
94608516@N07,11137,19,1401094076,1401094616,1,1,540
94628763@N00,11138,31,1317423315,1317424815,2,2,1500
94628763@N00,11138,10,1317428794,1317429034,1,2,240
94628763@N00,11139,11,1343129677,1343129917,1,1,240
94628763@N00,11140,28,1348578273,1348579173,1,1,900
94628763@N00,11141,28,1352465834,1352466734,1,1,900
94628763@N00,11142,1,1402539570,1402539630,1,1,60
94628763@N00,11143,26,1429397784,1429398684,1,1,900
94645446@N04,11144,26,1391726918,1391727295,2,2,377
94645446@N04,11144,11,1391727295,1391727535,1,2,240
94657254@N02,11145,18,1453360446,1453360896,1,1,450
94657254@N02,11146,18,1453415507,1453415957,1,1,450
94675251@N02,11147,30,1355932259,1355933339,1,1,1080
94734319@N00,11148,3,1238410655,1238410745,2,2,90
94734319@N00,11148,24,1238413348,1238414128,2,2,780
94734319@N00,11149,26,1238457452,1238458352,3,9,900
94734319@N00,11149,31,1238459236,1238460736,3,9,1500
94734319@N00,11149,30,1238485404,1238485423,5,9,19
94734319@N00,11149,19,1238485423,1238485963,2,9,540
94734319@N00,11149,29,1238492379,1238493279,4,9,900
94734319@N00,11149,10,1238497741,1238497981,2,9,240
94734319@N00,11149,3,1238500039,1238500047,3,9,8
94734319@N00,11149,16,1238500047,1238500054,3,9,7
94734319@N00,11149,12,1238500054,1238500294,2,9,240
94752424@N00,11150,1,1429506181,1429506241,2,1,60
94774760@N00,11151,12,1371355925,1371356165,2,3,240
94774760@N00,11151,17,1371383374,1371383674,2,3,300
94774760@N00,11151,15,1371388044,1371388314,1,3,270
94774760@N00,11152,17,1432644036,1432644336,1,1,300
9480786@N07,11153,31,1281408972,1281410472,1,1,1500
9480786@N07,11154,9,1281561466,1281561646,4,1,180
9480786@N07,11155,31,1281678515,1281680015,1,1,1500
94808878@N00,11156,15,1348640326,1348640596,2,3,270
94808878@N00,11156,31,1348642381,1348643153,2,3,772
94808878@N00,11156,30,1348643153,1348644233,1,3,1080
94812957@N00,11157,24,1214558443,1214559223,3,3,780
94812957@N00,11157,15,1214559336,1214559606,2,3,270
94812957@N00,11157,17,1214561636,1214561936,3,3,300
94865168@N00,11158,26,1317538269,1317539169,2,2,900
94865168@N00,11158,13,1317543076,1317543316,1,2,240
94921086@N08,11159,29,1403919378,1403920278,3,4,900
94921086@N08,11159,23,1403943966,1403944566,2,4,600
94921086@N08,11159,29,1403957819,1403958719,2,4,900
94921086@N08,11159,26,1403965151,1403966051,1,4,900
94935685@N00,11160,17,1189007029,1189007176,2,5,147
94935685@N00,11160,27,1189007176,1189008063,2,5,887
94935685@N00,11160,6,1189008063,1189008183,2,5,120
94935685@N00,11160,26,1189008592,1189009492,2,5,900
94935685@N00,11160,22,1189011436,1189012036,1,5,600
94935685@N00,11161,26,1189271530,1189272430,2,1,900
94935685@N00,11162,30,1189433284,1189434364,2,3,1080
94935685@N00,11162,23,1189438579,1189439179,3,3,600
94935685@N00,11162,30,1189439266,1189440346,7,3,1080
94935685@N00,11163,16,1190466064,1190466137,3,10,73
94935685@N00,11163,27,1190466137,1190466542,2,10,405
94935685@N00,11163,16,1190466542,1190466580,2,10,38
94935685@N00,11163,17,1190466580,1190466674,2,10,94
94935685@N00,11163,24,1190466674,1190466851,2,10,177
94935685@N00,11163,27,1190466851,1190467751,5,10,900
94935685@N00,11163,17,1190468433,1190468733,6,10,300
94935685@N00,11163,24,1190469786,1190470566,3,10,780
94935685@N00,11163,15,1190472000,1190472270,2,10,270
94935685@N00,11163,26,1190487577,1190488477,1,10,900
94935685@N00,11164,30,1191595193,1191596273,5,3,1080
94935685@N00,11164,23,1191599931,1191600531,3,3,600
94935685@N00,11164,28,1191603229,1191604129,3,3,900
94935685@N00,11165,26,1192897339,1192898239,2,3,900
94935685@N00,11165,16,1192901948,1192902218,11,3,270
94935685@N00,11165,26,1192905954,1192906854,1,3,900
94935685@N00,11166,30,1193506955,1193508035,1,1,1080
94935685@N00,11167,26,1195900382,1195901282,6,3,900
94935685@N00,11167,17,1195910218,1195910518,11,3,300
94935685@N00,11167,27,1195911862,1195912762,2,3,900
94935685@N00,11168,29,1196581010,1196581910,3,1,900
94935685@N00,11169,26,1198921531,1198922431,1,1,900
94935685@N00,11170,1,1199432436,1199432496,3,3,60
94935685@N00,11170,17,1199438212,1199438512,2,3,300
94935685@N00,11170,25,1199440543,1199441383,2,3,840
94935685@N00,11171,28,1200758283,1200759183,3,2,900
94935685@N00,11171,26,1200772399,1200773299,1,2,900
94935685@N00,11172,28,1200891786,1200892686,5,3,900
94935685@N00,11172,24,1200896644,1200897424,2,3,780
94935685@N00,11172,17,1200902353,1200902653,5,3,300
94935685@N00,11173,28,1202014613,1202015513,7,1,900
94935685@N00,11174,26,1202082212,1202083112,2,1,900
94935685@N00,11175,1,1202556261,1202556321,3,4,60
94935685@N00,11175,26,1202557615,1202558515,2,4,900
94935685@N00,11175,3,1202559005,1202559095,3,4,90
94935685@N00,11175,1,1202560409,1202560469,14,4,60
94942286@N07,11176,15,1302773785,1302774055,1,1,270
94942286@N07,11177,7,1367066377,1367066557,1,1,180
94942286@N07,11178,28,1369385778,1369386678,1,1,900
9496161@N07,11179,30,1318658789,1318659869,1,1,1080
94965190@N06,11180,25,1405231611,1405232451,1,1,840
95050769@N05,11181,12,1367367794,1367368034,2,5,240
95050769@N05,11181,29,1367380090,1367380990,30,5,900
95050769@N05,11181,5,1367389262,1367389361,2,5,99
95050769@N05,11181,7,1367389361,1367389541,2,5,180
95050769@N05,11181,29,1367390046,1367390946,14,5,900
95050769@N05,11182,26,1367538594,1367539494,2,7,900
95050769@N05,11182,29,1367540525,1367541425,4,7,900
95050769@N05,11182,28,1367547377,1367548277,2,7,900
95050769@N05,11182,29,1367548959,1367549859,8,7,900
95050769@N05,11182,23,1367568019,1367568619,2,7,600
95050769@N05,11182,26,1367572492,1367573392,2,7,900
95050769@N05,11182,29,1367579310,1367580210,2,7,900
95061722@N00,11183,28,1393209819,1393210154,3,8,335
95061722@N00,11183,16,1393210154,1393210159,2,8,5
95061722@N00,11183,26,1393210159,1393211059,2,8,900
95061722@N00,11183,19,1393213422,1393213962,2,8,540
95061722@N00,11183,16,1393217265,1393217535,2,8,270
95061722@N00,11183,13,1393222681,1393222921,3,8,240
95061722@N00,11183,4,1393227286,1393227387,3,8,101
95061722@N00,11183,5,1393229981,1393230101,1,8,120
95061722@N00,11184,14,1393279134,1393279374,2,18,240
95061722@N00,11184,5,1393281106,1393281226,3,18,120
95061722@N00,11184,21,1393282285,1393282681,2,18,396
95061722@N00,11184,3,1393282681,1393282771,4,18,90
95061722@N00,11184,15,1393283864,1393284128,2,18,264
95061722@N00,11184,24,1393284128,1393284236,2,18,108
95061722@N00,11184,15,1393284236,1393284506,3,18,270
95061722@N00,11184,24,1393285309,1393285531,2,18,222
95061722@N00,11184,15,1393285531,1393285801,2,18,270
95061722@N00,11184,24,1393285864,1393286644,4,18,780
95061722@N00,11184,26,1393286984,1393287884,4,18,900
95061722@N00,11184,19,1393288658,1393289198,3,18,540
95061722@N00,11184,18,1393289793,1393290053,3,18,260
95061722@N00,11184,23,1393290053,1393290653,2,18,600
95061722@N00,11184,29,1393293020,1393293920,2,18,900
95061722@N00,11184,24,1393295284,1393296064,2,18,780
95061722@N00,11184,12,1393305277,1393305517,2,18,240
95061722@N00,11184,17,1393306214,1393306514,2,18,300
95061722@N00,11185,28,1393380326,1393380643,2,12,317
95061722@N00,11185,1,1393380643,1393380703,4,12,60
95061722@N00,11185,19,1393381258,1393381798,4,12,540
95061722@N00,11185,30,1393384153,1393384313,3,12,160
95061722@N00,11185,23,1393384313,1393384324,2,12,11
95061722@N00,11185,30,1393384324,1393384400,2,12,76
95061722@N00,11185,29,1393384400,1393384434,2,12,34
95061722@N00,11185,31,1393384434,1393385482,3,12,1048
95061722@N00,11185,29,1393385482,1393386382,2,12,900
95061722@N00,11185,28,1393386764,1393387664,2,12,900
95061722@N00,11185,12,1393388713,1393388953,3,12,240
95061722@N00,11185,16,1393391437,1393391707,3,12,270
95061722@N00,11186,24,1393457120,1393457900,2,21,780
95061722@N00,11186,17,1393459054,1393459354,2,21,300
95061722@N00,11186,18,1393463695,1393464145,3,21,450
95061722@N00,11186,29,1393464744,1393465644,2,21,900
95061722@N00,11186,14,1393466530,1393466770,7,21,240
95061722@N00,11186,22,1393467907,1393468318,2,21,411
95061722@N00,11186,26,1393468318,1393469218,2,21,900
95061722@N00,11186,6,1393470119,1393470239,2,21,120
95061722@N00,11186,4,1393471033,1393471134,2,21,101
95061722@N00,11186,7,1393471298,1393471478,2,21,180
95061722@N00,11186,4,1393471693,1393471794,2,21,101
95061722@N00,11186,11,1393472028,1393472268,2,21,240
95061722@N00,11186,6,1393472638,1393472665,2,21,27
95061722@N00,11186,7,1393472665,1393472704,2,21,39
95061722@N00,11186,6,1393472704,1393472824,2,21,120
95061722@N00,11186,7,1393473009,1393473189,2,21,180
95061722@N00,11186,12,1393473376,1393473616,2,21,240
95061722@N00,11186,16,1393473699,1393473969,5,21,270
95061722@N00,11186,15,1393475298,1393475568,2,21,270
95061722@N00,11186,24,1393475788,1393476568,2,21,780
95061722@N00,11186,28,1393488976,1393489876,11,21,900
95063789@N00,11187,28,1201902204,1201902601,3,2,397
95063789@N00,11187,26,1201902601,1201903501,3,2,900
95063789@N00,11188,27,1201990639,1201991539,5,4,900
95063789@N00,11188,1,1202007199,1202007259,2,4,60
95063789@N00,11188,27,1202014269,1202015169,2,4,900
95063789@N00,11188,26,1202033547,1202034447,1,4,900
95071949@N00,11189,12,1354420404,1354420644,3,7,240
95071949@N00,11189,25,1354429008,1354429848,3,7,840
95071949@N00,11189,23,1354430029,1354430629,2,7,600
95071949@N00,11189,10,1354441325,1354441565,3,7,240
95071949@N00,11189,7,1354442420,1354442600,2,7,180
95071949@N00,11189,3,1354443651,1354443741,2,7,90
95071949@N00,11189,25,1354443808,1354444648,1,7,840
95090008@N02,11190,16,1362056400,1362056400,4,2,0
95090008@N02,11190,26,1362056400,1362057300,1,2,900
95101667@N00,11191,28,1428304334,1428305234,2,3,900
95101667@N00,11191,26,1428317669,1428317691,2,3,22
95101667@N00,11191,16,1428317691,1428317961,3,3,270
9510444@N08,11192,20,1450325298,1450325838,2,2,540
9510444@N08,11192,4,1450343304,1450343405,1,2,101
95118343@N00,11193,28,1190775355,1190776255,1,1,900
95118343@N00,11194,13,1262743227,1262743228,2,2,1
95118343@N00,11194,3,1262743228,1262743318,1,2,90
95133089@N00,11195,17,1294740864,1294741164,2,2,300
95133089@N00,11195,29,1294744580,1294745480,1,2,900
95142644@N00,11196,30,1468706647,1468707727,2,4,1080
95142644@N00,11196,18,1468715606,1468716056,3,4,450
95142644@N00,11196,28,1468737607,1468738507,2,4,900
95142644@N00,11196,9,1468741563,1468741743,1,4,180
95142644@N00,11197,28,1468881411,1468881433,2,2,22
95142644@N00,11197,30,1468881433,1468882513,2,2,1080
95230267@N07,11198,26,1397528934,1397529834,1,1,900
95230267@N07,11199,13,1397798115,1397798355,2,3,240
95230267@N07,11199,30,1397813690,1397814770,2,3,1080
95230267@N07,11199,17,1397816533,1397816833,1,3,300
95230267@N07,11200,28,1398016534,1398017434,1,1,900
95230267@N07,11201,14,1398339670,1398339910,1,1,240
95254689@N05,11202,1,1413887188,1413887248,1,1,60
95286803@N00,11203,1,1202191241,1202191301,2,4,60
95286803@N00,11203,28,1202191338,1202192238,2,4,900
95286803@N00,11203,10,1202192367,1202192607,6,4,240
95286803@N00,11203,26,1202212325,1202213225,6,4,900
95303040@N00,11204,20,1371515424,1371515964,9,3,540
95303040@N00,11204,27,1371519107,1371520005,2,3,898
95303040@N00,11204,20,1371520005,1371520545,26,3,540
95319148@N07,11205,26,1439984581,1439985481,4,1,900
95341382@N05,11206,11,1425955773,1425956013,1,1,240
95341382@N05,11207,21,1429604636,1429605206,1,1,570
95341382@N05,11208,1,1446507430,1446507490,1,1,60
95356654@N00,11209,16,1370358443,1370358713,2,3,270
95356654@N00,11209,17,1370358998,1370359298,2,3,300
95356654@N00,11209,26,1370364629,1370365529,1,3,900
95364079@N08,11210,21,1300267015,1300267585,1,1,570
95383339@N07,11211,18,1444688756,1444689206,4,3,450
95383339@N07,11211,26,1444722915,1444723815,2,3,900
95383339@N07,11211,28,1444731625,1444732525,2,3,900
95383339@N07,11212,4,1445066944,1445067045,1,1,101
95400904@N02,11213,30,1382398815,1382399895,3,2,1080
95400904@N02,11213,26,1382418891,1382419791,2,2,900
95414019@N00,11214,28,1234044574,1234044876,2,7,302
95414019@N00,11214,1,1234044876,1234044936,5,7,60
95414019@N00,11214,3,1234048733,1234048823,2,7,90
95414019@N00,11214,18,1234053691,1234054141,3,7,450
95414019@N00,11214,29,1234059198,1234060098,2,7,900
95414019@N00,11214,26,1234066943,1234067843,2,7,900
95414019@N00,11214,1,1234069642,1234069702,2,7,60
95428663@N03,11215,27,1233365919,1233366819,1,1,900
95428663@N03,11216,23,1233451608,1233452208,9,2,600
95428663@N03,11216,28,1233472158,1233473058,2,2,900
95450266@N06,11217,26,1440125404,1440126304,7,22,900
95450266@N06,11217,24,1440126654,1440127434,3,22,780
95450266@N06,11217,15,1440127995,1440128265,3,22,270
95450266@N06,11217,24,1440128471,1440128789,5,22,318
95450266@N06,11217,15,1440128789,1440129059,4,22,270
95450266@N06,11217,21,1440129299,1440129825,7,22,526
95450266@N06,11217,25,1440129825,1440130665,4,22,840
95450266@N06,11217,21,1440131082,1440131652,5,22,570
95450266@N06,11217,13,1440132053,1440132293,7,22,240
95450266@N06,11217,30,1440133206,1440134286,3,22,1080
95450266@N06,11217,31,1440134674,1440134758,2,22,84
95450266@N06,11217,30,1440134758,1440135838,5,22,1080
95450266@N06,11217,18,1440139863,1440140313,3,22,450
95450266@N06,11217,28,1440140857,1440141757,8,22,900
95450266@N06,11217,1,1440142709,1440142769,4,22,60
95450266@N06,11217,28,1440143983,1440144883,2,22,900
95450266@N06,11217,3,1440153460,1440153550,2,22,90
95450266@N06,11217,25,1440153603,1440154443,2,22,840
95450266@N06,11217,30,1440154597,1440155677,2,22,1080
95450266@N06,11217,29,1440156790,1440157690,5,22,900
95450266@N06,11217,18,1440158295,1440158455,3,22,160
95450266@N06,11217,28,1440158455,1440159355,2,22,900
95461076@N00,11218,1,1281729155,1281729215,2,6,60
95461076@N00,11218,29,1281732073,1281732973,4,6,900
95461076@N00,11218,22,1281734477,1281735077,5,6,600
95461076@N00,11218,17,1281749235,1281749535,4,6,300
95461076@N00,11218,11,1281761231,1281761471,17,6,240
95461076@N00,11218,12,1281769254,1281769494,3,6,240
95508147@N03,11219,1,1401416158,1401416218,8,1,60
95555269@N00,11220,1,1317862409,1317862469,2,5,60
95555269@N00,11220,28,1317869017,1317869917,2,5,900
95555269@N00,11220,25,1317872790,1317873630,2,5,840
95555269@N00,11220,18,1317884878,1317885328,2,5,450
95555269@N00,11220,28,1317893730,1317894630,1,5,900
95559818@N00,11221,10,1207207700,1207207940,2,2,240
95559818@N00,11221,29,1207210437,1207211337,1,2,900
95559818@N00,11222,26,1207266161,1207267061,3,1,900
95559818@N00,11223,10,1283854388,1283854628,6,1,240
95594534@N05,11224,29,1418721449,1418722349,4,1,900
95601478@N00,11225,26,1279521155,1279522055,17,1,900
95601478@N00,11226,26,1279583560,1279584460,49,1,900
95601478@N00,11227,26,1279675725,1279676625,21,1,900
95601478@N00,11228,26,1279883197,1279884097,1,1,900
95601478@N00,11229,7,1279941418,1279941598,2,4,180
95601478@N00,11229,17,1279950943,1279951243,2,4,300
95601478@N00,11229,28,1279952163,1279953063,3,4,900
95601478@N00,11229,26,1279972386,1279973286,21,4,900
95601478@N00,11230,26,1280032437,1280033337,60,1,900
95611942@N00,11231,28,1249080752,1249080916,4,27,164
95611942@N00,11231,26,1249080916,1249081419,5,27,503
95611942@N00,11231,16,1249081419,1249081689,3,27,270
95611942@N00,11231,17,1249082981,1249083281,2,27,300
95611942@N00,11231,16,1249085424,1249085694,2,27,270
95611942@N00,11231,15,1249085928,1249086198,2,27,270
95611942@N00,11231,23,1249087833,1249088433,2,27,600
95611942@N00,11231,18,1249088472,1249088922,5,27,450
95611942@N00,11231,29,1249090711,1249090834,3,27,123
95611942@N00,11231,20,1249090834,1249091374,3,27,540
95611942@N00,11231,26,1249095591,1249096015,5,27,424
95611942@N00,11231,3,1249096015,1249096105,4,27,90
95611942@N00,11231,25,1249096198,1249097038,18,27,840
95611942@N00,11231,12,1249099745,1249099985,2,27,240
95611942@N00,11231,30,1249102323,1249103403,2,27,1080
95611942@N00,11231,29,1249107293,1249108193,3,27,900
95611942@N00,11231,24,1249116466,1249117246,3,27,780
95611942@N00,11231,27,1249117367,1249117659,2,27,292
95611942@N00,11231,24,1249117659,1249118198,4,27,539
95611942@N00,11231,15,1249118198,1249118259,4,27,61
95611942@N00,11231,16,1249118259,1249118529,5,27,270
95611942@N00,11231,28,1249120038,1249120938,6,27,900
95611942@N00,11231,18,1249121690,1249121798,2,27,108
95611942@N00,11231,26,1249121798,1249122698,4,27,900
95611942@N00,11231,22,1249123957,1249124557,2,27,600
95611942@N00,11231,26,1249126214,1249126813,4,27,599
95611942@N00,11231,28,1249126813,1249127713,1,27,900
95611942@N00,11232,14,1434488247,1434488487,3,15,240
95611942@N00,11232,28,1434489796,1434490028,2,15,232
95611942@N00,11232,26,1434490028,1434490380,2,15,352
95611942@N00,11232,25,1434490380,1434491220,6,15,840
95611942@N00,11232,3,1434492103,1434492193,2,15,90
95611942@N00,11232,4,1434492991,1434493092,8,15,101
95611942@N00,11232,26,1434495062,1434495791,2,15,729
95611942@N00,11232,9,1434495791,1434495971,2,15,180
95611942@N00,11232,13,1434497015,1434497255,2,15,240
95611942@N00,11232,16,1434500961,1434501231,2,15,270
95611942@N00,11232,22,1434502845,1434503445,2,15,600
95611942@N00,11232,28,1434521986,1434522886,2,15,900
95611942@N00,11232,26,1434524084,1434524984,4,15,900
95611942@N00,11232,29,1434528216,1434528519,2,15,303
95611942@N00,11232,20,1434528519,1434529059,6,15,540
95637476@N06,11233,26,1368323119,1368324019,1,1,900
95637476@N06,11234,12,1370763511,1370763751,2,1,240
95637476@N06,11235,28,1370923508,1370924408,2,2,900
95637476@N06,11235,31,1370924851,1370926351,1,2,1500
95672420@N02,11236,13,1371796156,1371796396,2,1,240
95701812@N00,11237,21,1308275932,1308276197,2,9,265
95701812@N00,11237,13,1308276197,1308276437,8,9,240
95701812@N00,11237,15,1308278995,1308279265,4,9,270
95701812@N00,11237,28,1308283238,1308284029,2,9,791
95701812@N00,11237,26,1308284029,1308284084,2,9,55
95701812@N00,11237,6,1308284084,1308284204,2,9,120
95701812@N00,11237,16,1308287332,1308287602,14,9,270
95701812@N00,11237,1,1308300337,1308300397,8,9,60
95701812@N00,11237,26,1308314172,1308315072,1,9,900
95708853@N00,11238,28,1362440380,1362441280,2,3,900
95708853@N00,11238,27,1362464429,1362465329,4,3,900
95708853@N00,11238,28,1362466053,1362466953,1,3,900
95724996@N04,11239,1,1466832496,1466832556,2,4,60
95724996@N04,11239,28,1466832771,1466833671,2,4,900
95724996@N04,11239,15,1466834046,1466834316,2,4,270
95724996@N04,11239,27,1466834515,1466835415,1,4,900
95769700@N00,11240,20,1325141746,1325141747,2,2,1
95769700@N00,11240,15,1325141747,1325142017,1,2,270
95769700@N00,11241,28,1356223621,1356224521,14,1,900
95769700@N00,11242,28,1356311317,1356312217,1,1,900
95782054@N05,11243,26,1359187697,1359188597,2,1,900
95867639@N03,11244,26,1372924366,1372925266,1,1,900
95867639@N03,11245,1,1374756418,1374756478,2,1,60
95867639@N03,11246,1,1375003968,1375004028,5,1,60
95867639@N03,11247,1,1375058531,1375058591,1,1,60
95867639@N03,11248,1,1375238281,1375238341,1,1,60
95867639@N03,11249,1,1375351942,1375352002,2,1,60
95867639@N03,11250,1,1375516030,1375516090,2,1,60
95867639@N03,11251,1,1375608091,1375608151,4,1,60
95867639@N03,11252,1,1375789099,1375789159,1,1,60
95867639@N03,11253,1,1375860539,1375860599,1,1,60
95867639@N03,11254,1,1376032839,1376032899,6,1,60
95867639@N03,11255,1,1376209891,1376209951,3,1,60
95867639@N03,11256,1,1376739779,1376739839,2,1,60
95867639@N03,11257,1,1376995712,1376995772,6,1,60
95867639@N03,11258,1,1377176059,1377176119,1,1,60
95867639@N03,11259,1,1377347507,1377347567,7,1,60
95867639@N03,11260,1,1377772366,1377772426,4,1,60
95867639@N03,11261,1,1377941891,1377941951,7,1,60
95867639@N03,11262,1,1378012194,1378012254,2,1,60
95867639@N03,11263,1,1378282995,1378283055,1,1,60
95867639@N03,11264,1,1378550168,1378550228,7,1,60
95867639@N03,11265,1,1379146415,1379146475,5,1,60
95867639@N03,11266,1,1379491867,1379491927,5,1,60
95867639@N03,11267,1,1379772380,1379772440,1,1,60
95867639@N03,11268,1,1380179066,1380179126,13,1,60
95867639@N03,11269,1,1380875039,1380875099,4,1,60
95867639@N03,11270,1,1380983419,1380983479,1,1,60
95867639@N03,11271,1,1381400303,1381400363,1,1,60
95867639@N03,11272,1,1381437487,1381437547,1,1,60
95867639@N03,11273,1,1381493679,1381493739,1,1,60
95867639@N03,11274,1,1381574144,1381574204,2,1,60
9588819@N06,11275,7,1399482499,1399482679,1,1,180
95899395@N02,11276,13,1369442581,1369442821,2,1,240
95904983@N03,11277,29,1356927772,1356928672,2,1,900
95904983@N03,11278,27,1439456461,1439457361,3,1,900
95924854@N06,11279,26,1341797411,1341798311,2,1,900
96004001@N00,11280,28,1197757070,1197757970,3,4,900
96004001@N00,11280,23,1197759113,1197759511,2,4,398
96004001@N00,11280,18,1197759511,1197759961,2,4,450
96004001@N00,11280,29,1197762057,1197762957,3,4,900
96004001@N00,11281,20,1422151791,1422152331,2,21,540
96004001@N00,11281,23,1422155812,1422155823,2,21,11
96004001@N00,11281,18,1422155823,1422156273,5,21,450
96004001@N00,11281,30,1422156356,1422157436,2,21,1080
96004001@N00,11281,18,1422164248,1422164698,8,21,450
96004001@N00,11281,1,1422165489,1422165549,4,21,60
96004001@N00,11281,20,1422166325,1422166865,2,21,540
96004001@N00,11281,21,1422167303,1422167873,2,21,570
96004001@N00,11281,12,1422169182,1422169422,2,21,240
96004001@N00,11281,16,1422171639,1422171909,2,21,270
96004001@N00,11281,5,1422179925,1422180045,2,21,120
96004001@N00,11281,17,1422181374,1422181674,2,21,300
96004001@N00,11281,7,1422185576,1422185756,2,21,180
96004001@N00,11281,29,1422186537,1422187136,2,21,599
96004001@N00,11281,5,1422187136,1422187256,2,21,120
96004001@N00,11281,30,1422187454,1422187575,2,21,121
96004001@N00,11281,29,1422187575,1422188475,2,21,900
96004001@N00,11281,4,1422189806,1422189907,2,21,101
96004001@N00,11281,3,1422189919,1422190009,2,21,90
96004001@N00,11281,28,1422196401,1422196493,3,21,92
96004001@N00,11281,1,1422196493,1422196553,6,21,60
96004001@N00,11282,1,1422263137,1422263197,1,1,60
96004001@N00,11283,12,1422313263,1422313503,2,13,240
96004001@N00,11283,30,1422315243,1422316323,6,13,1080
96004001@N00,11283,17,1422319775,1422320075,2,13,300
96004001@N00,11283,30,1422321859,1422322683,4,13,824
96004001@N00,11283,27,1422322683,1422323340,2,13,657
96004001@N00,11283,15,1422323340,1422323610,7,13,270
96004001@N00,11283,17,1422330794,1422331094,7,13,300
96004001@N00,11283,15,1422332003,1422332273,10,13,270
96004001@N00,11283,30,1422333006,1422333383,3,13,377
96004001@N00,11283,15,1422333383,1422333653,6,13,270
96004001@N00,11283,13,1422333982,1422334222,2,13,240
96004001@N00,11283,15,1422335064,1422335334,6,13,270
96004001@N00,11283,13,1422336155,1422336395,9,13,240
96004001@N00,11284,3,1422430160,1422430250,5,2,90
96004001@N00,11284,29,1422434549,1422435449,6,2,900
96045537@N00,11285,18,1194488200,1194488650,3,7,450
96045537@N00,11285,30,1194490828,1194491908,3,7,1080
96045537@N00,11285,13,1194496835,1194497075,7,7,240
96045537@N00,11285,12,1194498560,1194498800,3,7,240
96045537@N00,11285,26,1194501332,1194502232,3,7,900
96045537@N00,11285,27,1194515900,1194516800,2,7,900
96045537@N00,11285,26,1194518071,1194518971,1,7,900
96045537@N00,11286,8,1194575758,1194575938,2,1,180
96045537@N00,11287,8,1194605817,1194605997,3,1,180
96051441@N00,11288,15,1338351473,1338351743,1,1,270
9606104@N07,11289,26,1279177812,1279178712,10,1,900
9606104@N07,11290,26,1279242321,1279243221,138,1,900
9606104@N07,11291,26,1279321210,1279322110,52,1,900
96067265@N02,11292,29,1356907721,1356907911,2,10,190
96067265@N02,11292,28,1356907911,1356908811,3,10,900
96067265@N02,11292,13,1356915163,1356915403,4,10,240
96067265@N02,11292,15,1356927847,1356928117,2,10,270
96067265@N02,11292,28,1356936527,1356937427,8,10,900
96067265@N02,11292,18,1356937450,1356937900,7,10,450
96067265@N02,11292,1,1356938878,1356938938,2,10,60
96067265@N02,11292,18,1356940589,1356941039,4,10,450
96067265@N02,11292,29,1356948474,1356949374,2,10,900
96067265@N02,11292,28,1356951064,1356951964,1,10,900
96156793@N00,11293,3,1412290506,1412290596,2,2,90
96156793@N00,11293,19,1412292296,1412292836,1,2,540
96156793@N00,11294,30,1412421429,1412421470,2,5,41
96156793@N00,11294,3,1412421470,1412421534,2,5,64
96156793@N00,11294,18,1412421534,1412421560,2,5,26
96156793@N00,11294,19,1412421560,1412421607,2,5,47
96156793@N00,11294,30,1412421607,1412422687,2,5,1080
96156793@N00,11295,19,1412688414,1412688954,1,1,540
96156793@N00,11296,19,1415622527,1415622570,2,3,43
96156793@N00,11296,25,1415622570,1415622594,2,3,24
96156793@N00,11296,19,1415622594,1415623134,2,3,540
96156793@N00,11297,18,1454497077,1454497527,2,1,450
96156793@N00,11298,18,1454658707,1454659157,1,1,450
96173146@N00,11299,27,1327288994,1327289894,1,1,900
96175708@N06,11300,1,1381626010,1381626070,2,11,60
96175708@N06,11300,28,1381626122,1381626975,2,11,853
96175708@N06,11300,26,1381626975,1381627875,3,11,900
96175708@N06,11300,29,1381629011,1381629911,5,11,900
96175708@N06,11300,22,1381630193,1381630395,2,11,202
96175708@N06,11300,14,1381630395,1381630635,2,11,240
96175708@N06,11300,20,1381631488,1381632028,2,11,540
96175708@N06,11300,30,1381634535,1381635615,2,11,1080
96175708@N06,11300,17,1381636945,1381637245,2,11,300
96175708@N06,11300,13,1381638163,1381638403,3,11,240
96175708@N06,11300,12,1381651261,1381651501,1,11,240
96175708@N06,11301,29,1381710967,1381711867,2,2,900
96175708@N06,11301,11,1381739507,1381739747,1,2,240
96175708@N06,11302,26,1381905251,1381906151,2,2,900
96175708@N06,11302,16,1381907164,1381907434,1,2,270
9628881@N05,11303,26,1236547112,1236548012,36,1,900
9628881@N05,11304,26,1237152154,1237153054,10,1,900
9628881@N05,11305,26,1237540759,1237541659,4,1,900
9628881@N05,11306,26,1238140225,1238141125,11,1,900
9628881@N05,11307,26,1239962179,1239963079,6,1,900
9628881@N05,11308,23,1307669377,1307669977,15,3,600
9628881@N05,11308,29,1307673496,1307673594,2,3,98
9628881@N05,11308,23,1307673594,1307674194,1,3,600
96312503@N08,11309,11,1377813440,1377813680,2,2,240
96312503@N08,11309,28,1377829975,1377830875,1,2,900
96312503@N08,11310,8,1377908441,1377908621,2,3,180
96312503@N08,11310,20,1377910587,1377911127,2,3,540
96312503@N08,11310,14,1377911575,1377911815,1,3,240
96312503@N08,11311,16,1377983643,1377983913,2,2,270
96312503@N08,11311,14,1378009417,1378009657,1,2,240
96312503@N08,11312,29,1378092341,1378093241,2,2,900
96312503@N08,11312,20,1378094724,1378095264,1,2,540
96312503@N08,11313,26,1411904591,1411905491,1,1,900
96326655@N08,11314,1,1369400373,1369400433,5,1,60
96326655@N08,11315,1,1369639445,1369639505,1,1,60
96326655@N08,11316,1,1374054955,1374055015,1,1,60
96326655@N08,11317,1,1386591995,1386592055,1,1,60
96326655@N08,11318,15,1397465054,1397465324,7,3,270
96326655@N08,11318,1,1397485522,1397485582,2,3,60
96326655@N08,11318,15,1397485815,1397486085,1,3,270
96326655@N08,11319,19,1408871727,1408872267,3,1,540
96326655@N08,11320,18,1427663814,1427664264,3,1,450
96326655@N08,11321,18,1427726397,1427726847,10,1,450
96328796@N02,11322,1,1358567782,1358567842,3,1,60
96353274@N00,11323,1,1361498502,1361498562,2,2,60
96353274@N00,11323,27,1361516208,1361517108,1,2,900
96355380@N03,11324,28,1364955769,1364955775,2,2,6
96355380@N03,11324,26,1364955775,1364956675,2,2,900
96359838@N06,11325,1,1402361745,1402361805,1,1,60
96366612@N03,11326,21,1306857979,1306858549,1,1,570
96372242@N07,11327,15,1343807477,1343807747,1,1,270
96387804@N07,11328,3,1409271252,1409271342,1,1,90
96387804@N07,11329,31,1413943680,1413945180,1,1,1500
9640183@N05,11330,17,1302920176,1302920476,1,1,300
96430093@N05,11331,13,1375767545,1375767785,3,2,240
96430093@N05,11331,28,1375781719,1375782619,2,2,900
96430093@N05,11332,6,1375842430,1375842550,2,4,120
96430093@N05,11332,9,1375845638,1375845760,2,4,122
96430093@N05,11332,5,1375845760,1375845880,2,4,120
96430093@N05,11332,3,1375847521,1375847611,1,4,90
96430093@N05,11333,29,1376224933,1376225833,1,1,900
96430093@N05,11334,28,1390349062,1390349962,2,3,900
96430093@N05,11334,3,1390351623,1390351713,2,3,90
96430093@N05,11334,17,1390377139,1390377439,1,3,300
96430093@N05,11335,1,1390441158,1390441218,1,1,60
96430093@N05,11336,22,1390610849,1390611449,2,2,600
96430093@N05,11336,23,1390613358,1390613958,1,2,600
96430093@N05,11337,28,1390692571,1390693471,2,4,900
96430093@N05,11337,30,1390694369,1390695449,2,4,1080
96430093@N05,11337,29,1390695935,1390696835,2,4,900
96430093@N05,11337,28,1390698290,1390699190,2,4,900
96430093@N05,11338,28,1421820906,1421821806,1,1,900
96430093@N05,11339,30,1421903399,1421904479,1,1,1080
96430093@N05,11340,18,1422080351,1422080801,1,1,450
96430093@N05,11341,28,1422514845,1422515745,2,2,900
96430093@N05,11341,25,1422520075,1422520915,1,2,840
96430093@N05,11342,18,1423717811,1423718261,1,1,450
96430093@N05,11343,11,1439439713,1439439953,2,3,240
96430093@N05,11343,30,1439446868,1439447948,2,3,1080
96430093@N05,11343,27,1439473537,1439474437,1,3,900
96430093@N05,11344,18,1439725990,1439726440,1,1,450
96430093@N05,11345,18,1439795575,1439796025,1,1,450
96430093@N05,11346,18,1439860457,1439860907,4,1,450
96433270@N00,11347,18,1452414574,1452415024,1,1,450
96453045@N03,11348,16,1381644857,1381645127,1,1,270
96455082@N00,11349,26,1218809506,1218810406,1,1,900
96455082@N00,11350,26,1223815069,1223815969,1,1,900
96455082@N00,11351,26,1223854540,1223855440,15,1,900
96467080@N06,11352,29,1445046585,1445047485,1,1,900
96479915@N00,11353,31,1311654640,1311656140,3,5,1500
96479915@N00,11353,27,1311662307,1311663207,10,5,900
96479915@N00,11353,10,1311665999,1311666239,7,5,240
96479915@N00,11353,30,1311667633,1311667643,5,5,10
96479915@N00,11353,31,1311667643,1311669143,11,5,1500
96499116@N06,11354,28,1439979794,1439980694,5,1,900
96499116@N06,11355,28,1440214509,1440215409,17,1,900
96525992@N08,11356,1,1383983262,1383983322,1,1,60
96541149@N00,11357,26,1222783200,1222784100,31,1,900
96548081@N07,11358,16,1408265968,1408266238,2,2,270
96548081@N07,11358,26,1408279031,1408279931,1,2,900
96573443@N05,11359,26,1375853266,1375854166,2,1,900
96581740@N03,11360,1,1364172715,1364172775,2,31,60
96581740@N03,11360,28,1364173806,1364174115,10,31,309
96581740@N03,11360,16,1364174115,1364174155,2,31,40
96581740@N03,11360,26,1364174155,1364174672,13,31,517
96581740@N03,11360,10,1364174672,1364174763,3,31,91
96581740@N03,11360,26,1364174763,1364174876,3,31,113
96581740@N03,11360,6,1364174876,1364174878,3,31,2
96581740@N03,11360,26,1364174878,1364175014,2,31,136
96581740@N03,11360,7,1364175014,1364175032,2,31,18
96581740@N03,11360,6,1364175032,1364175152,2,31,120
96581740@N03,11360,7,1364175448,1364175454,3,31,6
96581740@N03,11360,11,1364175454,1364175459,2,31,5
96581740@N03,11360,7,1364175459,1364175639,2,31,180
96581740@N03,11360,13,1364180621,1364180861,96,31,240
96581740@N03,11360,21,1364184983,1364184989,3,31,6
96581740@N03,11360,3,1364184989,1364184993,3,31,4
96581740@N03,11360,21,1364184993,1364185563,3,31,570
96581740@N03,11360,7,1364186060,1364186137,5,31,77
96581740@N03,11360,10,1364186137,1364186143,3,31,6
96581740@N03,11360,7,1364186143,1364186323,3,31,180
96581740@N03,11360,4,1364186530,1364186631,5,31,101
96581740@N03,11360,21,1364186726,1364186736,5,31,10
96581740@N03,11360,6,1364186736,1364186856,3,31,120
96581740@N03,11360,9,1364187347,1364187527,5,31,180
96581740@N03,11360,10,1364188233,1364188473,5,31,240
96581740@N03,11360,30,1364190825,1364191461,7,31,636
96581740@N03,11360,29,1364191461,1364192053,5,31,592
96581740@N03,11360,22,1364192053,1364192653,7,31,600
96581740@N03,11360,28,1364194833,1364195733,19,31,900
96581740@N03,11360,26,1364204170,1364204610,16,31,440
96581740@N03,11360,28,1364204610,1364205510,14,31,900
96626588@N07,11361,28,1388451575,1388452041,10,17,466
96626588@N07,11361,16,1388452041,1388452077,3,17,36
96626588@N07,11361,26,1388452077,1388452343,7,17,266
96626588@N07,11361,6,1388452343,1388452463,8,17,120
96626588@N07,11361,23,1388456033,1388456095,2,17,62
96626588@N07,11361,29,1388456095,1388456995,2,17,900
96626588@N07,11361,14,1388459867,1388460107,2,17,240
96626588@N07,11361,29,1388471793,1388471851,3,17,58
96626588@N07,11361,21,1388471851,1388472421,6,17,570
96626588@N07,11361,25,1388474895,1388475735,7,17,840
96626588@N07,11361,4,1388479845,1388479946,5,17,101
96626588@N07,11361,20,1388487905,1388488445,12,17,540
96626588@N07,11361,18,1388495329,1388495663,2,17,334
96626588@N07,11361,28,1388495663,1388495670,3,17,7
96626588@N07,11361,18,1388495670,1388495743,2,17,73
96626588@N07,11361,28,1388495743,1388496643,4,17,900
96626588@N07,11361,1,1388497345,1388497405,4,17,60
9664872@N04,11362,15,1453866482,1453866752,1,1,270
9664872@N04,11363,15,1462340114,1462340384,1,1,270
96649001@N00,11364,29,1405901015,1405901915,2,4,900
96649001@N00,11364,14,1405914492,1405914688,2,4,196
96649001@N00,11364,17,1405914688,1405914988,2,4,300
96649001@N00,11364,19,1405925181,1405925721,1,4,540
96649001@N00,11365,26,1406271182,1406272082,2,1,900
96653558@N00,11366,3,1205227227,1205227317,2,1,90
96717948@N05,11367,18,1372815533,1372815983,1,1,450
96722532@N03,11368,26,1350628931,1350629831,14,1,900
96722532@N03,11369,31,1354225713,1354227213,2,1,1500
96722532@N03,11370,1,1357257875,1357257935,24,1,60
96722532@N03,11371,26,1358239831,1358240731,2,1,900
96722532@N03,11372,1,1358532040,1358532100,10,1,60
96722532@N03,11373,1,1358617775,1358617835,5,1,60
96722532@N03,11374,26,1362969676,1362970576,2,1,900
96722532@N03,11375,6,1369300168,1369300170,2,10,2
96722532@N03,11375,26,1369300170,1369300643,3,10,473
96722532@N03,11375,3,1369300643,1369300733,2,10,90
96722532@N03,11375,21,1369300817,1369301273,2,10,456
96722532@N03,11375,26,1369301273,1369302173,6,10,900
96722532@N03,11375,3,1369305557,1369305647,4,10,90
96722532@N03,11375,5,1369305649,1369305769,4,10,120
96722532@N03,11375,26,1369309844,1369309852,2,10,8
96722532@N03,11375,8,1369309852,1369309884,2,10,32
96722532@N03,11375,6,1369309884,1369310004,4,10,120
96722532@N03,11376,16,1369405005,1369405275,59,1,270
96722532@N03,11377,26,1371169290,1371170190,2,1,900
96722532@N03,11378,1,1372435347,1372435407,11,1,60
96722532@N03,11379,7,1377990970,1377991150,1,1,180
96722532@N03,11380,4,1385082146,1385082247,1,1,101
96722532@N03,11381,15,1391302622,1391302892,14,3,270
96722532@N03,11381,29,1391307633,1391308533,3,3,900
96722532@N03,11381,26,1391312117,1391313017,9,3,900
96722532@N03,11382,5,1400935608,1400935728,1,1,120
96722532@N03,11383,3,1401025201,1401025291,2,3,90
96722532@N03,11383,25,1401025432,1401025679,3,3,247
96722532@N03,11383,26,1401025679,1401026579,1,3,900
96722532@N03,11384,26,1414843153,1414844053,1,1,900
96722532@N03,11385,18,1433686466,1433686817,2,2,351
96722532@N03,11385,26,1433686817,1433687717,1,2,900
9672978@N08,11386,18,1213771072,1213771522,1,1,450
9672978@N08,11387,23,1237008283,1237008883,1,1,600
9672978@N08,11388,23,1237552801,1237553401,1,1,600
96799583@N00,11389,26,1290337702,1290338602,3,4,900
96799583@N00,11389,21,1290339232,1290339300,2,4,68
96799583@N00,11389,25,1290339300,1290340140,3,4,840
96799583@N00,11389,28,1290346593,1290347493,1,4,900
96961309@N00,11390,28,1255227180,1255228080,22,1,900
96981714@N07,11391,26,1370067296,1370068196,1,1,900
96981714@N07,11392,16,1370150968,1370151238,1,1,270
96985020@N07,11393,1,1376550698,1376550758,1,1,60
96985020@N07,11394,28,1389581520,1389582420,1,1,900
96985020@N07,11395,15,1395623865,1395624135,1,1,270
9708101@N02,11396,26,1198489683,1198490583,1,1,900
9708101@N02,11397,23,1214646087,1214646687,2,2,600
9708101@N02,11397,29,1214647448,1214648348,4,2,900
9708101@N02,11398,28,1215130295,1215131195,1,1,900
97124099@N08,11399,1,1452063845,1452063905,2,2,60
97124099@N08,11399,28,1452087645,1452088545,1,2,900
97137858@N00,11400,28,1416898663,1416899563,2,22,900
97137858@N00,11400,18,1416900277,1416900727,2,22,450
97137858@N00,11400,19,1416900868,1416900891,2,22,23
97137858@N00,11400,29,1416900891,1416900921,2,22,30
97137858@N00,11400,19,1416900921,1416901003,3,22,82
97137858@N00,11400,18,1416901003,1416901055,2,22,52
97137858@N00,11400,19,1416901055,1416901230,2,22,175
97137858@N00,11400,18,1416901230,1416901680,3,22,450
97137858@N00,11400,19,1416901718,1416902258,5,22,540
97137858@N00,11400,20,1416903354,1416903894,2,22,540
97137858@N00,11400,22,1416904504,1416905104,4,22,600
97137858@N00,11400,19,1416911989,1416912529,2,22,540
97137858@N00,11400,18,1416913312,1416913762,2,22,450
97137858@N00,11400,27,1416918211,1416919111,2,22,900
97137858@N00,11400,15,1416925330,1416925600,2,22,270
97137858@N00,11400,16,1416927727,1416927997,2,22,270
97137858@N00,11400,21,1416929622,1416930192,2,22,570
97137858@N00,11400,5,1416930262,1416930382,2,22,120
97137858@N00,11400,7,1416930538,1416930718,2,22,180
97137858@N00,11400,29,1416931539,1416932439,11,22,900
97137858@N00,11400,18,1416934072,1416934204,2,22,132
97137858@N00,11400,28,1416934204,1416935104,1,22,900
97137858@N00,11401,17,1417258782,1417259082,3,8,300
97137858@N00,11401,27,1417262078,1417262978,3,8,900
97137858@N00,11401,12,1417263185,1417263320,2,8,135
97137858@N00,11401,21,1417263320,1417263718,5,8,398
97137858@N00,11401,25,1417263718,1417264558,20,8,840
97137858@N00,11401,3,1417265615,1417265705,2,8,90
97137858@N00,11401,26,1417265742,1417266510,2,8,768
97137858@N00,11401,19,1417266510,1417267050,1,8,540
97161736@N02,11402,1,1383168678,1383168738,3,26,60
97161736@N02,11402,28,1383168799,1383169014,7,26,215
97161736@N02,11402,23,1383169014,1383169124,3,26,110
97161736@N02,11402,19,1383169124,1383169664,2,26,540
97161736@N02,11402,29,1383170354,1383170370,2,26,16
97161736@N02,11402,19,1383170370,1383170428,3,26,58
97161736@N02,11402,18,1383170428,1383170465,3,26,37
97161736@N02,11402,19,1383170465,1383170662,5,26,197
97161736@N02,11402,18,1383170662,1383170943,3,26,281
97161736@N02,11402,19,1383170943,1383171268,7,26,325
97161736@N02,11402,29,1383171268,1383171433,2,26,165
97161736@N02,11402,31,1383171433,1383171737,5,26,304
97161736@N02,11402,20,1383171737,1383172277,5,26,540
97161736@N02,11402,22,1383172621,1383173221,4,26,600
97161736@N02,11402,30,1383174056,1383174797,13,26,741
97161736@N02,11402,11,1383174797,1383174891,7,26,94
97161736@N02,11402,10,1383174891,1383175004,2,26,113
97161736@N02,11402,11,1383175004,1383175066,2,26,62
97161736@N02,11402,7,1383175066,1383175246,2,26,180
97161736@N02,11402,6,1383175607,1383175712,2,26,105
97161736@N02,11402,5,1383175712,1383175832,2,26,120
97161736@N02,11402,12,1383176307,1383176547,7,26,240
97161736@N02,11402,15,1383177940,1383178210,11,26,270
97161736@N02,11402,26,1383179204,1383179745,8,26,541
97161736@N02,11402,1,1383179745,1383179805,2,26,60
97161736@N02,11402,28,1383184552,1383185452,4,26,900
97161736@N02,11403,26,1383342749,1383343649,2,14,900
97161736@N02,11403,22,1383344032,1383344632,3,14,600
97161736@N02,11403,14,1383344641,1383344750,2,14,109
97161736@N02,11403,22,1383344750,1383344820,2,14,70
97161736@N02,11403,31,1383344820,1383345192,3,14,372
97161736@N02,11403,23,1383345192,1383345246,2,14,54
97161736@N02,11403,30,1383345246,1383345269,2,14,23
97161736@N02,11403,23,1383345269,1383345869,2,14,600
97161736@N02,11403,19,1383346108,1383346139,2,14,31
97161736@N02,11403,18,1383346139,1383346589,2,14,450
97161736@N02,11403,19,1383346726,1383346739,2,14,13
97161736@N02,11403,29,1383346739,1383346830,2,14,91
97161736@N02,11403,18,1383346830,1383346846,3,14,16
97161736@N02,11403,19,1383346846,1383347386,4,14,540
97161736@N02,11404,29,1383381284,1383382184,2,4,900
97161736@N02,11404,22,1383383286,1383383886,2,4,600
97161736@N02,11404,16,1383387391,1383387661,2,4,270
97161736@N02,11404,29,1383390858,1383391758,12,4,900
97161736@N02,11405,26,1383440659,1383441559,4,4,900
97161736@N02,11405,1,1383468127,1383468187,2,4,60
97161736@N02,11405,17,1383470509,1383470809,2,4,300
97161736@N02,11405,23,1383470886,1383471486,1,4,600
97161736@N02,11406,18,1383525786,1383525823,2,8,37
97161736@N02,11406,23,1383525823,1383526035,5,8,212
97161736@N02,11406,26,1383526035,1383526935,2,8,900
97161736@N02,11406,16,1383527015,1383527285,4,8,270
97161736@N02,11406,28,1383527839,1383527864,2,8,25
97161736@N02,11406,1,1383527864,1383527924,9,8,60
97161736@N02,11406,12,1383542738,1383542978,2,8,240
97161736@N02,11406,20,1383546163,1383546703,4,8,540
97161736@N02,11407,28,1416780060,1416780069,2,2,9
97161736@N02,11407,1,1416780069,1416780129,1,2,60
97161736@N02,11408,26,1416821714,1416822614,2,2,900
97161736@N02,11408,21,1416824110,1416824680,1,2,570
97173103@N07,11409,23,1423032733,1423033333,1,1,600
97173103@N07,11410,13,1425683696,1425683936,1,1,240
9718370@N07,11411,17,1288411794,1288412094,12,1,300
97225209@N00,11412,28,1386380795,1386381695,2,2,900
97225209@N00,11412,29,1386389086,1386389986,1,2,900
97225209@N00,11413,18,1444385602,1444386052,1,1,450
97225209@N00,11414,18,1444478923,1444479373,1,1,450
97225209@N00,11415,18,1444541381,1444541831,1,1,450
97286705@N07,11416,1,1456464549,1456464609,4,3,60
97286705@N07,11416,29,1456475449,1456476349,6,3,900
97286705@N07,11416,14,1456479737,1456479977,10,3,240
97286705@N07,11417,26,1456555208,1456555830,3,3,622
97286705@N07,11417,23,1456555830,1456556430,3,3,600
97286705@N07,11417,14,1456557675,1456557915,6,3,240
97286705@N07,11418,1,1456605344,1456605404,2,5,60
97286705@N07,11418,17,1456608634,1456608934,3,5,300
97286705@N07,11418,3,1456609603,1456609693,13,5,90
97286705@N07,11418,13,1456609934,1456610174,4,5,240
97286705@N07,11418,26,1456611460,1456612360,3,5,900
9728779@N03,11419,24,1409908938,1409909718,1,1,780
97302400@N00,11420,3,1308398515,1308398605,2,1,90
97309002@N00,11421,4,1237348061,1237348162,1,1,101
97314397@N02,11422,16,1393114122,1393114392,2,2,270
97314397@N02,11422,27,1393114956,1393115856,1,2,900
97385633@N00,11423,30,1358469711,1358470791,1,1,1080
97405121@N08,11424,1,1337334181,1337334241,3,3,60
97405121@N08,11424,24,1337336071,1337336117,3,3,46
97405121@N08,11424,25,1337336117,1337336957,24,3,840
97405121@N08,11425,30,1385279122,1385280202,4,1,1080
97408089@N00,11426,30,1305797475,1305798555,2,1,1080
97408089@N00,11427,30,1305850050,1305851130,19,3,1080
97408089@N00,11427,3,1305877900,1305877990,3,3,90
97408089@N00,11427,30,1305879864,1305880944,9,3,1080
9744114@N08,11428,18,1218597675,1218598125,1,1,450
9744114@N08,11429,14,1315081828,1315082068,2,6,240
9744114@N08,11429,28,1315083290,1315083347,2,6,57
9744114@N08,11429,16,1315083347,1315083541,2,6,194
9744114@N08,11429,7,1315083541,1315083558,2,6,17
9744114@N08,11429,6,1315083558,1315083678,3,6,120
9744114@N08,11429,13,1315084107,1315084347,1,6,240
9744114@N08,11430,13,1377836141,1377836381,2,4,240
9744114@N08,11430,18,1377841861,1377842311,2,4,450
9744114@N08,11430,26,1377855448,1377856348,4,4,900
9744114@N08,11430,25,1377859667,1377860507,1,4,840
9744114@N08,11431,13,1400854614,1400854854,3,4,240
9744114@N08,11431,25,1400855358,1400856198,5,4,840
9744114@N08,11431,1,1400860157,1400860217,3,4,60
9744114@N08,11431,28,1400860372,1400861272,2,4,900
9744114@N08,11432,21,1429878995,1429879565,2,1,570
9744114@N08,11433,21,1431066886,1431067456,2,2,570
9744114@N08,11433,7,1431067914,1431068094,2,2,180
9744114@N08,11434,29,1433718238,1433719138,2,3,900
9744114@N08,11434,14,1433725543,1433725783,9,3,240
9744114@N08,11434,13,1433732096,1433732336,1,3,240
9744114@N08,11435,25,1443951579,1443952012,6,2,433
9744114@N08,11435,21,1443952012,1443952582,5,2,570
9744114@N08,11436,14,1449354862,1449355102,1,1,240
97460734@N07,11437,1,1366940113,1366940173,6,1,60
97460734@N07,11438,1,1384046780,1384046840,13,1,60
97463056@N00,11439,1,1380425349,1380425409,1,1,60
97463056@N00,11440,15,1381038142,1381038412,2,1,270
97472023@N04,11441,28,1462152833,1462153733,1,1,900
97527209@N00,11442,17,1389939806,1389940106,2,3,300
97527209@N00,11442,21,1389947476,1389948046,3,3,570
97527209@N00,11442,27,1389949735,1389950635,1,3,900
97527209@N00,11443,13,1390006053,1390006293,3,2,240
97527209@N00,11443,7,1390012468,1390012648,1,2,180
97527209@N00,11444,17,1390198902,1390199202,1,1,300
97527209@N00,11445,3,1390801146,1390801236,1,1,90
97527209@N00,11446,29,1392168591,1392169491,1,1,900
9753074@N04,11447,1,1289782315,1289782375,2,5,60
9753074@N04,11447,29,1289786881,1289787781,2,5,900
9753074@N04,11447,18,1289790828,1289791278,4,5,450
9753074@N04,11447,14,1289792351,1289792591,2,5,240
9753074@N04,11447,3,1289795467,1289795557,1,5,90
97623972@N06,11448,17,1388919756,1388920056,2,2,300
97623972@N06,11448,26,1388922594,1388923494,2,2,900
97623972@N06,11449,26,1438436183,1438437083,1,1,900
9762956@N03,11450,19,1419743068,1419743608,2,1,540
97632346@N06,11451,12,1191545315,1191545555,2,6,240
97632346@N06,11451,4,1191553424,1191553525,3,6,101
97632346@N06,11451,31,1191554754,1191556254,2,6,1500
97632346@N06,11451,16,1191569027,1191569068,2,6,41
97632346@N06,11451,12,1191569068,1191569308,2,6,240
97632346@N06,11451,1,1191572059,1191572119,1,6,60
97632346@N06,11452,16,1235796895,1235797165,2,4,270
97632346@N06,11452,30,1235811297,1235812377,3,4,1080
97632346@N06,11452,20,1235812508,1235813048,2,4,540
97632346@N06,11452,7,1235818466,1235818646,1,4,180
97632346@N06,11453,5,1285111874,1285111994,2,10,120
97632346@N06,11453,12,1285113212,1285113452,8,10,240
97632346@N06,11453,24,1285114702,1285115475,3,10,773
97632346@N06,11453,17,1285115475,1285115775,2,10,300
97632346@N06,11453,20,1285121554,1285122028,2,10,474
97632346@N06,11453,14,1285122028,1285122268,3,10,240
97632346@N06,11453,24,1285128600,1285129380,2,10,780
97632346@N06,11453,16,1285133894,1285134164,2,10,270
97632346@N06,11453,26,1285145147,1285145494,3,10,347
97632346@N06,11453,16,1285145494,1285145764,1,10,270
97632346@N06,11454,25,1309431023,1309431863,1,1,840
97632346@N06,11455,30,1363853286,1363854366,2,2,1080
97632346@N06,11455,16,1363862306,1363862576,1,2,270
97634415@N00,11456,26,1260272253,1260273153,2,1,900
97651774@N07,11457,5,1357535183,1357535303,2,1,120
97653878@N07,11458,19,1407044684,1407045224,2,8,540
97653878@N07,11458,26,1407045612,1407046512,2,8,900
97653878@N07,11458,29,1407046635,1407047535,3,8,900
97653878@N07,11458,22,1407049536,1407050136,2,8,600
97653878@N07,11458,16,1407065194,1407065262,2,8,68
97653878@N07,11458,26,1407065262,1407065880,2,8,618
97653878@N07,11458,16,1407065880,1407066106,5,8,226
97653878@N07,11458,26,1407066106,1407067006,1,8,900
97653878@N07,11459,19,1407145188,1407145728,2,1,540
97653878@N07,11460,24,1407314823,1407315603,1,1,780
97653878@N07,11461,1,1438222108,1438222168,3,13,60
97653878@N07,11461,28,1438222285,1438223185,3,13,900
97653878@N07,11461,18,1438224810,1438225260,2,13,450
97653878@N07,11461,29,1438225909,1438226809,3,13,900
97653878@N07,11461,1,1438226950,1438227010,2,13,60
97653878@N07,11461,24,1438230035,1438230815,7,13,780
97653878@N07,11461,26,1438232443,1438233343,4,13,900
97653878@N07,11461,21,1438237421,1438237991,27,13,570
97653878@N07,11461,26,1438247749,1438248649,2,13,900
97653878@N07,11461,18,1438254362,1438254812,19,13,450
97653878@N07,11461,1,1438255991,1438256051,6,13,60
97653878@N07,11461,28,1438256096,1438256102,3,13,6
97653878@N07,11461,1,1438256102,1438256162,27,13,60
97665178@N02,11462,1,1368066912,1368066972,3,1,60
97665178@N02,11463,1,1370571245,1370571305,1,1,60
97665178@N02,11464,1,1372215924,1372215984,6,1,60
97665178@N02,11465,1,1375861125,1375861185,1,1,60
9766803@N05,11466,18,1432698589,1432699039,1,1,450
9766803@N05,11467,18,1440704150,1440704600,2,1,450
97747865@N00,11468,16,1256965598,1256965868,2,4,270
97747865@N00,11468,26,1256968532,1256969432,4,4,900
97747865@N00,11468,3,1256972523,1256972613,2,4,90
97747865@N00,11468,16,1256972941,1256973211,1,4,270
97748032@N04,11469,19,1404717274,1404717814,1,1,540
97761705@N00,11470,6,1366250701,1366250821,1,1,120
97761705@N00,11471,6,1366280980,1366281100,1,1,120
97761705@N00,11472,6,1366417813,1366417933,1,1,120
97761705@N00,11473,3,1395298103,1395298193,2,2,90
97761705@N00,11473,6,1395308647,1395308767,1,2,120
97798599@N00,11474,28,1329714687,1329715587,2,1,900
9785054@N05,11475,27,1438823543,1438824443,2,2,900
9785054@N05,11475,26,1438845055,1438845955,1,2,900
97862183@N05,11476,17,1372686430,1372686730,1,1,300
97864553@N00,11477,28,1369701854,1369702754,1,1,900
97898435@N00,11478,29,1212195295,1212196195,2,4,900
97898435@N00,11478,26,1212215361,1212216261,3,4,900
97898435@N00,11478,20,1212219363,1212219903,2,4,540
97898435@N00,11478,29,1212227427,1212228327,2,4,900
97898435@N00,11479,17,1212276553,1212276853,3,6,300
97898435@N00,11479,26,1212288569,1212289420,2,6,851
97898435@N00,11479,9,1212289420,1212289600,4,6,180
97898435@N00,11479,28,1212293091,1212293991,2,6,900
97898435@N00,11479,17,1212294903,1212295203,3,6,300
97898435@N00,11479,28,1212309592,1212310492,2,6,900
97898435@N00,11480,17,1323211306,1323211606,2,3,300
97898435@N00,11480,14,1323225265,1323225505,2,3,240
97898435@N00,11480,28,1323226080,1323226980,1,3,900
97898435@N00,11481,8,1323422112,1323422137,2,2,25
97898435@N00,11481,21,1323422137,1323422707,1,2,570
97907761@N00,11482,7,1361679100,1361679280,1,1,180
97948161@N05,11483,29,1238334531,1238335431,2,1,900
97987383@N02,11484,1,1394835761,1394835821,2,1,60
98054093@N00,11485,14,1291073759,1291073999,2,7,240
98054093@N00,11485,29,1291077276,1291078176,2,7,900
98054093@N00,11485,20,1291079191,1291079731,2,7,540
98054093@N00,11485,24,1291082530,1291083310,2,7,780
98054093@N00,11485,25,1291087584,1291088424,2,7,840
98054093@N00,11485,18,1291099046,1291099496,2,7,450
98054093@N00,11485,26,1291100078,1291100978,1,7,900
98071415@N05,11486,1,1372485718,1372485778,1,1,60
98071415@N05,11487,1,1373260637,1373260697,1,1,60
98071415@N05,11488,1,1373533306,1373533366,2,1,60
98071415@N05,11489,7,1374017931,1374018111,2,3,180
98071415@N05,11489,28,1374018695,1374019595,2,3,900
98071415@N05,11489,1,1374020306,1374020366,1,3,60
98071415@N05,11490,1,1379738189,1379738249,1,1,60
98071415@N05,11491,1,1380109868,1380109928,1,1,60
98071415@N05,11492,1,1380164383,1380164443,1,1,60
98071415@N05,11493,26,1380284136,1380285036,1,1,900
98071415@N05,11494,28,1380315025,1380315925,1,1,900
98071415@N05,11495,1,1380360085,1380360145,2,1,60
98071415@N05,11496,1,1380703191,1380703251,1,1,60
98071415@N05,11497,1,1384598111,1384598171,1,1,60
98071415@N05,11498,1,1384978273,1384978333,1,1,60
98071415@N05,11499,1,1385460726,1385460786,1,1,60
98071415@N05,11500,1,1388795220,1388795280,1,1,60
98071415@N05,11501,1,1388877525,1388877585,1,1,60
98111413@N05,11502,15,1470992268,1470992538,1,1,270
98148330@N06,11503,16,1331255017,1331255287,2,1,270
98148330@N06,11504,16,1338956379,1338956649,2,1,270
98182088@N03,11505,23,1430097299,1430097899,2,4,600
98182088@N03,11505,26,1430101070,1430101970,3,4,900
98182088@N03,11505,12,1430117468,1430117708,2,4,240
98182088@N03,11505,15,1430131852,1430132122,1,4,270
98201633@N03,11506,26,1290041220,1290042120,4,1,900
98201633@N03,11507,26,1290113749,1290114649,5,1,900
9820882@N06,11508,19,1411900729,1411901269,2,2,540
9820882@N06,11508,30,1411907058,1411908138,1,2,1080
9821843@N08,11509,27,1215140201,1215141101,1,1,900
9821843@N08,11510,27,1215226493,1215227393,2,1,900
9821843@N08,11511,4,1220078672,1220078773,1,1,101
9821843@N08,11512,18,1220191147,1220191597,1,1,450
9821843@N08,11513,27,1252111826,1252112726,2,1,900
9821843@N08,11514,27,1278041789,1278042689,4,1,900
9821843@N08,11515,27,1278196698,1278197598,2,1,900
98235322@N00,11516,25,1353448636,1353449476,1,1,840
98235322@N00,11517,13,1353532790,1353533030,1,1,240
98255736@N00,11518,13,1338707078,1338707318,1,1,240
98274023@N00,11519,11,1193350026,1193350266,2,2,240
98274023@N00,11519,16,1193354150,1193354420,1,2,270
98274023@N00,11520,20,1228991650,1228992190,1,1,540
98274023@N00,11521,29,1243234887,1243235787,1,1,900
98274023@N00,11522,10,1244539903,1244540143,1,1,240
98274023@N00,11523,20,1253871240,1253871780,1,1,540
98274023@N00,11524,14,1256294343,1256294583,1,1,240
98274023@N00,11525,28,1314095517,1314096417,1,1,900
98278862@N00,11526,28,1362891408,1362892308,2,3,900
98278862@N00,11526,25,1362893154,1362893994,2,3,840
98278862@N00,11526,15,1362896189,1362896459,1,3,270
98278862@N00,11527,28,1372735325,1372736225,1,1,900
98278862@N00,11528,28,1380446606,1380447506,1,1,900
98278862@N00,11529,7,1382508776,1382508956,2,2,180
98278862@N00,11529,20,1382510095,1382510635,1,2,540
98278862@N00,11530,13,1412492627,1412492867,1,1,240
98278862@N00,11531,19,1417341522,1417342062,1,1,540
98278862@N00,11532,28,1421649631,1421650531,1,1,900
98278862@N00,11533,18,1434264754,1434265204,1,1,450
9829137@N04,11534,26,1233266577,1233267477,2,1,900
9829137@N04,11535,26,1233298794,1233299694,5,1,900
98308974@N02,11536,14,1369362275,1369362515,2,4,240
98308974@N02,11536,26,1369368095,1369368995,7,4,900
98308974@N02,11536,16,1369371909,1369372179,2,4,270
98308974@N02,11536,28,1369379342,1369380242,8,4,900
98308974@N02,11537,14,1375338881,1375339121,15,1,240
98308974@N02,11538,1,1375483038,1375483098,19,13,60
98308974@N02,11538,28,1375483240,1375483427,2,13,187
98308974@N02,11538,26,1375483427,1375484013,5,13,586
98308974@N02,11538,25,1375484013,1375484853,16,13,840
98308974@N02,11538,16,1375489082,1375489352,24,13,270
98308974@N02,11538,27,1375489487,1375489491,2,13,4
98308974@N02,11538,16,1375489491,1375489761,4,13,270
98308974@N02,11538,26,1375490915,1375491078,3,13,163
98308974@N02,11538,28,1375491078,1375491949,7,13,871
98308974@N02,11538,26,1375491949,1375492849,35,13,900
98308974@N02,11538,8,1375495674,1375495854,5,13,180
98308974@N02,11538,25,1375497818,1375498658,19,13,840
98308974@N02,11538,15,1375523844,1375524114,1,13,270
98308974@N02,11539,16,1375741555,1375741571,2,8,16
98308974@N02,11539,27,1375741571,1375742412,7,8,841
98308974@N02,11539,17,1375742412,1375742712,9,8,300
98308974@N02,11539,22,1375743939,1375744539,19,8,600
98308974@N02,11539,30,1375748033,1375749113,6,8,1080
98308974@N02,11539,26,1375751205,1375752105,15,8,900
98308974@N02,11539,7,1375756272,1375756316,5,8,44
98308974@N02,11539,5,1375756316,1375756436,3,8,120
98321034@N06,11540,1,1375057596,1375057656,1,1,60
98323495@N00,11541,18,1433830143,1433830593,1,1,450
98343724@N06,11542,28,1383288732,1383289632,1,1,900
98352952@N02,11543,1,1403766452,1403766512,4,8,60
98352952@N02,11543,26,1403767330,1403768230,2,8,900
98352952@N02,11543,15,1403772992,1403773262,4,8,270
98352952@N02,11543,28,1403786239,1403787139,2,8,900
98352952@N02,11543,26,1403788616,1403788722,4,8,106
98352952@N02,11543,6,1403788722,1403788735,2,8,13
98352952@N02,11543,8,1403788735,1403788915,2,8,180
98352952@N02,11543,26,1403790748,1403791648,1,8,900
98367299@N00,11544,29,1218349961,1218350861,1,1,900
98367299@N00,11545,29,1304565589,1304566489,1,1,900
98419063@N00,11546,18,1438261129,1438261579,3,1,450
98453848@N00,11547,29,1453530305,1453531205,1,1,900
98538941@N00,11548,28,1318291883,1318292054,2,10,171
98538941@N00,11548,26,1318292054,1318292719,5,10,665
98538941@N00,11548,23,1318292719,1318293026,15,10,307
98538941@N00,11548,30,1318293026,1318294106,7,10,1080
98538941@N00,11548,20,1318294401,1318294941,8,10,540
98538941@N00,11548,31,1318295078,1318296578,6,10,1500
98538941@N00,11548,30,1318298461,1318299541,25,10,1080
98538941@N00,11548,27,1318300666,1318301566,12,10,900
98538941@N00,11548,10,1318305769,1318306009,8,10,240
98538941@N00,11548,18,1318310014,1318310464,49,10,450
98552680@N07,11549,1,1424738027,1424738087,2,14,60
98552680@N07,11549,28,1424738253,1424739153,5,14,900
98552680@N07,11549,16,1424740581,1424740851,3,14,270
98552680@N07,11549,27,1424741867,1424742767,2,14,900
98552680@N07,11549,24,1424746114,1424746894,2,14,780
98552680@N07,11549,25,1424748286,1424748820,5,14,534
98552680@N07,11549,13,1424748820,1424749060,3,14,240
98552680@N07,11549,5,1424752455,1424752575,2,14,120
98552680@N07,11549,7,1424753386,1424753566,2,14,180
98552680@N07,11549,4,1424753744,1424753845,3,14,101
98552680@N07,11549,29,1424755070,1424755970,3,14,900
98552680@N07,11549,18,1424760385,1424760835,2,14,450
98552680@N07,11549,26,1424765506,1424765635,2,14,129
98552680@N07,11549,18,1424765635,1424766085,1,14,450
98583319@N04,11550,18,1389152603,1389153053,1,1,450
98583319@N04,11551,1,1389524772,1389524832,1,1,60
98583319@N04,11552,29,1391593629,1391594529,1,1,900
9858951@N03,11553,23,1205457167,1205457767,1,1,600
9858951@N03,11554,1,1208762706,1208762706,2,2,0
9858951@N03,11554,26,1208762706,1208763606,14,2,900
9858951@N03,11555,28,1209009580,1209009923,2,3,343
9858951@N03,11555,19,1209009923,1209010463,2,3,540
9858951@N03,11555,31,1209010825,1209012325,1,3,1500
9858951@N03,11556,12,1209418048,1209418288,2,4,240
9858951@N03,11556,8,1209418458,1209418462,2,4,4
9858951@N03,11556,6,1209418462,1209418465,2,4,3
9858951@N03,11556,31,1209418465,1209419965,1,4,1500
9858951@N03,11557,25,1209493293,1209493314,6,4,21
9858951@N03,11557,28,1209493314,1209493336,2,4,22
9858951@N03,11557,18,1209493336,1209493786,2,4,450
9858951@N03,11557,4,1209494610,1209494711,1,4,101
9858951@N03,11558,24,1211605836,1211606616,6,2,780
9858951@N03,11558,29,1211609425,1211610325,4,2,900
9858951@N03,11559,16,1211702761,1211702765,2,38,4
9858951@N03,11559,1,1211702765,1211702825,11,38,60
9858951@N03,11559,28,1211710936,1211711836,18,38,900
9858951@N03,11559,26,1211711984,1211712034,3,38,50
9858951@N03,11559,5,1211712034,1211712154,15,38,120
9858951@N03,11559,4,1211714672,1211714773,2,38,101
9858951@N03,11559,5,1211718653,1211718773,3,38,120
9858951@N03,11559,24,1211718866,1211719646,95,38,780
9858951@N03,11559,15,1211726651,1211726651,2,38,0
9858951@N03,11559,17,1211726651,1211726655,2,38,4
9858951@N03,11559,15,1211726655,1211726655,2,38,0
9858951@N03,11559,17,1211726655,1211726672,2,38,17
9858951@N03,11559,15,1211726672,1211726672,2,38,0
9858951@N03,11559,17,1211726672,1211726673,2,38,1
9858951@N03,11559,15,1211726673,1211726673,2,38,0
9858951@N03,11559,17,1211726673,1211726688,2,38,15
9858951@N03,11559,15,1211726688,1211726688,2,38,0
9858951@N03,11559,17,1211726688,1211726689,2,38,1
9858951@N03,11559,15,1211726689,1211726689,2,38,0
9858951@N03,11559,17,1211726689,1211726691,2,38,2
9858951@N03,11559,15,1211726691,1211726691,2,38,0
9858951@N03,11559,17,1211726691,1211726702,2,38,11
9858951@N03,11559,27,1211726702,1211726794,17,38,92
9858951@N03,11559,16,1211726794,1211726915,17,38,121
9858951@N03,11559,27,1211726915,1211726952,5,38,37
9858951@N03,11559,16,1211726952,1211726960,3,38,8
9858951@N03,11559,27,1211726960,1211726988,16,38,28
9858951@N03,11559,16,1211726988,1211726990,3,38,2
9858951@N03,11559,27,1211726990,1211726991,2,38,1
9858951@N03,11559,16,1211726991,1211727003,9,38,12
9858951@N03,11559,27,1211727003,1211727004,4,38,1
9858951@N03,11559,16,1211727004,1211727197,8,38,193
9858951@N03,11559,28,1211727197,1211728097,63,38,900
9858951@N03,11559,1,1211728656,1211728673,4,38,17
9858951@N03,11559,28,1211728673,1211728683,2,38,10
9858951@N03,11559,1,1211728683,1211728719,5,38,36
9858951@N03,11559,28,1211728719,1211729137,8,38,418
9858951@N03,11559,1,1211729137,1211729197,1,38,60
9858951@N03,11560,1,1211771017,1211771077,2,14,60
9858951@N03,11560,18,1211778901,1211779351,15,14,450
9858951@N03,11560,19,1211779440,1211779980,8,14,540
9858951@N03,11560,18,1211780627,1211781077,6,14,450
9858951@N03,11560,16,1211781944,1211782214,3,14,270
9858951@N03,11560,28,1211782291,1211782523,3,14,232
9858951@N03,11560,1,1211782523,1211782583,7,14,60
9858951@N03,11560,21,1211804694,1211804776,9,14,82
9858951@N03,11560,3,1211804776,1211804813,7,14,37
9858951@N03,11560,26,1211804813,1211804871,2,14,58
9858951@N03,11560,3,1211804871,1211804961,2,14,90
9858951@N03,11560,26,1211805180,1211806080,6,14,900
9858951@N03,11560,1,1211807573,1211807633,17,14,60
9858951@N03,11560,23,1211834792,1211835392,62,14,600
9858951@N03,11561,1,1211945400,1211945460,2,1,60
9858951@N03,11562,28,1212503014,1212503030,2,34,16
9858951@N03,11562,19,1212503030,1212503049,2,34,19
9858951@N03,11562,1,1212503049,1212503072,2,34,23
9858951@N03,11562,18,1212503072,1212503145,2,34,73
9858951@N03,11562,28,1212503145,1212503151,2,34,6
9858951@N03,11562,1,1212503151,1212503197,4,34,46
9858951@N03,11562,28,1212503197,1212503542,40,34,345
9858951@N03,11562,16,1212503542,1212503546,3,34,4
9858951@N03,11562,27,1212503546,1212503551,5,34,5
9858951@N03,11562,16,1212503551,1212503551,2,34,0
9858951@N03,11562,27,1212503551,1212503552,2,34,1
9858951@N03,11562,16,1212503552,1212503553,2,34,1
9858951@N03,11562,27,1212503553,1212503559,6,34,6
9858951@N03,11562,16,1212503559,1212503564,5,34,5
9858951@N03,11562,27,1212503564,1212503566,4,34,2
9858951@N03,11562,15,1212503566,1212503567,2,34,1
9858951@N03,11562,17,1212503567,1212503568,2,34,1
9858951@N03,11562,15,1212503568,1212503569,2,34,1
9858951@N03,11562,24,1212503569,1212503591,19,34,22
9858951@N03,11562,3,1212503591,1212503592,2,34,1
9858951@N03,11562,5,1212503592,1212503598,2,34,6
9858951@N03,11562,28,1212503598,1212503612,9,34,14
9858951@N03,11562,1,1212503612,1212503672,5,34,60
9858951@N03,11562,26,1212534812,1212535712,4,34,900
9858951@N03,11562,7,1212536352,1212536532,38,34,180
9858951@N03,11562,4,1212537140,1212537241,5,34,101
9858951@N03,11562,21,1212537487,1212538057,2,34,570
9858951@N03,11562,3,1212539271,1212539361,34,34,90
9858951@N03,11562,12,1212540921,1212541161,11,34,240
9858951@N03,11562,16,1212543832,1212544102,8,34,270
9858951@N03,11562,28,1212546125,1212546337,11,34,212
9858951@N03,11562,1,1212546337,1212546397,13,34,60
9858951@N03,11562,28,1212547766,1212548666,12,34,900
9858951@N03,11562,1,1212552355,1212552415,2,34,60
9858951@N03,11563,28,1212806974,1212807874,4,11,900
9858951@N03,11563,1,1212812731,1212812748,4,11,17
9858951@N03,11563,28,1212812748,1212812750,2,11,2
9858951@N03,11563,1,1212812750,1212812752,3,11,2
9858951@N03,11563,28,1212812752,1212812756,2,11,4
9858951@N03,11563,1,1212812756,1212812816,26,11,60
9858951@N03,11563,28,1212821556,1212821558,2,11,2
9858951@N03,11563,1,1212821558,1212821558,2,11,0
9858951@N03,11563,28,1212821558,1212821559,2,11,1
9858951@N03,11563,1,1212821559,1212821559,2,11,0
9858951@N03,11563,28,1212821559,1212822459,1,11,900
9858951@N03,11564,28,1212929525,1212930425,65,66,900
9858951@N03,11564,19,1212932534,1212932558,4,66,24
9858951@N03,11564,23,1212932558,1212932560,2,66,2
9858951@N03,11564,19,1212932560,1212932560,2,66,0
9858951@N03,11564,23,1212932560,1212932562,2,66,2
9858951@N03,11564,19,1212932562,1212932562,2,66,0
9858951@N03,11564,23,1212932562,1212932567,2,66,5
9858951@N03,11564,19,1212932567,1212932567,2,66,0
9858951@N03,11564,23,1212932567,1212932569,2,66,2
9858951@N03,11564,19,1212932569,1212932569,2,66,0
9858951@N03,11564,23,1212932569,1212932571,2,66,2
9858951@N03,11564,19,1212932571,1212932571,2,66,0
9858951@N03,11564,23,1212932571,1212932631,2,66,60
9858951@N03,11564,19,1212932631,1212932631,2,66,0
9858951@N03,11564,23,1212932631,1212932633,2,66,2
9858951@N03,11564,19,1212932633,1212932633,2,66,0
9858951@N03,11564,23,1212932633,1212932634,2,66,1
9858951@N03,11564,19,1212932634,1212932634,2,66,0
9858951@N03,11564,23,1212932634,1212932643,2,66,9
9858951@N03,11564,19,1212932643,1212932643,2,66,0
9858951@N03,11564,23,1212932643,1212932645,2,66,2
9858951@N03,11564,19,1212932645,1212932645,2,66,0
9858951@N03,11564,23,1212932645,1212932647,2,66,2
9858951@N03,11564,19,1212932647,1212932647,2,66,0
9858951@N03,11564,23,1212932647,1212932705,2,66,58
9858951@N03,11564,19,1212932705,1212932705,2,66,0
9858951@N03,11564,23,1212932705,1212932707,2,66,2
9858951@N03,11564,19,1212932707,1212932707,2,66,0
9858951@N03,11564,23,1212932707,1212932709,2,66,2
9858951@N03,11564,19,1212932709,1212932709,2,66,0
9858951@N03,11564,23,1212932709,1212932840,2,66,131
9858951@N03,11564,19,1212932840,1212932840,2,66,0
9858951@N03,11564,23,1212932840,1212932842,2,66,2
9858951@N03,11564,19,1212932842,1212932842,2,66,0
9858951@N03,11564,23,1212932842,1212932844,2,66,2
9858951@N03,11564,19,1212932844,1212932844,2,66,0
9858951@N03,11564,23,1212932844,1212932889,2,66,45
9858951@N03,11564,19,1212932889,1212932889,2,66,0
9858951@N03,11564,23,1212932889,1212932891,2,66,2
9858951@N03,11564,19,1212932891,1212932891,2,66,0
9858951@N03,11564,23,1212932891,1212932910,2,66,19
9858951@N03,11564,19,1212932910,1212932910,2,66,0
9858951@N03,11564,23,1212932910,1212932913,2,66,3
9858951@N03,11564,19,1212932913,1212932915,3,66,2
9858951@N03,11564,23,1212932915,1212932917,2,66,2
9858951@N03,11564,19,1212932917,1212932917,2,66,0
9858951@N03,11564,23,1212932917,1212932952,2,66,35
9858951@N03,11564,19,1212932952,1212932952,2,66,0
9858951@N03,11564,23,1212932952,1212932953,2,66,1
9858951@N03,11564,19,1212932953,1212932953,2,66,0
9858951@N03,11564,23,1212932953,1212932954,2,66,1
9858951@N03,11564,19,1212932954,1212932954,2,66,0
9858951@N03,11564,23,1212932954,1212932988,2,66,34
9858951@N03,11564,19,1212932988,1212932992,4,66,4
9858951@N03,11564,23,1212932992,1212933039,4,66,47
9858951@N03,11564,19,1212933039,1212933042,4,66,3
9858951@N03,11564,23,1212933042,1212933090,2,66,48
9858951@N03,11564,19,1212933090,1212933090,2,66,0
9858951@N03,11564,23,1212933090,1212933091,2,66,1
9858951@N03,11564,19,1212933091,1212933631,57,66,540
9858951@N03,11564,29,1212934014,1212934914,39,66,900
9858951@N03,11564,18,1212935666,1212936017,35,66,351
9858951@N03,11564,28,1212936017,1212936917,139,66,900
9858951@N03,11564,1,1212937550,1212937601,9,66,51
9858951@N03,11564,28,1212937601,1212937615,5,66,14
9858951@N03,11564,1,1212937615,1212937675,19,66,60
9858951@N03,11565,28,1212979096,1212979996,14,2,900
9858951@N03,11565,23,1213006685,1213007285,2,2,600
9858951@N03,11566,26,1213380224,1213380225,2,12,1
9858951@N03,11566,21,1213380225,1213380795,4,12,570
9858951@N03,11566,18,1213402924,1213403374,40,12,450
9858951@N03,11566,23,1213405029,1213405279,4,12,250
9858951@N03,11566,19,1213405279,1213405803,3,12,524
9858951@N03,11566,18,1213405803,1213405805,3,12,2
9858951@N03,11566,23,1213405805,1213405806,2,12,1
9858951@N03,11566,18,1213405806,1213406255,3,12,449
9858951@N03,11566,23,1213406255,1213406793,3,12,538
9858951@N03,11566,19,1213406793,1213407333,41,12,540
9858951@N03,11566,10,1213408037,1213408277,2,12,240
9858951@N03,11566,19,1213409890,1213410430,6,12,540
9858951@N03,11567,19,1213567663,1213568203,1,1,540
9858951@N03,11568,19,1213870752,1213871292,1,1,540
9858951@N03,11569,13,1214228160,1214228185,3,2,25
9858951@N03,11569,24,1214228185,1214228965,5,2,780
9858951@N03,11570,19,1214380411,1214380951,4,1,540
9858951@N03,11571,19,1214478953,1214479493,2,1,540
9858951@N03,11572,13,1214553449,1214553689,2,2,240
9858951@N03,11572,15,1214554068,1214554338,1,2,270
9858951@N03,11573,28,1214606371,1214607271,11,529,900
9858951@N03,11573,13,1214608716,1214608956,46,529,240
9858951@N03,11573,28,1214609693,1214609700,2,529,7
9858951@N03,11573,13,1214609700,1214609700,2,529,0
9858951@N03,11573,28,1214609700,1214609702,2,529,2
9858951@N03,11573,13,1214609702,1214609702,2,529,0
9858951@N03,11573,28,1214609702,1214609703,2,529,1
9858951@N03,11573,13,1214609703,1214609703,2,529,0
9858951@N03,11573,28,1214609703,1214609704,2,529,1
9858951@N03,11573,13,1214609704,1214609704,2,529,0
9858951@N03,11573,28,1214609704,1214609705,2,529,1
9858951@N03,11573,13,1214609705,1214609705,2,529,0
9858951@N03,11573,28,1214609705,1214609722,2,529,17
9858951@N03,11573,13,1214609722,1214609722,2,529,0
9858951@N03,11573,28,1214609722,1214609724,2,529,2
9858951@N03,11573,13,1214609724,1214609724,2,529,0
9858951@N03,11573,28,1214609724,1214609725,2,529,1
9858951@N03,11573,13,1214609725,1214609725,2,529,0
9858951@N03,11573,28,1214609725,1214609727,2,529,2
9858951@N03,11573,13,1214609727,1214609727,2,529,0
9858951@N03,11573,28,1214609727,1214609730,2,529,3
9858951@N03,11573,13,1214609730,1214609730,2,529,0
9858951@N03,11573,28,1214609730,1214609735,2,529,5
9858951@N03,11573,13,1214609735,1214609735,2,529,0
9858951@N03,11573,28,1214609735,1214609736,2,529,1
9858951@N03,11573,13,1214609736,1214609736,2,529,0
9858951@N03,11573,28,1214609736,1214609742,2,529,6
9858951@N03,11573,13,1214609742,1214609742,2,529,0
9858951@N03,11573,28,1214609742,1214609743,2,529,1
9858951@N03,11573,13,1214609743,1214609743,2,529,0
9858951@N03,11573,28,1214609743,1214609746,2,529,3
9858951@N03,11573,13,1214609746,1214609746,2,529,0
9858951@N03,11573,28,1214609746,1214609761,2,529,15
9858951@N03,11573,13,1214609761,1214609761,2,529,0
9858951@N03,11573,28,1214609761,1214609762,2,529,1
9858951@N03,11573,13,1214609762,1214609762,2,529,0
9858951@N03,11573,28,1214609762,1214609764,2,529,2
9858951@N03,11573,13,1214609764,1214609764,2,529,0
9858951@N03,11573,28,1214609764,1214609765,2,529,1
9858951@N03,11573,13,1214609765,1214609765,2,529,0
9858951@N03,11573,28,1214609765,1214609786,2,529,21
9858951@N03,11573,13,1214609786,1214609786,2,529,0
9858951@N03,11573,28,1214609786,1214609788,2,529,2
9858951@N03,11573,13,1214609788,1214609788,2,529,0
9858951@N03,11573,28,1214609788,1214609790,2,529,2
9858951@N03,11573,13,1214609790,1214609790,2,529,0
9858951@N03,11573,28,1214609790,1214609791,2,529,1
9858951@N03,11573,13,1214609791,1214609791,2,529,0
9858951@N03,11573,28,1214609791,1214609850,2,529,59
9858951@N03,11573,13,1214609850,1214609850,2,529,0
9858951@N03,11573,28,1214609850,1214609858,2,529,8
9858951@N03,11573,13,1214609858,1214609858,2,529,0
9858951@N03,11573,28,1214609858,1214609933,2,529,75
9858951@N03,11573,13,1214609933,1214609933,2,529,0
9858951@N03,11573,28,1214609933,1214609935,2,529,2
9858951@N03,11573,13,1214609935,1214609935,2,529,0
9858951@N03,11573,28,1214609935,1214609936,2,529,1
9858951@N03,11573,13,1214609936,1214609936,2,529,0
9858951@N03,11573,28,1214609936,1214609938,2,529,2
9858951@N03,11573,13,1214609938,1214609938,2,529,0
9858951@N03,11573,28,1214609938,1214609953,2,529,15
9858951@N03,11573,13,1214609953,1214609953,2,529,0
9858951@N03,11573,28,1214609953,1214609955,2,529,2
9858951@N03,11573,13,1214609955,1214609955,2,529,0
9858951@N03,11573,28,1214609955,1214609957,2,529,2
9858951@N03,11573,13,1214609957,1214609957,2,529,0
9858951@N03,11573,28,1214609957,1214609958,2,529,1
9858951@N03,11573,13,1214609958,1214609958,2,529,0
9858951@N03,11573,28,1214609958,1214609996,2,529,38
9858951@N03,11573,13,1214609996,1214609996,2,529,0
9858951@N03,11573,28,1214609996,1214609998,2,529,2
9858951@N03,11573,13,1214609998,1214609998,2,529,0
9858951@N03,11573,28,1214609998,1214609999,2,529,1
9858951@N03,11573,13,1214609999,1214609999,2,529,0
9858951@N03,11573,28,1214609999,1214610001,2,529,2
9858951@N03,11573,13,1214610001,1214610001,2,529,0
9858951@N03,11573,28,1214610001,1214610095,2,529,94
9858951@N03,11573,13,1214610095,1214610095,2,529,0
9858951@N03,11573,28,1214610095,1214610096,2,529,1
9858951@N03,11573,13,1214610096,1214610096,2,529,0
9858951@N03,11573,28,1214610096,1214610098,2,529,2
9858951@N03,11573,13,1214610098,1214610098,2,529,0
9858951@N03,11573,28,1214610098,1214610108,2,529,10
9858951@N03,11573,13,1214610108,1214610108,2,529,0
9858951@N03,11573,28,1214610108,1214610110,2,529,2
9858951@N03,11573,13,1214610110,1214610110,2,529,0
9858951@N03,11573,28,1214610110,1214610241,2,529,131
9858951@N03,11573,13,1214610241,1214610241,2,529,0
9858951@N03,11573,28,1214610241,1214610243,2,529,2
9858951@N03,11573,13,1214610243,1214610243,2,529,0
9858951@N03,11573,28,1214610243,1214610244,2,529,1
9858951@N03,11573,13,1214610244,1214610244,2,529,0
9858951@N03,11573,28,1214610244,1214610246,2,529,2
9858951@N03,11573,13,1214610246,1214610246,2,529,0
9858951@N03,11573,28,1214610246,1214610248,2,529,2
9858951@N03,11573,13,1214610248,1214610248,2,529,0
9858951@N03,11573,28,1214610248,1214610253,2,529,5
9858951@N03,11573,13,1214610253,1214610253,2,529,0
9858951@N03,11573,28,1214610253,1214610255,2,529,2
9858951@N03,11573,13,1214610255,1214610255,3,529,0
9858951@N03,11573,28,1214610255,1214610257,2,529,2
9858951@N03,11573,13,1214610257,1214610257,2,529,0
9858951@N03,11573,28,1214610257,1214610258,2,529,1
9858951@N03,11573,13,1214610258,1214610258,2,529,0
9858951@N03,11573,28,1214610258,1214610260,2,529,2
9858951@N03,11573,13,1214610260,1214610260,2,529,0
9858951@N03,11573,28,1214610260,1214610434,2,529,174
9858951@N03,11573,13,1214610434,1214610434,2,529,0
9858951@N03,11573,28,1214610434,1214610436,2,529,2
9858951@N03,11573,13,1214610436,1214610436,2,529,0
9858951@N03,11573,28,1214610436,1214610438,2,529,2
9858951@N03,11573,13,1214610438,1214610438,2,529,0
9858951@N03,11573,28,1214610438,1214610440,2,529,2
9858951@N03,11573,13,1214610440,1214610440,2,529,0
9858951@N03,11573,28,1214610440,1214610442,2,529,2
9858951@N03,11573,13,1214610442,1214610442,2,529,0
9858951@N03,11573,28,1214610442,1214610474,2,529,32
9858951@N03,11573,13,1214610474,1214610474,2,529,0
9858951@N03,11573,28,1214610474,1214610479,3,529,5
9858951@N03,11573,13,1214610479,1214610479,2,529,0
9858951@N03,11573,28,1214610479,1214610481,2,529,2
9858951@N03,11573,13,1214610481,1214610481,2,529,0
9858951@N03,11573,28,1214610481,1214610567,2,529,86
9858951@N03,11573,13,1214610567,1214610567,3,529,0
9858951@N03,11573,28,1214610567,1214610568,2,529,1
9858951@N03,11573,13,1214610568,1214610568,2,529,0
9858951@N03,11573,28,1214610568,1214610570,2,529,2
9858951@N03,11573,13,1214610570,1214610570,2,529,0
9858951@N03,11573,28,1214610570,1214610571,2,529,1
9858951@N03,11573,13,1214610571,1214610571,2,529,0
9858951@N03,11573,28,1214610571,1214610686,2,529,115
9858951@N03,11573,13,1214610686,1214610686,2,529,0
9858951@N03,11573,28,1214610686,1214610688,2,529,2
9858951@N03,11573,13,1214610688,1214610688,2,529,0
9858951@N03,11573,28,1214610688,1214610690,2,529,2
9858951@N03,11573,13,1214610690,1214610690,2,529,0
9858951@N03,11573,28,1214610690,1214610692,2,529,2
9858951@N03,11573,13,1214610692,1214610692,2,529,0
9858951@N03,11573,28,1214610692,1214610760,2,529,68
9858951@N03,11573,13,1214610760,1214610760,2,529,0
9858951@N03,11573,28,1214610760,1214610761,2,529,1
9858951@N03,11573,13,1214610761,1214610761,2,529,0
9858951@N03,11573,28,1214610761,1214610763,2,529,2
9858951@N03,11573,13,1214610763,1214610763,2,529,0
9858951@N03,11573,28,1214610763,1214610764,2,529,1
9858951@N03,11573,13,1214610764,1214610764,2,529,0
9858951@N03,11573,28,1214610764,1214611003,2,529,239
9858951@N03,11573,13,1214611003,1214611003,3,529,0
9858951@N03,11573,28,1214611003,1214611005,2,529,2
9858951@N03,11573,13,1214611005,1214611005,2,529,0
9858951@N03,11573,28,1214611005,1214611007,2,529,2
9858951@N03,11573,13,1214611007,1214611007,2,529,0
9858951@N03,11573,28,1214611007,1214611026,2,529,19
9858951@N03,11573,13,1214611026,1214611026,2,529,0
9858951@N03,11573,28,1214611026,1214611028,2,529,2
9858951@N03,11573,13,1214611028,1214611028,2,529,0
9858951@N03,11573,28,1214611028,1214611029,2,529,1
9858951@N03,11573,13,1214611029,1214611029,2,529,0
9858951@N03,11573,28,1214611029,1214611030,2,529,1
9858951@N03,11573,13,1214611030,1214611030,2,529,0
9858951@N03,11573,28,1214611030,1214611049,2,529,19
9858951@N03,11573,13,1214611049,1214611049,2,529,0
9858951@N03,11573,28,1214611049,1214611050,2,529,1
9858951@N03,11573,13,1214611050,1214611050,2,529,0
9858951@N03,11573,28,1214611050,1214611052,2,529,2
9858951@N03,11573,13,1214611052,1214611052,2,529,0
9858951@N03,11573,28,1214611052,1214611053,2,529,1
9858951@N03,11573,13,1214611053,1214611053,2,529,0
9858951@N03,11573,28,1214611053,1214611062,2,529,9
9858951@N03,11573,13,1214611062,1214611062,2,529,0
9858951@N03,11573,28,1214611062,1214611064,2,529,2
9858951@N03,11573,13,1214611064,1214611064,2,529,0
9858951@N03,11573,28,1214611064,1214611065,2,529,1
9858951@N03,11573,13,1214611065,1214611065,2,529,0
9858951@N03,11573,28,1214611065,1214611067,2,529,2
9858951@N03,11573,13,1214611067,1214611067,2,529,0
9858951@N03,11573,28,1214611067,1214611079,2,529,12
9858951@N03,11573,13,1214611079,1214611079,2,529,0
9858951@N03,11573,28,1214611079,1214611081,2,529,2
9858951@N03,11573,13,1214611081,1214611081,2,529,0
9858951@N03,11573,28,1214611081,1214611082,2,529,1
9858951@N03,11573,13,1214611082,1214611082,2,529,0
9858951@N03,11573,28,1214611082,1214611084,2,529,2
9858951@N03,11573,13,1214611084,1214611084,2,529,0
9858951@N03,11573,28,1214611084,1214611085,2,529,1
9858951@N03,11573,13,1214611085,1214611085,2,529,0
9858951@N03,11573,28,1214611085,1214611114,2,529,29
9858951@N03,11573,13,1214611114,1214611114,2,529,0
9858951@N03,11573,28,1214611114,1214611116,2,529,2
9858951@N03,11573,13,1214611116,1214611116,2,529,0
9858951@N03,11573,28,1214611116,1214611118,2,529,2
9858951@N03,11573,13,1214611118,1214611118,2,529,0
9858951@N03,11573,28,1214611118,1214611119,2,529,1
9858951@N03,11573,13,1214611119,1214611119,2,529,0
9858951@N03,11573,28,1214611119,1214611121,2,529,2
9858951@N03,11573,13,1214611121,1214611121,2,529,0
9858951@N03,11573,28,1214611121,1214611148,2,529,27
9858951@N03,11573,13,1214611148,1214611148,2,529,0
9858951@N03,11573,28,1214611148,1214611149,2,529,1
9858951@N03,11573,13,1214611149,1214611149,2,529,0
9858951@N03,11573,28,1214611149,1214611205,2,529,56
9858951@N03,11573,13,1214611205,1214611205,2,529,0
9858951@N03,11573,28,1214611205,1214611206,2,529,1
9858951@N03,11573,13,1214611206,1214611206,2,529,0
9858951@N03,11573,28,1214611206,1214611207,2,529,1
9858951@N03,11573,13,1214611207,1214611207,2,529,0
9858951@N03,11573,28,1214611207,1214611208,2,529,1
9858951@N03,11573,13,1214611208,1214611208,2,529,0
9858951@N03,11573,28,1214611208,1214611240,2,529,32
9858951@N03,11573,13,1214611240,1214611240,2,529,0
9858951@N03,11573,28,1214611240,1214611241,2,529,1
9858951@N03,11573,13,1214611241,1214611241,2,529,0
9858951@N03,11573,28,1214611241,1214611940,2,529,699
9858951@N03,11573,13,1214611940,1214611940,2,529,0
9858951@N03,11573,28,1214611940,1214611941,2,529,1
9858951@N03,11573,13,1214611941,1214611941,2,529,0
9858951@N03,11573,28,1214611941,1214611943,2,529,2
9858951@N03,11573,13,1214611943,1214611943,2,529,0
9858951@N03,11573,28,1214611943,1214611945,2,529,2
9858951@N03,11573,13,1214611945,1214611945,2,529,0
9858951@N03,11573,28,1214611945,1214611953,2,529,8
9858951@N03,11573,13,1214611953,1214611953,2,529,0
9858951@N03,11573,28,1214611953,1214611957,2,529,4
9858951@N03,11573,13,1214611957,1214611957,2,529,0
9858951@N03,11573,28,1214611957,1214611959,2,529,2
9858951@N03,11573,13,1214611959,1214611959,2,529,0
9858951@N03,11573,28,1214611959,1214611960,2,529,1
9858951@N03,11573,13,1214611960,1214611960,2,529,0
9858951@N03,11573,28,1214611960,1214611962,2,529,2
9858951@N03,11573,13,1214611962,1214611962,2,529,0
9858951@N03,11573,28,1214611962,1214611963,2,529,1
9858951@N03,11573,13,1214611963,1214611963,2,529,0
9858951@N03,11573,28,1214611963,1214611965,2,529,2
9858951@N03,11573,13,1214611965,1214611965,2,529,0
9858951@N03,11573,28,1214611965,1214611972,2,529,7
9858951@N03,11573,13,1214611972,1214611972,2,529,0
9858951@N03,11573,28,1214611972,1214611974,2,529,2
9858951@N03,11573,13,1214611974,1214611974,2,529,0
9858951@N03,11573,28,1214611974,1214611975,2,529,1
9858951@N03,11573,13,1214611975,1214611975,2,529,0
9858951@N03,11573,28,1214611975,1214611977,2,529,2
9858951@N03,11573,13,1214611977,1214611977,2,529,0
9858951@N03,11573,28,1214611977,1214611978,2,529,1
9858951@N03,11573,13,1214611978,1214611978,2,529,0
9858951@N03,11573,28,1214611978,1214612129,2,529,151
9858951@N03,11573,13,1214612129,1214612129,2,529,0
9858951@N03,11573,28,1214612129,1214612131,2,529,2
9858951@N03,11573,13,1214612131,1214612131,2,529,0
9858951@N03,11573,28,1214612131,1214612132,2,529,1
9858951@N03,11573,13,1214612132,1214612132,2,529,0
9858951@N03,11573,28,1214612132,1214612134,2,529,2
9858951@N03,11573,13,1214612134,1214612134,2,529,0
9858951@N03,11573,28,1214612134,1214612135,2,529,1
9858951@N03,11573,13,1214612135,1214612135,2,529,0
9858951@N03,11573,28,1214612135,1214612211,2,529,76
9858951@N03,11573,13,1214612211,1214612211,2,529,0
9858951@N03,11573,28,1214612211,1214612213,2,529,2
9858951@N03,11573,13,1214612213,1214612213,2,529,0
9858951@N03,11573,28,1214612213,1214612215,2,529,2
9858951@N03,11573,13,1214612215,1214612218,4,529,3
9858951@N03,11573,28,1214612218,1214612226,2,529,8
9858951@N03,11573,13,1214612226,1214612226,2,529,0
9858951@N03,11573,28,1214612226,1214612227,2,529,1
9858951@N03,11573,13,1214612227,1214612227,2,529,0
9858951@N03,11573,28,1214612227,1214612228,2,529,1
9858951@N03,11573,13,1214612228,1214612228,2,529,0
9858951@N03,11573,28,1214612228,1214612230,2,529,2
9858951@N03,11573,13,1214612230,1214612230,2,529,0
9858951@N03,11573,28,1214612230,1214612265,2,529,35
9858951@N03,11573,13,1214612265,1214612265,2,529,0
9858951@N03,11573,28,1214612265,1214612266,2,529,1
9858951@N03,11573,13,1214612266,1214612266,2,529,0
9858951@N03,11573,28,1214612266,1214612268,2,529,2
9858951@N03,11573,13,1214612268,1214612268,2,529,0
9858951@N03,11573,28,1214612268,1214612269,2,529,1
9858951@N03,11573,13,1214612269,1214612269,2,529,0
9858951@N03,11573,28,1214612269,1214612462,2,529,193
9858951@N03,11573,13,1214612462,1214612462,2,529,0
9858951@N03,11573,28,1214612462,1214612464,2,529,2
9858951@N03,11573,13,1214612464,1214612464,2,529,0
9858951@N03,11573,28,1214612464,1214612465,2,529,1
9858951@N03,11573,13,1214612465,1214612465,2,529,0
9858951@N03,11573,28,1214612465,1214612467,2,529,2
9858951@N03,11573,13,1214612467,1214612467,2,529,0
9858951@N03,11573,28,1214612467,1214612468,2,529,1
9858951@N03,11573,13,1214612468,1214612468,2,529,0
9858951@N03,11573,28,1214612468,1214612470,2,529,2
9858951@N03,11573,13,1214612470,1214612470,2,529,0
9858951@N03,11573,28,1214612470,1214612471,2,529,1
9858951@N03,11573,13,1214612471,1214612471,2,529,0
9858951@N03,11573,28,1214612471,1214612525,2,529,54
9858951@N03,11573,13,1214612525,1214612525,2,529,0
9858951@N03,11573,28,1214612525,1214612528,2,529,3
9858951@N03,11573,13,1214612528,1214612528,2,529,0
9858951@N03,11573,28,1214612528,1214612529,2,529,1
9858951@N03,11573,13,1214612529,1214612529,2,529,0
9858951@N03,11573,28,1214612529,1214612531,2,529,2
9858951@N03,11573,13,1214612531,1214612531,2,529,0
9858951@N03,11573,28,1214612531,1214612565,2,529,34
9858951@N03,11573,13,1214612565,1214612565,2,529,0
9858951@N03,11573,28,1214612565,1214612567,2,529,2
9858951@N03,11573,13,1214612567,1214612567,2,529,0
9858951@N03,11573,28,1214612567,1214612569,2,529,2
9858951@N03,11573,13,1214612569,1214612569,2,529,0
9858951@N03,11573,28,1214612569,1214612570,2,529,1
9858951@N03,11573,13,1214612570,1214612572,3,529,2
9858951@N03,11573,28,1214612572,1214612755,2,529,183
9858951@N03,11573,13,1214612755,1214612755,2,529,0
9858951@N03,11573,28,1214612755,1214612867,2,529,112
9858951@N03,11573,13,1214612867,1214612867,2,529,0
9858951@N03,11573,28,1214612867,1214612870,2,529,3
9858951@N03,11573,13,1214612870,1214612870,2,529,0
9858951@N03,11573,28,1214612870,1214612872,2,529,2
9858951@N03,11573,13,1214612872,1214612872,2,529,0
9858951@N03,11573,28,1214612872,1214613192,2,529,320
9858951@N03,11573,13,1214613192,1214613192,2,529,0
9858951@N03,11573,28,1214613192,1214613194,2,529,2
9858951@N03,11573,13,1214613194,1214613194,2,529,0
9858951@N03,11573,28,1214613194,1214613196,2,529,2
9858951@N03,11573,13,1214613196,1214613196,2,529,0
9858951@N03,11573,28,1214613196,1214613197,2,529,1
9858951@N03,11573,13,1214613197,1214613197,2,529,0
9858951@N03,11573,28,1214613197,1214613203,2,529,6
9858951@N03,11573,13,1214613203,1214613203,2,529,0
9858951@N03,11573,28,1214613203,1214613204,2,529,1
9858951@N03,11573,13,1214613204,1214613204,2,529,0
9858951@N03,11573,28,1214613204,1214613206,2,529,2
9858951@N03,11573,13,1214613206,1214613206,2,529,0
9858951@N03,11573,28,1214613206,1214613689,2,529,483
9858951@N03,11573,13,1214613689,1214613689,2,529,0
9858951@N03,11573,28,1214613689,1214613690,2,529,1
9858951@N03,11573,13,1214613690,1214613690,2,529,0
9858951@N03,11573,28,1214613690,1214613691,2,529,1
9858951@N03,11573,13,1214613691,1214613691,2,529,0
9858951@N03,11573,28,1214613691,1214613692,2,529,1
9858951@N03,11573,13,1214613692,1214613692,2,529,0
9858951@N03,11573,28,1214613692,1214613757,2,529,65
9858951@N03,11573,13,1214613757,1214613757,2,529,0
9858951@N03,11573,28,1214613757,1214613759,2,529,2
9858951@N03,11573,13,1214613759,1214613759,2,529,0
9858951@N03,11573,28,1214613759,1214613762,2,529,3
9858951@N03,11573,13,1214613762,1214613762,2,529,0
9858951@N03,11573,28,1214613762,1214613764,2,529,2
9858951@N03,11573,13,1214613764,1214613764,2,529,0
9858951@N03,11573,28,1214613764,1214613768,2,529,4
9858951@N03,11573,13,1214613768,1214613768,2,529,0
9858951@N03,11573,28,1214613768,1214613769,2,529,1
9858951@N03,11573,13,1214613769,1214613769,2,529,0
9858951@N03,11573,28,1214613769,1214613771,2,529,2
9858951@N03,11573,13,1214613771,1214613771,2,529,0
9858951@N03,11573,28,1214613771,1214613773,2,529,2
9858951@N03,11573,13,1214613773,1214613773,2,529,0
9858951@N03,11573,28,1214613773,1214613775,2,529,2
9858951@N03,11573,13,1214613775,1214613775,2,529,0
9858951@N03,11573,28,1214613775,1214613776,2,529,1
9858951@N03,11573,13,1214613776,1214613776,2,529,0
9858951@N03,11573,28,1214613776,1214613983,2,529,207
9858951@N03,11573,13,1214613983,1214613983,2,529,0
9858951@N03,11573,28,1214613983,1214613985,2,529,2
9858951@N03,11573,13,1214613985,1214613985,2,529,0
9858951@N03,11573,28,1214613985,1214613987,2,529,2
9858951@N03,11573,13,1214613987,1214613987,2,529,0
9858951@N03,11573,28,1214613987,1214613989,2,529,2
9858951@N03,11573,13,1214613989,1214613989,2,529,0
9858951@N03,11573,28,1214613989,1214613992,2,529,3
9858951@N03,11573,13,1214613992,1214613992,2,529,0
9858951@N03,11573,28,1214613992,1214614004,2,529,12
9858951@N03,11573,13,1214614004,1214614004,2,529,0
9858951@N03,11573,28,1214614004,1214614006,2,529,2
9858951@N03,11573,13,1214614006,1214614006,2,529,0
9858951@N03,11573,28,1214614006,1214614008,2,529,2
9858951@N03,11573,13,1214614008,1214614008,2,529,0
9858951@N03,11573,28,1214614008,1214614009,2,529,1
9858951@N03,11573,13,1214614009,1214614009,2,529,0
9858951@N03,11573,28,1214614009,1214614028,2,529,19
9858951@N03,11573,13,1214614028,1214614028,2,529,0
9858951@N03,11573,28,1214614028,1214614030,2,529,2
9858951@N03,11573,13,1214614030,1214614030,2,529,0
9858951@N03,11573,28,1214614030,1214614031,2,529,1
9858951@N03,11573,13,1214614031,1214614031,2,529,0
9858951@N03,11573,28,1214614031,1214614033,2,529,2
9858951@N03,11573,13,1214614033,1214614033,2,529,0
9858951@N03,11573,28,1214614033,1214614050,2,529,17
9858951@N03,11573,13,1214614050,1214614050,2,529,0
9858951@N03,11573,28,1214614050,1214614055,2,529,5
9858951@N03,11573,13,1214614055,1214614055,2,529,0
9858951@N03,11573,28,1214614055,1214614057,2,529,2
9858951@N03,11573,13,1214614057,1214614057,2,529,0
9858951@N03,11573,28,1214614057,1214614060,2,529,3
9858951@N03,11573,13,1214614060,1214614060,2,529,0
9858951@N03,11573,28,1214614060,1214614102,2,529,42
9858951@N03,11573,13,1214614102,1214614102,2,529,0
9858951@N03,11573,28,1214614102,1214614104,2,529,2
9858951@N03,11573,13,1214614104,1214614104,2,529,0
9858951@N03,11573,28,1214614104,1214614105,2,529,1
9858951@N03,11573,13,1214614105,1214614105,2,529,0
9858951@N03,11573,28,1214614105,1214615005,2,529,900
9858951@N03,11573,13,1214615209,1214615209,2,529,0
9858951@N03,11573,28,1214615209,1214615210,2,529,1
9858951@N03,11573,13,1214615210,1214615210,2,529,0
9858951@N03,11573,28,1214615210,1214615212,2,529,2
9858951@N03,11573,13,1214615212,1214615212,2,529,0
9858951@N03,11573,28,1214615212,1214615240,2,529,28
9858951@N03,11573,13,1214615240,1214615240,2,529,0
9858951@N03,11573,28,1214615240,1214615241,2,529,1
9858951@N03,11573,13,1214615241,1214615241,2,529,0
9858951@N03,11573,28,1214615241,1214615242,2,529,1
9858951@N03,11573,13,1214615242,1214615242,2,529,0
9858951@N03,11573,28,1214615242,1214615250,2,529,8
9858951@N03,11573,13,1214615250,1214615250,2,529,0
9858951@N03,11573,28,1214615250,1214615252,2,529,2
9858951@N03,11573,13,1214615252,1214615252,2,529,0
9858951@N03,11573,28,1214615252,1214615254,2,529,2
9858951@N03,11573,13,1214615254,1214615254,2,529,0
9858951@N03,11573,28,1214615254,1214615255,2,529,1
9858951@N03,11573,13,1214615255,1214615255,2,529,0
9858951@N03,11573,28,1214615255,1214615524,2,529,269
9858951@N03,11573,13,1214615524,1214615524,2,529,0
9858951@N03,11573,28,1214615524,1214615528,2,529,4
9858951@N03,11573,13,1214615528,1214615528,2,529,0
9858951@N03,11573,28,1214615528,1214615530,2,529,2
9858951@N03,11573,13,1214615530,1214615530,2,529,0
9858951@N03,11573,28,1214615530,1214615532,2,529,2
9858951@N03,11573,13,1214615532,1214615532,2,529,0
9858951@N03,11573,28,1214615532,1214615538,2,529,6
9858951@N03,11573,13,1214615538,1214615538,2,529,0
9858951@N03,11573,28,1214615538,1214615540,2,529,2
9858951@N03,11573,13,1214615540,1214615540,2,529,0
9858951@N03,11573,28,1214615540,1214615541,2,529,1
9858951@N03,11573,13,1214615541,1214615541,2,529,0
9858951@N03,11573,28,1214615541,1214615542,2,529,1
9858951@N03,11573,13,1214615542,1214615542,2,529,0
9858951@N03,11573,28,1214615542,1214616442,2,529,900
9858951@N03,11573,15,1214618657,1214618657,2,529,0
9858951@N03,11573,28,1214618657,1214618661,2,529,4
9858951@N03,11573,15,1214618661,1214618661,2,529,0
9858951@N03,11573,28,1214618661,1214618674,2,529,13
9858951@N03,11573,15,1214618674,1214618674,2,529,0
9858951@N03,11573,28,1214618674,1214618677,2,529,3
9858951@N03,11573,15,1214618677,1214618677,2,529,0
9858951@N03,11573,28,1214618677,1214619577,2,529,900
9858951@N03,11573,15,1214622299,1214622569,3,529,270
9858951@N03,11573,28,1214622583,1214622587,2,529,4
9858951@N03,11573,15,1214622587,1214622587,2,529,0
9858951@N03,11573,28,1214622587,1214622589,2,529,2
9858951@N03,11573,15,1214622589,1214622589,2,529,0
9858951@N03,11573,28,1214622589,1214622592,2,529,3
9858951@N03,11573,15,1214622592,1214622592,2,529,0
9858951@N03,11573,28,1214622592,1214622595,2,529,3
9858951@N03,11573,15,1214622595,1214622595,2,529,0
9858951@N03,11573,28,1214622595,1214622612,2,529,17
9858951@N03,11573,15,1214622612,1214622612,2,529,0
9858951@N03,11573,28,1214622612,1214622615,2,529,3
9858951@N03,11573,15,1214622615,1214622615,2,529,0
9858951@N03,11573,28,1214622615,1214622617,2,529,2
9858951@N03,11573,15,1214622617,1214622617,2,529,0
9858951@N03,11573,28,1214622617,1214622619,2,529,2
9858951@N03,11573,15,1214622619,1214622619,2,529,0
9858951@N03,11573,28,1214622619,1214622622,2,529,3
9858951@N03,11573,15,1214622622,1214622622,2,529,0
9858951@N03,11573,28,1214622622,1214622719,2,529,97
9858951@N03,11573,15,1214622719,1214622719,2,529,0
9858951@N03,11573,28,1214622719,1214622721,2,529,2
9858951@N03,11573,15,1214622721,1214622721,2,529,0
9858951@N03,11573,28,1214622721,1214622722,2,529,1
9858951@N03,11573,15,1214622722,1214622722,2,529,0
9858951@N03,11573,28,1214622722,1214622723,2,529,1
9858951@N03,11573,15,1214622723,1214622723,2,529,0
9858951@N03,11573,28,1214622723,1214622772,2,529,49
9858951@N03,11573,15,1214622772,1214622772,2,529,0
9858951@N03,11573,28,1214622772,1214622774,2,529,2
9858951@N03,11573,15,1214622774,1214622774,2,529,0
9858951@N03,11573,28,1214622774,1214622776,2,529,2
9858951@N03,11573,15,1214622776,1214622776,2,529,0
9858951@N03,11573,28,1214622776,1214622777,2,529,1
9858951@N03,11573,15,1214622777,1214622777,2,529,0
9858951@N03,11573,28,1214622777,1214622947,2,529,170
9858951@N03,11573,15,1214622947,1214622947,2,529,0
9858951@N03,11573,28,1214622947,1214622949,2,529,2
9858951@N03,11573,15,1214622949,1214622949,2,529,0
9858951@N03,11573,28,1214622949,1214622951,2,529,2
9858951@N03,11573,15,1214622951,1214622951,2,529,0
9858951@N03,11573,28,1214622951,1214622962,2,529,11
9858951@N03,11573,15,1214622962,1214622962,2,529,0
9858951@N03,11573,28,1214622962,1214622971,2,529,9
9858951@N03,11573,15,1214622971,1214623213,10,529,242
9858951@N03,11573,17,1214623213,1214623213,2,529,0
9858951@N03,11573,28,1214623213,1214623215,2,529,2
9858951@N03,11573,17,1214623215,1214623215,2,529,0
9858951@N03,11573,28,1214623215,1214623217,2,529,2
9858951@N03,11573,17,1214623217,1214623217,2,529,0
9858951@N03,11573,28,1214623217,1214623219,2,529,2
9858951@N03,11573,17,1214623219,1214623219,2,529,0
9858951@N03,11573,28,1214623219,1214623358,2,529,139
9858951@N03,11573,17,1214623358,1214623358,2,529,0
9858951@N03,11573,28,1214623358,1214623371,2,529,13
9858951@N03,11573,17,1214623371,1214623371,2,529,0
9858951@N03,11573,28,1214623371,1214623400,2,529,29
9858951@N03,11573,17,1214623400,1214623400,2,529,0
9858951@N03,11573,28,1214623400,1214623435,2,529,35
9858951@N03,11573,17,1214623435,1214623435,2,529,0
9858951@N03,11573,28,1214623435,1214623441,2,529,6
9858951@N03,11573,17,1214623441,1214623441,2,529,0
9858951@N03,11573,28,1214623441,1214623442,2,529,1
9858951@N03,11573,17,1214623442,1214623442,2,529,0
9858951@N03,11573,28,1214623442,1214623444,2,529,2
9858951@N03,11573,17,1214623444,1214623444,2,529,0
9858951@N03,11573,28,1214623444,1214623474,2,529,30
9858951@N03,11573,17,1214623474,1214623474,2,529,0
9858951@N03,11573,28,1214623474,1214623488,2,529,14
9858951@N03,11573,17,1214623488,1214623488,2,529,0
9858951@N03,11573,28,1214623488,1214623500,2,529,12
9858951@N03,11573,17,1214623500,1214623500,2,529,0
9858951@N03,11573,28,1214623500,1214623513,2,529,13
9858951@N03,11573,17,1214623513,1214623513,2,529,0
9858951@N03,11573,28,1214623513,1214623523,2,529,10
9858951@N03,11573,17,1214623523,1214623523,2,529,0
9858951@N03,11573,28,1214623523,1214623532,2,529,9
9858951@N03,11573,17,1214623532,1214623532,2,529,0
9858951@N03,11573,28,1214623532,1214623540,2,529,8
9858951@N03,11573,17,1214623540,1214623540,2,529,0
9858951@N03,11573,28,1214623540,1214623549,2,529,9
9858951@N03,11573,17,1214623549,1214623549,2,529,0
9858951@N03,11573,28,1214623549,1214623551,2,529,2
9858951@N03,11573,17,1214623551,1214623551,2,529,0
9858951@N03,11573,28,1214623551,1214623553,2,529,2
9858951@N03,11573,17,1214623553,1214623553,2,529,0
9858951@N03,11573,28,1214623553,1214623682,2,529,129
9858951@N03,11573,17,1214623682,1214623982,8,529,300
9858951@N03,11574,13,1215059680,1215059920,1,1,240
9858951@N03,11575,28,1215615963,1215616020,8,17,57
9858951@N03,11575,23,1215616020,1215616058,22,17,38
9858951@N03,11575,19,1215616058,1215616074,16,17,16
9858951@N03,11575,29,1215616074,1215616079,4,17,5
9858951@N03,11575,19,1215616079,1215616082,4,17,3
9858951@N03,11575,23,1215616082,1215616086,5,17,4
9858951@N03,11575,18,1215616086,1215616098,7,17,12
9858951@N03,11575,23,1215616098,1215616099,2,17,1
9858951@N03,11575,26,1215616099,1215616112,9,17,13
9858951@N03,11575,28,1215616112,1215616121,4,17,9
9858951@N03,11575,19,1215616121,1215616340,16,17,219
9858951@N03,11575,28,1215616340,1215616343,2,17,3
9858951@N03,11575,19,1215616343,1215616354,3,17,11
9858951@N03,11575,15,1215616354,1215616361,5,17,7
9858951@N03,11575,13,1215616361,1215616486,11,17,125
9858951@N03,11575,15,1215616486,1215616540,23,17,54
9858951@N03,11575,13,1215616540,1215616780,124,17,240
9858951@N03,11576,20,1215760915,1215761455,4,3,540
9858951@N03,11576,29,1215762210,1215763110,5,3,900
9858951@N03,11576,1,1215773923,1215773983,1,3,60
9858951@N03,11577,1,1216229992,1216230052,4,12,60
9858951@N03,11577,28,1216251861,1216252761,13,12,900
9858951@N03,11577,27,1216253344,1216253772,4,12,428
9858951@N03,11577,26,1216253772,1216254672,8,12,900
9858951@N03,11577,28,1216258170,1216259070,3,12,900
9858951@N03,11577,1,1216259318,1216259378,2,12,60
9858951@N03,11577,28,1216259911,1216260811,8,12,900
9858951@N03,11577,1,1216262951,1216263011,5,12,60
9858951@N03,11577,28,1216263447,1216264347,9,12,900
9858951@N03,11577,1,1216267093,1216267153,9,12,60
9858951@N03,11577,28,1216271033,1216271933,5,12,900
9858951@N03,11577,1,1216273836,1216273896,35,12,60
9858951@N03,11578,28,1216629702,1216630602,2,1,900
9858951@N03,11579,13,1216660645,1216660885,3,12,240
9858951@N03,11579,28,1216661369,1216661562,5,12,193
9858951@N03,11579,1,1216661562,1216661622,3,12,60
9858951@N03,11579,18,1216661851,1216661873,14,12,22
9858951@N03,11579,23,1216661873,1216661876,3,12,3
9858951@N03,11579,18,1216661876,1216661878,2,12,2
9858951@N03,11579,19,1216661878,1216661880,3,12,2
9858951@N03,11579,23,1216661880,1216661883,2,12,3
9858951@N03,11579,29,1216661883,1216661885,2,12,2
9858951@N03,11579,19,1216661885,1216661964,6,12,79
9858951@N03,11579,10,1216661964,1216661974,2,12,10
9858951@N03,11579,19,1216661974,1216662514,3,12,540
9858951@N03,11580,16,1218117600,1218117605,6,4,5
9858951@N03,11580,12,1218117605,1218117606,2,4,1
9858951@N03,11580,17,1218117606,1218117617,12,4,11
9858951@N03,11580,15,1218117617,1218117887,8,4,270
9858951@N03,11581,1,1218153105,1218153165,4,35,60
9858951@N03,11581,28,1218153242,1218153243,2,35,1
9858951@N03,11581,1,1218153243,1218153243,2,35,0
9858951@N03,11581,28,1218153243,1218153273,2,35,30
9858951@N03,11581,1,1218153273,1218153333,4,35,60
9858951@N03,11581,28,1218153385,1218154285,29,35,900
9858951@N03,11581,1,1218154556,1218154616,3,35,60
9858951@N03,11581,28,1218154814,1218155714,55,35,900
9858951@N03,11581,16,1218177564,1218177834,9,35,270
9858951@N03,11581,17,1218178688,1218178940,12,35,252
9858951@N03,11581,15,1218178940,1218179210,9,35,270
9858951@N03,11581,24,1218183204,1218183984,28,35,780
9858951@N03,11581,23,1218184665,1218185265,10,35,600
9858951@N03,11581,31,1218192838,1218194338,4,35,1500
9858951@N03,11581,22,1218194421,1218195021,12,35,600
9858951@N03,11581,14,1218195720,1218195960,2,35,240
9858951@N03,11581,31,1218196255,1218196391,2,35,136
9858951@N03,11581,14,1218196391,1218196631,4,35,240
9858951@N03,11581,31,1218199851,1218201008,2,35,1157
9858951@N03,11581,11,1218201008,1218201175,60,35,167
9858951@N03,11581,4,1218201175,1218201276,12,35,101
9858951@N03,11581,11,1218201308,1218201508,8,35,200
9858951@N03,11581,4,1218201508,1218201609,25,35,101
9858951@N03,11581,7,1218201732,1218201770,4,35,38
9858951@N03,11581,5,1218201770,1218201890,3,35,120
9858951@N03,11581,8,1218202049,1218202229,6,35,180
9858951@N03,11581,26,1218202461,1218202879,7,35,418
9858951@N03,11581,18,1218202879,1218202889,2,35,10
9858951@N03,11581,28,1218202889,1218203418,20,35,529
9858951@N03,11581,10,1218203418,1218203517,7,35,99
9858951@N03,11581,28,1218203517,1218203544,2,35,27
9858951@N03,11581,10,1218203544,1218203777,10,35,233
9858951@N03,11581,28,1218203777,1218203779,2,35,2
9858951@N03,11581,10,1218203779,1218204019,8,35,240
9858951@N03,11581,1,1218204501,1218204561,5,35,60
9858951@N03,11582,8,1218470952,1218470967,10,7,15
9858951@N03,11582,27,1218470967,1218470968,2,7,1
9858951@N03,11582,16,1218470968,1218470974,3,7,6
9858951@N03,11582,8,1218470974,1218470976,2,7,2
9858951@N03,11582,17,1218470976,1218471014,20,7,38
9858951@N03,11582,15,1218471014,1218471037,12,7,23
9858951@N03,11582,24,1218471037,1218471817,1,7,780
9858951@N03,11583,24,1219329566,1219329584,10,29,18
9858951@N03,11583,21,1219329584,1219329596,4,29,12
9858951@N03,11583,25,1219329596,1219329602,4,29,6
9858951@N03,11583,21,1219329602,1219329635,10,29,33
9858951@N03,11583,3,1219329635,1219329651,3,29,16
9858951@N03,11583,12,1219329651,1219329657,4,29,6
9858951@N03,11583,24,1219329657,1219329704,22,29,47
9858951@N03,11583,23,1219329704,1219329707,3,29,3
9858951@N03,11583,18,1219329707,1219329714,5,29,7
9858951@N03,11583,23,1219329714,1219329715,2,29,1
9858951@N03,11583,29,1219329715,1219329802,64,29,87
9858951@N03,11583,31,1219329802,1219329829,11,29,27
9858951@N03,11583,20,1219329829,1219329831,2,29,2
9858951@N03,11583,31,1219329831,1219329834,4,29,3
9858951@N03,11583,29,1219329834,1219329835,2,29,1
9858951@N03,11583,31,1219329835,1219329836,2,29,1
9858951@N03,11583,29,1219329836,1219329840,5,29,4
9858951@N03,11583,31,1219329840,1219329841,2,29,1
9858951@N03,11583,29,1219329841,1219329851,9,29,10
9858951@N03,11583,31,1219329851,1219329863,12,29,12
9858951@N03,11583,22,1219329863,1219329865,3,29,2
9858951@N03,11583,31,1219329865,1219329880,10,29,15
9858951@N03,11583,22,1219329880,1219329881,2,29,1
9858951@N03,11583,31,1219329881,1219329882,2,29,1
9858951@N03,11583,22,1219329882,1219329883,2,29,1
9858951@N03,11583,31,1219329883,1219329895,9,29,12
9858951@N03,11583,22,1219329895,1219329896,2,29,1
9858951@N03,11583,31,1219329896,1219329899,4,29,3
9858951@N03,11583,22,1219329899,1219330499,1,29,600
9858951@N03,11584,22,1219934982,1219934983,2,14,1
9858951@N03,11584,31,1219934983,1219934984,2,14,1
9858951@N03,11584,14,1219934984,1219935027,34,14,43
9858951@N03,11584,22,1219935027,1219935028,2,14,1
9858951@N03,11584,14,1219935028,1219935030,3,14,2
9858951@N03,11584,22,1219935030,1219935031,2,14,1
9858951@N03,11584,14,1219935031,1219935042,10,14,11
9858951@N03,11584,22,1219935042,1219935045,4,14,3
9858951@N03,11584,31,1219935045,1219935046,2,14,1
9858951@N03,11584,22,1219935046,1219935047,2,14,1
9858951@N03,11584,31,1219935047,1219935058,13,14,11
9858951@N03,11584,20,1219935058,1219935058,3,14,0
9858951@N03,11584,31,1219935058,1219935060,2,14,2
9858951@N03,11584,20,1219935060,1219935600,40,14,540
9858951@N03,11585,24,1220683086,1220683866,1,1,780
9858951@N03,11586,24,1221352892,1221353672,2,1,780
9858951@N03,11587,24,1221496007,1221496787,1,1,780
9858951@N03,11588,24,1221567583,1221568363,4,1,780
9858951@N03,11589,18,1221786842,1221787292,4,1,450
9858951@N03,11590,29,1222999360,1222999591,6,5,231
9858951@N03,11590,30,1222999591,1223000671,21,5,1080
9858951@N03,11590,11,1223003481,1223003721,6,5,240
9858951@N03,11590,21,1223005502,1223006072,2,5,570
9858951@N03,11590,28,1223011867,1223012767,8,5,900
9858951@N03,11591,17,1223595087,1223595387,9,16,300
9858951@N03,11591,28,1223596359,1223596426,10,16,67
9858951@N03,11591,1,1223596426,1223596426,2,16,0
9858951@N03,11591,28,1223596426,1223596432,2,16,6
9858951@N03,11591,1,1223596432,1223596432,2,16,0
9858951@N03,11591,28,1223596432,1223596437,2,16,5
9858951@N03,11591,1,1223596437,1223596438,3,16,1
9858951@N03,11591,28,1223596438,1223596441,2,16,3
9858951@N03,11591,1,1223596441,1223596441,2,16,0
9858951@N03,11591,28,1223596441,1223596501,3,16,60
9858951@N03,11591,1,1223596501,1223596501,2,16,0
9858951@N03,11591,28,1223596501,1223597401,2,16,900
9858951@N03,11591,1,1223602791,1223602851,3,16,60
9858951@N03,11591,28,1223602870,1223603770,2,16,900
9858951@N03,11591,16,1223627712,1223627982,34,16,270
9858951@N03,11591,1,1223631819,1223631879,8,16,60
9858951@N03,11592,22,1224206246,1224206256,9,7,10
9858951@N03,11592,31,1224206256,1224206260,2,7,4
9858951@N03,11592,22,1224206260,1224206860,5,7,600
9858951@N03,11592,17,1224207844,1224207869,2,7,25
9858951@N03,11592,31,1224207869,1224209369,2,7,1500
9858951@N03,11592,29,1224216473,1224217373,6,7,900
9858951@N03,11592,15,1224220125,1224220395,24,7,270
9858951@N03,11593,1,1224803061,1224803121,3,5,60
9858951@N03,11593,20,1224803906,1224804446,14,5,540
9858951@N03,11593,31,1224809428,1224810928,6,5,1500
9858951@N03,11593,23,1224827059,1224827659,3,5,600
9858951@N03,11593,18,1224831102,1224831552,5,5,450
9858951@N03,11594,18,1224890637,1224891087,2,1,450
9858951@N03,11595,20,1225408312,1225408852,55,9,540
9858951@N03,11595,22,1225414639,1225415239,33,9,600
9858951@N03,11595,31,1225418456,1225419956,3,9,1500
9858951@N03,11595,29,1225425333,1225425838,2,9,505
9858951@N03,11595,31,1225425838,1225426109,3,9,271
9858951@N03,11595,22,1225426109,1225426622,6,9,513
9858951@N03,11595,30,1225426622,1225427375,19,9,753
9858951@N03,11595,29,1225427375,1225428162,6,9,787
9858951@N03,11595,30,1225428162,1225429242,5,9,1080
9858951@N03,11596,1,1226013917,1226013977,10,62,60
9858951@N03,11596,28,1226014666,1226015566,8,62,900
9858951@N03,11596,26,1226016691,1226016852,6,62,161
9858951@N03,11596,28,1226016852,1226016854,2,62,2
9858951@N03,11596,26,1226016854,1226016973,2,62,119
9858951@N03,11596,28,1226016973,1226017873,8,62,900
9858951@N03,11596,18,1226020077,1226020115,5,62,38
9858951@N03,11596,26,1226020115,1226020224,2,62,109
9858951@N03,11596,23,1226020224,1226020226,2,62,2
9858951@N03,11596,26,1226020226,1226021043,8,62,817
9858951@N03,11596,29,1226021043,1226021943,16,62,900
9858951@N03,11596,20,1226022590,1226023130,2,62,540
9858951@N03,11596,29,1226024259,1226025159,43,62,900
9858951@N03,11596,26,1226028111,1226029011,9,62,900
9858951@N03,11596,28,1226031060,1226031960,2,62,900
9858951@N03,11596,26,1226046184,1226047084,46,62,900
9858951@N03,11596,6,1226057931,1226057971,3,62,40
9858951@N03,11596,26,1226057971,1226058175,2,62,204
9858951@N03,11596,6,1226058175,1226058175,2,62,0
9858951@N03,11596,26,1226058175,1226058209,2,62,34
9858951@N03,11596,6,1226058209,1226058209,2,62,0
9858951@N03,11596,26,1226058209,1226058241,2,62,32
9858951@N03,11596,6,1226058241,1226058241,2,62,0
9858951@N03,11596,26,1226058241,1226058415,4,62,174
9858951@N03,11596,6,1226058415,1226058415,2,62,0
9858951@N03,11596,26,1226058415,1226058429,2,62,14
9858951@N03,11596,6,1226058429,1226058429,2,62,0
9858951@N03,11596,26,1226058429,1226058433,2,62,4
9858951@N03,11596,6,1226058433,1226058433,3,62,0
9858951@N03,11596,26,1226058433,1226058478,4,62,45
9858951@N03,11596,6,1226058478,1226058478,2,62,0
9858951@N03,11596,26,1226058478,1226058480,2,62,2
9858951@N03,11596,6,1226058480,1226058480,2,62,0
9858951@N03,11596,26,1226058480,1226059380,4,62,900
9858951@N03,11596,6,1226060228,1226060228,2,62,0
9858951@N03,11596,26,1226060228,1226061128,2,62,900
9858951@N03,11596,6,1226062104,1226062104,2,62,0
9858951@N03,11596,26,1226062104,1226062110,2,62,6
9858951@N03,11596,6,1226062110,1226062110,3,62,0
9858951@N03,11596,26,1226062110,1226062236,2,62,126
9858951@N03,11596,6,1226062236,1226062236,2,62,0
9858951@N03,11596,26,1226062236,1226062499,2,62,263
9858951@N03,11596,6,1226062499,1226062499,2,62,0
9858951@N03,11596,26,1226062499,1226062566,2,62,67
9858951@N03,11596,6,1226062566,1226062566,2,62,0
9858951@N03,11596,26,1226062566,1226063466,2,62,900
9858951@N03,11596,16,1226063948,1226063959,3,62,11
9858951@N03,11596,6,1226063959,1226063959,2,62,0
9858951@N03,11596,26,1226063959,1226063970,2,62,11
9858951@N03,11596,6,1226063970,1226063970,2,62,0
9858951@N03,11596,26,1226063970,1226063974,2,62,4
9858951@N03,11596,16,1226063974,1226063974,2,62,0
9858951@N03,11596,26,1226063974,1226064151,4,62,177
9858951@N03,11596,16,1226064151,1226064151,2,62,0
9858951@N03,11596,26,1226064151,1226064176,3,62,25
9858951@N03,11596,16,1226064176,1226064176,7,62,0
9858951@N03,11596,26,1226064176,1226064209,2,62,33
9858951@N03,11596,16,1226064209,1226064404,2,62,195
9858951@N03,11596,26,1226064404,1226064837,14,62,433
9858951@N03,11596,28,1226064837,1226065737,25,62,900
9858951@N03,11596,26,1226094850,1226095750,30,62,900
9858951@N03,11596,28,1226102054,1226102954,22,62,900
9858951@N03,11597,26,1226213284,1226214184,1,1,900
9858951@N03,11598,28,1226278123,1226279023,2,2,900
9858951@N03,11598,26,1226288575,1226289475,11,2,900
9858951@N03,11599,1,1226617240,1226617300,9,12,60
9858951@N03,11599,13,1226618368,1226618608,2,12,240
9858951@N03,11599,28,1226619406,1226620306,39,12,900
9858951@N03,11599,1,1226632644,1226632704,3,12,60
9858951@N03,11599,26,1226637243,1226638143,40,12,900
9858951@N03,11599,30,1226641241,1226642321,22,12,1080
9858951@N03,11599,10,1226642593,1226642833,2,12,240
9858951@N03,11599,30,1226644746,1226645088,2,12,342
9858951@N03,11599,29,1226645088,1226645257,5,12,169
9858951@N03,11599,30,1226645257,1226646075,16,12,818
9858951@N03,11599,29,1226646075,1226646975,6,12,900
9858951@N03,11599,23,1226649940,1226650540,1,12,600
9858951@N03,11600,28,1226785177,1226786077,11,1,900
9858951@N03,11601,1,1227222078,1227222138,2,13,60
9858951@N03,11601,28,1227222238,1227222710,3,13,472
9858951@N03,11601,1,1227222710,1227222770,11,13,60
9858951@N03,11601,25,1227225117,1227225957,14,13,840
9858951@N03,11601,13,1227226786,1227227026,13,13,240
9858951@N03,11601,26,1227227356,1227227392,2,13,36
9858951@N03,11601,6,1227227392,1227227512,10,13,120
9858951@N03,11601,9,1227228652,1227228832,2,13,180
9858951@N03,11601,26,1227230898,1227231798,5,13,900
9858951@N03,11601,16,1227237224,1227237494,3,13,270
9858951@N03,11601,1,1227243198,1227243258,6,13,60
9858951@N03,11601,21,1227249395,1227249965,6,13,570
9858951@N03,11601,28,1227253509,1227254409,17,13,900
9858951@N03,11602,26,1229436247,1229437147,1,1,900
9858951@N03,11603,28,1230200217,1230201117,203,2,900
9858951@N03,11603,26,1230201381,1230202281,1415,2,900
9858951@N03,11604,28,1230354829,1230355252,7,12,423
9858951@N03,11604,27,1230355252,1230356152,2,12,900
9858951@N03,11604,28,1230356535,1230356723,45,12,188
9858951@N03,11604,26,1230356723,1230356767,12,12,44
9858951@N03,11604,28,1230356767,1230356779,11,12,12
9858951@N03,11604,26,1230356779,1230356828,10,12,49
9858951@N03,11604,28,1230356828,1230357728,729,12,900
9858951@N03,11604,16,1230358959,1230359120,120,12,161
9858951@N03,11604,28,1230359120,1230360020,1004,12,900
9858951@N03,11604,21,1230360561,1230360573,9,12,12
9858951@N03,11604,3,1230360573,1230360573,2,12,0
9858951@N03,11604,21,1230360573,1230361143,58,12,570
9858951@N03,11605,24,1232978335,1232979115,1,1,780
9858951@N03,11606,1,1233890033,1233890093,13,4,60
9858951@N03,11606,28,1233891517,1233892417,6,4,900
9858951@N03,11606,1,1233904224,1233904284,21,4,60
9858951@N03,11606,25,1233905981,1233906821,111,4,840
9858951@N03,11607,5,1234231292,1234231412,1,1,120
9858951@N03,11608,18,1235355245,1235355472,7,18,227
9858951@N03,11608,19,1235355472,1235355491,2,18,19
9858951@N03,11608,18,1235355491,1235355506,3,18,15
9858951@N03,11608,19,1235355506,1235355954,32,18,448
9858951@N03,11608,29,1235355954,1235355963,2,18,9
9858951@N03,11608,19,1235355963,1235355997,2,18,34
9858951@N03,11608,29,1235355997,1235356209,9,18,212
9858951@N03,11608,19,1235356209,1235356209,4,18,0
9858951@N03,11608,29,1235356209,1235356224,2,18,15
9858951@N03,11608,19,1235356224,1235356224,4,18,0
9858951@N03,11608,29,1235356224,1235357124,13,18,900
9858951@N03,11608,18,1235358226,1235358676,2,18,450
9858951@N03,11608,25,1235363382,1235363844,2,18,462
9858951@N03,11608,12,1235363844,1235364084,8,18,240
9858951@N03,11608,15,1235364290,1235364560,3,18,270
9858951@N03,11608,21,1235364932,1235364948,4,18,16
9858951@N03,11608,3,1235364948,1235365038,2,18,90
9858951@N03,11608,24,1235365120,1235365900,3,18,780
9858951@N03,11609,5,1236419257,1236419377,4,1,120
9858951@N03,11610,13,1236903342,1236903582,4,3,240
9858951@N03,11610,30,1236915004,1236916037,4,3,1033
9858951@N03,11610,29,1236916037,1236916937,13,3,900
9858951@N03,11611,1,1236981087,1236981147,1,1,60
9858951@N03,11612,1,1237504931,1237504991,4,3,60
9858951@N03,11612,27,1237519564,1237519583,2,3,19
9858951@N03,11612,16,1237519583,1237519853,1,3,270
9858951@N03,11613,28,1238221579,1238222479,1,1,900
9858951@N03,11614,28,1238801343,1238802243,1,1,900
9858951@N03,11615,1,1239367111,1239367127,2,8,16
9858951@N03,11615,30,1239367127,1239367685,5,8,558
9858951@N03,11615,1,1239367685,1239367745,24,8,60
9858951@N03,11615,31,1239369625,1239369680,2,8,55
9858951@N03,11615,1,1239369680,1239369740,6,8,60
9858951@N03,11615,14,1239371443,1239371683,7,8,240
9858951@N03,11615,26,1239373972,1239374188,2,8,216
9858951@N03,11615,28,1239374188,1239375088,30,8,900
9858951@N03,11616,14,1239526940,1239527180,1,1,240
9858951@N03,11617,1,1240034597,1240034657,4,8,60
9858951@N03,11617,25,1240047004,1240047844,5,8,840
9858951@N03,11617,13,1240049324,1240049564,33,8,240
9858951@N03,11617,21,1240052651,1240052675,3,8,24
9858951@N03,11617,13,1240052675,1240052734,2,8,59
9858951@N03,11617,21,1240052734,1240053304,7,8,570
9858951@N03,11617,11,1240056773,1240057013,2,8,240
9858951@N03,11617,31,1240059733,1240061233,8,8,1500
9858951@N03,11618,28,1240296924,1240297824,5,1,900
9858951@N03,11619,28,1240547239,1240548139,2,1,900
9858951@N03,11620,14,1240890162,1240890402,2,2,240
9858951@N03,11620,22,1240896459,1240897059,2,2,600
9858951@N03,11621,28,1241132850,1241133530,13,6,680
9858951@N03,11621,1,1241133530,1241133590,6,6,60
9858951@N03,11621,29,1241140830,1241141730,44,6,900
9858951@N03,11621,18,1241170013,1241170463,3,6,450
9858951@N03,11621,28,1241172958,1241173858,2,6,900
9858951@N03,11621,1,1241187946,1241188006,6,6,60
9858951@N03,11622,24,1241876010,1241876790,21,8,780
9858951@N03,11622,15,1241878449,1241878682,26,8,233
9858951@N03,11622,27,1241878682,1241878686,3,8,4
9858951@N03,11622,15,1241878686,1241878956,17,8,270
9858951@N03,11622,27,1241879047,1241879163,4,8,116
9858951@N03,11622,16,1241879163,1241879182,2,8,19
9858951@N03,11622,27,1241879182,1241879811,2,8,629
9858951@N03,11622,1,1241879811,1241879871,6,8,60
9858951@N03,11623,1,1242811939,1242811999,14,8,60
9858951@N03,11623,28,1242812134,1242813034,4,8,900
9858951@N03,11623,1,1242813723,1242813783,2,8,60
9858951@N03,11623,31,1242815809,1242816428,16,8,619
9858951@N03,11623,20,1242816428,1242816968,54,8,540
9858951@N03,11623,13,1242817873,1242818048,13,8,175
9858951@N03,11623,25,1242818048,1242818888,5,8,840
9858951@N03,11623,28,1242819117,1242820017,28,8,900
9858951@N03,11624,26,1243118020,1243118920,125,2,900
9858951@N03,11624,28,1243136039,1243136939,31,2,900
9858951@N03,11625,26,1243653564,1243654464,6,1,900
9858951@N03,11626,26,1243750015,1243750915,2,1,900
9858951@N03,11627,19,1245322369,1245322909,7,1,540
9858951@N03,11628,26,1248512768,1248513668,1,1,900
9858951@N03,11629,26,1248680414,1248680416,2,2,2
9858951@N03,11629,13,1248680416,1248680656,2,2,240
9858951@N03,11630,1,1250313663,1250313723,3,1,60
9858951@N03,11631,22,1251259205,1251259805,4,3,600
9858951@N03,11631,30,1251261539,1251262619,4,3,1080
9858951@N03,11631,22,1251266643,1251267243,3,3,600
9858951@N03,11632,18,1252478890,1252479340,2,1,450
9858951@N03,11633,19,1252738223,1252738763,3,1,540
9858951@N03,11634,6,1254629538,1254629658,1,1,120
9858951@N03,11635,13,1255162167,1255162407,4,2,240
9858951@N03,11635,3,1255173337,1255173427,1,2,90
9858951@N03,11636,13,1255431151,1255431391,1,1,240
9858951@N03,11637,27,1258756227,1258757127,1,1,900
9858951@N03,11638,7,1259480588,1259480768,1,1,180
9858951@N03,11639,7,1259727681,1259727861,1,1,180
9858951@N03,11640,20,1264772278,1264772818,3,1,540
9858951@N03,11641,20,1264864133,1264864673,3,1,540
9858951@N03,11642,24,1271158633,1271159413,7,1,780
9858951@N03,11643,1,1271288580,1271288640,2,2,60
9858951@N03,11643,20,1271292873,1271293413,1,2,540
9858951@N03,11644,25,1271563458,1271564298,1,1,840
9858951@N03,11645,26,1273720006,1273720906,4,1,900
9858951@N03,11646,28,1273781324,1273782224,10,2,900
9858951@N03,11646,21,1273782808,1273783378,23,2,570
9858951@N03,11647,26,1274248820,1274249720,660,8,900
9858951@N03,11647,12,1274253453,1274253535,10,8,82
9858951@N03,11647,26,1274253535,1274254435,36,8,900
9858951@N03,11647,28,1274258359,1274259259,59,8,900
9858951@N03,11647,18,1274259776,1274260226,3,8,450
9858951@N03,11647,1,1274260691,1274260751,5,8,60
9858951@N03,11647,29,1274265285,1274266185,5,8,900
9858951@N03,11647,23,1274267328,1274267928,12,8,600
9858951@N03,11648,1,1275370250,1275370252,2,8,2
9858951@N03,11648,28,1275370252,1275370259,3,8,7
9858951@N03,11648,16,1275370259,1275370262,2,8,3
9858951@N03,11648,26,1275370262,1275370273,3,8,11
9858951@N03,11648,28,1275370273,1275370279,3,8,6
9858951@N03,11648,1,1275370279,1275370304,11,8,25
9858951@N03,11648,28,1275370304,1275370310,3,8,6
9858951@N03,11648,1,1275370310,1275370370,1,8,60
9858951@N03,11649,7,1276921041,1276921221,1,1,180
9858951@N03,11650,28,1282255309,1282255312,2,4,3
9858951@N03,11650,1,1282255312,1282255312,2,4,0
9858951@N03,11650,26,1282255312,1282255313,2,4,1
9858951@N03,11650,1,1282255313,1282255373,14,4,60
9858951@N03,11651,25,1316149317,1316150157,2,1,840
9858951@N03,11652,28,1316651765,1316652665,1,1,900
9858951@N03,11653,29,1345006623,1345007523,1,1,900
9858951@N03,11654,19,1345042911,1345043451,3,1,540
9858951@N03,11655,1,1345491965,1345491967,2,6,2
9858951@N03,11655,16,1345491967,1345491971,2,6,4
9858951@N03,11655,26,1345491971,1345491973,2,6,2
9858951@N03,11655,20,1345491973,1345491976,2,6,3
9858951@N03,11655,26,1345491976,1345491978,2,6,2
9858951@N03,11655,19,1345491978,1345492518,1,6,540
9858951@N03,11656,29,1345546894,1345547794,3,1,900
9858951@N03,11657,19,1345836843,1345837383,2,2,540
9858951@N03,11657,18,1345844008,1345844458,1,2,450
9858951@N03,11658,25,1346044868,1346045708,1,1,840
9858951@N03,11659,28,1346204320,1346205220,2,1,900
9858951@N03,11660,18,1346742339,1346742789,1,1,450
9858951@N03,11661,23,1346892667,1346893267,1,1,600
9858951@N03,11662,25,1347345638,1347346478,1,1,840
9858951@N03,11663,19,1349104231,1349104771,1,1,540
9858951@N03,11664,19,1349317923,1349318463,2,1,540
9858951@N03,11665,18,1355182313,1355182763,6,1,450
9858951@N03,11666,18,1355375002,1355375452,4,1,450
98636389@N06,11667,15,1401347320,1401347590,2,1,270
98663457@N00,11668,30,1359689722,1359690802,1,1,1080
98663457@N00,11669,26,1359972126,1359973026,2,1,900
98672552@N00,11670,13,1189912897,1189913137,1,1,240
98672552@N00,11671,17,1190344193,1190344493,2,4,300
98672552@N00,11671,10,1190347323,1190347563,2,4,240
98672552@N00,11671,28,1190352541,1190353441,5,4,900
98672552@N00,11671,29,1190371990,1190372890,1,4,900
98672552@N00,11672,1,1191563911,1191563971,4,5,60
98672552@N00,11672,28,1191564269,1191564835,2,5,566
98672552@N00,11672,30,1191564835,1191565124,5,5,289
98672552@N00,11672,29,1191565124,1191566024,7,5,900
98672552@N00,11672,28,1191568302,1191569202,1,5,900
98672552@N00,11673,25,1192921816,1192921906,2,13,90
98672552@N00,11673,13,1192921906,1192922146,2,13,240
98672552@N00,11673,3,1192923488,1192923578,4,13,90
98672552@N00,11673,21,1192924823,1192925393,2,13,570
98672552@N00,11673,30,1192935006,1192936086,8,13,1080
98672552@N00,11673,3,1192937219,1192937309,2,13,90
98672552@N00,11673,16,1192938245,1192938515,2,13,270
98672552@N00,11673,17,1192940052,1192940352,2,13,300
98672552@N00,11673,26,1192940366,1192941266,3,13,900
98672552@N00,11673,29,1192941946,1192942846,7,13,900
98672552@N00,11673,30,1192943324,1192944404,6,13,1080
98672552@N00,11673,16,1192948371,1192948641,9,13,270
98672552@N00,11673,28,1192950234,1192951134,1,13,900
98672552@N00,11674,26,1256167860,1256168760,2,3,900
98672552@N00,11674,30,1256169369,1256170449,2,3,1080
98672552@N00,11674,13,1256177347,1256177587,1,3,240
98672552@N00,11675,7,1264149711,1264149891,1,1,180
98684111@N07,11676,1,1372202198,1372202258,10,9,60
98684111@N07,11676,24,1372210818,1372210902,3,9,84
98684111@N07,11676,1,1372210902,1372210950,2,9,48
98684111@N07,11676,24,1372210950,1372211730,2,9,780
98684111@N07,11676,1,1372212581,1372212641,3,9,60
98684111@N07,11676,28,1372212710,1372212808,2,9,98
98684111@N07,11676,1,1372212808,1372212868,3,9,60
98684111@N07,11676,28,1372213147,1372214047,2,9,900
98684111@N07,11676,1,1372215912,1372215972,9,9,60
98684111@N07,11677,1,1372291954,1372292014,4,3,60
98684111@N07,11677,28,1372307146,1372308046,5,3,900
98684111@N07,11677,1,1372309162,1372309222,3,3,60
98684111@N07,11678,1,1372414737,1372414797,1,1,60
9868739@N04,11679,12,1364429931,1364430171,1,1,240
98735721@N06,11680,1,1373521159,1373521219,2,1,60
98798579@N00,11681,16,1347091105,1347091375,2,2,270
98798579@N00,11681,13,1347093803,1347094043,1,2,240
98798579@N00,11682,26,1354986830,1354987730,1,1,900
98798579@N00,11683,27,1355122160,1355123060,1,1,900
9885001@N08,11684,15,1311230957,1311231207,2,3,250
9885001@N08,11684,17,1311231207,1311231507,2,3,300
9885001@N08,11684,13,1311239409,1311239649,1,3,240
9885152@N08,11685,1,1451265199,1451265259,1,1,60
98927091@N08,11686,20,1383042481,1383043021,1,1,540
98988031@N02,11687,28,1218752660,1218753560,3,2,900
98988031@N02,11687,13,1218757552,1218757792,2,2,240
98988031@N02,11688,28,1218809407,1218809778,3,2,371
98988031@N02,11688,26,1218809778,1218810678,3,2,900
99016667@N00,11689,21,1325990949,1325991519,2,3,570
99016667@N00,11689,25,1325992568,1325993408,2,3,840
99016667@N00,11689,22,1325995234,1325995834,1,3,600
99016667@N00,11690,11,1331855382,1331855622,3,3,240
99016667@N00,11690,19,1331856823,1331857363,2,3,540
99016667@N00,11690,29,1331870043,1331870943,1,3,900
99016667@N00,11691,7,1338884334,1338884514,2,5,180
99016667@N00,11691,21,1338884811,1338884867,2,5,56
99016667@N00,11691,5,1338884867,1338884987,4,5,120
99016667@N00,11691,3,1338886230,1338886320,2,5,90
99016667@N00,11691,21,1338886353,1338886923,1,5,570
99020953@N02,11692,22,1458905540,1458906140,1,1,600
99162408@N00,11693,13,1325936563,1325936803,1,1,240
99193556@N06,11694,14,1459224339,1459224579,4,4,240
99193556@N06,11694,29,1459240000,1459240327,2,4,327
99193556@N06,11694,23,1459240327,1459240927,2,4,600
99193556@N06,11694,15,1459244652,1459244922,8,4,270
99210863@N07,11695,18,1457244359,1457244809,2,1,450
99238380@N02,11696,13,1371796594,1371796834,1,1,240
99244170@N03,11697,15,1327101079,1327101085,3,12,6
99244170@N03,11697,12,1327101085,1327101325,10,12,240
99244170@N03,11697,24,1327102889,1327103669,6,12,780
99244170@N03,11697,17,1327105425,1327105725,2,12,300
99244170@N03,11697,14,1327106166,1327106406,5,12,240
99244170@N03,11697,22,1327107070,1327107343,3,12,273
99244170@N03,11697,29,1327107343,1327108243,5,12,900
99244170@N03,11697,15,1327115502,1327115772,13,12,270
99244170@N03,11697,16,1327122962,1327123232,18,12,270
99244170@N03,11697,1,1327124341,1327124401,3,12,60
99244170@N03,11697,21,1327127879,1327128449,7,12,570
99244170@N03,11697,28,1327135732,1327136632,2,12,900
99253695@N00,11698,1,1317719792,1317719852,2,6,60
99253695@N00,11698,28,1317719869,1317720769,4,6,900
99253695@N00,11698,23,1317722203,1317722803,2,6,600
99253695@N00,11698,26,1317725209,1317726109,6,6,900
99253695@N00,11698,17,1317726380,1317726680,10,6,300
99253695@N00,11698,1,1317729716,1317729776,2,6,60
9926279@N03,11699,14,1416073899,1416074139,3,3,240
9926279@N03,11699,30,1416079851,1416080115,2,3,264
9926279@N03,11699,6,1416080115,1416080235,1,3,120
9926279@N03,11700,30,1421435661,1421436741,1,1,1080
9926279@N03,11701,7,1441484355,1441484535,2,2,180
9926279@N03,11701,21,1441484823,1441485393,3,2,570
99292329@N03,11702,16,1382083657,1382083927,9,10,270
99292329@N03,11702,25,1382086297,1382086546,5,10,249
99292329@N03,11702,21,1382086546,1382087116,2,10,570
99292329@N03,11702,11,1382087121,1382087361,2,10,240
99292329@N03,11702,31,1382089844,1382089972,3,10,128
99292329@N03,11702,20,1382089972,1382090512,3,10,540
99292329@N03,11702,16,1382096024,1382096294,27,10,270
99292329@N03,11702,26,1382098630,1382099530,7,10,900
99292329@N03,11702,28,1382103063,1382103246,6,10,183
99292329@N03,11702,1,1382103246,1382103306,5,10,60
99292329@N03,11703,1,1382133393,1382133453,3,1,60
99313869@N04,11704,16,1378870011,1378870281,1,1,270
99357189@N00,11705,1,1360709708,1360709768,2,2,60
99357189@N00,11705,26,1360710602,1360711502,77,2,900
99364192@N07,11706,22,1364520820,1364521420,2,1,600
9937502@N05,11707,29,1445425824,1445426724,1,1,900
99389853@N03,11708,26,1405489701,1405490601,1,1,900
99395292@N02,11709,11,1413799155,1413799395,1,1,240
99406544@N00,11710,15,1398605605,1398605875,2,2,270
99406544@N00,11710,14,1398606203,1398606443,1,2,240
9943904@N03,11711,28,1261613819,1261614719,2,5,900
9943904@N03,11711,21,1261615245,1261615815,2,5,570
9943904@N03,11711,31,1261622593,1261624093,6,5,1500
9943904@N03,11711,16,1261627444,1261627714,4,5,270
9943904@N03,11711,28,1261648304,1261649204,3,5,900
99471343@N00,11712,20,1313555214,1313555754,2,1,540
99471343@N00,11713,4,1313617567,1313617668,6,4,101
99471343@N00,11713,11,1313621640,1313621880,3,4,240
99471343@N00,11713,13,1313625726,1313625966,10,4,240
99471343@N00,11713,24,1313642541,1313643321,1,4,780
99471343@N00,11714,16,1313796840,1313797110,10,1,270
99472108@N06,11715,28,1377428410,1377429310,1,1,900
99519186@N03,11716,1,1374984529,1374984530,6,3,1
99519186@N03,11716,20,1374984530,1374984666,4,3,136
99519186@N03,11716,1,1374984666,1374984726,1,3,60
99519186@N03,11717,29,1375059323,1375060223,10,1,900
99519186@N03,11718,1,1375855167,1375855227,1,1,60
99519186@N03,11719,29,1376212758,1376213658,18,1,900
99519186@N03,11720,29,1377650659,1377651559,3,1,900
99519186@N03,11721,29,1378511948,1378512848,2,1,900
99519186@N03,11722,29,1379147116,1379148016,1,1,900
99519186@N03,11723,29,1379461772,1379462672,2,1,900
99552910@N00,11724,17,1236917713,1236918013,1,1,300
99578286@N04,11725,1,1372224130,1372224190,3,3,60
99578286@N04,11725,26,1372228857,1372229757,5,3,900
99578286@N04,11725,1,1372251725,1372251785,2,3,60
99578286@N04,11726,19,1380172991,1380173044,3,5,53
99578286@N04,11726,29,1380173044,1380173260,2,5,216
99578286@N04,11726,31,1380173260,1380174760,2,5,1500
99578286@N04,11726,20,1380175329,1380175869,5,5,540
99578286@N04,11726,30,1380181526,1380182606,15,5,1080
99578286@N04,11727,29,1420422324,1420422332,2,3,8
99578286@N04,11727,1,1420422332,1420422392,3,3,60
99578286@N04,11727,26,1420436907,1420437807,18,3,900
99591369@N06,11728,1,1373068812,1373068872,2,6,60
99591369@N06,11728,26,1373069722,1373070622,15,6,900
99591369@N06,11728,25,1373073514,1373074354,2,6,840
99591369@N06,11728,26,1373078760,1373079660,2,6,900
99591369@N06,11728,27,1373083926,1373084826,3,6,900
99591369@N06,11728,16,1373086945,1373087215,4,6,270
99591369@N06,11729,26,1374133856,1374134756,7,1,900
99591369@N06,11730,16,1375112440,1375112710,1,1,270
99598380@N08,11731,16,1432516702,1432516972,3,2,270
99598380@N08,11731,13,1432519875,1432520115,2,2,240
99608747@N00,11732,15,1342861326,1342861493,2,4,167
99608747@N00,11732,13,1342861493,1342861604,2,4,111
99608747@N00,11732,30,1342861604,1342862684,3,4,1080
99608747@N00,11732,3,1342872803,1342872893,1,4,90
99608747@N00,11733,29,1343136984,1343137884,1,1,900
99608747@N00,11734,1,1374296392,1374296452,1,1,60
99608747@N00,11735,25,1374364153,1374364993,1,1,840
99632250@N07,11736,31,1324685453,1324686953,1,1,1500
99707950@N00,11737,7,1323550663,1323550843,1,1,180
99707950@N00,11738,13,1349140509,1349140749,1,1,240
99711918@N00,11739,28,1318849911,1318850811,1,1,900
9979792@N04,11740,29,1279432016,1279432916,1,1,900
9979792@N04,11741,1,1287091330,1287091390,1,1,60
99803265@N00,11742,26,1189571701,1189572601,1,1,900
99804076@N02,11743,1,1444279888,1444279948,2,2,60
99804076@N02,11743,26,1444280149,1444281049,3,2,900
99804076@N02,11744,5,1444365442,1444365562,1,1,120
99814844@N00,11745,22,1340346378,1340346978,1,1,600
99855129@N00,11746,29,1386380738,1386381473,7,8,735
99855129@N00,11746,19,1386381473,1386382013,3,8,540
99855129@N00,11746,18,1386382558,1386383008,3,8,450
99855129@N00,11746,23,1386408882,1386409482,2,8,600
99855129@N00,11746,26,1386415619,1386416519,9,8,900
99855129@N00,11746,21,1386418574,1386419144,3,8,570
99855129@N00,11746,25,1386419760,1386420600,2,8,840
99855129@N00,11746,16,1386423721,1386423991,1,8,270
99855129@N00,11747,27,1391867783,1391868683,1,1,900
99855129@N00,11748,28,1427059546,1427060446,4,8,900
99855129@N00,11748,18,1427062237,1427062687,5,8,450
99855129@N00,11748,15,1427081509,1427081779,8,8,270
99855129@N00,11748,28,1427087086,1427087986,7,8,900
99855129@N00,11748,19,1427090596,1427091136,2,8,540
99855129@N00,11748,29,1427094538,1427095438,8,8,900
99855129@N00,11748,28,1427108259,1427109159,3,8,900
99855129@N00,11748,17,1427112678,1427112978,1,8,300
99855129@N00,11749,28,1427238307,1427239207,2,6,900
99855129@N00,11749,26,1427256194,1427257094,2,6,900
99855129@N00,11749,29,1427257685,1427258585,2,6,900
99855129@N00,11749,30,1427259294,1427260374,3,6,1080
99855129@N00,11749,28,1427262574,1427263474,2,6,900
99855129@N00,11749,20,1427270250,1427270790,3,6,540
99855129@N00,11750,28,1427322875,1427323775,2,2,900
99855129@N00,11750,30,1427328923,1427330003,1,2,1080
99855129@N00,11751,26,1427363538,1427363812,2,2,274
99855129@N00,11751,28,1427363812,1427364712,2,2,900
99855129@N00,11752,28,1427408157,1427408952,3,11,795
99855129@N00,11752,27,1427408952,1427409852,4,11,900
99855129@N00,11752,16,1427410921,1427411191,2,11,270
99855129@N00,11752,27,1427411637,1427412537,2,11,900
99855129@N00,11752,31,1427415741,1427417241,2,11,1500
99855129@N00,11752,28,1427417243,1427418143,8,11,900
99855129@N00,11752,26,1427422685,1427423585,3,11,900
99855129@N00,11752,10,1427425113,1427425353,2,11,240
99855129@N00,11752,13,1427426829,1427427069,2,11,240
99855129@N00,11752,16,1427428234,1427428504,5,11,270
99855129@N00,11752,28,1427438991,1427439891,1,11,900
9986207@N02,11753,26,1433504086,1433504986,10,3,900
9986207@N02,11753,16,1433510341,1433510611,4,3,270
9986207@N02,11753,20,1433513046,1433513586,2,3,540
99929919@N08,11754,14,1416023069,1416023309,1,1,240
99942665@N00,11755,30,1306562804,1306563884,28,1,1080
99961547@N00,11756,15,1462366322,1462366592,1,1,270
99976517@N00,11757,30,1291440186,1291441266,1,1,1080
99987318@N03,11758,30,1424472568,1424473648,2,3,1080
99987318@N03,11758,26,1424480124,1424481024,2,3,900
99987318@N03,11758,30,1424504807,1424505887,1,3,1080
