userID,trajID,poiID,startTime,endTime,#photo,trajLen,poiDuration
10005149@N03,1,5,1274095158,1274096058,1,1,900
10008488@N07,2,6,1354345925,1354346945,2,1,1020
100320969@N08,3,2,1375140897,1375141287,200,1,390
100354657@N04,4,8,1363864004,1363865144,1,1,1140
10039169@N06,5,4,1202198535,1202199435,2,1,900
100436193@N03,6,1,1419228064,1419228154,1,1,90
100448554@N06,7,2,1340768886,1340769276,1,1,390
100459519@N02,8,1,1430730654,1430730744,1,1,90
100459519@N02,9,1,1462967483,1462967573,13,1,90
100483258@N08,10,6,1408182937,1408183957,1,1,1020
10048675@N02,11,5,1233440737,1233441637,2,2,900
10048675@N02,11,8,1233454191,1233455331,1,2,1140
10048675@N02,12,2,1234477057,1234477447,4,2,390
10048675@N02,12,8,1234478064,1234479204,1,2,1140
10048675@N02,13,5,1234555645,1234556545,1,1,900
100506822@N02,14,6,1387783960,1387784743,4,2,783
100506822@N02,14,4,1387784743,1387785643,6,2,900
100620414@N03,15,8,1461545701,1461545704,2,4,3
100620414@N03,15,11,1461545704,1461547204,2,4,1500
100620414@N03,15,8,1461549014,1461550154,3,4,1140
100620414@N03,15,5,1461551576,1461552476,8,4,900
100691062@N08,16,13,1403232016,1403233816,1,1,1800
100747900@N02,17,1,1312430318,1312430408,1,1,90
100775193@N08,18,12,1384806405,1384807905,1,1,1500
100775193@N08,19,4,1401150188,1401151088,1,1,900
100775237@N03,20,1,1341064800,1341064800,3,6,0
100775237@N03,20,4,1341064800,1341064800,2,6,0
100775237@N03,20,5,1341064800,1341064800,2,6,0
100775237@N03,20,8,1341064800,1341064800,2,6,0
100775237@N03,20,10,1341064800,1341064800,3,6,0
100775237@N03,20,13,1341064800,1341066600,1,6,1800
100775237@N03,21,1,1372600800,1372600800,2,4,0
100775237@N03,21,5,1372600800,1372600800,2,4,0
100775237@N03,21,9,1372600800,1372600800,4,4,0
100775237@N03,21,10,1372600800,1372602300,1,4,1500
100775237@N03,22,10,1405491145,1405492645,3,4,1500
100775237@N03,22,6,1405496170,1405497190,3,4,1020
100775237@N03,22,9,1405504983,1405506483,4,4,1500
100775237@N03,22,1,1405507959,1405508049,1,4,90
100775237@N03,23,5,1405728273,1405728313,2,4,40
100775237@N03,23,10,1405728313,1405729813,2,4,1500
100775237@N03,23,13,1405730809,1405731475,2,4,666
100775237@N03,23,1,1405731475,1405731565,1,4,90
100775237@N03,24,9,1405853910,1405855410,3,2,1500
100775237@N03,24,1,1405859263,1405859353,2,2,90
100822654@N07,25,2,1400915809,1400915881,2,2,72
100822654@N07,25,8,1400915881,1400917021,1,2,1140
100822654@N07,26,4,1400958812,1400959712,7,5,900
100822654@N07,26,10,1400966179,1400967679,3,5,1500
100822654@N07,26,6,1400977027,1400977570,2,5,543
100822654@N07,26,10,1400977570,1400979070,6,5,1500
100822654@N07,26,6,1400979105,1400980125,3,5,1020
10084809@N04,27,10,1459769420,1459770920,1,1,1500
100948027@N07,28,13,1315211339,1315213139,1,1,1800
101044534@N02,29,1,1380943080,1380943170,2,2,90
101044534@N02,29,8,1380945700,1380946840,1,2,1140
101195207@N02,30,10,1466733859,1466735359,2,7,1500
101195207@N02,30,1,1466739658,1466739748,2,7,90
101195207@N02,30,5,1466739786,1466740686,5,7,900
101195207@N02,30,10,1466747635,1466749135,7,7,1500
101195207@N02,30,1,1466750092,1466750182,2,7,90
101195207@N02,30,8,1466750230,1466751370,3,7,1140
101195207@N02,30,2,1466752480,1466752870,8,7,390
101282917@N07,31,1,1372820336,1372820426,4,1,90
101324125@N05,32,8,1373085892,1373087032,3,4,1140
101324125@N05,32,12,1373089924,1373091424,5,4,1500
101324125@N05,32,4,1373096671,1373096711,2,4,40
101324125@N05,32,6,1373096711,1373097731,1,4,1020
101445497@N05,33,2,1222056461,1222056702,2,3,241
101445497@N05,33,1,1222056702,1222056792,3,3,90
101445497@N05,33,2,1222085178,1222085568,3,3,390
101445497@N05,34,1,1353301772,1353301862,3,3,90
101445497@N05,34,6,1353311101,1353312121,2,3,1020
101445497@N05,34,2,1353322793,1353323183,1,3,390
101445497@N05,35,8,1369526812,1369527078,2,2,266
101445497@N05,35,4,1369527078,1369527978,1,2,900
101445497@N05,36,6,1433049345,1433050365,2,7,1020
101445497@N05,36,2,1433052961,1433053351,4,7,390
101445497@N05,36,13,1433055154,1433056954,4,7,1800
101445497@N05,36,1,1433060042,1433060132,2,7,90
101445497@N05,36,6,1433063323,1433064343,2,7,1020
101445497@N05,36,2,1433064454,1433064844,3,7,390
101445497@N05,36,4,1433065021,1433065921,1,7,900
10156308@N03,37,6,1418888793,1418889813,10,2,1020
10156308@N03,37,9,1418894601,1418896101,3,2,1500
10156308@N03,38,8,1418955350,1418956490,1,1,1140
10156308@N03,39,6,1419154366,1419155386,2,1,1020
101593101@N02,40,6,1449044736,1449045756,1,1,1020
101644764@N07,41,2,1287618396,1287618786,1,1,390
10175710@N03,42,5,1374552797,1374553697,1,1,900
10183029@N00,43,8,1326671795,1326672935,65,1,1140
10196023@N00,44,8,1342984200,1342985340,1,1,1140
102284959@N03,45,1,1378513647,1378513737,3,1,90
102284959@N03,46,6,1380404127,1380405147,2,1,1020
102284959@N03,47,13,1443012610,1443014410,2,2,1800
102284959@N03,47,1,1443016325,1443016415,3,2,90
10259875@N03,48,1,1204290000,1204290000,2,4,0
10259875@N03,48,2,1204290000,1204290000,2,4,0
10259875@N03,48,8,1204290000,1204290000,2,4,0
10259875@N03,48,10,1204290000,1204291500,1,4,1500
10259875@N03,49,8,1206195892,1206197032,1,1,1140
10259875@N03,50,8,1206244114,1206245254,1,1,1140
10259875@N03,51,1,1231453610,1231453700,2,5,90
10259875@N03,51,2,1231457334,1231457724,2,5,390
10259875@N03,51,1,1231477200,1231477290,2,5,90
10259875@N03,51,12,1231479743,1231481243,2,5,1500
10259875@N03,51,8,1231494447,1231495587,1,5,1140
10259875@N03,52,1,1241348427,1241348517,2,1,90
10259875@N03,53,1,1262493314,1262493404,8,3,90
10259875@N03,53,9,1262504628,1262506128,5,3,1500
10259875@N03,53,1,1262506367,1262506457,1,3,90
10259875@N03,54,1,1262564319,1262564409,2,15,90
10259875@N03,54,10,1262565638,1262567011,5,15,1373
10259875@N03,54,5,1262567011,1262567911,8,15,900
10259875@N03,54,1,1262570921,1262571011,4,15,90
10259875@N03,54,13,1262588647,1262589042,2,15,395
10259875@N03,54,6,1262589042,1262590062,3,15,1020
10259875@N03,54,13,1262591122,1262591880,2,15,758
10259875@N03,54,1,1262591880,1262591970,2,15,90
10259875@N03,54,2,1262592780,1262593108,2,15,328
10259875@N03,54,11,1262593108,1262593171,2,15,63
10259875@N03,54,2,1262593171,1262593561,2,15,390
10259875@N03,54,5,1262595338,1262595557,2,15,219
10259875@N03,54,1,1262595557,1262595647,2,15,90
10259875@N03,54,8,1262597911,1262599051,4,15,1140
10259875@N03,54,2,1262600974,1262601364,1,15,390
10259875@N03,55,5,1274054985,1274055885,2,6,900
10259875@N03,55,1,1274056085,1274056175,2,6,90
10259875@N03,55,13,1274062221,1274064021,2,6,1800
10259875@N03,55,6,1274065705,1274066725,2,6,1020
10259875@N03,55,2,1274069480,1274069870,4,6,390
10259875@N03,55,1,1274081559,1274081649,2,6,90
10259875@N03,56,1,1303007011,1303007101,3,3,90
10259875@N03,56,10,1303029633,1303031133,2,3,1500
10259875@N03,56,9,1303033447,1303034947,1,3,1500
10259875@N03,57,5,1322174101,1322175001,2,5,900
10259875@N03,57,8,1322175464,1322176604,2,5,1140
10259875@N03,57,12,1322177115,1322178313,2,5,1198
10259875@N03,57,1,1322178313,1322178403,2,5,90
10259875@N03,57,10,1322179228,1322180728,1,5,1500
10259875@N03,58,11,1364599868,1364601368,5,3,1500
10259875@N03,58,1,1364605221,1364605311,2,3,90
10259875@N03,58,5,1364607299,1364608199,2,3,900
10259875@N03,59,8,1392689359,1392690499,4,6,1140
10259875@N03,59,6,1392691202,1392692222,3,6,1020
10259875@N03,59,1,1392699297,1392699387,2,6,90
10259875@N03,59,6,1392700944,1392701964,4,6,1020
10259875@N03,59,5,1392703614,1392704514,3,6,900
10259875@N03,59,1,1392706981,1392707071,3,6,90
10259875@N03,60,8,1428380197,1428381337,3,8,1140
10259875@N03,60,1,1428393713,1428393803,2,8,90
10259875@N03,60,5,1428395022,1428395321,2,8,299
10259875@N03,60,10,1428395321,1428396821,2,8,1500
10259875@N03,60,1,1428397836,1428397926,2,8,90
10259875@N03,60,13,1428398337,1428398691,2,8,354
10259875@N03,60,8,1428398691,1428399235,2,8,544
10259875@N03,60,1,1428399235,1428399325,2,8,90
10266387@N07,61,4,1422264791,1422265691,1,1,900
10295241@N02,62,1,1446963129,1446963219,1,1,90
10297435@N03,63,1,1340772037,1340772127,12,1,90
10310250@N02,64,10,1281664988,1281666488,1,1,1500
10350193@N07,65,6,1419593709,1419594729,5,1,1020
103792860@N03,66,4,1353211390,1353212290,7,1,900
103955312@N02,67,1,1402529256,1402529346,2,3,90
103955312@N02,67,5,1402549370,1402550270,4,3,900
103955312@N02,67,10,1402554444,1402555944,1,3,1500
10414404@N08,68,1,1406093648,1406093738,3,1,90
104152796@N05,69,5,1423632576,1423633476,2,2,900
104152796@N05,69,9,1423636670,1423638170,2,2,1500
10455863@N03,70,4,1339240607,1339241244,2,2,637
10455863@N03,70,5,1339241244,1339242144,2,2,900
10495641@N00,71,4,1336173094,1336173994,1,1,900
105156445@N06,72,1,1408429140,1408429230,2,5,90
105156445@N06,72,13,1408429237,1408430877,2,5,1640
105156445@N06,72,6,1408430877,1408431897,5,5,1020
105156445@N06,72,12,1408436263,1408437763,2,5,1500
105156445@N06,72,4,1408439026,1408439926,2,5,900
10529536@N05,73,8,1299034201,1299035341,3,1,1140
105380744@N04,74,5,1382057252,1382058152,2,4,900
105380744@N04,74,1,1382059289,1382059379,3,4,90
105380744@N04,74,6,1382071908,1382072928,6,4,1020
105380744@N04,74,8,1382081162,1382082302,4,4,1140
10570686@N02,75,8,1236977235,1236978375,12,1,1140
10570686@N02,76,8,1268514597,1268515737,4,1,1140
10572043@N03,77,5,1305341252,1305342152,1,1,900
105763347@N06,78,13,1357021189,1357022989,2,3,1800
105763347@N06,78,6,1357027714,1357028734,2,3,1020
105763347@N06,78,1,1357035002,1357035092,1,3,90
10583070@N05,79,10,1228495023,1228495763,5,6,740
10583070@N05,79,5,1228495763,1228496663,4,6,900
10583070@N05,79,7,1228498558,1228498594,4,6,36
10583070@N05,79,8,1228498594,1228499734,3,6,1140
10583070@N05,79,1,1228501179,1228501269,2,6,90
10583070@N05,79,4,1228501615,1228502515,1,6,900
105833253@N02,80,6,1375576988,1375578008,2,2,1020
105833253@N02,80,1,1375593594,1375593684,1,2,90
106045902@N02,81,1,1366155945,1366156035,2,4,90
106045902@N02,81,8,1366156084,1366157224,2,4,1140
106045902@N02,81,11,1366160963,1366162463,2,4,1500
106045902@N02,81,1,1366173376,1366173466,1,4,90
10617321@N00,82,12,1464772284,1464773784,1,1,1500
106475835@N05,83,7,1358599267,1358600287,4,1,1020
106475835@N05,84,7,1366984498,1366985518,1,1,1020
106558608@N06,85,4,1463266795,1463267695,8,9,900
106558608@N06,85,5,1463269265,1463269733,4,9,468
106558608@N06,85,8,1463269733,1463270583,3,9,850
106558608@N06,85,11,1463270583,1463272083,3,9,1500
106558608@N06,85,2,1463272332,1463272632,9,9,300
106558608@N06,85,8,1463272632,1463272703,2,9,71
106558608@N06,85,2,1463272703,1463273093,5,9,390
106558608@N06,85,4,1463291771,1463292671,2,9,900
106558608@N06,85,9,1463307376,1463308876,11,9,1500
10673595@N00,86,7,1463545160,1463546180,1,1,1020
10692931@N08,87,10,1229564262,1229565762,3,4,1500
10692931@N08,87,5,1229568631,1229569531,2,4,900
10692931@N08,87,2,1229587000,1229587390,2,4,390
10692931@N08,87,1,1229591413,1229591503,1,4,90
106980455@N06,88,10,1386383408,1386383861,2,11,453
106980455@N06,88,1,1386383861,1386383951,2,11,90
106980455@N06,88,5,1386384074,1386384974,2,11,900
106980455@N06,88,7,1386386416,1386386478,2,11,62
106980455@N06,88,8,1386386478,1386386668,3,11,190
106980455@N06,88,2,1386386668,1386386928,3,11,260
106980455@N06,88,6,1386386928,1386387948,8,11,1020
106980455@N06,88,8,1386391086,1386392226,2,11,1140
106980455@N06,88,7,1386392885,1386393905,3,11,1020
106980455@N06,88,1,1386394585,1386394675,6,11,90
106980455@N06,88,6,1386399728,1386400748,11,11,1020
10703707@N07,89,6,1320445808,1320446828,2,1,1020
107084948@N08,90,1,1383875168,1383875258,65,1,90
10774763@N05,91,1,1251941192,1251941282,4,5,90
10774763@N05,91,5,1251943774,1251944674,22,5,900
10774763@N05,91,1,1251947736,1251947826,5,5,90
10774763@N05,91,8,1251947838,1251948978,6,5,1140
10774763@N05,91,13,1251949889,1251951689,1,5,1800
10782871@N00,92,4,1399876292,1399877192,2,2,900
10782871@N00,92,1,1399879728,1399879818,1,2,90
107905375@N06,93,10,1455163940,1455165440,5,11,1500
107905375@N06,93,6,1455166868,1455167185,2,11,317
107905375@N06,93,8,1455167185,1455168325,2,11,1140
107905375@N06,93,13,1455173571,1455174930,2,11,1359
107905375@N06,93,6,1455174930,1455175950,7,11,1020
107905375@N06,93,7,1455177806,1455178134,3,11,328
107905375@N06,93,1,1455178134,1455178224,2,11,90
107905375@N06,93,7,1455178296,1455179316,3,11,1020
107905375@N06,93,12,1455179453,1455179506,2,11,53
107905375@N06,93,7,1455179506,1455179511,2,11,5
107905375@N06,93,12,1455179511,1455181011,8,11,1500
108140637@N08,94,8,1375174229,1375175369,6,4,1140
108140637@N08,94,1,1375178002,1375178092,3,4,90
108140637@N08,94,10,1375178149,1375178652,2,4,503
108140637@N08,94,9,1375178652,1375180152,20,4,1500
108207234@N02,95,1,1426378741,1426378831,2,2,90
108207234@N02,95,8,1426380439,1426381579,1,2,1140
108207234@N02,96,1,1464334345,1464334435,4,2,90
108207234@N02,96,10,1464341933,1464343433,1,2,1500
108231769@N08,97,6,1397719210,1397720230,4,1,1020
108231769@N08,98,9,1397750579,1397752079,6,1,1500
10857883@N05,99,8,1270872006,1270873146,2,2,1140
10857883@N05,99,9,1270875077,1270876577,4,2,1500
10858077@N00,100,2,1207263707,1207264097,1,1,390
10864775@N02,101,6,1299307707,1299308727,1,1,1020
108906145@N05,102,5,1394678139,1394679039,1,1,900
109002055@N07,103,5,1367565166,1367566066,1,1,900
10902412@N03,104,5,1367877802,1367878702,1,1,900
10902412@N03,105,9,1367925858,1367927358,1,1,1500
10905622@N03,106,1,1188881634,1188881724,1,1,90
10925918@N03,107,1,1277351159,1277351249,2,4,90
10925918@N03,107,2,1277358586,1277358976,2,4,390
10925918@N03,107,6,1277365809,1277366829,2,4,1020
10925918@N03,107,8,1277368163,1277369303,1,4,1140
10925918@N03,108,5,1362354481,1362355381,2,3,900
10925918@N03,108,4,1362356439,1362357339,2,3,900
10925918@N03,108,6,1362372471,1362373491,1,3,1020
10925918@N03,109,5,1362536223,1362537123,2,3,900
10925918@N03,109,10,1362544548,1362546048,2,3,1500
10925918@N03,109,9,1362551032,1362552532,1,3,1500
109402089@N08,110,1,1381654050,1381654140,1,1,90
109554486@N07,111,1,1384472828,1384472918,3,6,90
109554486@N07,111,6,1384483292,1384484312,8,6,1020
109554486@N07,111,1,1384486624,1384486714,5,6,90
109554486@N07,111,8,1384488927,1384490067,2,6,1140
109554486@N07,111,6,1384492333,1384493353,18,6,1020
109554486@N07,111,10,1384505777,1384507277,1,6,1500
10983978@N03,112,11,1215939049,1215940549,1,1,1500
10983978@N03,113,6,1221377395,1221378415,2,1,1020
10983978@N03,114,8,1245506227,1245507367,1,1,1140
10983978@N03,115,4,1256508723,1256509623,1,1,900
10983978@N03,116,11,1257032544,1257034044,1,1,1500
10983978@N03,117,8,1271400342,1271401482,1,1,1140
10983978@N03,118,1,1294054654,1294054744,1,1,90
10983978@N03,119,1,1302876000,1302876000,3,2,0
10983978@N03,119,8,1302876000,1302877140,1,2,1140
10983978@N03,120,4,1306760345,1306761245,1,1,900
10983978@N03,121,5,1307023200,1307024100,1,1,900
10989907@N07,122,6,1385854170,1385854288,2,10,118
10989907@N07,122,1,1385854288,1385854378,2,10,90
10989907@N07,122,8,1385854395,1385854598,2,10,203
10989907@N07,122,6,1385854598,1385855618,6,10,1020
10989907@N07,122,8,1385858036,1385859176,3,10,1140
10989907@N07,122,4,1385863636,1385864536,2,10,900
10989907@N07,122,1,1385874222,1385874312,2,10,90
10989907@N07,122,5,1385890848,1385891072,2,10,224
10989907@N07,122,6,1385891072,1385892092,2,10,1020
10989907@N07,122,5,1385892410,1385893310,1,10,900
10989907@N07,123,12,1386399490,1386400990,6,1,1500
10989907@N07,124,6,1386589095,1386590115,1,1,1020
10989907@N07,125,1,1417498202,1417498292,1,1,90
11014059@N02,126,2,1210845814,1210846204,18,3,390
11014059@N02,126,11,1210859555,1210859787,5,3,232
11014059@N02,126,1,1210859787,1210859877,1,3,90
110166673@N02,127,2,1385509875,1385510265,7,12,390
110166673@N02,127,6,1385518515,1385519535,35,12,1020
110166673@N02,127,8,1385520490,1385521630,4,12,1140
110166673@N02,127,4,1385525341,1385526200,10,12,859
110166673@N02,127,8,1385526200,1385527340,4,12,1140
110166673@N02,127,4,1385527442,1385528342,4,12,900
110166673@N02,127,11,1385531572,1385532040,23,12,468
110166673@N02,127,7,1385532040,1385532545,9,12,505
110166673@N02,127,8,1385532545,1385533669,3,12,1124
110166673@N02,127,2,1385533669,1385534059,56,12,390
110166673@N02,127,8,1385543663,1385544364,6,12,701
110166673@N02,127,6,1385544364,1385545384,24,12,1020
110223705@N07,128,1,1463780913,1463781003,1,1,90
110242495@N04,129,5,1395112687,1395113587,2,2,900
110242495@N04,129,4,1395117282,1395118182,1,2,900
110333758@N06,130,6,1386409898,1386410918,4,1,1020
11036701@N06,131,11,1305617021,1305618521,1,1,1500
11041171@N06,132,8,1358034605,1358035745,2,3,1140
11041171@N06,132,7,1358056846,1358057866,2,3,1020
11041171@N06,132,9,1358066722,1358068222,2,3,1500
11041171@N06,133,6,1371861941,1371862961,1,1,1020
110670053@N07,134,8,1425164427,1425165567,3,1,1140
110670053@N07,135,8,1426809871,1426811011,1,1,1140
11136034@N06,136,8,1242653410,1242654550,19,1,1140
111364633@N02,137,3,1322010083,1322010503,1,1,420
11149127@N05,138,1,1300105565,1300105655,3,2,90
11149127@N05,138,8,1300105952,1300107092,1,2,1140
111603867@N06,139,5,1390603411,1390604311,4,7,900
111603867@N06,139,8,1390611351,1390612491,3,7,1140
111603867@N06,139,2,1390620130,1390620520,2,7,390
111603867@N06,139,10,1390631897,1390633397,2,7,1500
111603867@N06,139,9,1390633783,1390635283,4,7,1500
111603867@N06,139,2,1390640878,1390641183,2,7,305
111603867@N06,139,1,1390641183,1390641273,2,7,90
111603867@N06,140,6,1391047254,1391048274,2,2,1020
111603867@N06,140,8,1391054522,1391055662,1,2,1140
11171054@N04,141,6,1440154613,1440154616,3,2,3
11171054@N04,141,7,1440154616,1440155636,1,2,1020
11201728@N02,142,8,1215299154,1215300294,3,1,1140
112045904@N02,143,8,1385198750,1385199890,1,1,1140
112593954@N05,144,2,1336178985,1336179375,2,1,390
11260538@N06,145,2,1348997214,1348997604,1,1,390
11260538@N06,146,6,1352440784,1352441804,1,1,1020
11260538@N06,147,12,1352604975,1352606475,1,1,1500
11260538@N06,148,6,1352708370,1352709390,1,1,1020
11260538@N06,149,6,1355558747,1355559767,1,1,1020
11260538@N06,150,2,1365289306,1365289696,2,3,390
11260538@N06,150,8,1365303334,1365304474,3,3,1140
11260538@N06,150,4,1365306487,1365307387,2,3,900
11260538@N06,151,7,1380845646,1380846666,1,1,1020
112691972@N02,152,1,1399271310,1399271400,1,1,90
11269849@N03,153,1,1305942651,1305942741,99,4,90
11269849@N03,153,6,1305945796,1305946816,78,4,1020
11269849@N03,153,4,1305955005,1305955905,20,4,900
11269849@N03,153,10,1305960057,1305961557,1,4,1500
11269849@N03,154,1,1338604266,1338604356,28,1,90
11269849@N03,155,1,1338691346,1338691436,58,1,90
112734542@N02,156,6,1396676251,1396677271,1,1,1020
112734542@N02,157,6,1396839062,1396840082,3,3,1020
112734542@N02,157,12,1396854854,1396855810,3,3,956
112734542@N02,157,8,1396855810,1396856950,2,3,1140
112786774@N07,158,4,1416103198,1416104098,1,1,900
112861324@N05,159,6,1388358562,1388359582,2,1,1020
113086034@N04,160,2,1449170202,1449170592,2,1,390
113086034@N04,161,6,1459417455,1459418475,1,1,1020
113086034@N04,162,6,1459464818,1459465838,1,1,1020
11315654@N06,163,6,1261384389,1261385409,15,1,1020
113200565@N07,164,4,1388355161,1388356061,1,1,900
113552105@N07,165,10,1459917037,1459918537,1,1,1500
11374644@N06,166,9,1289120750,1289122250,11,1,1500
113875683@N02,167,8,1355031131,1355032271,4,1,1140
113875683@N02,168,6,1385278224,1385279244,15,1,1020
11429691@N03,169,10,1299925786,1299925799,2,3,13
11429691@N03,169,8,1299925799,1299925803,2,3,4
11429691@N03,169,1,1299925803,1299925893,1,3,90
11438118@N00,170,5,1189046374,1189047274,3,2,900
11438118@N00,170,1,1189049935,1189050025,1,2,90
11438118@N00,171,4,1194387225,1194387353,2,6,128
11438118@N00,171,6,1194387353,1194387758,2,6,405
11438118@N00,171,2,1194387758,1194387794,2,6,36
11438118@N00,171,6,1194387794,1194388073,5,6,279
11438118@N00,171,2,1194388073,1194388463,25,6,390
11438118@N00,171,5,1194406077,1194406977,6,6,900
11438118@N00,172,1,1196835768,1196835858,4,4,90
11438118@N00,172,5,1196835912,1196836253,3,4,341
11438118@N00,172,1,1196836253,1196836343,3,4,90
11438118@N00,172,6,1196837475,1196838495,54,4,1020
11438118@N00,173,8,1197964040,1197964343,2,3,303
11438118@N00,173,6,1197964343,1197965363,34,3,1020
11438118@N00,173,8,1197966305,1197967445,29,3,1140
11438118@N00,174,10,1205364488,1205365988,2,4,1500
11438118@N00,174,12,1205369780,1205371280,4,4,1500
11438118@N00,174,8,1205374361,1205375501,18,4,1140
11438118@N00,174,1,1205382334,1205382424,4,4,90
11438118@N00,175,8,1212016994,1212018134,2,3,1140
11438118@N00,175,5,1212019696,1212020596,4,3,900
11438118@N00,175,2,1212023450,1212023840,7,3,390
11438118@N00,176,5,1212192764,1212193664,2,4,900
11438118@N00,176,1,1212194065,1212194155,2,4,90
11438118@N00,176,2,1212196264,1212196654,18,4,390
11438118@N00,176,1,1212202209,1212202299,4,4,90
11438118@N00,177,2,1230866787,1230867177,1,1,390
11438118@N00,178,6,1235767031,1235767315,2,6,284
11438118@N00,178,13,1235767315,1235767803,3,6,488
11438118@N00,178,5,1235767803,1235767987,4,6,184
11438118@N00,178,9,1235767987,1235768052,3,6,65
11438118@N00,178,5,1235768052,1235768468,4,6,416
11438118@N00,178,13,1235768468,1235770268,1,6,1800
11438118@N00,179,5,1244728829,1244729729,1,1,900
11438118@N00,180,2,1250313623,1250314013,2,2,390
11438118@N00,180,11,1250319622,1250321122,1,2,1500
11439401@N07,181,6,1241694856,1241695876,1,1,1020
11441631@N00,182,5,1348433341,1348434241,2,5,900
11441631@N00,182,8,1348435140,1348436280,2,5,1140
11441631@N00,182,4,1348437987,1348438887,4,5,900
11441631@N00,182,1,1348463094,1348463184,3,5,90
11441631@N00,182,9,1348475419,1348476919,1,5,1500
11448601@N02,183,10,1368753757,1368755257,7,2,1500
11448601@N02,183,6,1368764265,1368765285,4,2,1020
114677615@N06,184,6,1350201596,1350202616,1,1,1020
11479795@N00,185,10,1191378537,1191380037,2,2,1500
11479795@N00,185,6,1191383746,1191384766,1,2,1020
114862435@N06,186,6,1356852586,1356853606,5,1,1020
11511707@N05,187,8,1273115226,1273116366,47,1,1140
11531720@N04,188,2,1359261324,1359261714,1,1,390
11541209@N06,189,8,1191152405,1191153545,1,1,1140
11541209@N06,190,5,1193908590,1193909490,1,1,900
115511286@N06,191,8,1392304253,1392304308,2,7,55
115511286@N06,191,11,1392304308,1392305808,2,7,1500
115511286@N06,191,6,1392313359,1392314379,2,7,1020
115511286@N06,191,1,1392325603,1392325693,2,7,90
115511286@N06,191,8,1392325838,1392326978,2,7,1140
115511286@N06,191,5,1392327104,1392328004,2,7,900
115511286@N06,191,1,1392328317,1392328407,1,7,90
115653984@N07,192,4,1388278739,1388279639,1,1,900
11581147@N06,193,13,1432607697,1432609497,3,2,1800
11581147@N06,193,4,1432616461,1432617361,1,2,900
11611067@N02,194,10,1342833389,1342834074,2,12,685
11611067@N02,194,2,1342834074,1342834464,2,12,390
11611067@N02,194,6,1342837568,1342838588,6,12,1020
11611067@N02,194,5,1342845605,1342846505,10,12,900
11611067@N02,194,8,1342847624,1342848764,3,12,1140
11611067@N02,194,13,1342856825,1342858588,2,12,1763
11611067@N02,194,8,1342858588,1342858654,3,12,66
11611067@N02,194,2,1342858654,1342859044,6,12,390
11611067@N02,194,4,1342863884,1342864784,7,12,900
11611067@N02,194,5,1342871022,1342871922,5,12,900
11611067@N02,194,8,1342873626,1342873685,2,12,59
11611067@N02,194,1,1342873685,1342873775,1,12,90
11632646@N02,195,6,1187949064,1187950084,1,1,1020
11654579@N07,196,1,1370128776,1370128866,1,1,90
11699747@N03,197,4,1388731483,1388732383,1,1,900
11724486@N02,198,1,1384908453,1384908543,2,8,90
11724486@N02,198,2,1384908953,1384909343,10,8,390
11724486@N02,198,6,1384913450,1384914470,3,8,1020
11724486@N02,198,13,1384915596,1384917396,7,8,1800
11724486@N02,198,6,1384920459,1384921479,28,8,1020
11724486@N02,198,4,1384937778,1384938052,3,8,274
11724486@N02,198,1,1384938052,1384938142,3,8,90
11724486@N02,198,10,1384938229,1384939729,1,8,1500
11724486@N02,199,5,1384998537,1384999437,2,2,900
11724486@N02,199,1,1385000166,1385000256,2,2,90
117386007@N08,200,5,1323920060,1323920960,3,1,900
11752574@N06,201,9,1194863070,1194864570,3,2,1500
11752574@N06,201,8,1194867072,1194868212,11,2,1140
11752574@N06,202,11,1347879470,1347880970,1,1,1500
11752574@N06,203,4,1348187570,1348188470,2,2,900
11752574@N06,203,1,1348201983,1348202073,1,2,90
117536444@N07,204,6,1373787970,1373788990,1,1,1020
11785705@N02,205,5,1291530596,1291531496,2,3,900
11785705@N02,205,7,1291532404,1291533424,2,3,1020
11785705@N02,205,8,1291541664,1291542804,1,3,1140
11825945@N00,206,1,1370011964,1370012054,1,1,90
11825945@N00,207,1,1378248428,1378248518,1,1,90
11825945@N00,208,1,1379048071,1379048161,1,1,90
11825945@N00,209,5,1389493193,1389494093,1,1,900
11825945@N00,210,8,1403344473,1403345613,1,1,1140
118757159@N03,211,1,1393023090,1393023130,5,3,40
118757159@N03,211,8,1393023130,1393023811,2,3,681
118757159@N03,211,1,1393023811,1393023901,1,3,90
11901577@N03,212,4,1425168331,1425169231,2,1,900
11901577@N03,213,4,1432261320,1432262220,1,1,900
11901577@N03,214,4,1432338691,1432339591,1,1,900
11901577@N03,215,4,1432451575,1432452475,2,1,900
11915551@N07,216,4,1195799188,1195799564,2,9,376
11915551@N07,216,8,1195799564,1195800704,2,9,1140
11915551@N07,216,5,1195802623,1195802798,2,9,175
11915551@N07,216,1,1195802798,1195802888,2,9,90
11915551@N07,216,4,1195804591,1195805491,2,9,900
11915551@N07,216,13,1195808062,1195809862,5,9,1800
11915551@N07,216,6,1195813785,1195814805,2,9,1020
11915551@N07,216,8,1195816421,1195816563,2,9,142
11915551@N07,216,1,1195816563,1195816653,1,9,90
11928454@N04,217,10,1244674345,1244675038,2,19,693
11928454@N04,217,1,1244675038,1244675128,2,19,90
11928454@N04,217,8,1244675136,1244675952,2,19,816
11928454@N04,217,1,1244675952,1244676042,3,19,90
11928454@N04,217,8,1244676856,1244677924,2,19,1068
11928454@N04,217,2,1244677924,1244678314,5,19,390
11928454@N04,217,1,1244680781,1244680871,2,19,90
11928454@N04,217,5,1244680974,1244681874,7,19,900
11928454@N04,217,7,1244686426,1244687446,2,19,1020
11928454@N04,217,12,1244688394,1244688623,2,19,229
11928454@N04,217,1,1244688623,1244688713,2,19,90
11928454@N04,217,4,1244694841,1244695322,2,19,481
11928454@N04,217,8,1244695322,1244696462,3,19,1140
11928454@N04,217,4,1244700950,1244701850,2,19,900
11928454@N04,217,12,1244703888,1244705388,4,19,1500
11928454@N04,217,11,1244710500,1244711429,3,19,929
11928454@N04,217,2,1244711429,1244711819,2,19,390
11928454@N04,217,6,1244711876,1244712896,7,19,1020
11928454@N04,217,9,1244723220,1244724720,3,19,1500
11935368@N00,218,1,1292275254,1292275344,2,6,90
11935368@N00,218,5,1292275368,1292276268,6,6,900
11935368@N00,218,2,1292284750,1292285140,2,6,390
11935368@N00,218,6,1292289058,1292290078,2,6,1020
11935368@N00,218,8,1292293768,1292294908,9,6,1140
11935368@N00,218,6,1292306615,1292307635,4,6,1020
11935368@N00,219,1,1292833783,1292833788,2,3,5
11935368@N00,219,8,1292833788,1292833801,3,3,13
11935368@N00,219,1,1292833801,1292833891,1,3,90
119422749@N03,220,1,1395021135,1395021225,1,1,90
11954862@N00,221,4,1394585766,1394586666,3,1,900
119796978@N03,222,7,1393222670,1393223690,1,1,1020
119993435@N06,223,5,1381530041,1381530941,2,1,900
119993435@N06,224,9,1381570055,1381571555,4,2,1500
119993435@N06,224,2,1381571785,1381572175,7,2,390
12004667@N02,225,8,1294189062,1294190202,1,1,1140
12008385@N00,226,12,1291337758,1291339258,1,1,1500
120147674@N05,227,5,1395541082,1395541982,2,1,900
120147674@N05,228,6,1395637555,1395638575,1,1,1020
12036424@N04,229,2,1305518103,1305518493,3,2,390
12036424@N04,229,5,1305535719,1305536619,1,2,900
12044368@N04,230,2,1409520858,1409521248,1,1,390
12044368@N04,231,4,1410646605,1410647505,1,1,900
120533378@N03,232,11,1443222844,1443224344,32,1,1500
120533378@N03,233,2,1443308605,1443308889,7,7,284
120533378@N03,233,6,1443308889,1443309909,4,7,1020
120533378@N03,233,1,1443311457,1443311547,2,7,90
120533378@N03,233,11,1443315586,1443317086,2,7,1500
120533378@N03,233,6,1443318166,1443319186,3,7,1020
120533378@N03,233,4,1443319571,1443320471,4,7,900
120533378@N03,233,11,1443325884,1443327384,1,7,1500
120533378@N03,234,11,1443607640,1443609140,3,1,1500
120533378@N03,235,11,1443935613,1443937113,1,1,1500
120756153@N05,236,2,1344919542,1344919932,5,1,390
120756153@N05,237,6,1386733041,1386734061,4,1,1020
12083014@N05,238,1,1222338668,1222338758,1,1,90
12083014@N05,239,5,1253670181,1253671081,2,3,900
12083014@N05,239,8,1253679229,1253679313,2,3,84
12083014@N05,239,1,1253679313,1253679403,1,3,90
12083014@N05,240,5,1298270423,1298271323,2,1,900
12084245@N08,241,1,1247561926,1247562016,8,1,90
12084245@N08,242,1,1247644483,1247644573,1,1,90
12084245@N08,243,1,1247727888,1247727978,5,1,90
121354827@N08,244,5,1370565558,1370566458,2,4,900
121354827@N08,244,4,1370574691,1370575591,6,4,900
121354827@N08,244,13,1370576162,1370576176,2,4,14
121354827@N08,244,4,1370576176,1370577076,1,4,900
121499845@N05,245,4,1404350364,1404351264,1,1,900
121655138@N03,246,8,1395787851,1395788991,2,15,1140
121655138@N03,246,10,1395791030,1395792479,9,15,1449
121655138@N03,246,1,1395792479,1395792569,3,15,90
121655138@N03,246,7,1395792790,1395793810,2,15,1020
121655138@N03,246,13,1395794652,1395796452,3,15,1800
121655138@N03,246,8,1395802890,1395802896,2,15,6
121655138@N03,246,2,1395802896,1395803286,5,15,390
121655138@N03,246,6,1395807500,1395808520,2,15,1020
121655138@N03,246,1,1395811636,1395811726,2,15,90
121655138@N03,246,8,1395812109,1395812371,2,15,262
121655138@N03,246,5,1395812371,1395813271,3,15,900
121655138@N03,246,1,1395814193,1395814230,2,15,37
121655138@N03,246,8,1395814230,1395814297,2,15,67
121655138@N03,246,1,1395814297,1395814387,5,15,90
121655138@N03,246,8,1395815268,1395816408,5,15,1140
121655138@N03,247,6,1396012693,1396013713,1,1,1020
121861619@N03,248,1,1423627678,1423627768,3,6,90
121861619@N03,248,4,1423628127,1423628184,3,6,57
121861619@N03,248,6,1423628184,1423629204,20,6,1020
121861619@N03,248,2,1423630357,1423630435,4,6,78
121861619@N03,248,8,1423630435,1423631575,6,6,1140
121861619@N03,248,4,1423633762,1423634662,2,6,900
121861619@N03,249,1,1423696686,1423696776,4,12,90
121861619@N03,249,3,1423699821,1423700241,2,12,420
121861619@N03,249,6,1423703159,1423703313,2,12,154
121861619@N03,249,3,1423703313,1423703336,2,12,23
121861619@N03,249,6,1423703336,1423703619,2,12,283
121861619@N03,249,3,1423703619,1423704039,6,12,420
121861619@N03,249,10,1423713858,1423715358,15,12,1500
121861619@N03,249,7,1423719812,1423719872,2,12,60
121861619@N03,249,11,1423719872,1423719902,2,12,30
121861619@N03,249,8,1423719902,1423719967,2,12,65
121861619@N03,249,2,1423719967,1423720251,3,12,284
121861619@N03,249,13,1423720251,1423722051,4,12,1800
12186997@N00,250,6,1356773316,1356774336,1,1,1020
12197785@N03,251,8,1246159959,1246161099,1,1,1140
12197785@N03,252,11,1259912134,1259913634,2,2,1500
12197785@N03,252,8,1259915628,1259916768,1,2,1140
12197785@N03,253,13,1287875234,1287877034,2,3,1800
12197785@N03,253,1,1287888667,1287888757,3,3,90
12197785@N03,253,5,1287889790,1287890690,1,3,900
12205233@N02,254,8,1227527503,1227528643,1,1,1140
122353703@N02,255,1,1421211481,1421211571,3,1,90
122353703@N02,256,7,1421727030,1421727073,4,3,43
122353703@N02,256,1,1421727073,1421727163,5,3,90
122353703@N02,256,8,1421727179,1421728319,3,3,1140
122353703@N02,257,7,1421813172,1421813229,4,4,57
122353703@N02,257,1,1421813229,1421813274,4,4,45
122353703@N02,257,8,1421813274,1421813301,2,4,27
122353703@N02,257,1,1421813301,1421813391,6,4,90
12247055@N00,258,13,1461198101,1461199901,3,5,1800
12247055@N00,258,5,1461200710,1461201170,2,5,460
12247055@N00,258,13,1461201170,1461202970,9,5,1800
12247055@N00,258,12,1461203879,1461204454,3,5,575
12247055@N00,258,13,1461204454,1461206254,2,5,1800
12247055@N00,259,13,1461307605,1461309405,1,1,1800
12277777@N04,260,3,1311222580,1311223000,2,3,420
12277777@N04,260,1,1311224040,1311224130,3,3,90
12277777@N04,260,6,1311230777,1311231797,1,3,1020
122876725@N05,261,1,1406328033,1406328123,7,9,90
122876725@N05,261,5,1406328219,1406328478,5,9,259
122876725@N05,261,7,1406328478,1406328494,2,9,16
122876725@N05,261,8,1406328494,1406329634,7,9,1140
122876725@N05,261,11,1406331436,1406331463,2,9,27
122876725@N05,261,8,1406331463,1406331469,2,9,6
122876725@N05,261,2,1406331469,1406331859,11,9,390
122876725@N05,261,4,1406335757,1406336657,10,9,900
122876725@N05,261,5,1406351232,1406352132,3,9,900
122876725@N05,262,1,1407227832,1407227922,2,7,90
122876725@N05,262,5,1407229209,1407230109,3,7,900
122876725@N05,262,4,1407233187,1407233240,5,7,53
122876725@N05,262,3,1407233240,1407233660,2,7,420
122876725@N05,262,1,1407236020,1407236110,5,7,90
122876725@N05,262,10,1407236349,1407237093,7,7,744
122876725@N05,262,9,1407237093,1407238593,76,7,1500
122876725@N05,263,1,1407286640,1407286730,2,12,90
122876725@N05,263,6,1407289500,1407290520,2,12,1020
122876725@N05,263,5,1407298072,1407298102,3,12,30
122876725@N05,263,10,1407298102,1407298225,7,12,123
122876725@N05,263,5,1407298225,1407298232,3,12,7
122876725@N05,263,10,1407298232,1407298242,3,12,10
122876725@N05,263,5,1407298242,1407298308,8,12,66
122876725@N05,263,9,1407298308,1407298538,4,12,230
122876725@N05,263,10,1407298538,1407299081,12,12,543
122876725@N05,263,9,1407299081,1407300581,2,12,1500
122876725@N05,263,5,1407323422,1407323557,2,12,135
122876725@N05,263,1,1407323557,1407323647,5,12,90
123065585@N07,264,5,1398926501,1398927401,1,1,900
12316147@N05,265,6,1459470454,1459471474,22,3,1020
12316147@N05,265,7,1459490076,1459491096,28,3,1020
12316147@N05,265,1,1459493156,1459493246,2,3,90
123398648@N02,266,2,1349564597,1349564987,3,2,390
123398648@N02,266,6,1349566143,1349567163,1,2,1020
12353441@N02,267,1,1191317489,1191317579,2,1,90
12381123@N06,268,1,1324337047,1324337137,3,4,90
12381123@N06,268,5,1324337348,1324338248,2,4,900
12381123@N06,268,1,1324338577,1324338667,7,4,90
12381123@N06,268,6,1324351939,1324352959,1,4,1020
12395214@N08,269,7,1357922286,1357923306,114,1,1020
12395214@N08,270,7,1432984860,1432985880,43,1,1020
124146448@N07,271,2,1357095263,1357095653,1,1,390
124235757@N05,272,1,1342655347,1342655437,1,1,90
124235757@N05,273,4,1342685908,1342685927,2,4,19
124235757@N05,273,6,1342685927,1342686947,2,4,1020
124235757@N05,273,11,1342688161,1342688302,2,4,141
124235757@N05,273,2,1342688302,1342688692,2,4,390
124370052@N08,274,10,1396654429,1396655929,1,1,1500
12445963@N00,275,8,1412820400,1412821540,1,1,1140
124601595@N06,276,1,1398489903,1398489993,4,3,90
124601595@N06,276,5,1398490852,1398491752,19,3,900
124601595@N06,276,1,1398499596,1398499686,1,3,90
124601595@N06,277,5,1398700558,1398701458,1,1,900
124601595@N06,278,10,1398740509,1398742009,9,4,1500
124601595@N06,278,1,1398744113,1398744203,2,4,90
124601595@N06,278,4,1398746307,1398747207,7,4,900
124601595@N06,278,6,1398748319,1398749339,14,4,1020
124948917@N04,279,8,1433632952,1433634092,2,2,1140
124948917@N04,279,1,1433652614,1433652704,3,2,90
12508217@N08,280,8,1301708081,1301709221,1,1,1140
12508217@N08,281,4,1318562490,1318563390,1,1,900
12508217@N08,282,13,1337478253,1337480053,4,3,1800
12508217@N08,282,4,1337481245,1337482145,7,3,900
12508217@N08,282,6,1337489572,1337490592,1,3,1020
12508217@N08,283,8,1368837134,1368838274,6,2,1140
12508217@N08,283,7,1368865161,1368866181,8,2,1020
125837856@N05,284,10,1404164483,1404165983,2,11,1500
125837856@N05,284,8,1404169667,1404170807,5,11,1140
125837856@N05,284,6,1404174187,1404175207,2,11,1020
125837856@N05,284,4,1404176846,1404177746,2,11,900
125837856@N05,284,8,1404181689,1404182829,3,11,1140
125837856@N05,284,1,1404186991,1404187081,3,11,90
125837856@N05,284,4,1404189077,1404189977,4,11,900
125837856@N05,284,1,1404194733,1404194823,6,11,90
125837856@N05,284,13,1404201969,1404203769,28,11,1800
125837856@N05,284,5,1404208123,1404209023,7,11,900
125837856@N05,284,9,1404213120,1404214620,6,11,1500
125863683@N08,285,5,1417822774,1417823674,6,5,900
125863683@N08,285,2,1417827013,1417827403,4,5,390
125863683@N08,285,8,1417839217,1417840357,5,5,1140
125863683@N08,285,10,1417843396,1417844896,2,5,1500
125863683@N08,285,6,1417851414,1417852434,1,5,1020
12592520@N03,286,1,1230855282,1230855372,2,7,90
12592520@N03,286,11,1230859384,1230860884,2,7,1500
12592520@N03,286,7,1230866516,1230867536,2,7,1020
12592520@N03,286,5,1230872358,1230873258,2,7,900
12592520@N03,286,13,1230875775,1230877575,2,7,1800
12592520@N03,286,6,1230884385,1230885405,2,7,1020
12592520@N03,286,8,1230892404,1230893544,1,7,1140
12592520@N03,287,10,1231377861,1231379361,3,4,1500
12592520@N03,287,5,1231380138,1231381038,2,4,900
12592520@N03,287,13,1231385729,1231387529,2,4,1800
12592520@N03,287,8,1231390313,1231391453,1,4,1140
126190379@N03,288,8,1376882057,1376883197,3,2,1140
126190379@N03,288,2,1376893303,1376893693,1,2,390
126521704@N08,289,1,1404261446,1404261536,2,3,90
126521704@N08,289,8,1404266385,1404267525,2,3,1140
126521704@N08,289,6,1404279502,1404280522,1,3,1020
12658090@N00,290,4,1358664971,1358665871,1,1,900
12658090@N00,291,4,1400924621,1400925521,1,1,900
12659736@N02,292,6,1210229645,1210230665,7,7,1020
12659736@N02,292,2,1210232781,1210233112,6,7,331
12659736@N02,292,6,1210233112,1210234132,3,7,1020
12659736@N02,292,1,1210237752,1210237842,13,7,90
12659736@N02,292,5,1210243785,1210244057,2,7,272
12659736@N02,292,9,1210244057,1210245557,84,7,1500
12659736@N02,292,5,1210246453,1210247353,3,7,900
12659736@N02,293,2,1232783434,1232783534,2,3,100
12659736@N02,293,1,1232783534,1232783624,3,3,90
12659736@N02,293,9,1232785190,1232786690,2,3,1500
12659736@N02,294,10,1420769262,1420770762,11,1,1500
126776752@N03,295,8,1437183741,1437184881,1,1,1140
126776752@N03,296,4,1449272650,1449273550,1,1,900
126977796@N08,297,4,1460073729,1460074629,3,6,900
126977796@N08,297,6,1460080500,1460080958,2,6,458
126977796@N08,297,7,1460080958,1460081978,5,6,1020
126977796@N08,297,5,1460087003,1460087903,3,6,900
126977796@N08,297,12,1460089210,1460090710,3,6,1500
126977796@N08,297,1,1460093084,1460093174,1,6,90
127278883@N08,298,1,1439708144,1439708234,7,1,90
12742129@N00,299,5,1300693783,1300694683,3,1,900
12742129@N00,300,5,1340111218,1340112118,1,1,900
127484878@N05,301,9,1444712678,1444714178,1,1,1500
127662106@N04,302,1,1413535724,1413535814,2,2,90
127662106@N04,302,9,1413540143,1413541643,4,2,1500
127662106@N04,303,6,1415516270,1415517290,13,1,1020
127662106@N04,304,1,1420859803,1420859893,2,3,90
127662106@N04,304,8,1420860330,1420861470,2,3,1140
127662106@N04,304,1,1420863146,1420863236,2,3,90
127662106@N04,305,1,1421815074,1421815164,2,2,90
127662106@N04,305,8,1421815194,1421816334,4,2,1140
127662106@N04,306,8,1422160895,1422162035,7,1,1140
127662106@N04,307,12,1453535275,1453536775,2,1,1500
127662106@N04,308,6,1459916121,1459917141,5,1,1020
127662106@N04,309,6,1462610016,1462611036,4,1,1020
127662106@N04,310,6,1466153387,1466154407,3,2,1020
127662106@N04,310,1,1466164069,1466164159,9,2,90
127662106@N04,311,6,1470728837,1470729857,9,1,1020
127810693@N08,312,6,1259088424,1259089444,4,1,1020
128509080@N04,313,8,1417516295,1417517435,2,11,1140
128509080@N04,313,2,1417525200,1417525200,2,11,0
128509080@N04,313,6,1417525200,1417526220,2,11,1020
128509080@N04,313,1,1417536180,1417536270,2,11,90
128509080@N04,313,8,1417536701,1417537841,2,11,1140
128509080@N04,313,6,1417539370,1417540390,4,11,1020
128509080@N04,313,2,1417565069,1417565459,2,11,390
128509080@N04,313,1,1417566483,1417566573,2,11,90
128509080@N04,313,6,1417567147,1417568167,7,11,1020
128509080@N04,313,12,1417571598,1417573098,2,11,1500
128509080@N04,313,5,1417575138,1417576038,1,11,900
128526407@N07,314,2,1416192751,1416193141,1,1,390
128526407@N07,315,2,1416338751,1416339141,1,1,390
128526407@N07,316,6,1418085124,1418086144,1,1,1020
128526407@N07,317,5,1418536656,1418537556,1,1,900
128799974@N05,318,9,1367752429,1367753929,1,1,1500
129438227@N06,319,2,1417427790,1417428180,1,1,390
129438227@N06,320,8,1419417584,1419418724,1,1,1140
129438227@N06,321,2,1451984782,1451985172,1,1,390
129455250@N03,322,10,1438653146,1438654646,1,1,1500
12989776@N03,323,8,1272943898,1272945038,1,1,1140
12989776@N03,324,7,1300520787,1300521807,1,1,1020
130069612@N06,325,1,1433328716,1433328806,2,2,90
130069612@N06,325,7,1433329556,1433330576,1,2,1020
130069612@N06,326,2,1433577683,1433578073,3,2,390
130069612@N06,326,1,1433585112,1433585202,1,2,90
130069612@N06,327,4,1463294171,1463295071,2,2,900
130069612@N06,327,5,1463305163,1463306063,1,2,900
130069612@N06,328,5,1463528599,1463529499,2,1,900
130069612@N06,329,5,1464082999,1464083899,2,2,900
130069612@N06,329,1,1464085658,1464085748,1,2,90
130127205@N04,330,10,1455940324,1455941824,3,1,1500
13137063@N05,331,5,1370252355,1370253255,2,1,900
131412080@N05,332,1,1451080331,1451080421,5,16,90
131412080@N05,332,5,1451080600,1451081500,13,16,900
131412080@N05,332,1,1451084597,1451084641,2,16,44
131412080@N05,332,8,1451084641,1451085411,12,16,770
131412080@N05,332,2,1451085411,1451085763,8,16,352
131412080@N05,332,8,1451085763,1451085806,3,16,43
131412080@N05,332,2,1451085806,1451085970,4,16,164
131412080@N05,332,6,1451085970,1451086102,6,16,132
131412080@N05,332,8,1451086102,1451087118,2,16,1016
131412080@N05,332,4,1451087118,1451087174,4,16,56
131412080@N05,332,3,1451087174,1451087594,3,16,420
131412080@N05,332,4,1451088160,1451089060,3,16,900
131412080@N05,332,6,1451089650,1451090670,4,16,1020
131412080@N05,332,5,1451092759,1451093659,12,16,900
131412080@N05,332,1,1451098671,1451098761,2,16,90
131412080@N05,332,9,1451116953,1451118453,10,16,1500
13156986@N08,333,1,1391969825,1391969915,2,2,90
13156986@N08,333,11,1391981290,1391982790,1,2,1500
131849702@N06,334,7,1436316484,1436316755,6,6,271
131849702@N06,334,4,1436316755,1436317655,2,6,900
131849702@N06,334,11,1436321588,1436322638,2,6,1050
131849702@N06,334,2,1436322638,1436323028,2,6,390
131849702@N06,334,8,1436328926,1436330066,3,6,1140
131849702@N06,334,5,1436333187,1436334087,6,6,900
131918782@N02,335,12,1422313687,1422315187,6,5,1500
131918782@N02,335,1,1422315818,1422315828,3,5,10
131918782@N02,335,12,1422315828,1422317328,8,5,1500
131918782@N02,335,6,1422334804,1422335824,13,5,1020
131918782@N02,335,4,1422340951,1422341851,3,5,900
131918782@N02,336,4,1422572207,1422573107,3,5,900
131918782@N02,336,2,1422576107,1422576497,3,5,390
131918782@N02,336,8,1422577414,1422578554,3,5,1140
131918782@N02,336,6,1422583055,1422584075,24,5,1020
131918782@N02,336,4,1422600277,1422601177,1,5,900
131918782@N02,337,2,1442272718,1442273108,3,3,390
131918782@N02,337,8,1442277766,1442278906,5,3,1140
131918782@N02,337,6,1442290519,1442291539,2,3,1020
13199533@N04,338,1,1311001232,1311001322,2,1,90
132132547@N04,339,7,1428730693,1428731713,5,3,1020
132132547@N04,339,5,1428733361,1428734261,3,3,900
132132547@N04,339,1,1428746744,1428746834,1,3,90
13230685@N08,340,1,1359522689,1359522779,1,1,90
132357461@N07,341,9,1405676940,1405678440,1,1,1500
132472019@N05,342,5,1440147326,1440148226,2,2,900
132472019@N05,342,9,1440158775,1440160275,1,2,1500
13259518@N00,343,1,1245201951,1245202041,2,7,90
13259518@N00,343,5,1245202276,1245202647,3,7,371
13259518@N00,343,1,1245202647,1245202737,2,7,90
13259518@N00,343,2,1245205525,1245205915,2,7,390
13259518@N00,343,4,1245209192,1245210092,2,7,900
13259518@N00,343,13,1245212278,1245214078,2,7,1800
13259518@N00,343,1,1245224180,1245224270,1,7,90
13269428@N04,344,4,1233713431,1233714331,1,1,900
13269428@N04,345,11,1233807238,1233808738,2,1,1500
132959156@N02,346,12,1433151402,1433152902,3,1,1500
132959156@N02,347,8,1440155875,1440157015,1,1,1140
132959156@N02,348,13,1463571900,1463573700,1,1,1800
13352060@N06,349,1,1278543315,1278543405,1,1,90
13359849@N00,350,5,1383773232,1383774132,3,2,900
13359849@N00,350,12,1383785496,1383786996,1,2,1500
13403703@N06,351,9,1200030835,1200032335,1,1,1500
13417605@N00,352,8,1441418552,1441419692,1,1,1140
13417605@N00,353,13,1441586292,1441588092,1,1,1800
134211944@N07,354,1,1460345320,1460345410,1,1,90
134814033@N03,355,10,1452207050,1452208550,3,8,1500
134814033@N03,355,1,1452211986,1452212076,2,8,90
134814033@N03,355,13,1452215309,1452217109,4,8,1800
134814033@N03,355,12,1452217451,1452217781,2,8,330
134814033@N03,355,8,1452217781,1452218921,3,8,1140
134814033@N03,355,4,1452219092,1452219992,4,8,900
134814033@N03,355,1,1452221852,1452221942,2,8,90
134814033@N03,355,8,1452232897,1452234037,2,8,1140
13487696@N04,356,12,1378704825,1378706325,1,1,1500
135022299@N07,357,12,1442801913,1442803413,5,1,1500
135322752@N06,358,5,1439807744,1439808644,1,1,900
13599014@N08,359,7,1376952812,1376952813,4,24,1
13599014@N08,359,11,1376952813,1376952814,3,24,1
13599014@N08,359,1,1376952814,1376952815,3,24,1
13599014@N08,359,7,1376952815,1376952817,7,24,2
13599014@N08,359,11,1376952817,1376952818,2,24,1
13599014@N08,359,1,1376952818,1376952818,2,24,0
13599014@N08,359,12,1376952818,1376952819,2,24,1
13599014@N08,359,1,1376952819,1376952819,2,24,0
13599014@N08,359,11,1376952819,1376952820,2,24,1
13599014@N08,359,1,1376952820,1376952820,2,24,0
13599014@N08,359,7,1376952820,1376952821,2,24,1
13599014@N08,359,11,1376952821,1376952822,2,24,1
13599014@N08,359,1,1376952822,1376952822,3,24,0
13599014@N08,359,7,1376952822,1376952823,3,24,1
13599014@N08,359,11,1376952823,1376952825,2,24,2
13599014@N08,359,7,1376952825,1376953062,2,24,237
13599014@N08,359,1,1376953062,1376953062,2,24,0
13599014@N08,359,7,1376953062,1376953064,6,24,2
13599014@N08,359,1,1376953064,1376953065,2,24,1
13599014@N08,359,7,1376953065,1376953098,6,24,33
13599014@N08,359,1,1376953098,1376953098,2,24,0
13599014@N08,359,8,1376953098,1376953118,2,24,20
13599014@N08,359,1,1376953118,1376953120,5,24,2
13599014@N08,359,7,1376953120,1376954140,2,24,1020
13599014@N08,360,7,1377134668,1377135688,9,1,1020
13600026@N07,361,5,1389308967,1389309867,1,1,900
13613904@N05,362,4,1211443621,1211444521,3,3,900
13613904@N05,362,2,1211447600,1211447990,2,3,390
13613904@N05,362,9,1211455351,1211456851,5,3,1500
13613904@N05,363,2,1274501816,1274502206,2,2,390
13613904@N05,363,8,1274515171,1274516311,1,2,1140
13613904@N05,364,8,1275028967,1275030107,2,2,1140
13613904@N05,364,4,1275035555,1275036455,2,2,900
13613904@N05,365,8,1275102526,1275103263,2,3,737
13613904@N05,365,9,1275103263,1275104763,2,3,1500
13613904@N05,365,10,1275114337,1275115837,1,3,1500
13613904@N05,366,5,1336801910,1336802810,1,1,900
13616389@N04,367,8,1329006550,1329007690,26,1,1140
13619351@N06,368,4,1336136605,1336137505,3,1,900
13644648@N03,369,12,1254032430,1254033930,1,1,1500
13644648@N03,370,2,1254659293,1254659321,2,3,28
13644648@N03,370,8,1254659321,1254659323,2,3,2
13644648@N03,370,10,1254659323,1254660823,1,3,1500
13644648@N03,371,5,1287810298,1287810302,6,8,4
13644648@N03,371,8,1287810302,1287810306,4,8,4
13644648@N03,371,1,1287810306,1287810307,2,8,1
13644648@N03,371,4,1287810307,1287810309,2,8,2
13644648@N03,371,1,1287810309,1287810311,2,8,2
13644648@N03,371,2,1287810311,1287810312,2,8,1
13644648@N03,371,10,1287810312,1287810313,2,8,1
13644648@N03,371,5,1287810313,1287811213,1,8,900
13722851@N04,372,2,1302064394,1302064784,1,1,390
13764100@N05,373,5,1237082833,1237083733,3,4,900
13764100@N05,373,1,1237086011,1237086101,12,4,90
13764100@N05,373,5,1237096639,1237097539,2,4,900
13764100@N05,373,1,1237100177,1237100267,10,4,90
13764100@N05,374,10,1348974549,1348976049,4,3,1500
13764100@N05,374,1,1348976162,1348976252,20,3,90
13764100@N05,374,5,1348996911,1348997811,1,3,900
13813159@N00,375,1,1353907681,1353907771,2,1,90
13813159@N00,376,5,1353959938,1353960838,6,4,900
13813159@N00,376,6,1353984511,1353984775,2,4,264
13813159@N00,376,4,1353984775,1353985675,4,4,900
13813159@N00,376,12,1353994681,1353996181,5,4,1500
13813159@N00,377,12,1354035706,1354037206,1,1,1500
13818837@N05,378,4,1308782454,1308783354,1,1,900
13880897@N06,379,1,1361058670,1361058760,2,12,90
13880897@N06,379,8,1361059509,1361060649,3,12,1140
13880897@N06,379,6,1361063737,1361064712,2,12,975
13880897@N06,379,8,1361064712,1361065852,3,12,1140
13880897@N06,379,1,1361066185,1361066275,3,12,90
13880897@N06,379,5,1361066410,1361067310,7,12,900
13880897@N06,379,1,1361069189,1361069279,2,12,90
13880897@N06,379,6,1361074494,1361075514,2,12,1020
13880897@N06,379,12,1361078367,1361079867,3,12,1500
13880897@N06,379,1,1361085921,1361086011,2,12,90
13880897@N06,379,6,1361086633,1361087653,3,12,1020
13880897@N06,379,1,1361090265,1361090355,1,12,90
13880897@N06,380,2,1403171102,1403171492,1,1,390
13885531@N00,381,6,1226209498,1226210481,2,3,983
13885531@N00,381,1,1226210481,1226210571,2,3,90
13885531@N00,381,10,1226211296,1226212796,1,3,1500
13901020@N02,382,8,1190404931,1190406071,2,8,1140
13901020@N02,382,1,1190414975,1190414988,2,8,13
13901020@N02,382,13,1190414988,1190415008,3,8,20
13901020@N02,382,6,1190415008,1190415098,5,8,90
13901020@N02,382,1,1190415098,1190415188,29,8,90
13901020@N02,382,4,1190415242,1190415285,4,8,43
13901020@N02,382,1,1190415285,1190415298,4,8,13
13901020@N02,382,5,1190415298,1190416198,6,8,900
139081931@N05,383,9,1409568772,1409570272,1,1,1500
139081931@N05,384,4,1458382876,1458383776,1,1,900
13929738@N04,385,1,1194834579,1194834669,3,2,90
13929738@N04,385,9,1194859537,1194861037,1,2,1500
13933131@N08,386,10,1317274556,1317274851,6,9,295
13933131@N08,386,1,1317274851,1317274941,3,9,90
13933131@N08,386,10,1317275125,1317275262,2,9,137
13933131@N08,386,5,1317275262,1317276162,5,9,900
13933131@N08,386,1,1317277288,1317277378,5,9,90
13933131@N08,386,12,1317278102,1317279602,3,9,1500
13933131@N08,386,10,1317281146,1317281498,2,9,352
13933131@N08,386,1,1317281498,1317281588,2,9,90
13933131@N08,386,7,1317282300,1317283320,1,9,1020
13933131@N08,387,8,1381622995,1381624135,8,1,1140
13933131@N08,388,8,1381684496,1381685636,13,1,1140
13945854@N00,389,8,1423618271,1423619411,1,1,1140
13959240@N08,390,5,1346548916,1346549816,2,3,900
13959240@N08,390,2,1346555378,1346555768,2,3,390
13959240@N08,390,4,1346556867,1346557767,1,3,900
13991097@N02,391,4,1323158666,1323158826,5,2,160
13991097@N02,391,6,1323158826,1323159846,8,2,1020
14022320@N00,392,8,1314313160,1314314300,42,1,1140
14057191@N07,393,8,1266814236,1266815376,1,1,1140
14101284@N07,394,1,1191105702,1191105792,1,1,90
14101284@N07,395,1,1228450578,1228450668,1,1,90
14101284@N07,396,1,1250814419,1250814509,1,1,90
14125170@N02,397,7,1273586401,1273587421,1,1,1020
14129109@N07,398,8,1344320411,1344321551,17,1,1140
14129109@N07,399,8,1345184141,1345185281,12,1,1140
14130502@N07,400,8,1310251429,1310252569,3,3,1140
14130502@N07,400,1,1310256568,1310256658,2,3,90
14130502@N07,400,13,1310257714,1310259514,1,3,1800
14135751@N07,401,6,1368851632,1368851927,2,3,295
14135751@N07,401,2,1368851927,1368852285,2,3,358
14135751@N07,401,8,1368852285,1368853425,4,3,1140
14135751@N07,402,2,1400286007,1400286397,2,2,390
14135751@N07,402,1,1400291999,1400292089,7,2,90
14135751@N07,403,4,1433059296,1433060196,1,1,900
14249123@N02,404,1,1211158281,1211158308,2,2,27
14249123@N02,404,5,1211158308,1211159208,1,2,900
14280458@N05,405,6,1284371603,1284372623,6,1,1020
14332482@N05,406,5,1452849225,1452850125,1,1,900
14334279@N02,407,4,1420334546,1420335446,1,1,900
14344313@N05,408,8,1203662646,1203663786,2,1,1140
14344313@N05,409,8,1203802839,1203803979,11,2,1140
14344313@N05,409,9,1203834599,1203836099,2,2,1500
14363548@N07,410,13,1230812002,1230813802,1,1,1800
14370802@N05,411,8,1402719439,1402720579,1,1,1140
14370802@N05,412,4,1433588285,1433589185,1,1,900
14404008@N00,413,8,1223589196,1223590336,2,6,1140
14404008@N00,413,4,1223593052,1223593952,3,6,900
14404008@N00,413,12,1223595857,1223596705,4,6,848
14404008@N00,413,1,1223596705,1223596795,3,6,90
14404008@N00,413,4,1223597499,1223598399,2,6,900
14404008@N00,413,6,1223608123,1223609143,1,6,1020
14428367@N00,414,8,1287281995,1287283135,3,2,1140
14428367@N00,414,2,1287284346,1287284736,1,2,390
14449931@N08,415,6,1378599526,1378600546,2,2,1020
14449931@N08,415,12,1378615345,1378616845,1,2,1500
14449931@N08,416,13,1378889195,1378889530,2,2,335
14449931@N08,416,2,1378889530,1378889920,2,2,390
14449931@N08,417,8,1400191821,1400192961,2,1,1140
14449931@N08,418,8,1400312910,1400314050,2,1,1140
14449931@N08,419,8,1400398660,1400399800,3,1,1140
14453171@N00,420,4,1322884544,1322885444,1,1,900
14479515@N03,421,10,1199751414,1199751777,3,18,363
14479515@N03,421,1,1199751777,1199751867,8,18,90
14479515@N03,421,4,1199752335,1199753235,7,18,900
14479515@N03,421,6,1199753428,1199754326,10,18,898
14479515@N03,421,1,1199754326,1199754416,2,18,90
14479515@N03,421,5,1199754423,1199755323,5,18,900
14479515@N03,421,1,1199759142,1199759232,4,18,90
14479515@N03,421,13,1199763636,1199763803,2,18,167
14479515@N03,421,4,1199763803,1199764170,6,18,367
14479515@N03,421,1,1199764170,1199764250,2,18,80
14479515@N03,421,8,1199764250,1199765390,3,18,1140
14479515@N03,421,1,1199766531,1199766621,43,18,90
14479515@N03,421,13,1199767556,1199769356,37,18,1800
14479515@N03,421,1,1199772887,1199772977,2,18,90
14479515@N03,421,7,1199774242,1199775262,8,18,1020
14479515@N03,421,8,1199775612,1199776752,8,18,1140
14479515@N03,421,1,1199778390,1199778480,5,18,90
14479515@N03,421,9,1199779456,1199780956,26,18,1500
14479515@N03,422,1,1254095190,1254095280,11,1,90
14479515@N03,423,8,1254463673,1254464813,4,1,1140
14484378@N08,424,1,1189833248,1189833338,1,1,90
14484378@N08,425,1,1190567402,1190567492,1,1,90
14484378@N08,426,1,1191085877,1191085967,16,1,90
14484378@N08,427,1,1192464551,1192464641,5,1,90
14484378@N08,428,1,1195920516,1195920606,8,1,90
14484378@N08,429,1,1197648566,1197648656,4,1,90
14484378@N08,430,9,1204749180,1204750680,4,1,1500
14484378@N08,431,9,1205440587,1205442087,6,1,1500
14484378@N08,432,9,1209052808,1209054308,10,1,1500
14484378@N08,433,9,1210350120,1210351620,1,1,1500
14484378@N08,434,9,1211385644,1211387144,16,1,1500
14484378@N08,435,9,1211493629,1211495129,5,1,1500
14484378@N08,436,9,1211558953,1211560453,7,1,1500
14484378@N08,437,9,1212163769,1212165269,6,1,1500
14484378@N08,438,9,1212508983,1212510483,5,1,1500
14484378@N08,439,9,1212682044,1212683544,2,1,1500
14484378@N08,440,9,1213372997,1213374497,2,1,1500
14484378@N08,441,8,1216348200,1216349340,10,1,1140
14484378@N08,442,9,1216679550,1216681050,2,1,1500
14484378@N08,443,9,1217866449,1217867949,1,1,1500
14484378@N08,444,9,1218730219,1218731719,3,1,1500
14484378@N08,445,12,1218814664,1218816164,2,2,1500
14484378@N08,445,9,1218816555,1218818055,3,2,1500
14484378@N08,446,9,1219420756,1219422256,2,1,1500
14484378@N08,447,9,1219853542,1219855042,5,1,1500
14484378@N08,448,9,1220996060,1220997560,6,1,1500
14484378@N08,449,8,1221217721,1221218861,22,1,1140
14484378@N08,450,9,1222204641,1222206141,3,1,1500
14484378@N08,451,9,1222290050,1222291550,20,1,1500
14484378@N08,452,9,1222377151,1222378651,17,1,1500
14580956@N08,453,11,1281222752,1281224252,102,1,1500
14617498@N00,454,13,1227339665,1227341465,3,3,1800
14617498@N00,454,5,1227347194,1227348094,4,3,900
14617498@N00,454,1,1227349233,1227349323,2,3,90
14617498@N00,455,9,1229243628,1229245128,11,2,1500
14617498@N00,455,6,1229247802,1229248822,4,2,1020
14617498@N00,456,11,1229309180,1229310680,1,1,1500
14617498@N00,457,8,1255831444,1255832584,1,1,1140
14617498@N00,458,4,1318633716,1318634616,1,1,900
14625004@N00,459,6,1195716233,1195717253,2,1,1020
14625004@N00,460,1,1195773036,1195773126,3,6,90
14625004@N00,460,5,1195773998,1195774898,2,6,900
14625004@N00,460,8,1195775070,1195776210,3,6,1140
14625004@N00,460,13,1195779618,1195781418,3,6,1800
14625004@N00,460,4,1195789206,1195790106,2,6,900
14625004@N00,460,6,1195794032,1195795052,2,6,1020
14667816@N02,461,8,1228788885,1228790025,8,1,1140
14764161@N00,462,2,1383224400,1383224790,4,1,390
14769156@N08,463,6,1417954936,1417955956,1,1,1020
14769156@N08,464,8,1433252970,1433253058,2,4,88
14769156@N08,464,11,1433253058,1433253147,3,4,89
14769156@N08,464,8,1433253147,1433253262,2,4,115
14769156@N08,464,2,1433253262,1433253652,4,4,390
14845075@N00,465,13,1407549100,1407550832,2,9,1732
14845075@N00,465,1,1407550832,1407550922,4,9,90
14845075@N00,465,8,1407551662,1407552802,2,9,1140
14845075@N00,465,6,1407554317,1407555337,2,9,1020
14845075@N00,465,1,1407558805,1407558895,3,9,90
14845075@N00,465,6,1407568903,1407569142,3,9,239
14845075@N00,465,4,1407569142,1407569834,2,9,692
14845075@N00,465,8,1407569834,1407570781,4,9,947
14845075@N00,465,1,1407570781,1407570871,2,9,90
14873749@N02,466,1,1215684786,1215684876,18,2,90
14873749@N02,466,8,1215710003,1215711143,2,2,1140
14873749@N02,467,7,1220336845,1220337865,1,1,1020
14873749@N02,468,8,1309952226,1309953366,6,1,1140
14873749@N02,469,1,1311172500,1311172590,1,1,90
14877255@N04,470,4,1442659777,1442660677,1,1,900
14884361@N02,471,10,1264401277,1264402432,2,5,1155
14884361@N02,471,3,1264402432,1264402852,2,5,420
14884361@N02,471,8,1264405412,1264406552,6,5,1140
14884361@N02,471,3,1264407321,1264407741,6,5,420
14884361@N02,471,13,1264411368,1264413168,45,5,1800
14903923@N07,472,5,1242014701,1242015601,1,1,900
14915921@N00,473,5,1196455452,1196456352,2,8,900
14915921@N00,473,10,1196467633,1196469133,2,8,1500
14915921@N00,473,1,1196487856,1196487946,9,8,90
14915921@N00,473,5,1196488208,1196489108,3,8,900
14915921@N00,473,1,1196490360,1196490450,3,8,90
14915921@N00,473,8,1196490719,1196491859,12,8,1140
14915921@N00,473,7,1196493921,1196494941,6,8,1020
14915921@N00,473,13,1196495712,1196497512,2,8,1800
14921024@N02,474,11,1199590942,1199592442,9,1,1500
14921024@N02,475,11,1199787739,1199789239,2,1,1500
14934218@N03,476,5,1214902661,1214902758,2,3,97
14934218@N03,476,8,1214902758,1214902856,2,3,98
14934218@N03,476,6,1214902856,1214903876,1,3,1020
14934218@N03,477,5,1251933724,1251933852,2,8,128
14934218@N03,477,1,1251933852,1251933942,4,8,90
14934218@N03,477,8,1251936680,1251936787,2,8,107
14934218@N03,477,1,1251936787,1251936877,3,8,90
14934218@N03,477,8,1251938306,1251939446,2,8,1140
14934218@N03,477,13,1251943847,1251945647,3,8,1800
14934218@N03,477,8,1251951389,1251952529,13,8,1140
14934218@N03,477,6,1251955094,1251956114,1,8,1020
14958748@N00,478,5,1380171518,1380172418,2,2,900
14958748@N00,478,2,1380188037,1380188427,1,2,390
15021432@N00,479,10,1199653800,1199655300,2,4,1500
15021432@N00,479,8,1199657570,1199658710,6,4,1140
15021432@N00,479,6,1199660969,1199661989,2,4,1020
15021432@N00,479,8,1199670893,1199672033,1,4,1140
15021432@N00,480,8,1209270101,1209271241,5,1,1140
15021432@N00,481,7,1213239626,1213240646,1,1,1020
15021432@N00,482,8,1214626618,1214627758,5,1,1140
15021432@N00,483,8,1216440289,1216441429,4,1,1140
15021432@N00,484,8,1222575947,1222577087,7,1,1140
15021432@N00,485,1,1230715308,1230715398,6,3,90
15021432@N00,485,6,1230716561,1230717581,4,3,1020
15021432@N00,485,8,1230722084,1230723224,5,3,1140
15021432@N00,486,1,1234418286,1234418376,4,1,90
15021432@N00,487,1,1238304720,1238304810,1,1,90
15021432@N00,488,1,1241125116,1241125206,3,2,90
15021432@N00,488,8,1241151856,1241152996,9,2,1140
15021432@N00,489,2,1241218816,1241219206,3,2,390
15021432@N00,489,5,1241252884,1241253784,1,2,900
15048974@N00,490,2,1465087870,1465088260,1,1,390
15066420@N00,491,5,1207865873,1207866773,1,1,900
15079826@N00,492,4,1327722045,1327722945,2,3,900
15079826@N00,492,8,1327723941,1327725081,2,3,1140
15079826@N00,492,4,1327729760,1327730660,1,3,900
15079826@N00,493,2,1400900924,1400901314,4,1,390
15239812@N00,494,6,1352532700,1352533720,1,1,1020
15268966@N00,495,10,1212469915,1212470531,2,7,616
15268966@N00,495,5,1212470531,1212471431,2,7,900
15268966@N00,495,12,1212472510,1212472535,2,7,25
15268966@N00,495,8,1212472535,1212473675,3,7,1140
15268966@N00,495,1,1212476741,1212476831,3,7,90
15268966@N00,495,5,1212478907,1212479807,2,7,900
15268966@N00,495,2,1212491783,1212492173,1,7,390
15279029@N02,496,11,1257119414,1257120914,88,1,1500
15403331@N00,497,8,1420451295,1420452435,2,1,1140
15409357@N07,498,5,1393455272,1393456172,3,2,900
15409357@N07,498,6,1393464345,1393465365,1,2,1020
15409357@N07,499,5,1393625846,1393626746,1,1,900
15409357@N07,500,6,1418972657,1418973677,1,1,1020
15409357@N07,501,1,1431734730,1431734820,1,1,90
15409357@N07,502,1,1431775291,1431775381,1,1,90
15473418@N00,503,8,1212574914,1212575687,2,4,773
15473418@N00,503,9,1212575687,1212576774,8,4,1087
15473418@N00,503,5,1212576774,1212577674,3,4,900
15473418@N00,503,8,1212580632,1212581772,3,4,1140
15473418@N00,504,11,1212806532,1212808032,2,7,1500
15473418@N00,504,10,1212812974,1212813274,2,7,300
15473418@N00,504,1,1212813274,1212813364,2,7,90
15473418@N00,504,4,1212813607,1212814507,8,7,900
15473418@N00,504,8,1212819406,1212819444,3,7,38
15473418@N00,504,4,1212819444,1212820344,7,7,900
15473418@N00,504,1,1212820674,1212820764,1,7,90
15473418@N00,505,11,1212909753,1212909837,2,7,84
15473418@N00,505,8,1212909837,1212909921,2,7,84
15473418@N00,505,11,1212909921,1212911183,3,7,1262
15473418@N00,505,7,1212911183,1212912203,4,7,1020
15473418@N00,505,4,1212919271,1212919504,2,7,233
15473418@N00,505,11,1212919504,1212920092,4,7,588
15473418@N00,505,5,1212920092,1212920992,1,7,900
15515205@N02,506,7,1226446055,1226447075,2,2,1020
15515205@N02,506,6,1226452037,1226453057,2,2,1020
15515205@N02,507,6,1226536803,1226537823,1,1,1020
15530177@N05,508,1,1319067489,1319067579,161,1,90
15531512@N00,509,4,1365736907,1365737807,6,1,900
15531512@N00,510,8,1426458670,1426458684,2,10,14
15531512@N00,510,2,1426458684,1426459074,9,10,390
15531512@N00,510,4,1426463251,1426464151,15,10,900
15531512@N00,510,6,1426468641,1426469661,3,10,1020
15531512@N00,510,4,1426473885,1426474785,2,10,900
15531512@N00,510,8,1426475977,1426476957,10,10,980
15531512@N00,510,2,1426476957,1426477344,10,10,387
15531512@N00,510,8,1426477344,1426477395,5,10,51
15531512@N00,510,6,1426477395,1426477661,11,10,266
15531512@N00,510,8,1426477661,1426478801,1,10,1140
15551876@N04,511,6,1376789152,1376790172,1,1,1020
15578904@N00,512,5,1370672505,1370673405,1,1,900
15652554@N07,513,8,1224817380,1224818520,72,1,1140
15790231@N02,514,5,1222555506,1222555640,2,21,134
15790231@N02,514,10,1222555640,1222555954,2,21,314
15790231@N02,514,1,1222555954,1222556038,3,21,84
15790231@N02,514,8,1222556038,1222556168,2,21,130
15790231@N02,514,13,1222556168,1222556492,2,21,324
15790231@N02,514,11,1222556492,1222557202,4,21,710
15790231@N02,514,2,1222557202,1222557377,3,21,175
15790231@N02,514,4,1222557377,1222558277,10,21,900
15790231@N02,514,2,1222559303,1222559312,2,21,9
15790231@N02,514,13,1222559312,1222561112,4,21,1800
15790231@N02,514,11,1222563971,1222565471,11,21,1500
15790231@N02,514,12,1222567316,1222568816,11,21,1500
15790231@N02,514,1,1222569101,1222569191,3,21,90
15790231@N02,514,5,1222569399,1222569627,2,21,228
15790231@N02,514,10,1222569627,1222571127,9,21,1500
15790231@N02,514,5,1222572776,1222573676,3,21,900
15790231@N02,514,1,1222577669,1222577688,2,21,19
15790231@N02,514,5,1222577688,1222577697,2,21,9
15790231@N02,514,1,1222577697,1222577787,14,21,90
15790231@N02,514,5,1222578685,1222578694,2,21,9
15790231@N02,514,1,1222578694,1222578784,2,21,90
15802258@N04,515,5,1433057103,1433058003,2,1,900
15949547@N04,516,4,1398481260,1398482160,1,1,900
16035349@N05,517,10,1234678038,1234679538,6,1,1500
16088786@N03,518,9,1403367631,1403369131,1,1,1500
16137863@N00,519,6,1345627502,1345628522,1,1,1020
16137863@N00,520,8,1345884852,1345885728,2,2,876
16137863@N00,520,4,1345885728,1345886628,2,2,900
16272116@N03,521,8,1207367876,1207369016,5,2,1140
16272116@N03,521,5,1207375736,1207376636,1,2,900
16355945@N00,522,2,1315527310,1315527700,1,1,390
16355945@N00,523,7,1355138817,1355139837,1,1,1020
16429538@N00,524,9,1246960083,1246961583,7,1,1500
16678301@N02,525,12,1406778124,1406779624,1,1,1500
16691514@N07,526,13,1411199392,1411201192,1,1,1800
16899467@N03,527,4,1200557206,1200557284,2,2,78
16899467@N03,527,13,1200557284,1200559084,9,2,1800
16903393@N07,528,12,1243208713,1243210213,38,2,1500
16903393@N07,528,1,1243212254,1243212344,29,2,90
16985502@N04,529,9,1292576087,1292577587,2,1,1500
16985502@N04,530,6,1324197476,1324198496,3,1,1020
16985502@N04,531,13,1324366174,1324367974,2,2,1800
16985502@N04,531,6,1324368692,1324369712,1,2,1020
16985502@N04,532,13,1353652495,1353654295,4,4,1800
16985502@N04,532,10,1353655329,1353656829,2,4,1500
16985502@N04,532,9,1353660845,1353662345,3,4,1500
16985502@N04,532,6,1353665551,1353666571,3,4,1020
17017714@N04,533,5,1295144135,1295145035,2,2,900
17017714@N04,533,4,1295146865,1295147765,5,2,900
17017714@N04,534,5,1306850400,1306850400,2,2,0
17017714@N04,534,8,1306850400,1306851540,3,2,1140
17057923@N06,535,10,1311712437,1311712524,4,36,87
17057923@N06,535,1,1311712524,1311712614,5,36,90
17057923@N06,535,10,1311715914,1311717414,5,36,1500
17057923@N06,535,8,1311717933,1311718176,3,36,243
17057923@N06,535,1,1311718176,1311718266,3,36,90
17057923@N06,535,2,1311718597,1311718987,12,36,390
17057923@N06,535,6,1311721744,1311721891,4,36,147
17057923@N06,535,4,1311721891,1311722068,4,36,177
17057923@N06,535,2,1311722068,1311722071,2,36,3
17057923@N06,535,4,1311722071,1311722086,2,36,15
17057923@N06,535,2,1311722086,1311722088,2,36,2
17057923@N06,535,4,1311722088,1311722140,4,36,52
17057923@N06,535,2,1311722140,1311722171,3,36,31
17057923@N06,535,4,1311722171,1311722592,10,36,421
17057923@N06,535,2,1311722592,1311722982,26,36,390
17057923@N06,535,6,1311725228,1311725403,3,36,175
17057923@N06,535,4,1311725403,1311726303,7,36,900
17057923@N06,535,10,1311726743,1311727075,21,36,332
17057923@N06,535,4,1311727075,1311727091,2,36,16
17057923@N06,535,10,1311727091,1311728591,66,36,1500
17057923@N06,535,6,1311729043,1311729338,2,36,295
17057923@N06,535,8,1311729338,1311729852,2,36,514
17057923@N06,535,6,1311729852,1311730872,13,36,1020
17057923@N06,535,7,1311737943,1311738963,4,36,1020
17057923@N06,535,6,1311739079,1311740099,5,36,1020
17057923@N06,535,12,1311740708,1311741413,37,36,705
17057923@N06,535,7,1311741413,1311741513,3,36,100
17057923@N06,535,12,1311741513,1311741992,34,36,479
17057923@N06,535,7,1311741992,1311741994,2,36,2
17057923@N06,535,12,1311741994,1311741996,2,36,2
17057923@N06,535,7,1311741996,1311742106,3,36,110
17057923@N06,535,12,1311742106,1311743606,3,36,1500
17057923@N06,535,7,1311747244,1311748164,2,36,920
17057923@N06,535,5,1311748164,1311748580,2,36,416
17057923@N06,535,10,1311748580,1311748607,3,36,27
17057923@N06,535,5,1311748607,1311749507,3,36,900
17099253@N00,536,1,1350258900,1350258990,3,3,90
17099253@N00,536,5,1350259027,1350259927,2,3,900
17099253@N00,536,10,1350265539,1350267039,2,3,1500
17109883@N00,537,4,1301180404,1301180532,3,8,128
17109883@N00,537,6,1301180532,1301181552,3,8,1020
17109883@N00,537,2,1301182033,1301182423,6,8,390
17109883@N00,537,8,1301186114,1301186670,3,8,556
17109883@N00,537,13,1301186670,1301188470,25,8,1800
17109883@N00,537,5,1301190159,1301191059,5,8,900
17109883@N00,537,4,1301197741,1301198306,3,8,565
17109883@N00,537,6,1301198306,1301199326,9,8,1020
17145135@N00,538,2,1330380768,1330381158,2,4,390
17145135@N00,538,5,1330385020,1330385920,2,4,900
17145135@N00,538,6,1330390177,1330391197,3,4,1020
17145135@N00,538,11,1330400055,1330401555,1,4,1500
17328804@N05,539,8,1268823694,1268824834,1,1,1140
17386110@N00,540,13,1373462288,1373464088,1,1,1800
17450418@N08,541,4,1452941466,1452942366,1,1,900
17567960@N00,542,6,1322788947,1322789967,2,2,1020
17567960@N00,542,10,1322815720,1322817220,1,2,1500
17595434@N07,543,8,1400825401,1400826541,1,1,1140
17599044@N08,544,3,1220410255,1220410675,2,2,420
17599044@N08,544,5,1220427915,1220428815,1,2,900
17657655@N00,545,6,1305512674,1305513694,1,1,1020
17657655@N00,546,6,1321086902,1321087922,1,1,1020
17671095@N04,547,8,1244144041,1244145181,2,1,1140
17725987@N00,548,5,1386945640,1386946540,3,1,900
17754571@N02,549,5,1353101652,1353102552,2,1,900
17893195@N03,550,12,1362270687,1362272187,2,2,1500
17893195@N03,550,13,1362274893,1362276693,1,2,1800
17966142@N08,551,4,1432341759,1432342659,2,3,900
17966142@N08,551,8,1432347231,1432348371,3,3,1140
17966142@N08,551,1,1432354655,1432354745,1,3,90
18081271@N00,552,4,1324256937,1324257837,1,1,900
18081271@N00,553,6,1324450953,1324451973,2,2,1020
18081271@N00,553,10,1324456477,1324457977,1,2,1500
18081271@N00,554,6,1324628956,1324629976,3,1,1020
18097936@N00,555,13,1330340719,1330342519,42,1,1800
18097936@N00,556,13,1330408565,1330410365,1,1,1800
18214853@N00,557,4,1346136990,1346137034,2,3,44
18214853@N00,557,13,1346137034,1346137072,2,3,38
18214853@N00,557,6,1346137072,1346138092,2,3,1020
18226236@N00,558,8,1230694033,1230695173,1,1,1140
18229944@N04,559,8,1272386828,1272387968,2,3,1140
18229944@N04,559,2,1272389054,1272389444,2,3,390
18229944@N04,559,1,1272389989,1272390079,1,3,90
18229944@N04,560,5,1272893529,1272894429,1,1,900
18229944@N04,561,1,1317060054,1317060144,1,1,90
18307147@N00,562,10,1228088967,1228090467,2,3,1500
18307147@N00,562,1,1228093973,1228094063,2,3,90
18307147@N00,562,6,1228117448,1228118468,3,3,1020
18581554@N04,563,7,1463537575,1463538595,13,1,1020
18647653@N08,564,6,1376871749,1376872769,3,2,1020
18647653@N08,564,13,1376893202,1376895002,1,2,1800
18703622@N06,565,13,1353625628,1353627428,9,2,1800
18703622@N06,565,2,1353647868,1353648258,16,2,390
18703622@N06,566,8,1359410470,1359411610,11,1,1140
18703622@N06,567,7,1359684017,1359685037,5,1,1020
18748204@N00,568,2,1401088646,1401089036,5,2,390
18748204@N00,568,8,1401098127,1401099267,1,2,1140
18862724@N00,569,1,1338804910,1338805000,1,1,90
19026178@N00,570,1,1195015345,1195015402,3,2,57
19026178@N00,570,7,1195015402,1195016422,1,2,1020
19201870@N00,571,1,1265870931,1265871021,2,2,90
19201870@N00,571,8,1265871092,1265872232,2,2,1140
19213110@N00,572,5,1232688475,1232689375,1,1,900
19262297@N03,573,8,1286262527,1286263667,1,1,1140
19262297@N03,574,10,1286872575,1286874075,1,1,1500
19307177@N00,575,4,1331956915,1331957815,1,1,900
19344501@N00,576,1,1276644718,1276644808,34,1,90
19555551@N00,577,11,1276745849,1276745857,2,5,8
19555551@N00,577,8,1276745857,1276745964,2,5,107
19555551@N00,577,7,1276745964,1276746984,2,5,1020
19555551@N00,577,8,1276747274,1276747636,2,5,362
19555551@N00,577,7,1276747636,1276748656,1,5,1020
19585456@N00,578,4,1359260688,1359261588,1,1,900
19682872@N00,579,13,1451428370,1451430170,25,1,1800
19709423@N04,580,2,1278878299,1278878689,3,2,390
19709423@N04,580,1,1278883944,1278884034,73,2,90
19709423@N04,581,5,1387784872,1387785772,1,1,900
19709423@N04,582,6,1393114125,1393115145,1,1,1020
19712216@N08,583,11,1200365381,1200366881,2,1,1500
19712216@N08,584,11,1200597223,1200598723,8,1,1500
19712216@N08,585,11,1318714524,1318716024,1,1,1500
19771234@N00,586,8,1322966435,1322967575,1,1,1140
19840488@N05,587,1,1221375544,1221375634,1,1,90
19936517@N07,588,2,1385957711,1385958101,1,1,390
19951106@N03,589,12,1320113298,1320114798,4,5,1500
19951106@N03,589,8,1320117972,1320119112,3,5,1140
19951106@N03,589,4,1320121513,1320121657,3,5,144
19951106@N03,589,3,1320121657,1320121683,2,5,26
19951106@N03,589,4,1320121683,1320122583,4,5,900
19951106@N03,590,8,1368922637,1368923777,28,2,1140
19951106@N03,590,4,1368943852,1368944752,6,2,900
20008009@N05,591,4,1431148452,1431149352,2,2,900
20008009@N05,591,7,1431159591,1431160611,2,2,1020
20035490@N00,592,5,1355615444,1355616344,1,1,900
20154444@N04,593,8,1278225183,1278226323,1,1,1140
20184646@N04,594,4,1317087155,1317088055,5,2,900
20184646@N04,594,12,1317099255,1317100755,4,2,1500
20229609@N03,595,8,1341210697,1341211416,2,4,719
20229609@N03,595,2,1341211416,1341211806,5,4,390
20229609@N03,595,11,1341213165,1341214665,3,4,1500
20229609@N03,595,6,1341215083,1341216103,8,4,1020
20268128@N05,596,7,1402714606,1402715626,1,1,1020
20287222@N00,597,2,1290232446,1290232836,4,2,390
20287222@N00,597,6,1290234102,1290235122,2,2,1020
20322483@N05,598,5,1198845213,1198846113,3,2,900
20322483@N05,598,8,1198848196,1198849336,1,2,1140
20322483@N05,599,1,1198932344,1198932434,3,2,90
20322483@N05,599,10,1198936340,1198937840,1,2,1500
20322483@N05,600,1,1204322934,1204323024,3,3,90
20322483@N05,600,5,1204323326,1204324226,3,3,900
20322483@N05,600,7,1204324244,1204325264,1,3,1020
20322483@N05,601,8,1218494020,1218495160,3,1,1140
20322483@N05,602,6,1218625552,1218626572,2,4,1020
20322483@N05,602,8,1218627324,1218627482,2,4,158
20322483@N05,602,1,1218627482,1218627572,4,4,90
20322483@N05,602,13,1218628884,1218630684,1,4,1800
20322483@N05,603,13,1225421313,1225423113,8,1,1800
20333966@N07,604,4,1419980334,1419981234,1,1,900
20544000@N00,605,4,1416104158,1416105058,1,1,900
20677928@N06,606,8,1237125999,1237127139,5,5,1140
20677928@N06,606,4,1237132299,1237133199,7,5,900
20677928@N06,606,13,1237137888,1237139688,2,5,1800
20677928@N06,606,1,1237142106,1237142196,2,5,90
20677928@N06,606,12,1237150320,1237151820,5,5,1500
20677928@N06,607,1,1237981023,1237981113,2,2,90
20677928@N06,607,12,1238006442,1238007942,3,2,1500
20701570@N00,608,1,1319099730,1319099820,2,5,90
20701570@N00,608,8,1319099861,1319100012,3,5,151
20701570@N00,608,7,1319100012,1319100160,2,5,148
20701570@N00,608,8,1319100160,1319100450,4,5,290
20701570@N00,608,2,1319100450,1319100840,3,5,390
20701570@N00,609,4,1319237913,1319238813,3,2,900
20701570@N00,609,2,1319244268,1319244658,1,2,390
20701570@N00,610,5,1349002162,1349003062,3,1,900
20701570@N00,611,2,1349052858,1349053248,2,2,390
20701570@N00,611,4,1349053884,1349054784,1,2,900
20701570@N00,612,10,1402198631,1402198633,2,2,2
20701570@N00,612,2,1402198633,1402199023,3,2,390
20704576@N04,613,6,1197964523,1197965543,5,1,1020
20704576@N04,614,2,1226287392,1226287782,4,1,390
20715134@N00,615,4,1237663687,1237664587,3,4,900
20715134@N00,615,13,1237678007,1237678902,2,4,895
20715134@N00,615,6,1237678902,1237679922,2,4,1020
20715134@N00,615,1,1237690406,1237690496,5,4,90
20719638@N00,616,6,1206741336,1206741400,2,11,64
20719638@N00,616,4,1206741400,1206741463,2,11,63
20719638@N00,616,6,1206741463,1206741779,2,11,316
20719638@N00,616,1,1206741779,1206741854,2,11,75
20719638@N00,616,13,1206741854,1206741873,2,11,19
20719638@N00,616,6,1206741873,1206742196,3,11,323
20719638@N00,616,13,1206742196,1206742303,2,11,107
20719638@N00,616,10,1206742303,1206743129,2,11,826
20719638@N00,616,8,1206743129,1206743867,3,11,738
20719638@N00,616,6,1206743867,1206744162,2,11,295
20719638@N00,616,4,1206744162,1206745062,1,11,900
20727999@N06,617,5,1304831219,1304832119,3,5,900
20727999@N06,617,6,1304832970,1304833990,2,5,1020
20727999@N06,617,2,1304836724,1304837114,2,5,390
20727999@N06,617,8,1304849300,1304850440,5,5,1140
20727999@N06,617,5,1304851376,1304852276,2,5,900
20727999@N06,618,4,1305240570,1305241470,2,7,900
20727999@N06,618,6,1305242567,1305242887,3,7,320
20727999@N06,618,13,1305242887,1305243208,2,7,321
20727999@N06,618,5,1305243208,1305244108,2,7,900
20727999@N06,618,1,1305249345,1305249435,8,7,90
20727999@N06,618,5,1305249760,1305250660,8,7,900
20727999@N06,618,13,1305257094,1305258894,7,7,1800
20771338@N00,619,5,1222041628,1222042528,2,2,900
20771338@N00,619,4,1222043827,1222044727,2,2,900
20869901@N08,620,8,1249545688,1249546828,18,1,1140
20869901@N08,621,8,1249859152,1249860292,76,1,1140
20869901@N08,622,8,1249948361,1249949501,38,1,1140
20885794@N00,623,1,1467601374,1467601464,4,8,90
20885794@N00,623,8,1467601679,1467602819,10,8,1140
20885794@N00,623,7,1467608485,1467609505,6,8,1020
20885794@N00,623,8,1467609514,1467609546,2,8,32
20885794@N00,623,2,1467609546,1467609936,5,8,390
20885794@N00,623,12,1467611720,1467613220,2,8,1500
20885794@N00,623,13,1467614693,1467616374,2,8,1681
20885794@N00,623,4,1467616374,1467617274,7,8,900
21038859@N08,624,1,1209776202,1209776292,2,3,90
21038859@N08,624,8,1209778440,1209779580,2,3,1140
21038859@N08,624,4,1209786677,1209787577,1,3,900
21038859@N08,625,4,1209880322,1209881222,2,3,900
21038859@N08,625,9,1209896950,1209898309,2,3,1359
21038859@N08,625,8,1209898309,1209899449,1,3,1140
21045041@N06,626,1,1206072456,1206072546,11,1,90
21126148@N00,627,12,1211001600,1211003100,1,1,1500
21138471@N00,628,12,1224741979,1224743479,5,2,1500
21138471@N00,628,8,1224744163,1224745303,1,2,1140
21155738@N04,629,6,1293269947,1293270967,6,1,1020
21212744@N07,630,6,1199170978,1199171998,6,1,1020
21254904@N02,631,13,1219977199,1219978999,1,1,1800
21288866@N04,632,2,1383267791,1383268181,1,1,390
21329192@N06,633,8,1252750757,1252751897,14,1,1140
21361334@N02,634,7,1255226989,1255228009,2,2,1020
21361334@N02,634,1,1255233135,1255233225,4,2,90
21369373@N00,635,5,1353713221,1353714121,1,1,900
21377282@N00,636,6,1221192600,1221193620,1,1,1020
21377282@N00,637,4,1402703699,1402704599,1,1,900
21383026@N06,638,12,1243646687,1243648187,2,1,1500
21383026@N06,639,12,1247395199,1247396699,2,1,1500
21422300@N00,640,13,1197679944,1197681744,2,1,1800
21422300@N00,641,6,1218258158,1218259178,1,1,1020
21422300@N00,642,1,1298098142,1298098232,2,3,90
21422300@N00,642,8,1298107736,1298107993,2,3,257
21422300@N00,642,1,1298107993,1298108083,3,3,90
21422300@N00,643,9,1337681467,1337682967,1,1,1500
21432876@N06,644,4,1248916603,1248917503,2,2,900
21432876@N06,644,5,1248936771,1248937671,1,2,900
21619670@N03,645,1,1196900432,1196900522,1,1,90
21641933@N00,646,6,1336538829,1336539849,1,1,1020
21641933@N00,647,12,1377836871,1377837483,3,2,612
21641933@N00,647,1,1377837483,1377837573,1,2,90
21652490@N06,648,8,1196427600,1196428740,81,1,1140
21652490@N06,649,8,1217512800,1217513940,66,1,1140
21652490@N06,650,8,1259586000,1259587140,53,1,1140
21652490@N06,651,8,1275314400,1275315540,33,1,1140
21652490@N06,652,8,1288530000,1288531140,1,1,1140
21652490@N06,653,8,1314799200,1314800340,44,1,1140
21652490@N06,654,8,1354280400,1354281540,2,1,1140
21652490@N06,655,8,1359637200,1359638340,9,1,1140
21667128@N00,656,10,1293434278,1293435736,3,2,1458
21667128@N00,656,5,1293435736,1293436636,1,2,900
21668671@N04,657,8,1336019679,1336020819,13,6,1140
21668671@N04,657,6,1336024940,1336025960,3,6,1020
21668671@N04,657,4,1336032657,1336033048,2,6,391
21668671@N04,657,6,1336033048,1336034068,3,6,1020
21668671@N04,657,1,1336036852,1336036942,2,6,90
21668671@N04,657,9,1336040297,1336041797,13,6,1500
21668671@N04,658,2,1339300070,1339300460,6,1,390
21668671@N04,659,3,1343266738,1343267074,2,3,336
21668671@N04,659,4,1343267074,1343267974,3,3,900
21668671@N04,659,6,1343269233,1343270253,5,3,1020
21668671@N04,660,9,1343800030,1343801530,3,1,1500
21685693@N02,661,12,1195640219,1195640267,2,2,48
21685693@N02,661,7,1195640267,1195641287,1,2,1020
21685693@N02,662,12,1197160054,1197161554,3,1,1500
21685693@N02,663,13,1257374586,1257376386,1,1,1800
21705920@N08,664,7,1369954288,1369955308,1,1,1020
21739162@N04,665,10,1254007504,1254008264,3,9,760
21739162@N04,665,1,1254008264,1254008354,4,9,90
21739162@N04,665,5,1254008390,1254009290,4,9,900
21739162@N04,665,1,1254011291,1254011381,2,9,90
21739162@N04,665,8,1254011397,1254012537,6,9,1140
21739162@N04,665,2,1254014146,1254014536,12,9,390
21739162@N04,665,6,1254018225,1254019245,4,9,1020
21739162@N04,665,4,1254025425,1254026325,3,9,900
21739162@N04,665,1,1254029762,1254029852,4,9,90
21739162@N04,666,5,1302392747,1302393647,3,16,900
21739162@N04,666,8,1302396304,1302396406,2,16,102
21739162@N04,666,12,1302396406,1302397906,3,16,1500
21739162@N04,666,13,1302399340,1302401140,2,16,1800
21739162@N04,666,6,1302401757,1302402131,4,16,374
21739162@N04,666,2,1302402131,1302402521,3,16,390
21739162@N04,666,6,1302410526,1302411546,9,16,1020
21739162@N04,666,8,1302415161,1302415177,2,16,16
21739162@N04,666,2,1302415177,1302415567,3,16,390
21739162@N04,666,12,1302416154,1302417654,7,16,1500
21739162@N04,666,10,1302421757,1302423257,8,16,1500
21739162@N04,666,8,1302423912,1302425052,4,16,1140
21739162@N04,666,1,1302426108,1302426129,2,16,21
21739162@N04,666,8,1302426129,1302426872,2,16,743
21739162@N04,666,4,1302426872,1302427772,3,16,900
21739162@N04,666,9,1302436534,1302438034,10,16,1500
21748548@N00,667,4,1420668219,1420669119,3,5,900
21748548@N00,667,1,1420670224,1420670314,2,5,90
21748548@N00,667,8,1420679391,1420680531,4,5,1140
21748548@N00,667,13,1420682621,1420684421,3,5,1800
21748548@N00,667,9,1420704244,1420705744,23,5,1500
21748548@N00,668,12,1420874883,1420876383,3,3,1500
21748548@N00,668,6,1420877027,1420877055,2,3,28
21748548@N00,668,8,1420877055,1420878195,1,3,1140
21748548@N00,669,2,1420940093,1420940483,1,1,390
21807174@N04,670,2,1233776905,1233777295,1,1,390
21807174@N04,671,1,1309508492,1309508582,1,1,90
21807174@N04,672,1,1309920112,1309920202,10,1,90
21876388@N00,673,6,1291360862,1291361882,2,1,1020
21882182@N03,674,10,1347136030,1347136894,3,2,864
21882182@N03,674,12,1347136894,1347138394,1,2,1500
21978090@N03,675,2,1323213369,1323213759,2,3,390
21978090@N03,675,6,1323218107,1323219127,2,3,1020
21978090@N03,675,12,1323222231,1323223731,3,3,1500
22024026@N03,676,8,1392328741,1392329881,3,3,1140
22024026@N03,676,5,1392334520,1392335420,4,3,900
22024026@N03,676,2,1392351182,1392351572,4,3,390
22046456@N04,677,13,1280416779,1280418579,1,1,1800
22068918@N00,678,5,1237936119,1237937019,2,9,900
22068918@N00,678,6,1237946907,1237947927,2,9,1020
22068918@N00,678,10,1237948656,1237948940,2,9,284
22068918@N00,678,5,1237948940,1237949840,2,9,900
22068918@N00,678,13,1237962625,1237964425,3,9,1800
22068918@N00,678,6,1237964780,1237965800,4,9,1020
22068918@N00,678,8,1237965888,1237966478,3,9,590
22068918@N00,678,13,1237966478,1237968278,2,9,1800
22068918@N00,678,9,1237968757,1237970257,2,9,1500
22107206@N00,679,4,1369528001,1369528901,2,1,900
22151340@N02,680,5,1198647502,1198648402,2,1,900
22151340@N02,681,5,1208572160,1208573060,6,5,900
22151340@N02,681,6,1208596152,1208596694,2,5,542
22151340@N02,681,7,1208596694,1208597714,2,5,1020
22151340@N02,681,5,1208598234,1208599134,6,5,900
22151340@N02,681,10,1208603380,1208604880,1,5,1500
22151340@N02,682,5,1209288292,1209289192,2,1,900
22151340@N02,683,1,1212889309,1212889399,2,7,90
22151340@N02,683,2,1212890752,1212891142,2,7,390
22151340@N02,683,5,1212892693,1212893593,3,7,900
22151340@N02,683,2,1212901656,1212902046,2,7,390
22151340@N02,683,4,1212903509,1212904409,2,7,900
22151340@N02,683,2,1212907558,1212907948,2,7,390
22151340@N02,683,5,1212910214,1212911114,1,7,900
22151340@N02,684,2,1213235008,1213235398,4,5,390
22151340@N02,684,5,1213238407,1213239307,2,5,900
22151340@N02,684,2,1213244697,1213245087,2,5,390
22151340@N02,684,4,1213249749,1213250649,2,5,900
22151340@N02,684,6,1213254828,1213255848,1,5,1020
22151340@N02,685,2,1214189325,1214189715,4,3,390
22151340@N02,685,8,1214189952,1214191092,2,3,1140
22151340@N02,685,5,1214194504,1214195404,4,3,900
22151340@N02,686,6,1216534981,1216536001,1,1,1020
22185077@N06,687,1,1356962806,1356962896,2,2,90
22185077@N06,687,2,1356963856,1356964246,1,2,390
22232518@N05,688,2,1218609689,1218610079,1,1,390
22232518@N05,689,9,1275928618,1275930118,13,1,1500
22232518@N05,690,4,1313029189,1313030089,2,1,900
22255270@N04,691,1,1194478645,1194478735,20,2,90
22255270@N04,691,10,1194509355,1194510855,3,2,1500
22261589@N00,692,10,1194302419,1194303919,2,1,1500
22261589@N00,693,1,1194927018,1194927108,1,1,90
22261589@N00,694,1,1203833031,1203833121,1,1,90
22261589@N00,695,1,1240993297,1240993387,1,1,90
22261589@N00,696,12,1291509421,1291510921,2,3,1500
22261589@N00,696,7,1291512014,1291512965,3,3,951
22261589@N00,696,8,1291512965,1291514105,3,3,1140
22261589@N00,697,4,1291890232,1291891132,2,2,900
22261589@N00,697,9,1291895627,1291897127,1,2,1500
22261589@N00,698,4,1292293689,1292294589,2,2,900
22261589@N00,698,8,1292300291,1292301431,1,2,1140
22261589@N00,699,8,1337295956,1337296112,2,6,156
22261589@N00,699,1,1337296112,1337296202,2,6,90
22261589@N00,699,5,1337296239,1337297139,2,6,900
22261589@N00,699,10,1337298885,1337300385,2,6,1500
22261589@N00,699,8,1337302561,1337303701,2,6,1140
22261589@N00,699,1,1337310476,1337310566,1,6,90
22261589@N00,700,1,1337901326,1337901416,6,1,90
22261589@N00,701,5,1346764818,1346764840,2,5,22
22261589@N00,701,8,1346764840,1346764852,2,5,12
22261589@N00,701,1,1346764852,1346764882,3,5,30
22261589@N00,701,10,1346764882,1346764892,2,5,10
22261589@N00,701,8,1346764892,1346766032,1,5,1140
22261589@N00,702,1,1386024533,1386024623,3,3,90
22261589@N00,702,3,1386028717,1386029137,2,3,420
22261589@N00,702,6,1386054374,1386055394,2,3,1020
22265703@N06,703,6,1246970420,1246971440,1,1,1020
22273519@N07,704,4,1315872562,1315873462,7,2,900
22273519@N07,704,6,1315880103,1315881123,2,2,1020
22295147@N05,705,5,1284886983,1284887883,1,1,900
22326950@N05,706,10,1199130496,1199130500,2,5,4
22326950@N05,706,5,1199130500,1199130529,3,5,29
22326950@N05,706,10,1199130529,1199130538,2,5,9
22326950@N05,706,5,1199130538,1199130569,4,5,31
22326950@N05,706,10,1199130569,1199132069,1,5,1500
22326950@N05,707,4,1217840984,1217841884,5,3,900
22326950@N05,707,1,1217842684,1217842774,3,3,90
22326950@N05,707,9,1217843470,1217844970,16,3,1500
22326950@N05,708,10,1217918304,1217918470,3,3,166
22326950@N05,708,1,1217918470,1217918560,2,3,90
22326950@N05,708,11,1217918628,1217920128,19,3,1500
22326950@N05,709,10,1243028036,1243029536,2,2,1500
22326950@N05,709,4,1243041471,1243042371,1,2,900
22326950@N05,710,10,1243359860,1243361360,2,3,1500
22326950@N05,710,4,1243376341,1243377241,6,3,900
22326950@N05,710,10,1243384793,1243386293,1,3,1500
22326950@N05,711,1,1247485976,1247486066,3,3,90
22326950@N05,711,8,1247486290,1247487430,7,3,1140
22326950@N05,711,4,1247488606,1247489506,1,3,900
22326950@N05,712,8,1247623783,1247624923,1,1,1140
22423587@N03,713,1,1217726205,1217726295,3,5,90
22423587@N03,713,11,1217726975,1217728220,6,5,1245
22423587@N03,713,8,1217728220,1217729360,2,5,1140
22423587@N03,713,6,1217730240,1217730886,2,5,646
22423587@N03,713,2,1217730886,1217731276,4,5,390
22423587@N03,714,1,1284885713,1284885803,1,1,90
22423587@N03,715,11,1291783298,1291784798,2,2,1500
22423587@N03,715,1,1291785882,1291785972,1,2,90
22423587@N03,716,8,1297566560,1297567700,2,3,1140
22423587@N03,716,2,1297576403,1297576793,2,3,390
22423587@N03,716,8,1297580557,1297581697,1,3,1140
22423587@N03,717,1,1299317334,1299317424,1,1,90
22423587@N03,718,1,1319417115,1319417205,2,1,90
22423587@N03,719,1,1323663675,1323663765,1,1,90
22446827@N02,720,1,1401249463,1401249553,1,1,90
22462637@N00,721,13,1301808706,1301810466,3,3,1760
22462637@N00,721,1,1301810466,1301810556,2,3,90
22462637@N00,721,4,1301814104,1301815004,1,3,900
22473198@N00,722,4,1319254899,1319255799,3,2,900
22473198@N00,722,5,1319260527,1319261427,1,2,900
22474934@N00,723,13,1382497551,1382499351,2,7,1800
22474934@N00,723,3,1382500322,1382500486,3,7,164
22474934@N00,723,4,1382500486,1382501386,2,7,900
22474934@N00,723,11,1382502935,1382503374,7,7,439
22474934@N00,723,1,1382503374,1382503464,16,7,90
22474934@N00,723,4,1382506486,1382507386,11,7,900
22474934@N00,723,8,1382512454,1382513594,1,7,1140
22496843@N03,724,6,1207610175,1207611195,4,8,1020
22496843@N03,724,5,1207622173,1207623073,25,8,900
22496843@N03,724,6,1207636715,1207637735,9,8,1020
22496843@N03,724,5,1207642041,1207642941,5,8,900
22496843@N03,724,8,1207647639,1207647896,3,8,257
22496843@N03,724,1,1207647896,1207647986,3,8,90
22496843@N03,724,9,1207648782,1207650282,4,8,1500
22496843@N03,724,1,1207652607,1207652697,1,8,90
22597539@N03,725,1,1301872434,1301872524,1,1,90
22659528@N06,726,6,1347251891,1347252911,2,5,1020
22659528@N06,726,12,1347266071,1347267571,2,5,1500
22659528@N06,726,4,1347270010,1347270910,2,5,900
22659528@N06,726,8,1347275229,1347275497,2,5,268
22659528@N06,726,9,1347275497,1347276997,2,5,1500
22659528@N06,727,1,1347321853,1347321943,1,1,90
22659528@N06,728,12,1347689750,1347691250,3,1,1500
22659528@N06,729,11,1348126437,1348127937,2,3,1500
22659528@N06,729,4,1348133278,1348134178,2,3,900
22659528@N06,729,12,1348138769,1348140269,1,3,1500
22659528@N06,730,4,1348189497,1348190397,1,1,900
22659528@N06,731,6,1348367556,1348368576,1,1,1020
22659528@N06,732,7,1401434890,1401435910,1,1,1020
22659528@N06,733,2,1401520202,1401520592,2,2,390
22659528@N06,733,6,1401525953,1401526973,1,2,1020
22659528@N06,734,8,1401594959,1401596099,1,1,1140
22659528@N06,735,2,1402042248,1402042638,1,1,390
22659528@N06,736,13,1407400923,1407402723,1,1,1800
22659528@N06,737,1,1407570144,1407570234,3,1,90
22687691@N02,738,4,1194396023,1194396923,2,1,900
22687691@N02,739,6,1225767179,1225768199,1,1,1020
22696986@N08,740,8,1339309939,1339311079,3,3,1140
22696986@N08,740,11,1339317214,1339318714,2,3,1500
22696986@N08,740,5,1339325479,1339326379,1,3,900
22720103@N06,741,12,1346284226,1346284620,2,5,394
22720103@N06,741,1,1346284620,1346284710,2,5,90
22720103@N06,741,8,1346287974,1346289114,2,5,1140
22720103@N06,741,1,1346289664,1346289754,3,5,90
22720103@N06,741,8,1346300868,1346302008,2,5,1140
22786107@N06,742,4,1206844730,1206845630,4,3,900
22786107@N06,742,2,1206849633,1206850023,2,3,390
22786107@N06,742,1,1206852549,1206852639,1,3,90
22802028@N08,743,4,1209626627,1209627527,2,7,900
22802028@N08,743,6,1209629875,1209630895,4,7,1020
22802028@N08,743,8,1209631097,1209631973,3,7,876
22802028@N08,743,6,1209631973,1209632993,2,7,1020
22802028@N08,743,9,1209634552,1209634805,2,7,253
22802028@N08,743,8,1209634805,1209635318,2,7,513
22802028@N08,743,9,1209635318,1209636818,10,7,1500
22802028@N08,744,5,1209862528,1209863428,4,1,900
22808487@N04,745,8,1260069883,1260071023,3,7,1140
22808487@N04,745,5,1260071092,1260071110,2,7,18
22808487@N04,745,1,1260071110,1260071168,2,7,58
22808487@N04,745,5,1260071168,1260071189,2,7,21
22808487@N04,745,1,1260071189,1260071279,3,7,90
22808487@N04,745,11,1260078372,1260079872,7,7,1500
22808487@N04,745,6,1260081290,1260082310,24,7,1020
22854594@N07,746,2,1380014125,1380014515,1,1,390
22854594@N07,747,6,1381421737,1381422757,2,2,1020
22854594@N07,747,8,1381444628,1381445768,1,2,1140
22866792@N00,748,1,1291434699,1291434789,2,6,90
22866792@N00,748,4,1291434998,1291435272,3,6,274
22866792@N00,748,6,1291435272,1291436292,7,6,1020
22866792@N00,748,8,1291437489,1291438629,2,6,1140
22866792@N00,748,6,1291439184,1291439887,2,6,703
22866792@N00,748,12,1291439887,1291441387,2,6,1500
22884021@N06,749,1,1262851928,1262852018,2,3,90
22884021@N06,749,5,1262861512,1262861760,2,3,248
22884021@N06,749,8,1262861760,1262862900,1,3,1140
22937808@N04,750,1,1367885201,1367885291,1,1,90
22937808@N04,751,8,1462232120,1462233260,1,1,1140
22966062@N04,752,6,1198571566,1198572586,2,2,1020
22966062@N04,752,5,1198574137,1198575037,1,2,900
22967174@N06,753,8,1341119760,1341120900,1,1,1140
23012921@N08,754,1,1305432604,1305432694,1,1,90
23012921@N08,755,1,1309780827,1309780917,1,1,90
23028801@N03,756,11,1350231018,1350232518,1,1,1500
23041412@N08,757,2,1243308805,1243309195,2,1,390
23041412@N08,758,2,1243576693,1243577083,2,1,390
23043254@N03,759,10,1197096135,1197097635,1,1,1500
23043254@N03,760,6,1198133661,1198134681,3,1,1020
23043254@N03,761,5,1201476549,1201477449,2,2,900
23043254@N03,761,4,1201481395,1201482295,1,2,900
23070886@N08,762,5,1277106418,1277107318,1,1,900
23071450@N02,763,11,1283755007,1283756507,1,1,1500
23099604@N06,764,8,1199947153,1199948293,1,1,1140
23108813@N00,765,5,1226209572,1226210472,1,1,900
23108813@N00,766,1,1242545490,1242545580,1,1,90
23108813@N00,767,6,1260082955,1260083975,1,1,1020
23108813@N00,768,11,1264659905,1264661405,1,1,1500
23108813@N00,769,12,1279597387,1279598887,1,1,1500
23108813@N00,770,2,1281179316,1281179706,1,1,390
23108813@N00,771,4,1294366390,1294367290,1,1,900
23108813@N00,772,6,1337423353,1337424373,1,1,1020
23108813@N00,773,1,1337564502,1337564592,1,1,90
23108813@N00,774,10,1358905863,1358907363,1,1,1500
23108813@N00,775,6,1384500183,1384501203,1,1,1020
23108813@N00,776,6,1416390033,1416391053,1,1,1020
23108813@N00,777,5,1423429130,1423430030,1,1,900
23108813@N00,778,8,1430778952,1430780092,1,1,1140
23108813@N00,779,11,1432200997,1432202497,1,1,1500
23108813@N00,780,6,1450861084,1450862104,1,1,1020
23108813@N00,781,1,1459502294,1459502384,1,1,90
23108813@N00,782,4,1462961334,1462962234,1,1,900
23117061@N05,783,5,1331108190,1331109090,1,1,900
23205379@N02,784,5,1400815301,1400816201,2,3,900
23205379@N02,784,2,1400820543,1400820933,2,3,390
23205379@N02,784,9,1400834060,1400835560,1,3,1500
23205379@N02,785,5,1408742573,1408743473,1,1,900
23212779@N04,786,11,1291773094,1291774594,1,1,1500
23237004@N06,787,1,1351067693,1351067783,2,1,90
23288611@N00,788,2,1232175283,1232175673,1,1,390
23311397@N04,789,1,1246831927,1246831982,3,3,55
23311397@N04,789,8,1246831982,1246833122,12,3,1140
23311397@N04,789,1,1246856765,1246856855,3,3,90
23319775@N04,790,13,1394452693,1394454493,3,6,1800
23319775@N04,790,10,1394456309,1394457809,2,6,1500
23319775@N04,790,5,1394458305,1394459205,3,6,900
23319775@N04,790,2,1394461485,1394461875,2,6,390
23319775@N04,790,12,1394464558,1394466058,3,6,1500
23319775@N04,790,8,1394483229,1394484369,1,6,1140
23322134@N02,791,5,1201293247,1201294147,5,5,900
23322134@N02,791,1,1201296001,1201296091,2,5,90
23322134@N02,791,2,1201297241,1201297631,3,5,390
23322134@N02,791,6,1201299218,1201300238,2,5,1020
23322134@N02,791,1,1201304282,1201304372,1,5,90
23322134@N02,792,13,1213666693,1213668493,2,2,1800
23322134@N02,792,6,1213669690,1213670710,1,2,1020
23322134@N02,793,9,1226826138,1226827638,8,5,1500
23322134@N02,793,8,1226829004,1226830144,3,5,1140
23322134@N02,793,5,1226831300,1226832200,5,5,900
23322134@N02,793,1,1226834099,1226834189,2,5,90
23322134@N02,793,8,1226834717,1226835857,1,5,1140
23322134@N02,794,5,1245197193,1245198093,4,10,900
23322134@N02,794,11,1245200917,1245202417,2,10,1500
23322134@N02,794,8,1245213548,1245214688,4,10,1140
23322134@N02,794,5,1245221613,1245222513,2,10,900
23322134@N02,794,1,1245228563,1245228653,3,10,90
23322134@N02,794,5,1245233250,1245234150,2,10,900
23322134@N02,794,1,1245234491,1245234581,2,10,90
23322134@N02,794,4,1245239237,1245239548,2,10,311
23322134@N02,794,3,1245239548,1245239968,2,10,420
23322134@N02,794,6,1245246049,1245247069,1,10,1020
23322134@N02,795,1,1260054999,1260055089,3,5,90
23322134@N02,795,6,1260058900,1260059920,2,5,1020
23322134@N02,795,3,1260072565,1260072985,2,5,420
23322134@N02,795,8,1260076219,1260077359,2,5,1140
23322134@N02,795,1,1260081657,1260081747,1,5,90
23322134@N02,796,1,1267824681,1267824771,7,4,90
23322134@N02,796,2,1267836685,1267837075,2,4,390
23322134@N02,796,6,1267837742,1267838762,2,4,1020
23322134@N02,796,10,1267849645,1267851145,1,4,1500
23322134@N02,797,1,1291411296,1291411386,2,3,90
23322134@N02,797,11,1291422604,1291424104,2,3,1500
23322134@N02,797,1,1291429796,1291429886,1,3,90
23322134@N02,798,6,1291535114,1291536134,3,1,1020
23322134@N02,799,1,1301611116,1301611206,2,1,90
23322134@N02,800,8,1310429560,1310430700,2,6,1140
23322134@N02,800,5,1310436525,1310437425,2,6,900
23322134@N02,800,2,1310440257,1310440647,2,6,390
23322134@N02,800,10,1310461120,1310461233,2,6,113
23322134@N02,800,5,1310461233,1310462133,2,6,900
23322134@N02,800,4,1310466892,1310467792,1,6,900
23322134@N02,801,10,1310609460,1310610960,1,1,1500
23322134@N02,802,11,1325490387,1325491887,1,1,1500
23380822@N05,803,6,1385629678,1385630587,28,2,909
23380822@N05,803,4,1385630587,1385631487,1,2,900
23492103@N03,804,11,1223261086,1223262586,4,1,1500
23531325@N00,805,11,1242194190,1242195690,1,1,1500
23566994@N06,806,8,1218693800,1218694940,2,1,1140
23566994@N06,807,8,1233289601,1233290741,3,1,1140
23573205@N05,808,1,1278898714,1278898804,2,10,90
23573205@N05,808,13,1278898932,1278900732,18,10,1800
23573205@N05,808,4,1278901466,1278902366,17,10,900
23573205@N05,808,13,1278903182,1278904024,2,10,842
23573205@N05,808,6,1278904024,1278905044,13,10,1020
23573205@N05,808,2,1278906613,1278907003,3,10,390
23573205@N05,808,6,1278909931,1278910951,2,10,1020
23573205@N05,808,4,1278911017,1278911478,6,10,461
23573205@N05,808,8,1278911478,1278912618,2,10,1140
23573205@N05,808,6,1278913474,1278914494,18,10,1020
23673310@N02,809,4,1200182905,1200183095,4,2,190
23673310@N02,809,1,1200183095,1200183185,1,2,90
23673310@N02,810,1,1200434213,1200434303,3,9,90
23673310@N02,810,5,1200434876,1200435776,3,9,900
23673310@N02,810,6,1200442771,1200443791,13,9,1020
23673310@N02,810,4,1200446108,1200447008,4,9,900
23673310@N02,810,8,1200447270,1200448410,10,9,1140
23673310@N02,810,7,1200450643,1200451663,3,9,1020
23673310@N02,810,12,1200454372,1200455872,2,9,1500
23673310@N02,810,1,1200456526,1200456616,21,9,90
23673310@N02,810,9,1200469402,1200470902,38,9,1500
23673310@N02,811,1,1204368002,1204368092,8,6,90
23673310@N02,811,6,1204368283,1204368323,2,6,40
23673310@N02,811,1,1204368323,1204368362,2,6,39
23673310@N02,811,6,1204368362,1204368603,7,6,241
23673310@N02,811,4,1204368603,1204368895,8,6,292
23673310@N02,811,1,1204368895,1204368985,3,6,90
23673310@N02,812,2,1212920296,1212920686,13,1,390
23673310@N02,813,2,1213402432,1213402822,3,12,390
23673310@N02,813,4,1213408047,1213408947,47,12,900
23673310@N02,813,6,1213412464,1213413484,9,12,1020
23673310@N02,813,8,1213417646,1213418786,10,12,1140
23673310@N02,813,1,1213419692,1213419782,25,12,90
23673310@N02,813,8,1213420720,1213421860,16,12,1140
23673310@N02,813,11,1213422925,1213424425,2,12,1500
23673310@N02,813,8,1213424474,1213425614,5,12,1140
23673310@N02,813,4,1213427526,1213428131,5,12,605
23673310@N02,813,3,1213428131,1213428551,5,12,420
23673310@N02,813,6,1213429436,1213430456,6,12,1020
23673310@N02,813,4,1213431514,1213432414,1,12,900
23673310@N02,814,10,1213918512,1213920012,3,5,1500
23673310@N02,814,4,1213926582,1213927482,11,5,900
23673310@N02,814,2,1213929821,1213930211,7,5,390
23673310@N02,814,5,1213932252,1213933152,2,5,900
23673310@N02,814,10,1213934552,1213936052,1,5,1500
23673310@N02,815,6,1214020414,1214021434,6,1,1020
23673310@N02,816,2,1292623265,1292623655,5,9,390
23673310@N02,816,11,1292624949,1292626449,3,9,1500
23673310@N02,816,6,1292627491,1292628511,5,9,1020
23673310@N02,816,4,1292631194,1292632094,2,9,900
23673310@N02,816,5,1292633301,1292634201,2,9,900
23673310@N02,816,12,1292635632,1292637132,4,9,1500
23673310@N02,816,2,1292658664,1292659054,4,9,390
23673310@N02,816,6,1292659942,1292660962,21,9,1020
23673310@N02,816,4,1292662151,1292663051,1,9,900
23673310@N02,817,2,1304118791,1304119181,3,2,390
23673310@N02,817,5,1304122415,1304123315,4,2,900
23673310@N02,818,10,1339193405,1339193576,3,15,171
23673310@N02,818,1,1339193576,1339193666,2,15,90
23673310@N02,818,5,1339194875,1339195775,3,15,900
23673310@N02,818,8,1339200285,1339201425,7,15,1140
23673310@N02,818,2,1339201887,1339202277,4,15,390
23673310@N02,818,1,1339208412,1339208502,2,15,90
23673310@N02,818,8,1339209799,1339210939,19,15,1140
23673310@N02,818,1,1339212225,1339212315,2,15,90
23673310@N02,818,13,1339212521,1339212997,2,15,476
23673310@N02,818,4,1339212997,1339213897,4,15,900
23673310@N02,818,13,1339214510,1339216310,3,15,1800
23673310@N02,818,6,1339227530,1339228550,5,15,1020
23673310@N02,818,3,1339233009,1339233429,3,15,420
23673310@N02,818,1,1339236610,1339236700,29,15,90
23673310@N02,818,9,1339239547,1339241047,4,15,1500
23673310@N02,819,2,1415426085,1415426475,2,4,390
23673310@N02,819,12,1415428708,1415430208,8,4,1500
23673310@N02,819,6,1415432443,1415433463,39,4,1020
23673310@N02,819,3,1415434472,1415434892,1,4,420
23684642@N08,820,12,1254273780,1254275280,2,2,1500
23684642@N08,820,1,1254278861,1254278951,1,2,90
23684642@N08,821,12,1259632543,1259634043,2,4,1500
23684642@N08,821,8,1259641514,1259642654,2,4,1140
23684642@N08,821,10,1259645002,1259646502,2,4,1500
23684642@N08,821,8,1259652388,1259653528,1,4,1140
23684642@N08,822,1,1259890676,1259890766,1,1,90
23684642@N08,823,1,1261014189,1261014279,2,4,90
23684642@N08,823,7,1261022220,1261023240,4,4,1020
23684642@N08,823,5,1261034262,1261035162,2,4,900
23684642@N08,823,6,1261035526,1261036546,2,4,1020
23684642@N08,824,2,1272005609,1272005999,1,1,390
23684642@N08,825,6,1275442804,1275443824,2,1,1020
23684642@N08,826,6,1275609830,1275610850,3,3,1020
23684642@N08,826,13,1275620945,1275622745,2,3,1800
23684642@N08,826,6,1275626276,1275627296,1,3,1020
23684642@N08,827,8,1285045788,1285046928,1,1,1140
23693999@N05,828,6,1224819100,1224820120,1,1,1020
23693999@N05,829,4,1346380047,1346380947,3,3,900
23693999@N05,829,2,1346390822,1346391212,2,3,390
23693999@N05,829,8,1346394382,1346395522,1,3,1140
23701913@N04,830,4,1442480644,1442481544,1,1,900
23716209@N02,831,4,1347208146,1347209046,1,1,900
23720661@N08,832,1,1244683423,1244683513,2,4,90
23720661@N08,832,8,1244687130,1244688270,2,4,1140
23720661@N08,832,5,1244693150,1244693636,2,4,486
23720661@N08,832,1,1244693636,1244693726,1,4,90
23720661@N08,833,5,1262741869,1262742769,2,4,900
23720661@N08,833,1,1262743730,1262743820,3,4,90
23720661@N08,833,8,1262749881,1262751021,2,4,1140
23720661@N08,833,5,1262763475,1262764375,1,4,900
23720661@N08,834,1,1275211922,1275212012,2,3,90
23720661@N08,834,8,1275212987,1275214127,2,3,1140
23720661@N08,834,5,1275216147,1275217047,2,3,900
23720661@N08,835,10,1275271014,1275272514,2,4,1500
23720661@N08,835,8,1275272856,1275273996,2,4,1140
23720661@N08,835,11,1275282060,1275282900,2,4,840
23720661@N08,835,1,1275282900,1275282990,1,4,90
23720661@N08,836,6,1302166235,1302167255,1,1,1020
23720661@N08,837,1,1307324980,1307325070,3,5,90
23720661@N08,837,8,1307326810,1307327950,4,5,1140
23720661@N08,837,5,1307329070,1307329970,4,5,900
23720661@N08,837,6,1307335234,1307336254,2,5,1020
23720661@N08,837,10,1307336387,1307337887,1,5,1500
23720661@N08,838,5,1331078097,1331078997,3,7,900
23720661@N08,838,8,1331080323,1331081463,2,7,1140
23720661@N08,838,6,1331081686,1331082706,2,7,1020
23720661@N08,838,3,1331084451,1331084871,5,7,420
23720661@N08,838,4,1331086160,1331086431,2,7,271
23720661@N08,838,13,1331086431,1331086585,5,7,154
23720661@N08,838,8,1331086585,1331087725,4,7,1140
23720661@N08,839,1,1369708560,1369708614,2,6,54
23720661@N08,839,5,1369708614,1369709514,4,6,900
23720661@N08,839,8,1369710134,1369711274,2,6,1140
23720661@N08,839,1,1369711709,1369711799,2,6,90
23720661@N08,839,8,1369715679,1369716819,4,6,1140
23720661@N08,839,6,1369720601,1369721621,1,6,1020
23720661@N08,840,8,1369882021,1369883161,4,5,1140
23720661@N08,840,4,1369883198,1369884039,2,5,841
23720661@N08,840,3,1369884039,1369884459,2,5,420
23720661@N08,840,1,1369885994,1369886084,2,5,90
23720661@N08,840,10,1369887425,1369888925,2,5,1500
23720661@N08,841,5,1370073738,1370074638,1,1,900
23724661@N00,842,1,1299355574,1299355664,1,1,90
23734263@N03,843,6,1375236660,1375237680,1,1,1020
23828731@N02,844,12,1226359920,1226360279,2,5,359
23828731@N02,844,8,1226360279,1226361419,3,5,1140
23828731@N02,844,2,1226361764,1226362154,2,5,390
23828731@N02,844,4,1226373962,1226374862,3,5,900
23828731@N02,844,6,1226377010,1226378030,3,5,1020
23828731@N02,845,1,1287264392,1287264463,3,6,71
23828731@N02,845,8,1287264463,1287264553,3,6,90
23828731@N02,845,2,1287264553,1287264756,3,6,203
23828731@N02,845,1,1287264756,1287264775,2,6,19
23828731@N02,845,10,1287264775,1287264885,2,6,110
23828731@N02,845,5,1287264885,1287265785,11,6,900
23828731@N02,846,1,1339128025,1339128115,2,11,90
23828731@N02,846,8,1339128526,1339128536,2,11,10
23828731@N02,846,4,1339128536,1339128607,3,11,71
23828731@N02,846,8,1339128607,1339129747,4,11,1140
23828731@N02,846,5,1339130644,1339131544,4,11,900
23828731@N02,846,2,1339135377,1339135767,3,11,390
23828731@N02,846,8,1339138475,1339139615,3,11,1140
23828731@N02,846,4,1339139949,1339140219,2,11,270
23828731@N02,846,6,1339140219,1339140478,2,11,259
23828731@N02,846,2,1339140478,1339140616,5,11,138
23828731@N02,846,8,1339140616,1339141756,3,11,1140
23828731@N02,847,13,1341298344,1341298769,2,7,425
23828731@N02,847,8,1341298769,1341298818,2,7,49
23828731@N02,847,1,1341298818,1341298908,3,7,90
23828731@N02,847,13,1341301110,1341301290,2,7,180
23828731@N02,847,3,1341301290,1341301710,2,7,420
23828731@N02,847,4,1341302848,1341302968,2,7,120
23828731@N02,847,13,1341302968,1341304768,1,7,1800
23828731@N02,848,7,1344848394,1344849414,1,1,1020
23828731@N02,849,2,1345358067,1345358457,2,1,390
23828731@N02,850,2,1346654101,1346654491,1,1,390
23828731@N02,851,6,1357368754,1357369774,29,1,1020
23828731@N02,852,1,1367645804,1367645894,2,1,90
23828731@N02,853,2,1368178464,1368178854,1,1,390
23833168@N04,854,13,1354758378,1354760178,13,3,1800
23833168@N04,854,6,1354772599,1354773619,7,3,1020
23833168@N04,854,1,1354779579,1354779669,5,3,90
23942903@N00,855,2,1326505935,1326506325,2,3,390
23942903@N00,855,6,1326513632,1326514652,2,3,1020
23942903@N00,855,1,1326524173,1326524263,1,3,90
23953488@N03,856,1,1226102392,1226102482,2,2,90
23953488@N03,856,8,1226106633,1226107773,1,2,1140
24021297@N00,857,4,1307150724,1307150779,2,3,55
24021297@N00,857,2,1307150779,1307150939,2,3,160
24021297@N00,857,1,1307150939,1307151029,1,3,90
24021297@N00,858,10,1343612634,1343614134,3,1,1500
24021297@N00,859,8,1371370439,1371371579,1,1,1140
24048284@N02,860,10,1203846219,1203846220,2,8,1
24048284@N02,860,5,1203846220,1203846223,2,8,3
24048284@N02,860,6,1203846223,1203846224,2,8,1
24048284@N02,860,8,1203846224,1203846275,2,8,51
24048284@N02,860,10,1203846275,1203846276,2,8,1
24048284@N02,860,1,1203846276,1203846278,3,8,2
24048284@N02,860,5,1203846278,1203846282,3,8,4
24048284@N02,860,8,1203846282,1203847422,1,8,1140
24083444@N03,861,6,1305962453,1305963473,1,1,1020
24143798@N08,862,4,1432963056,1432963956,2,1,900
24213326@N04,863,4,1345201654,1345202554,1,1,900
24230954@N06,864,5,1201260203,1201261103,1,1,900
24232695@N00,865,2,1325298026,1325298416,8,3,390
24232695@N00,865,6,1325302815,1325303835,3,3,1020
24232695@N00,865,13,1325310710,1325312510,2,3,1800
24306356@N00,866,4,1386109717,1386110617,7,2,900
24306356@N00,866,8,1386128698,1386129838,2,2,1140
24345053@N06,867,4,1290728212,1290729112,2,2,900
24345053@N06,867,12,1290748318,1290749818,1,2,1500
24364723@N08,868,6,1349421194,1349422214,1,1,1020
24386268@N05,869,6,1204259651,1204260671,3,1,1020
24386374@N00,870,8,1378360270,1378361410,7,1,1140
24386374@N00,871,8,1378455226,1378456366,23,1,1140
24386374@N00,872,8,1378607567,1378608707,3,1,1140
24391317@N05,873,6,1275726185,1275727205,1,1,1020
24435279@N00,874,9,1194743041,1194744029,3,2,988
24435279@N00,874,10,1194744029,1194745529,6,2,1500
24435279@N00,875,11,1204944748,1204946248,2,2,1500
24435279@N00,875,4,1204949346,1204950246,3,2,900
24435279@N00,876,1,1205021903,1205021993,7,11,90
24435279@N00,876,8,1205022040,1205022226,9,11,186
24435279@N00,876,11,1205022226,1205023726,15,11,1500
24435279@N00,876,8,1205026047,1205026520,14,11,473
24435279@N00,876,1,1205026520,1205026610,3,11,90
24435279@N00,876,12,1205026660,1205026800,6,11,140
24435279@N00,876,1,1205026800,1205026890,3,11,90
24435279@N00,876,2,1205027379,1205027769,5,11,390
24435279@N00,876,6,1205028633,1205029209,3,11,576
24435279@N00,876,8,1205029209,1205030349,3,11,1140
24435279@N00,876,1,1205032700,1205032790,17,11,90
24435279@N00,877,11,1208917519,1208917775,3,8,256
24435279@N00,877,8,1208917775,1208917983,9,8,208
24435279@N00,877,1,1208917983,1208918060,3,8,77
24435279@N00,877,11,1208918060,1208918364,5,8,304
24435279@N00,877,12,1208918364,1208919864,31,8,1500
24435279@N00,877,1,1208920341,1208920431,5,8,90
24435279@N00,877,2,1208921495,1208921708,2,8,213
24435279@N00,877,6,1208921708,1208922728,11,8,1020
24435279@N00,878,10,1217716359,1217717859,5,4,1500
24435279@N00,878,11,1217718605,1217718745,9,4,140
24435279@N00,878,1,1217718745,1217718792,2,4,47
24435279@N00,878,12,1217718792,1217720292,6,4,1500
24435279@N00,879,1,1222567241,1222567331,6,12,90
24435279@N00,879,2,1222568150,1222568423,4,12,273
24435279@N00,879,8,1222568423,1222569563,2,12,1140
24435279@N00,879,6,1222571095,1222572115,4,12,1020
24435279@N00,879,8,1222578362,1222579502,4,12,1140
24435279@N00,879,4,1222582305,1222583205,17,12,900
24435279@N00,879,8,1222583838,1222584391,6,12,553
24435279@N00,879,12,1222584391,1222584573,4,12,182
24435279@N00,879,1,1222584573,1222584663,15,12,90
24435279@N00,879,5,1222584710,1222585610,7,12,900
24435279@N00,879,1,1222586050,1222586140,2,12,90
24435279@N00,879,8,1222586693,1222587833,49,12,1140
24435279@N00,880,10,1224400775,1224401169,5,3,394
24435279@N00,880,8,1224401169,1224401718,4,3,549
24435279@N00,880,2,1224401718,1224402108,52,3,390
24435279@N00,881,8,1226736879,1226738019,2,2,1140
24435279@N00,881,10,1226746525,1226748025,4,2,1500
24435279@N00,882,9,1226786601,1226788101,8,2,1500
24435279@N00,882,6,1226802552,1226803572,13,2,1020
24435279@N00,883,6,1228547923,1228548943,3,2,1020
24435279@N00,883,8,1228551137,1228552277,14,2,1140
24435279@N00,884,2,1240633097,1240633121,4,6,24
24435279@N00,884,1,1240633121,1240633211,16,6,90
24435279@N00,884,12,1240633940,1240635121,7,6,1181
24435279@N00,884,11,1240635121,1240635300,4,6,179
24435279@N00,884,7,1240635300,1240636320,21,6,1020
24435279@N00,884,1,1240640642,1240640732,50,6,90
24435279@N00,885,5,1241129706,1241130606,4,10,900
24435279@N00,885,1,1241130791,1241130881,3,10,90
24435279@N00,885,8,1241131063,1241132203,22,10,1140
24435279@N00,885,11,1241134011,1241135511,8,10,1500
24435279@N00,885,6,1241138310,1241139330,5,10,1020
24435279@N00,885,8,1241146154,1241147294,2,10,1140
24435279@N00,885,5,1241148064,1241148964,7,10,900
24435279@N00,885,2,1241156821,1241157211,2,10,390
24435279@N00,885,8,1241165071,1241166211,2,10,1140
24435279@N00,885,10,1241168606,1241170106,5,10,1500
24435279@N00,886,1,1241237392,1241237482,6,1,90
24435279@N00,887,7,1241327090,1241328110,6,1,1020
24519194@N08,888,5,1381042337,1381042679,2,2,342
24519194@N08,888,8,1381042679,1381043819,1,2,1140
24519194@N08,889,12,1381558621,1381560121,1,1,1500
24557725@N03,890,5,1366001937,1366002837,1,1,900
24568538@N00,891,5,1306560738,1306561638,1,1,900
24616128@N00,892,1,1285901907,1285901997,4,6,90
24616128@N00,892,4,1285907713,1285908428,2,6,715
24616128@N00,892,2,1285908428,1285908818,2,6,390
24616128@N00,892,6,1285912536,1285912704,2,6,168
24616128@N00,892,8,1285912704,1285913844,5,6,1140
24616128@N00,892,6,1285915315,1285916335,4,6,1020
24616128@N00,893,7,1286058043,1286059063,16,2,1020
24616128@N00,893,1,1286067198,1286067288,6,2,90
24704473@N07,894,1,1189658146,1189658236,8,12,90
24704473@N07,894,13,1189658559,1189660359,18,12,1800
24704473@N07,894,1,1189662693,1189662744,2,12,51
24704473@N07,894,8,1189662744,1189663884,2,12,1140
24704473@N07,894,6,1189664495,1189664678,4,12,183
24704473@N07,894,8,1189664678,1189664689,2,12,11
24704473@N07,894,6,1189664689,1189664819,3,12,130
24704473@N07,894,4,1189664819,1189664986,3,12,167
24704473@N07,894,8,1189664986,1189666126,4,12,1140
24704473@N07,894,1,1189666539,1189666572,2,12,33
24704473@N07,894,7,1189666572,1189666597,2,12,25
24704473@N07,894,1,1189666597,1189666687,7,12,90
24704473@N07,895,1,1237675676,1237675766,4,30,90
24704473@N07,895,13,1237675837,1237675912,2,30,75
24704473@N07,895,1,1237675912,1237676002,3,30,90
24704473@N07,895,8,1237676072,1237677208,4,30,1136
24704473@N07,895,2,1237677208,1237677598,3,30,390
24704473@N07,895,8,1237677601,1237677722,4,30,121
24704473@N07,895,12,1237677722,1237677761,2,30,39
24704473@N07,895,8,1237677761,1237678614,2,30,853
24704473@N07,895,5,1237678614,1237678726,2,30,112
24704473@N07,895,13,1237678726,1237680526,19,30,1800
24704473@N07,895,6,1237692207,1237693225,16,30,1018
24704473@N07,895,13,1237693225,1237693350,2,30,125
24704473@N07,895,4,1237693350,1237693683,5,30,333
24704473@N07,895,6,1237693683,1237694379,7,30,696
24704473@N07,895,8,1237694379,1237695519,3,30,1140
24704473@N07,895,13,1237696429,1237696647,2,30,218
24704473@N07,895,4,1237696647,1237696864,5,30,217
24704473@N07,895,13,1237696864,1237698664,4,30,1800
24704473@N07,895,1,1237700069,1237700159,4,30,90
24704473@N07,895,8,1237700242,1237700998,2,30,756
24704473@N07,895,12,1237700998,1237702498,22,30,1500
24704473@N07,895,1,1237704072,1237704162,4,30,90
24704473@N07,895,8,1237704264,1237704337,2,30,73
24704473@N07,895,7,1237704337,1237704464,3,30,127
24704473@N07,895,8,1237704464,1237704684,3,30,220
24704473@N07,895,2,1237704684,1237705074,4,30,390
24704473@N07,895,6,1237705899,1237706318,2,30,419
24704473@N07,895,4,1237706318,1237706881,5,30,563
24704473@N07,895,13,1237706881,1237707922,3,30,1041
24704473@N07,895,1,1237707922,1237708012,3,30,90
24704473@N07,896,1,1238048865,1238048955,7,20,90
24704473@N07,896,5,1238049077,1238049121,3,20,44
24704473@N07,896,1,1238049121,1238049211,8,20,90
24704473@N07,896,5,1238051189,1238052089,12,20,900
24704473@N07,896,1,1238054719,1238054809,6,20,90
24704473@N07,896,8,1238055785,1238056925,8,20,1140
24704473@N07,896,7,1238058099,1238058152,2,20,53
24704473@N07,896,12,1238058152,1238058177,2,20,25
24704473@N07,896,11,1238058177,1238058223,2,20,46
24704473@N07,896,12,1238058223,1238058263,2,20,40
24704473@N07,896,8,1238058263,1238058287,3,20,24
24704473@N07,896,2,1238058287,1238058298,2,20,11
24704473@N07,896,12,1238058298,1238058518,3,20,220
24704473@N07,896,1,1238058518,1238058608,3,20,90
24704473@N07,896,6,1238058743,1238059385,5,20,642
24704473@N07,896,4,1238059385,1238060285,15,20,900
24704473@N07,896,13,1238060939,1238061494,3,20,555
24704473@N07,896,1,1238061494,1238061584,4,20,90
24704473@N07,896,5,1238061912,1238062164,2,20,252
24704473@N07,896,1,1238062164,1238062254,3,20,90
24733811@N04,897,7,1218409811,1218410831,2,2,1020
24733811@N04,897,12,1218412901,1218414401,2,2,1500
24738734@N00,898,11,1228198923,1228200423,1,1,1500
24738911@N08,899,8,1219892416,1219893556,1,1,1140
24738911@N08,900,8,1229917325,1229918465,2,1,1140
24738911@N08,901,8,1234423545,1234424685,12,1,1140
24738911@N08,902,8,1239332684,1239333824,3,1,1140
24738911@N08,903,8,1258704136,1258705276,6,1,1140
24738911@N08,904,8,1259567979,1259569119,1,1,1140
24738911@N08,905,1,1266204330,1266204420,1,1,90
24767349@N02,906,7,1207379245,1207380265,2,2,1020
24767349@N02,906,8,1207389762,1207390902,1,2,1140
24767349@N02,907,9,1207996367,1207997867,1,1,1500
24850040@N07,908,6,1244871122,1244872142,19,4,1020
24850040@N07,908,8,1244874313,1244875453,19,4,1140
24850040@N07,908,11,1244877898,1244878599,4,4,701
24850040@N07,908,7,1244878599,1244879619,28,4,1020
24850040@N07,909,2,1244965995,1244966385,8,2,390
24850040@N07,909,11,1244967426,1244968926,1,2,1500
24872311@N07,910,8,1317524775,1317524970,2,3,195
24872311@N07,910,6,1317524970,1317525990,3,3,1020
24872311@N07,910,13,1317539128,1317540928,1,3,1800
24889779@N03,911,5,1254632400,1254633300,1,1,900
24897645@N04,912,2,1209866333,1209866723,1,1,390
24897645@N04,913,10,1212629454,1212630954,1,1,1500
24897645@N04,914,8,1212898206,1212899346,3,4,1140
24897645@N04,914,6,1212904868,1212905888,3,4,1020
24897645@N04,914,8,1212906527,1212907667,2,4,1140
24897645@N04,914,5,1212909648,1212910548,1,4,900
24897645@N04,915,1,1213321285,1213321375,20,3,90
24897645@N04,915,5,1213324720,1213325620,3,3,900
24897645@N04,915,1,1213327664,1213327754,1,3,90
24897645@N04,916,11,1214107680,1214109180,2,2,1500
24897645@N04,916,5,1214110234,1214111134,1,2,900
24897645@N04,917,10,1215481031,1215482531,2,3,1500
24897645@N04,917,7,1215484517,1215485537,2,3,1020
24897645@N04,917,11,1215488575,1215490075,2,3,1500
24897645@N04,918,11,1217042419,1217042530,2,8,111
24897645@N04,918,8,1217042530,1217043246,2,8,716
24897645@N04,918,4,1217043246,1217044146,2,8,900
24897645@N04,918,7,1217044457,1217045477,3,8,1020
24897645@N04,918,8,1217045512,1217046652,2,8,1140
24897645@N04,918,1,1217055984,1217056074,3,8,90
24897645@N04,918,12,1217057988,1217059413,2,8,1425
24897645@N04,918,1,1217059413,1217059503,1,8,90
24942927@N03,919,8,1238399451,1238400591,1,1,1140
25027171@N08,920,10,1399679355,1399679615,3,23,260
25027171@N08,920,1,1399679615,1399679705,5,23,90
25027171@N08,920,7,1399680093,1399681113,4,23,1020
25027171@N08,920,11,1399681591,1399681881,4,23,290
25027171@N08,920,8,1399681881,1399683021,7,23,1140
25027171@N08,920,2,1399683029,1399683419,6,23,390
25027171@N08,920,6,1399683727,1399684747,9,23,1020
25027171@N08,920,2,1399685134,1399685524,3,23,390
25027171@N08,920,6,1399685808,1399686828,8,23,1020
25027171@N08,920,1,1399691215,1399691305,4,23,90
25027171@N08,920,10,1399691476,1399691512,2,23,36
25027171@N08,920,5,1399691512,1399692183,3,23,671
25027171@N08,920,1,1399692183,1399692225,2,23,42
25027171@N08,920,7,1399692225,1399692288,2,23,63
25027171@N08,920,8,1399692288,1399692569,5,23,281
25027171@N08,920,13,1399692569,1399694369,10,23,1800
25027171@N08,920,1,1399695568,1399695657,3,23,89
25027171@N08,920,8,1399695657,1399696797,3,23,1140
25027171@N08,920,10,1399698410,1399699910,21,23,1500
25027171@N08,920,8,1399719325,1399719337,2,23,12
25027171@N08,920,1,1399719337,1399719427,10,23,90
25027171@N08,920,10,1399720400,1399721900,3,23,1500
25027171@N08,920,9,1399725353,1399726853,51,23,1500
25027171@N08,921,6,1449557771,1449558791,7,1,1020
25027171@N08,922,6,1449993786,1449994806,67,4,1020
25027171@N08,922,4,1449995342,1449995410,7,4,68
25027171@N08,922,6,1449995410,1449996016,5,4,606
25027171@N08,922,10,1449996016,1449997516,6,4,1500
25050086@N07,923,6,1389572738,1389573758,2,3,1020
25050086@N07,923,1,1389581266,1389581356,2,3,90
25050086@N07,923,8,1389581821,1389582961,1,3,1140
25083094@N04,924,4,1399163932,1399164832,1,1,900
25083094@N04,925,8,1400282582,1400283722,2,3,1140
25083094@N04,925,1,1400286887,1400286977,13,3,90
25083094@N04,925,8,1400304355,1400305495,1,3,1140
25126729@N00,926,6,1228778960,1228779980,2,8,1020
25126729@N00,926,8,1228785195,1228786335,2,8,1140
25126729@N00,926,2,1228789534,1228789924,2,8,390
25126729@N00,926,8,1228802751,1228803891,2,8,1140
25126729@N00,926,9,1228810895,1228811913,3,8,1018
25126729@N00,926,8,1228811913,1228812308,2,8,395
25126729@N00,926,6,1228812308,1228813328,6,8,1020
25126729@N00,926,8,1228814124,1228815264,2,8,1140
25126729@N00,927,1,1276165027,1276165117,2,2,90
25126729@N00,927,5,1276165572,1276166472,2,2,900
25126729@N00,928,8,1276208918,1276210058,2,7,1140
25126729@N00,928,6,1276212297,1276212459,2,7,162
25126729@N00,928,2,1276212459,1276212849,3,7,390
25126729@N00,928,13,1276217327,1276219127,14,7,1800
25126729@N00,928,5,1276220975,1276221875,2,7,900
25126729@N00,928,1,1276222613,1276222703,2,7,90
25126729@N00,928,12,1276228388,1276229888,1,7,1500
25126729@N00,929,11,1307582051,1307583551,2,3,1500
25126729@N00,929,12,1307596483,1307597983,2,3,1500
25126729@N00,929,9,1307618457,1307619957,2,3,1500
25126729@N00,930,5,1307662611,1307663511,1,1,900
25152546@N04,931,6,1441939115,1441940135,3,2,1020
25152546@N04,931,5,1441950587,1441951487,1,2,900
25183144@N03,932,2,1344075122,1344075512,1,1,390
25282313@N08,933,8,1308359904,1308361044,2,1,1140
25358521@N05,934,7,1330048499,1330049519,2,2,1020
25358521@N05,934,12,1330065934,1330067434,1,2,1500
25360342@N02,935,1,1395788820,1395788910,2,9,90
25360342@N02,935,6,1395790413,1395791433,2,9,1020
25360342@N02,935,4,1395792311,1395793211,2,9,900
25360342@N02,935,12,1395794148,1395795648,3,9,1500
25360342@N02,935,11,1395795841,1395796228,2,9,387
25360342@N02,935,8,1395796228,1395797368,2,9,1140
25360342@N02,935,12,1395803158,1395804658,2,9,1500
25360342@N02,935,8,1395804976,1395806116,2,9,1140
25360342@N02,935,6,1395807408,1395808428,1,9,1020
25360342@N02,936,1,1408781979,1408782069,2,9,90
25360342@N02,936,5,1408785737,1408786637,2,9,900
25360342@N02,936,1,1408788753,1408788843,15,9,90
25360342@N02,936,2,1408796981,1408797371,2,9,390
25360342@N02,936,6,1408797807,1408798373,4,9,566
25360342@N02,936,4,1408798373,1408798955,3,9,582
25360342@N02,936,6,1408798955,1408799579,4,9,624
25360342@N02,936,1,1408799579,1408799669,2,9,90
25360342@N02,936,10,1408800578,1408802078,2,9,1500
25360342@N02,937,1,1454719008,1454719098,1,1,90
25382096@N05,938,5,1462537753,1462538653,1,1,900
25385084@N07,939,1,1269899554,1269899644,1,1,90
25387061@N06,940,6,1327207635,1327208655,1,1,1020
25437583@N00,941,5,1240594683,1240595583,2,2,900
25437583@N00,941,1,1240595638,1240595728,4,2,90
25438065@N03,942,8,1212876142,1212877282,29,1,1140
25438065@N03,943,8,1213312014,1213313154,23,1,1140
25548984@N06,944,5,1210252456,1210253356,2,2,900
25548984@N06,944,13,1210264692,1210266492,1,2,1800
25548984@N06,945,1,1229016027,1229016117,4,2,90
25548984@N06,945,8,1229017543,1229018683,1,2,1140
25548984@N06,946,8,1233586363,1233587503,8,2,1140
25548984@N06,946,1,1233593951,1233594041,5,2,90
25548984@N06,947,8,1235051965,1235053105,7,1,1140
25585962@N06,948,10,1412482919,1412483657,2,13,738
25585962@N06,948,8,1412483657,1412483815,3,13,158
25585962@N06,948,2,1412483815,1412483898,2,13,83
25585962@N06,948,8,1412483898,1412485038,3,13,1140
25585962@N06,948,6,1412487180,1412488200,10,13,1020
25585962@N06,948,13,1412491840,1412492043,2,13,203
25585962@N06,948,4,1412492043,1412492943,2,13,900
25585962@N06,948,1,1412496111,1412496201,4,13,90
25585962@N06,948,4,1412508213,1412509113,2,13,900
25585962@N06,948,5,1412511653,1412512553,2,13,900
25585962@N06,948,1,1412515302,1412515392,9,13,90
25585962@N06,948,8,1412524774,1412525433,2,13,659
25585962@N06,948,1,1412525433,1412525523,3,13,90
25627071@N00,949,8,1312169083,1312170223,15,1,1140
25651350@N06,950,6,1227942016,1227943036,13,1,1020
25651350@N06,951,6,1229067523,1229068543,7,1,1020
25651350@N06,952,6,1257917521,1257918541,3,1,1020
25651350@N06,953,6,1258787871,1258788891,1,1,1020
25651350@N06,954,1,1307092892,1307092982,6,3,90
25651350@N06,954,8,1307093067,1307093184,3,3,117
25651350@N06,954,1,1307093184,1307093274,1,3,90
25686649@N00,955,5,1371340663,1371341563,1,1,900
25686649@N00,956,5,1373265762,1373266662,2,2,900
25686649@N00,956,4,1373270566,1373271466,1,2,900
25737136@N06,957,8,1307493528,1307494668,1,1,1140
25823827@N00,958,10,1447823389,1447823532,2,2,143
25823827@N00,958,9,1447823532,1447825032,1,2,1500
25825657@N05,959,11,1355189610,1355191110,1,1,1500
25827417@N00,960,12,1430438108,1430439608,2,1,1500
25846522@N00,961,6,1360371168,1360372188,3,3,1020
25846522@N00,961,9,1360398391,1360399891,2,3,1500
25846522@N00,961,1,1360405281,1360405371,1,3,90
25854008@N00,962,8,1352501221,1352502361,1,1,1140
25905065@N00,963,10,1336963740,1336965240,2,8,1500
25905065@N00,963,8,1336969996,1336971136,5,8,1140
25905065@N00,963,3,1336977677,1336978097,2,8,420
25905065@N00,963,13,1336989881,1336990321,4,8,440
25905065@N00,963,12,1336990321,1336990324,2,8,3
25905065@N00,963,7,1336990324,1336991344,3,8,1020
25905065@N00,963,5,1336993452,1336994352,2,8,900
25905065@N00,963,10,1336995329,1336996829,1,8,1500
25905065@N00,964,8,1362892135,1362893275,18,1,1140
26094090@N00,965,5,1338083064,1338083964,1,1,900
26094090@N00,966,1,1338509120,1338509210,1,1,90
26143366@N00,967,6,1205535324,1205536344,4,1,1020
26153219@N00,968,11,1308952257,1308953757,5,2,1500
26153219@N00,968,2,1308981773,1308982163,19,2,390
26211887@N07,969,10,1224048878,1224050378,2,2,1500
26211887@N07,969,1,1224058471,1224058561,1,2,90
26247897@N03,970,10,1337981464,1337981884,2,3,420
26247897@N03,970,1,1337981884,1337981974,2,3,90
26247897@N03,970,10,1337981975,1337983475,1,3,1500
26284290@N05,971,1,1189346401,1189346402,2,2,1
26284290@N05,971,8,1189346402,1189347542,1,2,1140
26284290@N05,972,2,1220796000,1220796001,2,2,1
26284290@N05,972,8,1220796001,1220797141,1,2,1140
26284290@N05,973,2,1284904800,1284904801,2,3,1
26284290@N05,973,12,1284904801,1284904802,2,3,1
26284290@N05,973,2,1284904802,1284905192,1,3,390
26284290@N05,974,8,1305295203,1305296343,2,1,1140
26284290@N05,975,1,1321607394,1321607484,1,1,90
26334284@N00,976,6,1200866168,1200867188,155,1,1020
26334284@N00,977,6,1201219730,1201220750,574,1,1020
26342127@N00,978,1,1264487888,1264487978,1,1,90
26393454@N00,979,13,1423185328,1423187128,1,1,1800
26443143@N03,980,8,1305841451,1305842591,1,1,1140
26475432@N03,981,10,1410912615,1410914115,1,1,1500
26522673@N07,982,13,1227841116,1227841118,2,2,2
26522673@N07,982,8,1227841118,1227842258,1,2,1140
26522673@N07,983,10,1283306146,1283306467,2,16,321
26522673@N07,983,1,1283306467,1283306557,3,16,90
26522673@N07,983,8,1283306880,1283307871,2,16,991
26522673@N07,983,2,1283307871,1283308261,3,16,390
26522673@N07,983,13,1283311848,1283313648,17,16,1800
26522673@N07,983,5,1283317521,1283318421,5,16,900
26522673@N07,983,10,1283323146,1283324000,3,16,854
26522673@N07,983,1,1283324000,1283324090,2,16,90
26522673@N07,983,8,1283324818,1283325958,2,16,1140
26522673@N07,983,6,1283329188,1283330208,2,16,1020
26522673@N07,983,12,1283330827,1283331767,2,16,940
26522673@N07,983,1,1283331767,1283331857,2,16,90
26522673@N07,983,6,1283333968,1283334065,2,16,97
26522673@N07,983,13,1283334065,1283334294,2,16,229
26522673@N07,983,1,1283334294,1283334384,2,16,90
26522673@N07,983,10,1283334953,1283336453,1,16,1500
26522673@N07,984,1,1346640084,1346640090,2,11,6
26522673@N07,984,10,1346640090,1346641590,2,11,1500
26522673@N07,984,8,1346642587,1346643727,5,11,1140
26522673@N07,984,13,1346645455,1346647255,6,11,1800
26522673@N07,984,6,1346653487,1346654507,3,11,1020
26522673@N07,984,2,1346658135,1346658525,2,11,390
26522673@N07,984,13,1346661099,1346662899,2,11,1800
26522673@N07,984,1,1346664756,1346664846,2,11,90
26522673@N07,984,7,1346666937,1346667957,2,11,1020
26522673@N07,984,8,1346669285,1346670425,3,11,1140
26522673@N07,984,1,1346686800,1346686890,2,11,90
26522673@N07,985,8,1382326983,1382327166,2,10,183
26522673@N07,985,1,1382327166,1382327256,2,10,90
26522673@N07,985,5,1382329575,1382330475,2,10,900
26522673@N07,985,10,1382333586,1382334508,2,10,922
26522673@N07,985,5,1382334508,1382335323,2,10,815
26522673@N07,985,1,1382335323,1382335413,2,10,90
26522673@N07,985,13,1382338238,1382340038,2,10,1800
26522673@N07,985,2,1382340470,1382340860,3,10,390
26522673@N07,985,6,1382343606,1382344626,3,10,1020
26522673@N07,985,1,1382346520,1382346610,3,10,90
26531284@N02,986,6,1320295235,1320296255,3,5,1020
26531284@N02,986,11,1320304492,1320305743,5,5,1251
26531284@N02,986,12,1320305743,1320307243,2,5,1500
26531284@N02,986,2,1320311918,1320312308,3,5,390
26531284@N02,986,8,1320314071,1320315211,1,5,1140
26531284@N02,987,2,1352327968,1352328358,2,5,390
26531284@N02,987,5,1352329579,1352330479,3,5,900
26531284@N02,987,2,1352338708,1352339098,4,5,390
26531284@N02,987,8,1352342961,1352344101,2,5,1140
26531284@N02,987,10,1352347884,1352349384,1,5,1500
26546859@N00,988,8,1247361408,1247362548,12,1,1140
26573031@N05,989,6,1465949940,1465950960,2,6,1020
26573031@N05,989,2,1465950973,1465951363,2,6,390
26573031@N05,989,12,1465955061,1465956561,4,6,1500
26573031@N05,989,8,1465964587,1465965727,2,6,1140
26573031@N05,989,4,1465968659,1465969559,4,6,900
26573031@N05,989,2,1465975115,1465975505,1,6,390
26603119@N00,990,12,1367365160,1367366144,2,4,984
26603119@N00,990,7,1367366144,1367367164,2,4,1020
26603119@N00,990,2,1367373798,1367374188,2,4,390
26603119@N00,990,4,1367375497,1367376397,1,4,900
26603119@N00,991,13,1400060209,1400062009,2,2,1800
26603119@N00,991,8,1400064643,1400065783,1,2,1140
26603119@N00,992,2,1400104103,1400104493,1,1,390
26603119@N00,993,4,1462959360,1462960011,2,4,651
26603119@N00,993,13,1462960011,1462961811,4,4,1800
26603119@N00,993,4,1462963002,1462963902,4,4,900
26603119@N00,993,8,1462967313,1462968453,4,4,1140
26603119@N00,994,12,1463173792,1463175292,14,3,1500
26603119@N00,994,11,1463178458,1463179958,2,3,1500
26603119@N00,994,8,1463183298,1463184438,2,3,1140
26619856@N00,995,5,1350983204,1350984104,2,2,900
26619856@N00,995,8,1350991019,1350992159,1,2,1140
26633936@N03,996,7,1400460409,1400461429,2,3,1020
26633936@N03,996,5,1400463313,1400464213,2,3,900
26633936@N03,996,8,1400486571,1400487711,1,3,1140
26650546@N07,997,5,1311634730,1311635630,1,1,900
26652894@N06,998,12,1195433697,1195435197,1,1,1500
26670433@N07,999,8,1232672648,1232673788,3,1,1140
26678134@N04,1000,6,1356253121,1356254141,2,1,1020
26678134@N04,1001,4,1360900577,1360901477,2,2,900
26678134@N04,1001,8,1360907651,1360908791,2,2,1140
26678134@N04,1002,6,1381462194,1381462530,2,2,336
26678134@N04,1002,4,1381462530,1381463430,2,2,900
26678134@N04,1003,6,1383899196,1383900216,2,1,1020
26678134@N04,1004,10,1387173797,1387175297,1,1,1500
26678134@N04,1005,4,1387436526,1387437426,2,2,900
26678134@N04,1005,6,1387437739,1387438759,6,2,1020
26678134@N04,1006,5,1411783117,1411784017,1,1,900
26678134@N04,1007,1,1417160715,1417160805,3,2,90
26678134@N04,1007,6,1417161628,1417162648,9,2,1020
26678134@N04,1008,6,1419321958,1419322095,2,2,137
26678134@N04,1008,4,1419322095,1419322995,1,2,900
26678134@N04,1009,6,1446798397,1446799235,3,2,838
26678134@N04,1009,4,1446799235,1446800135,1,2,900
26678134@N04,1010,6,1451725449,1451726469,11,1,1020
26680632@N04,1011,7,1275806212,1275807232,1,1,1020
26695377@N00,1012,8,1330163493,1330164633,2,2,1140
26695377@N00,1012,11,1330168393,1330169893,1,2,1500
26728047@N05,1013,8,1281777250,1281778390,67,1,1140
26874770@N06,1014,6,1197190468,1197191488,2,2,1020
26874770@N06,1014,1,1197197729,1197197819,1,2,90
26874770@N06,1015,6,1199169519,1199170539,6,1,1020
26874770@N06,1016,10,1204166244,1204167744,1,1,1500
26874770@N06,1017,13,1204418637,1204420437,1,1,1800
26874770@N06,1018,2,1235775071,1235775461,2,9,390
26874770@N06,1018,5,1235776853,1235777753,10,9,900
26874770@N06,1018,8,1235781854,1235782994,5,9,1140
26874770@N06,1018,12,1235794169,1235795669,6,9,1500
26874770@N06,1018,1,1235798370,1235798460,2,9,90
26874770@N06,1018,8,1235798584,1235799448,2,9,864
26874770@N06,1018,4,1235799448,1235800348,2,9,900
26874770@N06,1018,6,1235800653,1235801673,3,9,1020
26874770@N06,1018,8,1235803988,1235805128,1,9,1140
26874770@N06,1019,10,1236162306,1236162321,2,2,15
26874770@N06,1019,5,1236162321,1236163221,2,2,900
26874770@N06,1020,10,1241183785,1241185285,1,1,1500
26874770@N06,1021,11,1242518408,1242519908,1,1,1500
26874770@N06,1022,5,1245464860,1245465327,2,3,467
26874770@N06,1022,12,1245465327,1245465904,6,3,577
26874770@N06,1022,11,1245465904,1245467404,1,3,1500
26874770@N06,1023,10,1281570589,1281572089,2,6,1500
26874770@N06,1023,5,1281589589,1281590489,4,6,900
26874770@N06,1023,3,1281607924,1281608344,2,6,420
26874770@N06,1023,5,1281608541,1281609441,2,6,900
26874770@N06,1023,12,1281609848,1281611348,9,6,1500
26874770@N06,1023,1,1281616926,1281617016,3,6,90
26874770@N06,1024,10,1281769625,1281771125,7,9,1500
26874770@N06,1024,2,1281771915,1281772305,2,9,390
26874770@N06,1024,4,1281778350,1281778993,3,9,643
26874770@N06,1024,13,1281778993,1281780793,14,9,1800
26874770@N06,1024,8,1281784467,1281784986,2,9,519
26874770@N06,1024,12,1281784986,1281786486,4,9,1500
26874770@N06,1024,4,1281788428,1281789328,2,9,900
26874770@N06,1024,8,1281792532,1281793672,10,9,1140
26874770@N06,1024,13,1281798983,1281800783,1,9,1800
26888485@N08,1025,9,1371544153,1371545653,1,1,1500
26897917@N02,1026,8,1365022786,1365023926,2,1,1140
27027561@N03,1027,5,1382606413,1382607313,2,2,900
27027561@N03,1027,1,1382608691,1382608781,1,2,90
27174905@N03,1028,6,1345698506,1345699526,1,1,1020
27182886@N02,1029,12,1452557961,1452559461,1,1,1500
27193990@N00,1030,13,1363999104,1364000904,1,1,1800
27207509@N00,1031,12,1426639474,1426640974,4,1,1500
27233089@N04,1032,13,1256612909,1256614709,1,1,1800
27270108@N05,1033,4,1275633069,1275633969,1,1,900
27270108@N05,1034,1,1306633579,1306633669,4,1,90
27270108@N05,1035,6,1306723874,1306724894,2,2,1020
27270108@N05,1035,1,1306726625,1306726715,3,2,90
27270108@N05,1036,6,1306881321,1306882341,5,3,1020
27270108@N05,1036,7,1306884482,1306885005,2,3,523
27270108@N05,1036,4,1306885005,1306885905,4,3,900
27270108@N05,1037,10,1307052621,1307054121,2,3,1500
27270108@N05,1037,5,1307055645,1307056545,5,3,900
27270108@N05,1037,1,1307057486,1307057576,1,3,90
27270108@N05,1038,5,1339198217,1339199117,5,2,900
27270108@N05,1038,6,1339201829,1339202849,2,2,1020
27270108@N05,1039,6,1339282691,1339283711,3,3,1020
27270108@N05,1039,5,1339284956,1339285352,2,3,396
27270108@N05,1039,1,1339285352,1339285442,2,3,90
27270108@N05,1040,1,1339492409,1339492499,10,2,90
27270108@N05,1040,10,1339494926,1339496426,3,2,1500
27270108@N05,1041,4,1356742602,1356743502,1,1,900
27270108@N05,1042,3,1357192638,1357193058,4,2,420
27270108@N05,1042,6,1357201144,1357202164,10,2,1020
27292880@N03,1043,7,1294965134,1294965349,12,4,215
27292880@N03,1043,8,1294965349,1294965507,2,4,158
27292880@N03,1043,7,1294965507,1294966527,9,4,1020
27292880@N03,1043,11,1294978578,1294980078,3,4,1500
27312248@N04,1044,5,1203553036,1203553936,10,6,900
27312248@N04,1044,4,1203556838,1203557738,6,6,900
27312248@N04,1044,2,1203564284,1203564674,2,6,390
27312248@N04,1044,13,1203570145,1203571945,4,6,1800
27312248@N04,1044,7,1203578733,1203579753,7,6,1020
27312248@N04,1044,9,1203586616,1203588116,21,6,1500
27312248@N04,1045,6,1216121662,1216122682,18,1,1020
27338137@N06,1046,8,1253917358,1253918498,3,1,1140
27372897@N00,1047,4,1353265769,1353266669,1,1,900
27429042@N08,1048,7,1188873345,1188874365,2,2,1020
27429042@N08,1048,6,1188880952,1188881972,1,2,1020
27429042@N08,1049,5,1219980259,1219981159,1,1,900
27429042@N08,1050,8,1231364912,1231366052,4,7,1140
27429042@N08,1050,6,1231368222,1231369242,3,7,1020
27429042@N08,1050,1,1231370036,1231370126,2,7,90
27429042@N08,1050,8,1231379971,1231381111,4,7,1140
27429042@N08,1050,12,1231384299,1231385624,3,7,1325
27429042@N08,1050,5,1231385624,1231386524,2,7,900
27429042@N08,1050,1,1231390716,1231390806,1,7,90
27429042@N08,1051,8,1231630980,1231631491,3,5,511
27429042@N08,1051,11,1231631491,1231632991,2,5,1500
27429042@N08,1051,13,1231637326,1231639126,2,5,1800
27429042@N08,1051,5,1231639165,1231640065,3,5,900
27429042@N08,1051,8,1231644676,1231645816,3,5,1140
27429042@N08,1052,5,1232347232,1232348132,1,1,900
27429042@N08,1053,6,1232431864,1232432884,1,1,1020
27429042@N08,1054,8,1253256321,1253257461,2,2,1140
27429042@N08,1054,10,1253257593,1253259093,1,2,1500
27429042@N08,1055,5,1263618876,1263619776,2,3,900
27429042@N08,1055,1,1263621711,1263621801,2,3,90
27429042@N08,1055,8,1263624588,1263625728,1,3,1140
27429042@N08,1056,8,1265685266,1265685461,2,2,195
27429042@N08,1056,12,1265685461,1265686961,2,2,1500
27429042@N08,1057,5,1266302449,1266303349,1,1,900
27429042@N08,1058,6,1267495298,1267496318,2,3,1020
27429042@N08,1058,8,1267496657,1267496973,2,3,316
27429042@N08,1058,1,1267496973,1267497063,2,3,90
27429042@N08,1059,5,1271116813,1271117713,8,2,900
27429042@N08,1059,8,1271122089,1271123229,1,2,1140
27429042@N08,1060,12,1273619406,1273620906,2,3,1500
27429042@N08,1060,8,1273621598,1273622738,2,3,1140
27429042@N08,1060,5,1273625902,1273626802,1,3,900
27429042@N08,1061,5,1292369156,1292370056,2,3,900
27429042@N08,1061,11,1292389787,1292389899,2,3,112
27429042@N08,1061,12,1292389899,1292391399,1,3,1500
27429042@N08,1062,6,1292746302,1292747322,2,2,1020
27429042@N08,1062,1,1292748212,1292748302,1,2,90
27429042@N08,1063,6,1301011584,1301012604,3,2,1020
27429042@N08,1063,5,1301029456,1301030356,1,2,900
27429042@N08,1064,6,1313057651,1313058671,2,1,1020
27429042@N08,1065,10,1323311288,1323312788,1,1,1500
27429042@N08,1066,8,1324189075,1324190215,1,1,1140
27429042@N08,1067,13,1330993437,1330995237,2,2,1800
27429042@N08,1067,8,1331003475,1331004615,1,2,1140
27527078@N05,1068,10,1360541654,1360542229,3,10,575
27527078@N05,1068,1,1360542229,1360542319,4,10,90
27527078@N05,1068,6,1360542905,1360543925,5,10,1020
27527078@N05,1068,3,1360544458,1360544878,2,10,420
27527078@N05,1068,1,1360553021,1360553111,3,10,90
27527078@N05,1068,10,1360555698,1360557198,19,10,1500
27527078@N05,1068,2,1360562331,1360562721,2,10,390
27527078@N05,1068,11,1360564069,1360565569,3,10,1500
27527078@N05,1068,12,1360566722,1360568222,9,10,1500
27527078@N05,1068,1,1360571399,1360571489,4,10,90
27539218@N06,1069,13,1208064987,1208066787,1,1,1800
27539218@N06,1070,10,1219715199,1219716699,7,1,1500
27539218@N06,1071,13,1231657323,1231659123,2,1,1800
27539218@N06,1072,1,1241755575,1241755665,2,1,90
27539218@N06,1073,10,1246856612,1246858112,22,1,1500
27539218@N06,1074,8,1251623295,1251624435,6,1,1140
27539218@N06,1075,2,1254991150,1254991540,1,1,390
27539218@N06,1076,8,1276320301,1276321441,1,1,1140
27599409@N02,1077,11,1200357671,1200359171,59,1,1500
27599409@N02,1078,11,1200632660,1200634160,3,1,1500
27599409@N02,1079,11,1213380971,1213382471,3,1,1500
27810107@N08,1080,8,1232326269,1232326496,3,4,227
27810107@N08,1080,12,1232326496,1232327996,3,4,1500
27810107@N08,1080,7,1232328142,1232329162,4,4,1020
27810107@N08,1080,1,1232336872,1232336962,1,4,90
27813472@N00,1081,6,1422426934,1422427954,1,1,1020
27853624@N00,1082,6,1230083882,1230084902,2,2,1020
27853624@N00,1082,7,1230098588,1230099608,1,2,1020
27853624@N00,1083,1,1230431438,1230431528,2,1,90
27874898@N00,1084,1,1349821417,1349821507,3,11,90
27874898@N00,1084,5,1349823054,1349823954,2,11,900
27874898@N00,1084,1,1349826072,1349826162,2,11,90
27874898@N00,1084,8,1349826198,1349826399,2,11,201
27874898@N00,1084,6,1349826399,1349827419,10,11,1020
27874898@N00,1084,4,1349828849,1349829749,4,11,900
27874898@N00,1084,6,1349830980,1349831534,5,11,554
27874898@N00,1084,2,1349831534,1349831837,7,11,303
27874898@N00,1084,5,1349831837,1349831936,2,11,99
27874898@N00,1084,8,1349831936,1349833076,8,11,1140
27874898@N00,1084,5,1349845749,1349846649,3,11,900
27874898@N00,1085,13,1350000710,1350002510,36,2,1800
27874898@N00,1085,5,1350009020,1350009920,1,2,900
27874898@N00,1086,8,1368055294,1368056240,2,4,946
27874898@N00,1086,2,1368056240,1368056630,2,4,390
27874898@N00,1086,4,1368067243,1368067998,4,4,755
27874898@N00,1086,6,1368067998,1368069018,2,4,1020
27874898@N00,1087,1,1368232547,1368232637,2,8,90
27874898@N00,1087,5,1368232673,1368233573,2,8,900
27874898@N00,1087,8,1368234586,1368235726,5,8,1140
27874898@N00,1087,2,1368239259,1368239649,2,8,390
27874898@N00,1087,6,1368240430,1368241450,4,8,1020
27874898@N00,1087,4,1368242862,1368243762,5,8,900
27874898@N00,1087,13,1368249599,1368251399,2,8,1800
27874898@N00,1087,2,1368258912,1368259302,1,8,390
27874898@N00,1088,1,1370669317,1370669407,12,2,90
27874898@N00,1088,4,1370669673,1370670573,2,2,900
27874898@N00,1089,1,1378712230,1378712320,3,6,90
27874898@N00,1089,5,1378713142,1378714042,2,6,900
27874898@N00,1089,1,1378719097,1378719187,4,6,90
27874898@N00,1089,4,1378721799,1378722696,4,6,897
27874898@N00,1089,2,1378722696,1378723086,2,6,390
27874898@N00,1089,1,1378725074,1378725164,2,6,90
27874898@N00,1090,1,1379038310,1379038400,2,5,90
27874898@N00,1090,5,1379064074,1379064974,2,5,900
27874898@N00,1090,8,1379066624,1379067764,34,5,1140
27874898@N00,1090,4,1379069068,1379069968,3,5,900
27874898@N00,1090,2,1379080148,1379080538,1,5,390
27967379@N08,1091,5,1410406740,1410407640,4,2,900
27967379@N08,1091,6,1410422526,1410423546,9,2,1020
27975788@N07,1092,1,1218799818,1218799908,1,1,90
27976717@N05,1093,2,1221171115,1221171505,1,1,390
28019195@N07,1094,6,1419282466,1419283486,1,1,1020
28044472@N08,1095,8,1300178378,1300179518,1,1,1140
28065533@N00,1096,6,1356150018,1356151038,1,1,1020
28083255@N00,1097,2,1416286070,1416286460,2,1,390
28090908@N04,1098,1,1241425685,1241425775,1,1,90
28163344@N08,1099,5,1446937346,1446938246,1,1,900
28203925@N08,1100,6,1344917273,1344918293,3,4,1020
28203925@N08,1100,13,1344918721,1344920521,2,4,1800
28203925@N08,1100,8,1344920995,1344922135,4,4,1140
28203925@N08,1100,1,1344928206,1344928296,1,4,90
28203925@N08,1101,10,1345026408,1345027908,2,2,1500
28203925@N08,1101,1,1345031658,1345031748,2,2,90
28215341@N07,1102,4,1367806307,1367807207,3,2,900
28215341@N07,1102,13,1367813410,1367815210,1,2,1800
28215341@N07,1103,4,1402706593,1402707493,3,5,900
28215341@N07,1103,13,1402720040,1402721840,2,5,1800
28215341@N07,1103,4,1402724278,1402724984,3,5,706
28215341@N07,1103,13,1402724984,1402726784,3,5,1800
28215341@N07,1103,4,1402732019,1402732919,2,5,900
28215341@N07,1104,4,1402788795,1402789695,3,1,900
28215341@N07,1105,13,1424410972,1424412772,1,1,1800
28215341@N07,1106,4,1434162139,1434163039,1,1,900
28236477@N08,1107,2,1222039691,1222040081,2,1,390
28245557@N00,1108,2,1416871279,1416871669,2,2,390
28245557@N00,1108,6,1416872349,1416873369,1,2,1020
28289318@N07,1109,8,1433116467,1433117607,33,1,1140
28289318@N07,1110,8,1433414368,1433415508,10,1,1140
28407078@N08,1111,13,1215422530,1215424330,1,1,1800
28407078@N08,1112,13,1215505384,1215507184,1,1,1800
28446856@N00,1113,5,1383271449,1383272349,2,1,900
28450912@N02,1114,11,1220143920,1220145420,3,7,1500
28450912@N02,1114,5,1220147132,1220147319,3,7,187
28450912@N02,1114,1,1220147319,1220147409,7,7,90
28450912@N02,1114,8,1220147476,1220147619,2,7,143
28450912@N02,1114,4,1220147619,1220148519,5,7,900
28450912@N02,1114,3,1220149145,1220149565,4,7,420
28450912@N02,1114,8,1220155745,1220156885,10,7,1140
28450912@N02,1115,10,1235773724,1235775224,2,8,1500
28450912@N02,1115,5,1235775721,1235776621,4,8,900
28450912@N02,1115,12,1235779604,1235780733,3,8,1129
28450912@N02,1115,7,1235780733,1235780816,2,8,83
28450912@N02,1115,8,1235780816,1235781956,2,8,1140
28450912@N02,1115,1,1235784403,1235784493,5,8,90
28450912@N02,1115,10,1235784544,1235784751,2,8,207
28450912@N02,1115,1,1235784751,1235784841,3,8,90
28450912@N02,1116,1,1243033806,1243033896,2,7,90
28450912@N02,1116,13,1243034028,1243035828,2,7,1800
28450912@N02,1116,6,1243040702,1243041722,3,7,1020
28450912@N02,1116,12,1243060946,1243061222,3,7,276
28450912@N02,1116,2,1243061222,1243061612,6,7,390
28450912@N02,1116,6,1243063762,1243064176,2,7,414
28450912@N02,1116,4,1243064176,1243065076,1,7,900
28450912@N02,1117,2,1243145193,1243145583,3,1,390
28450912@N02,1118,5,1249892916,1249892921,3,11,5
28450912@N02,1118,8,1249892921,1249893127,2,11,206
28450912@N02,1118,4,1249893127,1249893127,2,11,0
28450912@N02,1118,8,1249893127,1249893128,2,11,1
28450912@N02,1118,1,1249893128,1249893128,2,11,0
28450912@N02,1118,6,1249893128,1249893131,4,11,3
28450912@N02,1118,2,1249893131,1249893131,3,11,0
28450912@N02,1118,11,1249893131,1249893132,2,11,1
28450912@N02,1118,2,1249893132,1249893134,6,11,2
28450912@N02,1118,6,1249893134,1249893150,3,11,16
28450912@N02,1118,2,1249893150,1249893540,1,11,390
28450912@N02,1119,1,1278480198,1278480288,2,4,90
28450912@N02,1119,5,1278480521,1278480794,3,4,273
28450912@N02,1119,1,1278480794,1278480884,4,4,90
28450912@N02,1119,7,1278481003,1278482023,1,4,1020
28450912@N02,1120,8,1324018637,1324019180,2,2,543
28450912@N02,1120,5,1324019180,1324020080,4,2,900
28450912@N02,1121,8,1324073118,1324073137,2,4,19
28450912@N02,1121,7,1324073137,1324073228,3,4,91
28450912@N02,1121,8,1324073228,1324074368,8,4,1140
28450912@N02,1121,4,1324075589,1324076489,4,4,900
28450912@N02,1122,13,1368947608,1368949408,4,1,1800
28450912@N02,1123,6,1400193114,1400194134,2,2,1020
28450912@N02,1123,1,1400201112,1400201202,3,2,90
28450912@N02,1124,4,1400283548,1400283804,2,3,256
28450912@N02,1124,3,1400283804,1400283926,3,3,122
28450912@N02,1124,13,1400283926,1400285726,1,3,1800
28450912@N02,1125,1,1416103340,1416103430,3,2,90
28450912@N02,1125,8,1416103998,1416105138,3,2,1140
28474359@N03,1126,5,1217181919,1217181963,2,2,44
28474359@N03,1126,10,1217181963,1217183463,1,2,1500
28474359@N03,1127,5,1217278459,1217279359,3,3,900
28474359@N03,1127,8,1217302770,1217303910,2,3,1140
28474359@N03,1127,1,1217310130,1217310220,1,3,90
28478615@N03,1128,8,1331932839,1331933979,3,2,1140
28478615@N03,1128,10,1331953677,1331955177,1,2,1500
28495936@N03,1129,13,1390614373,1390616128,4,2,1755
28495936@N03,1129,1,1390616128,1390616218,2,2,90
28527853@N00,1130,4,1335392584,1335393484,2,3,900
28527853@N00,1130,6,1335400636,1335401656,2,3,1020
28527853@N00,1130,2,1335409813,1335410203,1,3,390
28527853@N00,1131,6,1335832283,1335833303,3,2,1020
28527853@N00,1131,4,1335833754,1335834654,4,2,900
28527853@N00,1132,6,1354597356,1354597470,2,2,114
28527853@N00,1132,4,1354597470,1354598370,1,2,900
28527853@N00,1133,4,1354662333,1354663233,3,2,900
28527853@N00,1133,6,1354664759,1354665779,1,2,1020
28527853@N00,1134,2,1368238243,1368238633,1,1,390
28530387@N06,1135,12,1470289873,1470290910,2,3,1037
28530387@N06,1135,5,1470290910,1470291810,2,3,900
28530387@N06,1135,7,1470295160,1470296180,1,3,1020
28572085@N03,1136,8,1216905899,1216907039,21,8,1140
28572085@N03,1136,2,1216909338,1216909728,24,8,390
28572085@N03,1136,11,1216914882,1216916382,5,8,1500
28572085@N03,1136,12,1216923394,1216924894,14,8,1500
28572085@N03,1136,5,1216929303,1216930039,2,8,736
28572085@N03,1136,10,1216930039,1216931539,69,8,1500
28572085@N03,1136,12,1216943030,1216944530,4,8,1500
28572085@N03,1136,9,1216944765,1216946265,3,8,1500
28572085@N03,1137,8,1217018452,1217018943,8,3,491
28572085@N03,1137,6,1217018943,1217019963,4,3,1020
28572085@N03,1137,5,1217025594,1217026494,1,3,900
28572085@N03,1138,12,1219054623,1219054663,3,4,40
28572085@N03,1138,11,1219054663,1219056163,39,4,1500
28572085@N03,1138,12,1219069350,1219069357,10,4,7
28572085@N03,1138,8,1219069357,1219070497,6,4,1140
28598412@N04,1139,5,1251475906,1251476806,1,1,900
28598412@N04,1140,5,1251818524,1251819424,2,2,900
28598412@N04,1140,10,1251823584,1251825084,2,2,1500
28712708@N06,1141,8,1314586155,1314587295,2,2,1140
28712708@N06,1141,4,1314612217,1314613117,1,2,900
28715213@N00,1142,6,1197087976,1197088996,3,6,1020
28715213@N00,1142,9,1197095533,1197097033,26,6,1500
28715213@N00,1142,5,1197097568,1197097619,2,6,51
28715213@N00,1142,1,1197097619,1197097709,3,6,90
28715213@N00,1142,8,1197097987,1197098412,2,6,425
28715213@N00,1142,10,1197098412,1197099912,1,6,1500
28715213@N00,1143,6,1207184925,1207185945,1,1,1020
28724781@N04,1144,10,1229049901,1229051401,3,3,1500
28724781@N04,1144,1,1229055107,1229055166,2,3,59
28724781@N04,1144,8,1229055166,1229056306,3,3,1140
28724781@N04,1145,5,1229119581,1229119875,2,3,294
28724781@N04,1145,1,1229119875,1229119965,2,3,90
28724781@N04,1145,2,1229120095,1229120485,3,3,390
28724781@N04,1146,11,1231362519,1231363749,2,8,1230
28724781@N04,1146,2,1231363749,1231364139,2,8,390
28724781@N04,1146,1,1231375460,1231375550,2,8,90
28724781@N04,1146,12,1231383734,1231384263,2,8,529
28724781@N04,1146,8,1231384263,1231385403,3,8,1140
28724781@N04,1146,1,1231388964,1231389054,2,8,90
28724781@N04,1146,12,1231391311,1231391976,3,8,665
28724781@N04,1146,4,1231391976,1231392876,1,8,900
28732514@N00,1147,8,1304412986,1304414126,1,1,1140
28761221@N00,1148,1,1187990880,1187990970,6,1,90
28761221@N00,1149,1,1201924574,1201924664,17,1,90
28761221@N00,1150,1,1230965994,1230966084,86,1,90
28782167@N03,1151,1,1357422944,1357423034,1,1,90
28827568@N05,1152,8,1222386305,1222387445,2,2,1140
28827568@N05,1152,5,1222391665,1222392565,1,2,900
28835512@N07,1153,13,1302759097,1302760897,5,3,1800
28835512@N07,1153,6,1302763558,1302764578,2,3,1020
28835512@N07,1153,2,1302764680,1302765070,1,3,390
28917843@N02,1154,5,1328876506,1328877406,1,1,900
28946471@N00,1155,4,1378024138,1378025038,1,1,900
28959709@N05,1156,7,1291963959,1291964979,1,1,1020
28971971@N00,1157,10,1194822843,1194824343,2,9,1500
28971971@N00,1157,8,1194825407,1194826362,11,9,955
28971971@N00,1157,7,1194826362,1194827382,2,9,1020
28971971@N00,1157,4,1194828761,1194829661,7,9,900
28971971@N00,1157,2,1194831549,1194831939,3,9,390
28971971@N00,1157,12,1194833203,1194834703,7,9,1500
28971971@N00,1157,13,1194835229,1194837029,6,9,1800
28971971@N00,1157,1,1194842956,1194843046,39,9,90
28971971@N00,1157,10,1194852847,1194854347,1,9,1500
28971971@N00,1158,8,1195167897,1195169037,2,6,1140
28971971@N00,1158,1,1195169152,1195169242,3,6,90
28971971@N00,1158,6,1195169685,1195170705,5,6,1020
28971971@N00,1158,4,1195171976,1195172265,3,6,289
28971971@N00,1158,2,1195172265,1195172655,3,6,390
28971971@N00,1158,6,1195198965,1195199985,5,6,1020
28971971@N00,1159,12,1297407984,1297409484,4,1,1500
28977782@N00,1160,6,1192149695,1192150715,4,5,1020
28977782@N00,1160,7,1192157633,1192158653,7,5,1020
28977782@N00,1160,12,1192162126,1192163484,3,5,1358
28977782@N00,1160,6,1192163484,1192164504,6,5,1020
28977782@N00,1160,8,1192175267,1192176407,1,5,1140
28977782@N00,1161,6,1324313152,1324314172,2,6,1020
28977782@N00,1161,2,1324314376,1324314762,2,6,386
28977782@N00,1161,7,1324314762,1324315319,2,6,557
28977782@N00,1161,12,1324315319,1324316279,2,6,960
28977782@N00,1161,8,1324316279,1324317419,2,6,1140
28977782@N00,1161,13,1324319792,1324321592,2,6,1800
28977782@N00,1162,2,1324562920,1324563310,3,2,390
28977782@N00,1162,5,1324575885,1324576785,3,2,900
28977782@N00,1163,1,1324755290,1324755380,2,1,90
29000027@N05,1164,1,1432289734,1432289824,1,1,90
29000027@N05,1165,12,1436513781,1436515281,3,1,1500
29000027@N05,1166,10,1441624636,1441626136,6,1,1500
29000027@N05,1167,12,1449468562,1449470062,15,1,1500
29000027@N05,1168,12,1449891867,1449893367,16,1,1500
29000027@N05,1169,6,1456873195,1456874215,5,1,1020
29044494@N00,1170,9,1272622466,1272623966,2,2,1500
29044494@N00,1170,8,1272627375,1272628515,1,2,1140
29057323@N07,1171,3,1207365019,1207365439,3,6,420
29057323@N07,1171,8,1207380477,1207380656,2,6,179
29057323@N07,1171,5,1207380656,1207381556,2,6,900
29057323@N07,1171,13,1207388031,1207388143,2,6,112
29057323@N07,1171,3,1207388143,1207388563,2,6,420
29057323@N07,1171,5,1207399710,1207400610,1,6,900
29057323@N07,1172,13,1207808157,1207809957,2,1,1800
29108089@N04,1173,1,1385945775,1385945865,2,3,90
29108089@N04,1173,4,1385949973,1385950873,4,3,900
29108089@N04,1173,2,1385969756,1385970146,13,3,390
29129621@N05,1174,6,1291547999,1291549019,1,1,1020
29129621@N05,1175,4,1321146112,1321147012,1,1,900
29129621@N05,1176,3,1348898060,1348898480,2,2,420
29129621@N05,1176,2,1348901803,1348902193,1,2,390
29168905@N00,1177,4,1313816225,1313817125,11,2,900
29168905@N00,1177,1,1313841787,1313841877,1,2,90
29210960@N04,1178,8,1370732279,1370733419,1,1,1140
29225947@N00,1179,13,1380155412,1380155632,5,5,220
29225947@N00,1179,4,1380155632,1380156532,3,5,900
29225947@N00,1179,6,1380158119,1380159139,28,5,1020
29225947@N00,1179,10,1380162553,1380162778,3,5,225
29225947@N00,1179,5,1380162778,1380163678,22,5,900
29225947@N00,1180,5,1380251573,1380252473,20,1,900
29232178@N03,1181,8,1411760417,1411761557,1,1,1140
29259314@N04,1182,8,1286082638,1286083778,4,3,1140
29259314@N04,1182,13,1286088579,1286090379,3,3,1800
29259314@N04,1182,8,1286091530,1286092670,1,3,1140
29259314@N04,1183,1,1286133040,1286133044,2,4,4
29259314@N04,1183,4,1286133044,1286133647,2,4,603
29259314@N04,1183,1,1286133647,1286133737,5,4,90
29259314@N04,1183,5,1286144343,1286145243,1,4,900
29352917@N00,1184,9,1255335515,1255337015,1,1,1500
29352917@N00,1185,2,1255558149,1255558539,3,2,390
29352917@N00,1185,5,1255563895,1255564795,2,2,900
29384095@N00,1186,4,1253768413,1253769313,1,1,900
29568026@N07,1187,8,1397282177,1397283317,1,1,1140
29583624@N04,1188,5,1223020390,1223021290,3,2,900
29583624@N04,1188,13,1223027989,1223029789,2,2,1800
29618911@N04,1189,13,1329883076,1329884876,3,2,1800
29618911@N04,1189,6,1329890072,1329891092,1,2,1020
29619840@N00,1190,10,1209966867,1209968023,5,19,1156
29619840@N00,1190,1,1209968023,1209968113,4,19,90
29619840@N00,1190,5,1209968381,1209969281,6,19,900
29619840@N00,1190,10,1209969813,1209971313,6,19,1500
29619840@N00,1190,1,1209972867,1209972957,6,19,90
29619840@N00,1190,10,1209973902,1209974372,3,19,470
29619840@N00,1190,5,1209974372,1209975272,2,19,900
29619840@N00,1190,10,1209975736,1209976176,2,19,440
29619840@N00,1190,1,1209976176,1209976184,2,19,8
29619840@N00,1190,7,1209976184,1209977204,3,19,1020
29619840@N00,1190,12,1209977886,1209979289,14,19,1403
29619840@N00,1190,7,1209979289,1209979587,3,19,298
29619840@N00,1190,8,1209979587,1209980727,9,19,1140
29619840@N00,1190,5,1209980803,1209981586,7,19,783
29619840@N00,1190,10,1209981586,1209982038,2,19,452
29619840@N00,1190,9,1209982038,1209983538,42,19,1500
29619840@N00,1190,8,1209988987,1209989049,2,19,62
29619840@N00,1190,7,1209989049,1209989108,2,19,59
29619840@N00,1190,8,1209989108,1209990248,1,19,1140
29619840@N00,1191,4,1210139613,1210139766,2,6,153
29619840@N00,1191,6,1210139766,1210140786,3,6,1020
29619840@N00,1191,13,1210144645,1210146443,10,6,1798
29619840@N00,1191,4,1210146443,1210147343,3,6,900
29619840@N00,1191,8,1210147662,1210148802,14,6,1140
29619840@N00,1191,1,1210150326,1210150416,6,6,90
29648523@N05,1192,8,1258602750,1258603406,2,6,656
29648523@N05,1192,5,1258603406,1258604306,3,6,900
29648523@N05,1192,13,1258608982,1258610782,3,6,1800
29648523@N05,1192,4,1258611301,1258612201,2,6,900
29648523@N05,1192,7,1258619406,1258619500,2,6,94
29648523@N05,1192,8,1258619500,1258620640,1,6,1140
29675024@N05,1193,1,1275963050,1275963140,2,2,90
29675024@N05,1193,5,1275963365,1275964265,2,2,900
29756928@N03,1194,12,1398993649,1398995149,1,1,1500
29797746@N08,1195,4,1234062536,1234063436,1,1,900
29797746@N08,1196,8,1277002264,1277003404,42,1,1140
29826898@N00,1197,11,1206815580,1206817080,6,1,1500
29838859@N08,1198,4,1433458923,1433459823,2,1,900
29845947@N00,1199,1,1278640308,1278640398,23,5,90
29845947@N00,1199,6,1278651880,1278652900,13,5,1020
29845947@N00,1199,2,1278655639,1278656029,2,5,390
29845947@N00,1199,6,1278656497,1278657517,9,5,1020
29845947@N00,1199,2,1278660348,1278660738,7,5,390
29865634@N04,1200,10,1204156047,1204157547,4,6,1500
29865634@N04,1200,5,1204158122,1204159022,2,6,900
29865634@N04,1200,1,1204160567,1204160657,2,6,90
29865634@N04,1200,7,1204165111,1204166131,2,6,1020
29865634@N04,1200,10,1204168453,1204168629,2,6,176
29865634@N04,1200,5,1204168629,1204169529,1,6,900
29865634@N04,1201,4,1214552205,1214553105,3,2,900
29865634@N04,1201,5,1214553628,1214554528,1,2,900
29865634@N04,1202,1,1214630451,1214630541,1,1,90
29865634@N04,1203,5,1222490598,1222491498,10,2,900
29865634@N04,1203,1,1222494440,1222494530,1,2,90
29865634@N04,1204,6,1229674334,1229675354,10,3,1020
29865634@N04,1204,4,1229675495,1229676395,2,3,900
29865634@N04,1204,1,1229678435,1229678525,2,3,90
29865634@N04,1205,12,1249474841,1249475234,2,3,393
29865634@N04,1205,1,1249475234,1249475324,4,3,90
29865634@N04,1205,4,1249478967,1249479867,2,3,900
29865634@N04,1206,1,1250952376,1250952466,2,1,90
29865634@N04,1207,5,1250985255,1250986155,2,1,900
29865634@N04,1208,1,1251027873,1251027963,2,1,90
29865634@N04,1209,1,1251058148,1251058238,10,4,90
29865634@N04,1209,8,1251080994,1251082045,2,4,1051
29865634@N04,1209,6,1251082045,1251083065,8,4,1020
29865634@N04,1209,1,1251089078,1251089168,4,4,90
29865634@N04,1210,8,1251805194,1251806334,3,1,1140
29870124@N02,1211,4,1333966857,1333967757,1,1,900
29870124@N02,1212,1,1334191035,1334191125,2,1,90
29924665@N05,1213,4,1454795177,1454796077,7,9,900
29924665@N05,1213,13,1454808645,1454809594,2,9,949
29924665@N05,1213,4,1454809594,1454810494,27,9,900
29924665@N05,1213,10,1454818209,1454819709,2,9,1500
29924665@N05,1213,8,1454819820,1454820960,2,9,1140
29924665@N05,1213,12,1454821599,1454822886,5,9,1287
29924665@N05,1213,1,1454822886,1454822976,2,9,90
29924665@N05,1213,3,1454825690,1454826110,2,9,420
29924665@N05,1213,8,1454834412,1454835552,1,9,1140
29980560@N06,1214,12,1287909105,1287910605,1,1,1500
30022156@N00,1215,1,1336173110,1336173200,22,1,90
30030726@N05,1216,1,1437461138,1437461228,1,1,90
30042168@N03,1217,7,1328505901,1328505926,2,5,25
30042168@N03,1217,12,1328505926,1328507426,2,5,1500
30042168@N03,1217,4,1328507953,1328508134,4,5,181
30042168@N03,1217,6,1328508134,1328509154,4,5,1020
30042168@N03,1217,11,1328519367,1328520867,1,5,1500
30042168@N03,1218,1,1328735835,1328735925,5,2,90
30042168@N03,1218,4,1328740242,1328741142,4,2,900
30042168@N03,1219,2,1328924151,1328924226,2,3,75
30042168@N03,1219,11,1328924226,1328925726,2,3,1500
30042168@N03,1219,6,1328933948,1328934968,3,3,1020
30052360@N08,1220,1,1340955550,1340955640,18,1,90
30197109@N03,1221,1,1343546637,1343546727,1,1,90
30269754@N05,1222,1,1327712377,1327712467,3,6,90
30269754@N05,1222,5,1327714437,1327714951,2,6,514
30269754@N05,1222,1,1327714951,1327715041,2,6,90
30269754@N05,1222,13,1327715215,1327716184,2,6,969
30269754@N05,1222,4,1327716184,1327717084,2,6,900
30269754@N05,1222,6,1327720154,1327721174,8,6,1020
30269754@N05,1223,1,1380937896,1380937986,3,4,90
30269754@N05,1223,5,1380938053,1380938953,4,4,900
30269754@N05,1223,13,1380944865,1380946665,6,4,1800
30269754@N05,1223,4,1380947030,1380947930,3,4,900
30375980@N02,1224,8,1247519671,1247520811,30,1,1140
30452086@N07,1225,8,1376458770,1376459910,1,1,1140
30485540@N03,1226,8,1244915331,1244916471,1,1,1140
30493847@N04,1227,2,1317622966,1317623356,1,1,390
30498826@N00,1228,1,1310203352,1310203442,4,1,90
30586074@N07,1229,6,1242958541,1242959561,54,1,1020
30586074@N07,1230,8,1243043030,1243044170,36,3,1140
30586074@N07,1230,6,1243050083,1243051103,95,3,1020
30586074@N07,1230,10,1243061270,1243062770,4,3,1500
30586074@N07,1231,6,1243137250,1243138270,19,1,1020
30586074@N07,1232,1,1307062046,1307062136,41,3,90
30586074@N07,1232,6,1307063014,1307064034,45,3,1020
30586074@N07,1232,4,1307078234,1307079134,10,3,900
30586074@N07,1233,6,1307213996,1307215016,52,2,1020
30586074@N07,1233,4,1307259155,1307260055,1,2,900
30629351@N00,1234,8,1218262253,1218262416,2,8,163
30629351@N00,1234,2,1218262416,1218262806,3,8,390
30629351@N00,1234,8,1218263044,1218264184,3,8,1140
30629351@N00,1234,6,1218268490,1218269510,5,8,1020
30629351@N00,1234,1,1218271244,1218271334,2,8,90
30629351@N00,1234,10,1218271763,1218273263,18,8,1500
30629351@N00,1234,7,1218276885,1218277905,8,8,1020
30629351@N00,1234,1,1218278112,1218278202,1,8,90
30650680@N02,1235,8,1434354110,1434354800,2,2,690
30650680@N02,1235,4,1434354800,1434355700,1,2,900
30701202@N03,1236,10,1339819644,1339821144,4,1,1500
30706862@N02,1237,8,1307193085,1307194225,10,1,1140
30738244@N07,1238,8,1201759589,1201759662,2,2,73
30738244@N07,1238,5,1201759662,1201760562,4,2,900
30738244@N07,1239,9,1204446900,1204448400,1,1,1500
30738244@N07,1240,9,1218107968,1218109468,16,1,1500
30796335@N08,1241,10,1362306169,1362307669,2,5,1500
30796335@N08,1241,7,1362309580,1362310600,2,5,1020
30796335@N08,1241,11,1362311052,1362311077,2,5,25
30796335@N08,1241,2,1362311077,1362311467,4,5,390
30796335@N08,1241,6,1362313826,1362314846,1,5,1020
30796335@N08,1242,6,1362354291,1362355311,1,1,1020
30829906@N00,1243,1,1203133250,1203133340,1,1,90
30831872@N08,1244,2,1241305887,1241306277,2,5,390
30831872@N08,1244,11,1241318201,1241319701,5,5,1500
30831872@N08,1244,13,1241330240,1241332040,3,5,1800
30831872@N08,1244,7,1241332522,1241332580,2,5,58
30831872@N08,1244,12,1241332580,1241334080,1,5,1500
30891516@N08,1245,6,1305177796,1305178816,2,5,1020
30891516@N08,1245,4,1305179964,1305180864,2,5,900
30891516@N08,1245,12,1305190839,1305191326,2,5,487
30891516@N08,1245,6,1305191326,1305192346,3,5,1020
30891516@N08,1245,9,1305201039,1305202539,1,5,1500
30954521@N08,1246,5,1197192777,1197193677,1,1,900
31073542@N07,1247,5,1471247365,1471247814,2,2,449
31073542@N07,1247,9,1471247814,1471249314,1,2,1500
31169813@N04,1248,5,1232838620,1232839520,6,18,900
31169813@N04,1248,2,1232844680,1232845070,6,18,390
31169813@N04,1248,4,1232847230,1232847284,2,18,54
31169813@N04,1248,6,1232847284,1232848304,2,18,1020
31169813@N04,1248,8,1232849064,1232850204,2,18,1140
31169813@N04,1248,1,1232850662,1232850752,2,18,90
31169813@N04,1248,12,1232852365,1232853865,3,18,1500
31169813@N04,1248,8,1232854304,1232855444,9,18,1140
31169813@N04,1248,1,1232857770,1232857860,3,18,90
31169813@N04,1248,4,1232859444,1232859610,2,18,166
31169813@N04,1248,6,1232859610,1232860630,9,18,1020
31169813@N04,1248,2,1232865375,1232865765,3,18,390
31169813@N04,1248,12,1232869364,1232870864,8,18,1500
31169813@N04,1248,5,1232876517,1232877417,5,18,900
31169813@N04,1248,8,1232879226,1232880366,2,18,1140
31169813@N04,1248,12,1232880505,1232882005,2,18,1500
31169813@N04,1248,8,1232882483,1232882979,2,18,496
31169813@N04,1248,10,1232882979,1232884479,1,18,1500
31169813@N04,1249,10,1233202579,1233204079,3,4,1500
31169813@N04,1249,5,1233208099,1233208999,2,4,900
31169813@N04,1249,9,1233216052,1233217552,13,4,1500
31169813@N04,1249,1,1233218674,1233218764,2,4,90
31223689@N00,1250,5,1222056423,1222057323,1,1,900
31223689@N00,1251,1,1230620578,1230620668,2,4,90
31223689@N00,1251,8,1230620694,1230620854,2,4,160
31223689@N00,1251,5,1230620854,1230621754,2,4,900
31223689@N00,1251,9,1230622636,1230624136,1,4,1500
31291728@N05,1252,8,1461728643,1461729783,1,1,1140
31291728@N05,1253,4,1461928816,1461929716,3,2,900
31291728@N05,1253,2,1461935521,1461935911,1,2,390
31369133@N04,1254,2,1292161107,1292161497,1,1,390
31429098@N03,1255,12,1375672097,1375673351,2,2,1254
31429098@N03,1255,6,1375673351,1375674371,1,2,1020
31449648@N05,1256,2,1365844048,1365844438,1,1,390
31449648@N05,1257,5,1375152347,1375153247,1,1,900
31449648@N05,1258,1,1383377396,1383377486,1,1,90
31449648@N05,1259,6,1383984076,1383985096,2,1,1020
31535569@N00,1260,5,1255132920,1255133820,1,1,900
31565537@N00,1261,12,1281151632,1281153132,6,1,1500
31608675@N00,1262,8,1253335339,1253336479,1,1,1140
31681108@N07,1263,6,1246529871,1246530891,1,1,1020
31681108@N07,1264,5,1247299973,1247300873,1,1,900
31692641@N00,1265,13,1228367543,1228369343,2,9,1800
31692641@N00,1265,1,1228374984,1228375074,4,9,90
31692641@N00,1265,11,1228375841,1228376067,2,9,226
31692641@N00,1265,2,1228376067,1228376457,5,9,390
31692641@N00,1265,1,1228377575,1228377601,3,9,26
31692641@N00,1265,8,1228377601,1228377602,2,9,1
31692641@N00,1265,11,1228377602,1228377603,2,9,1
31692641@N00,1265,1,1228377603,1228377693,2,9,90
31692641@N00,1265,2,1228378523,1228378913,1,9,390
31692641@N00,1266,1,1228568400,1228568404,4,4,4
31692641@N00,1266,5,1228568404,1228568411,2,4,7
31692641@N00,1266,2,1228568411,1228568412,2,4,1
31692641@N00,1266,5,1228568412,1228569312,2,4,900
31692641@N00,1267,2,1228599253,1228599643,2,6,390
31692641@N00,1267,5,1228602562,1228603462,2,6,900
31692641@N00,1267,2,1228604244,1228604634,2,6,390
31692641@N00,1267,6,1228624039,1228625059,2,6,1020
31692641@N00,1267,2,1228626317,1228626707,3,6,390
31692641@N00,1267,1,1228628970,1228629060,1,6,90
31692641@N00,1268,1,1317560401,1317560413,12,5,12
31692641@N00,1268,2,1317560413,1317560426,6,5,13
31692641@N00,1268,4,1317560426,1317560429,4,5,3
31692641@N00,1268,1,1317560429,1317560432,4,5,3
31692641@N00,1268,2,1317560432,1317560822,9,5,390
31692641@N00,1269,1,1317598832,1317598922,2,3,90
31692641@N00,1269,2,1317606136,1317606526,7,3,390
31692641@N00,1269,1,1317633532,1317633622,1,3,90
31764887@N02,1270,1,1333198800,1333198800,3,2,0
31764887@N02,1270,6,1333198800,1333199820,1,2,1020
31764887@N02,1271,1,1364734800,1364734890,2,1,90
31770349@N02,1272,8,1223676162,1223677302,3,6,1140
31770349@N02,1272,6,1223678892,1223679912,2,6,1020
31770349@N02,1272,2,1223683998,1223684388,2,6,390
31770349@N02,1272,6,1223690510,1223690589,2,6,79
31770349@N02,1272,3,1223690589,1223691009,3,6,420
31770349@N02,1272,4,1223691560,1223692460,1,6,900
31846143@N08,1273,8,1238903159,1238904299,43,1,1140
31924266@N02,1274,2,1304725378,1304725768,1,1,390
31937081@N07,1275,4,1421884121,1421885021,2,4,900
31937081@N07,1275,5,1421888515,1421889415,2,4,900
31937081@N07,1275,10,1421893820,1421895320,2,4,1500
31937081@N07,1275,6,1421901500,1421902520,2,4,1020
31947407@N00,1276,12,1333980004,1333981504,13,1,1500
31947407@N00,1277,12,1334013181,1334014681,22,1,1500
31947407@N00,1278,12,1334066433,1334067933,45,1,1500
31947407@N00,1279,12,1334127890,1334129390,47,1,1500
31957707@N08,1280,4,1419663768,1419664668,1,1,900
31964360@N00,1281,6,1420005682,1420006702,1,1,1020
31964360@N00,1282,4,1420145379,1420146279,2,3,900
31964360@N00,1282,2,1420151340,1420151730,2,3,390
31964360@N00,1282,6,1420153383,1420154403,3,3,1020
32018985@N00,1283,8,1455321488,1455322123,3,8,635
32018985@N00,1283,12,1455322123,1455323623,12,8,1500
32018985@N00,1283,4,1455330894,1455331794,2,8,900
32018985@N00,1283,2,1455332746,1455333136,5,8,390
32018985@N00,1283,1,1455333386,1455333476,2,8,90
32018985@N00,1283,4,1455344417,1455345317,5,8,900
32018985@N00,1283,2,1455347538,1455347928,3,8,390
32018985@N00,1283,9,1455349997,1455351497,1,8,1500
32040587@N04,1284,5,1304140012,1304140912,2,1,900
32077113@N00,1285,4,1269473556,1269474456,1,1,900
32090737@N04,1286,5,1224811259,1224812159,1,1,900
32090737@N04,1287,5,1225962362,1225963133,2,2,771
32090737@N04,1287,4,1225963133,1225964033,1,2,900
32090737@N04,1288,5,1238987438,1238988338,1,1,900
32263245@N00,1289,8,1243730269,1243731409,31,1,1140
32263245@N00,1290,8,1260006957,1260008097,5,1,1140
32263245@N00,1291,6,1291540749,1291541769,2,1,1020
32359947@N00,1292,8,1243573796,1243574936,2,7,1140
32359947@N00,1292,13,1243575317,1243577117,2,7,1800
32359947@N00,1292,1,1243579267,1243579357,9,7,90
32359947@N00,1292,4,1243581598,1243581791,3,7,193
32359947@N00,1292,6,1243581791,1243582811,3,7,1020
32359947@N00,1292,13,1243595527,1243596961,3,7,1434
32359947@N00,1292,1,1243596961,1243597051,6,7,90
32370701@N02,1293,4,1292644243,1292645143,1,1,900
32372198@N00,1294,5,1360898722,1360899622,3,3,900
32372198@N00,1294,12,1360907403,1360908066,2,3,663
32372198@N00,1294,4,1360908066,1360908966,6,3,900
32399171@N00,1295,10,1300751976,1300753476,1,1,1500
32527241@N04,1296,8,1266274707,1266275847,86,1,1140
32617425@N00,1297,6,1352531094,1352532114,45,2,1020
32617425@N00,1297,10,1352537809,1352539309,2,2,1500
32617425@N00,1298,1,1415419183,1415419273,3,5,90
32617425@N00,1298,6,1415420874,1415421894,7,5,1020
32617425@N00,1298,13,1415430074,1415431874,4,5,1800
32617425@N00,1298,6,1415435486,1415436211,6,5,725
32617425@N00,1298,4,1415436211,1415437111,7,5,900
32644191@N07,1299,10,1254458688,1254460188,2,1,1500
32644191@N07,1300,10,1255255102,1255256602,1,1,1500
32644191@N07,1301,6,1255653773,1255654793,3,4,1020
32644191@N07,1301,10,1255667208,1255667745,2,4,537
32644191@N07,1301,2,1255667745,1255668135,2,4,390
32644191@N07,1301,10,1255672018,1255673518,1,4,1500
32907388@N08,1302,6,1300769379,1300770399,3,1,1020
33029321@N00,1303,2,1331645197,1331645587,15,1,390
33050020@N08,1304,9,1360967332,1360968832,1,1,1500
33063488@N02,1305,6,1229244677,1229245697,1,1,1020
33063488@N02,1306,4,1231057827,1231058727,1,1,900
33063488@N02,1307,11,1238424122,1238425622,1,1,1500
33115152@N06,1308,1,1248226272,1248226362,2,1,90
33121758@N04,1309,8,1229134184,1229135324,30,1,1140
33121758@N04,1310,8,1316846928,1316848068,1,1,1140
33121758@N04,1311,11,1350196246,1350197746,1,1,1500
33121758@N04,1312,4,1352614506,1352615406,2,2,900
33121758@N04,1312,6,1352620222,1352621242,1,2,1020
33121758@N04,1313,1,1368871438,1368871528,1,1,90
33121758@N04,1314,1,1386397860,1386397950,2,2,90
33121758@N04,1314,6,1386413381,1386414401,1,2,1020
33197996@N07,1315,2,1396643036,1396643426,1,1,390
33197996@N07,1316,4,1396993018,1396993918,2,1,900
33197996@N07,1317,5,1405876378,1405877278,1,1,900
33197996@N07,1318,4,1409174665,1409175565,1,1,900
33197996@N07,1319,11,1410472954,1410474454,1,1,1500
33197996@N07,1320,4,1433569084,1433569984,2,1,900
33197996@N07,1321,6,1452066687,1452067707,1,1,1020
33244915@N00,1322,5,1328914600,1328915500,5,8,900
33244915@N00,1322,10,1328921462,1328922962,3,8,1500
33244915@N00,1322,4,1328924642,1328925542,3,8,900
33244915@N00,1322,6,1328926086,1328927106,2,8,1020
33244915@N00,1322,3,1328928454,1328928460,2,8,6
33244915@N00,1322,6,1328928460,1328929480,2,8,1020
33244915@N00,1322,5,1328938716,1328939616,3,8,900
33244915@N00,1322,2,1328946482,1328946872,3,8,390
33244915@N00,1323,1,1329042580,1329042596,2,6,16
33244915@N00,1323,5,1329042596,1329042676,6,6,80
33244915@N00,1323,1,1329042676,1329042766,16,6,90
33244915@N00,1323,6,1329042910,1329043092,12,6,182
33244915@N00,1323,8,1329043092,1329043146,5,6,54
33244915@N00,1323,1,1329043146,1329043236,2,6,90
33244915@N00,1324,8,1329097828,1329098968,4,7,1140
33244915@N00,1324,7,1329101126,1329102146,4,7,1020
33244915@N00,1324,12,1329103180,1329104156,4,7,976
33244915@N00,1324,7,1329104156,1329105176,3,7,1020
33244915@N00,1324,12,1329107686,1329109186,14,7,1500
33244915@N00,1324,4,1329129378,1329129616,11,7,238
33244915@N00,1324,6,1329129616,1329130636,28,7,1020
33244915@N00,1325,6,1329210636,1329211520,43,2,884
33244915@N00,1325,9,1329211520,1329213020,91,2,1500
33257765@N05,1326,5,1333877888,1333878788,3,1,900
33277678@N03,1327,1,1393230553,1393230643,2,9,90
33277678@N03,1327,13,1393235328,1393237039,4,9,1711
33277678@N03,1327,8,1393237039,1393238179,10,9,1140
33277678@N03,1327,10,1393240081,1393241526,3,9,1445
33277678@N03,1327,4,1393241526,1393242426,3,9,900
33277678@N03,1327,10,1393244232,1393245732,22,9,1500
33277678@N03,1327,6,1393250248,1393251200,4,9,952
33277678@N03,1327,8,1393251200,1393252340,9,9,1140
33277678@N03,1327,9,1393259670,1393261170,2,9,1500
33277678@N03,1328,9,1393308214,1393309714,1,1,1500
33312419@N07,1329,8,1354072400,1354073540,1,1,1140
33312419@N07,1330,12,1458437028,1458438528,1,1,1500
33352249@N03,1331,2,1331679694,1331680084,1,1,390
33360568@N05,1332,1,1389138856,1389138946,4,5,90
33360568@N05,1332,10,1389139406,1389140906,2,5,1500
33360568@N05,1332,13,1389141658,1389143458,3,5,1800
33360568@N05,1332,5,1389153336,1389154236,6,5,900
33360568@N05,1332,1,1389170517,1389170607,1,5,90
33386366@N06,1333,8,1237524315,1237525455,1,1,1140
33404394@N00,1334,5,1435399085,1435399985,1,1,900
33441892@N00,1335,10,1380844029,1380844655,3,27,626
33441892@N00,1335,1,1380844655,1380844745,3,27,90
33441892@N00,1335,7,1380844977,1380845151,4,27,174
33441892@N00,1335,12,1380845151,1380846058,7,27,907
33441892@N00,1335,7,1380846058,1380846335,2,27,277
33441892@N00,1335,12,1380846335,1380847604,10,27,1269
33441892@N00,1335,13,1380847604,1380849250,5,27,1646
33441892@N00,1335,12,1380849250,1380849628,9,27,378
33441892@N00,1335,1,1380849628,1380849718,4,27,90
33441892@N00,1335,13,1380854293,1380854464,2,27,171
33441892@N00,1335,4,1380854464,1380855112,14,27,648
33441892@N00,1335,3,1380855112,1380855532,3,27,420
33441892@N00,1335,13,1380855585,1380856656,2,27,1071
33441892@N00,1335,6,1380856656,1380856885,2,27,229
33441892@N00,1335,13,1380856885,1380858685,6,27,1800
33441892@N00,1335,6,1380859102,1380859267,3,27,165
33441892@N00,1335,4,1380859267,1380859365,2,27,98
33441892@N00,1335,13,1380859365,1380860708,3,27,1343
33441892@N00,1335,4,1380860708,1380861608,2,27,900
33441892@N00,1335,13,1380862254,1380864054,13,27,1800
33441892@N00,1335,2,1380874369,1380874759,2,27,390
33441892@N00,1335,1,1380878334,1380878424,2,27,90
33441892@N00,1335,2,1380879393,1380879601,2,27,208
33441892@N00,1335,8,1380879601,1380880074,3,27,473
33441892@N00,1335,2,1380880074,1380880464,11,27,390
33441892@N00,1335,10,1380882926,1380884426,5,27,1500
33441892@N00,1335,9,1380886348,1380887848,6,27,1500
33484476@N00,1336,10,1192727433,1192728933,12,1,1500
33494202@N04,1337,10,1252534656,1252535969,2,12,1313
33494202@N04,1337,2,1252535969,1252536359,4,12,390
33494202@N04,1337,7,1252537334,1252538354,2,12,1020
33494202@N04,1337,12,1252539744,1252541244,4,12,1500
33494202@N04,1337,10,1252545553,1252547053,4,12,1500
33494202@N04,1337,5,1252549598,1252550498,2,12,900
33494202@N04,1337,3,1252551828,1252551857,2,12,29
33494202@N04,1337,6,1252551857,1252552877,2,12,1020
33494202@N04,1337,1,1252556072,1252556162,4,12,90
33494202@N04,1337,11,1252558483,1252559983,5,12,1500
33494202@N04,1337,9,1252575407,1252576907,7,12,1500
33494202@N04,1337,5,1252579021,1252579921,1,12,900
33507016@N05,1338,1,1385475436,1385475526,1,1,90
33507605@N03,1339,8,1250140918,1250142058,12,1,1140
33507605@N03,1340,8,1250227014,1250228154,24,1,1140
33507605@N03,1341,8,1250441850,1250442990,6,1,1140
33546659@N08,1342,7,1323480142,1323481162,2,7,1020
33546659@N08,1342,11,1323491320,1323492820,3,7,1500
33546659@N08,1342,2,1323495771,1323495784,2,7,13
33546659@N08,1342,12,1323495784,1323495825,2,7,41
33546659@N08,1342,2,1323495825,1323496215,4,7,390
33546659@N08,1342,11,1323522332,1323523832,2,7,1500
33546659@N08,1342,2,1323525102,1323525492,1,7,390
33546659@N08,1343,8,1323667771,1323667953,2,4,182
33546659@N08,1343,7,1323667953,1323668019,2,4,66
33546659@N08,1343,8,1323668019,1323668284,2,4,265
33546659@N08,1343,7,1323668284,1323669304,1,4,1020
33557908@N02,1344,5,1333274107,1333275007,1,1,900
33563310@N06,1345,1,1349415819,1349415909,3,2,90
33563310@N06,1345,5,1349421576,1349422476,1,2,900
33563310@N06,1346,8,1357085164,1357086304,4,3,1140
33563310@N06,1346,6,1357086782,1357087802,3,3,1020
33563310@N06,1346,4,1357090917,1357091817,1,3,900
33572008@N03,1347,13,1420013227,1420015027,4,4,1800
33572008@N03,1347,2,1420016460,1420016607,2,4,147
33572008@N03,1347,8,1420016607,1420017747,5,4,1140
33572008@N03,1347,1,1420018892,1420018982,9,4,90
33598193@N03,1348,8,1355629825,1355630965,3,2,1140
33598193@N03,1348,6,1355637763,1355638783,3,2,1020
33598193@N03,1349,6,1385284763,1385285783,1,1,1020
33598193@N03,1350,6,1385445443,1385446463,1,1,1020
33598193@N03,1351,12,1393623811,1393624173,2,2,362
33598193@N03,1351,7,1393624173,1393625193,1,2,1020
33598193@N03,1352,9,1401604097,1401605597,2,1,1500
33598193@N03,1353,5,1402882591,1402883491,1,1,900
33598193@N03,1354,6,1416041198,1416042218,2,1,1020
33623158@N04,1355,8,1238401887,1238403027,1,1,1140
33667899@N07,1356,1,1318369984,1318370074,5,5,90
33667899@N07,1356,11,1318389385,1318389390,3,5,5
33667899@N07,1356,1,1318389390,1318389480,2,5,90
33667899@N07,1356,5,1318390912,1318391812,3,5,900
33667899@N07,1356,1,1318393028,1318393118,4,5,90
33667899@N07,1357,5,1318829678,1318830578,2,1,900
33667899@N07,1358,4,1349826616,1349827516,2,3,900
33667899@N07,1358,13,1349840478,1349842278,2,3,1800
33667899@N07,1358,5,1349844596,1349845496,2,3,900
33667899@N07,1359,10,1381960252,1381961752,3,4,1500
33667899@N07,1359,2,1381978638,1381979028,2,4,390
33667899@N07,1359,4,1381981594,1381982494,3,4,900
33667899@N07,1359,10,1381990354,1381991854,1,4,1500
33667899@N07,1360,9,1382137603,1382139103,1,1,1500
33680092@N03,1361,6,1451202267,1451203287,3,1,1020
33680092@N03,1362,6,1455093917,1455094937,1,1,1020
33704098@N00,1363,10,1389401638,1389402744,3,12,1106
33704098@N00,1363,13,1389402744,1389404544,9,12,1800
33704098@N00,1363,8,1389406204,1389406954,5,12,750
33704098@N00,1363,2,1389406954,1389407344,4,12,390
33704098@N00,1363,8,1389408264,1389408963,3,12,699
33704098@N00,1363,4,1389408963,1389409863,4,12,900
33704098@N00,1363,6,1389410222,1389410832,6,12,610
33704098@N00,1363,4,1389410832,1389411732,11,12,900
33704098@N00,1363,6,1389412983,1389413194,3,12,211
33704098@N00,1363,2,1389413194,1389413584,2,12,390
33704098@N00,1363,5,1389420406,1389421306,6,12,900
33704098@N00,1363,9,1389428706,1389430206,2,12,1500
33754377@N03,1364,1,1423098856,1423098946,1,1,90
33786609@N02,1365,13,1437264290,1437266090,1,1,1800
33812931@N04,1366,11,1390193326,1390194826,1,1,1500
33822743@N08,1367,1,1229191707,1229191797,4,2,90
33822743@N08,1367,8,1229192074,1229193214,1,2,1140
33822743@N08,1368,1,1230191067,1230191157,5,2,90
33822743@N08,1368,6,1230192415,1230193435,10,2,1020
33822743@N08,1369,1,1240150058,1240150148,7,2,90
33822743@N08,1369,2,1240157195,1240157585,11,2,390
33822743@N08,1370,6,1273196029,1273197049,2,1,1020
33824882@N07,1371,6,1398210914,1398211934,3,1,1020
33897253@N07,1372,5,1232849221,1232850121,1,1,900
33929547@N03,1373,1,1430730904,1430730994,2,2,90
33929547@N03,1373,9,1430738267,1430739767,12,2,1500
33934966@N00,1374,8,1290481623,1290482152,2,3,529
33934966@N00,1374,5,1290482152,1290483052,11,3,900
33934966@N00,1374,6,1290491094,1290492114,2,3,1020
33934966@N00,1375,9,1291038562,1291040062,19,3,1500
33934966@N00,1375,6,1291041625,1291042645,12,3,1020
33934966@N00,1375,8,1291042849,1291043989,3,3,1140
33934966@N00,1376,8,1320325038,1320325153,2,4,115
33934966@N00,1376,1,1320325153,1320325243,6,4,90
33934966@N00,1376,8,1320326313,1320327453,2,4,1140
33934966@N00,1376,5,1320328037,1320328937,2,4,900
33934966@N00,1377,4,1320557453,1320558353,5,1,900
33971415@N07,1378,4,1254572014,1254572914,1,1,900
34008756@N07,1379,1,1268695748,1268695838,1,1,90
34041523@N06,1380,4,1355982437,1355983337,5,2,900
34041523@N06,1380,6,1355987196,1355988216,4,2,1020
34127338@N04,1381,6,1445990731,1445991751,2,11,1020
34127338@N04,1381,4,1445999869,1446000769,2,11,900
34127338@N04,1381,13,1446001376,1446003176,2,11,1800
34127338@N04,1381,4,1446011535,1446012435,3,11,900
34127338@N04,1381,8,1446014387,1446014458,2,11,71
34127338@N04,1381,7,1446014458,1446014847,2,11,389
34127338@N04,1381,11,1446014847,1446016347,5,11,1500
34127338@N04,1381,2,1446017369,1446017549,2,11,180
34127338@N04,1381,6,1446017549,1446018569,3,11,1020
34127338@N04,1381,8,1446019066,1446019114,2,11,48
34127338@N04,1381,1,1446019114,1446019204,2,11,90
34127338@N04,1382,6,1446172584,1446173604,3,2,1020
34127338@N04,1382,2,1446177440,1446177830,1,2,390
34153311@N05,1383,6,1292830201,1292831221,5,1,1020
34153311@N05,1384,10,1318997620,1318999056,2,6,1436
34153311@N05,1384,6,1318999056,1319000076,3,6,1020
34153311@N05,1384,1,1319001342,1319001432,4,6,90
34153311@N05,1384,9,1319009835,1319010964,3,6,1129
34153311@N05,1384,1,1319010964,1319011054,4,6,90
34153311@N05,1384,9,1319011062,1319012562,1,6,1500
34153311@N05,1385,4,1361139436,1361140336,2,5,900
34153311@N05,1385,2,1361146253,1361146643,2,5,390
34153311@N05,1385,6,1361147635,1361148655,4,5,1020
34153311@N05,1385,8,1361151197,1361152337,2,5,1140
34153311@N05,1385,4,1361153185,1361154085,2,5,900
34153311@N05,1386,2,1408656991,1408657381,3,4,390
34153311@N05,1386,4,1408658428,1408658873,4,4,445
34153311@N05,1386,2,1408658873,1408659263,4,4,390
34153311@N05,1386,4,1408661232,1408662132,1,4,900
34153311@N05,1387,5,1408750991,1408751891,2,2,900
34153311@N05,1387,6,1408757759,1408758779,13,2,1020
34153311@N05,1388,2,1409222620,1409223010,4,1,390
34176066@N00,1389,9,1319531384,1319532884,2,1,1500
34176066@N00,1390,10,1319673429,1319674929,14,3,1500
34176066@N00,1390,12,1319684518,1319686018,3,3,1500
34176066@N00,1390,1,1319688185,1319688275,45,3,90
34239398@N00,1391,6,1197188577,1197189597,3,1,1020
34239398@N00,1392,1,1197243690,1197243780,4,2,90
34239398@N00,1392,7,1197243898,1197244918,2,2,1020
34361916@N00,1393,5,1339717601,1339718501,2,3,900
34361916@N00,1393,4,1339727422,1339728322,3,3,900
34361916@N00,1393,5,1339752398,1339753298,1,3,900
34390084@N07,1394,8,1231521274,1231522414,2,3,1140
34390084@N07,1394,7,1231527917,1231528607,2,3,690
34390084@N07,1394,8,1231528607,1231529747,1,3,1140
34390084@N07,1395,8,1233233918,1233235058,1,1,1140
34390084@N07,1396,1,1234408182,1234408272,4,1,90
34390084@N07,1397,1,1234478571,1234478661,1,1,90
34390084@N07,1398,12,1235773628,1235773975,2,5,347
34390084@N07,1398,7,1235773975,1235774211,2,5,236
34390084@N07,1398,8,1235774211,1235775351,7,5,1140
34390084@N07,1398,5,1235784632,1235785532,4,5,900
34390084@N07,1398,8,1235786416,1235787556,3,5,1140
34390084@N07,1399,11,1238796512,1238796831,2,2,319
34390084@N07,1399,8,1238796831,1238797971,1,2,1140
34390084@N07,1400,6,1241161888,1241162908,2,3,1020
34390084@N07,1400,8,1241167071,1241168211,3,3,1140
34390084@N07,1400,1,1241168236,1241168326,4,3,90
34390084@N07,1401,7,1256390797,1256390895,2,3,98
34390084@N07,1401,8,1256390895,1256392035,3,3,1140
34390084@N07,1401,13,1256392597,1256394397,1,3,1800
34390084@N07,1402,6,1258619828,1258620848,12,1,1020
34390084@N07,1403,6,1260615371,1260616391,7,1,1020
34482114@N07,1404,5,1398668448,1398669348,1,1,900
34522551@N02,1405,7,1340860047,1340861067,12,1,1020
34544450@N05,1406,5,1360111062,1360111962,3,3,900
34544450@N05,1406,13,1360123084,1360124884,2,3,1800
34544450@N05,1406,12,1360126645,1360128145,3,3,1500
34544916@N07,1407,8,1355620378,1355621518,1,1,1140
34612686@N08,1408,5,1427183668,1427184568,3,1,900
34695087@N00,1409,10,1203539195,1203540695,1,1,1500
34695134@N00,1410,9,1197885753,1197887253,7,1,1500
34703628@N00,1411,7,1300156679,1300157699,2,4,1020
34703628@N00,1411,8,1300163656,1300164796,2,4,1140
34703628@N00,1411,6,1300177270,1300177528,2,4,258
34703628@N00,1411,3,1300177528,1300177948,1,4,420
34727974@N05,1412,1,1291604460,1291604550,2,2,90
34727974@N05,1412,12,1291607749,1291609249,2,2,1500
34783369@N05,1413,8,1340446956,1340448096,5,1,1140
34848373@N03,1414,4,1230329589,1230330489,1,1,900
34945596@N06,1415,12,1220191200,1220192700,3,1,1500
35034348373@N01,1416,6,1364178052,1364179072,2,2,1020
35034348373@N01,1416,4,1364194309,1364195209,1,2,900
35034363370@N01,1417,10,1414878579,1414879297,3,16,718
35034363370@N01,1417,8,1414879297,1414879602,3,16,305
35034363370@N01,1417,7,1414879602,1414879632,2,16,30
35034363370@N01,1417,12,1414879632,1414880596,12,16,964
35034363370@N01,1417,8,1414880596,1414881736,6,16,1140
35034363370@N01,1417,6,1414884172,1414885192,4,16,1020
35034363370@N01,1417,13,1414886582,1414888382,11,16,1800
35034363370@N01,1417,6,1414892697,1414893717,3,16,1020
35034363370@N01,1417,4,1414898289,1414898521,2,16,232
35034363370@N01,1417,3,1414898521,1414898941,3,16,420
35034363370@N01,1417,2,1414902551,1414902941,3,16,390
35034363370@N01,1417,8,1414909102,1414910242,2,16,1140
35034363370@N01,1417,6,1414911484,1414912504,5,16,1020
35034363370@N01,1417,1,1414917110,1414917200,2,16,90
35034363370@N01,1417,9,1414918033,1414919533,14,16,1500
35034363370@N01,1417,1,1414921384,1414921474,2,16,90
35034364890@N01,1418,10,1194477407,1194478177,3,11,770
35034364890@N01,1418,8,1194478177,1194479317,3,11,1140
35034364890@N01,1418,4,1194482218,1194482510,2,11,292
35034364890@N01,1418,8,1194482510,1194483371,2,11,861
35034364890@N01,1418,6,1194483371,1194484391,6,11,1020
35034364890@N01,1418,2,1194490949,1194491339,2,11,390
35034364890@N01,1418,6,1194493937,1194494957,3,11,1020
35034364890@N01,1418,5,1194495946,1194496846,4,11,900
35034364890@N01,1418,10,1194502427,1194503927,3,11,1500
35034364890@N01,1418,9,1194513604,1194515104,6,11,1500
35034364890@N01,1418,1,1194516766,1194516856,3,11,90
35041397@N00,1419,1,1287095999,1287096089,2,8,90
35041397@N00,1419,5,1287096527,1287097427,3,8,900
35041397@N00,1419,1,1287098329,1287098419,2,8,90
35041397@N00,1419,10,1287099237,1287100737,6,8,1500
35041397@N00,1419,8,1287102410,1287103550,2,8,1140
35041397@N00,1419,13,1287103824,1287105624,6,8,1800
35041397@N00,1419,6,1287105778,1287106798,4,8,1020
35041397@N00,1419,2,1287115911,1287116301,1,8,390
35082889@N05,1420,5,1415245384,1415246284,1,1,900
35155400@N03,1421,7,1403330456,1403331476,1,1,1020
35155400@N03,1422,7,1410085049,1410086069,2,1,1020
35155400@N03,1423,8,1425698983,1425698984,2,2,1
35155400@N03,1423,1,1425698984,1425699074,1,2,90
35155400@N03,1424,7,1425779763,1425780783,1,1,1020
35167741@N05,1425,1,1461596810,1461596900,75,3,90
35167741@N05,1425,2,1461642068,1461642098,2,3,30
35167741@N05,1425,1,1461642098,1461642188,29,3,90
35170449@N06,1426,8,1234420411,1234421551,80,1,1140
35209467@N02,1427,1,1295737996,1295738086,1,1,90
35237092727@N01,1428,5,1344512994,1344513894,1,1,900
35261894@N00,1429,13,1404199781,1404201581,2,9,1800
35261894@N00,1429,1,1404201825,1404201915,4,9,90
35261894@N00,1429,13,1404202142,1404203942,4,9,1800
35261894@N00,1429,4,1404204331,1404205105,2,9,774
35261894@N00,1429,6,1404205105,1404205145,2,9,40
35261894@N00,1429,13,1404205145,1404206945,4,9,1800
35261894@N00,1429,4,1404207593,1404208493,6,9,900
35261894@N00,1429,6,1404210802,1404211299,5,9,497
35261894@N00,1429,2,1404211299,1404211689,10,9,390
35356940@N00,1430,5,1368829337,1368830237,2,4,900
35356940@N00,1430,6,1368839070,1368840090,2,4,1020
35356940@N00,1430,4,1368840848,1368841748,2,4,900
35356940@N00,1430,12,1368859709,1368861209,10,4,1500
35378947@N07,1431,8,1205168481,1205169621,21,3,1140
35378947@N07,1431,4,1205175844,1205176744,2,3,900
35378947@N07,1431,8,1205177522,1205178662,5,3,1140
35378947@N07,1432,8,1205412828,1205413968,3,1,1140
35378947@N07,1433,8,1233976761,1233977901,12,1,1140
35378947@N07,1434,8,1234149222,1234150362,31,1,1140
35378947@N07,1435,8,1259877709,1259878849,36,3,1140
35378947@N07,1435,2,1259885915,1259886305,10,3,390
35378947@N07,1435,8,1259906016,1259907156,3,3,1140
35378947@N07,1436,8,1260092358,1260093498,3,4,1140
35378947@N07,1436,4,1260093654,1260094554,2,4,900
35378947@N07,1436,6,1260095210,1260096230,30,4,1020
35378947@N07,1436,5,1260098178,1260099078,1,4,900
35378947@N07,1437,8,1281685245,1281686385,2,2,1140
35378947@N07,1437,12,1281690093,1281691593,8,2,1500
35378947@N07,1438,12,1281743654,1281743689,2,6,35
35378947@N07,1438,7,1281743689,1281744171,3,6,482
35378947@N07,1438,12,1281744171,1281744664,2,6,493
35378947@N07,1438,2,1281744664,1281745054,7,6,390
35378947@N07,1438,6,1281745583,1281745693,3,6,110
35378947@N07,1438,8,1281745693,1281746833,1,6,1140
35378947@N07,1439,1,1284509648,1284509738,5,3,90
35378947@N07,1439,5,1284513560,1284514460,3,3,900
35378947@N07,1439,2,1284515353,1284515743,1,3,390
35378947@N07,1440,1,1285135993,1285136005,2,2,12
35378947@N07,1440,12,1285136005,1285137505,1,2,1500
35378947@N07,1441,6,1305074508,1305074848,2,8,340
35378947@N07,1441,8,1305074848,1305075233,2,8,385
35378947@N07,1441,7,1305075233,1305076253,5,8,1020
35378947@N07,1441,10,1305077775,1305079275,4,8,1500
35378947@N07,1441,12,1305080751,1305082251,3,8,1500
35378947@N07,1441,2,1305087097,1305087487,2,8,390
35378947@N07,1441,12,1305097840,1305097914,3,8,74
35378947@N07,1441,7,1305097914,1305098934,2,8,1020
35378947@N07,1442,5,1305337131,1305338031,1,1,900
35378947@N07,1443,2,1305519751,1305520093,2,8,342
35378947@N07,1443,12,1305520093,1305520461,2,8,368
35378947@N07,1443,7,1305520461,1305520579,3,8,118
35378947@N07,1443,12,1305520579,1305522079,6,8,1500
35378947@N07,1443,1,1305524346,1305524436,10,8,90
35378947@N07,1443,2,1305530751,1305531141,2,8,390
35378947@N07,1443,8,1305545369,1305546509,2,8,1140
35378947@N07,1443,12,1305551774,1305553274,5,8,1500
35378947@N07,1444,13,1305767664,1305767782,2,4,118
35378947@N07,1444,1,1305767782,1305767872,2,4,90
35378947@N07,1444,13,1305770326,1305772126,2,4,1800
35378947@N07,1444,1,1305772415,1305772505,2,4,90
35378947@N07,1445,8,1328405757,1328406897,24,1,1140
35378947@N07,1446,8,1328575780,1328576920,12,1,1140
35378947@N07,1447,8,1411685276,1411686416,2,1,1140
35380796@N03,1448,7,1230728400,1230728400,2,3,0
35380796@N03,1448,10,1230728400,1230728400,2,3,0
35380796@N03,1448,11,1230728400,1230729900,1,3,1500
35380796@N03,1449,8,1292369553,1292370693,4,7,1140
35380796@N03,1449,5,1292372317,1292373217,3,7,900
35380796@N03,1449,8,1292374844,1292375440,2,7,596
35380796@N03,1449,6,1292375440,1292376460,9,7,1020
35380796@N03,1449,5,1292398076,1292398976,3,7,900
35380796@N03,1449,7,1292399693,1292400407,2,7,714
35380796@N03,1449,6,1292400407,1292401427,9,7,1020
35380796@N03,1450,11,1318627816,1318629316,7,8,1500
35380796@N03,1450,4,1318631625,1318632525,2,8,900
35380796@N03,1450,6,1318632953,1318633973,7,8,1020
35380796@N03,1450,8,1318638535,1318639675,3,8,1140
35380796@N03,1450,4,1318640617,1318641517,3,8,900
35380796@N03,1450,8,1318641974,1318643114,4,8,1140
35380796@N03,1450,1,1318644306,1318644396,3,8,90
35380796@N03,1450,8,1318646599,1318647739,3,8,1140
35380796@N03,1451,4,1318750689,1318751589,2,3,900
35380796@N03,1451,6,1318751800,1318752820,3,3,1020
35380796@N03,1451,5,1318753531,1318754431,5,3,900
35473328@N00,1452,1,1272155097,1272155187,2,2,90
35473328@N00,1452,8,1272159860,1272161000,1,2,1140
35498711@N04,1453,8,1346189463,1346190603,2,3,1140
35498711@N04,1453,13,1346204146,1346205946,2,3,1800
35498711@N04,1453,1,1346217456,1346217546,3,3,90
35498711@N04,1454,6,1346562462,1346563482,2,1,1020
35570988@N08,1455,2,1344548547,1344548937,1,1,390
35602564@N00,1456,8,1299196341,1299197481,86,1,1140
35617346@N02,1457,5,1375508464,1375509364,1,1,900
35617346@N02,1458,5,1404134991,1404135891,1,1,900
35657441@N02,1459,8,1418528121,1418529261,2,2,1140
35657441@N02,1459,9,1418546799,1418548299,1,2,1500
35736481@N00,1460,10,1258605708,1258607208,3,1,1500
35736481@N00,1461,10,1258670876,1258672376,1,1,1500
35736481@N00,1462,10,1296350385,1296350716,2,7,331
35736481@N00,1462,1,1296350716,1296350806,2,7,90
35736481@N00,1462,12,1296352070,1296353570,8,7,1500
35736481@N00,1462,6,1296358568,1296359588,7,7,1020
35736481@N00,1462,4,1296366436,1296367336,2,7,900
35736481@N00,1462,1,1296367497,1296367587,5,7,90
35736481@N00,1462,5,1296375672,1296376572,1,7,900
35736481@N00,1463,5,1335755597,1335756497,3,1,900
35758162@N00,1464,12,1194768104,1194768169,2,2,65
35758162@N00,1464,1,1194768169,1194768259,1,2,90
35816811@N04,1465,6,1379899659,1379900679,1,1,1020
35816811@N04,1466,6,1388909212,1388910232,1,1,1020
35850424@N05,1467,5,1278811613,1278812513,1,1,900
35853462@N00,1468,2,1283822884,1283823274,3,4,390
35853462@N00,1468,6,1283825907,1283826927,4,4,1020
35853462@N00,1468,4,1283828758,1283829658,5,4,900
35853462@N00,1468,12,1283840701,1283842201,4,4,1500
35853462@N00,1469,1,1284020927,1284021017,1,1,90
35853462@N00,1470,1,1284089635,1284089725,1,1,90
35853462@N00,1471,5,1388964300,1388965200,2,3,900
35853462@N00,1471,4,1388967112,1388968012,5,3,900
35853462@N00,1471,5,1388970464,1388971364,2,3,900
35853462@N00,1472,1,1389228893,1389228983,3,5,90
35853462@N00,1472,12,1389236628,1389238128,3,5,1500
35853462@N00,1472,1,1389248229,1389248319,2,5,90
35853462@N00,1472,5,1389251320,1389252220,5,5,900
35853462@N00,1472,9,1389252615,1389254115,11,5,1500
35872939@N00,1473,4,1233698770,1233699670,2,6,900
35872939@N00,1473,7,1233702222,1233703242,5,6,1020
35872939@N00,1473,6,1233713500,1233714520,3,6,1020
35872939@N00,1473,8,1233717602,1233718742,9,6,1140
35872939@N00,1473,7,1233719334,1233720354,2,6,1020
35872939@N00,1473,6,1233723277,1233724297,1,6,1020
35872939@N00,1474,1,1233877747,1233877837,2,7,90
35872939@N00,1474,7,1233879353,1233880373,6,7,1020
35872939@N00,1474,10,1233883473,1233884973,5,7,1500
35872939@N00,1474,11,1233891348,1233892848,4,7,1500
35872939@N00,1474,12,1233895562,1233897062,7,7,1500
35872939@N00,1474,8,1233902439,1233903579,2,7,1140
35872939@N00,1474,1,1233907740,1233907830,1,7,90
35872939@N00,1475,8,1267314203,1267315343,6,11,1140
35872939@N00,1475,7,1267319510,1267320524,2,11,1014
35872939@N00,1475,12,1267320524,1267322024,2,11,1500
35872939@N00,1475,7,1267325178,1267326198,5,11,1020
35872939@N00,1475,8,1267326741,1267327399,4,11,658
35872939@N00,1475,6,1267327399,1267328419,2,11,1020
35872939@N00,1475,8,1267329656,1267330796,11,11,1140
35872939@N00,1475,3,1267335195,1267335615,2,11,420
35872939@N00,1475,9,1267344644,1267346144,10,11,1500
35872939@N00,1475,8,1267347282,1267347662,2,11,380
35872939@N00,1475,11,1267347662,1267349162,1,11,1500
35888901@N00,1476,8,1325062189,1325063329,2,3,1140
35888901@N00,1476,1,1325068779,1325068869,2,3,90
35888901@N00,1476,5,1325072444,1325073344,1,3,900
35897523@N04,1477,5,1283998083,1283998983,1,1,900
35909485@N03,1478,1,1217719880,1217719970,3,1,90
35928519@N00,1479,6,1322971706,1322972726,1,1,1020
35928519@N00,1480,4,1323126283,1323127183,2,2,900
35928519@N00,1480,6,1323134664,1323135684,1,2,1020
35928519@N00,1481,12,1323381367,1323382867,2,2,1500
35928519@N00,1481,5,1323383431,1323384331,1,2,900
35928519@N00,1482,6,1386024788,1386025808,1,1,1020
35928519@N00,1483,12,1386287764,1386289264,2,2,1500
35928519@N00,1483,5,1386290400,1386291300,1,2,900
36101699447@N01,1484,6,1357087178,1357088198,2,1,1020
36101699447@N01,1485,5,1357127014,1357127914,1,1,900
36101699901@N01,1486,1,1224926658,1224926748,1,1,90
36101699901@N01,1487,1,1260930786,1260930876,1,1,90
36226805@N03,1488,1,1222390592,1222390682,2,3,90
36226805@N03,1488,8,1222402820,1222403960,2,3,1140
36226805@N03,1488,7,1222412884,1222413904,1,3,1020
36226805@N03,1489,1,1238853210,1238853300,1,1,90
36226805@N03,1490,1,1240751967,1240752057,1,1,90
36226805@N03,1491,5,1246373131,1246374031,1,1,900
36226805@N03,1492,2,1253679812,1253680202,2,6,390
36226805@N03,1492,5,1253681440,1253682340,2,6,900
36226805@N03,1492,11,1253684754,1253685077,2,6,323
36226805@N03,1492,12,1253685077,1253685338,2,6,261
36226805@N03,1492,7,1253685338,1253685375,2,6,37
36226805@N03,1492,11,1253685375,1253686875,1,6,1500
36226805@N03,1493,5,1284962366,1284963266,2,1,900
36226805@N03,1494,2,1316490419,1316490809,4,15,390
36226805@N03,1494,12,1316498263,1316499006,2,15,743
36226805@N03,1494,7,1316499006,1316499813,9,15,807
36226805@N03,1494,1,1316499813,1316499864,2,15,51
36226805@N03,1494,7,1316499864,1316500361,2,15,497
36226805@N03,1494,2,1316500361,1316500751,3,15,390
36226805@N03,1494,3,1316502460,1316502880,3,15,420
36226805@N03,1494,10,1316503559,1316503681,2,15,122
36226805@N03,1494,5,1316503681,1316503711,2,15,30
36226805@N03,1494,1,1316503711,1316503790,3,15,79
36226805@N03,1494,10,1316503790,1316504265,6,15,475
36226805@N03,1494,5,1316504265,1316505165,10,15,900
36226805@N03,1494,1,1316506564,1316506587,2,15,23
36226805@N03,1494,10,1316506587,1316507655,2,15,1068
36226805@N03,1494,5,1316507655,1316508555,1,15,900
36226805@N03,1495,12,1347506045,1347506557,2,20,512
36226805@N03,1495,8,1347506557,1347506581,2,20,24
36226805@N03,1495,12,1347506581,1347506598,2,20,17
36226805@N03,1495,1,1347506598,1347506645,2,20,47
36226805@N03,1495,12,1347506645,1347506854,2,20,209
36226805@N03,1495,7,1347506854,1347507485,2,20,631
36226805@N03,1495,11,1347507485,1347507652,2,20,167
36226805@N03,1495,7,1347507652,1347508672,2,20,1020
36226805@N03,1495,10,1347513353,1347514853,2,20,1500
36226805@N03,1495,5,1347514898,1347515101,3,20,203
36226805@N03,1495,1,1347515101,1347515138,2,20,37
36226805@N03,1495,5,1347515138,1347515748,8,20,610
36226805@N03,1495,10,1347515748,1347517248,2,20,1500
36226805@N03,1495,2,1347517512,1347517902,2,20,390
36226805@N03,1495,11,1347521574,1347522366,2,20,792
36226805@N03,1495,2,1347522366,1347522756,8,20,390
36226805@N03,1495,5,1347523385,1347523776,2,20,391
36226805@N03,1495,12,1347523776,1347523805,2,20,29
36226805@N03,1495,1,1347523805,1347523894,2,20,89
36226805@N03,1495,13,1347523894,1347525694,1,20,1800
36226805@N03,1496,2,1378966616,1378967006,4,1,390
36258343@N03,1497,9,1361172756,1361174256,1,1,1500
36335057@N00,1498,13,1392940443,1392942243,1,1,1800
36399194@N03,1499,10,1389333988,1389335488,1,1,1500
36450627@N08,1500,1,1243405088,1243405178,1,1,90
36521978259@N01,1501,5,1304324483,1304325383,1,1,900
36606366@N00,1502,8,1379998766,1379999906,2,5,1140
36606366@N00,1502,5,1380006134,1380007034,2,5,900
36606366@N00,1502,6,1380010909,1380011488,2,5,579
36606366@N00,1502,4,1380011488,1380012388,2,5,900
36606366@N00,1502,1,1380013969,1380014059,1,5,90
36606366@N00,1503,11,1380069860,1380071360,2,4,1500
36606366@N00,1503,7,1380080874,1380081894,2,4,1020
36606366@N00,1503,1,1380084421,1380084511,2,4,90
36606366@N00,1503,8,1380099063,1380100203,1,4,1140
36606366@N00,1504,5,1380315019,1380315919,1,1,900
36607954@N05,1505,1,1246965982,1246966072,2,3,90
36607954@N05,1505,5,1246966882,1246967782,4,3,900
36607954@N05,1505,8,1246970520,1246971660,1,3,1140
36671802@N04,1506,8,1364257024,1364258164,50,1,1140
36671802@N04,1507,8,1425790620,1425791760,9,1,1140
36694655@N08,1508,8,1402271776,1402272916,3,3,1140
36694655@N08,1508,2,1402275669,1402276059,2,3,390
36694655@N08,1508,8,1402282820,1402283960,1,3,1140
36702908@N05,1509,6,1422152592,1422153612,8,8,1020
36702908@N05,1509,2,1422157035,1422157425,3,8,390
36702908@N05,1509,6,1422157633,1422157645,2,8,12
36702908@N05,1509,2,1422157645,1422157679,2,8,34
36702908@N05,1509,8,1422157679,1422158819,2,8,1140
36702908@N05,1509,6,1422158966,1422159986,9,8,1020
36702908@N05,1509,10,1422174247,1422175747,2,8,1500
36702908@N05,1509,9,1422179729,1422181229,2,8,1500
36702908@N05,1510,1,1422236546,1422236636,2,2,90
36702908@N05,1510,5,1422248968,1422249868,5,2,900
36735086@N07,1511,6,1252199973,1252200993,2,2,1020
36735086@N07,1511,4,1252204318,1252205218,1,2,900
36801190@N00,1512,5,1357257078,1357257212,2,2,134
36801190@N00,1512,6,1357257212,1357258232,1,2,1020
36895960@N00,1513,5,1423110607,1423111507,1,1,900
36911028@N00,1514,8,1332138001,1332139141,2,2,1140
36911028@N00,1514,4,1332141661,1332142561,1,2,900
36911028@N00,1515,5,1332453587,1332454487,1,1,900
36916766@N08,1516,2,1261445946,1261446336,2,4,390
36916766@N08,1516,11,1261464182,1261464667,2,4,485
36916766@N08,1516,8,1261464667,1261465807,2,4,1140
36916766@N08,1516,6,1261467110,1261468130,2,4,1020
36916766@N08,1517,6,1275879497,1275880517,2,2,1020
36916766@N08,1517,1,1275903633,1275903723,1,2,90
36916766@N08,1518,4,1276329230,1276329240,2,3,10
36916766@N08,1518,6,1276329240,1276329265,2,3,25
36916766@N08,1518,2,1276329265,1276329655,3,3,390
37046031@N00,1519,4,1225870173,1225870693,2,3,520
37046031@N00,1519,5,1225870693,1225871593,2,3,900
37046031@N00,1519,8,1225876032,1225877172,1,3,1140
37046031@N00,1520,5,1226149200,1226150100,1,1,900
37046031@N00,1521,5,1226196927,1226197827,1,1,900
37046031@N00,1522,3,1226358429,1226358849,4,2,420
37046031@N00,1522,8,1226360300,1226361440,1,2,1140
37046031@N00,1523,4,1226667600,1226668500,1,1,900
37088822@N00,1524,5,1237085732,1237086632,10,4,900
37088822@N00,1524,4,1237088733,1237089633,16,4,900
37088822@N00,1524,13,1237090785,1237092585,33,4,1800
37088822@N00,1524,2,1237101162,1237101552,17,4,390
37088822@N00,1525,2,1237417269,1237417659,19,2,390
37088822@N00,1525,1,1237425807,1237425897,16,2,90
37097738@N02,1526,8,1450041653,1450042793,4,8,1140
37097738@N02,1526,4,1450042897,1450043797,3,8,900
37097738@N02,1526,8,1450046844,1450047984,14,8,1140
37097738@N02,1526,1,1450049893,1450049983,3,8,90
37097738@N02,1526,5,1450050279,1450051179,2,8,900
37097738@N02,1526,4,1450052972,1450053872,7,8,900
37097738@N02,1526,6,1450059427,1450059900,2,8,473
37097738@N02,1526,13,1450059900,1450061700,48,8,1800
37159320@N00,1527,2,1274494394,1274494784,5,2,390
37159320@N00,1527,10,1274508275,1274509775,1,2,1500
37159320@N00,1528,10,1274572286,1274573032,3,2,746
37159320@N00,1528,2,1274573032,1274573422,5,2,390
37159320@N00,1529,2,1274693293,1274693683,3,2,390
37159320@N00,1529,6,1274696264,1274697284,1,2,1020
37159320@N00,1530,5,1359949697,1359950597,2,5,900
37159320@N00,1530,6,1359952420,1359953440,2,5,1020
37159320@N00,1530,4,1359953992,1359954892,2,5,900
37159320@N00,1530,8,1359958025,1359959165,3,5,1140
37159320@N00,1530,4,1359961555,1359962455,1,5,900
37159320@N00,1531,5,1379307314,1379308214,2,4,900
37159320@N00,1531,8,1379310061,1379311201,2,4,1140
37159320@N00,1531,10,1379312121,1379313621,2,4,1500
37159320@N00,1531,1,1379327036,1379327126,1,4,90
37186095@N08,1532,8,1306016192,1306016600,2,3,408
37186095@N08,1532,11,1306016600,1306018100,2,3,1500
37186095@N08,1532,8,1306032443,1306033583,1,3,1140
37186095@N08,1533,13,1306071846,1306073646,1,1,1800
37186095@N08,1534,5,1317270897,1317271016,2,6,119
37186095@N08,1534,1,1317271016,1317271106,7,6,90
37186095@N08,1534,10,1317276162,1317277662,6,6,1500
37186095@N08,1534,2,1317278384,1317278774,2,6,390
37186095@N08,1534,7,1317295622,1317295697,2,6,75
37186095@N08,1534,1,1317295697,1317295787,1,6,90
37186095@N08,1535,5,1330567841,1330568741,2,2,900
37186095@N08,1535,8,1330579772,1330580912,3,2,1140
37206648@N00,1536,5,1242860421,1242861321,3,2,900
37206648@N00,1536,8,1242882086,1242883226,1,2,1140
37216383@N05,1537,5,1336208002,1336208902,1,1,900
37216383@N05,1538,8,1337422801,1337423941,3,1,1140
37216383@N05,1539,6,1352877758,1352878778,1,1,1020
37216383@N05,1540,5,1358903512,1358904412,1,1,900
37274056@N05,1541,13,1295574366,1295576166,6,4,1800
37274056@N05,1541,8,1295578424,1295578926,2,4,502
37274056@N05,1541,4,1295578926,1295579826,3,4,900
37274056@N05,1541,2,1295580006,1295580396,11,4,390
37276158@N05,1542,8,1305291933,1305293073,1,1,1140
37287420@N08,1543,4,1357351740,1357352640,3,4,900
37287420@N08,1543,6,1357369260,1357369932,3,4,672
37287420@N08,1543,4,1357369932,1357369947,2,4,15
37287420@N08,1543,6,1357369947,1357370967,2,4,1020
37460376@N08,1544,11,1381279817,1381281317,1,1,1500
37504803@N00,1545,6,1198841226,1198842246,5,1,1020
37515566@N00,1546,7,1358228968,1358229988,3,1,1020
37541950@N08,1547,1,1286059856,1286059946,2,1,90
37541950@N08,1548,7,1286173131,1286174151,2,1,1020
37553034@N03,1549,1,1317183825,1317183915,3,2,90
37553034@N03,1549,9,1317196673,1317198173,1,2,1500
37553034@N03,1550,5,1322785184,1322786084,1,1,900
37561427@N04,1551,7,1345346878,1345347898,4,8,1020
37561427@N04,1551,8,1345354224,1345355364,2,8,1140
37561427@N04,1551,7,1345360968,1345361988,3,8,1020
37561427@N04,1551,12,1345365954,1345366300,2,8,346
37561427@N04,1551,5,1345366300,1345366458,2,8,158
37561427@N04,1551,12,1345366458,1345366565,2,8,107
37561427@N04,1551,1,1345366565,1345366608,2,8,43
37561427@N04,1551,12,1345366608,1345368108,1,8,1500
37572076@N08,1552,10,1329539096,1329540244,2,4,1148
37572076@N08,1552,4,1329540244,1329540668,2,4,424
37572076@N08,1552,10,1329540668,1329542168,2,4,1500
37572076@N08,1552,5,1329545717,1329546617,1,4,900
37572297@N00,1553,1,1211205600,1211205601,2,16,1
37572297@N00,1553,8,1211205601,1211205604,2,16,3
37572297@N00,1553,10,1211205604,1211205605,2,16,1
37572297@N00,1553,5,1211205605,1211205610,2,16,5
37572297@N00,1553,1,1211205610,1211205615,6,16,5
37572297@N00,1553,13,1211205615,1211205616,2,16,1
37572297@N00,1553,1,1211205616,1211205619,2,16,3
37572297@N00,1553,8,1211205619,1211205620,2,16,1
37572297@N00,1553,6,1211205620,1211205623,3,16,3
37572297@N00,1553,13,1211205623,1211205625,2,16,2
37572297@N00,1553,6,1211205625,1211205626,2,16,1
37572297@N00,1553,13,1211205626,1211205634,9,16,8
37572297@N00,1553,12,1211205634,1211205635,2,16,1
37572297@N00,1553,7,1211205635,1211205636,2,16,1
37572297@N00,1553,4,1211205636,1211205640,5,16,4
37572297@N00,1553,5,1211205640,1211206540,1,16,900
37585370@N00,1554,10,1263552019,1263552350,2,2,331
37585370@N00,1554,5,1263552350,1263553250,1,2,900
37595844@N08,1555,8,1286843864,1286844431,2,3,567
37595844@N08,1555,2,1286844431,1286844821,3,3,390
37595844@N08,1555,6,1286846082,1286847102,1,3,1020
37620552@N06,1556,8,1325939264,1325940404,1,1,1140
37620552@N06,1557,7,1367497638,1367498658,1,1,1020
37620552@N06,1558,2,1367567931,1367568321,1,1,390
37657436@N04,1559,6,1262264550,1262265570,2,4,1020
37657436@N04,1559,13,1262272375,1262273716,3,4,1341
37657436@N04,1559,6,1262273716,1262274736,2,4,1020
37657436@N04,1559,10,1262275408,1262276908,1,4,1500
37709784@N00,1560,2,1239264940,1239264951,2,2,11
37709784@N00,1560,4,1239264951,1239265851,2,2,900
37714481@N00,1561,8,1189721954,1189723094,32,1,1140
37718677660@N01,1562,1,1290424142,1290424232,1,1,90
37729827@N05,1563,6,1337468672,1337469692,4,3,1020
37729827@N05,1563,4,1337470515,1337471415,16,3,900
37729827@N05,1563,13,1337482397,1337484197,1,3,1800
37729827@N05,1564,2,1337643135,1337643525,5,3,390
37729827@N05,1564,1,1337646294,1337646384,2,3,90
37729827@N05,1564,13,1337652852,1337654652,3,3,1800
37729827@N05,1565,2,1337986374,1337986764,1,1,390
37747991@N02,1566,1,1240622218,1240622308,2,5,90
37747991@N02,1566,11,1240625634,1240627134,2,5,1500
37747991@N02,1566,8,1240629173,1240630313,3,5,1140
37747991@N02,1566,4,1240634152,1240635052,4,5,900
37747991@N02,1566,13,1240636989,1240638789,3,5,1800
37775700@N02,1567,1,1303930684,1303930774,2,3,90
37775700@N02,1567,8,1303931369,1303932509,2,3,1140
37775700@N02,1567,13,1303935007,1303936807,1,3,1800
37775700@N02,1568,5,1304186556,1304187456,2,3,900
37775700@N02,1568,2,1304191621,1304192011,2,3,390
37775700@N02,1568,11,1304192316,1304193816,1,3,1500
37869753@N06,1569,1,1313009986,1313010076,5,6,90
37869753@N06,1569,5,1313011696,1313012596,2,6,900
37869753@N06,1569,1,1313013826,1313013916,2,6,90
37869753@N06,1569,2,1313017455,1313017845,2,6,390
37869753@N06,1569,8,1313032671,1313033811,2,6,1140
37869753@N06,1569,1,1313044378,1313044468,1,6,90
37869753@N06,1570,11,1376516187,1376517687,2,2,1500
37869753@N06,1570,4,1376523158,1376524058,2,2,900
37869753@N06,1571,7,1377039451,1377040471,2,1,1020
37919954@N07,1572,8,1463752409,1463753549,1,1,1140
37996603748@N01,1573,8,1418259561,1418260701,2,1,1140
37996603748@N01,1574,1,1418336873,1418336963,3,3,90
37996603748@N01,1574,12,1418340997,1418342497,2,3,1500
37996603748@N01,1574,1,1418342694,1418342784,2,3,90
37996654902@N01,1575,5,1355657698,1355658598,1,1,900
37996654902@N01,1576,4,1355884748,1355885648,3,4,900
37996654902@N01,1576,13,1355897374,1355897395,2,4,21
37996654902@N01,1576,4,1355897395,1355897766,3,4,371
37996654902@N01,1576,13,1355897766,1355899566,1,4,1800
38022350@N04,1577,1,1241851635,1241851725,1,1,90
38053290@N08,1578,8,1198132424,1198133564,74,1,1140
38053290@N08,1579,8,1275289007,1275290147,27,1,1140
38067879@N08,1580,5,1323399677,1323400577,2,3,900
38067879@N08,1580,9,1323405220,1323406720,2,3,1500
38067879@N08,1580,5,1323408072,1323408972,1,3,900
38067879@N08,1581,2,1348480915,1348481305,2,1,390
38067879@N08,1582,9,1348538166,1348539666,1,1,1500
38067879@N08,1583,4,1348792201,1348793101,2,3,900
38067879@N08,1583,6,1348797569,1348798589,3,3,1020
38067879@N08,1583,10,1348804024,1348805524,1,3,1500
38067879@N08,1584,4,1349724932,1349725832,1,1,900
38067879@N08,1585,5,1368740497,1368741397,3,1,900
38067879@N08,1586,2,1412045911,1412046301,1,1,390
38067879@N08,1587,6,1449296172,1449297192,1,1,1020
38084526@N06,1588,5,1229556396,1229557296,1,1,900
38084526@N06,1589,6,1229592326,1229593346,1,1,1020
38084526@N06,1590,5,1240480219,1240481119,1,1,900
38084526@N06,1591,1,1284886195,1284886285,1,1,90
38084526@N06,1592,4,1285366087,1285366987,2,1,900
38084526@N06,1593,11,1315448439,1315449939,1,1,1500
38088964@N00,1594,13,1330654465,1330656265,1,1,1800
38088964@N00,1595,6,1330739046,1330740066,1,1,1020
38090510@N06,1596,11,1246879454,1246880954,1,1,1500
38102706@N05,1597,1,1256366660,1256366750,6,2,90
38102706@N05,1597,8,1256366751,1256367891,3,2,1140
38102706@N05,1598,8,1258868492,1258869122,2,2,630
38102706@N05,1598,11,1258869122,1258870622,2,2,1500
38102706@N05,1599,1,1262239145,1262239235,5,2,90
38102706@N05,1599,2,1262240583,1262240973,4,2,390
38102706@N05,1600,5,1263799086,1263799986,1,1,900
38102706@N05,1601,1,1264385555,1264385645,2,8,90
38102706@N05,1601,2,1264386223,1264386613,15,8,390
38102706@N05,1601,7,1264391734,1264392754,2,8,1020
38102706@N05,1601,2,1264392952,1264393342,2,8,390
38102706@N05,1601,7,1264400527,1264401547,6,8,1020
38102706@N05,1601,2,1264406025,1264406415,16,8,390
38102706@N05,1601,8,1264415585,1264415959,2,8,374
38102706@N05,1601,7,1264415959,1264416979,1,8,1020
38102706@N05,1602,1,1277528560,1277528650,33,1,90
38102706@N05,1603,10,1286936437,1286937861,2,2,1424
38102706@N05,1603,6,1286937861,1286938881,1,2,1020
38102706@N05,1604,13,1348542575,1348544375,1,1,1800
38102706@N05,1605,6,1384153944,1384154964,2,1,1020
38102706@N05,1606,12,1389145349,1389146849,1,1,1500
38102706@N05,1607,5,1402567139,1402568039,1,1,900
38117199@N07,1608,8,1253687344,1253688484,3,1,1140
38145706@N05,1609,1,1384865640,1384865730,2,1,90
38145706@N05,1610,6,1384897889,1384898909,1,1,1020
38153332@N00,1611,8,1372746963,1372747292,2,2,329
38153332@N00,1611,4,1372747292,1372748192,1,2,900
38155459@N05,1612,12,1400312637,1400314137,1,1,1500
38189526@N02,1613,2,1240927200,1240927202,3,2,2
38189526@N02,1613,8,1240927202,1240928342,1,2,1140
38194020@N00,1614,10,1220040384,1220041884,3,1,1500
38194020@N00,1615,2,1220270061,1220270451,9,2,390
38194020@N00,1615,8,1220272170,1220273310,2,2,1140
38235069@N00,1616,1,1451531284,1451531374,3,10,90
38235069@N00,1616,12,1451531789,1451533289,10,10,1500
38235069@N00,1616,8,1451535004,1451535368,7,10,364
38235069@N00,1616,1,1451535368,1451535458,2,10,90
38235069@N00,1616,6,1451535694,1451536714,3,10,1020
38235069@N00,1616,5,1451537905,1451538805,2,10,900
38235069@N00,1616,10,1451539396,1451540896,4,10,1500
38235069@N00,1616,1,1451546105,1451546195,18,10,90
38235069@N00,1616,13,1451554836,1451556636,8,10,1800
38235069@N00,1616,6,1451560485,1451561505,4,10,1020
38235069@N00,1617,6,1451617262,1451618282,28,4,1020
38235069@N00,1617,7,1451622430,1451623450,2,4,1020
38235069@N00,1617,8,1451624389,1451625529,2,4,1140
38235069@N00,1617,9,1451634627,1451636127,6,4,1500
38235069@N00,1618,8,1451790980,1451792120,1,1,1140
38251487@N03,1619,6,1388473256,1388474276,1,1,1020
38323338@N02,1620,1,1274771697,1274771787,1,1,90
38359273@N00,1621,7,1220607029,1220608049,15,1,1020
38359273@N00,1622,7,1252744999,1252746019,15,1,1020
38359273@N00,1623,7,1299295993,1299297013,50,1,1020
38359273@N00,1624,7,1306031989,1306033009,20,1,1020
38359273@N00,1625,7,1307745964,1307746984,60,1,1020
38359273@N00,1626,7,1324368483,1324369503,14,1,1020
38359273@N00,1627,7,1337568745,1337569765,38,1,1020
38359273@N00,1628,7,1339203138,1339204158,47,1,1020
38359273@N00,1629,7,1353128793,1353129813,42,1,1020
38359273@N00,1630,7,1369530018,1369531038,22,1,1020
38359273@N00,1631,7,1370731100,1370732120,37,1,1020
38359273@N00,1632,7,1385252463,1385253483,12,1,1020
38359273@N00,1633,7,1386466653,1386467673,40,1,1020
38359273@N00,1634,7,1396769968,1396770988,10,1,1020
38359273@N00,1635,7,1400364723,1400365743,40,1,1020
38359273@N00,1636,7,1400983548,1400984568,24,1,1020
38359273@N00,1637,7,1402187704,1402188724,46,1,1020
38359273@N00,1638,7,1402627807,1402628827,31,1,1020
38359273@N00,1639,7,1408400976,1408401996,23,1,1020
38359273@N00,1640,7,1417591485,1417592505,12,1,1020
38359273@N00,1641,7,1431663514,1431664534,21,1,1020
38359273@N00,1642,7,1432334987,1432336007,30,1,1020
38359273@N00,1643,7,1433476019,1433477039,18,1,1020
38359273@N00,1644,7,1434061300,1434062320,32,1,1020
38359273@N00,1645,7,1450158986,1450160006,30,1,1020
38359273@N00,1646,7,1459400571,1459401591,13,1,1020
38492497@N02,1647,1,1344837783,1344837873,2,2,90
38492497@N02,1647,7,1344841027,1344842047,1,2,1020
38519746@N04,1648,4,1197011491,1197012391,1,1,900
38604142@N08,1649,2,1317769485,1317769875,2,2,390
38604142@N08,1649,8,1317789354,1317790494,4,2,1140
38642555@N06,1650,8,1238376161,1238377301,372,1,1140
38773853@N06,1651,2,1342459418,1342459808,1,1,390
38789043@N02,1652,6,1368840216,1368841236,2,2,1020
38789043@N02,1652,10,1368848294,1368849794,1,2,1500
38794272@N04,1653,10,1321097066,1321098566,11,1,1500
38794272@N04,1654,6,1321205127,1321206147,88,1,1020
38848642@N00,1655,1,1218085341,1218085431,2,1,90
38848642@N00,1656,1,1218611411,1218611501,1,1,90
38848642@N00,1657,1,1255924313,1255924403,3,1,90
38848642@N00,1658,6,1275731618,1275732638,1,1,1020
38848642@N00,1659,6,1408674137,1408675157,2,1,1020
38855106@N04,1660,4,1437883107,1437884007,2,2,900
38855106@N04,1660,5,1437887241,1437888141,1,2,900
38879474@N04,1661,13,1360309632,1360309997,2,2,365
38879474@N04,1661,4,1360309997,1360310897,1,2,900
38879474@N04,1662,8,1361396852,1361397992,1,1,1140
38879474@N04,1663,10,1363125714,1363127214,1,1,1500
38879474@N04,1664,13,1381953017,1381954817,1,1,1800
38937312@N00,1665,10,1449892608,1449894108,1,1,1500
39146060@N00,1666,13,1190678550,1190680350,5,5,1800
39146060@N00,1666,1,1190704740,1190704830,2,5,90
39146060@N00,1666,5,1190704844,1190705022,2,5,178
39146060@N00,1666,1,1190705022,1190705112,4,5,90
39146060@N00,1666,8,1190705196,1190706336,3,5,1140
39146060@N00,1667,1,1190927452,1190927542,2,6,90
39146060@N00,1667,5,1190927864,1190928764,3,6,900
39146060@N00,1667,12,1190931866,1190931994,3,6,128
39146060@N00,1667,1,1190931994,1190932084,2,6,90
39146060@N00,1667,8,1190932122,1190933262,2,6,1140
39146060@N00,1667,5,1190935174,1190936074,4,6,900
39146060@N00,1668,7,1228918482,1228919303,2,6,821
39146060@N00,1668,8,1228919303,1228920443,3,6,1140
39146060@N00,1668,4,1228921069,1228921969,2,6,900
39146060@N00,1668,5,1228925477,1228925540,2,6,63
39146060@N00,1668,1,1228925540,1228925630,2,6,90
39146060@N00,1668,5,1228925668,1228926568,1,6,900
39146060@N00,1669,6,1229201485,1229202505,2,4,1020
39146060@N00,1669,8,1229203611,1229204217,3,4,606
39146060@N00,1669,1,1229204217,1229204307,2,4,90
39146060@N00,1669,5,1229205679,1229206579,1,4,900
39149225@N08,1670,10,1418678885,1418680385,3,8,1500
39149225@N08,1670,8,1418680470,1418681610,2,8,1140
39149225@N08,1670,5,1418681765,1418682665,3,8,900
39149225@N08,1670,12,1418689278,1418690778,4,8,1500
39149225@N08,1670,4,1418694450,1418695350,3,8,900
39149225@N08,1670,8,1418697185,1418698325,2,8,1140
39149225@N08,1670,5,1418700121,1418701021,2,8,900
39149225@N08,1670,10,1418707398,1418708898,1,8,1500
39179826@N04,1671,7,1255217677,1255218697,2,2,1020
39179826@N04,1671,1,1255229670,1255229760,1,2,90
39179826@N04,1672,1,1265155143,1265155233,1,1,90
39179826@N04,1673,8,1350675221,1350676361,1,1,1140
39198272@N04,1674,11,1369100794,1369102294,1,1,1500
39198272@N04,1675,13,1400276555,1400278355,4,5,1800
39198272@N04,1675,2,1400279878,1400279998,2,5,120
39198272@N04,1675,6,1400279998,1400281018,4,5,1020
39198272@N04,1675,4,1400283850,1400284750,6,5,900
39198272@N04,1675,1,1400290497,1400290587,52,5,90
39276962@N07,1676,1,1259387346,1259387436,24,1,90
39279716@N00,1677,1,1215783489,1215783579,1,1,90
39360988@N05,1678,2,1300400208,1300400598,1,1,390
39403274@N00,1679,5,1255779998,1255780898,1,1,900
39414936@N05,1680,8,1267137983,1267139123,1,1,1140
39444366@N06,1681,11,1241266474,1241267974,1,1,1500
39444366@N06,1682,11,1271060660,1271062160,1,1,1500
39707801@N00,1683,4,1195353015,1195353915,5,1,900
39747657@N08,1684,5,1362174571,1362175471,1,1,900
39784714@N03,1685,4,1422150353,1422151253,1,1,900
39864275@N02,1686,6,1417681084,1417682104,5,1,1020
39893757@N00,1687,5,1314956749,1314957649,1,1,900
39909510@N07,1688,7,1232842639,1232842668,5,2,29
39909510@N07,1688,12,1232842668,1232844168,4,2,1500
39925495@N00,1689,6,1327973574,1327974594,2,2,1020
39925495@N00,1689,5,1327987732,1327988632,1,2,900
39925495@N00,1690,4,1356958800,1356958800,3,2,0
39925495@N00,1690,5,1356958800,1356959700,1,2,900
39926012@N04,1691,5,1313889755,1313890655,1,1,900
39939148@N00,1692,4,1306226315,1306227215,1,1,900
39953677@N06,1693,2,1348283777,1348284167,2,2,390
39953677@N06,1693,6,1348295797,1348296817,1,2,1020
40021579@N00,1694,6,1375765859,1375766879,1,1,1020
40041746@N00,1695,9,1381912349,1381913849,55,1,1500
40170821@N06,1696,1,1345765421,1345765511,2,2,90
40170821@N06,1696,4,1345774133,1345775033,1,2,900
40262057@N06,1697,10,1236560921,1236561439,2,4,518
40262057@N06,1697,5,1236561439,1236562339,7,4,900
40262057@N06,1697,8,1236565950,1236567090,4,4,1140
40262057@N06,1697,13,1236567872,1236569672,24,4,1800
40262057@N06,1698,8,1236992423,1236993563,3,5,1140
40262057@N06,1698,5,1237000949,1237001849,10,5,900
40262057@N06,1698,2,1237004542,1237004932,9,5,390
40262057@N06,1698,7,1237005021,1237005112,2,5,91
40262057@N06,1698,12,1237005112,1237006612,1,5,1500
40262057@N06,1699,10,1354857074,1354857175,2,5,101
40262057@N06,1699,5,1354857175,1354858075,6,5,900
40262057@N06,1699,4,1354858944,1354859844,7,5,900
40262057@N06,1699,5,1354863898,1354864563,4,5,665
40262057@N06,1699,6,1354864563,1354865583,6,5,1020
40291653@N08,1700,8,1318750190,1318751330,1,1,1140
40303166@N06,1701,13,1288220484,1288222284,1,1,1800
40303166@N06,1702,10,1288983905,1288985405,2,10,1500
40303166@N06,1702,4,1288987443,1288987794,2,10,351
40303166@N06,1702,8,1288987794,1288988934,2,10,1140
40303166@N06,1702,7,1288990963,1288991983,2,10,1020
40303166@N06,1702,12,1288995454,1288996954,4,10,1500
40303166@N06,1702,7,1288998084,1288998201,2,10,117
40303166@N06,1702,1,1288998201,1288998291,2,10,90
40303166@N06,1702,5,1288998403,1288999303,2,10,900
40303166@N06,1702,7,1288999410,1289000430,2,10,1020
40303166@N06,1702,10,1289000488,1289001988,1,10,1500
40303166@N06,1703,10,1289108864,1289110364,2,8,1500
40303166@N06,1703,5,1289114425,1289115325,4,8,900
40303166@N06,1703,7,1289115812,1289116013,2,8,201
40303166@N06,1703,12,1289116013,1289116153,3,8,140
40303166@N06,1703,7,1289116153,1289116354,2,8,201
40303166@N06,1703,8,1289116354,1289117494,3,8,1140
40303166@N06,1703,1,1289117681,1289117771,2,8,90
40303166@N06,1703,10,1289118255,1289119755,1,8,1500
40303166@N06,1704,4,1289284537,1289284559,2,3,22
40303166@N06,1704,6,1289284559,1289285579,16,3,1020
40303166@N06,1704,12,1289289106,1289290606,1,3,1500
40379233@N00,1705,8,1278135633,1278136773,1,1,1140
40472186@N08,1706,11,1261540846,1261542346,2,1,1500
40563308@N02,1707,2,1250368404,1250368794,2,4,390
40563308@N02,1707,6,1250370765,1250371785,2,4,1020
40563308@N02,1707,2,1250378032,1250378422,2,4,390
40563308@N02,1707,13,1250400083,1250401883,5,4,1800
40563308@N02,1708,1,1312924745,1312924835,2,2,90
40563308@N02,1708,13,1312935286,1312937086,2,2,1800
40647915@N03,1709,1,1290638109,1290638199,1,1,90
40745887@N05,1710,1,1284626191,1284626264,2,2,73
40745887@N05,1710,10,1284626264,1284627764,2,2,1500
40788961@N05,1711,10,1304214228,1304215728,2,2,1500
40788961@N05,1711,4,1304219892,1304220792,2,2,900
40897907@N08,1712,5,1354148346,1354149246,2,2,900
40897907@N08,1712,12,1354157141,1354158641,1,2,1500
40897907@N08,1713,5,1354315804,1354316704,1,1,900
40897907@N08,1714,13,1354487106,1354488906,1,1,1800
40901879@N07,1715,8,1207054805,1207055945,14,1,1140
40901879@N07,1716,8,1207116756,1207117896,2,2,1140
40901879@N07,1716,1,1207123945,1207124035,1,2,90
40908775@N04,1717,10,1248789626,1248791126,1,1,1500
40919416@N06,1718,4,1281306445,1281307345,2,3,900
40919416@N06,1718,10,1281334352,1281335852,3,3,1500
40919416@N06,1718,4,1281342874,1281343774,3,3,900
40919416@N06,1719,4,1281777006,1281777906,28,5,900
40919416@N06,1719,13,1281783191,1281784991,77,5,1800
40919416@N06,1719,8,1281786952,1281788092,3,5,1140
40919416@N06,1719,5,1281788431,1281789234,2,5,803
40919416@N06,1719,1,1281789234,1281789324,52,5,90
40919416@N06,1720,4,1310592645,1310593545,12,2,900
40919416@N06,1720,5,1310597812,1310598712,1,2,900
40919416@N06,1721,13,1326586400,1326587963,3,6,1563
40919416@N06,1721,4,1326587963,1326588863,2,6,900
40919416@N06,1721,6,1326589688,1326590708,2,6,1020
40919416@N06,1721,13,1326598760,1326598826,2,6,66
40919416@N06,1721,6,1326598826,1326599846,3,6,1020
40919416@N06,1721,4,1326615958,1326616858,2,6,900
40937461@N02,1722,8,1329223493,1329223635,2,7,142
40937461@N02,1722,11,1329223635,1329224017,2,7,382
40937461@N02,1722,6,1329224017,1329224157,2,7,140
40937461@N02,1722,4,1329224157,1329225057,3,7,900
40937461@N02,1722,5,1329228220,1329229120,2,7,900
40937461@N02,1722,8,1329239972,1329241112,2,7,1140
40937461@N02,1722,1,1329259010,1329259100,1,7,90
40937461@N02,1723,8,1329627058,1329628198,2,3,1140
40937461@N02,1723,6,1329630073,1329631093,2,3,1020
40937461@N02,1723,9,1329639906,1329641406,1,3,1500
40979501@N04,1724,8,1307333695,1307334835,6,1,1140
41117712@N05,1725,7,1361741479,1361742499,2,3,1020
41117712@N05,1725,6,1361752610,1361753630,2,3,1020
41117712@N05,1725,9,1361767544,1361769044,3,3,1500
41126359@N00,1726,9,1283684286,1283685786,2,1,1500
41126359@N00,1727,1,1326967421,1326967511,1,1,90
41126359@N00,1728,12,1360988537,1360990037,1,1,1500
41134616@N00,1729,5,1225320574,1225320854,2,9,280
41134616@N00,1729,1,1225320854,1225320944,2,9,90
41134616@N00,1729,11,1225323330,1225324830,2,9,1500
41134616@N00,1729,13,1225327836,1225327852,2,9,16
41134616@N00,1729,8,1225327852,1225328992,2,9,1140
41134616@N00,1729,10,1225330996,1225332496,2,9,1500
41134616@N00,1729,13,1225339243,1225341043,11,9,1800
41134616@N00,1729,12,1225352590,1225354090,3,9,1500
41134616@N00,1729,9,1225356258,1225357758,1,9,1500
41138825@N00,1730,6,1452914792,1452915812,2,4,1020
41138825@N00,1730,4,1452916749,1452917649,4,4,900
41138825@N00,1730,7,1452917697,1452917778,2,4,81
41138825@N00,1730,12,1452917778,1452919278,1,4,1500
41197583@N00,1731,4,1250290600,1250291500,2,2,900
41197583@N00,1731,5,1250299933,1250300833,1,2,900
41236077@N02,1732,6,1291360329,1291361349,2,1,1020
41236077@N02,1733,8,1326703458,1326704598,1,1,1140
41407408@N00,1734,8,1212759003,1212760143,1,1,1140
41407408@N00,1735,1,1369170136,1369170226,1,1,90
41407408@N00,1736,2,1415655585,1415655975,2,1,390
41407408@N00,1737,8,1417644248,1417645388,1,1,1140
41407408@N00,1738,1,1422315816,1422315906,1,1,90
41427544@N00,1739,2,1297653087,1297653477,1,1,390
41446425@N03,1740,10,1402651230,1402652730,1,1,1500
41476650@N00,1741,5,1414296027,1414296927,1,1,900
41545932@N02,1742,4,1356845266,1356846166,2,1,900
41624223@N08,1743,10,1338255466,1338256966,2,7,1500
41624223@N08,1743,13,1338262490,1338264290,2,7,1800
41624223@N08,1743,1,1338265475,1338265565,7,7,90
41624223@N08,1743,10,1338271640,1338273140,2,7,1500
41624223@N08,1743,5,1338274163,1338275063,2,7,900
41624223@N08,1743,2,1338279993,1338280383,3,7,390
41624223@N08,1743,6,1338282716,1338283736,3,7,1020
41644332@N07,1744,8,1263198936,1263200076,1,1,1140
41661621@N00,1745,10,1240529070,1240530570,2,11,1500
41661621@N00,1745,4,1240530789,1240531689,2,11,900
41661621@N00,1745,2,1240532913,1240533303,2,11,390
41661621@N00,1745,12,1240535979,1240537479,28,11,1500
41661621@N00,1745,7,1240547635,1240548655,15,11,1020
41661621@N00,1745,1,1240549116,1240549206,29,11,90
41661621@N00,1745,11,1240550973,1240552473,2,11,1500
41661621@N00,1745,2,1240552581,1240552971,4,11,390
41661621@N00,1745,6,1240553052,1240553724,6,11,672
41661621@N00,1745,4,1240553724,1240553896,4,11,172
41661621@N00,1745,13,1240553896,1240555696,1,11,1800
41661621@N00,1746,10,1392250684,1392250895,2,12,211
41661621@N00,1746,1,1392250895,1392250985,2,12,90
41661621@N00,1746,4,1392251365,1392252265,4,12,900
41661621@N00,1746,1,1392253339,1392253429,3,12,90
41661621@N00,1746,12,1392253861,1392255361,20,12,1500
41661621@N00,1746,8,1392256179,1392256640,2,12,461
41661621@N00,1746,4,1392256640,1392257540,2,12,900
41661621@N00,1746,8,1392257996,1392258529,6,12,533
41661621@N00,1746,2,1392258529,1392258579,2,12,50
41661621@N00,1746,11,1392258579,1392258685,3,12,106
41661621@N00,1746,7,1392258685,1392259028,4,12,343
41661621@N00,1746,1,1392259028,1392259118,2,12,90
41662207@N05,1747,5,1393139021,1393139921,1,1,900
41662207@N05,1748,5,1405733489,1405734389,1,1,900
41693381@N00,1749,2,1292041559,1292041949,2,3,390
41693381@N00,1749,6,1292043957,1292044977,2,3,1020
41693381@N00,1749,1,1292048144,1292048234,3,3,90
41693381@N00,1750,8,1292152804,1292153944,2,2,1140
41693381@N00,1750,10,1292157485,1292158985,1,2,1500
41693381@N00,1751,8,1337422389,1337423529,8,1,1140
41693381@N00,1752,5,1337609368,1337610268,2,1,900
41693381@N00,1753,2,1337726673,1337727063,2,3,390
41693381@N00,1753,1,1337728072,1337728162,2,3,90
41693381@N00,1753,5,1337740720,1337741620,1,3,900
41693381@N00,1754,5,1337928554,1337929454,1,1,900
41693381@N00,1755,8,1430469487,1430470404,2,3,917
41693381@N00,1755,1,1430470404,1430470494,2,3,90
41693381@N00,1755,8,1430471715,1430472855,1,3,1140
41693381@N00,1756,8,1431680461,1431681601,2,2,1140
41693381@N00,1756,1,1431687867,1431687957,1,2,90
41693381@N00,1757,13,1433069189,1433070989,1,1,1800
41693381@N00,1758,13,1434187761,1434189561,1,1,1800
41693381@N00,1759,8,1441960191,1441961331,1,1,1140
41693381@N00,1760,6,1446969987,1446971007,2,1,1020
41693381@N00,1761,6,1447848122,1447849142,3,1,1020
41693381@N00,1762,1,1456125701,1456125791,2,3,90
41693381@N00,1762,6,1456126695,1456127715,3,3,1020
41693381@N00,1762,13,1456130310,1456132110,1,3,1800
41872770@N05,1763,7,1229021175,1229022195,1,1,1020
41872770@N05,1764,5,1252210202,1252211102,1,1,900
41872770@N05,1765,5,1266017040,1266017408,2,4,368
41872770@N05,1765,1,1266017408,1266017498,2,4,90
41872770@N05,1765,2,1266023232,1266023622,2,4,390
41872770@N05,1765,6,1266023643,1266024663,3,4,1020
41878212@N00,1766,3,1281750208,1281750628,2,1,420
41878212@N00,1767,6,1419407788,1419408808,3,2,1020
41878212@N00,1767,5,1419416131,1419417031,1,2,900
41894167453@N01,1768,4,1323148624,1323149524,2,1,900
41894170742@N01,1769,8,1274887158,1274888298,7,1,1140
41894185936@N01,1770,7,1381389483,1381390503,1,1,1020
41967511@N00,1771,1,1275513515,1275513605,2,4,90
41967511@N00,1771,5,1275515380,1275516280,5,4,900
41967511@N00,1771,7,1275519490,1275519544,3,4,54
41967511@N00,1771,2,1275519544,1275519934,5,4,390
41976006@N02,1772,8,1304990251,1304991391,1,1,1140
42118699@N08,1773,12,1210227243,1210227403,2,2,160
42118699@N08,1773,1,1210227403,1210227493,1,2,90
42118699@N08,1774,4,1254514229,1254515129,3,4,900
42118699@N08,1774,6,1254516048,1254517068,2,4,1020
42118699@N08,1774,11,1254518724,1254520224,2,4,1500
42118699@N08,1774,12,1254522603,1254524103,1,4,1500
42118699@N08,1775,8,1257800947,1257801918,2,2,971
42118699@N08,1775,12,1257801918,1257803418,3,2,1500
42118699@N08,1776,4,1367613062,1367613962,1,1,900
42118699@N08,1777,8,1368732202,1368733342,2,3,1140
42118699@N08,1777,5,1368733613,1368734513,2,3,900
42118699@N08,1777,4,1368734565,1368735465,5,3,900
42118699@N08,1778,8,1460599625,1460600765,4,1,1140
42151752@N05,1779,10,1448390540,1448392040,1,1,1500
42320709@N06,1780,4,1453523502,1453524402,1,1,900
42327762@N03,1781,1,1258071619,1258071709,3,6,90
42327762@N03,1781,7,1258075334,1258075869,2,6,535
42327762@N03,1781,12,1258075869,1258077369,3,6,1500
42327762@N03,1781,2,1258080342,1258080732,2,6,390
42327762@N03,1781,4,1258088085,1258088985,2,6,900
42327762@N03,1781,13,1258090650,1258092450,9,6,1800
42327762@N03,1782,6,1286165936,1286166956,12,1,1020
42340071@N05,1783,12,1349574488,1349575988,1,1,1500
42363455@N02,1784,1,1252763256,1252763346,1,1,90
42398872@N03,1785,10,1325549636,1325551136,2,4,1500
42398872@N03,1785,4,1325556096,1325556996,2,4,900
42398872@N03,1785,6,1325570241,1325571261,3,4,1020
42398872@N03,1785,2,1325581900,1325582290,1,4,390
42399173@N05,1786,1,1345770558,1345770648,4,4,90
42399173@N05,1786,8,1345770748,1345771888,3,4,1140
42399173@N05,1786,7,1345772522,1345772561,2,4,39
42399173@N05,1786,12,1345772561,1345774061,1,4,1500
42399173@N05,1787,1,1345805489,1345805579,4,1,90
42399173@N05,1788,1,1386550052,1386550142,7,7,90
42399173@N05,1788,13,1386554548,1386555251,5,7,703
42399173@N05,1788,1,1386555251,1386555341,5,7,90
42399173@N05,1788,8,1386556361,1386557291,3,7,930
42399173@N05,1788,11,1386557291,1386558791,2,7,1500
42399173@N05,1788,6,1386577047,1386577790,7,7,743
42399173@N05,1788,4,1386577790,1386578690,1,7,900
42399173@N05,1789,7,1386739800,1386739938,4,4,138
42399173@N05,1789,1,1386739938,1386740028,18,4,90
42399173@N05,1789,10,1386744125,1386745304,2,4,1179
42399173@N05,1789,1,1386745304,1386745394,7,4,90
42416044@N04,1790,2,1291674104,1291674494,4,3,390
42416044@N04,1790,4,1291678062,1291678962,2,3,900
42416044@N04,1790,6,1291680363,1291681383,1,3,1020
42419824@N03,1791,7,1383264830,1383265850,141,1,1020
42486569@N00,1792,5,1299888517,1299889417,4,2,900
42486569@N00,1792,1,1299891877,1299891967,1,2,90
42504117@N06,1793,7,1257414046,1257415066,1,1,1020
42504117@N06,1794,7,1259439215,1259440235,6,1,1020
42504117@N06,1795,7,1259829890,1259830910,3,1,1020
42504117@N06,1796,5,1356558973,1356559873,2,3,900
42504117@N06,1796,12,1356568465,1356569965,6,3,1500
42504117@N06,1796,9,1356591438,1356592938,1,3,1500
42508926@N03,1797,12,1329172075,1329173575,25,1,1500
42533701@N00,1798,8,1215045617,1215046757,8,1,1140
42533701@N00,1799,8,1215165965,1215167105,15,1,1140
42580834@N08,1800,8,1256425618,1256425724,2,22,106
42580834@N08,1800,1,1256425724,1256425814,2,22,90
42580834@N08,1800,8,1256425931,1256427071,2,22,1140
42580834@N08,1800,4,1256428918,1256429818,5,22,900
42580834@N08,1800,13,1256432354,1256432946,2,22,592
42580834@N08,1800,4,1256432946,1256433846,5,22,900
42580834@N08,1800,6,1256434535,1256435555,2,22,1020
42580834@N08,1800,2,1256439748,1256440074,2,22,326
42580834@N08,1800,12,1256440074,1256440687,2,22,613
42580834@N08,1800,1,1256440687,1256440736,2,22,49
42580834@N08,1800,12,1256440736,1256440750,2,22,14
42580834@N08,1800,1,1256440750,1256440840,2,22,90
42580834@N08,1800,5,1256444686,1256444697,2,22,11
42580834@N08,1800,10,1256444697,1256446197,2,22,1500
42580834@N08,1800,5,1256448501,1256449401,2,22,900
42580834@N08,1800,1,1256454041,1256454131,2,22,90
42580834@N08,1800,8,1256458684,1256459433,6,22,749
42580834@N08,1800,11,1256459433,1256460933,3,22,1500
42580834@N08,1800,2,1256461497,1256461682,2,22,185
42580834@N08,1800,6,1256461682,1256462702,2,22,1020
42580834@N08,1800,9,1256466154,1256466971,3,22,817
42580834@N08,1800,10,1256466971,1256468471,2,22,1500
42580834@N08,1801,2,1256600979,1256601369,2,5,390
42580834@N08,1801,4,1256605808,1256606517,5,5,709
42580834@N08,1801,13,1256606517,1256608317,4,5,1800
42580834@N08,1801,1,1256609021,1256609111,2,5,90
42580834@N08,1801,10,1256610140,1256611640,1,5,1500
42580834@N08,1802,10,1350089157,1350090657,5,2,1500
42580834@N08,1802,1,1350090701,1350090791,1,2,90
42580834@N08,1803,1,1350193424,1350193514,2,4,90
42580834@N08,1803,12,1350193672,1350195172,2,4,1500
42580834@N08,1803,1,1350204744,1350204834,2,4,90
42580834@N08,1803,9,1350210292,1350211792,3,4,1500
42580834@N08,1804,4,1350433617,1350433842,2,2,225
42580834@N08,1804,13,1350433842,1350435642,1,2,1800
42614577@N03,1805,6,1335778708,1335778774,2,13,66
42614577@N03,1805,10,1335778774,1335779280,5,13,506
42614577@N03,1805,1,1335779280,1335779370,6,13,90
42614577@N03,1805,6,1335780811,1335781200,2,13,389
42614577@N03,1805,7,1335781200,1335781235,3,13,35
42614577@N03,1805,12,1335781235,1335781575,3,13,340
42614577@N03,1805,6,1335781575,1335781734,2,13,159
42614577@N03,1805,7,1335781734,1335781829,3,13,95
42614577@N03,1805,8,1335781829,1335782969,3,13,1140
42614577@N03,1805,13,1335783838,1335784100,3,13,262
42614577@N03,1805,4,1335784100,1335785000,9,13,900
42614577@N03,1805,13,1335785299,1335786461,4,13,1162
42614577@N03,1805,9,1335786461,1335787961,4,13,1500
42688661@N06,1806,10,1442227094,1442228547,2,2,1453
42688661@N06,1806,5,1442228547,1442229447,2,2,900
42688661@N06,1807,8,1442366238,1442367378,2,5,1140
42688661@N06,1807,6,1442368527,1442369186,3,5,659
42688661@N06,1807,4,1442369186,1442370086,3,5,900
42688661@N06,1807,2,1442378787,1442379177,2,5,390
42688661@N06,1807,5,1442381341,1442382241,5,5,900
42688661@N06,1808,1,1442558358,1442558448,1,1,90
42730389@N03,1809,1,1427511079,1427511149,2,5,70
42730389@N03,1809,4,1427511149,1427512049,2,5,900
42730389@N03,1809,1,1427516605,1427516610,2,5,5
42730389@N03,1809,4,1427516610,1427517510,2,5,900
42730389@N03,1809,8,1427544439,1427545579,1,5,1140
42786185@N06,1810,13,1446351768,1446353568,1,1,1800
42848911@N05,1811,13,1298420460,1298422260,2,2,1800
42848911@N05,1811,5,1298429969,1298430869,1,2,900
42912996@N00,1812,5,1380056663,1380057563,2,2,900
42912996@N00,1812,10,1380065221,1380066721,1,2,1500
42912996@N00,1813,9,1380097027,1380098527,1,1,1500
43074401@N07,1814,5,1386459588,1386460488,2,1,900
43082306@N00,1815,5,1233463164,1233463828,2,2,664
43082306@N00,1815,8,1233463828,1233464968,1,2,1140
43082306@N00,1816,10,1234660975,1234662475,2,2,1500
43082306@N00,1816,1,1234662534,1234662624,2,2,90
43082306@N00,1817,1,1241142453,1241142543,3,2,90
43082306@N00,1817,8,1241158023,1241159163,1,2,1140
43082306@N00,1818,11,1244867727,1244869227,3,3,1500
43082306@N00,1818,13,1244871433,1244873233,3,3,1800
43082306@N00,1818,10,1244875652,1244877152,2,3,1500
43082306@N00,1819,8,1256961186,1256962326,3,1,1140
43082306@N00,1820,13,1266648004,1266649804,1,1,1800
43082306@N00,1821,5,1273217591,1273218491,1,1,900
43082306@N00,1822,5,1282436434,1282437334,2,3,900
43082306@N00,1822,13,1282438072,1282439006,2,3,934
43082306@N00,1822,1,1282439006,1282439096,1,3,90
43082306@N00,1823,13,1295664395,1295666195,2,2,1800
43082306@N00,1823,10,1295672362,1295673862,1,2,1500
43082306@N00,1824,3,1305818401,1305818821,2,1,420
43082306@N00,1825,1,1315710318,1315710408,1,1,90
43082306@N00,1826,1,1326960605,1326960695,1,1,90
43082306@N00,1827,13,1336190675,1336192475,2,2,1800
43082306@N00,1827,8,1336194623,1336195763,1,2,1140
43082306@N00,1828,13,1337409234,1337411034,2,2,1800
43082306@N00,1828,8,1337423053,1337424193,1,2,1140
43082306@N00,1829,1,1338688359,1338688449,2,2,90
43082306@N00,1829,13,1338696387,1338698187,1,2,1800
43082306@N00,1830,1,1355028632,1355028722,1,1,90
43082306@N00,1831,13,1382237194,1382238994,1,1,1800
43082306@N00,1832,10,1401536949,1401538449,1,1,1500
43082306@N00,1833,13,1432468335,1432470135,1,1,1800
43082306@N00,1834,13,1437998065,1437999865,1,1,1800
43082306@N00,1835,10,1453539783,1453541283,1,1,1500
43082306@N00,1836,9,1462015296,1462016796,1,1,1500
43091652@N03,1837,10,1318675968,1318677468,11,1,1500
43108539@N03,1838,1,1278933474,1278933564,2,3,90
43108539@N03,1838,6,1278935194,1278935700,2,3,506
43108539@N03,1838,13,1278935700,1278937500,1,3,1800
43108539@N03,1839,1,1279120240,1279120330,2,3,90
43108539@N03,1839,8,1279124240,1279125380,2,3,1140
43108539@N03,1839,1,1279128230,1279128320,1,3,90
43122711@N02,1840,1,1253875931,1253876021,2,1,90
43195725@N00,1841,7,1220892605,1220893625,1,1,1020
43198257@N03,1842,6,1362788848,1362789868,255,1,1020
43244835@N00,1843,6,1354149487,1354150507,2,3,1020
43244835@N00,1843,4,1354150876,1354151776,3,3,900
43244835@N00,1843,6,1354181804,1354182824,2,3,1020
43245053@N00,1844,8,1332758091,1332759231,1,1,1140
43245053@N00,1845,6,1353055156,1353056176,2,1,1020
43245053@N00,1846,8,1380849717,1380850857,2,2,1140
43245053@N00,1846,11,1380877154,1380878654,1,2,1500
43245053@N00,1847,6,1415524919,1415525939,2,1,1020
43297700@N00,1848,5,1321741679,1321742579,1,1,900
43365284@N00,1849,8,1246846180,1246847320,162,1,1140
43365284@N00,1850,8,1246989878,1246991018,4,1,1140
43391619@N06,1851,10,1269778196,1269779696,1,1,1500
43391619@N06,1852,2,1278562276,1278562666,2,2,390
43391619@N06,1852,5,1278574891,1278575791,1,2,900
43391619@N06,1853,5,1290640912,1290641812,1,1,900
43391619@N06,1854,5,1306625651,1306626551,1,1,900
43535605@N00,1855,4,1360570361,1360570767,2,2,406
43535605@N00,1855,1,1360570767,1360570857,1,2,90
43545301@N03,1856,6,1331802584,1331802590,2,3,6
43545301@N03,1856,3,1331802590,1331802636,2,3,46
43545301@N03,1856,13,1331802636,1331804436,1,3,1800
43549138@N00,1857,2,1201226486,1201226876,1,1,390
43606766@N00,1858,4,1434178696,1434179596,2,1,900
43612819@N03,1859,6,1256174881,1256175901,1,1,1020
43612819@N03,1860,1,1284936188,1284936278,2,1,90
43612819@N03,1861,6,1291450492,1291451512,1,1,1020
43612819@N03,1862,7,1325839943,1325840963,1,1,1020
43636216@N00,1863,10,1228635711,1228637211,2,2,1500
43636216@N00,1863,2,1228644571,1228644961,1,2,390
43642153@N04,1864,1,1412291730,1412291820,2,6,90
43642153@N04,1864,8,1412292195,1412293335,2,6,1140
43642153@N04,1864,10,1412293862,1412294783,2,6,921
43642153@N04,1864,9,1412294783,1412296283,2,6,1500
43642153@N04,1864,12,1412296364,1412297864,2,6,1500
43642153@N04,1864,10,1412301626,1412303126,2,6,1500
43642153@N04,1865,9,1412331317,1412332817,4,1,1500
43643415@N07,1866,5,1292895633,1292896533,1,1,900
43652558@N00,1867,4,1462706095,1462706995,1,1,900
43667163@N00,1868,8,1256623731,1256624871,4,1,1140
43700437@N06,1869,5,1363386014,1363386914,1,1,900
43700437@N06,1870,10,1373963077,1373963343,5,5,266
43700437@N06,1870,1,1373963343,1373963433,2,5,90
43700437@N06,1870,4,1373965881,1373966781,2,5,900
43700437@N06,1870,8,1373968201,1373969006,2,5,805
43700437@N06,1870,13,1373969006,1373970806,3,5,1800
43700437@N06,1871,1,1383341073,1383341163,1,1,90
43700437@N06,1872,1,1418182518,1418182608,1,1,90
43700437@N06,1873,13,1440665600,1440667400,1,1,1800
43730464@N07,1874,7,1341204475,1341205495,18,1,1020
43749215@N03,1875,1,1368269479,1368269569,1,1,90
43808803@N00,1876,5,1462163574,1462164474,6,5,900
43808803@N00,1876,10,1462165489,1462166742,2,5,1253
43808803@N00,1876,5,1462166742,1462167642,2,5,900
43808803@N00,1876,7,1462181270,1462182290,2,5,1020
43808803@N00,1876,2,1462182417,1462182807,1,5,390
43808803@N00,1877,5,1462614926,1462615826,1,1,900
43808803@N00,1878,8,1462779898,1462781038,7,5,1140
43808803@N00,1878,4,1462786508,1462787069,2,5,561
43808803@N00,1878,6,1462787069,1462788089,2,5,1020
43808803@N00,1878,4,1462788401,1462789176,2,5,775
43808803@N00,1878,12,1462789176,1462790676,1,5,1500
43854580@N03,1879,1,1330650106,1330650196,6,6,90
43854580@N03,1879,10,1330652093,1330653593,3,6,1500
43854580@N03,1879,1,1330659375,1330659465,6,6,90
43854580@N03,1879,13,1330660106,1330661078,6,6,972
43854580@N03,1879,4,1330661078,1330661978,23,6,900
43854580@N03,1879,8,1330665179,1330666319,7,6,1140
43906182@N04,1880,10,1271392925,1271394425,2,1,1500
43906182@N04,1881,1,1271546509,1271546599,1,1,90
43906182@N04,1882,1,1271632603,1271632693,1,1,90
43906182@N04,1883,1,1271706683,1271706773,1,1,90
43906182@N04,1884,1,1272794252,1272794342,1,1,90
43906182@N04,1885,8,1275529629,1275530769,1,1,1140
44022769@N00,1886,5,1344650882,1344651782,1,1,900
44022769@N00,1887,5,1344732148,1344733048,2,2,900
44022769@N00,1887,8,1344733244,1344734384,1,2,1140
44023757@N04,1888,10,1321674496,1321674953,5,2,457
44023757@N04,1888,8,1321674953,1321676093,12,2,1140
44023757@N04,1889,6,1321776643,1321777663,149,4,1020
44023757@N04,1889,8,1321782340,1321783480,11,4,1140
44023757@N04,1889,1,1321784152,1321784242,4,4,90
44023757@N04,1889,10,1321784862,1321786362,2,4,1500
44031443@N04,1890,4,1442192363,1442193263,1,1,900
44031443@N04,1891,9,1442231569,1442233069,1,1,1500
44033839@N05,1892,2,1288994400,1288994401,2,2,1
44033839@N05,1892,1,1288994401,1288994491,1,2,90
44082489@N00,1893,9,1230710356,1230711856,10,2,1500
44082489@N00,1893,6,1230715248,1230716268,3,2,1020
44082489@N00,1894,6,1395538077,1395539097,3,3,1020
44082489@N00,1894,12,1395545045,1395546545,2,3,1500
44082489@N00,1894,1,1395558367,1395558457,1,3,90
44082489@N00,1895,6,1395875796,1395876816,1,1,1020
44124305550@N01,1896,1,1189652965,1189653055,4,3,90
44124305550@N01,1896,6,1189663523,1189664543,9,3,1020
44124305550@N01,1896,5,1189669094,1189669994,4,3,900
44124305550@N01,1897,5,1189829240,1189830140,1,1,900
44124341154@N01,1898,6,1353220153,1353221173,2,2,1020
44124341154@N01,1898,1,1353225028,1353225118,6,2,90
44124341154@N01,1899,2,1353372605,1353372995,6,4,390
44124341154@N01,1899,6,1353386273,1353387293,2,4,1020
44124341154@N01,1899,13,1353390472,1353392272,3,4,1800
44124341154@N01,1899,4,1353392604,1353393504,3,4,900
44124341154@N01,1900,2,1353622817,1353623207,2,3,390
44124341154@N01,1900,4,1353633228,1353634128,2,3,900
44124341154@N01,1900,2,1353637243,1353637633,6,3,390
44124364198@N01,1901,6,1420760107,1420761127,2,2,1020
44124364198@N01,1901,4,1420765508,1420766408,2,2,900
44124366632@N01,1902,8,1293769454,1293770594,2,5,1140
44124366632@N01,1902,5,1293786442,1293787342,2,5,900
44124366632@N01,1902,8,1293797438,1293797870,7,5,432
44124366632@N01,1902,6,1293797870,1293797893,2,5,23
44124366632@N01,1902,8,1293797893,1293799033,12,5,1140
44124372331@N01,1903,8,1217413228,1217414368,1,1,1140
44124377471@N01,1904,4,1306565272,1306566172,1,1,900
44124401501@N01,1905,2,1360454487,1360454877,1,1,390
44124401501@N01,1906,2,1360916126,1360916516,4,1,390
44124426205@N01,1907,10,1271587747,1271589247,1,1,1500
44124426205@N01,1908,6,1271639223,1271640243,2,1,1020
44124426205@N01,1909,6,1272007882,1272008902,1,1,1020
44124426205@N01,1910,2,1352497626,1352498016,2,2,390
44124426205@N01,1910,4,1352501663,1352502563,1,2,900
44124426205@N01,1911,6,1352541162,1352542182,1,1,1020
44124426205@N01,1912,6,1352887495,1352888515,1,1,1020
44124426205@N01,1913,6,1354166457,1354167477,1,1,1020
44124426205@N01,1914,6,1385971527,1385972547,4,1,1020
44124426205@N01,1915,1,1386116773,1386116863,2,1,90
44124426205@N01,1916,12,1386242030,1386243530,1,1,1500
44124426205@N01,1917,6,1386317731,1386318751,2,1,1020
44124427374@N01,1918,9,1202283727,1202285227,1,1,1500
44124427374@N01,1919,6,1348718202,1348719222,1,1,1020
44124427374@N01,1920,5,1348877752,1348878652,1,1,900
44124427374@N01,1921,1,1415400570,1415400660,2,4,90
44124427374@N01,1921,8,1415401023,1415402163,2,4,1140
44124427374@N01,1921,5,1415407264,1415408164,2,4,900
44124427374@N01,1921,6,1415408650,1415409670,1,4,1020
44124427374@N01,1922,6,1415609436,1415610456,3,1,1020
44164246@N00,1923,13,1267750191,1267751991,1,1,1800
44180995@N05,1924,8,1288367866,1288369006,1,1,1140
44275181@N00,1925,8,1368862354,1368863494,1,1,1140
44275181@N00,1926,2,1382848555,1382848945,1,1,390
44275181@N00,1927,8,1402013474,1402014614,1,1,1140
44275181@N00,1928,1,1425867584,1425867674,1,1,90
44275181@N00,1929,4,1442718691,1442719591,4,2,900
44275181@N00,1929,5,1442735445,1442736345,1,2,900
44318907@N08,1930,5,1286276458,1286277358,2,2,900
44318907@N08,1930,8,1286279199,1286280339,2,2,1140
44318907@N08,1931,10,1296689166,1296690666,2,6,1500
44318907@N08,1931,5,1296691994,1296692894,3,6,900
44318907@N08,1931,13,1296695121,1296696921,3,6,1800
44318907@N08,1931,5,1296698428,1296699328,6,6,900
44318907@N08,1931,13,1296703404,1296705204,2,6,1800
44318907@N08,1931,5,1296716409,1296717309,2,6,900
44318907@N08,1932,8,1298503843,1298504983,1,1,1140
44318907@N08,1933,8,1302346383,1302347523,1,1,1140
44318907@N08,1934,2,1305498145,1305498535,1,1,390
44318907@N08,1935,5,1307312679,1307313579,1,1,900
44318907@N08,1936,2,1308176721,1308177111,1,1,390
44318907@N08,1937,5,1309738326,1309739226,1,1,900
44318907@N08,1938,2,1309818499,1309818889,1,1,390
44318907@N08,1939,5,1310337016,1310337916,1,1,900
44318907@N08,1940,5,1310682813,1310683713,1,1,900
44318907@N08,1941,5,1317276293,1317277193,4,5,900
44318907@N08,1941,8,1317282292,1317283302,2,5,1010
44318907@N08,1941,5,1317283302,1317283935,2,5,633
44318907@N08,1941,8,1317283935,1317284608,2,5,673
44318907@N08,1941,1,1317284608,1317284698,1,5,90
44318907@N08,1942,5,1317419032,1317419932,2,2,900
44318907@N08,1942,6,1317429330,1317430350,2,2,1020
44318907@N08,1943,9,1317623097,1317624597,2,2,1500
44318907@N08,1943,5,1317624679,1317625579,1,2,900
44318907@N08,1944,5,1321998468,1321999368,1,1,900
44318907@N08,1945,5,1328922526,1328923426,2,4,900
44318907@N08,1945,8,1328931507,1328932647,3,4,1140
44318907@N08,1945,5,1328935084,1328935984,3,4,900
44318907@N08,1945,10,1328940618,1328942118,1,4,1500
44318907@N08,1946,5,1329120416,1329121316,1,1,900
44318907@N08,1947,5,1329346000,1329346900,4,3,900
44318907@N08,1947,8,1329360094,1329361234,4,3,1140
44318907@N08,1947,1,1329368893,1329368983,1,3,90
44318907@N08,1948,8,1346800029,1346801169,1,1,1140
44318907@N08,1949,5,1359065721,1359066621,1,1,900
44318907@N08,1950,10,1361683981,1361685481,3,4,1500
44318907@N08,1950,9,1361693732,1361695232,2,4,1500
44318907@N08,1950,5,1361695286,1361696186,3,4,900
44318907@N08,1950,8,1361696309,1361697449,1,4,1140
44318907@N08,1951,8,1361842456,1361843596,1,1,1140
44318907@N08,1952,4,1361948697,1361949597,2,3,900
44318907@N08,1952,5,1361951725,1361952625,5,3,900
44318907@N08,1952,8,1361954059,1361955199,1,3,1140
44318907@N08,1953,5,1371852569,1371853469,1,1,900
44437814@N00,1954,1,1256477056,1256477146,1,1,90
44490358@N04,1955,6,1312619536,1312620556,1,1,1020
44490358@N04,1956,1,1313484334,1313484424,2,1,90
44490358@N04,1957,1,1319241736,1319241826,3,1,90
44510773@N08,1958,1,1441256924,1441257014,1,1,90
44603553@N03,1959,13,1352345331,1352347131,1,1,1800
44621966@N00,1960,4,1428453728,1428454628,53,2,900
44621966@N00,1960,1,1428478075,1428478165,1,2,90
44621966@N00,1961,2,1428824810,1428825200,1,1,390
44813763@N07,1962,2,1425351928,1425352069,2,4,141
44813763@N07,1962,12,1425352069,1425353569,2,4,1500
44813763@N07,1962,4,1425358915,1425359815,4,4,900
44813763@N07,1962,6,1425362707,1425363727,2,4,1020
44816688@N00,1963,4,1371293320,1371294220,2,1,900
44816688@N00,1964,8,1371413374,1371414514,1,1,1140
44816688@N00,1965,8,1374019790,1374020930,4,4,1140
44816688@N00,1965,7,1374032730,1374032941,3,4,211
44816688@N00,1965,2,1374032941,1374033331,2,4,390
44816688@N00,1965,11,1374033861,1374035361,1,4,1500
44816688@N00,1966,4,1431735465,1431736365,12,1,900
44816688@N00,1967,8,1432078261,1432079401,1,1,1140
44816688@N00,1968,4,1433949822,1433950722,1,1,900
44816688@N00,1969,4,1441770195,1441771095,1,1,900
44816688@N00,1970,12,1449093099,1449094599,30,1,1500
44816688@N00,1971,4,1453315754,1453316654,1,1,900
44816688@N00,1972,4,1461980274,1461981174,1,1,900
44816688@N00,1973,4,1465851301,1465852201,2,1,900
44867875@N00,1974,1,1385681119,1385681209,1,1,90
44948268@N02,1975,13,1327971170,1327972970,4,1,1800
44948268@N02,1976,13,1329994343,1329996143,1,1,1800
44948268@N02,1977,8,1398830866,1398832006,2,2,1140
44948268@N02,1977,7,1398837474,1398838494,1,2,1020
44948268@N02,1978,13,1399511976,1399513776,2,3,1800
44948268@N02,1978,6,1399521019,1399522039,2,3,1020
44948268@N02,1978,2,1399530172,1399530562,1,3,390
44948268@N02,1979,2,1421377515,1421377905,1,1,390
44948268@N02,1980,4,1422428651,1422429551,2,2,900
44948268@N02,1980,8,1422430723,1422431863,1,2,1140
44948268@N02,1981,1,1422760859,1422760949,1,1,90
44957651@N00,1982,10,1320656511,1320658011,1,1,1500
44978333@N06,1983,2,1305500745,1305501135,1,1,390
45032460@N06,1984,10,1380753047,1380754217,5,12,1170
45032460@N06,1984,1,1380754217,1380754307,3,12,90
45032460@N06,1984,2,1380754451,1380754813,3,12,362
45032460@N06,1984,6,1380754813,1380755833,6,12,1020
45032460@N06,1984,1,1380760830,1380760920,3,12,90
45032460@N06,1984,8,1380762403,1380763329,3,12,926
45032460@N06,1984,6,1380763329,1380764349,6,12,1020
45032460@N06,1984,2,1380777097,1380777487,8,12,390
45032460@N06,1984,11,1380778643,1380780143,10,12,1500
45032460@N06,1984,10,1380781072,1380782572,12,12,1500
45032460@N06,1984,1,1380782948,1380783038,2,12,90
45032460@N06,1984,13,1380785523,1380787323,4,12,1800
45032460@N06,1985,12,1380934749,1380936249,1,1,1500
45033503@N06,1986,1,1249842978,1249843068,1,1,90
45033503@N06,1987,11,1260844597,1260846097,1,1,1500
45033503@N06,1988,1,1269391090,1269391180,3,3,90
45033503@N06,1988,13,1269392718,1269394504,2,3,1786
45033503@N06,1988,1,1269394504,1269394594,1,3,90
45033503@N06,1989,1,1285728292,1285728382,3,1,90
45033503@N06,1990,1,1289973913,1289974003,2,2,90
45033503@N06,1990,6,1289978143,1289979163,1,2,1020
45033503@N06,1991,1,1290140331,1290140421,2,1,90
45033503@N06,1992,2,1305550191,1305550581,1,1,390
45033503@N06,1993,13,1315962079,1315963879,1,1,1800
45067258@N00,1994,4,1305771699,1305772599,1,1,900
45067258@N00,1995,1,1339715331,1339715421,2,4,90
45067258@N00,1995,4,1339716479,1339717379,2,4,900
45067258@N00,1995,5,1339719593,1339720493,2,4,900
45067258@N00,1995,1,1339723086,1339723176,1,4,90
45067258@N00,1996,3,1339842342,1339842762,5,1,420
45067258@N00,1997,5,1355083235,1355084135,1,1,900
45067258@N00,1998,6,1355374630,1355375650,28,1,1020
45067258@N00,1999,1,1370394729,1370394819,4,4,90
45067258@N00,1999,5,1370395934,1370396834,17,4,900
45067258@N00,1999,8,1370402936,1370404076,2,4,1140
45067258@N00,1999,1,1370404143,1370404233,1,4,90
45067258@N00,2000,6,1383894273,1383895293,4,1,1020
45067258@N00,2001,1,1432328612,1432328702,8,13,90
45067258@N00,2001,8,1432343933,1432344542,17,13,609
45067258@N00,2001,1,1432344542,1432344632,4,13,90
45067258@N00,2001,4,1432350072,1432350972,3,13,900
45067258@N00,2001,10,1432352459,1432353959,13,13,1500
45067258@N00,2001,1,1432355787,1432355877,3,13,90
45067258@N00,2001,8,1432355893,1432357033,6,13,1140
45067258@N00,2001,10,1432358956,1432360456,7,13,1500
45067258@N00,2001,8,1432376921,1432377489,4,13,568
45067258@N00,2001,1,1432377489,1432377579,5,13,90
45067258@N00,2001,8,1432377665,1432378805,4,13,1140
45067258@N00,2001,1,1432380674,1432380764,2,13,90
45067258@N00,2001,8,1432380804,1432381944,8,13,1140
45067258@N00,2002,1,1432457489,1432457579,18,1,90
45067258@N00,2003,4,1432706412,1432707312,19,3,900
45067258@N00,2003,13,1432710979,1432711004,4,3,25
45067258@N00,2003,4,1432711004,1432711904,1,3,900
45067258@N00,2004,1,1432854526,1432854616,3,8,90
45067258@N00,2004,5,1432855545,1432856445,2,8,900
45067258@N00,2004,1,1432857526,1432857616,2,8,90
45067258@N00,2004,10,1432860776,1432862276,2,8,1500
45067258@N00,2004,13,1432865565,1432866615,2,8,1050
45067258@N00,2004,8,1432866615,1432867755,4,8,1140
45067258@N00,2004,10,1432869618,1432871118,25,8,1500
45067258@N00,2004,4,1432895489,1432896389,12,8,900
45072542@N00,2005,12,1317509540,1317509669,6,5,129
45072542@N00,2005,7,1317509669,1317509870,5,5,201
45072542@N00,2005,2,1317509870,1317510260,3,5,390
45072542@N00,2005,1,1317512294,1317512384,4,5,90
45072542@N00,2005,2,1317527089,1317527479,4,5,390
45083310@N06,2006,6,1358118037,1358119057,3,7,1020
45083310@N06,2006,13,1358122931,1358122990,2,7,59
45083310@N06,2006,4,1358122990,1358123539,2,7,549
45083310@N06,2006,13,1358123539,1358125237,5,7,1698
45083310@N06,2006,10,1358125237,1358126737,2,7,1500
45083310@N06,2006,8,1358136563,1358137703,6,7,1140
45083310@N06,2006,3,1358143782,1358144202,1,7,420
45228416@N03,2007,1,1298621101,1298621191,2,4,90
45228416@N03,2007,8,1298622680,1298623305,2,4,625
45228416@N03,2007,11,1298623305,1298624073,2,4,768
45228416@N03,2007,8,1298624073,1298625213,2,4,1140
45411733@N00,2008,6,1270942371,1270943391,1,1,1020
45444404@N04,2009,8,1426742372,1426743264,14,3,892
45444404@N04,2009,4,1426743264,1426744164,8,3,900
45444404@N04,2009,13,1426747374,1426749174,1,3,1800
45537774@N02,2010,1,1310464006,1310464096,1,1,90
45561435@N00,2011,1,1295128532,1295128622,2,3,90
45561435@N00,2011,5,1295130754,1295131654,6,3,900
45561435@N00,2011,10,1295146347,1295147847,1,3,1500
45561435@N00,2012,4,1426554115,1426555015,6,20,900
45561435@N00,2012,6,1426557385,1426558405,3,20,1020
45561435@N00,2012,1,1426563970,1426564060,2,20,90
45561435@N00,2012,5,1426564381,1426565281,10,20,900
45561435@N00,2012,8,1426572996,1426574136,3,20,1140
45561435@N00,2012,4,1426574775,1426575219,2,20,444
45561435@N00,2012,8,1426575219,1426575272,2,20,53
45561435@N00,2012,1,1426575272,1426575301,2,20,29
45561435@N00,2012,8,1426575301,1426576441,5,20,1140
45561435@N00,2012,1,1426580661,1426580751,2,20,90
45561435@N00,2012,9,1426581152,1426581865,2,20,713
45561435@N00,2012,5,1426581865,1426582765,3,20,900
45561435@N00,2012,10,1426583607,1426583638,2,20,31
45561435@N00,2012,5,1426583638,1426584538,5,20,900
45561435@N00,2012,1,1426586137,1426586227,3,20,90
45561435@N00,2012,8,1426586243,1426586537,2,20,294
45561435@N00,2012,6,1426586537,1426587557,2,20,1020
45561435@N00,2012,8,1426587568,1426587928,2,20,360
45561435@N00,2012,10,1426587928,1426589428,2,20,1500
45561435@N00,2012,9,1426591587,1426593087,5,20,1500
45571875@N06,2013,8,1265532936,1265534076,3,1,1140
45571875@N06,2014,1,1282711336,1282711426,2,2,90
45571875@N06,2014,5,1282711607,1282712507,2,2,900
45571875@N06,2015,8,1337248272,1337249412,1,1,1140
45571875@N06,2016,12,1348705053,1348706383,2,3,1330
45571875@N06,2016,5,1348706383,1348707283,2,3,900
45571875@N06,2016,13,1348710731,1348712531,3,3,1800
45571875@N06,2017,8,1400327004,1400328144,1,1,1140
45571875@N06,2018,6,1415191430,1415192450,1,1,1020
45614589@N02,2019,7,1226012491,1226013511,3,1,1020
45614589@N02,2020,7,1289697924,1289698944,1,1,1020
45614589@N02,2021,7,1320704313,1320705333,12,1,1020
45614589@N02,2022,7,1352156101,1352157121,8,1,1020
45614589@N02,2023,7,1352705171,1352706191,5,1,1020
45629924@N03,2024,6,1278244321,1278245341,5,1,1020
45681479@N04,2025,1,1298636435,1298636525,2,10,90
45681479@N04,2025,10,1298636528,1298636760,3,10,232
45681479@N04,2025,5,1298636760,1298637660,8,10,900
45681479@N04,2025,4,1298638026,1298638165,3,10,139
45681479@N04,2025,6,1298638165,1298639185,9,10,1020
45681479@N04,2025,1,1298639984,1298640020,2,10,36
45681479@N04,2025,8,1298640020,1298641160,10,10,1140
45681479@N04,2025,1,1298641951,1298642041,16,10,90
45681479@N04,2025,4,1298646262,1298646512,6,10,250
45681479@N04,2025,1,1298646512,1298646602,1,10,90
45716980@N00,2026,8,1327183713,1327184134,3,18,421
45716980@N00,2026,2,1327184134,1327184458,5,18,324
45716980@N00,2026,6,1327184458,1327185478,4,18,1020
45716980@N00,2026,2,1327186365,1327186718,2,18,353
45716980@N00,2026,6,1327186718,1327186983,3,18,265
45716980@N00,2026,4,1327186983,1327187883,2,18,900
45716980@N00,2026,1,1327189952,1327190042,2,18,90
45716980@N00,2026,2,1327193631,1327194021,2,18,390
45716980@N00,2026,4,1327194118,1327195018,2,18,900
45716980@N00,2026,8,1327195791,1327195806,2,18,15
45716980@N00,2026,2,1327195806,1327195987,3,18,181
45716980@N00,2026,7,1327195987,1327196280,2,18,293
45716980@N00,2026,12,1327196280,1327197780,6,18,1500
45716980@N00,2026,5,1327200738,1327201638,7,18,900
45716980@N00,2026,6,1327205393,1327206413,3,18,1020
45716980@N00,2026,4,1327212690,1327213590,2,18,900
45716980@N00,2026,13,1327216788,1327217217,2,18,429
45716980@N00,2026,4,1327217217,1327218117,5,18,900
45716980@N00,2027,1,1361825126,1361825216,2,38,90
45716980@N00,2027,10,1361828449,1361829374,2,38,925
45716980@N00,2027,2,1361829374,1361829513,5,38,139
45716980@N00,2027,8,1361829513,1361829903,2,38,390
45716980@N00,2027,2,1361829903,1361830293,6,38,390
45716980@N00,2027,11,1361831028,1361831777,4,38,749
45716980@N00,2027,12,1361831777,1361831954,3,38,177
45716980@N00,2027,7,1361831954,1361832115,3,38,161
45716980@N00,2027,1,1361832115,1361832205,4,38,90
45716980@N00,2027,8,1361832956,1361834096,4,38,1140
45716980@N00,2027,3,1361834101,1361834178,4,38,77
45716980@N00,2027,8,1361834178,1361834180,2,38,2
45716980@N00,2027,3,1361834180,1361834600,6,38,420
45716980@N00,2027,1,1361835869,1361835916,2,38,47
45716980@N00,2027,13,1361835916,1361836114,3,38,198
45716980@N00,2027,4,1361836114,1361837014,4,38,900
45716980@N00,2027,8,1361837837,1361838324,3,38,487
45716980@N00,2027,1,1361838324,1361838414,5,38,90
45716980@N00,2027,4,1361839255,1361839778,2,38,523
45716980@N00,2027,1,1361839778,1361839868,2,38,90
45716980@N00,2027,7,1361839891,1361840607,2,38,716
45716980@N00,2027,2,1361840607,1361840997,2,38,390
45716980@N00,2027,3,1361842726,1361843146,2,38,420
45716980@N00,2027,5,1361845224,1361845587,2,38,363
45716980@N00,2027,6,1361845587,1361846084,2,38,497
45716980@N00,2027,5,1361846084,1361846566,19,38,482
45716980@N00,2027,1,1361846566,1361846656,4,38,90
45716980@N00,2027,8,1361846741,1361846766,4,38,25
45716980@N00,2027,5,1361846766,1361846775,2,38,9
45716980@N00,2027,6,1361846775,1361846849,2,38,74
45716980@N00,2027,13,1361846849,1361847090,2,38,241
45716980@N00,2027,6,1361847090,1361848110,17,38,1020
45716980@N00,2027,8,1361849628,1361849771,5,38,143
45716980@N00,2027,12,1361849771,1361851271,2,38,1500
45716980@N00,2027,1,1361851818,1361851908,8,38,90
45716980@N00,2027,3,1361851979,1361852003,2,38,24
45716980@N00,2027,1,1361852003,1361852093,24,38,90
45716980@N00,2027,10,1361852442,1361853942,1,38,1500
45749280@N00,2028,2,1303779130,1303779520,10,8,390
45749280@N00,2028,13,1303786332,1303788132,5,8,1800
45749280@N00,2028,8,1303793433,1303793581,2,8,148
45749280@N00,2028,2,1303793581,1303793971,4,8,390
45749280@N00,2028,8,1303796627,1303797767,15,8,1140
45749280@N00,2028,13,1303798926,1303800726,2,8,1800
45749280@N00,2028,5,1303806563,1303807463,2,8,900
45749280@N00,2028,9,1303815461,1303816961,2,8,1500
45749280@N00,2029,5,1304320576,1304321476,7,1,900
45749280@N00,2030,13,1413178819,1413180560,2,4,1741
45749280@N00,2030,6,1413180560,1413180953,2,4,393
45749280@N00,2030,4,1413180953,1413181460,4,4,507
45749280@N00,2030,3,1413181460,1413181880,1,4,420
45749280@N00,2031,5,1413969063,1413969963,4,2,900
45749280@N00,2031,9,1413986393,1413987893,1,2,1500
45805775@N08,2032,13,1326317150,1326318950,4,1,1800
45842774@N00,2033,8,1223874040,1223875180,1,1,1140
45842803@N00,2034,10,1254547421,1254548921,2,2,1500
45842803@N00,2034,5,1254551834,1254552734,4,2,900
45865730@N02,2035,5,1364268257,1364269157,1,1,900
45865730@N02,2036,8,1364419117,1364420257,3,3,1140
45865730@N02,2036,6,1364425841,1364426861,2,3,1020
45865730@N02,2036,2,1364427548,1364427938,3,3,390
45886439@N06,2037,1,1301791756,1301791846,1,1,90
45959609@N00,2038,5,1343881848,1343882748,2,8,900
45959609@N00,2038,4,1343887583,1343888216,3,8,633
45959609@N00,2038,8,1343888216,1343889356,3,8,1140
45959609@N00,2038,4,1343890801,1343891701,2,8,900
45959609@N00,2038,8,1343909369,1343909639,2,8,270
45959609@N00,2038,5,1343909639,1343909884,2,8,245
45959609@N00,2038,4,1343909884,1343910196,2,8,312
45959609@N00,2038,8,1343910196,1343911336,1,8,1140
45959609@N00,2039,4,1408160935,1408161835,2,2,900
45959609@N00,2039,9,1408178139,1408179639,1,2,1500
45959609@N00,2040,5,1444456657,1444457557,1,1,900
45959609@N00,2041,13,1456526917,1456528717,1,1,1800
45959609@N00,2042,4,1462510630,1462511530,1,1,900
45965611@N06,2043,6,1333290292,1333291312,1,1,1020
46027550@N00,2044,1,1236743294,1236743384,3,3,90
46027550@N00,2044,2,1236747189,1236747579,2,3,390
46027550@N00,2044,1,1236760326,1236760416,1,3,90
46050386@N03,2045,5,1242804650,1242805550,3,1,900
46050386@N03,2046,4,1242858566,1242859466,2,2,900
46050386@N03,2046,12,1242866120,1242867620,1,2,1500
46050386@N03,2047,13,1242969841,1242971641,1,1,1800
46134803@N05,2048,4,1370752271,1370753171,1,1,900
46134803@N05,2049,4,1370782502,1370783402,1,1,900
46364076@N02,2050,8,1258745980,1258747120,8,1,1140
46364076@N02,2051,8,1284880797,1284881937,60,1,1140
46419214@N06,2052,10,1277465482,1277466982,1,1,1500
46453719@N00,2053,5,1205616206,1205617106,1,1,900
46536427@N04,2054,8,1357342812,1357343952,20,1,1140
46536427@N04,2055,8,1357599201,1357600341,16,1,1140
46592338@N04,2056,10,1262042867,1262044367,2,2,1500
46592338@N04,2056,5,1262044666,1262045566,1,2,900
46602694@N00,2057,1,1355009891,1355009981,1,1,90
46602694@N00,2058,2,1355650796,1355650888,2,2,92
46602694@N00,2058,6,1355650888,1355651908,1,2,1020
46602694@N00,2059,13,1357940716,1357942516,1,1,1800
46623443@N00,2060,5,1392548674,1392549574,1,1,900
46649528@N04,2061,8,1285737832,1285738972,1,1,1140
46649528@N04,2062,6,1348487278,1348488298,1,1,1020
46659210@N07,2063,1,1319674132,1319674222,1,1,90
46671006@N00,2064,4,1253338038,1253338938,2,1,900
46724048@N00,2065,8,1295318968,1295320108,2,3,1140
46724048@N00,2065,1,1295321078,1295321168,2,3,90
46724048@N00,2065,5,1295321314,1295322214,1,3,900
46866298@N02,2066,10,1280021975,1280023475,2,1,1500
46866350@N00,2067,6,1294010309,1294011329,2,2,1020
46866350@N00,2067,5,1294020492,1294021392,1,2,900
46993481@N04,2068,8,1271033948,1271035088,14,1,1140
47084049@N07,2069,8,1361850892,1361852032,1,1,1140
47125846@N08,2070,8,1261560421,1261561561,1,1,1140
47125846@N08,2071,1,1276392039,1276392129,3,3,90
47125846@N08,2071,8,1276396403,1276397543,4,3,1140
47125846@N08,2071,6,1276400542,1276401562,2,3,1020
47125846@N08,2072,6,1291539387,1291540407,3,4,1020
47125846@N08,2072,1,1291547008,1291547098,2,4,90
47125846@N08,2072,5,1291547597,1291548497,2,4,900
47125846@N08,2072,6,1291551161,1291552181,3,4,1020
47125846@N08,2073,1,1291787446,1291787536,4,2,90
47125846@N08,2073,5,1291788652,1291789552,10,2,900
47125846@N08,2074,8,1297406960,1297408100,1,1,1140
47125846@N08,2075,13,1301819508,1301821308,1,1,1800
47125846@N08,2076,4,1305810678,1305811303,7,5,625
47125846@N08,2076,3,1305811303,1305811723,6,5,420
47125846@N08,2076,4,1305812254,1305813104,4,5,850
47125846@N08,2076,3,1305813104,1305813524,14,5,420
47125846@N08,2076,4,1305817503,1305818403,1,5,900
47125846@N08,2077,13,1307234307,1307236107,6,7,1800
47125846@N08,2077,1,1307238530,1307238620,2,7,90
47125846@N08,2077,12,1307240699,1307242199,2,7,1500
47125846@N08,2077,13,1307243007,1307244807,3,7,1800
47125846@N08,2077,1,1307245928,1307246018,2,7,90
47125846@N08,2077,8,1307255598,1307256738,3,7,1140
47125846@N08,2077,5,1307258236,1307259136,1,7,900
47125846@N08,2078,13,1310896700,1310898500,2,3,1800
47125846@N08,2078,5,1310900088,1310900988,2,3,900
47125846@N08,2078,6,1310905077,1310906097,1,3,1020
47125846@N08,2079,6,1311504399,1311505419,3,4,1020
47125846@N08,2079,4,1311506670,1311507570,2,4,900
47125846@N08,2079,5,1311507845,1311508745,2,4,900
47125846@N08,2079,9,1311510791,1311512291,1,4,1500
47125846@N08,2080,6,1313820991,1313822011,2,1,1020
47125846@N08,2081,6,1319332735,1319333755,2,4,1020
47125846@N08,2081,1,1319344737,1319344827,3,4,90
47125846@N08,2081,13,1319345724,1319347524,8,4,1800
47125846@N08,2081,5,1319350149,1319351049,2,4,900
47125846@N08,2082,6,1321765242,1321765695,4,3,453
47125846@N08,2082,4,1321765695,1321766595,2,3,900
47125846@N08,2082,8,1321772271,1321773411,2,3,1140
47125846@N08,2083,6,1323420790,1323421810,1,1,1020
47125846@N08,2084,8,1323938120,1323939066,2,2,946
47125846@N08,2084,6,1323939066,1323940086,3,2,1020
47125846@N08,2085,8,1326960603,1326961743,1,1,1140
47125846@N08,2086,4,1327206306,1327207206,1,1,900
47125846@N08,2087,5,1329562100,1329563000,1,1,900
47125846@N08,2088,6,1338091566,1338092586,1,1,1020
47125846@N08,2089,1,1338688186,1338688276,1,1,90
47125846@N08,2090,13,1339305478,1339307278,4,4,1800
47125846@N08,2090,4,1339307614,1339308514,2,4,900
47125846@N08,2090,6,1339308795,1339309815,2,4,1020
47125846@N08,2090,8,1339312947,1339314087,9,4,1140
47125846@N08,2091,4,1344680689,1344681589,1,1,900
47125846@N08,2092,13,1346653205,1346655005,2,1,1800
47125846@N08,2093,1,1355028085,1355028175,3,4,90
47125846@N08,2093,8,1355043903,1355045043,2,4,1140
47125846@N08,2093,5,1355048123,1355049023,2,4,900
47125846@N08,2093,6,1355049549,1355050569,4,4,1020
47125846@N08,2094,9,1367064188,1367065688,1,1,1500
47125846@N08,2095,1,1367668468,1367668558,1,1,90
47125846@N08,2096,1,1370740144,1370740234,2,1,90
47125846@N08,2097,8,1372940946,1372942086,1,1,1140
47125846@N08,2098,7,1375591467,1375592487,3,2,1020
47125846@N08,2098,13,1375600812,1375602612,2,2,1800
47125846@N08,2099,1,1378115084,1378115174,3,1,90
47125846@N08,2100,10,1379057750,1379059250,2,2,1500
47125846@N08,2100,3,1379063750,1379064170,1,2,420
47125846@N08,2101,8,1381047951,1381049091,1,1,1140
47125846@N08,2102,2,1386481336,1386481726,2,2,390
47125846@N08,2102,13,1386484001,1386485801,1,2,1800
47125846@N08,2103,5,1387074135,1387075035,1,1,900
47125846@N08,2104,5,1391234893,1391235708,2,3,815
47125846@N08,2104,1,1391235708,1391235798,2,3,90
47125846@N08,2104,8,1391236265,1391237405,1,3,1140
47125846@N08,2105,5,1394293434,1394294334,1,1,900
47125846@N08,2106,5,1396073084,1396073984,1,1,900
47136771@N03,2107,13,1346821659,1346823459,10,2,1800
47136771@N03,2107,1,1346832362,1346832452,1,2,90
47145167@N03,2108,8,1317383081,1317384221,1,1,1140
47189760@N05,2109,5,1359732181,1359733081,1,1,900
47223527@N05,2110,10,1412151015,1412152515,1,1,1500
47363316@N08,2111,8,1330126953,1330128093,2,2,1140
47363316@N08,2111,5,1330131655,1330132555,2,2,900
47363316@N08,2112,5,1330249863,1330250763,2,1,900
47365658@N00,2113,4,1278841356,1278842256,2,2,900
47365658@N00,2113,1,1278852499,1278852589,1,2,90
47423151@N06,2114,5,1318253976,1318254876,1,1,900
47423151@N06,2115,1,1368529847,1368529937,1,1,90
47423151@N06,2116,6,1381126392,1381127412,1,1,1020
47615165@N04,2117,5,1357782067,1357782967,26,1,900
47615165@N04,2118,10,1357963768,1357965268,2,1,1500
47705525@N06,2119,11,1306235836,1306237336,2,2,1500
47705525@N06,2119,8,1306240356,1306241496,2,2,1140
47705525@N06,2120,11,1306315981,1306317481,1,1,1500
47705525@N06,2121,8,1306400422,1306401562,5,1,1140
47705525@N06,2122,8,1307073767,1307074907,5,1,1140
47705525@N06,2123,4,1307170109,1307171009,5,6,900
47705525@N06,2123,8,1307179165,1307179728,3,6,563
47705525@N06,2123,10,1307179728,1307179844,3,6,116
47705525@N06,2123,5,1307179844,1307180744,2,6,900
47705525@N06,2123,11,1307181053,1307182553,3,6,1500
47705525@N06,2123,8,1307182761,1307183901,2,6,1140
47705525@N06,2124,8,1307245594,1307246734,1,1,1140
47705525@N06,2125,7,1312975283,1312976303,1,1,1020
47705525@N06,2126,8,1314356779,1314356817,4,3,38
47705525@N06,2126,12,1314356817,1314356875,2,3,58
47705525@N06,2126,13,1314356875,1314358675,1,3,1800
47716066@N05,2127,1,1307267841,1307267931,1,1,90
47716066@N05,2128,8,1314607982,1314608578,2,3,596
47716066@N05,2128,1,1314608578,1314608668,5,3,90
47716066@N05,2128,8,1314609386,1314610526,1,3,1140
47785122@N06,2129,5,1349509366,1349510266,1,1,900
47826387@N03,2130,4,1339420351,1339421251,1,1,900
47845995@N00,2131,10,1338593070,1338594570,2,2,1500
47845995@N00,2131,4,1338595106,1338596006,4,2,900
47861479@N02,2132,6,1355709448,1355710468,1,1,1020
47861479@N02,2133,4,1355904735,1355905635,2,2,900
47861479@N02,2133,9,1355909479,1355910979,1,2,1500
47861479@N02,2134,2,1381646188,1381646578,4,3,390
47861479@N02,2134,8,1381652663,1381653803,2,3,1140
47861479@N02,2134,10,1381654732,1381656232,1,3,1500
47861479@N02,2135,10,1418623721,1418625221,2,2,1500
47861479@N02,2135,2,1418628967,1418629357,2,2,390
47894833@N04,2136,4,1459393680,1459394580,1,1,900
47953315@N04,2137,8,1199150039,1199151179,35,1,1140
48103768@N00,2138,5,1460160569,1460160946,2,2,377
48103768@N00,2138,10,1460160946,1460162446,2,2,1500
48105777@N00,2139,2,1370150879,1370151269,2,3,390
48105777@N00,2139,5,1370154667,1370155567,2,3,900
48105777@N00,2139,13,1370158951,1370160751,1,3,1800
48121645@N00,2140,8,1231970658,1231971798,4,1,1140
48121645@N00,2141,8,1254089762,1254090902,7,1,1140
48271781@N00,2142,10,1261995617,1261997117,1,1,1500
48275668@N02,2143,4,1347035697,1347036597,1,1,900
48275668@N02,2144,7,1347085158,1347086178,3,2,1020
48275668@N02,2144,12,1347090231,1347091731,1,2,1500
48275668@N02,2145,13,1363561956,1363563756,1,1,1800
48275668@N02,2146,1,1410402447,1410402537,1,1,90
48275668@N02,2147,5,1469008395,1469009295,1,1,900
48311919@N00,2148,2,1194824849,1194825239,18,1,390
48311919@N00,2149,2,1221778551,1221778941,33,1,390
48311919@N00,2150,2,1228460195,1228460585,6,1,390
48311919@N00,2151,2,1228611373,1228611763,12,1,390
48311919@N00,2152,2,1418370302,1418370692,64,1,390
48311919@N00,2153,2,1430714731,1430715121,72,2,390
48311919@N00,2153,5,1430737855,1430738755,10,2,900
48311919@N00,2154,8,1440736881,1440738021,16,2,1140
48311919@N00,2154,7,1440741082,1440742102,199,2,1020
48311919@N00,2155,12,1443248263,1443249763,1,1,1500
48311919@N00,2156,7,1443835677,1443836697,15,87,1020
48311919@N00,2156,1,1443838372,1443838400,2,87,28
48311919@N00,2156,7,1443838400,1443838482,2,87,82
48311919@N00,2156,1,1443838482,1443838487,3,87,5
48311919@N00,2156,7,1443838487,1443838494,3,87,7
48311919@N00,2156,1,1443838494,1443838500,2,87,6
48311919@N00,2156,7,1443838500,1443838505,2,87,5
48311919@N00,2156,1,1443838505,1443838511,2,87,6
48311919@N00,2156,7,1443838511,1443838731,3,87,220
48311919@N00,2156,1,1443838731,1443838734,2,87,3
48311919@N00,2156,7,1443838734,1443838926,11,87,192
48311919@N00,2156,12,1443838926,1443838935,2,87,9
48311919@N00,2156,1,1443838935,1443839025,2,87,90
48311919@N00,2156,12,1443840641,1443840646,3,87,5
48311919@N00,2156,7,1443840646,1443840652,4,87,6
48311919@N00,2156,1,1443840652,1443840654,2,87,2
48311919@N00,2156,7,1443840654,1443841222,4,87,568
48311919@N00,2156,1,1443841222,1443841239,4,87,17
48311919@N00,2156,7,1443841239,1443841251,2,87,12
48311919@N00,2156,1,1443841251,1443841252,2,87,1
48311919@N00,2156,12,1443841252,1443841257,4,87,5
48311919@N00,2156,1,1443841257,1443841259,2,87,2
48311919@N00,2156,12,1443841259,1443841277,9,87,18
48311919@N00,2156,1,1443841277,1443841278,2,87,1
48311919@N00,2156,12,1443841278,1443841301,6,87,23
48311919@N00,2156,7,1443841301,1443841302,2,87,1
48311919@N00,2156,12,1443841302,1443841307,4,87,5
48311919@N00,2156,1,1443841307,1443841308,2,87,1
48311919@N00,2156,12,1443841308,1443841309,2,87,1
48311919@N00,2156,7,1443841309,1443841311,2,87,2
48311919@N00,2156,1,1443841311,1443841312,2,87,1
48311919@N00,2156,12,1443841312,1443841396,2,87,84
48311919@N00,2156,7,1443841396,1443841419,2,87,23
48311919@N00,2156,12,1443841419,1443841427,5,87,8
48311919@N00,2156,1,1443841427,1443841436,5,87,9
48311919@N00,2156,12,1443841436,1443841437,2,87,1
48311919@N00,2156,1,1443841437,1443841442,3,87,5
48311919@N00,2156,12,1443841442,1443841443,2,87,1
48311919@N00,2156,1,1443841443,1443841448,4,87,5
48311919@N00,2156,12,1443841448,1443841449,2,87,1
48311919@N00,2156,1,1443841449,1443841452,2,87,3
48311919@N00,2156,12,1443841452,1443841479,2,87,27
48311919@N00,2156,1,1443841479,1443841479,2,87,0
48311919@N00,2156,12,1443841479,1443841480,2,87,1
48311919@N00,2156,1,1443841480,1443841484,3,87,4
48311919@N00,2156,12,1443841484,1443841486,3,87,2
48311919@N00,2156,1,1443841486,1443841489,4,87,3
48311919@N00,2156,12,1443841489,1443841493,2,87,4
48311919@N00,2156,1,1443841493,1443841494,2,87,1
48311919@N00,2156,12,1443841494,1443841495,2,87,1
48311919@N00,2156,1,1443841495,1443841497,2,87,2
48311919@N00,2156,12,1443841497,1443841511,3,87,14
48311919@N00,2156,1,1443841511,1443841513,3,87,2
48311919@N00,2156,12,1443841513,1443841522,6,87,9
48311919@N00,2156,1,1443841522,1443841537,3,87,15
48311919@N00,2156,12,1443841537,1443841538,2,87,1
48311919@N00,2156,1,1443841538,1443841541,4,87,3
48311919@N00,2156,12,1443841541,1443841542,2,87,1
48311919@N00,2156,7,1443841542,1443841543,2,87,1
48311919@N00,2156,12,1443841543,1443841917,5,87,374
48311919@N00,2156,7,1443841917,1443841921,2,87,4
48311919@N00,2156,12,1443841921,1443841967,16,87,46
48311919@N00,2156,7,1443841967,1443841968,2,87,1
48311919@N00,2156,12,1443841968,1443841980,8,87,12
48311919@N00,2156,7,1443841980,1443841986,2,87,6
48311919@N00,2156,12,1443841986,1443842169,62,87,183
48311919@N00,2156,1,1443842169,1443842175,3,87,6
48311919@N00,2156,12,1443842175,1443842183,4,87,8
48311919@N00,2156,1,1443842183,1443842190,4,87,7
48311919@N00,2156,12,1443842190,1443842249,6,87,59
48311919@N00,2156,1,1443842249,1443842252,2,87,3
48311919@N00,2156,12,1443842252,1443842265,3,87,13
48311919@N00,2156,1,1443842265,1443842272,3,87,7
48311919@N00,2156,12,1443842272,1443842278,3,87,6
48311919@N00,2156,1,1443842278,1443842280,2,87,2
48311919@N00,2156,12,1443842280,1443843780,385,87,1500
48311919@N00,2156,7,1443861282,1443861283,2,87,1
48311919@N00,2156,12,1443861283,1443861392,12,87,109
48311919@N00,2156,7,1443861392,1443861394,2,87,2
48311919@N00,2156,12,1443861394,1443861744,14,87,350
48311919@N00,2156,7,1443861744,1443861751,2,87,7
48311919@N00,2156,12,1443861751,1443861785,4,87,34
48311919@N00,2156,7,1443861785,1443861806,3,87,21
48311919@N00,2156,12,1443861806,1443863306,41,87,1500
48311919@N00,2156,7,1443864001,1443865021,2,87,1020
48311919@N00,2156,1,1443872071,1443872161,10,87,90
48311919@N00,2156,12,1443872191,1443873691,3,87,1500
48311919@N00,2157,7,1453430739,1453431759,57,1,1020
48391953@N02,2158,1,1286350927,1286351017,2,1,90
48427787@N00,2159,5,1320445523,1320446259,2,4,736
48427787@N00,2159,4,1320446259,1320447159,3,4,900
48427787@N00,2159,2,1320450634,1320451024,3,4,390
48427787@N00,2159,6,1320452044,1320453064,6,4,1020
48481127@N08,2160,5,1356816833,1356817733,2,4,900
48481127@N08,2160,1,1356820058,1356820148,2,4,90
48481127@N08,2160,6,1356828145,1356829165,3,4,1020
48481127@N08,2160,4,1356836378,1356837278,1,4,900
48481127@N08,2161,5,1372785299,1372786199,1,1,900
48494440@N04,2162,2,1253416905,1253417295,2,2,390
48494440@N04,2162,4,1253418809,1253419709,1,2,900
48600084713@N01,2163,10,1314494811,1314496311,1,1,1500
48603464@N05,2164,13,1458189749,1458191549,2,1,1800
48658532@N06,2165,6,1311070684,1311071704,2,2,1020
48658532@N06,2165,8,1311079276,1311080416,2,2,1140
48658532@N06,2166,7,1352621986,1352623006,3,1,1020
48661840@N08,2167,5,1406793037,1406793937,1,1,900
48763139@N00,2168,1,1380166498,1380166588,2,1,90
48826873@N08,2169,1,1326372950,1326373040,2,2,90
48826873@N08,2169,8,1326385794,1326386934,1,2,1140
48886342@N00,2170,6,1293958142,1293959162,1,1,1020
48889050018@N01,2171,1,1296944173,1296944263,2,4,90
48889050018@N01,2171,4,1296947573,1296948473,2,4,900
48889050018@N01,2171,11,1296955887,1296955958,2,4,71
48889050018@N01,2171,8,1296955958,1296957098,2,4,1140
48889119686@N01,2172,4,1352437740,1352438640,9,1,900
48891180@N00,2173,4,1230038269,1230039169,2,5,900
48891180@N00,2173,8,1230049349,1230050489,2,5,1140
48891180@N00,2173,1,1230057992,1230058082,2,5,90
48891180@N00,2173,9,1230059456,1230060956,2,5,1500
48891180@N00,2173,8,1230064518,1230065658,3,5,1140
48926352@N00,2174,8,1278805220,1278806360,92,1,1140
48938973@N07,2175,4,1379467998,1379468898,2,2,900
48938973@N07,2175,6,1379473063,1379474083,1,2,1020
48999318@N00,2176,8,1256191580,1256192720,62,1,1140
49014295@N06,2177,8,1396565026,1396566166,2,6,1140
49014295@N06,2177,3,1396580064,1396580484,2,6,420
49014295@N06,2177,13,1396584306,1396586106,4,6,1800
49014295@N06,2177,8,1396586394,1396587534,2,6,1140
49014295@N06,2177,9,1396600230,1396601730,9,6,1500
49014295@N06,2177,8,1396602846,1396603986,1,6,1140
49027661@N03,2178,1,1318639298,1318639388,13,1,90
49027661@N03,2179,6,1400572115,1400573135,5,1,1020
49032331@N05,2180,8,1339210065,1339210724,5,5,659
49032331@N05,2180,1,1339210724,1339210814,5,5,90
49032331@N05,2180,8,1339210887,1339212027,2,5,1140
49032331@N05,2180,5,1339220981,1339221881,3,5,900
49032331@N05,2180,8,1339240794,1339241934,1,5,1140
49103297@N04,2181,10,1408083331,1408084831,45,5,1500
49103297@N04,2181,13,1408087107,1408088907,28,5,1800
49103297@N04,2181,6,1408092102,1408093122,2,5,1020
49103297@N04,2181,9,1408100566,1408102066,64,5,1500
49103297@N04,2181,1,1408103264,1408103354,7,5,90
49109678@N04,2182,10,1309387689,1309387901,2,5,212
49109678@N04,2182,13,1309387901,1309389095,2,5,1194
49109678@N04,2182,3,1309389095,1309389515,2,5,420
49109678@N04,2182,8,1309390449,1309391589,2,5,1140
49109678@N04,2182,10,1309391801,1309393301,1,5,1500
49109678@N04,2183,1,1343778902,1343778992,2,5,90
49109678@N04,2183,3,1343781366,1343781786,2,5,420
49109678@N04,2183,13,1343782505,1343784305,2,5,1800
49109678@N04,2183,5,1343788312,1343789212,4,5,900
49109678@N04,2183,1,1343817856,1343817946,1,5,90
49109678@N04,2184,2,1365146394,1365146784,1,1,390
49126050@N00,2185,2,1312849941,1312850331,1,1,390
49165041@N00,2186,1,1281746387,1281746477,3,4,90
49165041@N00,2186,12,1281746519,1281748019,3,4,1500
49165041@N00,2186,6,1281753442,1281753698,2,4,256
49165041@N00,2186,13,1281753698,1281755498,1,4,1800
49169223@N00,2187,12,1231074000,1231074001,2,8,1
49169223@N00,2187,10,1231074001,1231074004,2,8,3
49169223@N00,2187,3,1231074004,1231074012,2,8,8
49169223@N00,2187,6,1231074012,1231074014,3,8,2
49169223@N00,2187,7,1231074014,1231074017,4,8,3
49169223@N00,2187,2,1231074017,1231074022,6,8,5
49169223@N00,2187,5,1231074022,1231074023,2,8,1
49169223@N00,2187,10,1231074023,1231075523,1,8,1500
49169223@N00,2188,13,1231333224,1231333225,2,2,1
49169223@N00,2188,1,1231333225,1231333315,2,2,90
49275237@N00,2189,8,1206994419,1206994472,2,6,53
49275237@N00,2189,10,1206994472,1206994564,3,6,92
49275237@N00,2189,5,1206994564,1206995464,5,6,900
49275237@N00,2189,10,1206996750,1206998250,5,6,1500
49275237@N00,2189,5,1206998764,1206999664,2,6,900
49275237@N00,2189,1,1207001469,1207001559,1,6,90
49275237@N00,2190,11,1329601337,1329602837,3,11,1500
49275237@N00,2190,6,1329604886,1329605906,18,11,1020
49275237@N00,2190,10,1329619454,1329619789,2,11,335
49275237@N00,2190,1,1329619789,1329619879,2,11,90
49275237@N00,2190,13,1329620709,1329622509,9,11,1800
49275237@N00,2190,4,1329625945,1329626095,2,11,150
49275237@N00,2190,8,1329626095,1329626230,8,11,135
49275237@N00,2190,1,1329626230,1329626320,9,11,90
49275237@N00,2190,9,1329631377,1329632877,30,11,1500
49275237@N00,2190,11,1329634534,1329636034,21,11,1500
49275237@N00,2190,1,1329638133,1329638223,2,11,90
49299827@N06,2191,1,1467239161,1467239251,1,1,90
49305593@N05,2192,8,1429530903,1429532043,1,1,1140
49345884@N06,2193,8,1286850045,1286851185,15,1,1140
49348048@N03,2194,6,1387871753,1387872773,1,1,1020
49502978053@N01,2195,4,1316062252,1316063152,1,1,900
49502978053@N01,2196,13,1317466871,1317467050,3,8,179
49502978053@N01,2196,1,1317467050,1317467140,4,8,90
49502978053@N01,2196,8,1317469225,1317469584,2,8,359
49502978053@N01,2196,2,1317469584,1317469597,2,8,13
49502978053@N01,2196,6,1317469597,1317470617,4,8,1020
49502978053@N01,2196,10,1317470654,1317470703,4,8,49
49502978053@N01,2196,4,1317470703,1317470706,2,8,3
49502978053@N01,2196,5,1317470706,1317471606,1,8,900
49502987176@N01,2197,6,1275091159,1275092179,3,1,1020
49502987176@N01,2198,6,1314171816,1314172836,2,2,1020
49502987176@N01,2198,1,1314175279,1314175369,1,2,90
49503114584@N01,2199,13,1217603969,1217605769,2,2,1800
49503114584@N01,2199,8,1217611904,1217613044,1,2,1140
49503114584@N01,2200,8,1218364071,1218365211,3,1,1140
49503114584@N01,2201,11,1343868884,1343870384,2,5,1500
49503114584@N01,2201,4,1343870915,1343871815,3,5,900
49503114584@N01,2201,6,1343874287,1343875307,2,5,1020
49503114584@N01,2201,4,1343879634,1343880534,2,5,900
49503114584@N01,2201,1,1343900737,1343900827,2,5,90
49503114584@N01,2202,8,1344386513,1344387653,2,4,1140
49503114584@N01,2202,4,1344389041,1344389941,2,4,900
49503114584@N01,2202,6,1344391012,1344392032,2,4,1020
49503114584@N01,2202,4,1344416896,1344417796,1,4,900
49503114584@N01,2203,8,1344730738,1344731150,2,4,412
49503114584@N01,2203,4,1344731150,1344732050,2,4,900
49503114584@N01,2203,2,1344737951,1344738341,2,4,390
49503114584@N01,2203,6,1344739402,1344740422,2,4,1020
49503114584@N01,2204,12,1406784592,1406786092,1,1,1500
49503128117@N01,2205,11,1391367185,1391367188,2,3,3
49503128117@N01,2205,4,1391367188,1391368088,2,3,900
49503128117@N01,2205,9,1391369286,1391370786,1,3,1500
49645702@N00,2206,1,1363391200,1363391290,7,4,90
49645702@N00,2206,4,1363395179,1363395814,13,4,635
49645702@N00,2206,8,1363395814,1363396954,6,4,1140
49645702@N00,2206,6,1363397306,1363398326,8,4,1020
49675952@N07,2207,1,1272711568,1272711658,1,1,90
49677598@N00,2208,12,1221126900,1221128400,2,1,1500
49677598@N00,2209,6,1221185400,1221186420,5,5,1020
49677598@N00,2209,7,1221190800,1221191820,5,5,1020
49677598@N00,2209,12,1221193140,1221194640,7,5,1500
49677598@N00,2209,7,1221195780,1221196200,2,5,420
49677598@N00,2209,1,1221196200,1221196290,5,5,90
49679809@N07,2210,1,1291687050,1291687140,1,1,90
49679809@N07,2211,1,1291879421,1291879511,4,1,90
49679809@N07,2212,1,1322610716,1322610806,7,1,90
49679809@N07,2213,1,1352086672,1352086762,3,1,90
49679809@N07,2214,1,1352185239,1352185329,17,1,90
49679809@N07,2215,1,1367652566,1367652656,11,1,90
49679809@N07,2216,1,1382923087,1382923177,2,1,90
49679809@N07,2217,1,1383196232,1383196322,21,1,90
49679809@N07,2218,1,1401004659,1401004749,13,1,90
49679809@N07,2219,1,1414867423,1414867513,3,1,90
49679809@N07,2220,1,1415252778,1415252868,11,1,90
49679809@N07,2221,1,1445752904,1445752994,9,1,90
49679809@N07,2222,1,1446089978,1446090068,1,1,90
49708289@N04,2223,10,1297925164,1297926664,8,1,1500
49708289@N04,2224,10,1298888384,1298889884,16,1,1500
49708289@N04,2225,10,1299579900,1299581400,1,1,1500
49738389@N00,2226,12,1287461233,1287462733,5,3,1500
49738389@N00,2226,6,1287465472,1287466492,2,3,1020
49738389@N00,2226,2,1287474025,1287474415,3,3,390
49824012@N00,2227,7,1324594545,1324595565,1,1,1020
49855440@N00,2228,4,1297128439,1297129339,1,1,900
49887039@N04,2229,11,1283318641,1283318751,2,13,110
49887039@N04,2229,2,1283318751,1283318827,2,13,76
49887039@N04,2229,11,1283318827,1283319011,2,13,184
49887039@N04,2229,1,1283319011,1283319101,3,13,90
49887039@N04,2229,5,1283319237,1283320137,3,13,900
49887039@N04,2229,8,1283322322,1283323462,2,13,1140
49887039@N04,2229,4,1283324674,1283325574,2,13,900
49887039@N04,2229,8,1283339520,1283340660,10,13,1140
49887039@N04,2229,13,1283344544,1283346344,4,13,1800
49887039@N04,2229,10,1283349354,1283350854,6,13,1500
49887039@N04,2229,8,1283358443,1283358659,3,13,216
49887039@N04,2229,1,1283358659,1283358749,2,13,90
49887039@N04,2229,10,1283359488,1283360988,1,13,1500
49887039@N04,2230,4,1283849035,1283849935,1,1,900
49887039@N04,2231,9,1284028398,1284029898,4,1,1500
49887039@N04,2232,10,1346942995,1346944495,2,2,1500
49887039@N04,2232,9,1346954553,1346956053,1,2,1500
49887039@N04,2233,2,1347033638,1347034028,2,1,390
49887039@N04,2234,2,1347106865,1347106996,3,6,131
49887039@N04,2234,1,1347106996,1347107086,2,6,90
49887039@N04,2234,5,1347118387,1347118582,3,6,195
49887039@N04,2234,8,1347118582,1347118640,2,6,58
49887039@N04,2234,12,1347118640,1347119345,2,6,705
49887039@N04,2234,5,1347119345,1347120245,1,6,900
49887039@N04,2235,8,1347714856,1347714957,2,3,101
49887039@N04,2235,6,1347714957,1347715977,2,3,1020
49887039@N04,2235,4,1347735473,1347736373,1,3,900
49887039@N04,2236,5,1361358785,1361359685,1,1,900
49934509@N00,2237,10,1291780917,1291782417,2,3,1500
49934509@N00,2237,6,1291783696,1291784716,3,3,1020
49934509@N00,2237,2,1291785877,1291786267,1,3,390
49934509@N00,2238,13,1326686344,1326688144,5,1,1800
49934509@N00,2239,1,1326949845,1326949935,1,1,90
49934509@N00,2240,1,1327121503,1327121593,1,1,90
49934509@N00,2241,1,1351574803,1351574893,2,4,90
49934509@N00,2241,6,1351577764,1351578784,3,4,1020
49934509@N00,2241,1,1351582926,1351583016,3,4,90
49934509@N00,2241,9,1351584244,1351585744,1,4,1500
49934509@N00,2242,1,1351732788,1351732878,3,4,90
49934509@N00,2242,4,1351736657,1351737557,2,4,900
49934509@N00,2242,13,1351738036,1351739836,2,4,1800
49934509@N00,2242,12,1351752876,1351754376,5,4,1500
49934509@N00,2243,9,1354413363,1354414863,1,1,1500
49981237@N02,2244,5,1379629294,1379630194,1,1,900
50073458@N00,2245,6,1339551318,1339552338,2,2,1020
50073458@N00,2245,8,1339575387,1339576527,2,2,1140
50073458@N00,2246,9,1340462316,1340463816,1,1,1500
50158065@N00,2247,8,1390299734,1390300874,2,2,1140
50158065@N00,2247,2,1390301315,1390301705,1,2,390
50216293@N04,2248,6,1260086556,1260087576,3,1,1020
50267281@N07,2249,8,1354603806,1354604946,7,1,1140
50267281@N07,2250,8,1354664619,1354665759,5,1,1140
50267281@N07,2251,10,1415423651,1415425151,1,1,1500
50267281@N07,2252,8,1415608611,1415609564,11,3,953
50267281@N07,2252,6,1415609564,1415609965,2,3,401
50267281@N07,2252,8,1415609965,1415611105,25,3,1140
50267281@N07,2253,6,1452085518,1452086538,1,1,1020
50287784@N00,2254,8,1206003147,1206004287,1,1,1140
50287784@N00,2255,8,1206057442,1206058582,53,1,1140
50514133@N00,2256,8,1267401243,1267402383,3,1,1140
50581274@N07,2257,6,1259136551,1259137571,1,1,1020
50624286@N00,2258,8,1310026365,1310027505,1,1,1140
50679269@N07,2259,5,1425450316,1425451216,1,1,900
50722289@N02,2260,5,1275316042,1275316942,1,1,900
50755034@N04,2261,10,1316564715,1316566215,2,2,1500
50755034@N04,2261,4,1316576631,1316577531,1,2,900
50968580@N00,2262,5,1356857489,1356858389,3,3,900
50968580@N00,2262,8,1356861971,1356863111,3,3,1140
50968580@N00,2262,6,1356868260,1356869280,1,3,1020
50968580@N00,2263,2,1377933594,1377933984,1,1,390
51011933@N00,2264,6,1366094592,1366095612,2,3,1020
51011933@N00,2264,12,1366102858,1366104358,2,3,1500
51011933@N00,2264,13,1366106822,1366108622,1,3,1800
51011933@N00,2265,13,1366151487,1366153287,1,1,1800
51035769302@N01,2266,13,1275122832,1275124632,1,1,1800
51038094@N04,2267,8,1361288007,1361289147,1,1,1140
51038094@N04,2268,8,1401596157,1401597297,1,1,1140
51038094@N04,2269,8,1401637075,1401638215,1,1,1140
51048990@N00,2270,13,1322273881,1322275681,2,2,1800
51048990@N00,2270,5,1322281452,1322282352,4,2,900
51099190@N00,2271,4,1356061511,1356062411,2,5,900
51099190@N00,2271,5,1356064113,1356065013,2,5,900
51099190@N00,2271,6,1356066806,1356067826,3,5,1020
51099190@N00,2271,4,1356076784,1356077684,2,5,900
51099190@N00,2271,6,1356094027,1356095047,5,5,1020
51103472@N04,2272,10,1457567528,1457569028,1,1,1500
51141147@N02,2273,12,1335061175,1335062675,2,7,1500
51141147@N02,2273,5,1335064826,1335065471,4,7,645
51141147@N02,2273,1,1335065471,1335065561,2,7,90
51141147@N02,2273,11,1335067373,1335068873,3,7,1500
51141147@N02,2273,1,1335079569,1335079659,3,7,90
51141147@N02,2273,7,1335079694,1335079772,2,7,78
51141147@N02,2273,1,1335079772,1335079862,10,7,90
51166785@N06,2274,1,1352070890,1352070980,5,14,90
51166785@N06,2274,5,1352071994,1352072894,7,14,900
51166785@N06,2274,1,1352073982,1352074072,2,14,90
51166785@N06,2274,10,1352077228,1352078728,3,14,1500
51166785@N06,2274,8,1352080616,1352081231,2,14,615
51166785@N06,2274,4,1352081231,1352082131,8,14,900
51166785@N06,2274,2,1352087490,1352087880,6,14,390
51166785@N06,2274,13,1352089672,1352089991,4,14,319
51166785@N06,2274,2,1352089991,1352090061,2,14,70
51166785@N06,2274,8,1352090061,1352090636,2,14,575
51166785@N06,2274,2,1352090636,1352091026,2,14,390
51166785@N06,2274,8,1352094308,1352094736,2,14,428
51166785@N06,2274,2,1352094736,1352095126,2,14,390
51166785@N06,2274,5,1352097668,1352098568,4,14,900
51166785@N06,2275,5,1444514509,1444515409,4,2,900
51166785@N06,2275,4,1444526943,1444527843,1,2,900
51186242@N00,2276,13,1418523767,1418525567,1,1,1800
51267780@N00,2277,10,1224018559,1224019055,3,14,496
51267780@N00,2277,1,1224019055,1224019145,5,14,90
51267780@N00,2277,5,1224019289,1224020128,6,14,839
51267780@N00,2277,8,1224020128,1224021268,10,14,1140
51267780@N00,2277,13,1224025873,1224027673,23,14,1800
51267780@N00,2277,4,1224030768,1224030879,2,14,111
51267780@N00,2277,6,1224030879,1224031899,5,14,1020
51267780@N00,2277,1,1224040787,1224040877,15,14,90
51267780@N00,2277,8,1224048702,1224049668,3,14,966
51267780@N00,2277,11,1224049668,1224050057,2,14,389
51267780@N00,2277,2,1224050057,1224050313,2,14,256
51267780@N00,2277,6,1224050313,1224051072,2,14,759
51267780@N00,2277,8,1224051072,1224052212,2,14,1140
51267780@N00,2277,9,1224054056,1224055556,19,14,1500
51313971@N08,2278,5,1443666817,1443667717,1,1,900
51437422@N03,2279,4,1427933414,1427934314,2,2,900
51437422@N03,2279,2,1427946606,1427946996,1,2,390
51437422@N03,2280,1,1428026918,1428027008,4,1,90
51437422@N03,2281,8,1429822756,1429823896,1,1,1140
51437422@N03,2282,2,1429878188,1429878578,1,1,390
51479343@N00,2283,8,1272453514,1272454654,2,1,1140
51547237@N00,2284,9,1253438841,1253440341,2,1,1500
51547237@N00,2285,8,1291853648,1291854788,3,2,1140
51547237@N00,2285,6,1291880673,1291881693,1,2,1020
51547237@N00,2286,13,1412731831,1412733631,1,1,1800
51547237@N00,2287,1,1412814026,1412814116,1,1,90
51692964@N05,2288,5,1232552739,1232553639,2,2,900
51692964@N05,2288,8,1232556626,1232557766,2,2,1140
51692964@N05,2289,5,1236951679,1236952579,1,1,900
51746064@N07,2290,4,1362811873,1362812773,3,2,900
51746064@N07,2290,10,1362815129,1362816629,2,2,1500
51746586@N06,2291,4,1281419907,1281420807,19,2,900
51746586@N06,2291,2,1281449417,1281449807,1,2,390
51746586@N06,2292,5,1281835891,1281836791,2,3,900
51746586@N06,2292,10,1281840790,1281842290,2,3,1500
51746586@N06,2292,2,1281843259,1281843649,2,3,390
51746586@N06,2293,4,1282356351,1282357251,1,1,900
51746586@N06,2294,4,1312419008,1312419908,2,8,900
51746586@N06,2294,8,1312420227,1312421367,5,8,1140
51746586@N06,2294,5,1312421374,1312422274,2,8,900
51746586@N06,2294,1,1312425907,1312425997,3,8,90
51746586@N06,2294,6,1312426602,1312427622,7,8,1020
51746586@N06,2294,4,1312431679,1312432579,28,8,900
51746586@N06,2294,8,1312434216,1312434281,2,8,65
51746586@N06,2294,4,1312434281,1312435181,3,8,900
51746586@N06,2295,13,1312940127,1312941927,3,4,1800
51746586@N06,2295,8,1312951130,1312952270,3,4,1140
51746586@N06,2295,5,1312954383,1312955283,2,4,900
51746586@N06,2295,10,1312956208,1312957708,28,4,1500
51746586@N06,2296,10,1313282666,1313283024,2,11,358
51746586@N06,2296,1,1313283024,1313283114,10,11,90
51746586@N06,2296,5,1313284326,1313285226,4,11,900
51746586@N06,2296,1,1313286446,1313286536,2,11,90
51746586@N06,2296,8,1313286563,1313286613,2,11,50
51746586@N06,2296,2,1313286613,1313287003,3,11,390
51746586@N06,2296,6,1313291258,1313292278,2,11,1020
51746586@N06,2296,4,1313295990,1313296890,3,11,900
51746586@N06,2296,10,1313298978,1313299019,2,11,41
51746586@N06,2296,4,1313299019,1313299089,2,11,70
51746586@N06,2296,10,1313299089,1313300589,1,11,1500
51746586@N06,2297,8,1343865536,1343865719,2,12,183
51746586@N06,2297,5,1343865719,1343866619,3,12,900
51746586@N06,2297,8,1343867744,1343867942,3,12,198
51746586@N06,2297,1,1343867942,1343867987,4,12,45
51746586@N06,2297,8,1343867987,1343869127,16,12,1140
51746586@N06,2297,5,1343872508,1343873408,9,12,900
51746586@N06,2297,1,1343876987,1343877077,8,12,90
51746586@N06,2297,5,1343877625,1343878525,5,12,900
51746586@N06,2297,8,1343882642,1343883782,2,12,1140
51746586@N06,2297,2,1343884830,1343885220,2,12,390
51746586@N06,2297,6,1343887114,1343888134,2,12,1020
51746586@N06,2297,7,1343892741,1343893761,1,12,1020
51746586@N06,2298,1,1343956299,1343956389,2,2,90
51746586@N06,2298,8,1343956568,1343957708,1,2,1140
51746586@N06,2299,13,1344822036,1344823836,5,6,1800
51746586@N06,2299,7,1344826634,1344827654,2,6,1020
51746586@N06,2299,12,1344828112,1344828122,2,6,10
51746586@N06,2299,11,1344828122,1344828220,2,6,98
51746586@N06,2299,7,1344828220,1344829240,2,6,1020
51746586@N06,2299,1,1344834443,1344834533,3,6,90
51791370@N03,2300,1,1300063397,1300063487,1,1,90
51791370@N03,2301,12,1300167309,1300168809,4,1,1500
51826494@N06,2302,4,1451521556,1451522456,1,1,900
51826494@N06,2303,4,1451596399,1451597299,1,1,900
51981360@N07,2304,4,1349927467,1349928367,1,1,900
52066610@N03,2305,4,1394671544,1394672444,4,2,900
52066610@N03,2305,8,1394696092,1394697232,1,2,1140
52082189@N03,2306,8,1328014800,1328015940,1,1,1140
52168854@N00,2307,5,1348288715,1348289615,1,1,900
52168854@N00,2308,6,1348471157,1348471825,2,2,668
52168854@N00,2308,13,1348471825,1348473625,12,2,1800
52192784@N08,2309,6,1389833050,1389834070,9,4,1020
52192784@N08,2309,2,1389848550,1389848940,2,4,390
52192784@N08,2309,11,1389849343,1389850843,2,4,1500
52192784@N08,2309,1,1389853356,1389853446,4,4,90
52195956@N03,2310,13,1383089701,1383091501,11,1,1800
52195956@N03,2311,7,1425603074,1425604094,2,1,1020
52226961@N04,2312,13,1376707023,1376708823,1,1,1800
52226961@N04,2313,8,1391860302,1391861442,1,1,1140
52254014@N00,2314,4,1277527828,1277528728,1,1,900
52254014@N00,2315,1,1292058593,1292058683,2,2,90
52254014@N00,2315,4,1292059628,1292060528,1,2,900
52254014@N00,2316,1,1306049039,1306049129,1,1,90
52254014@N00,2317,6,1322645671,1322646691,1,1,1020
52254014@N00,2318,1,1324681889,1324681979,1,1,90
52254014@N00,2319,8,1339324026,1339325166,1,1,1140
52254014@N00,2320,1,1356208773,1356208863,3,2,90
52254014@N00,2320,6,1356210652,1356211672,2,2,1020
52399740@N05,2321,13,1395723216,1395725016,3,3,1800
52399740@N05,2321,2,1395725797,1395725936,2,3,139
52399740@N05,2321,1,1395725936,1395726026,4,3,90
52458519@N07,2322,5,1250982270,1250983170,3,2,900
52458519@N07,2322,4,1251001834,1251002734,1,2,900
52504278@N00,2323,6,1332835748,1332836768,1,1,1020
52574631@N00,2324,1,1323127289,1323127379,61,14,90
52574631@N00,2324,5,1323147048,1323147948,2,14,900
52574631@N00,2324,1,1323148558,1323148648,4,14,90
52574631@N00,2324,12,1323150467,1323151967,3,14,1500
52574631@N00,2324,1,1323152178,1323152268,7,14,90
52574631@N00,2324,12,1323152280,1323153780,2,14,1500
52574631@N00,2324,1,1323154359,1323154449,3,14,90
52574631@N00,2324,11,1323156016,1323156043,2,14,27
52574631@N00,2324,1,1323156043,1323156092,2,14,49
52574631@N00,2324,8,1323156092,1323156161,2,14,69
52574631@N00,2324,1,1323156161,1323156251,2,14,90
52574631@N00,2324,6,1323159703,1323160723,15,14,1020
52574631@N00,2324,1,1323162882,1323162972,3,14,90
52574631@N00,2324,8,1323173095,1323174235,1,14,1140
52574631@N00,2325,10,1455328110,1455329585,2,5,1475
52574631@N00,2325,8,1455329585,1455330725,3,5,1140
52574631@N00,2325,12,1455334323,1455335823,2,5,1500
52574631@N00,2325,13,1455339000,1455340341,2,5,1341
52574631@N00,2325,2,1455340341,1455340731,3,5,390
52574631@N00,2326,10,1455838597,1455839242,2,12,645
52574631@N00,2326,1,1455839242,1455839332,9,12,90
52574631@N00,2326,13,1455846989,1455848749,4,12,1760
52574631@N00,2326,4,1455848749,1455849649,3,12,900
52574631@N00,2326,2,1455853126,1455853516,2,12,390
52574631@N00,2326,8,1455853730,1455854870,2,12,1140
52574631@N00,2326,7,1455855096,1455856116,3,12,1020
52574631@N00,2326,4,1455859893,1455860481,7,12,588
52574631@N00,2326,6,1455860481,1455861501,3,12,1020
52574631@N00,2326,2,1455861716,1455862023,3,12,307
52574631@N00,2326,11,1455862023,1455862179,2,12,156
52574631@N00,2326,7,1455862179,1455863199,1,12,1020
52627430@N00,2327,6,1220239645,1220240665,3,1,1020
52636686@N07,2328,10,1390163836,1390165211,9,30,1375
52636686@N07,2328,1,1390165211,1390165301,7,30,90
52636686@N07,2328,13,1390165691,1390165824,4,30,133
52636686@N07,2328,6,1390165824,1390166844,32,30,1020
52636686@N07,2328,2,1390168801,1390169191,5,30,390
52636686@N07,2328,11,1390169226,1390170726,27,30,1500
52636686@N07,2328,12,1390171799,1390171923,2,30,124
52636686@N07,2328,1,1390171923,1390172013,11,30,90
52636686@N07,2328,5,1390172427,1390173327,9,30,900
52636686@N07,2328,1,1390174415,1390174505,2,30,90
52636686@N07,2328,13,1390176418,1390178218,19,30,1800
52636686@N07,2328,6,1390180913,1390181357,5,30,444
52636686@N07,2328,4,1390181357,1390182257,4,30,900
52636686@N07,2328,8,1390187402,1390188542,27,30,1140
52636686@N07,2328,12,1390190636,1390191778,2,30,1142
52636686@N07,2328,7,1390191778,1390192798,4,30,1020
52636686@N07,2328,12,1390193157,1390194657,6,30,1500
52636686@N07,2328,2,1390195718,1390196108,11,30,390
52636686@N07,2328,1,1390197124,1390197214,6,30,90
52636686@N07,2328,8,1390198822,1390199962,2,30,1140
52636686@N07,2328,13,1390201174,1390202974,7,30,1800
52636686@N07,2328,1,1390205549,1390205639,3,30,90
52636686@N07,2328,9,1390206703,1390208203,45,30,1500
52636686@N07,2328,5,1390209293,1390209456,4,30,163
52636686@N07,2328,1,1390209456,1390209546,20,30,90
52636686@N07,2328,8,1390210999,1390211277,2,30,278
52636686@N07,2328,1,1390211277,1390211332,2,30,55
52636686@N07,2328,8,1390211332,1390211439,3,30,107
52636686@N07,2328,1,1390211439,1390211529,3,30,90
52636686@N07,2328,10,1390212019,1390213519,2,30,1500
52666614@N06,2329,13,1408334769,1408336191,2,2,1422
52666614@N06,2329,6,1408336191,1408337211,1,2,1020
52758053@N07,2330,8,1335404608,1335405748,1,1,1140
52758053@N07,2331,7,1375481338,1375482358,2,3,1020
52758053@N07,2331,5,1375482576,1375483175,2,3,599
52758053@N07,2331,1,1375483175,1375483265,1,3,90
52758053@N07,2332,9,1375960251,1375960771,2,2,520
52758053@N07,2332,10,1375960771,1375962271,1,2,1500
52786697@N00,2333,6,1239604481,1239605501,1,1,1020
52793155@N07,2334,6,1291294813,1291295833,2,1,1020
52793155@N07,2335,8,1357371491,1357372631,2,2,1140
52793155@N07,2335,6,1357373222,1357374242,1,2,1020
52793155@N07,2336,13,1385870143,1385871943,3,2,1800
52793155@N07,2336,7,1385875690,1385876710,1,2,1020
52793155@N07,2337,2,1391931704,1391932094,2,2,390
52793155@N07,2337,1,1391936269,1391936359,1,2,90
52793155@N07,2338,1,1416095390,1416095480,1,1,90
52872213@N04,2339,3,1307113866,1307114286,1,1,420
52976240@N00,2340,6,1354969010,1354970030,2,1,1020
52982457@N00,2341,2,1278370618,1278371008,171,1,390
52999052@N08,2342,8,1278806751,1278807891,2,1,1140
53024970@N07,2343,6,1321602178,1321603198,1,1,1020
53024970@N07,2344,5,1330331682,1330332582,1,1,900
53024970@N07,2345,5,1338104726,1338105626,1,1,900
53034361@N00,2346,2,1463143025,1463143415,2,3,390
53034361@N00,2346,12,1463143536,1463145036,2,3,1500
53034361@N00,2346,2,1463146639,1463147029,1,3,390
53034361@N00,2347,8,1463208190,1463209330,2,5,1140
53034361@N00,2347,1,1463214540,1463214630,2,5,90
53034361@N00,2347,12,1463218936,1463219400,2,5,464
53034361@N00,2347,1,1463219400,1463219404,2,5,4
53034361@N00,2347,8,1463219404,1463220544,2,5,1140
53034361@N00,2348,4,1463471870,1463472770,2,1,900
53046881@N07,2349,5,1389740880,1389741780,2,4,900
53046881@N07,2349,6,1389755108,1389756128,2,4,1020
53046881@N07,2349,2,1389762533,1389762923,2,4,390
53046881@N07,2349,1,1389768863,1389768953,1,4,90
53157520@N07,2350,8,1285830542,1285831682,1,1,1140
53199533@N07,2351,8,1268830800,1268830801,2,10,1
53199533@N07,2351,9,1268830801,1268830812,12,10,11
53199533@N07,2351,5,1268830812,1268830816,5,10,4
53199533@N07,2351,4,1268830816,1268830825,2,10,9
53199533@N07,2351,8,1268830825,1268830830,4,10,5
53199533@N07,2351,5,1268830830,1268830833,4,10,3
53199533@N07,2351,10,1268830833,1268830834,2,10,1
53199533@N07,2351,5,1268830834,1268830836,2,10,2
53199533@N07,2351,1,1268830836,1268830837,2,10,1
53199533@N07,2351,12,1268830837,1268832337,1,10,1500
53325263@N07,2352,2,1301006899,1301007289,3,1,390
53325263@N07,2353,1,1301092223,1301092313,2,2,90
53325263@N07,2353,6,1301101598,1301102618,45,2,1020
53407359@N00,2354,6,1417594924,1417595944,2,1,1020
53407359@N00,2355,8,1417816573,1417817713,2,3,1140
53407359@N00,2355,12,1417823621,1417825121,2,3,1500
53407359@N00,2355,6,1417833542,1417834562,4,3,1020
53407359@N00,2356,5,1417935234,1417936134,4,2,900
53407359@N00,2356,2,1417950090,1417950480,2,2,390
53488242@N04,2357,5,1334217385,1334218285,2,2,900
53488242@N04,2357,1,1334218858,1334218948,1,2,90
53516741@N04,2358,9,1319365496,1319366996,3,2,1500
53516741@N04,2358,4,1319373873,1319374773,1,2,900
53516741@N04,2359,1,1354665277,1354665367,1,1,90
53516741@N04,2360,13,1355026855,1355028655,2,2,1800
53516741@N04,2360,6,1355031476,1355032496,2,2,1020
53516741@N04,2361,8,1413706788,1413707928,2,1,1140
53613159@N04,2362,6,1319268849,1319269869,2,2,1020
53613159@N04,2362,8,1319271646,1319272786,1,2,1140
53613159@N04,2363,5,1319414533,1319415433,1,1,900
53770108@N03,2364,4,1364361231,1364362131,1,1,900
53797701@N07,2365,5,1407327322,1407328222,1,1,900
53821866@N05,2366,1,1470741063,1470741153,1,1,90
53980976@N07,2367,1,1372830776,1372830866,3,1,90
54049616@N06,2368,1,1317204593,1317204683,2,1,90
54114021@N06,2369,6,1332907636,1332907645,2,2,9
54114021@N06,2369,4,1332907645,1332908545,1,2,900
54193979@N06,2370,8,1251727200,1251728340,1,1,1140
54250081@N05,2371,13,1369950567,1369952367,3,9,1800
54250081@N05,2371,6,1369952384,1369952611,2,9,227
54250081@N05,2371,4,1369952611,1369952663,2,9,52
54250081@N05,2371,6,1369952663,1369953683,2,9,1020
54250081@N05,2371,13,1369957174,1369958974,4,9,1800
54250081@N05,2371,1,1369960699,1369960789,7,9,90
54250081@N05,2371,4,1369962394,1369962533,2,9,139
54250081@N05,2371,1,1369962533,1369962623,4,9,90
54250081@N05,2371,2,1369965474,1369965864,1,9,390
54364530@N08,2372,1,1354577644,1354577734,9,9,90
54364530@N08,2372,10,1354578100,1354578188,3,9,88
54364530@N08,2372,5,1354578188,1354578437,10,9,249
54364530@N08,2372,10,1354578437,1354578467,2,9,30
54364530@N08,2372,5,1354578467,1354579367,4,9,900
54364530@N08,2372,1,1354581264,1354581354,4,9,90
54364530@N08,2372,2,1354581528,1354581896,5,9,368
54364530@N08,2372,6,1354581896,1354582916,28,9,1020
54364530@N08,2372,5,1354586500,1354587400,2,9,900
54364530@N08,2373,2,1386890220,1386890610,6,1,390
54364530@N08,2374,4,1448940122,1448941022,1,1,900
54364530@N08,2375,3,1449272486,1449272906,1,1,420
54409902@N00,2376,1,1228992013,1228992103,1,1,90
54433880@N05,2377,7,1382588184,1382589204,1,1,1020
54507847@N06,2378,4,1413855800,1413856700,3,1,900
54612194@N05,2379,5,1364626055,1364626955,1,1,900
54679799@N03,2380,5,1370384025,1370384925,1,1,900
54679799@N03,2381,10,1463870242,1463871742,2,6,1500
54679799@N03,2381,8,1463872081,1463873221,3,6,1140
54679799@N03,2381,4,1463882305,1463883205,4,6,900
54679799@N03,2381,2,1463883512,1463883902,2,6,390
54679799@N03,2381,8,1463899442,1463900582,2,6,1140
54679799@N03,2381,13,1463904801,1463906601,1,6,1800
54804105@N07,2382,6,1291544331,1291545351,1,1,1020
54821630@N00,2383,8,1190245640,1190246780,44,1,1140
54831087@N00,2384,1,1287038361,1287038451,3,1,90
54845704@N05,2385,4,1298158458,1298159358,2,13,900
54845704@N05,2385,13,1298162404,1298164204,2,13,1800
54845704@N05,2385,1,1298172529,1298172619,3,13,90
54845704@N05,2385,8,1298173098,1298173403,2,13,305
54845704@N05,2385,2,1298173403,1298173793,6,13,390
54845704@N05,2385,6,1298178893,1298179913,9,13,1020
54845704@N05,2385,4,1298180494,1298181394,3,13,900
54845704@N05,2385,6,1298184126,1298184771,5,13,645
54845704@N05,2385,1,1298184771,1298184861,2,13,90
54845704@N05,2385,6,1298187250,1298187995,2,13,745
54845704@N05,2385,9,1298187995,1298189495,6,13,1500
54845704@N05,2385,2,1298191351,1298191741,17,13,390
54845704@N05,2385,1,1298194693,1298194783,2,13,90
54855264@N00,2386,6,1371339640,1371340660,2,2,1020
54855264@N00,2386,12,1371349322,1371350822,1,2,1500
54865141@N03,2387,5,1452768495,1452769395,1,1,900
54902025@N00,2388,8,1227319590,1227320730,1,1,1140
54902025@N00,2389,5,1286701637,1286702537,1,1,900
54902025@N00,2390,4,1328922529,1328923429,1,1,900
54902025@N00,2391,6,1329104642,1329105063,2,2,421
54902025@N00,2391,4,1329105063,1329105963,1,2,900
54902025@N00,2392,8,1357805275,1357806415,1,1,1140
54902025@N00,2393,1,1379507378,1379507468,4,1,90
54962750@N05,2394,13,1336463926,1336465726,1,1,1800
54968643@N02,2395,6,1357194317,1357195337,2,1,1020
55029145@N00,2396,1,1256109702,1256109792,1,1,90
55104105@N00,2397,13,1350804271,1350806071,1,1,1800
55143107@N00,2398,1,1224032130,1224032220,6,2,90
55143107@N00,2398,6,1224038942,1224039962,1,2,1020
55191318@N04,2399,1,1287052904,1287052994,2,1,90
55217458@N00,2400,5,1352492958,1352493858,2,1,900
55217458@N00,2401,4,1352710659,1352711559,1,1,900
55217458@N00,2402,5,1389401860,1389402760,2,1,900
55266776@N00,2403,2,1266360666,1266361056,2,1,390
55314293@N00,2404,8,1398143954,1398145094,1,1,1140
55455788@N00,2405,13,1194159588,1194161388,2,2,1800
55455788@N00,2405,9,1194177413,1194178913,4,2,1500
55455788@N00,2406,6,1197793374,1197794394,15,1,1020
55455788@N00,2407,6,1228639701,1228640721,15,1,1020
55455788@N00,2408,6,1228728014,1228729034,1,1,1020
55455788@N00,2409,13,1258290905,1258292705,1,1,1800
55455788@N00,2410,8,1284865864,1284867004,2,3,1140
55455788@N00,2410,2,1284873678,1284874068,2,3,390
55455788@N00,2410,8,1284886790,1284887930,1,3,1140
55455788@N00,2411,8,1296774717,1296775857,1,1,1140
55569174@N00,2412,6,1349419149,1349420169,2,1,1020
55569174@N00,2413,6,1349486019,1349487039,2,1,1020
55615740@N00,2414,5,1404439169,1404440069,5,1,900
55615740@N00,2415,11,1413611377,1413611388,2,6,11
55615740@N00,2415,7,1413611388,1413611395,2,6,7
55615740@N00,2415,11,1413611395,1413612895,3,6,1500
55615740@N00,2415,8,1413613139,1413613622,2,6,483
55615740@N00,2415,2,1413613622,1413614012,2,6,390
55615740@N00,2415,13,1413616330,1413618130,1,6,1800
55639505@N05,2416,6,1288325576,1288326596,2,1,1020
55639632@N03,2417,8,1343187252,1343188392,2,2,1140
55639632@N03,2417,1,1343203027,1343203117,1,2,90
55651863@N06,2418,5,1329527282,1329528182,2,1,900
55891979@N03,2419,13,1295326929,1295328729,1,1,1800
55894487@N00,2420,13,1351835258,1351837058,2,2,1800
55894487@N00,2420,9,1351845297,1351846797,5,2,1500
55986062@N03,2421,5,1371166761,1371167661,1,1,900
55991777@N00,2422,10,1433453647,1433455147,2,3,1500
55991777@N00,2422,8,1433455368,1433456508,2,3,1140
55991777@N00,2422,6,1433458326,1433459346,1,3,1020
56027706@N00,2423,8,1235783497,1235784637,1,1,1140
56027706@N00,2424,4,1268450665,1268450898,2,2,233
56027706@N00,2424,6,1268450898,1268451918,2,2,1020
56040377@N07,2425,1,1412300784,1412300874,3,4,90
56040377@N07,2425,8,1412301437,1412301566,2,4,129
56040377@N07,2425,4,1412301566,1412302466,2,4,900
56040377@N07,2425,6,1412305465,1412306485,1,4,1020
56068273@N06,2426,4,1359692737,1359693637,1,1,900
56068273@N06,2427,4,1359747539,1359748439,3,1,900
56176110@N04,2428,1,1307955544,1307955634,2,1,90
56176110@N04,2429,5,1308220930,1308221706,2,2,776
56176110@N04,2429,8,1308221706,1308222846,1,2,1140
56221910@N03,2430,13,1439241549,1439243349,2,3,1800
56221910@N03,2430,4,1439249344,1439250244,2,3,900
56221910@N03,2430,8,1439270584,1439271724,1,3,1140
56223610@N07,2431,10,1335934546,1335936046,4,2,1500
56223610@N07,2431,13,1335941642,1335943442,1,2,1800
56223610@N07,2432,9,1335975373,1335976873,5,1,1500
56223610@N07,2433,7,1390617914,1390618934,1,1,1020
56281521@N00,2434,8,1338854641,1338855781,16,1,1140
56281521@N00,2435,8,1437525362,1437526502,30,1,1140
56416261@N00,2436,8,1306112096,1306113236,3,10,1140
56416261@N00,2436,2,1306114387,1306114777,2,10,390
56416261@N00,2436,4,1306117994,1306118894,5,10,900
56416261@N00,2436,6,1306126465,1306127485,2,10,1020
56416261@N00,2436,8,1306129199,1306129283,2,10,84
56416261@N00,2436,1,1306129283,1306129373,3,10,90
56416261@N00,2436,6,1306130858,1306131878,2,10,1020
56416261@N00,2436,13,1306133262,1306134120,2,10,858
56416261@N00,2436,5,1306134120,1306135020,3,10,900
56416261@N00,2436,1,1306136129,1306136219,4,10,90
56596283@N04,2437,9,1313229097,1313230597,4,1,1500
56615362@N05,2438,8,1288473500,1288474640,1,1,1140
56615362@N05,2439,8,1288517752,1288518892,1,1,1140
56625532@N04,2440,5,1404762400,1404763300,1,1,900
56922122@N03,2441,8,1249217129,1249218269,1,1,1140
56922122@N03,2442,8,1304686979,1304688119,2,1,1140
56952792@N00,2443,6,1198198800,1198199820,1,1,1020
56955635@N00,2444,6,1392618409,1392619429,1,1,1020
56972276@N06,2445,1,1311405089,1311405179,1,1,90
56996539@N00,2446,6,1225513363,1225514383,3,1,1020
56996539@N00,2447,10,1225710002,1225711052,2,2,1050
56996539@N00,2447,11,1225711052,1225712552,6,2,1500
56998983@N00,2448,1,1270481855,1270481945,5,1,90
57073634@N00,2449,5,1435226914,1435227814,2,2,900
57073634@N00,2449,4,1435229177,1435230077,1,2,900
57104916@N04,2450,3,1310908108,1310908528,1,1,420
57169261@N06,2451,5,1369955586,1369956486,58,1,900
57169261@N06,2452,5,1370001917,1370002817,2,1,900
57169261@N06,2453,6,1385871606,1385872626,34,1,1020
57169261@N06,2454,5,1412427751,1412428651,2,1,900
57169261@N06,2455,6,1419752152,1419753172,1,1,1020
57245945@N03,2456,5,1292647160,1292648060,1,1,900
57268629@N00,2457,5,1388725303,1388726203,4,2,900
57268629@N00,2457,13,1388733439,1388735239,1,2,1800
57268629@N00,2458,6,1388895112,1388896132,3,5,1020
57268629@N00,2458,11,1388904330,1388904877,4,5,547
57268629@N00,2458,7,1388904877,1388905101,5,5,224
57268629@N00,2458,2,1388905101,1388905459,2,5,358
57268629@N00,2458,6,1388905459,1388906479,1,5,1020
57269504@N03,2459,5,1262084712,1262085612,1,1,900
57269504@N03,2460,6,1262118729,1262119749,1,1,1020
57311596@N05,2461,5,1321831943,1321832843,2,2,900
57311596@N05,2461,6,1321835746,1321836766,2,2,1020
57428183@N00,2462,8,1194743017,1194744157,9,1,1140
57434805@N03,2463,5,1373713450,1373714350,2,6,900
57434805@N03,2463,1,1373722000,1373722033,2,6,33
57434805@N03,2463,5,1373722033,1373722933,2,6,900
57434805@N03,2463,8,1373725233,1373726373,2,6,1140
57434805@N03,2463,10,1373728380,1373729880,2,6,1500
57434805@N03,2463,2,1373732508,1373732898,1,6,390
57453992@N04,2464,4,1259819653,1259820553,1,1,900
57498635@N02,2465,12,1370823475,1370824975,1,1,1500
57501091@N00,2466,8,1212393857,1212394997,1,1,1140
57507580@N00,2467,4,1336393510,1336394344,2,2,834
57507580@N00,2467,3,1336394344,1336394764,1,2,420
57507580@N00,2468,4,1336552233,1336553133,1,1,900
57507580@N00,2469,8,1336869235,1336870375,3,1,1140
57516324@N03,2470,5,1428369360,1428370260,1,1,900
57657053@N00,2471,1,1212282920,1212283010,2,2,90
57657053@N00,2471,6,1212288122,1212289142,2,2,1020
57657053@N00,2472,6,1233453016,1233454036,1,1,1020
57657053@N00,2473,8,1241222532,1241223672,1,1,1140
57669645@N03,2474,1,1408791129,1408791219,4,2,90
57669645@N03,2474,6,1408801325,1408802345,4,2,1020
57799803@N02,2475,4,1446263287,1446264187,1,1,900
57809043@N00,2476,8,1294299071,1294300211,1,1,1140
57812277@N05,2477,8,1343003011,1343004151,1,1,1140
57812277@N05,2478,8,1343640087,1343641227,1,1,1140
57813403@N07,2479,7,1355514030,1355515050,2,14,1020
57813403@N07,2479,1,1355523504,1355523594,2,14,90
57813403@N07,2479,12,1355524959,1355526459,3,14,1500
57813403@N07,2479,4,1355528184,1355529084,6,14,900
57813403@N07,2479,8,1355529153,1355530293,3,14,1140
57813403@N07,2479,4,1355533988,1355534327,2,14,339
57813403@N07,2479,1,1355534327,1355534417,2,14,90
57813403@N07,2479,10,1355536624,1355538124,2,14,1500
57813403@N07,2479,12,1355539242,1355540742,4,14,1500
57813403@N07,2479,5,1355541916,1355542816,2,14,900
57813403@N07,2479,6,1355547078,1355548098,12,14,1020
57813403@N07,2479,4,1355556866,1355557766,2,14,900
57813403@N07,2479,2,1355559729,1355560119,3,14,390
57813403@N07,2479,1,1355560478,1355560568,2,14,90
57835821@N00,2480,4,1327641083,1327641983,3,4,900
57835821@N00,2480,2,1327647673,1327648063,4,4,390
57835821@N00,2480,8,1327648291,1327649431,2,4,1140
57835821@N00,2480,1,1327650415,1327650505,8,4,90
57835821@N00,2481,6,1368321168,1368322188,20,5,1020
57835821@N00,2481,8,1368330140,1368331280,6,5,1140
57835821@N00,2481,12,1368338076,1368338630,4,5,554
57835821@N00,2481,7,1368338630,1368339650,7,5,1020
57835821@N00,2481,2,1368339701,1368340091,1,5,390
57837862@N06,2482,1,1302084537,1302084627,1,1,90
57915028@N00,2483,13,1357423094,1357424894,2,4,1800
57915028@N00,2483,6,1357440717,1357441737,2,4,1020
57915028@N00,2483,2,1357445226,1357445616,2,4,390
57915028@N00,2483,6,1357446857,1357447877,1,4,1020
57915028@N00,2484,1,1357924572,1357924662,2,2,90
57915028@N00,2484,9,1357926094,1357927594,6,2,1500
57959349@N00,2485,6,1328949031,1328950051,1,1,1020
58013444@N04,2486,2,1288930189,1288930579,1,1,390
58013444@N04,2487,6,1293183767,1293184787,2,1,1020
58013444@N04,2488,10,1405076778,1405078278,1,1,1500
58019767@N00,2489,8,1329338334,1329339063,2,3,729
58019767@N00,2489,5,1329339063,1329339963,2,3,900
58019767@N00,2489,13,1329350060,1329351860,1,3,1800
58114283@N00,2490,1,1201999911,1202000001,2,3,90
58114283@N00,2490,6,1202001435,1202002455,2,3,1020
58114283@N00,2490,1,1202008633,1202008723,3,3,90
58228008@N00,2491,13,1385337326,1385339126,3,6,1800
58228008@N00,2491,12,1385349503,1385349775,4,6,272
58228008@N00,2491,7,1385349775,1385350795,5,6,1020
58228008@N00,2491,8,1385354339,1385355479,2,6,1140
58228008@N00,2491,4,1385356703,1385357603,3,6,900
58228008@N00,2491,6,1385359761,1385360781,2,6,1020
58479263@N00,2492,5,1351043191,1351044091,2,2,900
58479263@N00,2492,1,1351070798,1351070888,1,2,90
58600691@N08,2493,8,1401517125,1401518265,1,1,1140
58602712@N04,2494,10,1295573135,1295574635,1,1,1500
58755999@N05,2495,6,1400637409,1400638429,4,1,1020
58769150@N04,2496,10,1322438877,1322440377,2,2,1500
58769150@N04,2496,13,1322442096,1322443896,1,2,1800
58828455@N00,2497,8,1224628380,1224629520,31,1,1140
58867684@N00,2498,10,1224652173,1224653673,2,2,1500
58867684@N00,2498,6,1224656612,1224657632,3,2,1020
58887120@N00,2499,4,1330152453,1330152629,2,2,176
58887120@N00,2499,13,1330152629,1330154429,1,2,1800
58991728@N00,2500,4,1260852621,1260853521,1,1,900
59071486@N00,2501,5,1338017906,1338018806,1,1,900
59071486@N00,2502,5,1355629675,1355630575,2,3,900
59071486@N00,2502,4,1355639709,1355640609,2,3,900
59071486@N00,2502,6,1355644321,1355645341,3,3,1020
59071486@N00,2503,5,1377423483,1377424383,1,1,900
59071486@N00,2504,6,1416989322,1416990342,1,1,1020
59162053@N00,2505,4,1433059770,1433060670,1,1,900
59171457@N00,2506,7,1329628839,1329629859,2,2,1020
59171457@N00,2506,9,1329638680,1329640180,2,2,1500
59288549@N02,2507,8,1347402877,1347404017,3,2,1140
59288549@N02,2507,13,1347417113,1347418913,2,2,1800
59288549@N02,2508,10,1347666078,1347667578,1,1,1500
59361155@N07,2509,10,1334276790,1334278290,2,2,1500
59361155@N07,2509,8,1334278694,1334279834,1,2,1140
59390981@N04,2510,8,1309853603,1309854743,1,1,1140
59411532@N02,2511,4,1299526384,1299526991,2,3,607
59411532@N02,2511,6,1299526991,1299527704,2,3,713
59411532@N02,2511,12,1299527704,1299529204,1,3,1500
59471679@N04,2512,6,1414736982,1414738002,2,2,1020
59471679@N04,2512,1,1414738593,1414738683,1,2,90
59471679@N04,2513,6,1415784756,1415785776,1,1,1020
59471679@N04,2514,8,1466585049,1466586189,1,1,1140
59471679@N04,2515,9,1468926826,1468928326,2,1,1500
59513859@N00,2516,10,1316669301,1316669664,2,4,363
59513859@N00,2516,1,1316669664,1316669754,4,4,90
59513859@N00,2516,8,1316675913,1316677053,2,4,1140
59513859@N00,2516,1,1316679347,1316679437,1,4,90
59643697@N00,2517,6,1387092428,1387093448,19,1,1020
59658856@N03,2518,13,1352331844,1352333644,3,5,1800
59658856@N03,2518,1,1352343209,1352343299,2,5,90
59658856@N03,2518,8,1352346293,1352346711,2,5,418
59658856@N03,2518,4,1352346711,1352347611,2,5,900
59658856@N03,2518,12,1352350812,1352352312,1,5,1500
59662848@N00,2519,4,1444977652,1444978552,3,2,900
59662848@N00,2519,6,1444978887,1444979907,2,2,1020
59669438@N05,2520,8,1311490148,1311490789,2,3,641
59669438@N05,2520,5,1311490789,1311491689,2,3,900
59669438@N05,2520,1,1311493465,1311493555,1,3,90
59676428@N04,2521,8,1318290459,1318291599,1,1,1140
59682384@N03,2522,10,1378787769,1378789269,1,1,1500
59888795@N03,2523,6,1253237430,1253238450,1,1,1020
59888795@N03,2524,12,1309921908,1309922625,2,6,717
59888795@N03,2524,3,1309922625,1309923045,2,6,420
59888795@N03,2524,1,1309928649,1309928649,2,6,0
59888795@N03,2524,8,1309928649,1309929789,2,6,1140
59888795@N03,2524,11,1309930793,1309930840,2,6,47
59888795@N03,2524,7,1309930840,1309931860,1,6,1020
59888795@N03,2525,2,1379288310,1379288700,3,3,390
59888795@N03,2525,5,1379299466,1379300366,2,3,900
59888795@N03,2525,8,1379320498,1379321638,1,3,1140
59888795@N03,2526,4,1379464509,1379465409,1,1,900
59888866@N00,2527,1,1216930509,1216930599,20,2,90
59888866@N00,2527,8,1216942484,1216943624,1,2,1140
59888866@N00,2528,8,1231822315,1231823455,5,1,1140
59888866@N00,2529,8,1317372000,1317373140,1,1,1140
59888866@N00,2530,8,1328658586,1328659726,1,1,1140
59888866@N00,2531,5,1377308188,1377309088,1,1,900
59888866@N00,2532,12,1377509307,1377510807,1,1,1500
59888866@N00,2533,4,1379075028,1379075928,1,1,900
59888866@N00,2534,9,1381834603,1381836103,1,1,1500
59888866@N00,2535,12,1383568004,1383569504,1,1,1500
59888866@N00,2536,6,1383894076,1383895096,2,1,1020
59888866@N00,2537,1,1393656015,1393656105,2,1,90
59920313@N07,2538,8,1451382214,1451383354,1,1,1140
59983818@N06,2539,13,1310000018,1310001818,1,1,1800
59983818@N06,2540,4,1366501484,1366502384,5,7,900
59983818@N06,2540,13,1366502609,1366502664,2,7,55
59983818@N06,2540,4,1366502664,1366503523,2,7,859
59983818@N06,2540,13,1366503523,1366505323,7,7,1800
59983818@N06,2540,1,1366509128,1366509218,5,7,90
59983818@N06,2540,5,1366510054,1366510954,2,7,900
59983818@N06,2540,6,1366512451,1366513471,4,7,1020
59983818@N06,2541,1,1366592610,1366592700,2,8,90
59983818@N06,2541,11,1366613743,1366615243,5,8,1500
59983818@N06,2541,8,1366616896,1366618036,8,8,1140
59983818@N06,2541,4,1366620128,1366621028,2,8,900
59983818@N06,2541,9,1366623186,1366624686,7,8,1500
59983818@N06,2541,1,1366625742,1366625832,7,8,90
59983818@N06,2541,4,1366627427,1366628327,2,8,900
59983818@N06,2541,1,1366629191,1366629281,1,8,90
60016896@N06,2542,10,1321055987,1321056327,2,10,340
60016896@N06,2542,8,1321056327,1321057467,3,10,1140
60016896@N06,2542,1,1321059732,1321059822,2,10,90
60016896@N06,2542,8,1321063939,1321065079,2,10,1140
60016896@N06,2542,5,1321068574,1321068610,2,10,36
60016896@N06,2542,8,1321068610,1321068717,2,10,107
60016896@N06,2542,1,1321068717,1321068807,2,10,90
60016896@N06,2542,4,1321068996,1321069151,2,10,155
60016896@N06,2542,8,1321069151,1321070291,19,10,1140
60016896@N06,2542,10,1321090373,1321091873,1,10,1500
60054626@N00,2543,8,1245817779,1245818919,9,5,1140
60054626@N00,2543,10,1245820741,1245821067,9,5,326
60054626@N00,2543,5,1245821067,1245821967,9,5,900
60054626@N00,2543,1,1245825900,1245825990,3,5,90
60054626@N00,2543,10,1245827758,1245829258,2,5,1500
60054626@N00,2544,5,1245977841,1245978741,3,4,900
60054626@N00,2544,8,1245991669,1245992194,5,4,525
60054626@N00,2544,2,1245992194,1245992584,17,4,390
60054626@N00,2544,8,1245998319,1245999459,4,4,1140
60054626@N00,2545,5,1246269146,1246269480,2,3,334
60054626@N00,2545,1,1246269480,1246269570,4,3,90
60054626@N00,2545,5,1246271173,1246272073,5,3,900
60054626@N00,2546,2,1431932593,1431932983,2,1,390
60054626@N00,2547,5,1431997724,1431998624,10,4,900
60054626@N00,2547,2,1432000852,1432001242,23,4,390
60054626@N00,2547,5,1432021195,1432022095,2,4,900
60054626@N00,2547,8,1432024679,1432025819,5,4,1140
60082453@N05,2548,1,1428882691,1428882781,2,8,90
60082453@N05,2548,4,1428883388,1428884288,2,8,900
60082453@N05,2548,8,1428889995,1428891135,2,8,1140
60082453@N05,2548,13,1428896939,1428898739,6,8,1800
60082453@N05,2548,12,1428899957,1428901457,2,8,1500
60082453@N05,2548,10,1428902189,1428903689,3,8,1500
60082453@N05,2548,1,1428907328,1428907418,4,8,90
60082453@N05,2548,9,1428926663,1428928163,6,8,1500
60082453@N05,2549,4,1447372251,1447373151,3,2,900
60082453@N05,2549,6,1447399020,1447400040,6,2,1020
60223140@N04,2550,4,1345596232,1345597132,4,4,900
60223140@N04,2550,8,1345601830,1345602970,2,4,1140
60223140@N04,2550,4,1345607363,1345608263,2,4,900
60223140@N04,2550,3,1345610936,1345611356,6,4,420
60309882@N00,2551,1,1244374833,1244374923,1,1,90
60385541@N00,2552,13,1380985604,1380987404,1,1,1800
60385541@N00,2553,1,1381044927,1381045017,2,2,90
60385541@N00,2553,2,1381053925,1381054315,1,2,390
60385541@N00,2554,8,1412433085,1412434225,3,2,1140
60385541@N00,2554,5,1412436475,1412437375,3,2,900
60481456@N00,2555,4,1387394594,1387395494,1,1,900
60481456@N00,2556,4,1387478331,1387478482,2,2,151
60481456@N00,2556,5,1387478482,1387479382,1,2,900
60504322@N04,2557,9,1317391200,1317392700,51,1,1500
60504322@N04,2558,8,1372215680,1372216820,50,3,1140
60504322@N04,2558,9,1372230228,1372231728,19,3,1500
60504322@N04,2558,8,1372240744,1372241884,21,3,1140
60588258@N00,2559,1,1279609561,1279609651,2,2,90
60588258@N00,2559,5,1279611223,1279612123,2,2,900
60611201@N02,2560,5,1347983076,1347983976,1,1,900
60611201@N02,2561,8,1348301292,1348302432,1,1,1140
60705140@N02,2562,8,1301613966,1301615106,18,1,1140
60719438@N05,2563,6,1196589691,1196590711,2,1,1020
60792472@N00,2564,12,1455009715,1455011215,1,1,1500
60897658@N00,2565,4,1210891475,1210892375,4,3,900
60897658@N00,2565,2,1210895259,1210895649,3,3,390
60897658@N00,2565,10,1210906824,1210908324,2,3,1500
61083754@N04,2566,8,1199256446,1199257586,2,1,1140
61083754@N04,2567,5,1199658137,1199659037,3,2,900
61083754@N04,2567,4,1199670682,1199671582,1,2,900
61083754@N04,2568,2,1253237570,1253237960,7,4,390
61083754@N04,2568,6,1253240104,1253241124,3,4,1020
61083754@N04,2568,5,1253258448,1253259348,3,4,900
61083754@N04,2568,8,1253269140,1253270280,4,4,1140
61083754@N04,2569,2,1253319205,1253319595,22,2,390
61083754@N04,2569,6,1253324219,1253325239,4,2,1020
61182627@N06,2570,1,1304172000,1304172090,3,1,90
61186593@N07,2571,6,1307755456,1307756476,1,1,1020
61198674@N00,2572,4,1311116824,1311117724,3,8,900
61198674@N00,2572,13,1311117735,1311118097,3,8,362
61198674@N00,2572,4,1311118097,1311118812,4,8,715
61198674@N00,2572,5,1311118812,1311119712,4,8,900
61198674@N00,2572,8,1311124151,1311125291,2,8,1140
61198674@N00,2572,4,1311133638,1311134538,4,8,900
61198674@N00,2572,6,1311143331,1311144351,2,8,1020
61198674@N00,2572,10,1311144601,1311146101,2,8,1500
61198674@N00,2573,12,1311240176,1311241676,1,1,1500
61198674@N00,2574,4,1311374639,1311375539,2,4,900
61198674@N00,2574,11,1311377105,1311377110,2,4,5
61198674@N00,2574,2,1311377110,1311377500,2,4,390
61198674@N00,2574,5,1311377706,1311378606,3,4,900
61198674@N00,2575,10,1311412885,1311414385,1,1,1500
61261095@N02,2576,6,1318480697,1318480977,2,8,280
61261095@N02,2576,3,1318480977,1318481140,2,8,163
61261095@N02,2576,4,1318481140,1318481401,2,8,261
61261095@N02,2576,13,1318481401,1318481770,3,8,369
61261095@N02,2576,8,1318481770,1318481996,2,8,226
61261095@N02,2576,1,1318481996,1318482086,2,8,90
61261095@N02,2576,10,1318482137,1318482177,2,8,40
61261095@N02,2576,5,1318482177,1318483077,9,8,900
61261095@N02,2577,9,1331637469,1331638969,2,1,1500
61261095@N02,2578,5,1334142209,1334143109,2,3,900
61261095@N02,2578,2,1334144741,1334145131,2,3,390
61261095@N02,2578,8,1334145260,1334146400,2,3,1140
61285553@N00,2579,10,1196560310,1196561810,5,10,1500
61285553@N00,2579,1,1196562063,1196562153,2,10,90
61285553@N00,2579,13,1196562531,1196564331,5,10,1800
61285553@N00,2579,6,1196574453,1196575473,6,10,1020
61285553@N00,2579,4,1196578299,1196579199,5,10,900
61285553@N00,2579,13,1196580362,1196582162,23,10,1800
61285553@N00,2579,6,1196582913,1196583933,10,10,1020
61285553@N00,2579,8,1196586053,1196587193,2,10,1140
61285553@N00,2579,5,1196594160,1196595060,3,10,900
61285553@N00,2579,1,1196598439,1196598529,1,10,90
61308976@N04,2580,11,1320192839,1320194339,1,1,1500
61338634@N04,2581,10,1456180061,1456180542,2,2,481
61338634@N04,2581,1,1456180542,1456180632,1,2,90
61403222@N03,2582,1,1431393904,1431393994,1,1,90
61581248@N04,2583,2,1388620387,1388620700,3,2,313
61581248@N04,2583,12,1388620700,1388622200,2,2,1500
61581248@N04,2584,10,1388702476,1388703976,1,1,1500
61644290@N00,2585,5,1193894710,1193895610,1,1,900
61644290@N00,2586,7,1258071222,1258072242,1,1,1020
61644290@N00,2587,1,1325797666,1325797756,1,1,90
61756292@N00,2588,4,1358577396,1358578296,1,1,900
61827589@N06,2589,5,1368344516,1368345416,2,2,900
61827589@N06,2589,9,1368350126,1368351626,1,2,1500
61897832@N00,2590,8,1260445853,1260446993,65,1,1140
61897832@N00,2591,8,1292192223,1292193363,49,1,1140
61897832@N00,2592,8,1293458417,1293459557,5,1,1140
61905010@N03,2593,8,1411096635,1411097775,2,2,1140
61905010@N03,2593,10,1411098056,1411099556,1,2,1500
61990140@N04,2594,13,1353621515,1353621808,2,2,293
61990140@N04,2594,5,1353621808,1353622708,1,2,900
62065836@N00,2595,10,1457413249,1457414749,1,1,1500
62102776@N02,2596,4,1376298088,1376298988,1,1,900
62122462@N00,2597,6,1347431822,1347432842,1,1,1020
62147041@N08,2598,12,1454214523,1454216023,1,1,1500
62205900@N00,2599,8,1268887626,1268887971,4,2,345
62205900@N00,2599,6,1268887971,1268888991,12,2,1020
62208823@N00,2600,6,1291534963,1291535983,1,1,1020
62208823@N00,2601,6,1354956692,1354957712,1,1,1020
62213164@N00,2602,10,1188723215,1188723773,2,5,558
62213164@N00,2602,1,1188723773,1188723863,3,5,90
62213164@N00,2602,8,1188724309,1188725449,5,5,1140
62213164@N00,2602,9,1188728819,1188730319,9,5,1500
62213164@N00,2602,5,1188730376,1188731276,1,5,900
62221880@N00,2603,1,1307560347,1307560437,2,1,90
62221880@N00,2604,4,1307593683,1307594583,4,2,900
62221880@N00,2604,1,1307603188,1307603278,2,2,90
62221880@N00,2605,8,1307634466,1307635606,2,1,1140
62221880@N00,2606,13,1308971035,1308972835,1,1,1800
62236593@N04,2607,4,1416976408,1416977308,2,2,900
62236593@N04,2607,12,1416981122,1416982622,1,2,1500
62256889@N05,2608,11,1305873505,1305875005,1,1,1500
62256889@N05,2609,3,1305932616,1305933036,2,2,420
62256889@N05,2609,6,1305937109,1305938129,1,2,1020
62256889@N05,2610,9,1358667210,1358668710,3,1,1500
62372928@N03,2611,10,1368975644,1368977144,1,1,1500
62486370@N00,2612,3,1191480079,1191480447,2,3,368
62486370@N00,2612,1,1191480447,1191480537,3,3,90
62486370@N00,2612,10,1191480723,1191482223,2,3,1500
62486370@N00,2613,1,1192441646,1192441736,1,1,90
62486370@N00,2614,7,1288590781,1288591801,3,2,1020
62486370@N00,2614,2,1288599460,1288599850,1,2,390
62547617@N04,2615,13,1322385292,1322387092,4,1,1800
62595633@N06,2616,1,1370559823,1370559913,3,24,90
62595633@N06,2616,8,1370560001,1370561141,3,24,1140
62595633@N06,2616,1,1370562293,1370562383,3,24,90
62595633@N06,2616,5,1370562442,1370563200,4,24,758
62595633@N06,2616,8,1370563200,1370564340,4,24,1140
62595633@N06,2616,2,1370565878,1370566268,14,24,390
62595633@N06,2616,6,1370568948,1370569008,3,24,60
62595633@N06,2616,4,1370569008,1370569376,2,24,368
62595633@N06,2616,1,1370569376,1370569466,2,24,90
62595633@N06,2616,5,1370569525,1370569734,2,24,209
62595633@N06,2616,1,1370569734,1370569824,3,24,90
62595633@N06,2616,13,1370572366,1370574166,5,24,1800
62595633@N06,2616,5,1370577687,1370578587,9,24,900
62595633@N06,2616,10,1370581254,1370582754,5,24,1500
62595633@N06,2616,1,1370587966,1370588056,3,24,90
62595633@N06,2616,4,1370588721,1370588846,3,24,125
62595633@N06,2616,6,1370588846,1370589866,4,24,1020
62595633@N06,2616,2,1370594111,1370594501,2,24,390
62595633@N06,2616,11,1370594661,1370596161,2,24,1500
62595633@N06,2616,5,1370598595,1370599495,7,24,900
62595633@N06,2616,9,1370602994,1370604494,14,24,1500
62595633@N06,2616,5,1370605287,1370605627,2,24,340
62595633@N06,2616,1,1370605627,1370605717,2,24,90
62595633@N06,2616,5,1370605925,1370606825,1,24,900
62595633@N06,2617,5,1370879012,1370879912,1,1,900
62624768@N02,2618,8,1189828565,1189829705,1,1,1140
62624768@N02,2619,8,1352532395,1352532520,2,2,125
62624768@N02,2619,6,1352532520,1352533540,5,2,1020
62667441@N00,2620,4,1224637971,1224638871,1,1,900
62683562@N07,2621,7,1361143793,1361144206,2,8,413
62683562@N07,2621,11,1361144206,1361145706,2,8,1500
62683562@N07,2621,7,1361150211,1361151231,3,8,1020
62683562@N07,2621,11,1361164130,1361164599,2,8,469
62683562@N07,2621,8,1361164599,1361165739,14,8,1140
62683562@N07,2621,7,1361166077,1361166092,2,8,15
62683562@N07,2621,8,1361166092,1361167232,32,8,1140
62683562@N07,2621,1,1361170694,1361170784,1,8,90
62704710@N03,2622,2,1362780698,1362781088,1,1,390
62705831@N05,2623,6,1290584247,1290585267,1,1,1020
62772368@N00,2624,1,1441586833,1441586923,3,6,90
62772368@N00,2624,9,1441590721,1441592221,2,6,1500
62772368@N00,2624,8,1441597346,1441598486,2,6,1140
62772368@N00,2624,4,1441599748,1441600648,3,6,900
62772368@N00,2624,1,1441617414,1441617504,2,6,90
62772368@N00,2624,9,1441622694,1441624194,3,6,1500
62783804@N05,2625,13,1358476402,1358478202,1,1,1800
62950363@N05,2626,1,1349004589,1349004679,4,1,90
62950363@N05,2627,11,1349047439,1349048939,3,2,1500
62950363@N05,2627,1,1349049031,1349049121,3,2,90
63026829@N08,2628,6,1421834242,1421834254,2,3,12
63026829@N08,2628,5,1421834254,1421834285,2,3,31
63026829@N08,2628,2,1421834285,1421834675,1,3,390
63084736@N00,2629,13,1437794421,1437796221,2,2,1800
63084736@N00,2629,4,1437803936,1437804836,2,2,900
63084736@N00,2630,5,1438414028,1438414928,1,1,900
63202442@N00,2631,7,1189417468,1189418488,2,2,1020
63202442@N00,2631,8,1189418669,1189419809,1,2,1140
63202442@N00,2632,13,1201304801,1201306601,1,1,1800
63202442@N00,2633,5,1201513585,1201514485,1,1,900
63202442@N00,2634,10,1201757821,1201759321,1,1,1500
63202442@N00,2635,8,1220850188,1220850237,2,3,49
63202442@N00,2635,1,1220850237,1220850327,3,3,90
63202442@N00,2635,8,1220867336,1220868476,1,3,1140
63202442@N00,2636,5,1221283806,1221284706,3,3,900
63202442@N00,2636,1,1221286814,1221286904,2,3,90
63202442@N00,2636,6,1221289161,1221290181,2,3,1020
63202442@N00,2637,5,1264892147,1264893047,1,1,900
63202442@N00,2638,4,1265087964,1265088071,2,6,107
63202442@N00,2638,3,1265088071,1265088491,2,6,420
63202442@N00,2638,1,1265091282,1265091372,2,6,90
63202442@N00,2638,5,1265093369,1265094269,2,6,900
63202442@N00,2638,1,1265095245,1265095335,2,6,90
63202442@N00,2638,8,1265096112,1265097252,2,6,1140
63202442@N00,2639,6,1291534150,1291535170,1,1,1020
63202442@N00,2640,1,1301256607,1301256697,1,1,90
63202442@N00,2641,1,1301358966,1301359056,1,1,90
63202442@N00,2642,5,1317197049,1317197949,1,1,900
63211078@N00,2643,1,1245620950,1245621040,2,2,90
63211078@N00,2643,8,1245627460,1245628600,1,2,1140
63211078@N00,2644,7,1245842057,1245843077,1,1,1020
63257911@N00,2645,5,1212794158,1212795058,2,7,900
63257911@N00,2645,8,1212795597,1212795637,2,7,40
63257911@N00,2645,1,1212795637,1212795727,2,7,90
63257911@N00,2645,5,1212796806,1212797706,4,7,900
63257911@N00,2645,4,1212803641,1212804541,5,7,900
63257911@N00,2645,8,1212808160,1212808445,4,7,285
63257911@N00,2645,2,1212808445,1212808835,9,7,390
63257911@N00,2646,10,1229123116,1229124600,2,5,1484
63257911@N00,2646,6,1229124600,1229125620,2,5,1020
63257911@N00,2646,2,1229127474,1229127864,2,5,390
63257911@N00,2646,6,1229129373,1229130393,2,5,1020
63257911@N00,2646,8,1229134305,1229135445,7,5,1140
63257911@N00,2647,1,1277417229,1277417319,2,16,90
63257911@N00,2647,8,1277417415,1277417878,3,16,463
63257911@N00,2647,2,1277417878,1277418268,3,16,390
63257911@N00,2647,4,1277418315,1277418738,3,16,423
63257911@N00,2647,1,1277418738,1277418828,3,16,90
63257911@N00,2647,4,1277419122,1277420022,4,16,900
63257911@N00,2647,13,1277420395,1277422171,2,16,1776
63257911@N00,2647,3,1277422171,1277422591,2,16,420
63257911@N00,2647,6,1277424037,1277425057,4,16,1020
63257911@N00,2647,12,1277426812,1277427546,4,16,734
63257911@N00,2647,7,1277427546,1277428566,2,16,1020
63257911@N00,2647,10,1277430611,1277430875,2,16,264
63257911@N00,2647,12,1277430875,1277432375,5,16,1500
63257911@N00,2647,10,1277433602,1277434078,2,16,476
63257911@N00,2647,8,1277434078,1277435218,4,16,1140
63257911@N00,2647,11,1277440229,1277441729,8,16,1500
63257911@N00,2648,10,1316935602,1316936261,2,3,659
63257911@N00,2648,4,1316936261,1316937161,5,3,900
63257911@N00,2648,2,1316939909,1316940299,5,3,390
63265130@N03,2649,10,1416445657,1416447066,2,9,1409
63265130@N03,2649,1,1416447066,1416447156,4,9,90
63265130@N03,2649,7,1416447277,1416447308,2,9,31
63265130@N03,2649,12,1416447308,1416448402,4,9,1094
63265130@N03,2649,7,1416448402,1416449422,8,9,1020
63265130@N03,2649,12,1416451567,1416452017,7,9,450
63265130@N03,2649,4,1416452017,1416452917,23,9,900
63265130@N03,2649,6,1416457079,1416458099,25,9,1020
63265130@N03,2649,4,1416460702,1416461602,6,9,900
63287267@N00,2650,11,1332921422,1332922922,1,1,1500
63287402@N00,2651,6,1214976234,1214977254,1,1,1020
63287402@N00,2652,6,1289201427,1289202447,3,2,1020
63287402@N00,2652,5,1289208342,1289209242,1,2,900
63287402@N00,2653,6,1304384612,1304385632,1,1,1020
63287402@N00,2654,13,1305123860,1305125660,1,1,1800
63287402@N00,2655,6,1305285535,1305286555,1,1,1020
63330642@N06,2656,5,1374980753,1374981653,3,1,900
63330642@N06,2657,5,1377932161,1377933061,1,1,900
63330642@N06,2658,13,1381012888,1381014688,1,1,1800
63330642@N06,2659,8,1383358507,1383359647,3,3,1140
63330642@N06,2659,4,1383360303,1383361203,3,3,900
63330642@N06,2659,5,1383364455,1383365355,1,3,900
63330642@N06,2660,2,1385261760,1385262150,1,1,390
63330642@N06,2661,4,1392440754,1392441654,1,1,900
63330642@N06,2662,5,1392952101,1392953001,2,1,900
63330642@N06,2663,5,1393730111,1393731011,2,2,900
63330642@N06,2663,2,1393736369,1393736759,2,2,390
63330642@N06,2664,6,1419044444,1419045464,1,1,1020
63497676@N06,2665,5,1205678089,1205678989,1,1,900
63513545@N00,2666,10,1380156316,1380156561,2,9,245
63513545@N00,2666,1,1380156561,1380156651,2,9,90
63513545@N00,2666,2,1380157061,1380157451,10,9,390
63513545@N00,2666,6,1380162371,1380163391,5,9,1020
63513545@N00,2666,4,1380165210,1380166110,5,9,900
63513545@N00,2666,6,1380168239,1380169259,2,9,1020
63513545@N00,2666,8,1380171784,1380172924,3,9,1140
63513545@N00,2666,6,1380173298,1380174318,2,9,1020
63513545@N00,2666,5,1380178556,1380179456,2,9,900
63513545@N00,2667,6,1380346913,1380347933,1,1,1020
63513545@N00,2668,2,1415321648,1415322038,10,1,390
63664617@N04,2669,8,1303076473,1303077613,16,1,1140
63812709@N02,2670,10,1306402999,1306404499,1,1,1500
63812709@N02,2671,9,1306572505,1306574005,2,2,1500
63812709@N02,2671,6,1306576604,1306577624,1,2,1020
63812709@N02,2672,10,1306800713,1306802213,3,3,1500
63812709@N02,2672,6,1306806475,1306807495,2,3,1020
63812709@N02,2672,4,1306811042,1306811942,2,3,900
63952466@N03,2673,5,1334560362,1334561262,4,2,900
63952466@N03,2673,4,1334563501,1334564401,1,2,900
63999590@N00,2674,8,1238796632,1238797772,1,1,1140
64034302@N02,2675,13,1319455884,1319457684,1,1,1800
64076251@N02,2676,5,1402178304,1402179204,2,6,900
64076251@N02,2676,4,1402182357,1402183257,3,6,900
64076251@N02,2676,8,1402186149,1402187289,2,6,1140
64076251@N02,2676,2,1402195613,1402196003,3,6,390
64076251@N02,2676,8,1402197133,1402198273,2,6,1140
64076251@N02,2676,6,1402204837,1402205857,2,6,1020
64102362@N06,2677,4,1349598920,1349599820,2,3,900
64102362@N06,2677,6,1349602130,1349603150,2,3,1020
64102362@N06,2677,2,1349604654,1349605044,1,3,390
64102362@N06,2678,10,1393491016,1393492516,2,1,1500
64171510@N00,2679,4,1247024463,1247025212,2,6,749
64171510@N00,2679,8,1247025212,1247026352,4,6,1140
64171510@N00,2679,7,1247029174,1247030194,3,6,1020
64171510@N00,2679,6,1247031570,1247031753,2,6,183
64171510@N00,2679,4,1247031753,1247032653,2,6,900
64171510@N00,2679,5,1247035710,1247036610,2,6,900
64220937@N02,2680,8,1322615951,1322617091,2,1,1140
64342403@N02,2681,11,1292134969,1292136469,1,1,1500
64406224@N07,2682,9,1372332324,1372333824,2,1,1500
64440833@N05,2683,1,1303867552,1303867642,4,2,90
64440833@N05,2683,5,1303870739,1303871639,2,2,900
64440833@N05,2684,1,1313234616,1313234706,6,1,90
64440833@N05,2685,6,1387776500,1387777520,61,1,1020
64465885@N03,2686,8,1268022054,1268022123,2,3,69
64465885@N03,2686,1,1268022123,1268022213,2,3,90
64465885@N03,2686,2,1268029040,1268029430,2,3,390
64465885@N03,2687,12,1421221057,1421222557,7,1,1500
64466278@N03,2688,8,1332667194,1332667218,2,4,24
64466278@N03,2688,6,1332667218,1332667405,4,4,187
64466278@N03,2688,8,1332667405,1332667418,2,4,13
64466278@N03,2688,1,1332667418,1332667508,1,4,90
64478148@N07,2689,5,1338595922,1338596822,4,4,900
64478148@N07,2689,11,1338598861,1338599440,11,4,579
64478148@N07,2689,7,1338599440,1338600460,4,4,1020
64478148@N07,2689,6,1338602836,1338603856,5,4,1020
64478148@N07,2690,12,1351408361,1351408501,4,5,140
64478148@N07,2690,7,1351408501,1351408543,5,5,42
64478148@N07,2690,12,1351408543,1351408563,2,5,20
64478148@N07,2690,7,1351408563,1351408577,4,5,14
64478148@N07,2690,12,1351408577,1351410077,10,5,1500
64478148@N07,2691,5,1368757961,1368758861,22,4,900
64478148@N07,2691,8,1368767487,1368768627,3,4,1140
64478148@N07,2691,1,1368772929,1368773019,2,4,90
64478148@N07,2691,8,1368781322,1368782462,49,4,1140
64478148@N07,2692,8,1379059358,1379060498,7,5,1140
64478148@N07,2692,1,1379065119,1379065209,2,5,90
64478148@N07,2692,8,1379065318,1379066458,7,5,1140
64478148@N07,2692,13,1379067081,1379067576,2,5,495
64478148@N07,2692,1,1379067576,1379067666,2,5,90
64478148@N07,2693,6,1384069520,1384070540,37,3,1020
64478148@N07,2693,4,1384070756,1384070775,2,3,19
64478148@N07,2693,6,1384070775,1384071795,11,3,1020
64478148@N07,2694,6,1384238512,1384239532,1,1,1020
64478148@N07,2695,6,1400189112,1400190132,4,7,1020
64478148@N07,2695,1,1400200925,1400201015,40,7,90
64478148@N07,2695,8,1400202052,1400203192,8,7,1140
64478148@N07,2695,2,1400206311,1400206701,5,7,390
64478148@N07,2695,4,1400213758,1400214658,2,7,900
64478148@N07,2695,8,1400225191,1400226331,6,7,1140
64478148@N07,2695,1,1400236875,1400236965,41,7,90
64478148@N07,2696,1,1404516540,1404516630,2,11,90
64478148@N07,2696,8,1404519418,1404519621,2,11,203
64478148@N07,2696,13,1404519621,1404521421,5,11,1800
64478148@N07,2696,6,1404529480,1404530500,3,11,1020
64478148@N07,2696,8,1404557138,1404557299,3,11,161
64478148@N07,2696,1,1404557299,1404557389,3,11,90
64478148@N07,2696,8,1404557430,1404557455,2,11,25
64478148@N07,2696,1,1404557455,1404557545,6,11,90
64478148@N07,2696,8,1404557705,1404557832,2,11,127
64478148@N07,2696,1,1404557832,1404557854,2,11,22
64478148@N07,2696,8,1404557854,1404558994,13,11,1140
64478148@N07,2697,6,1406414821,1406415022,2,6,201
64478148@N07,2697,8,1406415022,1406415323,2,6,301
64478148@N07,2697,6,1406415323,1406415529,2,6,206
64478148@N07,2697,8,1406415529,1406415624,2,6,95
64478148@N07,2697,6,1406415624,1406415640,2,6,16
64478148@N07,2697,8,1406415640,1406416780,3,6,1140
64478148@N07,2698,4,1460007672,1460008572,6,1,900
64531190@N05,2699,9,1360226141,1360227641,1,1,1500
64542402@N07,2700,1,1355438568,1355438658,2,15,90
64542402@N07,2700,8,1355438683,1355439823,2,15,1140
64542402@N07,2700,1,1355440215,1355440305,3,15,90
64542402@N07,2700,5,1355442097,1355442997,3,15,900
64542402@N07,2700,10,1355444375,1355445875,6,15,1500
64542402@N07,2700,6,1355447343,1355448363,9,15,1020
64542402@N07,2700,13,1355454432,1355456232,5,15,1800
64542402@N07,2700,8,1355458872,1355459715,2,15,843
64542402@N07,2700,6,1355459715,1355460735,2,15,1020
64542402@N07,2700,7,1355462741,1355463761,3,15,1020
64542402@N07,2700,5,1355465251,1355466151,3,15,900
64542402@N07,2700,2,1355470800,1355471190,2,15,390
64542402@N07,2700,6,1355472145,1355473165,3,15,1020
64542402@N07,2700,3,1355474012,1355474432,2,15,420
64542402@N07,2700,9,1355475813,1355477313,7,15,1500
64561762@N00,2701,13,1271732828,1271734628,10,1,1800
64574649@N00,2702,5,1308969022,1308969922,1,1,900
64592191@N00,2703,8,1197883640,1197884780,2,1,1140
64604717@N03,2704,2,1330155623,1330156013,1,1,390
64654599@N00,2705,6,1327014785,1327015805,3,4,1020
64654599@N00,2705,13,1327020532,1327020673,8,4,141
64654599@N00,2705,4,1327020673,1327021573,2,4,900
64654599@N00,2705,1,1327033362,1327033452,4,4,90
64669762@N02,2706,5,1351412341,1351413241,1,1,900
64779594@N00,2707,10,1201323296,1201324796,1,1,1500
64779594@N00,2708,5,1377389121,1377390021,5,1,900
64779594@N00,2709,6,1394934504,1394935524,1,1,1020
64779594@N00,2710,6,1449730194,1449730283,2,2,89
64779594@N00,2710,4,1449730283,1449731183,1,2,900
64779594@N00,2711,5,1454204176,1454205076,6,2,900
64779594@N00,2711,12,1454208290,1454209790,3,2,1500
64779594@N00,2712,10,1466803386,1466804886,1,1,1500
64807684@N07,2713,1,1387412467,1387412557,1,1,90
64834051@N00,2714,13,1421619798,1421621598,2,13,1800
64834051@N00,2714,12,1421621846,1421623346,3,13,1500
64834051@N00,2714,13,1421624951,1421626751,2,13,1800
64834051@N00,2714,1,1421629500,1421629590,2,13,90
64834051@N00,2714,5,1421632600,1421633500,4,13,900
64834051@N00,2714,1,1421633977,1421634067,2,13,90
64834051@N00,2714,6,1421636516,1421637536,2,13,1020
64834051@N00,2714,1,1421640624,1421640714,2,13,90
64834051@N00,2714,2,1421642221,1421642611,4,13,390
64834051@N00,2714,6,1421647512,1421647901,2,13,389
64834051@N00,2714,4,1421647901,1421648801,2,13,900
64834051@N00,2714,8,1421651470,1421652610,3,13,1140
64834051@N00,2714,12,1421665419,1421666919,1,13,1500
64834051@N00,2715,12,1421710256,1421711756,1,1,1500
64834051@N00,2716,4,1438558966,1438559866,2,6,900
64834051@N00,2716,5,1438566401,1438567301,2,6,900
64834051@N00,2716,4,1438576893,1438577793,2,6,900
64834051@N00,2716,1,1438586819,1438586909,2,6,90
64834051@N00,2716,2,1438590021,1438590411,2,6,390
64834051@N00,2716,4,1438593891,1438594791,4,6,900
64991808@N02,2717,7,1316856703,1316857723,1,1,1020
65013125@N06,2718,10,1372289100,1372289867,2,3,767
65013125@N06,2718,1,1372289867,1372289957,2,3,90
65013125@N06,2718,5,1372290019,1372290919,2,3,900
65061709@N00,2719,4,1468800094,1468800994,1,1,900
65103228@N02,2720,7,1409881881,1409882901,1,1,1020
65103228@N02,2721,7,1409916348,1409917368,1,1,1020
65103228@N02,2722,7,1410184481,1410185501,1,1,1020
65103228@N02,2723,7,1431080502,1431081522,1,1,1020
65103228@N02,2724,7,1431300525,1431301545,1,1,1020
65103228@N02,2725,7,1449742278,1449743298,1,1,1020
65105672@N00,2726,12,1379123403,1379124903,2,2,1500
65105672@N00,2726,6,1379139018,1379140038,1,2,1020
65105672@N00,2727,11,1443247532,1443249032,3,2,1500
65105672@N00,2727,9,1443263005,1443264505,1,2,1500
65105672@N00,2728,8,1443568508,1443569648,4,8,1140
65105672@N00,2728,4,1443569905,1443570805,2,8,900
65105672@N00,2728,8,1443573969,1443575109,3,8,1140
65105672@N00,2728,6,1443580159,1443581179,3,8,1020
65105672@N00,2728,4,1443584627,1443585527,2,8,900
65105672@N00,2728,13,1443586866,1443587683,2,8,817
65105672@N00,2728,1,1443587683,1443587773,2,8,90
65105672@N00,2728,8,1443589424,1443590564,1,8,1140
65105672@N00,2729,8,1460595979,1460597119,3,1,1140
65105672@N00,2730,9,1460635340,1460636840,2,1,1500
65159120@N05,2731,10,1230067285,1230068785,2,1,1500
65159120@N05,2732,6,1323497199,1323498219,1,1,1020
65223931@N00,2733,5,1387837288,1387838188,2,5,900
65223931@N00,2733,4,1387841899,1387842799,2,5,900
65223931@N00,2733,1,1387844203,1387844293,2,5,90
65223931@N00,2733,4,1387854691,1387855591,2,5,900
65223931@N00,2733,6,1387872090,1387873110,5,5,1020
65228321@N00,2734,4,1448446372,1448447272,1,1,900
65367128@N00,2735,8,1198390411,1198390926,2,2,515
65367128@N00,2735,6,1198390926,1198391946,9,2,1020
65367128@N00,2736,8,1211509019,1211510159,2,2,1140
65367128@N00,2736,2,1211513615,1211514005,40,2,390
65367128@N00,2737,12,1261189909,1261191409,1,1,1500
65367128@N00,2738,1,1330400653,1330400743,1,1,90
65429168@N00,2739,8,1198263411,1198264551,4,2,1140
65429168@N00,2739,6,1198269213,1198270233,2,2,1020
65435894@N02,2740,1,1339641432,1339641522,1,1,90
65547015@N00,2741,8,1389316141,1389317281,2,8,1140
65547015@N00,2741,4,1389318300,1389319200,7,8,900
65547015@N00,2741,1,1389333843,1389333933,3,8,90
65547015@N00,2741,10,1389341386,1389342141,2,8,755
65547015@N00,2741,5,1389342141,1389343041,3,8,900
65547015@N00,2741,9,1389343944,1389345444,3,8,1500
65547015@N00,2741,13,1389349305,1389351105,2,8,1800
65547015@N00,2741,9,1389354944,1389356444,1,8,1500
65778609@N03,2742,6,1408407530,1408408550,3,3,1020
65778609@N03,2742,5,1408408596,1408409496,2,3,900
65778609@N03,2742,13,1408414020,1408415820,1,3,1800
65785294@N07,2743,7,1359961197,1359962217,2,2,1020
65785294@N07,2743,11,1359966201,1359967701,1,2,1500
65825924@N03,2744,1,1395654379,1395654469,2,1,90
65825924@N03,2745,8,1418805723,1418806863,2,2,1140
65825924@N03,2745,6,1418807607,1418808627,1,2,1020
65825924@N03,2746,13,1425976179,1425977979,2,3,1800
65825924@N03,2746,6,1425978460,1425979480,2,3,1020
65825924@N03,2746,1,1425979911,1425980001,1,3,90
65825924@N03,2747,11,1440460271,1440461771,2,5,1500
65825924@N03,2747,12,1440468971,1440470356,2,5,1385
65825924@N03,2747,1,1440470356,1440470446,2,5,90
65825924@N03,2747,12,1440470718,1440472218,3,5,1500
65825924@N03,2747,13,1440498471,1440500271,1,5,1800
65825924@N03,2748,4,1458025659,1458026559,2,3,900
65825924@N03,2748,8,1458027335,1458028475,2,3,1140
65825924@N03,2748,1,1458034705,1458034795,1,3,90
65825924@N03,2749,10,1458380540,1458382040,1,1,1500
65856564@N08,2750,5,1386029137,1386030037,1,1,900
65976254@N05,2751,8,1323416944,1323418084,1,1,1140
65987396@N00,2752,8,1308449221,1308450361,5,2,1140
65987396@N00,2752,1,1308470437,1308470527,1,2,90
66231302@N00,2753,6,1280459907,1280460927,1,1,1020
66242944@N03,2754,4,1254479953,1254480853,1,1,900
66372647@N06,2755,13,1470825801,1470827601,1,1,1800
66408130@N07,2756,10,1418949398,1418950898,1,1,1500
66506437@N08,2757,2,1315613711,1315614101,1,1,390
66718423@N03,2758,5,1229912604,1229913504,3,3,900
66718423@N03,2758,8,1229914374,1229915514,2,3,1140
66718423@N03,2758,5,1229916238,1229917138,2,3,900
66718423@N03,2759,8,1230388948,1230390088,4,3,1140
66718423@N03,2759,5,1230390900,1230391800,2,3,900
66718423@N03,2759,6,1230398804,1230399824,15,3,1020
66718423@N03,2760,5,1230862646,1230863546,3,1,900
66718423@N03,2761,5,1287543805,1287544705,3,1,900
66718423@N03,2762,1,1287922685,1287922775,4,3,90
66718423@N03,2762,5,1287922923,1287923823,8,3,900
66718423@N03,2762,8,1287931141,1287932281,2,3,1140
66718423@N03,2763,5,1287976874,1287977774,10,4,900
66718423@N03,2763,8,1287979185,1287980325,3,4,1140
66718423@N03,2763,5,1287981660,1287982560,2,4,900
66718423@N03,2763,8,1287985181,1287986321,3,4,1140
66749627@N00,2764,5,1469875002,1469875426,2,2,424
66749627@N00,2764,1,1469875426,1469875516,1,2,90
66749627@N00,2765,12,1469928040,1469929540,1,1,1500
66884161@N05,2766,1,1353128116,1353128206,1,1,90
67037430@N06,2767,6,1385970105,1385971125,2,5,1020
67037430@N06,2767,13,1385972854,1385973368,2,5,514
67037430@N06,2767,6,1385973368,1385973501,4,5,133
67037430@N06,2767,13,1385973501,1385973520,2,5,19
67037430@N06,2767,6,1385973520,1385974540,21,5,1020
67043514@N00,2768,5,1354071845,1354072745,1,1,900
67056982@N00,2769,13,1277343520,1277345320,5,5,1800
67056982@N00,2769,1,1277346955,1277347045,6,5,90
67056982@N00,2769,11,1277353914,1277353948,2,5,34
67056982@N00,2769,8,1277353948,1277355088,2,5,1140
67056982@N00,2769,6,1277356919,1277357939,4,5,1020
67093054@N00,2770,5,1324459128,1324460028,2,2,900
67093054@N00,2770,1,1324462950,1324463040,1,2,90
67123974@N05,2771,13,1361569542,1361571342,1,1,1800
67214151@N00,2772,7,1399333958,1399334978,12,1,1020
67214151@N00,2773,7,1411258963,1411259983,9,1,1020
67214151@N00,2774,7,1417337162,1417338182,14,1,1020
67214151@N00,2775,7,1423379891,1423380911,6,1,1020
67237167@N03,2776,8,1388295372,1388295457,2,5,85
67237167@N03,2776,12,1388295457,1388296957,7,5,1500
67237167@N03,2776,1,1388296970,1388297060,15,5,90
67237167@N03,2776,6,1388314570,1388315590,2,5,1020
67237167@N03,2776,9,1388319490,1388320990,2,5,1500
67246822@N00,2777,6,1323817506,1323818526,2,4,1020
67246822@N00,2777,13,1323826510,1323828310,2,4,1800
67246822@N00,2777,11,1323829430,1323830930,9,4,1500
67246822@N00,2777,5,1323837164,1323838064,1,4,900
67298936@N05,2778,8,1333955038,1333956178,1,1,1140
67298936@N05,2779,8,1346732539,1346733679,1,1,1140
67298936@N05,2780,8,1377860429,1377861569,2,1,1140
67299437@N06,2781,4,1432883995,1432884895,2,1,900
67299437@N06,2782,3,1433039677,1433040097,3,4,420
67299437@N06,2782,5,1433042883,1433043783,8,4,900
67299437@N06,2782,13,1433050592,1433051721,5,4,1129
67299437@N06,2782,12,1433051721,1433053221,2,4,1500
67299437@N06,2783,4,1433215517,1433216417,3,1,900
67299437@N06,2784,4,1433397878,1433398778,4,1,900
67299437@N06,2785,4,1433542990,1433543890,2,1,900
67489881@N07,2786,13,1318585576,1318587376,2,2,1800
67489881@N07,2786,12,1318597926,1318599426,1,2,1500
67527549@N00,2787,7,1294114717,1294115737,12,1,1020
67621043@N00,2788,6,1337122986,1337123955,2,2,969
67621043@N00,2788,5,1337123955,1337124855,1,2,900
67621043@N00,2789,11,1337722486,1337723986,1,1,1500
67621043@N00,2790,7,1426585485,1426586505,1,1,1020
67621043@N00,2791,1,1431047043,1431047133,1,1,90
67737010@N08,2792,1,1471169407,1471169497,2,1,90
68010648@N07,2793,1,1343435239,1343435329,2,7,90
68010648@N07,2793,10,1343436021,1343436032,2,7,11
68010648@N07,2793,5,1343436032,1343436190,3,7,158
68010648@N07,2793,1,1343436190,1343436280,3,7,90
68010648@N07,2793,8,1343436533,1343437673,2,7,1140
68010648@N07,2793,13,1343443737,1343445537,4,7,1800
68010648@N07,2793,6,1343450564,1343451584,2,7,1020
68010648@N07,2794,8,1343526640,1343527780,2,2,1140
68010648@N07,2794,1,1343528480,1343528570,1,2,90
68010648@N07,2795,6,1343572865,1343573885,1,1,1020
68067047@N00,2796,5,1428428589,1428429489,1,1,900
68169569@N07,2797,1,1244094456,1244094546,1,1,90
68174416@N00,2798,8,1304492923,1304494063,1,1,1140
68235353@N00,2799,6,1328517470,1328518490,2,1,1020
68311601@N00,2800,6,1245426297,1245426626,2,3,329
68311601@N00,2800,8,1245426626,1245427766,3,3,1140
68311601@N00,2800,13,1245429950,1245431750,1,3,1800
68350381@N03,2801,5,1369961669,1369962569,3,3,900
68350381@N03,2801,4,1369969549,1369970449,2,3,900
68350381@N03,2801,8,1369973408,1369974548,1,3,1140
68559301@N00,2802,1,1335947862,1335947952,2,1,90
68559301@N00,2803,13,1374473985,1374475785,1,1,1800
68577094@N06,2804,12,1352618008,1352619508,2,1,1500
68577094@N06,2805,1,1357129766,1357129856,1,1,90
68647410@N05,2806,10,1310175368,1310176868,1,1,1500
68821991@N03,2807,5,1438647585,1438648485,1,1,900
68821991@N03,2808,4,1438681833,1438682733,1,1,900
68997488@N00,2809,5,1451111905,1451112805,1,1,900
68998347@N00,2810,1,1396951647,1396951737,3,3,90
68998347@N00,2810,5,1396951755,1396952655,3,3,900
68998347@N00,2810,9,1396954007,1396955507,11,3,1500
69108709@N07,2811,8,1325915470,1325915876,2,3,406
69108709@N07,2811,4,1325915876,1325916776,2,3,900
69108709@N07,2811,7,1325930252,1325931272,2,3,1020
69108709@N07,2812,1,1326971117,1326971120,25,3,3
69108709@N07,2812,6,1326971120,1326972140,2,3,1020
69108709@N07,2812,8,1326981862,1326983002,1,3,1140
69108709@N07,2813,5,1333364358,1333365258,5,2,900
69108709@N07,2813,6,1333380267,1333381287,3,2,1020
69108709@N07,2814,1,1333418753,1333418843,2,4,90
69108709@N07,2814,6,1333419662,1333420682,2,4,1020
69108709@N07,2814,1,1333422792,1333422882,2,4,90
69108709@N07,2814,5,1333422951,1333423851,2,4,900
69108709@N07,2815,6,1333952311,1333953331,3,1,1020
69116795@N00,2816,2,1285811375,1285811765,35,1,390
69121654@N00,2817,12,1265684461,1265685961,4,1,1500
69121654@N00,2818,7,1268640673,1268641693,1,1,1020
69161765@N08,2819,10,1352188818,1352188838,2,3,20
69161765@N08,2819,5,1352188838,1352189738,3,3,900
69161765@N08,2819,9,1352191775,1352193275,2,3,1500
69161765@N08,2820,1,1352238487,1352238577,2,3,90
69161765@N08,2820,4,1352239236,1352240136,6,3,900
69161765@N08,2820,2,1352242050,1352242440,2,3,390
69206063@N00,2821,5,1307814452,1307815352,2,4,900
69206063@N00,2821,3,1307820749,1307821169,2,4,420
69206063@N00,2821,8,1307841947,1307843087,2,4,1140
69206063@N00,2821,6,1307844448,1307845468,1,4,1020
69206063@N00,2822,3,1307938817,1307939237,4,1,420
69206229@N03,2823,8,1319850717,1319851857,4,1,1140
69219361@N05,2824,2,1371425235,1371425625,5,1,390
69256737@N00,2825,8,1310775616,1310776756,1,1,1140
69256737@N00,2826,8,1310809119,1310810259,1,1,1140
69256737@N00,2827,8,1311235381,1311236521,3,1,1140
69271250@N00,2828,12,1448593920,1448595420,2,4,1500
69271250@N00,2828,4,1448604700,1448605600,6,4,900
69271250@N00,2828,10,1448607114,1448608614,2,4,1500
69271250@N00,2828,6,1448611029,1448612049,6,4,1020
69301930@N03,2829,6,1315799158,1315800178,2,2,1020
69301930@N03,2829,9,1315824650,1315826150,3,2,1500
69343619@N08,2830,5,1371248536,1371249436,1,1,900
69389488@N00,2831,10,1226268607,1226270107,149,1,1500
69393458@N02,2832,6,1403755583,1403756603,1,1,1020
69416229@N00,2833,9,1248083292,1248084792,2,1,1500
69574134@N00,2834,5,1221031591,1221032491,1,1,900
69574134@N00,2835,10,1346221263,1346222647,2,22,1384
69574134@N00,2835,5,1346222647,1346223547,5,22,900
69574134@N00,2835,10,1346226398,1346227405,4,22,1007
69574134@N00,2835,11,1346227405,1346227858,3,22,453
69574134@N00,2835,5,1346227858,1346227916,3,22,58
69574134@N00,2835,11,1346227916,1346227981,2,22,65
69574134@N00,2835,5,1346227981,1346228180,6,22,199
69574134@N00,2835,11,1346228180,1346228207,2,22,27
69574134@N00,2835,5,1346228207,1346228628,4,22,421
69574134@N00,2835,11,1346228628,1346228679,2,22,51
69574134@N00,2835,5,1346228679,1346228761,3,22,82
69574134@N00,2835,11,1346228761,1346228929,5,22,168
69574134@N00,2835,5,1346228929,1346229028,2,22,99
69574134@N00,2835,1,1346229028,1346229063,2,22,35
69574134@N00,2835,5,1346229063,1346229963,2,22,900
69574134@N00,2835,2,1346231063,1346231453,3,22,390
69574134@N00,2835,11,1346232493,1346233993,2,22,1500
69574134@N00,2835,1,1346238074,1346238164,4,22,90
69574134@N00,2835,6,1346240279,1346241299,6,22,1020
69574134@N00,2835,13,1346241494,1346242939,5,22,1445
69574134@N00,2835,4,1346242939,1346243839,3,22,900
69574134@N00,2835,9,1346252078,1346253578,4,22,1500
69591415@N02,2836,6,1309042905,1309043925,1,1,1020
69689125@N02,2837,4,1395967933,1395968833,1,1,900
69781071@N00,2838,1,1299536209,1299536299,27,1,90
69872692@N07,2839,4,1332312106,1332313006,1,1,900
69872692@N07,2840,6,1352531827,1352532847,1,1,1020
69872692@N07,2841,1,1380243303,1380243393,1,1,90
69880349@N08,2842,12,1449071734,1449073234,2,1,1500
69883003@N00,2843,5,1348611463,1348612363,2,1,900
69883003@N00,2844,11,1431826430,1431827930,1,1,1500
69926337@N00,2845,6,1288077133,1288078153,1,1,1020
69987114@N00,2846,12,1197598940,1197600440,1,1,1500
69987114@N00,2847,11,1230192623,1230194123,1,1,1500
69990708@N04,2848,9,1232675371,1232676871,1,1,1500
69990708@N04,2849,9,1259586000,1259587500,1,1,1500
70084804@N00,2850,2,1349165941,1349166331,1,1,390
70084804@N00,2851,6,1349483040,1349484060,2,1,1020
70626136@N00,2852,4,1348659646,1348660546,1,1,900
70862502@N00,2853,4,1330691200,1330692100,1,1,900
70862502@N00,2854,9,1330878546,1330880046,1,1,1500
70862502@N00,2855,2,1331349630,1331350020,1,1,390
70862502@N00,2856,5,1358250414,1358251314,1,1,900
70862502@N00,2857,6,1384229057,1384230077,2,2,1020
70862502@N00,2857,4,1384232157,1384233057,1,2,900
70862502@N00,2858,1,1384322820,1384322910,1,1,90
70926999@N00,2859,5,1406343937,1406344837,3,1,900
70926999@N00,2860,7,1406687125,1406687723,2,8,598
70926999@N00,2860,11,1406687723,1406688120,2,8,397
70926999@N00,2860,5,1406688120,1406689020,7,8,900
70926999@N00,2860,2,1406691739,1406692129,2,8,390
70926999@N00,2860,8,1406693695,1406694482,2,8,787
70926999@N00,2860,6,1406694482,1406695484,2,8,1002
70926999@N00,2860,3,1406695484,1406695904,6,8,420
70926999@N00,2860,6,1406697165,1406698185,2,8,1020
70928085@N00,2861,5,1224024850,1224025750,5,6,900
70928085@N00,2861,13,1224031610,1224033410,6,6,1800
70928085@N00,2861,8,1224037351,1224037388,2,6,37
70928085@N00,2861,11,1224037388,1224037413,2,6,25
70928085@N00,2861,8,1224037413,1224038553,4,6,1140
70928085@N00,2861,1,1224059009,1224059099,1,6,90
70944869@N00,2862,9,1423984884,1423986384,3,1,1500
70944869@N00,2863,6,1429586928,1429587948,2,2,1020
70944869@N00,2863,8,1429595914,1429597054,1,2,1140
71121295@N00,2864,8,1362960713,1362961853,1,1,1140
71128153@N00,2865,8,1369386390,1369386543,3,2,153
71128153@N00,2865,1,1369386543,1369386633,1,2,90
7128421@N05,2866,1,1457031361,1457031451,1,1,90
71307440@N00,2867,6,1401410839,1401411859,2,1,1020
71307440@N00,2868,4,1401442708,1401443608,1,1,900
71369646@N00,2869,2,1382778659,1382779049,2,2,390
71369646@N00,2869,6,1382780946,1382781966,1,2,1020
7151738@N03,2870,6,1353137235,1353138255,1,1,1020
7151738@N03,2871,11,1393282256,1393283756,11,2,1500
7151738@N03,2871,13,1393299101,1393300901,1,2,1800
7151738@N03,2872,2,1396668161,1396668551,3,2,390
7151738@N03,2872,13,1396671942,1396673742,2,2,1800
7151738@N03,2873,13,1415486233,1415487663,2,6,1430
7151738@N03,2873,4,1415487663,1415488563,19,6,900
7151738@N03,2873,13,1415500205,1415502005,3,6,1800
7151738@N03,2873,4,1415502060,1415502960,3,6,900
7151738@N03,2873,1,1415511505,1415511595,5,6,90
7151738@N03,2873,10,1415513293,1415514793,1,6,1500
7151738@N03,2874,12,1421536140,1421536516,2,3,376
7151738@N03,2874,8,1421536516,1421537656,2,3,1140
7151738@N03,2874,12,1421542074,1421543574,3,3,1500
71854985@N00,2875,1,1332556362,1332556452,3,1,90
71922377@N00,2876,1,1372998009,1372998099,1,1,90
71922377@N00,2877,6,1387599159,1387600179,1,1,1020
71922377@N00,2878,2,1409526898,1409527288,2,1,390
7195717@N05,2879,4,1294716187,1294717087,1,1,900
71965292@N00,2880,7,1213140401,1213141421,72,1,1020
7200488@N08,2881,8,1195594700,1195595840,1,1,1140
7206981@N03,2882,10,1244935991,1244936682,2,4,691
7206981@N03,2882,5,1244936682,1244937569,2,4,887
7206981@N03,2882,1,1244937569,1244937631,2,4,62
7206981@N03,2882,8,1244937631,1244938771,1,4,1140
72126458@N00,2883,5,1311125431,1311126331,3,3,900
72126458@N00,2883,10,1311141713,1311143213,76,3,1500
72126458@N00,2883,6,1311146309,1311147329,7,3,1020
72143850@N00,2884,5,1336040603,1336041503,1,1,900
72324747@N00,2885,1,1287401795,1287401885,1,1,90
72324747@N00,2886,8,1287803574,1287804714,1,1,1140
72324747@N00,2887,4,1288081056,1288081956,1,1,900
7239561@N06,2888,8,1230717605,1230718745,4,1,1140
7256184@N02,2889,12,1228955854,1228957354,13,2,1500
7256184@N02,2889,6,1228971280,1228972300,5,2,1020
7256454@N05,2890,12,1214364752,1214366252,24,2,1500
7256454@N05,2890,6,1214386481,1214387501,1,2,1020
7256454@N05,2891,2,1214616827,1214617217,11,2,390
7256454@N05,2891,8,1214621792,1214622932,2,2,1140
7256454@N05,2892,12,1214708857,1214710233,6,9,1376
7256454@N05,2892,4,1214710233,1214710836,18,9,603
7256454@N05,2892,8,1214710836,1214711341,17,9,505
7256454@N05,2892,2,1214711341,1214711665,14,9,324
7256454@N05,2892,4,1214711665,1214712565,9,9,900
7256454@N05,2892,12,1214713947,1214715447,39,9,1500
7256454@N05,2892,8,1214715657,1214716453,13,9,796
7256454@N05,2892,1,1214716453,1214716543,7,9,90
7256454@N05,2892,10,1214718903,1214720403,5,9,1500
7256454@N05,2893,6,1245032252,1245033272,5,1,1020
7256454@N05,2894,8,1310085057,1310085231,2,3,174
7256454@N05,2894,12,1310085231,1310086731,2,3,1500
7256454@N05,2894,6,1310088442,1310089462,9,3,1020
72589879@N00,2895,5,1348921249,1348922149,8,1,900
72670227@N06,2896,13,1429321724,1429323524,31,5,1800
72670227@N06,2896,5,1429327476,1429328376,7,5,900
72670227@N06,2896,4,1429333943,1429334843,24,5,900
72670227@N06,2896,5,1429337306,1429338206,24,5,900
72670227@N06,2896,10,1429346125,1429347625,1,5,1500
72685908@N00,2897,2,1380183792,1380184047,2,2,255
72685908@N00,2897,5,1380184047,1380184947,1,2,900
72776097@N00,2898,8,1206133393,1206134533,2,1,1140
72844756@N00,2899,5,1250022902,1250023802,1,1,900
72844756@N00,2900,8,1250069465,1250070605,1,1,1140
7286287@N03,2901,7,1341809676,1341809789,2,7,113
7286287@N03,2901,8,1341809789,1341810929,2,7,1140
7286287@N03,2901,4,1341813178,1341814078,3,7,900
7286287@N03,2901,5,1341819159,1341820059,2,7,900
7286287@N03,2901,4,1341820282,1341820364,2,7,82
7286287@N03,2901,6,1341820364,1341821384,2,7,1020
7286287@N03,2901,5,1341824657,1341825557,1,7,900
7287512@N02,2902,12,1270704520,1270706020,5,5,1500
7287512@N02,2902,7,1270708210,1270708338,2,5,128
7287512@N02,2902,12,1270708338,1270709838,4,5,1500
7287512@N02,2902,6,1270723263,1270724283,2,5,1020
7287512@N02,2902,1,1270724895,1270724985,1,5,90
72915363@N00,2903,1,1206950390,1206950480,1,1,90
73055057@N00,2904,8,1323407954,1323409094,8,1,1140
7305851@N07,2905,4,1353811190,1353812090,1,1,900
73105116@N00,2906,1,1273782646,1273782736,2,2,90
73105116@N00,2906,5,1273783038,1273783938,2,2,900
73114641@N00,2907,5,1425715048,1425715948,5,1,900
7311921@N08,2908,8,1189223731,1189224871,9,1,1140
7311921@N08,2909,8,1189287130,1189288270,1,1,1140
73234653@N00,2910,11,1373675146,1373676646,9,1,1500
73265016@N00,2911,6,1207867884,1207868904,4,1,1020
73427821@N00,2912,7,1257818412,1257819432,9,2,1020
73427821@N00,2912,1,1257831227,1257831317,4,2,90
73427821@N00,2913,6,1332589790,1332590810,44,5,1020
73427821@N00,2913,7,1332595046,1332596066,10,5,1020
73427821@N00,2913,6,1332606953,1332607890,4,5,937
73427821@N00,2913,4,1332607890,1332608790,26,5,900
73427821@N00,2913,8,1332608916,1332610056,6,5,1140
73427821@N00,2914,1,1345852875,1345852965,21,6,90
73427821@N00,2914,8,1345860803,1345861943,11,6,1140
73427821@N00,2914,4,1345866655,1345867555,4,6,900
73427821@N00,2914,8,1345869574,1345870714,14,6,1140
73427821@N00,2914,1,1345882969,1345883059,5,6,90
73427821@N00,2914,12,1345887604,1345889104,2,6,1500
73427821@N00,2915,6,1353034874,1353035894,5,1,1020
73427821@N00,2916,1,1369314649,1369314739,7,2,90
73427821@N00,2916,5,1369329798,1369330698,9,2,900
73427821@N00,2917,4,1369974048,1369974948,4,2,900
73427821@N00,2917,5,1369976178,1369977078,9,2,900
73451901@N00,2918,1,1350954266,1350954356,2,5,90
73451901@N00,2918,5,1350955086,1350955986,3,5,900
73451901@N00,2918,1,1350956843,1350956933,2,5,90
73451901@N00,2918,6,1350964465,1350965485,2,5,1020
73451901@N00,2918,8,1350974139,1350975279,2,5,1140
73451901@N00,2919,6,1351146546,1351146658,2,2,112
73451901@N00,2919,5,1351146658,1351147558,1,2,900
73451901@N00,2920,2,1358032591,1358032981,1,1,390
7349370@N04,2921,1,1242089664,1242089754,2,12,90
7349370@N04,2921,5,1242089831,1242089848,2,12,17
7349370@N04,2921,1,1242089848,1242089938,7,12,90
7349370@N04,2921,10,1242090155,1242090457,2,12,302
7349370@N04,2921,5,1242090457,1242091357,7,12,900
7349370@N04,2921,10,1242092109,1242093609,22,12,1500
7349370@N04,2921,8,1242094225,1242094425,2,12,200
7349370@N04,2921,2,1242094425,1242094815,5,12,390
7349370@N04,2921,7,1242097797,1242098817,9,12,1020
7349370@N04,2921,6,1242105453,1242106473,2,12,1020
7349370@N04,2921,8,1242111790,1242112888,7,12,1098
7349370@N04,2921,1,1242112888,1242112978,1,12,90
7349370@N04,2922,8,1260750738,1260751878,2,2,1140
7349370@N04,2922,12,1260755452,1260756952,1,2,1500
7356139@N05,2923,5,1362531100,1362532000,1,1,900
7357708@N03,2924,8,1319639783,1319640923,1,1,1140
73596184@N00,2925,13,1299284754,1299286554,2,2,1800
73596184@N00,2925,6,1299290707,1299291727,3,2,1020
73596184@N00,2926,5,1299900500,1299901400,1,1,900
7366969@N02,2927,1,1336083622,1336083712,69,1,90
7366969@N02,2928,13,1336867224,1336869024,51,1,1800
7366969@N02,2929,8,1391648353,1391649493,92,3,1140
7366969@N02,2929,9,1391673019,1391673260,2,3,241
7366969@N02,2929,8,1391673260,1391674400,19,3,1140
7366969@N02,2930,9,1392278431,1392279931,15,4,1500
7366969@N02,2930,8,1392281173,1392281254,3,4,81
7366969@N02,2930,1,1392281254,1392281344,3,4,90
7366969@N02,2930,10,1392281787,1392283287,2,4,1500
7366969@N02,2931,10,1392348735,1392350235,13,1,1500
7367216@N05,2932,4,1218796986,1218797886,1,1,900
7367216@N05,2933,4,1218859708,1218860608,1,1,900
7367216@N05,2934,5,1218932191,1218933091,2,2,900
7367216@N05,2934,4,1218935018,1218935918,1,2,900
7367216@N05,2935,12,1239060658,1239062158,2,1,1500
7367216@N05,2936,2,1341653009,1341653399,3,1,390
7367216@N05,2937,13,1348709056,1348710856,4,1,1800
7367216@N05,2938,8,1348921839,1348922979,4,1,1140
73719225@N00,2939,5,1379821286,1379822186,1,1,900
7372061@N07,2940,13,1286532879,1286534679,25,1,1800
73783753@N00,2941,11,1275200685,1275202185,2,1,1500
73799444@N00,2942,5,1198036005,1198036905,3,3,900
73799444@N00,2942,9,1198047382,1198048882,2,3,1500
73799444@N00,2942,1,1198052432,1198052522,1,3,90
7397135@N04,2943,8,1327550814,1327551954,1,1,1140
74025099@N03,2944,1,1387602743,1387602833,3,2,90
74025099@N03,2944,7,1387602914,1387603934,1,2,1020
74081331@N00,2945,6,1400916502,1400917522,1,1,1020
74089168@N00,2946,9,1382426176,1382427676,1,1,1500
74089168@N00,2947,4,1447829788,1447830688,1,1,900
74101007@N00,2948,2,1190096783,1190097173,79,1,390
7416177@N04,2949,13,1293656938,1293658738,19,1,1800
7416177@N04,2950,13,1293947832,1293949632,2,1,1800
74246558@N00,2951,4,1468214583,1468215483,1,1,900
74289372@N00,2952,4,1318980129,1318981029,3,4,900
74289372@N00,2952,6,1318985324,1318986344,2,4,1020
74289372@N00,2952,8,1318988819,1318989959,2,4,1140
74289372@N00,2952,5,1318994168,1318995068,4,4,900
74366817@N06,2953,6,1389936680,1389937700,2,2,1020
74366817@N06,2953,5,1389941426,1389942326,2,2,900
74366817@N06,2954,8,1400395717,1400396857,1,1,1140
74366817@N06,2955,5,1402021773,1402022673,1,1,900
74372164@N04,2956,11,1352416708,1352418208,1,1,1500
74417388@N08,2957,13,1382235128,1382236928,1,1,1800
74461555@N05,2958,10,1330756555,1330756631,2,3,76
74461555@N05,2958,2,1330756631,1330756651,2,3,20
74461555@N05,2958,10,1330756651,1330758151,1,3,1500
74461555@N05,2959,4,1336170501,1336171401,2,2,900
74461555@N05,2959,8,1336172455,1336173595,3,2,1140
74461555@N05,2960,8,1336258531,1336259671,6,1,1140
74461555@N05,2961,8,1338587142,1338587607,2,5,465
74461555@N05,2961,4,1338587607,1338588507,3,5,900
74461555@N05,2961,8,1338605385,1338606525,2,5,1140
74461555@N05,2961,1,1338632550,1338632640,5,5,90
74461555@N05,2961,8,1338633469,1338634609,1,5,1140
74461555@N05,2962,10,1338686061,1338687561,1,1,1500
74461555@N05,2963,1,1375440443,1375440533,3,5,90
74461555@N05,2963,5,1375441008,1375441506,2,5,498
74461555@N05,2963,1,1375441506,1375441596,2,5,90
74461555@N05,2963,4,1375441925,1375442084,2,5,159
74461555@N05,2963,6,1375442084,1375443104,1,5,1020
74461555@N05,2964,6,1417416836,1417417856,5,2,1020
74461555@N05,2964,12,1417420816,1417422316,1,2,1500
74689807@N03,2965,6,1393211542,1393212562,1,1,1020
74712199@N00,2966,6,1334890479,1334891499,1,1,1020
74741442@N08,2967,8,1450440288,1450441428,1,1,1140
74754977@N03,2968,8,1468995424,1468996564,1,1,1140
74822965@N00,2969,4,1370652109,1370653009,4,1,900
74865359@N00,2970,2,1386837604,1386837994,3,1,390
74865359@N00,2971,5,1386892705,1386893605,3,3,900
74865359@N00,2971,1,1386893875,1386893965,2,3,90
74865359@N00,2971,8,1386894639,1386895779,1,3,1140
74865359@N00,2972,9,1391588575,1391590075,6,2,1500
74865359@N00,2972,1,1391590134,1391590224,1,2,90
74878854@N00,2973,2,1337326115,1337326505,1,1,390
74939715@N05,2974,5,1364892450,1364893350,1,1,900
74985978@N00,2975,3,1353192069,1353192489,1,1,420
75091505@N00,2976,13,1347875988,1347877788,1,1,1800
75132636@N00,2977,8,1228107025,1228108165,19,1,1140
75338025@N07,2978,10,1383616623,1383616822,3,11,199
75338025@N07,2978,1,1383616822,1383616912,6,11,90
75338025@N07,2978,5,1383617052,1383617952,6,11,900
75338025@N07,2978,6,1383620951,1383621971,2,11,1020
75338025@N07,2978,4,1383624478,1383625378,3,11,900
75338025@N07,2978,6,1383625431,1383626451,3,11,1020
75338025@N07,2978,13,1383628261,1383630061,5,11,1800
75338025@N07,2978,10,1383633134,1383634634,15,11,1500
75338025@N07,2978,8,1383636115,1383636614,4,11,499
75338025@N07,2978,2,1383636614,1383636868,2,11,254
75338025@N07,2978,6,1383636868,1383637888,2,11,1020
75421381@N00,2979,4,1223365328,1223366228,1,1,900
75555566@N05,2980,11,1349398935,1349400435,11,1,1500
75601845@N06,2981,7,1209105142,1209106162,12,1,1020
75601845@N06,2982,7,1209533898,1209534918,11,1,1020
75601845@N06,2983,7,1209896605,1209897625,45,1,1020
75601845@N06,2984,7,1210247156,1210248176,6,1,1020
75601845@N06,2985,7,1283837474,1283838494,441,1,1020
75601845@N06,2986,7,1284283252,1284284272,3,1,1020
75601845@N06,2987,7,1322992269,1322993289,226,1,1020
75601845@N06,2988,7,1323437073,1323438093,52,1,1020
75601845@N06,2989,7,1323684201,1323685221,67,1,1020
75637646@N07,2990,6,1423358664,1423359684,2,2,1020
75637646@N07,2990,4,1423369204,1423370104,1,2,900
7573710@N02,2991,1,1231628798,1231628888,1,1,90
7573710@N02,2992,5,1232272238,1232273138,10,1,900
75990687@N05,2993,5,1454191715,1454192615,3,3,900
75990687@N05,2993,9,1454195157,1454196657,5,3,1500
75990687@N05,2993,7,1454201086,1454202106,1,3,1020
76024515@N07,2994,8,1316318795,1316319935,2,1,1140
76024515@N07,2995,13,1347934886,1347936686,2,2,1800
76024515@N07,2995,5,1347946570,1347947470,1,2,900
76024515@N07,2996,6,1348114367,1348115387,2,2,1020
76024515@N07,2996,9,1348129778,1348131278,1,2,1500
76032222@N00,2997,10,1223940156,1223941656,2,1,1500
7612058@N04,2998,1,1254160284,1254160374,3,3,90
7612058@N04,2998,11,1254165018,1254165433,2,3,415
7612058@N04,2998,5,1254165433,1254166333,1,3,900
7612058@N04,2999,8,1254399553,1254400693,2,2,1140
7612058@N04,2999,1,1254411619,1254411709,1,2,90
76131376@N03,3000,1,1361058670,1361058760,2,4,90
76131376@N03,3000,8,1361064712,1361065852,2,4,1140
76131376@N03,3000,5,1361066410,1361067310,4,4,900
76131376@N03,3000,6,1361074494,1361075514,1,4,1020
76151808@N00,3001,10,1234481431,1234482931,2,8,1500
76151808@N00,3001,11,1234483088,1234484588,6,8,1500
76151808@N00,3001,8,1234485776,1234486266,2,8,490
76151808@N00,3001,1,1234486266,1234486356,3,8,90
76151808@N00,3001,8,1234488740,1234489880,3,8,1140
76151808@N00,3001,6,1234498467,1234499487,6,8,1020
76151808@N00,3001,4,1234501825,1234502725,2,8,900
76151808@N00,3001,9,1234514875,1234516375,2,8,1500
76151808@N00,3002,11,1234741043,1234742543,4,6,1500
76151808@N00,3002,7,1234745129,1234746149,2,6,1020
76151808@N00,3002,11,1234746855,1234748355,2,6,1500
76151808@N00,3002,4,1234752142,1234753042,2,6,900
76151808@N00,3002,10,1234763960,1234765460,2,6,1500
76151808@N00,3002,5,1234766836,1234767736,3,6,900
76151808@N00,3003,1,1266025105,1266025195,3,8,90
76151808@N00,3003,11,1266029008,1266030508,2,8,1500
76151808@N00,3003,8,1266036007,1266036803,2,8,796
76151808@N00,3003,1,1266036803,1266036893,2,8,90
76151808@N00,3003,6,1266042379,1266043078,2,8,699
76151808@N00,3003,4,1266043078,1266043092,2,8,14
76151808@N00,3003,3,1266043092,1266043512,2,8,420
76151808@N00,3003,7,1266044163,1266045183,4,8,1020
76151808@N00,3004,11,1266282196,1266283696,2,9,1500
76151808@N00,3004,6,1266287720,1266288740,6,9,1020
76151808@N00,3004,8,1266296478,1266297618,5,9,1140
76151808@N00,3004,1,1266299519,1266299609,3,9,90
76151808@N00,3004,7,1266307881,1266308367,2,9,486
76151808@N00,3004,1,1266308367,1266308457,2,9,90
76151808@N00,3004,10,1266308509,1266309781,2,9,1272
76151808@N00,3004,5,1266309781,1266310681,2,9,900
76151808@N00,3004,9,1266311114,1266312614,3,9,1500
76151808@N00,3005,1,1266452148,1266452238,3,4,90
76151808@N00,3005,6,1266454942,1266455490,3,4,548
76151808@N00,3005,4,1266455490,1266456390,2,4,900
76151808@N00,3005,1,1266459722,1266459812,1,4,90
76151808@N00,3006,2,1297898209,1297898599,2,4,390
76151808@N00,3006,1,1297904725,1297904815,4,4,90
76151808@N00,3006,6,1297917039,1297918059,5,4,1020
76151808@N00,3006,1,1297928651,1297928741,1,4,90
76151808@N00,3007,1,1298518142,1298518232,2,1,90
76151808@N00,3008,13,1345687339,1345688576,2,3,1237
76151808@N00,3008,3,1345688576,1345688996,2,3,420
76151808@N00,3008,2,1345693029,1345693419,1,3,390
76151808@N00,3009,8,1361502472,1361503612,1,1,1140
76151808@N00,3010,6,1388393973,1388394993,2,2,1020
76151808@N00,3010,2,1388395435,1388395825,1,2,390
76151808@N00,3011,2,1424226404,1424226794,2,3,390
76151808@N00,3011,1,1424230382,1424230472,4,3,90
76151808@N00,3011,13,1424236739,1424238539,1,3,1800
76151808@N00,3012,6,1424583203,1424584223,2,1,1020
76151808@N00,3013,6,1451376298,1451377318,2,1,1020
76152450@N07,3014,1,1280900708,1280900798,1,1,90
76235804@N08,3015,3,1355982411,1355982831,1,1,420
76235804@N08,3016,2,1356072197,1356072587,2,2,390
76235804@N08,3016,8,1356072699,1356073839,1,2,1140
7635377@N05,3017,5,1221293016,1221293916,8,1,900
76430348@N02,3018,2,1338093703,1338094093,8,2,390
76430348@N02,3018,6,1338100252,1338101272,1,2,1020
7664041@N07,3019,8,1391405053,1391406193,10,1,1140
7664041@N07,3020,8,1391474636,1391475776,11,1,1140
76663697@N00,3021,13,1212558143,1212559943,4,5,1800
76663697@N00,3021,8,1212561641,1212562056,2,5,415
76663697@N00,3021,4,1212562056,1212562338,2,5,282
76663697@N00,3021,6,1212562338,1212563358,10,5,1020
76663697@N00,3021,8,1212567926,1212569066,1,5,1140
76665138@N00,3022,8,1263349529,1263350669,1,1,1140
76665138@N00,3023,2,1274404551,1274404941,1,1,390
76665138@N00,3024,4,1326152306,1326153206,3,7,900
76665138@N00,3024,3,1326153446,1326153866,3,7,420
76665138@N00,3024,6,1326154756,1326155776,4,7,1020
76665138@N00,3024,2,1326157165,1326157555,5,7,390
76665138@N00,3024,5,1326160710,1326161610,2,7,900
76665138@N00,3024,12,1326162727,1326164227,5,7,1500
76665138@N00,3024,8,1326165393,1326166533,3,7,1140
76665138@N00,3025,4,1326429092,1326429992,4,4,900
76665138@N00,3025,6,1326432621,1326433641,4,4,1020
76665138@N00,3025,12,1326434810,1326436310,6,4,1500
76665138@N00,3025,10,1326438242,1326439742,1,4,1500
76665138@N00,3026,4,1326494725,1326495625,2,3,900
76665138@N00,3026,12,1326497448,1326498948,3,3,1500
76665138@N00,3026,4,1326499161,1326500061,1,3,900
76692421@N02,3027,4,1355677882,1355678782,1,1,900
76704164@N00,3028,5,1371620618,1371621518,3,3,900
76704164@N00,3028,6,1371640354,1371641374,2,3,1020
76704164@N00,3028,9,1371648268,1371649768,1,3,1500
76704164@N00,3029,12,1371697060,1371698560,1,1,1500
76730958@N07,3030,13,1365035819,1365037619,1,1,1800
76730958@N07,3031,13,1365288416,1365290216,2,4,1800
76730958@N07,3031,4,1365290356,1365291256,2,4,900
76730958@N07,3031,1,1365297219,1365297309,2,4,90
76730958@N07,3031,5,1365303270,1365304170,1,4,900
76766156@N06,3032,10,1359869726,1359871142,4,17,1416
76766156@N06,3032,5,1359871142,1359872042,5,17,900
76766156@N06,3032,8,1359872813,1359873953,3,17,1140
76766156@N06,3032,4,1359874457,1359875357,4,17,900
76766156@N06,3032,6,1359875623,1359876643,4,17,1020
76766156@N06,3032,2,1359877454,1359877652,3,17,198
76766156@N06,3032,12,1359877652,1359879152,2,17,1500
76766156@N06,3032,2,1359881180,1359881570,3,17,390
76766156@N06,3032,12,1359882669,1359884169,11,17,1500
76766156@N06,3032,13,1359885552,1359886876,14,17,1324
76766156@N06,3032,4,1359886876,1359887068,3,17,192
76766156@N06,3032,8,1359887068,1359887227,2,17,159
76766156@N06,3032,1,1359887227,1359887317,3,17,90
76766156@N06,3032,6,1359893916,1359894936,3,17,1020
76766156@N06,3032,10,1359897664,1359899164,2,17,1500
76766156@N06,3032,9,1359900324,1359901824,16,17,1500
76766156@N06,3032,8,1359903207,1359904347,3,17,1140
76766156@N06,3033,5,1390906441,1390907019,2,2,578
76766156@N06,3033,1,1390907019,1390907109,7,2,90
7677428@N07,3034,4,1350799601,1350799672,2,3,71
7677428@N07,3034,8,1350799672,1350799707,2,3,35
7677428@N07,3034,13,1350799707,1350801507,1,3,1800
76954449@N08,3035,5,1368577265,1368578165,1,1,900
7717393@N02,3036,11,1264004482,1264005982,1,1,1500
77179348@N00,3037,10,1342078755,1342079126,3,19,371
77179348@N00,3037,1,1342079126,1342079216,3,19,90
77179348@N00,3037,5,1342079320,1342079411,2,19,91
77179348@N00,3037,1,1342079411,1342079501,2,19,90
77179348@N00,3037,8,1342080191,1342081331,8,19,1140
77179348@N00,3037,7,1342081542,1342082153,13,19,611
77179348@N00,3037,8,1342082153,1342083293,13,19,1140
77179348@N00,3037,12,1342083638,1342084076,7,19,438
77179348@N00,3037,7,1342084076,1342084411,2,19,335
77179348@N00,3037,1,1342084411,1342084501,3,19,90
77179348@N00,3037,5,1342088235,1342089135,10,19,900
77179348@N00,3037,1,1342089721,1342089811,2,19,90
77179348@N00,3037,11,1342089970,1342090283,2,19,313
77179348@N00,3037,6,1342090283,1342091303,8,19,1020
77179348@N00,3037,4,1342091488,1342091706,2,19,218
77179348@N00,3037,13,1342091706,1342092992,3,19,1286
77179348@N00,3037,5,1342092992,1342093892,4,19,900
77179348@N00,3037,10,1342094498,1342094823,2,19,325
77179348@N00,3037,9,1342094823,1342096323,15,19,1500
77179348@N00,3038,11,1342246373,1342246377,2,6,4
77179348@N00,3038,8,1342246377,1342246433,2,6,56
77179348@N00,3038,2,1342246433,1342246823,7,6,390
77179348@N00,3038,7,1342252511,1342253531,13,6,1020
77179348@N00,3038,12,1342253787,1342254002,2,6,215
77179348@N00,3038,1,1342254002,1342254092,2,6,90
77179348@N00,3039,10,1442566571,1442566843,3,7,272
77179348@N00,3039,1,1442566843,1442566933,7,7,90
77179348@N00,3039,10,1442566965,1442566998,2,7,33
77179348@N00,3039,5,1442566998,1442567898,15,7,900
77179348@N00,3039,10,1442568761,1442568927,3,7,166
77179348@N00,3039,9,1442568927,1442570427,61,7,1500
77179348@N00,3039,10,1442572577,1442574077,5,7,1500
77179348@N00,3040,1,1442632887,1442632977,2,24,90
77179348@N00,3040,13,1442633043,1442633113,6,24,70
77179348@N00,3040,4,1442633113,1442634013,16,24,900
77179348@N00,3040,13,1442634993,1442635041,2,24,48
77179348@N00,3040,1,1442635041,1442635131,3,24,90
77179348@N00,3040,10,1442635663,1442635724,3,24,61
77179348@N00,3040,5,1442635724,1442636624,15,24,900
77179348@N00,3040,1,1442638258,1442638348,4,24,90
77179348@N00,3040,13,1442638393,1442638721,2,24,328
77179348@N00,3040,4,1442638721,1442639621,22,24,900
77179348@N00,3040,8,1442640177,1442641317,30,24,1140
77179348@N00,3040,2,1442641896,1442642219,10,24,323
77179348@N00,3040,6,1442642219,1442642259,3,24,40
77179348@N00,3040,2,1442642259,1442642304,3,24,45
77179348@N00,3040,6,1442642304,1442642468,3,24,164
77179348@N00,3040,8,1442642468,1442642833,2,24,365
77179348@N00,3040,11,1442642833,1442642869,2,24,36
77179348@N00,3040,8,1442642869,1442643115,2,24,246
77179348@N00,3040,6,1442643115,1442644135,25,24,1020
77179348@N00,3040,13,1442650340,1442652140,9,24,1800
77179348@N00,3040,4,1442652349,1442652351,2,24,2
77179348@N00,3040,13,1442652351,1442654006,31,24,1655
77179348@N00,3040,2,1442654006,1442654396,20,24,390
77179348@N00,3040,6,1442655020,1442656040,25,24,1020
77395664@N00,3041,13,1412432793,1412434593,3,10,1800
77395664@N00,3041,4,1412435348,1412436122,3,10,774
77395664@N00,3041,6,1412436122,1412436293,2,10,171
77395664@N00,3041,2,1412436293,1412436683,4,10,390
77395664@N00,3041,1,1412438095,1412438107,2,10,12
77395664@N00,3041,8,1412438107,1412438131,2,10,24
77395664@N00,3041,1,1412438131,1412438221,4,10,90
77395664@N00,3041,8,1412438427,1412438495,2,10,68
77395664@N00,3041,1,1412438495,1412438585,3,10,90
77395664@N00,3041,5,1412441114,1412442014,2,10,900
77437178@N00,3042,8,1273183020,1273184160,3,3,1140
77437178@N00,3042,7,1273200941,1273201961,2,3,1020
77437178@N00,3042,8,1273202157,1273203297,1,3,1140
77437178@N00,3043,8,1346380334,1346381474,1,1,1140
77437178@N00,3044,8,1346466489,1346467629,1,1,1140
77463997@N03,3045,13,1355093491,1355095291,1,1,1800
77463997@N03,3046,4,1358140392,1358141292,1,1,900
77463997@N03,3047,8,1367548986,1367550126,1,1,1140
77463997@N03,3048,4,1386040765,1386041665,1,1,900
77463997@N03,3049,4,1388456716,1388457616,1,1,900
77463997@N03,3050,4,1388546186,1388547086,1,1,900
77463997@N03,3051,13,1394104324,1394106124,1,1,1800
77463997@N03,3052,8,1406933793,1406934933,1,1,1140
77463997@N03,3053,8,1420549519,1420550659,1,1,1140
77463997@N03,3054,1,1425109229,1425109319,1,1,90
77463997@N03,3055,12,1425898554,1425900054,1,1,1500
77463997@N03,3056,10,1440724571,1440726071,1,1,1500
77463997@N03,3057,10,1441368936,1441370436,1,1,1500
77463997@N03,3058,8,1442527643,1442528783,1,1,1140
77463997@N03,3059,6,1446885152,1446886172,1,1,1020
77463997@N03,3060,6,1447233127,1447234147,1,1,1020
77463997@N03,3061,6,1447668137,1447669157,1,1,1020
77463997@N03,3062,10,1449203278,1449204778,1,1,1500
77463997@N03,3063,8,1453415851,1453416991,1,1,1140
77463997@N03,3064,10,1454014840,1454016340,1,1,1500
77463997@N03,3065,10,1458255437,1458256937,1,1,1500
77463997@N03,3066,6,1459372979,1459373999,1,1,1020
77463997@N03,3067,4,1459784490,1459785390,1,1,900
77463997@N03,3068,4,1459990068,1459990968,1,1,900
77503031@N00,3069,2,1261672145,1261672153,2,7,8
77503031@N00,3069,8,1261672153,1261672478,15,7,325
77503031@N00,3069,2,1261672478,1261672531,2,7,53
77503031@N00,3069,8,1261672531,1261672612,4,7,81
77503031@N00,3069,6,1261672612,1261672621,2,7,9
77503031@N00,3069,8,1261672621,1261672911,5,7,290
77503031@N00,3069,2,1261672911,1261673301,1,7,390
77545914@N00,3070,5,1268010520,1268010950,4,7,430
77545914@N00,3070,1,1268010950,1268011040,2,7,90
77545914@N00,3070,6,1268014566,1268015586,6,7,1020
77545914@N00,3070,4,1268016494,1268017394,2,7,900
77545914@N00,3070,5,1268027264,1268028164,3,7,900
77545914@N00,3070,2,1268033748,1268034138,8,7,390
77545914@N00,3070,6,1268045147,1268046167,1,7,1020
77573771@N00,3071,4,1230253621,1230254521,1,1,900
77692940@N00,3072,2,1367544719,1367545109,2,1,390
7772172@N02,3073,8,1298689781,1298690921,32,1,1140
77744839@N00,3074,13,1389676108,1389677908,2,7,1800
77744839@N00,3074,4,1389678075,1389678975,2,7,900
77744839@N00,3074,5,1389679894,1389680794,2,7,900
77744839@N00,3074,12,1389683304,1389683852,2,7,548
77744839@N00,3074,7,1389683852,1389684192,2,7,340
77744839@N00,3074,2,1389684192,1389684582,3,7,390
77744839@N00,3074,13,1389686157,1389687957,6,7,1800
77744839@N00,3075,5,1389737583,1389738483,3,4,900
77744839@N00,3075,8,1389739866,1389741006,2,4,1140
77744839@N00,3075,11,1389742326,1389743826,2,4,1500
77744839@N00,3075,6,1389744769,1389745789,2,4,1020
7776897@N02,3076,8,1223164185,1223165325,21,1,1140
7776897@N02,3077,8,1223254766,1223255906,3,1,1140
7784444@N07,3078,8,1253427752,1253428892,152,1,1140
7784444@N07,3079,8,1284418242,1284419382,301,1,1140
7784444@N07,3080,8,1299366686,1299367826,163,1,1140
7784444@N07,3081,8,1307142269,1307143409,108,1,1140
7784444@N07,3082,8,1376695662,1376696802,40,1,1140
77932199@N07,3083,10,1341022488,1341023988,21,2,1500
77932199@N07,3083,8,1341031235,1341032375,29,2,1140
77932199@N07,3084,6,1341395120,1341396140,2,2,1020
77932199@N07,3084,1,1341401034,1341401124,5,2,90
77932199@N07,3085,1,1356267241,1356267331,1,1,90
77932199@N07,3086,5,1374373927,1374374827,1,1,900
77987119@N08,3087,8,1327292600,1327293740,8,2,1140
77987119@N08,3087,4,1327297283,1327298183,1,2,900
78027754@N00,3088,2,1361590805,1361591195,1,1,390
78027754@N00,3089,1,1361702952,1361703042,1,1,90
7804123@N08,3090,2,1410244304,1410244694,2,2,390
7804123@N08,3090,4,1410267683,1410268583,1,2,900
78089576@N06,3091,6,1333250233,1333251253,1,1,1020
78132024@N00,3092,6,1389320926,1389321946,1,1,1020
78262954@N05,3093,8,1364857756,1364858896,42,1,1140
78299922@N08,3094,5,1281569422,1281570322,2,2,900
78299922@N08,3094,8,1281573293,1281574433,1,2,1140
7830943@N03,3095,4,1381637289,1381638189,3,4,900
7830943@N03,3095,11,1381640124,1381641624,2,4,1500
7830943@N03,3095,6,1381643136,1381643911,2,4,775
7830943@N03,3095,8,1381643911,1381645051,1,4,1140
78345092@N07,3096,4,1372735276,1372736176,2,5,900
78345092@N07,3096,13,1372745633,1372747433,2,5,1800
78345092@N07,3096,5,1372748220,1372748348,2,5,128
78345092@N07,3096,1,1372748348,1372748438,2,5,90
78345092@N07,3096,5,1372751575,1372752475,1,5,900
78364960@N04,3097,8,1338172445,1338173585,3,3,1140
78364960@N04,3097,12,1338179126,1338180626,4,3,1500
78364960@N04,3097,9,1338202830,1338204330,2,3,1500
78364960@N04,3098,12,1343731236,1343732736,1,1,1500
78364960@N04,3099,8,1344492636,1344493776,3,1,1140
78364960@N04,3100,13,1353121293,1353123093,4,1,1800
78364960@N04,3101,11,1354251167,1354252667,3,2,1500
78364960@N04,3101,8,1354252722,1354253862,2,2,1140
78364960@N04,3102,6,1354956506,1354957526,1,1,1020
78364960@N04,3103,12,1361153282,1361154782,1,1,1500
78364960@N04,3104,7,1368257936,1368258956,2,3,1020
78364960@N04,3104,8,1368259918,1368261058,4,3,1140
78364960@N04,3104,5,1368262704,1368263604,4,3,900
78364960@N04,3105,13,1369986247,1369986568,2,5,321
78364960@N04,3105,4,1369986568,1369987468,2,5,900
78364960@N04,3105,1,1369991781,1369991871,2,5,90
78364960@N04,3105,7,1369998546,1369999452,2,5,906
78364960@N04,3105,5,1369999452,1370000352,1,5,900
78364960@N04,3106,8,1374144315,1374145455,4,7,1140
78364960@N04,3106,4,1374146609,1374146868,2,7,259
78364960@N04,3106,6,1374146868,1374147888,2,7,1020
78364960@N04,3106,5,1374149994,1374150894,3,7,900
78364960@N04,3106,8,1374152783,1374153116,2,7,333
78364960@N04,3106,2,1374153116,1374153506,2,7,390
78364960@N04,3106,1,1374153587,1374153677,1,7,90
78364960@N04,3107,11,1379062296,1379063796,2,4,1500
78364960@N04,3107,1,1379076858,1379076948,3,4,90
78364960@N04,3107,13,1379079286,1379081086,2,4,1800
78364960@N04,3107,8,1379082245,1379083385,1,4,1140
78364960@N04,3108,9,1381825879,1381827379,1,1,1500
78364960@N04,3109,8,1382225278,1382225505,3,4,227
78364960@N04,3109,2,1382225505,1382225895,3,4,390
78364960@N04,3109,13,1382237128,1382238928,6,4,1800
78364960@N04,3109,8,1382246157,1382247297,2,4,1140
78364960@N04,3110,1,1386300868,1386300958,5,3,90
78364960@N04,3110,5,1386303418,1386304318,2,3,900
78364960@N04,3110,1,1386306727,1386306817,1,3,90
78364960@N04,3111,9,1397386138,1397387638,1,1,1500
78364960@N04,3112,1,1398908477,1398908567,3,3,90
78364960@N04,3112,8,1398918141,1398919281,2,3,1140
78364960@N04,3112,1,1398921835,1398921925,3,3,90
78364960@N04,3113,6,1404615437,1404616457,5,1,1020
78364960@N04,3114,6,1414913241,1414914261,2,2,1020
78364960@N04,3114,9,1414917174,1414918674,2,2,1500
78364960@N04,3115,13,1432880299,1432882099,2,2,1800
78364960@N04,3115,6,1432894365,1432895385,1,2,1020
78364960@N04,3116,1,1434282907,1434282997,2,2,90
78364960@N04,3116,9,1434286235,1434287735,1,2,1500
78364960@N04,3117,10,1435146786,1435148286,1,1,1500
78364960@N04,3118,7,1449213778,1449214798,2,2,1020
78364960@N04,3118,6,1449216878,1449217898,2,2,1020
78364960@N04,3119,6,1450866911,1450867931,1,1,1020
78364960@N04,3120,8,1461396182,1461397322,8,3,1140
78364960@N04,3120,7,1461406175,1461407195,6,3,1020
78364960@N04,3120,8,1461410411,1461411551,1,3,1140
78364960@N04,3121,5,1463184534,1463185434,1,1,900
78364960@N04,3122,13,1466250850,1466252650,1,1,1800
78427651@N00,3123,4,1356828982,1356829882,1,1,900
7843077@N06,3124,4,1275087078,1275087978,1,1,900
7843077@N06,3125,4,1275178728,1275179628,3,1,900
7849988@N04,3126,2,1428979451,1428979841,1,1,390
7849988@N04,3127,12,1466472777,1466474277,3,5,1500
7849988@N04,3127,5,1466479546,1466480443,3,5,897
7849988@N04,3127,4,1466480443,1466480464,2,5,21
7849988@N04,3127,3,1466480464,1466480884,2,5,420
7849988@N04,3127,6,1466501943,1466502963,11,5,1020
78562800@N05,3128,4,1362528629,1362529529,1,1,900
78569471@N00,3129,1,1214449964,1214450054,5,3,90
78569471@N00,3129,8,1214455654,1214456794,12,3,1140
78569471@N00,3129,11,1214457560,1214459060,1,3,1500
78779574@N00,3130,4,1335921294,1335921603,2,10,309
78779574@N00,3130,11,1335921603,1335923103,2,10,1500
78779574@N00,3130,1,1335926117,1335926207,4,10,90
78779574@N00,3130,8,1335943490,1335944630,3,10,1140
78779574@N00,3130,2,1335944705,1335945095,6,10,390
78779574@N00,3130,6,1335948857,1335949877,10,10,1020
78779574@N00,3130,8,1335953526,1335953671,3,10,145
78779574@N00,3130,1,1335953671,1335953761,9,10,90
78779574@N00,3130,9,1335954541,1335956041,80,10,1500
78779574@N00,3130,1,1335959235,1335959325,6,10,90
7886635@N06,3131,6,1425249760,1425250780,5,2,1020
7886635@N06,3131,10,1425277892,1425279392,12,2,1500
79023626@N00,3132,6,1298170420,1298171440,1,1,1020
79023626@N00,3133,4,1305800661,1305801561,1,1,900
79023626@N00,3134,13,1305838146,1305839946,2,3,1800
79023626@N00,3134,8,1305851854,1305852648,2,3,794
79023626@N00,3134,13,1305852648,1305854448,1,3,1800
79023626@N00,3135,6,1316853097,1316854117,2,1,1020
79023626@N00,3136,2,1335400199,1335400589,1,1,390
79023626@N00,3137,8,1345801681,1345802821,1,1,1140
79023626@N00,3138,2,1354753053,1354753443,2,2,390
79023626@N00,3138,12,1354770985,1354772485,1,2,1500
79023626@N00,3139,12,1356151636,1356153136,2,2,1500
79023626@N00,3139,1,1356153857,1356153947,1,2,90
79092915@N00,3140,5,1280556350,1280557250,2,2,900
79092915@N00,3140,8,1280561121,1280562261,1,2,1140
79121533@N00,3141,13,1388899485,1388901285,1,1,1800
79128990@N00,3142,4,1405858275,1405859175,1,1,900
7915108@N06,3143,4,1295831793,1295832693,1,1,900
79169260@N00,3144,6,1292657384,1292658404,1,1,1020
7917124@N07,3145,4,1458017818,1458018718,13,5,900
7917124@N07,3145,8,1458025320,1458026460,4,5,1140
7917124@N07,3145,7,1458027992,1458029012,8,5,1020
7917124@N07,3145,8,1458033394,1458034534,2,5,1140
7917124@N07,3145,1,1458038040,1458038130,2,5,90
79172203@N00,3146,10,1291581318,1291582818,3,14,1500
79172203@N00,3146,2,1291583212,1291583602,4,14,390
79172203@N00,3146,1,1291583798,1291583888,3,14,90
79172203@N00,3146,5,1291585710,1291586135,2,14,425
79172203@N00,3146,8,1291586135,1291586276,3,14,141
79172203@N00,3146,13,1291586276,1291586391,2,14,115
79172203@N00,3146,4,1291586391,1291586661,3,14,270
79172203@N00,3146,6,1291586661,1291587681,8,14,1020
79172203@N00,3146,13,1291592189,1291593989,5,14,1800
79172203@N00,3146,11,1291596469,1291597969,20,14,1500
79172203@N00,3146,2,1291599237,1291599627,5,14,390
79172203@N00,3146,8,1291602479,1291603619,4,14,1140
79172203@N00,3146,4,1291611003,1291611903,2,14,900
79172203@N00,3146,6,1291620174,1291621194,32,14,1020
79172203@N00,3147,5,1291930003,1291930903,4,7,900
79172203@N00,3147,1,1291931956,1291932022,2,7,66
79172203@N00,3147,12,1291932022,1291933330,2,7,1308
79172203@N00,3147,7,1291933330,1291934350,2,7,1020
79172203@N00,3147,12,1291934887,1291936387,3,7,1500
79172203@N00,3147,10,1291937692,1291939192,11,7,1500
79172203@N00,3147,2,1291940844,1291941234,4,7,390
79172203@N00,3148,5,1399245015,1399245915,2,3,900
79172203@N00,3148,8,1399248651,1399249791,3,3,1140
79172203@N00,3148,1,1399258386,1399258476,1,3,90
79344793@N02,3149,8,1330917381,1330918521,2,2,1140
79344793@N02,3149,7,1330933285,1330934305,1,2,1020
79366282@N00,3150,12,1385947564,1385949064,1,1,1500
79399703@N00,3151,4,1367188744,1367189644,1,1,900
79433444@N07,3152,6,1354805998,1354807018,3,1,1020
7945637@N07,3153,6,1217817728,1217818748,1,1,1020
7945637@N07,3154,12,1240723769,1240725269,2,1,1500
7945637@N07,3155,6,1261387242,1261388262,3,1,1020
7945637@N07,3156,6,1262501480,1262502500,3,2,1020
7945637@N07,3156,8,1262506467,1262507607,1,2,1140
7945637@N07,3157,6,1288952844,1288953864,1,1,1020
7945637@N07,3158,8,1305936980,1305938120,1,1,1140
7945637@N07,3159,8,1305970674,1305971814,1,1,1140
7945637@N07,3160,8,1326964463,1326965603,1,1,1140
7945637@N07,3161,6,1419593640,1419594660,1,1,1020
7945637@N07,3162,6,1446724185,1446725205,1,1,1020
79478905@N04,3163,6,1458458555,1458459575,1,1,1020
79541517@N00,3164,8,1378119159,1378120299,1,1,1140
7955606@N05,3165,13,1217402418,1217404218,1,1,1800
79577915@N00,3166,1,1290315579,1290315669,2,3,90
79577915@N00,3166,12,1290323043,1290324543,2,3,1500
79577915@N00,3166,9,1290326074,1290327574,1,3,1500
7973770@N05,3167,1,1218083725,1218083815,7,3,90
7973770@N05,3167,4,1218085794,1218086694,6,3,900
7973770@N05,3167,6,1218102608,1218103628,4,3,1020
79761301@N00,3168,5,1287670426,1287671326,14,2,900
79761301@N00,3168,8,1287672220,1287673360,16,2,1140
79761301@N00,3169,8,1287996114,1287996304,2,6,190
79761301@N00,3169,4,1287996304,1287996465,8,6,161
79761301@N00,3169,6,1287996465,1287997485,8,6,1020
79761301@N00,3169,8,1287997660,1287997951,2,6,291
79761301@N00,3169,12,1287997951,1287998592,2,6,641
79761301@N00,3169,5,1287998592,1287999492,42,6,900
79761301@N00,3170,8,1402015443,1402016583,8,8,1140
79761301@N00,3170,6,1402016827,1402017847,3,8,1020
79761301@N00,3170,11,1402020913,1402022413,8,8,1500
79761301@N00,3170,5,1402025035,1402025935,6,8,900
79761301@N00,3170,13,1402031517,1402031640,2,8,123
79761301@N00,3170,1,1402031640,1402031730,19,8,90
79761301@N00,3170,5,1402041464,1402042364,8,8,900
79761301@N00,3170,1,1402042799,1402042889,16,8,90
79939076@N02,3171,1,1342224887,1342224977,2,16,90
79939076@N02,3171,13,1342225094,1342225450,5,16,356
79939076@N02,3171,4,1342225450,1342226350,4,16,900
79939076@N02,3171,13,1342227199,1342227231,2,16,32
79939076@N02,3171,1,1342227231,1342227321,8,16,90
79939076@N02,3171,5,1342227867,1342228370,4,16,503
79939076@N02,3171,1,1342228370,1342228460,2,16,90
79939076@N02,3171,7,1342228498,1342228665,2,16,167
79939076@N02,3171,8,1342228665,1342229805,2,16,1140
79939076@N02,3171,6,1342233003,1342234023,15,16,1020
79939076@N02,3171,4,1342234854,1342235754,5,16,900
79939076@N02,3171,13,1342239419,1342241219,2,16,1800
79939076@N02,3171,12,1342251993,1342253493,4,16,1500
79939076@N02,3171,8,1342259207,1342259248,4,16,41
79939076@N02,3171,1,1342259248,1342259338,3,16,90
79939076@N02,3171,9,1342261232,1342262732,22,16,1500
79959485@N00,3172,6,1219046725,1219047745,2,4,1020
79959485@N00,3172,12,1219049033,1219050533,4,4,1500
79959485@N00,3172,8,1219051768,1219052908,14,4,1140
79959485@N00,3172,1,1219054767,1219054857,1,4,90
79959485@N00,3173,6,1219277014,1219278034,2,1,1020
79959485@N00,3174,8,1331794237,1331794727,3,9,490
79959485@N00,3174,2,1331794727,1331795117,9,9,390
79959485@N00,3174,4,1331796248,1331797148,6,9,900
79959485@N00,3174,6,1331798321,1331799341,15,9,1020
79959485@N00,3174,8,1331804326,1331804404,3,9,78
79959485@N00,3174,7,1331804404,1331805424,2,9,1020
79959485@N00,3174,1,1331807033,1331807123,5,9,90
79959485@N00,3174,5,1331807298,1331808198,25,9,900
79959485@N00,3174,1,1331809189,1331809279,7,9,90
79959485@N00,3175,10,1331853394,1331853835,3,9,441
79959485@N00,3175,1,1331853835,1331853925,3,9,90
79959485@N00,3175,7,1331853933,1331853947,2,9,14
79959485@N00,3175,1,1331853947,1331853958,2,9,11
79959485@N00,3175,7,1331853958,1331854978,3,9,1020
79959485@N00,3175,11,1331856060,1331857560,18,9,1500
79959485@N00,3175,6,1331859326,1331859735,9,9,409
79959485@N00,3175,4,1331859735,1331859853,2,9,118
79959485@N00,3175,13,1331859853,1331861653,2,9,1800
79959485@N00,3176,10,1332034456,1332034841,3,4,385
79959485@N00,3176,5,1332034841,1332035741,12,4,900
79959485@N00,3176,13,1332042016,1332042747,3,4,731
79959485@N00,3176,5,1332042747,1332043647,11,4,900
80075211@N06,3177,4,1289800176,1289801076,2,1,900
80081080@N00,3178,4,1445585113,1445586013,2,2,900
80081080@N00,3178,9,1445596659,1445598159,1,2,1500
80084904@N00,3179,5,1200866117,1200866118,2,3,1
80084904@N00,3179,13,1200866118,1200866121,3,3,3
80084904@N00,3179,6,1200866121,1200867141,11,3,1020
80084904@N00,3180,9,1227027780,1227029280,18,1,1500
8021465@N08,3181,1,1254384089,1254384179,1,1,90
8021465@N08,3182,13,1262599487,1262601287,2,1,1800
8021465@N08,3183,13,1262904689,1262906489,3,1,1800
8021465@N08,3184,8,1266957227,1266958367,1,1,1140
8021465@N08,3185,8,1267824500,1267825640,5,4,1140
8021465@N08,3185,6,1267838232,1267839252,2,4,1020
8021465@N08,3185,8,1267846012,1267847152,2,4,1140
8021465@N08,3185,2,1267848716,1267849106,1,4,390
8021465@N08,3186,11,1288664618,1288666118,1,1,1500
8021465@N08,3187,10,1309994612,1309996112,1,1,1500
8021465@N08,3188,1,1337333313,1337333403,1,1,90
80304458@N00,3189,8,1419374068,1419374445,3,3,377
80304458@N00,3189,2,1419374445,1419374835,2,3,390
80304458@N00,3189,6,1419383234,1419384254,1,3,1020
80341011@N00,3190,13,1416121825,1416123625,1,1,1800
80435580@N03,3191,1,1348306109,1348306199,1,1,90
8054352@N06,3192,5,1355147493,1355148393,1,1,900
8054352@N06,3193,9,1361594107,1361595607,1,1,1500
8054352@N06,3194,5,1365310997,1365311897,1,1,900
8054352@N06,3195,4,1381537491,1381538391,1,1,900
8054352@N06,3196,9,1390884196,1390885696,1,1,1500
80558292@N00,3197,8,1379059945,1379061085,1,1,1140
80558292@N00,3198,12,1382504977,1382506477,2,2,1500
80558292@N00,3198,6,1382512971,1382513991,1,2,1020
80612606@N00,3199,4,1262331109,1262331118,2,2,9
80612606@N00,3199,6,1262331118,1262332138,3,2,1020
80612606@N00,3200,2,1283576398,1283576788,2,1,390
80612606@N00,3201,2,1298673170,1298673560,1,1,390
80612606@N00,3202,4,1307706033,1307706933,2,1,900
8066628@N02,3203,7,1189924443,1189925463,84,1,1020
8066628@N02,3204,7,1190103510,1190104530,1,1,1020
8066628@N02,3205,7,1230631541,1230632561,1,1,1020
8066628@N02,3206,7,1230886064,1230887084,45,1,1020
8066628@N02,3207,7,1231399201,1231400221,3,1,1020
8066628@N02,3208,7,1343068502,1343069522,10,1,1020
8068421@N07,3209,13,1200888208,1200890008,1,1,1800
8068421@N07,3210,5,1209988933,1209989788,2,2,855
8068421@N07,3210,8,1209989788,1209990928,2,2,1140
8068421@N07,3211,6,1287475975,1287476995,4,1,1020
8068421@N07,3212,6,1295765400,1295766420,1,1,1020
8068421@N07,3213,6,1296106823,1296107843,2,2,1020
8068421@N07,3213,1,1296112198,1296112288,3,2,90
8068774@N05,3214,11,1213240155,1213241655,1,1,1500
8068835@N04,3215,10,1333789287,1333789802,2,11,515
8068835@N04,3215,1,1333789802,1333789892,13,11,90
8068835@N04,3215,10,1333789969,1333790011,4,11,42
8068835@N04,3215,5,1333790011,1333790577,26,11,566
8068835@N04,3215,10,1333790577,1333790915,4,11,338
8068835@N04,3215,1,1333790915,1333791005,53,11,90
8068835@N04,3215,10,1333791629,1333793129,11,11,1500
8068835@N04,3215,9,1333794621,1333796121,41,11,1500
8068835@N04,3215,5,1333797646,1333798546,4,11,900
8068835@N04,3215,2,1333799590,1333799980,47,11,390
8068835@N04,3215,1,1333801655,1333801745,5,11,90
8068835@N04,3216,10,1333856574,1333858074,67,5,1500
8068835@N04,3216,5,1333868428,1333869328,20,5,900
8068835@N04,3216,10,1333871447,1333872947,11,5,1500
8068835@N04,3216,4,1333877397,1333877584,8,5,187
8068835@N04,3216,13,1333877584,1333879384,2,5,1800
8068835@N04,3217,1,1409275023,1409275113,8,8,90
8068835@N04,3217,2,1409279705,1409280095,14,8,390
8068835@N04,3217,6,1409282749,1409283139,14,8,390
8068835@N04,3217,13,1409283139,1409283466,9,8,327
8068835@N04,3217,4,1409283466,1409284366,5,8,900
8068835@N04,3217,6,1409285157,1409285709,18,8,552
8068835@N04,3217,11,1409285709,1409287209,4,8,1500
8068835@N04,3217,1,1409288651,1409288741,6,8,90
80730316@N05,3218,4,1421813295,1421814195,2,2,900
80730316@N05,3218,5,1421824212,1421825112,4,2,900
8074702@N06,3219,4,1371717625,1371718525,2,1,900
80775532@N06,3220,1,1442722632,1442722722,2,5,90
80775532@N06,3220,8,1442723461,1442724601,3,5,1140
80775532@N06,3220,1,1442725274,1442725364,2,5,90
80775532@N06,3220,5,1442726754,1442727654,2,5,900
80775532@N06,3220,10,1442729477,1442730977,1,5,1500
80847103@N00,3221,7,1356406888,1356407046,6,7,158
80847103@N00,3221,12,1356407046,1356407102,3,7,56
80847103@N00,3221,7,1356407102,1356407786,6,7,684
80847103@N00,3221,12,1356407786,1356407810,2,7,24
80847103@N00,3221,7,1356407810,1356407926,6,7,116
80847103@N00,3221,12,1356407926,1356407952,2,7,26
80847103@N00,3221,7,1356407952,1356408972,2,7,1020
80847103@N00,3222,8,1356499856,1356500996,1,1,1140
8089996@N06,3223,2,1459656582,1459656972,3,4,390
8089996@N06,3223,1,1459663244,1459663334,5,4,90
8089996@N06,3223,13,1459674712,1459676512,6,4,1800
8089996@N06,3223,1,1459676770,1459676860,2,4,90
8094673@N04,3224,8,1279162615,1279163755,1,1,1140
8095506@N07,3225,8,1285729721,1285730861,82,1,1140
8095506@N07,3226,12,1286248338,1286249838,47,1,1500
80994469@N00,3227,4,1267609350,1267610250,1,1,900
8110876@N06,3228,8,1200794624,1200795764,35,1,1140
8110876@N06,3229,8,1238282389,1238283529,6,1,1140
8110876@N06,3230,8,1239169576,1239170716,4,1,1140
81118954@N00,3231,5,1418868490,1418869390,1,1,900
8124939@N07,3232,1,1200100360,1200100450,4,3,90
8124939@N07,3232,12,1200102727,1200104227,3,3,1500
8124939@N07,3232,5,1200113865,1200114765,1,3,900
81291546@N02,3233,5,1358042113,1358043013,1,1,900
81291546@N02,3234,6,1382237213,1382238233,1,1,1020
81292745@N00,3235,1,1305245986,1305246076,1,1,90
8129384@N04,3236,6,1355121449,1355122469,4,1,1020
81322238@N00,3237,6,1274269474,1274270494,3,4,1020
81322238@N00,3237,1,1274270557,1274270647,3,4,90
81322238@N00,3237,10,1274270747,1274272121,2,4,1374
81322238@N00,3237,9,1274272121,1274273621,6,4,1500
81322238@N00,3238,1,1274399565,1274399655,2,9,90
81322238@N00,3238,2,1274402154,1274402465,4,9,311
81322238@N00,3238,8,1274402465,1274403605,360,9,1140
81322238@N00,3238,1,1274407314,1274407404,2,9,90
81322238@N00,3238,10,1274422085,1274423585,15,9,1500
81322238@N00,3238,13,1274428952,1274429310,10,9,358
81322238@N00,3238,4,1274429310,1274430210,4,9,900
81322238@N00,3238,6,1274430764,1274431784,4,9,1020
81322238@N00,3238,2,1274441094,1274441484,2,9,390
81699626@N00,3239,4,1447664629,1447665529,1,1,900
81704292@N02,3240,1,1327065285,1327065375,1,1,90
81713706@N05,3241,2,1399253699,1399254089,4,1,390
81713774@N03,3242,12,1445912537,1445914037,1,1,1500
8177037@N06,3243,13,1339364364,1339366164,12,1,1800
8177037@N06,3244,13,1371934239,1371936039,53,1,1800
81810968@N02,3245,6,1342308937,1342309957,1,1,1020
81834077@N00,3246,8,1214018690,1214019830,20,1,1140
81855582@N00,3247,1,1255123750,1255123840,2,6,90
81855582@N00,3247,5,1255124729,1255125629,8,6,900
81855582@N00,3247,1,1255128057,1255128147,4,6,90
81855582@N00,3247,2,1255132394,1255132784,2,6,390
81855582@N00,3247,6,1255132997,1255134017,3,6,1020
81855582@N00,3247,2,1255141051,1255141441,2,6,390
81932021@N00,3248,5,1229894834,1229895734,11,1,900
82031849@N00,3249,8,1356767033,1356767642,2,2,609
82031849@N00,3249,6,1356767642,1356768662,7,2,1020
82031849@N00,3250,6,1357289073,1357290093,12,1,1020
82211889@N00,3251,4,1326594472,1326595372,14,2,900
82211889@N00,3251,2,1326603515,1326603905,1,2,390
82211889@N00,3252,1,1459033447,1459033537,4,5,90
82211889@N00,3252,8,1459033606,1459034746,10,5,1140
82211889@N00,3252,12,1459036178,1459037678,7,5,1500
82211889@N00,3252,2,1459039137,1459039527,2,5,390
82211889@N00,3252,4,1459042280,1459043180,3,5,900
82211889@N00,3253,6,1459207377,1459208397,3,4,1020
82211889@N00,3253,2,1459219362,1459219752,2,4,390
82211889@N00,3253,7,1459219871,1459220891,3,4,1020
82211889@N00,3253,9,1459241666,1459243166,4,4,1500
82211889@N00,3254,2,1459474321,1459474711,3,2,390
82211889@N00,3254,4,1459478112,1459479012,2,2,900
82335642@N00,3255,8,1258857710,1258858850,2,9,1140
82335642@N00,3255,10,1258863057,1258863239,2,9,182
82335642@N00,3255,1,1258863239,1258863329,4,9,90
82335642@N00,3255,8,1258863639,1258863914,4,9,275
82335642@N00,3255,7,1258863914,1258864934,10,9,1020
82335642@N00,3255,8,1258866341,1258866583,3,9,242
82335642@N00,3255,1,1258866583,1258866673,3,9,90
82335642@N00,3255,8,1258867122,1258868262,10,9,1140
82335642@N00,3255,1,1258868284,1258868374,1,9,90
82418556@N00,3256,5,1358139862,1358139937,2,6,75
82418556@N00,3256,9,1358139937,1358140164,2,6,227
82418556@N00,3256,5,1358140164,1358141064,3,6,900
82418556@N00,3256,4,1358142857,1358143757,2,6,900
82418556@N00,3256,6,1358147562,1358148582,2,6,1020
82418556@N00,3256,5,1358150358,1358151258,1,6,900
82418556@N00,3257,8,1380927382,1380927822,2,2,440
82418556@N00,3257,1,1380927822,1380927912,1,2,90
82418556@N00,3258,8,1380982783,1380983923,1,1,1140
82418556@N00,3259,1,1399155359,1399155449,2,5,90
82418556@N00,3259,4,1399157662,1399158562,2,5,900
82418556@N00,3259,8,1399158587,1399159727,2,5,1140
82418556@N00,3259,5,1399169898,1399170798,2,5,900
82418556@N00,3259,4,1399174031,1399174931,3,5,900
82541612@N00,3260,8,1395189298,1395190438,2,3,1140
82541612@N00,3260,5,1395193249,1395194149,2,3,900
82541612@N00,3260,4,1395198295,1395199195,1,3,900
82624704@N00,3261,2,1273973062,1273973452,11,4,390
82624704@N00,3261,6,1273980452,1273981472,13,4,1020
82624704@N00,3261,1,1273987878,1273987968,17,4,90
82624704@N00,3261,2,1274002852,1274003242,5,4,390
8270001@N04,3262,8,1269450053,1269451193,4,1,1140
82746306@N00,3263,8,1248262142,1248263282,1,1,1140
82936946@N00,3264,5,1281744053,1281744953,3,2,900
82936946@N00,3264,1,1281763289,1281763379,1,2,90
83035350@N06,3265,8,1362694508,1362695648,2,2,1140
83035350@N06,3265,13,1362707788,1362709588,1,2,1800
83083483@N04,3266,4,1432287919,1432288819,1,1,900
83083483@N04,3267,4,1432400893,1432401793,1,1,900
83088992@N06,3268,4,1366051238,1366051536,3,2,298
83088992@N06,3268,6,1366051536,1366052556,1,2,1020
83092888@N03,3269,8,1380108799,1380109939,1,1,1140
83106697@N00,3270,1,1225320263,1225320353,2,5,90
83106697@N00,3270,5,1225323146,1225324046,3,5,900
83106697@N00,3270,2,1225330142,1225330532,5,5,390
83106697@N00,3270,1,1225337418,1225337508,2,5,90
83106697@N00,3270,5,1225338398,1225339298,1,5,900
83106697@N00,3271,6,1354859449,1354860469,1,1,1020
8311873@N03,3272,8,1348036859,1348037127,2,5,268
8311873@N03,3272,2,1348037127,1348037228,2,5,101
8311873@N03,3272,6,1348037228,1348037414,2,5,186
8311873@N03,3272,5,1348037414,1348037581,2,5,167
8311873@N03,3272,8,1348037581,1348038721,1,5,1140
8311873@N03,3273,5,1352852684,1352853584,2,1,900
8311873@N03,3274,8,1359342151,1359343291,1,1,1140
8311873@N03,3275,5,1370762053,1370762953,1,1,900
8311873@N03,3276,13,1420452730,1420454530,1,1,1800
8311873@N03,3277,5,1423463888,1423464788,1,1,900
83133472@N05,3278,13,1347627309,1347629109,1,1,1800
83133472@N05,3279,4,1347671030,1347671930,1,1,900
83133472@N05,3280,4,1366550267,1366551167,1,1,900
83133472@N05,3281,4,1369313001,1369313901,1,1,900
83133472@N05,3282,4,1369400795,1369401695,2,2,900
83133472@N05,3282,12,1369403482,1369404982,1,2,1500
83133472@N05,3283,2,1370759272,1370759662,1,1,390
83133472@N05,3284,12,1371258397,1371259897,1,1,1500
83133472@N05,3285,6,1374312096,1374313116,1,1,1020
83133472@N05,3286,4,1374838882,1374839782,1,1,900
83167112@N06,3287,6,1416295823,1416296843,1,1,1020
83206670@N05,3288,8,1314239115,1314240255,66,1,1140
83206670@N05,3289,1,1314315691,1314315781,2,3,90
83206670@N05,3289,8,1314321172,1314322312,3,3,1140
83206670@N05,3289,2,1314325269,1314325659,2,3,390
8326174@N06,3290,5,1381828422,1381829322,1,1,900
8328546@N03,3291,8,1208945281,1208946421,3,6,1140
8328546@N03,3291,1,1208946886,1208946888,2,6,2
8328546@N03,3291,6,1208946888,1208946892,2,6,4
8328546@N03,3291,1,1208946892,1208946908,3,6,16
8328546@N03,3291,3,1208946908,1208947310,2,6,402
8328546@N03,3291,1,1208947310,1208947400,1,6,90
8328546@N03,3292,1,1209026705,1209026795,4,1,90
83286805@N00,3293,1,1320638478,1320638568,3,2,90
83286805@N00,3293,5,1320653394,1320654294,1,2,900
83286805@N00,3294,8,1320807995,1320809135,2,2,1140
83286805@N00,3294,6,1320814179,1320815199,1,2,1020
8330434@N05,3295,6,1358231643,1358232663,2,1,1020
8342736@N06,3296,6,1275355572,1275356592,1,1,1020
8358539@N02,3297,5,1331807230,1331808130,1,1,900
8358539@N02,3298,2,1370136639,1370137029,1,1,390
83657528@N00,3299,2,1300229792,1300230182,3,3,390
83657528@N00,3299,12,1300249785,1300251285,3,3,1500
83657528@N00,3299,5,1300258143,1300259043,1,3,900
83794242@N07,3300,4,1435641043,1435641943,1,1,900
83825280@N06,3301,12,1353072728,1353074228,1,1,1500
83848625@N00,3302,6,1432087116,1432088007,3,7,891
83848625@N00,3302,11,1432088007,1432089507,2,7,1500
83848625@N00,3302,5,1432090430,1432090448,2,7,18
83848625@N00,3302,10,1432090448,1432091499,2,7,1051
83848625@N00,3302,8,1432091499,1432092639,2,7,1140
83848625@N00,3302,13,1432092865,1432094665,2,7,1800
83848625@N00,3302,1,1432096199,1432096289,1,7,90
83848625@N00,3303,5,1456280002,1456280902,2,6,900
83848625@N00,3303,8,1456282559,1456283699,2,6,1140
83848625@N00,3303,4,1456284666,1456285566,2,6,900
83848625@N00,3303,12,1456287462,1456288962,2,6,1500
83848625@N00,3303,6,1456293999,1456295019,2,6,1020
83848625@N00,3303,1,1456303229,1456303319,1,6,90
83848625@N00,3304,8,1456377998,1456379138,3,4,1140
83848625@N00,3304,2,1456382606,1456382996,2,4,390
83848625@N00,3304,4,1456389357,1456390257,3,4,900
83848625@N00,3304,8,1456391154,1456392294,1,4,1140
83935707@N00,3305,10,1240528854,1240530354,2,4,1500
83935707@N00,3305,4,1240532900,1240533800,6,4,900
83935707@N00,3305,5,1240537213,1240537876,4,4,663
83935707@N00,3305,1,1240537876,1240537966,2,4,90
84013956@N00,3306,6,1325154006,1325155026,2,1,1020
84057763@N00,3307,1,1453166680,1453166770,1,1,90
8405842@N02,3308,6,1412471030,1412472050,1,1,1020
8405842@N02,3309,2,1412673328,1412673718,2,2,390
8405842@N02,3309,8,1412675431,1412676571,1,2,1140
84108876@N00,3310,13,1210901626,1210903426,1,1,1800
84132551@N00,3311,13,1439806123,1439807923,1,1,1800
84132551@N00,3312,13,1442476039,1442477839,1,1,1800
84168064@N02,3313,13,1445747721,1445748002,2,2,281
84168064@N02,3313,4,1445748002,1445748902,1,2,900
84169004@N00,3314,2,1228353900,1228354290,4,1,390
84169004@N00,3315,4,1386304091,1386304991,1,1,900
84221632@N00,3316,2,1359603485,1359603875,2,1,390
84227486@N02,3317,6,1354779989,1354781009,2,4,1020
84227486@N02,3317,4,1354782373,1354782426,3,4,53
84227486@N02,3317,6,1354782426,1354783446,3,4,1020
84227486@N02,3317,1,1354787568,1354787658,1,4,90
84227486@N02,3318,6,1366070509,1366071529,2,3,1020
84227486@N02,3318,7,1366077352,1366078372,3,3,1020
84227486@N02,3318,8,1366078553,1366079693,1,3,1140
84296061@N04,3319,8,1360628683,1360629823,2,1,1140
84489335@N04,3320,7,1346400342,1346401362,1,1,1020
84531937@N00,3321,6,1309466602,1309467622,2,2,1020
84531937@N00,3321,1,1309494868,1309494958,1,2,90
8459320@N03,3322,2,1246847260,1246847650,2,1,390
84643106@N00,3323,6,1261992973,1261993993,6,1,1020
84643106@N00,3324,6,1262255156,1262256176,1,1,1020
84697271@N00,3325,6,1294461120,1294462140,2,4,1020
84697271@N00,3325,2,1294466196,1294466497,2,4,301
84697271@N00,3325,8,1294466497,1294466507,3,4,10
84697271@N00,3325,1,1294466507,1294466597,1,4,90
84697271@N00,3326,13,1294701943,1294702220,2,4,277
84697271@N00,3326,4,1294702220,1294702451,3,4,231
84697271@N00,3326,6,1294702451,1294703455,3,4,1004
84697271@N00,3326,8,1294703455,1294704595,1,4,1140
84765974@N00,3327,12,1464692908,1464694408,1,1,1500
84824340@N07,3328,1,1409991379,1409991469,2,5,90
84824340@N07,3328,5,1409993470,1409994370,3,5,900
84824340@N07,3328,1,1409995976,1409996066,2,5,90
84824340@N07,3328,7,1409996225,1409996697,2,5,472
84824340@N07,3328,8,1409996697,1409997837,1,5,1140
84861343@N00,3329,6,1370560992,1370562012,2,2,1020
84861343@N00,3329,8,1370562665,1370563805,7,2,1140
85095974@N05,3330,4,1374370324,1374371224,6,1,900
85095974@N05,3331,4,1374487402,1374487416,2,3,14
85095974@N05,3331,6,1374487416,1374487436,2,3,20
85095974@N05,3331,4,1374487436,1374488336,6,3,900
85095974@N05,3332,1,1402091216,1402091306,2,3,90
85095974@N05,3332,2,1402094366,1402094756,3,3,390
85095974@N05,3332,1,1402104157,1402104247,24,3,90
85095974@N05,3333,8,1402670137,1402671277,1,1,1140
85095974@N05,3334,1,1434157420,1434157510,40,3,90
85095974@N05,3334,8,1434158909,1434160049,18,3,1140
85095974@N05,3334,10,1434169308,1434170808,16,3,1500
85095974@N05,3335,4,1434682513,1434683413,2,2,900
85095974@N05,3335,1,1434684803,1434684893,12,2,90
85095974@N05,3336,10,1470556507,1470556831,2,5,324
85095974@N05,3336,1,1470556831,1470556921,2,5,90
85095974@N05,3336,12,1470557004,1470558504,14,5,1500
85095974@N05,3336,8,1470558792,1470559932,7,5,1140
85095974@N05,3336,13,1470563917,1470565717,2,5,1800
85095974@N05,3337,1,1470609988,1470610078,2,6,90
85095974@N05,3337,12,1470611447,1470612947,2,6,1500
85095974@N05,3337,8,1470618277,1470619417,11,6,1140
85095974@N05,3337,7,1470619555,1470620575,18,6,1020
85095974@N05,3337,2,1470621138,1470621528,15,6,390
85095974@N05,3337,4,1470637846,1470638746,5,6,900
85116518@N06,3338,10,1376005136,1376006636,2,1,1500
85121305@N08,3339,5,1441074232,1441075132,4,2,900
85121305@N08,3339,1,1441098235,1441098325,5,2,90
85121963@N00,3340,8,1320724582,1320725722,11,1,1140
85148660@N00,3341,4,1362184980,1362185880,4,1,900
8526919@N08,3342,5,1461410210,1461411110,1,1,900
85281436@N03,3343,5,1362740395,1362741295,1,1,900
85288320@N00,3344,13,1312160651,1312162451,4,4,1800
85288320@N00,3344,4,1312164714,1312165614,2,4,900
85288320@N00,3344,5,1312173426,1312174326,2,4,900
85288320@N00,3344,10,1312174553,1312176053,1,4,1500
85288320@N00,3345,4,1312335266,1312336166,2,5,900
85288320@N00,3345,8,1312336678,1312336763,2,5,85
85288320@N00,3345,4,1312336763,1312337152,2,5,389
85288320@N00,3345,8,1312337152,1312338292,2,5,1140
85288320@N00,3345,5,1312341413,1312342313,11,5,900
85509341@N00,3346,7,1392874832,1392875852,2,2,1020
85509341@N00,3346,2,1392876587,1392876977,1,2,390
85542262@N00,3347,6,1280973226,1280974246,2,2,1020
85542262@N00,3347,13,1280986839,1280988639,1,2,1800
85543411@N08,3348,5,1381530057,1381530957,1,1,900
85543411@N08,3349,13,1420509761,1420511561,1,1,1800
85566955@N00,3350,2,1379466303,1379466693,1,1,390
8562768@N07,3351,6,1351212589,1351213609,2,2,1020
8562768@N07,3351,1,1351216178,1351216268,1,2,90
85631149@N00,3352,2,1393373194,1393373584,2,3,390
85631149@N00,3352,6,1393376689,1393377709,2,3,1020
85631149@N00,3352,1,1393398010,1393398100,3,3,90
85632208@N03,3353,6,1329409988,1329411008,2,2,1020
85632208@N03,3353,7,1329417006,1329418026,1,2,1020
85644119@N00,3354,8,1198790948,1198792088,2,3,1140
85644119@N00,3354,1,1198793116,1198793206,2,3,90
85644119@N00,3354,8,1198799808,1198800948,1,3,1140
85644119@N00,3355,6,1198829923,1198830943,4,2,1020
85644119@N00,3355,1,1198834822,1198834912,4,2,90
85644119@N00,3356,1,1212963106,1212963106,2,8,0
85644119@N00,3356,8,1212963106,1212963835,4,8,729
85644119@N00,3356,5,1212963835,1212963886,2,8,51
85644119@N00,3356,8,1212963886,1212964119,2,8,233
85644119@N00,3356,5,1212964119,1212964850,2,8,731
85644119@N00,3356,8,1212964850,1212965990,6,8,1140
85644119@N00,3356,6,1212974497,1212974948,2,8,451
85644119@N00,3356,8,1212974948,1212976088,4,8,1140
85644119@N00,3357,10,1228865463,1228866963,1,1,1500
85644119@N00,3358,1,1262120273,1262120363,2,17,90
85644119@N00,3358,2,1262122199,1262122589,3,17,390
85644119@N00,3358,5,1262123764,1262124378,2,17,614
85644119@N00,3358,1,1262124378,1262124468,2,17,90
85644119@N00,3358,4,1262124883,1262125783,2,17,900
85644119@N00,3358,6,1262126889,1262127909,2,17,1020
85644119@N00,3358,4,1262131036,1262131068,2,17,32
85644119@N00,3358,8,1262131068,1262131314,3,17,246
85644119@N00,3358,1,1262131314,1262131404,3,17,90
85644119@N00,3358,10,1262131461,1262132961,2,17,1500
85644119@N00,3358,2,1262139286,1262139676,2,17,390
85644119@N00,3358,5,1262147983,1262148883,2,17,900
85644119@N00,3358,1,1262149489,1262149579,2,17,90
85644119@N00,3358,11,1262154870,1262156370,2,17,1500
85644119@N00,3358,1,1262157627,1262157715,2,17,88
85644119@N00,3358,8,1262157715,1262158855,2,17,1140
85644119@N00,3358,6,1262159980,1262161000,2,17,1020
85644119@N00,3359,1,1324410786,1324410876,3,15,90
85644119@N00,3359,8,1324414505,1324414782,2,15,277
85644119@N00,3359,4,1324414782,1324415371,2,15,589
85644119@N00,3359,13,1324415371,1324415683,2,15,312
85644119@N00,3359,8,1324415683,1324416823,5,15,1140
85644119@N00,3359,13,1324419645,1324421445,2,15,1800
85644119@N00,3359,4,1324423387,1324424287,2,15,900
85644119@N00,3359,10,1324431718,1324431848,2,15,130
85644119@N00,3359,5,1324431848,1324432748,3,15,900
85644119@N00,3359,8,1324438654,1324439794,2,15,1140
85644119@N00,3359,6,1324440500,1324441520,2,15,1020
85644119@N00,3359,4,1324445369,1324446269,2,15,900
85644119@N00,3359,1,1324446782,1324446872,3,15,90
85644119@N00,3359,6,1324454025,1324455045,4,15,1020
85644119@N00,3359,10,1324457193,1324458693,1,15,1500
8567292@N04,3360,7,1229719041,1229720061,6,1,1020
8567292@N04,3361,7,1229813197,1229814217,39,1,1020
8567292@N04,3362,7,1230015798,1230016818,9,1,1020
8567292@N04,3363,4,1441498455,1441499355,4,3,900
8567292@N04,3363,2,1441504683,1441505073,15,3,390
8567292@N04,3363,1,1441525107,1441525197,1,3,90
85688704@N07,3364,1,1312447553,1312447643,1,1,90
85744958@N00,3365,1,1235991269,1235991359,3,1,90
85744958@N00,3366,1,1286078557,1286078647,2,1,90
85744958@N00,3367,9,1305648508,1305650008,13,1,1500
85744958@N00,3368,1,1305780461,1305780551,3,1,90
85744958@N00,3369,1,1318954238,1318954328,8,1,90
85744958@N00,3370,10,1328055376,1328056876,3,1,1500
85744958@N00,3371,1,1353661010,1353661100,2,2,90
85744958@N00,3371,10,1353661352,1353662852,1,2,1500
8576764@N02,3372,1,1409543529,1409543619,3,4,90
8576764@N02,3372,2,1409544369,1409544759,7,4,390
8576764@N02,3372,6,1409562477,1409563497,10,4,1020
8576764@N02,3372,4,1409563637,1409564537,1,4,900
8576764@N02,3373,4,1409909583,1409910483,1,1,900
85813749@N00,3374,7,1418773551,1418774571,2,6,1020
85813749@N00,3374,4,1418777132,1418778032,2,6,900
85813749@N00,3374,6,1418786429,1418787449,2,6,1020
85813749@N00,3374,4,1418788809,1418789709,2,6,900
85813749@N00,3374,9,1418805224,1418806724,2,6,1500
85813749@N00,3374,6,1418810172,1418811192,2,6,1020
85843151@N00,3375,4,1359931718,1359932618,4,9,900
85843151@N00,3375,6,1359935628,1359936648,2,9,1020
85843151@N00,3375,13,1359946217,1359948017,4,9,1800
85843151@N00,3375,4,1359948571,1359949471,3,9,900
85843151@N00,3375,13,1359950728,1359952528,3,9,1800
85843151@N00,3375,10,1359959939,1359961384,3,9,1445
85843151@N00,3375,5,1359961384,1359962284,2,9,900
85843151@N00,3375,9,1359965097,1359966597,2,9,1500
85843151@N00,3375,8,1359976853,1359977993,1,9,1140
85855667@N00,3376,1,1309474109,1309474199,2,5,90
85855667@N00,3376,12,1309475152,1309475219,2,5,67
85855667@N00,3376,8,1309475219,1309476359,2,5,1140
85855667@N00,3376,4,1309479738,1309480638,3,5,900
85855667@N00,3376,13,1309485723,1309487523,2,5,1800
85856616@N05,3377,6,1353932666,1353933686,6,1,1020
85859494@N02,3378,2,1369908563,1369908953,2,2,390
85859494@N02,3378,5,1369910622,1369911522,3,2,900
85859494@N02,3379,1,1370035907,1370035997,4,6,90
85859494@N02,3379,5,1370038218,1370039118,10,6,900
85859494@N02,3379,1,1370042207,1370042297,8,6,90
85859494@N02,3379,11,1370043802,1370045302,2,6,1500
85859494@N02,3379,6,1370048007,1370049027,5,6,1020
85859494@N02,3379,4,1370056284,1370057184,2,6,900
85863433@N04,3380,11,1323746123,1323747623,1,1,1500
85864407@N08,3381,8,1384659382,1384660522,2,3,1140
85864407@N08,3381,5,1384672896,1384673796,4,3,900
85864407@N08,3381,6,1384677318,1384678338,2,3,1020
85912588@N00,3382,6,1353568528,1353569548,1,1,1020
8592217@N08,3383,7,1237790180,1237791200,2,3,1020
8592217@N08,3383,8,1237792802,1237793312,2,3,510
8592217@N08,3383,4,1237793312,1237794212,1,3,900
8599745@N08,3384,13,1210765768,1210767568,5,1,1800
86001309@N00,3385,1,1336049303,1336049393,19,1,90
86061580@N00,3386,4,1291005616,1291006516,9,1,900
86111910@N03,3387,5,1348281138,1348282038,2,3,900
86111910@N03,3387,6,1348287406,1348288426,2,3,1020
86111910@N03,3387,11,1348298173,1348299673,1,3,1500
86171175@N08,3388,5,1404707174,1404708074,2,3,900
86171175@N08,3388,1,1404708333,1404708423,2,3,90
86171175@N08,3388,6,1404717374,1404718394,1,3,1020
86177168@N03,3389,4,1282008113,1282009013,1,1,900
86235456@N07,3390,6,1452749365,1452750385,1,1,1020
86278660@N00,3391,9,1386227468,1386228968,40,1,1500
8638605@N02,3392,10,1275623899,1275624262,4,5,363
8638605@N02,3392,1,1275624262,1275624352,6,5,90
8638605@N02,3392,8,1275625251,1275626391,6,5,1140
8638605@N02,3392,4,1275631899,1275632799,107,5,900
8638605@N02,3392,5,1275644088,1275644988,12,5,900
8638605@N02,3393,10,1275775298,1275776798,11,13,1500
8638605@N02,3393,5,1275778315,1275779215,5,13,900
8638605@N02,3393,1,1275780422,1275780512,2,13,90
8638605@N02,3393,4,1275781666,1275781783,2,13,117
8638605@N02,3393,6,1275781783,1275782803,15,13,1020
8638605@N02,3393,2,1275783287,1275783677,7,13,390
8638605@N02,3393,6,1275785008,1275786028,5,13,1020
8638605@N02,3393,4,1275786059,1275786959,6,13,900
8638605@N02,3393,13,1275788633,1275789439,46,13,806
8638605@N02,3393,4,1275789439,1275789992,28,13,553
8638605@N02,3393,6,1275789992,1275791012,4,13,1020
8638605@N02,3393,4,1275792024,1275792187,2,13,163
8638605@N02,3393,3,1275792187,1275792607,2,13,420
8638605@N02,3394,1,1275965911,1275966001,2,6,90
8638605@N02,3394,13,1275966581,1275967060,2,6,479
8638605@N02,3394,4,1275967060,1275967960,4,6,900
8638605@N02,3394,2,1275968718,1275969108,4,6,390
8638605@N02,3394,12,1275970373,1275971313,3,6,940
8638605@N02,3394,5,1275971313,1275972213,3,6,900
8642045@N04,3395,5,1421542401,1421543301,1,1,900
8642045@N04,3396,5,1421584860,1421585760,1,1,900
86434226@N00,3397,4,1360475366,1360476266,3,1,900
86459399@N00,3398,5,1255332539,1255333439,1,1,900
86459399@N00,3399,9,1275218215,1275219715,6,2,1500
86459399@N00,3399,1,1275221364,1275221454,1,2,90
86459399@N00,3400,6,1291878151,1291879171,4,1,1020
86459399@N00,3401,2,1318815944,1318816334,2,3,390
86459399@N00,3401,8,1318819338,1318820478,2,3,1140
86459399@N00,3401,4,1318820497,1318821397,3,3,900
86459399@N00,3402,1,1319101625,1319101715,3,3,90
86459399@N00,3402,8,1319101916,1319103056,4,3,1140
86459399@N00,3402,5,1319110099,1319110999,3,3,900
86482004@N00,3403,13,1337487464,1337489264,5,5,1800
86482004@N00,3403,4,1337491374,1337492274,5,5,900
86482004@N00,3403,8,1337498830,1337499970,2,5,1140
86482004@N00,3403,12,1337500907,1337502407,3,5,1500
86482004@N00,3403,5,1337503948,1337504848,1,5,900
86507020@N00,3404,1,1245710151,1245710241,7,1,90
86562986@N00,3405,10,1230671907,1230673407,2,6,1500
86562986@N00,3405,8,1230673608,1230674748,4,6,1140
86562986@N00,3405,2,1230677126,1230677516,3,6,390
86562986@N00,3405,8,1230677555,1230678695,2,6,1140
86562986@N00,3405,2,1230680582,1230680972,2,6,390
86562986@N00,3405,8,1230682978,1230684118,2,6,1140
86562986@N00,3406,6,1230713252,1230714272,1,1,1020
86643038@N07,3407,2,1400216236,1400216626,1,1,390
86701646@N00,3408,4,1292650888,1292651788,1,1,900
86719158@N00,3409,6,1299288039,1299289059,2,1,1020
86864767@N00,3410,8,1205178522,1205178596,2,2,74
86864767@N00,3410,5,1205178596,1205179496,1,2,900
86864767@N00,3411,1,1205345189,1205345279,1,1,90
86985744@N00,3412,4,1376698117,1376699017,1,1,900
87049901@N00,3413,2,1317283767,1317284157,1,1,390
87195182@N04,3414,8,1356576331,1356577471,1,1,1140
87261736@N00,3415,1,1443225010,1443225100,2,2,90
87261736@N00,3415,6,1443228617,1443229637,1,2,1020
8729032@N06,3416,10,1224629967,1224631467,2,2,1500
8729032@N06,3416,5,1224633962,1224634862,1,2,900
8729032@N06,3417,4,1224822441,1224823341,5,2,900
8729032@N06,3417,1,1224825727,1224825817,1,2,90
8729032@N06,3418,12,1283338132,1283339632,2,1,1500
8729032@N06,3419,8,1288042154,1288043294,88,2,1140
8729032@N06,3419,2,1288048595,1288048985,5,2,390
8729032@N06,3420,5,1373155133,1373156033,2,4,900
8729032@N06,3420,2,1373156044,1373156434,2,4,390
8729032@N06,3420,3,1373162145,1373162565,6,4,420
8729032@N06,3420,8,1373166719,1373167859,8,4,1140
8729032@N06,3421,12,1387235426,1387236926,5,23,1500
8729032@N06,3421,7,1387237428,1387238448,2,23,1020
8729032@N06,3421,5,1387238620,1387239210,5,23,590
8729032@N06,3421,12,1387239210,1387240217,2,23,1007
8729032@N06,3421,5,1387240217,1387241117,2,23,900
8729032@N06,3421,12,1387242322,1387242323,2,23,1
8729032@N06,3421,5,1387242323,1387242333,2,23,10
8729032@N06,3421,12,1387242333,1387243833,10,23,1500
8729032@N06,3421,4,1387249410,1387250228,8,23,818
8729032@N06,3421,3,1387250228,1387250238,2,23,10
8729032@N06,3421,4,1387250238,1387250767,2,23,529
8729032@N06,3421,2,1387250767,1387251157,5,23,390
8729032@N06,3421,6,1387253126,1387253294,2,23,168
8729032@N06,3421,2,1387253294,1387253684,3,23,390
8729032@N06,3421,6,1387259387,1387260407,2,23,1020
8729032@N06,3421,8,1387262557,1387263697,2,23,1140
8729032@N06,3421,6,1387264413,1387265433,15,23,1020
8729032@N06,3421,8,1387267236,1387268376,8,23,1140
8729032@N06,3421,12,1387269229,1387269881,14,23,652
8729032@N06,3421,8,1387269881,1387269936,3,23,55
8729032@N06,3421,12,1387269936,1387269963,2,23,27
8729032@N06,3421,8,1387269963,1387271075,15,23,1112
8729032@N06,3421,10,1387271075,1387272575,2,23,1500
8729032@N06,3422,11,1417990355,1417990378,2,32,23
8729032@N06,3422,10,1417990378,1417991878,7,32,1500
8729032@N06,3422,2,1417993396,1417993786,4,32,390
8729032@N06,3422,4,1417994100,1417994189,3,32,89
8729032@N06,3422,2,1417994189,1417994512,3,32,323
8729032@N06,3422,11,1417994512,1417994816,19,32,304
8729032@N06,3422,4,1417994816,1417994826,4,32,10
8729032@N06,3422,11,1417994826,1417994828,2,32,2
8729032@N06,3422,4,1417994828,1417994848,2,32,20
8729032@N06,3422,11,1417994848,1417994868,2,32,20
8729032@N06,3422,4,1417994868,1417994869,2,32,1
8729032@N06,3422,11,1417994869,1417994870,2,32,1
8729032@N06,3422,4,1417994870,1417994898,6,32,28
8729032@N06,3422,11,1417994898,1417994901,2,32,3
8729032@N06,3422,4,1417994901,1417994909,4,32,8
8729032@N06,3422,11,1417994909,1417995120,8,32,211
8729032@N06,3422,4,1417995120,1417996020,23,32,900
8729032@N06,3422,7,1417996282,1417996349,4,32,67
8729032@N06,3422,11,1417996349,1417996513,5,32,164
8729032@N06,3422,2,1417996513,1417996581,3,32,68
8729032@N06,3422,4,1417996581,1417997481,101,32,900
8729032@N06,3422,1,1418002622,1418002712,16,32,90
8729032@N06,3422,5,1418002875,1418003034,4,32,159
8729032@N06,3422,12,1418003034,1418003085,8,32,51
8729032@N06,3422,5,1418003085,1418003985,3,32,900
8729032@N06,3422,8,1418004968,1418005013,3,32,45
8729032@N06,3422,12,1418005013,1418006513,3,32,1500
8729032@N06,3422,4,1418007208,1418008108,13,32,900
8729032@N06,3422,2,1418009442,1418009832,5,32,390
8729032@N06,3422,11,1418011802,1418011942,3,32,140
8729032@N06,3422,7,1418011942,1418012962,2,32,1020
8729032@N06,3422,8,1418015915,1418017055,25,32,1140
8729032@N06,3423,5,1429752192,1429753092,1,1,900
8729032@N06,3424,12,1458284291,1458284292,2,5,1
8729032@N06,3424,10,1458284292,1458285792,2,5,1500
8729032@N06,3424,8,1458288749,1458288750,2,5,1
8729032@N06,3424,7,1458288750,1458288750,2,5,0
8729032@N06,3424,8,1458288750,1458289890,1,5,1140
8730186@N03,3425,7,1427922862,1427923882,20,1,1020
8730186@N03,3426,7,1428022224,1428023244,4,1,1020
87415005@N02,3427,2,1417665513,1417665903,2,6,390
87415005@N02,3427,1,1417667240,1417667330,2,6,90
87415005@N02,3427,12,1417674369,1417674376,2,6,7
87415005@N02,3427,7,1417674376,1417674509,2,6,133
87415005@N02,3427,12,1417674509,1417676009,2,6,1500
87415005@N02,3427,6,1417682057,1417683077,9,6,1020
8744270@N03,3428,8,1204762459,1204763599,2,1,1140
8744270@N03,3429,8,1204953303,1204954443,3,1,1140
87506761@N00,3430,4,1336137217,1336138117,8,1,900
87507703@N04,3431,1,1356560461,1356560551,4,13,90
87507703@N04,3431,5,1356560985,1356561809,2,13,824
87507703@N04,3431,1,1356561809,1356561899,10,13,90
87507703@N04,3431,12,1356562959,1356563195,2,13,236
87507703@N04,3431,8,1356563195,1356563210,2,13,15
87507703@N04,3431,1,1356563210,1356563300,3,13,90
87507703@N04,3431,5,1356565129,1356566029,3,13,900
87507703@N04,3431,1,1356568587,1356568677,2,13,90
87507703@N04,3431,13,1356569109,1356569516,2,13,407
87507703@N04,3431,4,1356569516,1356570010,7,13,494
87507703@N04,3431,6,1356570010,1356571030,17,13,1020
87507703@N04,3431,2,1356571625,1356572015,3,13,390
87507703@N04,3431,1,1356572454,1356572544,1,13,90
87635169@N02,3432,6,1449218023,1449219043,12,1,1020
87723016@N00,3433,4,1379561565,1379562465,2,1,900
87725423@N06,3434,1,1373612401,1373612491,2,5,90
87725423@N06,3434,5,1373614150,1373615050,3,5,900
87725423@N06,3434,8,1373618897,1373619398,2,5,501
87725423@N06,3434,1,1373619398,1373619488,2,5,90
87725423@N06,3434,5,1373631031,1373631931,1,5,900
8773866@N07,3435,5,1229122966,1229123866,2,2,900
8773866@N07,3435,6,1229126142,1229127162,1,2,1020
8773866@N07,3436,1,1287200141,1287200231,1,1,90
87854506@N04,3437,5,1355559575,1355559835,2,4,260
87854506@N04,3437,1,1355559835,1355559925,4,4,90
87854506@N04,3437,6,1355561080,1355562100,10,4,1020
87854506@N04,3437,4,1355569706,1355570606,6,4,900
87854506@N04,3438,5,1363502841,1363503741,1,1,900
87881467@N08,3439,1,1359557321,1359557411,64,1,90
87881467@N08,3440,1,1361857063,1361857153,2,1,90
87881467@N08,3441,1,1361928150,1361928240,7,1,90
87881467@N08,3442,1,1362440052,1362440142,6,1,90
87898971@N03,3443,6,1449271573,1449272593,1,1,1020
87942779@N00,3444,6,1202560735,1202561755,1,1,1020
87953089@N04,3445,1,1389997724,1389997814,4,7,90
87953089@N04,3445,5,1389997910,1389998810,10,7,900
87953089@N04,3445,4,1390002518,1390003418,3,7,900
87953089@N04,3445,6,1390009502,1390010522,6,7,1020
87953089@N04,3445,8,1390025402,1390025949,2,7,547
87953089@N04,3445,12,1390025949,1390027449,5,7,1500
87953089@N04,3445,9,1390033534,1390035034,2,7,1500
87953089@N04,3446,8,1390533096,1390534236,1,1,1140
87993502@N03,3447,2,1357572863,1357573253,1,1,390
8803306@N02,3448,1,1227313655,1227313745,1,1,90
8803306@N02,3449,4,1240705301,1240706201,1,1,900
8803306@N02,3450,10,1244843889,1244845389,2,8,1500
8803306@N02,3450,8,1244846378,1244846396,2,8,18
8803306@N02,3450,4,1244846396,1244847296,2,8,900
8803306@N02,3450,12,1244851285,1244852785,2,8,1500
8803306@N02,3450,8,1244853792,1244854932,9,8,1140
8803306@N02,3450,6,1244859615,1244860635,3,8,1020
8803306@N02,3450,2,1244860838,1244861228,2,8,390
8803306@N02,3450,8,1244867426,1244868566,1,8,1140
88078923@N04,3451,2,1415920919,1415921309,5,4,390
88078923@N04,3451,5,1415933185,1415934085,4,4,900
88078923@N04,3451,12,1415938659,1415939256,6,4,597
88078923@N04,3451,13,1415939256,1415941056,3,4,1800
8807897@N04,3452,1,1193020290,1193020380,1,1,90
88097009@N07,3453,5,1418535451,1418536351,1,1,900
88101388@N07,3454,8,1355698853,1355699993,22,2,1140
88101388@N07,3454,1,1355704294,1355704384,48,2,90
88158593@N00,3455,8,1305876928,1305878068,1,1,1140
88158593@N00,3456,5,1334295146,1334296046,1,1,900
88264442@N00,3457,1,1321426135,1321426225,1,1,90
88322185@N00,3458,5,1195626818,1195627718,2,2,900
88322185@N00,3458,6,1195636230,1195637250,3,2,1020
88322185@N00,3459,8,1195710906,1195712046,1,1,1140
88322185@N00,3460,8,1195953179,1195954319,1,1,1140
88322185@N00,3461,5,1323091014,1323091914,30,1,900
88322185@N00,3462,5,1468454853,1468455753,59,1,900
8838492@N05,3463,10,1198285744,1198286133,2,18,389
8838492@N05,3463,1,1198286133,1198286223,3,18,90
8838492@N05,3463,8,1198286540,1198287404,3,18,864
8838492@N05,3463,4,1198287404,1198288304,9,18,900
8838492@N05,3463,8,1198296404,1198296560,8,18,156
8838492@N05,3463,1,1198296560,1198296650,15,18,90
8838492@N05,3463,12,1198296838,1198296873,3,18,35
8838492@N05,3463,7,1198296873,1198296953,4,18,80
8838492@N05,3463,12,1198296953,1198296990,4,18,37
8838492@N05,3463,7,1198296990,1198297043,3,18,53
8838492@N05,3463,1,1198297043,1198297090,4,18,47
8838492@N05,3463,7,1198297090,1198297128,3,18,38
8838492@N05,3463,1,1198297128,1198297218,5,18,90
8838492@N05,3463,4,1198300644,1198300987,2,18,343
8838492@N05,3463,6,1198300987,1198302007,4,18,1020
8838492@N05,3463,8,1198307883,1198308035,2,18,152
8838492@N05,3463,1,1198308035,1198308125,3,18,90
8838492@N05,3463,9,1198315571,1198317071,2,18,1500
88479439@N03,3464,10,1350702821,1350704321,7,3,1500
88479439@N03,3464,6,1350722154,1350723174,6,3,1020
88479439@N03,3464,9,1350731649,1350733149,1,3,1500
88488885@N00,3465,6,1274259178,1274260198,1,1,1020
88504071@N00,3466,2,1211603499,1211603889,2,1,390
8854930@N07,3467,6,1417858912,1417859932,2,1,1020
88653431@N00,3468,4,1338356683,1338357583,2,2,900
88653431@N00,3468,9,1338368623,1338370123,1,2,1500
88711965@N00,3469,4,1380497262,1380498162,2,3,900
88711965@N00,3469,12,1380508210,1380509710,2,3,1500
88711965@N00,3469,2,1380515889,1380516279,1,3,390
88740729@N02,3470,6,1470627666,1470628686,1,1,1020
88785574@N00,3471,5,1340334077,1340334977,1,1,900
88859710@N03,3472,1,1379049345,1379049435,1,1,90
88859710@N03,3473,1,1384476385,1384476475,1,1,90
88959316@N00,3474,1,1193490000,1193490090,1,1,90
88959316@N00,3475,8,1193544931,1193546071,2,1,1140
88984016@N00,3476,8,1253406554,1253407694,1,1,1140
88984016@N00,3477,6,1348867099,1348868057,2,2,958
88984016@N00,3477,4,1348868057,1348868957,1,2,900
88984016@N00,3478,1,1349269944,1349270034,1,1,90
88994581@N00,3479,4,1351227824,1351228724,2,2,900
88994581@N00,3479,5,1351229803,1351230703,1,2,900
89014556@N00,3480,7,1202977551,1202978571,2,1,1020
89014556@N00,3481,7,1203050304,1203051324,1,1,1020
89072528@N00,3482,1,1243226450,1243226540,2,2,90
89072528@N00,3482,2,1243247949,1243248339,1,2,390
89138020@N00,3483,10,1241479360,1241479870,3,18,510
89138020@N00,3483,8,1241479870,1241480225,3,18,355
89138020@N00,3483,4,1241480225,1241481118,3,18,893
89138020@N00,3483,6,1241481118,1241482138,13,18,1020
89138020@N00,3483,2,1241486716,1241487106,7,18,390
89138020@N00,3483,6,1241488614,1241489634,9,18,1020
89138020@N00,3483,3,1241489726,1241490146,7,18,420
89138020@N00,3483,8,1241492600,1241493740,3,18,1140
89138020@N00,3483,2,1241493969,1241494359,11,18,390
89138020@N00,3483,12,1241496936,1241498436,5,18,1500
89138020@N00,3483,13,1241499471,1241501271,18,18,1800
89138020@N00,3483,8,1241501601,1241501834,2,18,233
89138020@N00,3483,4,1241501834,1241502734,2,18,900
89138020@N00,3483,13,1241502942,1241504742,6,18,1800
89138020@N00,3483,8,1241506768,1241507908,4,18,1140
89138020@N00,3483,11,1241509266,1241510766,3,18,1500
89138020@N00,3483,3,1241511552,1241511972,3,18,420
89138020@N00,3483,8,1241513041,1241514181,2,18,1140
89138020@N00,3484,4,1241824780,1241825680,2,5,900
89138020@N00,3484,7,1241826382,1241827402,2,5,1020
89138020@N00,3484,2,1241828364,1241828754,11,5,390
89138020@N00,3484,6,1241829957,1241830435,2,5,478
89138020@N00,3484,12,1241830435,1241831935,8,5,1500
8927252@N06,3485,8,1319325026,1319326166,10,1,1140
8927252@N06,3486,8,1325409453,1325410593,5,1,1140
8927252@N06,3487,8,1355636448,1355637588,9,1,1140
89334444@N08,3488,4,1392000524,1392001424,2,2,900
89334444@N08,3488,11,1392014216,1392015716,1,2,1500
89388234@N00,3489,8,1371858010,1371859150,2,4,1140
89388234@N00,3489,4,1371866167,1371867067,3,4,900
89388234@N00,3489,6,1371868804,1371869142,2,4,338
89388234@N00,3489,2,1371869142,1371869532,3,4,390
89451823@N08,3490,1,1378943001,1378943091,3,3,90
89451823@N08,3490,5,1378943113,1378944013,2,3,900
89451823@N08,3490,6,1378947587,1378948607,1,3,1020
89455189@N05,3491,5,1396931731,1396932631,1,1,900
8949620@N08,3492,6,1209811321,1209812341,2,2,1020
8949620@N08,3492,2,1209828853,1209829243,1,2,390
8949620@N08,3493,2,1209861327,1209861717,3,3,390
8949620@N08,3493,13,1209861723,1209861841,3,3,118
8949620@N08,3493,2,1209861841,1209862231,1,3,390
8949620@N08,3494,2,1209897967,1209898357,2,3,390
8949620@N08,3494,6,1209898433,1209899453,2,3,1020
8949620@N08,3494,2,1209905544,1209905934,1,3,390
8949620@N08,3495,10,1243928189,1243929689,4,3,1500
8949620@N08,3495,8,1243945819,1243945856,2,3,37
8949620@N08,3495,10,1243945856,1243947356,9,3,1500
8951720@N04,3496,5,1304315047,1304315947,3,1,900
89522530@N00,3497,11,1332020870,1332021306,2,12,436
89522530@N00,3497,4,1332021306,1332022206,6,12,900
89522530@N00,3497,2,1332023817,1332024207,6,12,390
89522530@N00,3497,6,1332026844,1332027864,10,12,1020
89522530@N00,3497,3,1332032412,1332032832,2,12,420
89522530@N00,3497,6,1332033458,1332034478,3,12,1020
89522530@N00,3497,7,1332036939,1332037959,4,12,1020
89522530@N00,3497,12,1332038885,1332040385,7,12,1500
89522530@N00,3497,1,1332044107,1332044147,2,12,40
89522530@N00,3497,8,1332044147,1332045287,10,12,1140
89522530@N00,3497,2,1332045889,1332046279,5,12,390
89522530@N00,3497,13,1332048316,1332050116,9,12,1800
89573469@N03,3498,7,1367648257,1367649277,1,1,1020
89658123@N07,3499,9,1359707249,1359708749,1,1,1500
8980678@N03,3500,8,1190771688,1190772828,4,1,1140
8980678@N03,3501,8,1213503358,1213504498,2,1,1140
8980678@N03,3502,8,1229501221,1229502361,8,1,1140
8980678@N03,3503,8,1236726105,1236727245,2,2,1140
8980678@N03,3503,1,1236733629,1236733719,1,2,90
8980678@N03,3504,8,1268279657,1268280797,1,1,1140
8980678@N03,3505,8,1279196350,1279197490,1,1,1140
8980678@N03,3506,8,1284079786,1284080926,3,1,1140
8980678@N03,3507,8,1290071934,1290073074,6,1,1140
8980678@N03,3508,11,1294962927,1294963069,2,3,142
8980678@N03,3508,7,1294963069,1294963323,2,3,254
8980678@N03,3508,8,1294963323,1294964463,1,3,1140
8980678@N03,3509,8,1308277032,1308278172,3,1,1140
8980678@N03,3510,1,1379060147,1379060237,2,3,90
8980678@N03,3510,13,1379071694,1379073494,6,3,1800
8980678@N03,3510,1,1379077648,1379077738,1,3,90
8980678@N03,3511,6,1384157537,1384158557,3,1,1020
8980678@N03,3512,6,1418458235,1418459255,3,1,1020
89938050@N07,3513,1,1350356682,1350356772,2,1,90
90008840@N00,3514,6,1370745190,1370746210,2,3,1020
90008840@N00,3514,4,1370749060,1370749960,2,3,900
90008840@N00,3514,6,1370750687,1370751707,1,3,1020
90008840@N00,3515,6,1417854409,1417855429,4,1,1020
90008840@N00,3516,4,1444436591,1444437491,1,1,900
90008840@N00,3517,12,1462587683,1462589183,2,1,1500
90067442@N03,3518,5,1376773545,1376774445,1,1,900
90123960@N00,3519,4,1227159101,1227160001,3,9,900
90123960@N00,3519,6,1227160063,1227161083,14,9,1020
90123960@N00,3519,8,1227168533,1227168720,3,9,187
90123960@N00,3519,5,1227168720,1227169528,3,9,808
90123960@N00,3519,1,1227169528,1227169618,6,9,90
90123960@N00,3519,5,1227171421,1227172321,5,9,900
90123960@N00,3519,4,1227173678,1227173876,5,9,198
90123960@N00,3519,13,1227173876,1227175676,5,9,1800
90123960@N00,3519,8,1227180259,1227181399,1,9,1140
90123960@N00,3520,1,1295406851,1295406941,2,5,90
90123960@N00,3520,6,1295416924,1295417634,2,5,710
90123960@N00,3520,8,1295417634,1295418034,2,5,400
90123960@N00,3520,13,1295418034,1295419519,2,5,1485
90123960@N00,3520,1,1295419519,1295419609,1,5,90
90184981@N00,3521,1,1354350180,1354350270,1,1,90
9026784@N08,3522,6,1356768732,1356769752,1,1,1020
90315279@N00,3523,10,1369004774,1369006051,4,9,1277
90315279@N00,3523,1,1369006051,1369006141,3,9,90
90315279@N00,3523,5,1369007089,1369007989,2,9,900
90315279@N00,3523,6,1369015660,1369016680,2,9,1020
90315279@N00,3523,4,1369021143,1369022043,5,9,900
90315279@N00,3523,6,1369022108,1369023128,6,9,1020
90315279@N00,3523,4,1369025052,1369025952,3,9,900
90315279@N00,3523,2,1369026135,1369026525,6,9,390
90315279@N00,3523,10,1369041731,1369043231,2,9,1500
90315279@N00,3524,6,1443494565,1443495585,1,1,1020
90347114@N05,3525,8,1397175161,1397175523,4,4,362
90347114@N05,3525,12,1397175523,1397175742,2,4,219
90347114@N05,3525,11,1397175742,1397177242,4,4,1500
90347114@N05,3525,13,1397178039,1397179839,1,4,1800
9036688@N06,3526,2,1317184853,1317184895,2,6,42
9036688@N06,3526,10,1317184895,1317184926,2,6,31
9036688@N06,3526,2,1317184926,1317184985,2,6,59
9036688@N06,3526,10,1317184985,1317186485,14,6,1500
9036688@N06,3526,2,1317188509,1317188899,6,6,390
9036688@N06,3526,6,1317203312,1317204332,1,6,1020
9046670@N05,3527,1,1409467408,1409467498,1,1,90
90468007@N00,3528,1,1202906966,1202907056,1,1,90
90496636@N05,3529,12,1424668115,1424669615,1,1,1500
9053157@N02,3530,10,1340848819,1340848828,2,2,9
9053157@N02,3530,5,1340848828,1340849728,1,2,900
9053157@N02,3531,12,1341130304,1341131804,2,1,1500
9053157@N02,3532,4,1342155327,1342155339,2,2,12
9053157@N02,3532,6,1342155339,1342156359,1,2,1020
9053157@N02,3533,6,1342433708,1342434728,1,1,1020
90533800@N00,3534,1,1329616111,1329616201,2,3,90
90533800@N00,3534,6,1329617419,1329618439,2,3,1020
90533800@N00,3534,1,1329624910,1329625000,2,3,90
90642923@N00,3535,5,1193439603,1193440503,3,2,900
90642923@N00,3535,6,1193447780,1193448800,1,2,1020
90642923@N00,3536,2,1199672906,1199673296,3,2,390
90642923@N00,3536,4,1199681128,1199682028,1,2,900
90642923@N00,3537,1,1205465806,1205465896,3,2,90
90642923@N00,3537,6,1205472981,1205474001,1,2,1020
90642923@N00,3538,12,1212115426,1212115533,2,4,107
90642923@N00,3538,11,1212115533,1212115581,2,4,48
90642923@N00,3538,2,1212115581,1212115971,8,4,390
90642923@N00,3538,6,1212117482,1212118502,1,4,1020
90642923@N00,3539,6,1222826750,1222827770,5,1,1020
90642923@N00,3540,6,1231903230,1231904250,2,2,1020
90642923@N00,3540,2,1231916652,1231917042,2,2,390
90642923@N00,3541,13,1244866692,1244867224,2,4,532
90642923@N00,3541,2,1244867224,1244867614,2,4,390
90642923@N00,3541,6,1244870934,1244871954,2,4,1020
90642923@N00,3541,4,1244876033,1244876933,2,4,900
9070451@N03,3542,13,1400728673,1400730473,1,1,1800
90727225@N00,3543,8,1245457710,1245458850,10,1,1140
90728477@N00,3544,5,1369436260,1369437160,2,5,900
90728477@N00,3544,2,1369439563,1369439953,2,5,390
90728477@N00,3544,8,1369440222,1369441362,2,5,1140
90728477@N00,3544,4,1369441549,1369442449,3,5,900
90728477@N00,3544,5,1369455805,1369456705,2,5,900
90844305@N00,3545,2,1215575896,1215576286,1,1,390
91045059@N02,3546,1,1358115783,1358115873,23,4,90
91045059@N02,3546,6,1358121117,1358122137,5,4,1020
91045059@N02,3546,13,1358122627,1358124427,3,4,1800
91045059@N02,3546,1,1358126330,1358126420,98,4,90
91087719@N08,3547,6,1416833650,1416834670,1,1,1020
91087719@N08,3548,6,1449309527,1449310547,1,1,1020
91092205@N07,3549,1,1368061136,1368061226,19,5,90
91092205@N07,3549,5,1368068707,1368069607,30,5,900
91092205@N07,3549,1,1368072066,1368072156,3,5,90
91092205@N07,3549,4,1368072644,1368073544,5,5,900
91092205@N07,3549,1,1368099006,1368099096,7,5,90
91110029@N02,3550,5,1389685849,1389686749,1,1,900
91110029@N02,3551,8,1412557092,1412558232,1,1,1140
91110029@N02,3552,1,1414619265,1414619355,1,1,90
91132397@N08,3553,12,1417498960,1417500460,2,2,1500
91132397@N08,3553,6,1417501724,1417502744,2,2,1020
91144647@N06,3554,4,1333874027,1333874927,1,1,900
91144647@N06,3555,6,1334134833,1334135853,2,1,1020
91144647@N06,3556,8,1355611034,1355612174,1,1,1140
91207697@N08,3557,7,1413442745,1413443765,2,3,1020
91207697@N08,3557,8,1413444197,1413445337,2,3,1140
91207697@N08,3557,9,1413449903,1413451403,1,3,1500
91207697@N08,3558,6,1413851157,1413852177,3,1,1020
91207697@N08,3559,4,1414196728,1414197628,2,1,900
91207697@N08,3560,8,1423377587,1423378727,1,1,1140
91220827@N02,3561,6,1377040834,1377041854,1,1,1020
91227690@N08,3562,12,1459836255,1459836682,11,2,427
91227690@N08,3562,7,1459836682,1459837702,1,2,1020
91227690@N08,3563,1,1460349778,1460349868,2,3,90
91227690@N08,3563,5,1460352025,1460352925,5,3,900
91227690@N08,3563,4,1460354236,1460355136,9,3,900
91227690@N08,3564,5,1460697780,1460698680,8,3,900
91227690@N08,3564,8,1460699471,1460700611,11,3,1140
91227690@N08,3564,2,1460701572,1460701962,2,3,390
91227690@N08,3565,5,1461129981,1461130881,1,1,900
91227690@N08,3566,1,1461559592,1461559682,2,2,90
91227690@N08,3566,5,1461561680,1461562580,3,2,900
91315857@N02,3567,5,1377202862,1377203762,1,1,900
91315857@N02,3568,9,1378191334,1378192834,1,1,1500
91315857@N02,3569,1,1440275042,1440275132,2,3,90
91315857@N02,3569,8,1440280107,1440281247,3,3,1140
91315857@N02,3569,4,1440282584,1440283484,2,3,900
91363409@N07,3570,5,1416003408,1416004308,3,2,900
91363409@N07,3570,2,1416016389,1416016779,1,2,390
91372718@N04,3571,8,1374458740,1374459880,2,6,1140
91372718@N04,3571,13,1374463335,1374464597,3,6,1262
91372718@N04,3571,2,1374464597,1374464987,2,6,390
91372718@N04,3571,1,1374487963,1374488053,3,6,90
91372718@N04,3571,9,1374497603,1374498846,2,6,1243
91372718@N04,3571,10,1374498846,1374500346,2,6,1500
91372718@N04,3572,10,1374652951,1374654451,2,3,1500
91372718@N04,3572,4,1374658303,1374659203,2,3,900
91372718@N04,3572,5,1374659798,1374660698,3,3,900
91380511@N05,3573,6,1321693932,1321694952,1,1,1020
91407288@N07,3574,10,1352066288,1352067788,2,6,1500
91407288@N07,3574,5,1352074735,1352075635,5,6,900
91407288@N07,3574,11,1352081862,1352083362,2,6,1500
91407288@N07,3574,6,1352089937,1352090957,2,6,1020
91407288@N07,3574,1,1352100189,1352100279,4,6,90
91407288@N07,3574,4,1352103167,1352104067,9,6,900
91407288@N07,3575,5,1352443435,1352444335,1,1,900
91409399@N07,3576,4,1379741788,1379742688,3,3,900
91409399@N07,3576,8,1379747465,1379748605,3,3,1140
91409399@N07,3576,1,1379751893,1379751983,2,3,90
91409399@N07,3577,6,1379811800,1379812820,2,3,1020
91409399@N07,3577,13,1379821756,1379823556,4,3,1800
91409399@N07,3577,5,1379827358,1379828258,1,3,900
91435349@N03,3578,6,1381383114,1381384134,1,1,1020
91501015@N07,3579,6,1356419850,1356420870,1,1,1020
91511594@N02,3580,4,1385375457,1385376357,3,2,900
91511594@N02,3580,2,1385380065,1385380455,1,2,390
91511594@N02,3581,2,1385445083,1385445473,1,1,390
91569514@N05,3582,1,1432683158,1432683248,5,1,90
91569514@N05,3583,13,1433302111,1433302676,2,2,565
91569514@N05,3583,12,1433302676,1433304176,3,2,1500
9161595@N03,3584,8,1329346930,1329348070,13,8,1140
9161595@N03,3584,13,1329352839,1329354534,4,8,1695
9161595@N03,3584,1,1329354534,1329354624,2,8,90
9161595@N03,3584,12,1329358196,1329359696,3,8,1500
9161595@N03,3584,6,1329362111,1329363131,10,8,1020
9161595@N03,3584,11,1329366450,1329367950,4,8,1500
9161595@N03,3584,2,1329373498,1329373888,2,8,390
9161595@N03,3584,1,1329376293,1329376383,1,8,90
91619162@N06,3585,13,1360380131,1360381931,1,1,1800
91621746@N00,3586,10,1330230505,1330232005,2,4,1500
91621746@N00,3586,13,1330235012,1330235443,8,4,431
91621746@N00,3586,4,1330235443,1330236343,5,4,900
91621746@N00,3586,9,1330250191,1330251691,4,4,1500
91678850@N02,3587,6,1355301479,1355302499,2,1,1020
91694685@N00,3588,7,1220953406,1220954426,4,2,1020
91694685@N00,3588,8,1220954641,1220955781,1,2,1140
91694685@N00,3589,2,1221004672,1221005062,6,1,390
9176927@N08,3590,1,1225858935,1225859025,4,2,90
9176927@N08,3590,4,1225864392,1225865292,3,2,900
9176927@N08,3591,1,1239237651,1239237741,3,3,90
9176927@N08,3591,11,1239240060,1239241560,2,3,1500
9176927@N08,3591,6,1239242001,1239243021,1,3,1020
91831221@N00,3592,1,1326497911,1326498001,1,1,90
91859523@N00,3593,1,1303706037,1303706127,2,5,90
91859523@N00,3593,13,1303706257,1303708057,2,5,1800
91859523@N00,3593,4,1303709143,1303709760,2,5,617
91859523@N00,3593,6,1303709760,1303710780,2,5,1020
91859523@N00,3593,1,1303711773,1303711863,1,5,90
91894661@N02,3594,1,1366516686,1366516776,1,1,90
9191162@N05,3595,2,1225500177,1225500567,2,1,390
9197147@N03,3596,8,1400212387,1400213527,1,1,1140
9197147@N03,3597,2,1400295152,1400295542,1,1,390
92005509@N02,3598,8,1464144216,1464145356,1,1,1140
92008781@N05,3599,1,1354672980,1354673070,1,1,90
92026547@N05,3600,1,1411550746,1411550836,2,2,90
92026547@N05,3600,5,1411551936,1411552836,6,2,900
92026547@N05,3601,5,1417862121,1417862984,3,2,863
92026547@N05,3601,8,1417862984,1417864124,2,2,1140
92098172@N03,3602,5,1357857343,1357858243,3,2,900
92098172@N03,3602,8,1357870847,1357871987,1,2,1140
9213713@N02,3603,5,1387935713,1387936613,1,1,900
92238955@N06,3604,7,1354067756,1354068776,3,1,1020
92248782@N00,3605,8,1381233678,1381234818,1,1,1140
9228491@N06,3606,10,1267305749,1267307249,4,10,1500
9228491@N06,3606,1,1267307256,1267307346,3,10,90
9228491@N06,3606,6,1267312196,1267313216,2,10,1020
9228491@N06,3606,2,1267314816,1267315206,2,10,390
9228491@N06,3606,12,1267319061,1267320561,4,10,1500
9228491@N06,3606,5,1267320590,1267321490,4,10,900
9228491@N06,3606,1,1267330000,1267330090,3,10,90
9228491@N06,3606,10,1267331938,1267333438,18,10,1500
9228491@N06,3606,5,1267335435,1267335737,3,10,302
9228491@N06,3606,1,1267335737,1267335827,1,10,90
9228491@N06,3607,10,1267566739,1267566755,2,12,16
9228491@N06,3607,1,1267566755,1267566845,4,12,90
9228491@N06,3607,8,1267567230,1267567563,2,12,333
9228491@N06,3607,2,1267567563,1267567953,4,12,390
9228491@N06,3607,8,1267568239,1267568442,2,12,203
9228491@N06,3607,6,1267568442,1267569462,7,12,1020
9228491@N06,3607,4,1267570774,1267571674,2,12,900
9228491@N06,3607,12,1267573312,1267573575,16,12,263
9228491@N06,3607,1,1267573575,1267573665,3,12,90
9228491@N06,3607,8,1267573770,1267574910,3,12,1140
9228491@N06,3607,1,1267576984,1267577074,3,12,90
9228491@N06,3607,2,1267589704,1267590094,3,12,390
9228491@N06,3608,1,1267676836,1267676926,2,22,90
9228491@N06,3608,2,1267677109,1267677499,4,22,390
9228491@N06,3608,13,1267679081,1267680881,6,22,1800
9228491@N06,3608,6,1267681785,1267682207,7,22,422
9228491@N06,3608,8,1267682207,1267682406,6,22,199
9228491@N06,3608,11,1267682406,1267682624,5,22,218
9228491@N06,3608,7,1267682624,1267682658,2,22,34
9228491@N06,3608,8,1267682658,1267682703,2,22,45
9228491@N06,3608,1,1267682703,1267682793,8,22,90
9228491@N06,3608,8,1267683264,1267683612,3,22,348
9228491@N06,3608,6,1267683612,1267683736,3,22,124
9228491@N06,3608,13,1267683736,1267683791,2,22,55
9228491@N06,3608,4,1267683791,1267684691,4,22,900
9228491@N06,3608,6,1267685104,1267685314,2,22,210
9228491@N06,3608,2,1267685314,1267685454,2,22,140
9228491@N06,3608,11,1267685454,1267685554,2,22,100
9228491@N06,3608,12,1267685554,1267685832,3,22,278
9228491@N06,3608,2,1267685832,1267686222,2,22,390
9228491@N06,3608,13,1267686474,1267686990,3,22,516
9228491@N06,3608,8,1267686990,1267688130,9,22,1140
9228491@N06,3608,10,1267690999,1267692499,5,22,1500
9228491@N06,3608,9,1267696512,1267698012,5,22,1500
9228491@N06,3609,2,1268090257,1268090647,32,1,390
9228491@N06,3610,1,1323644199,1323644289,2,1,90
9228491@N06,3611,8,1323752602,1323753742,3,3,1140
9228491@N06,3611,6,1323756965,1323757985,2,3,1020
9228491@N06,3611,9,1323767561,1323769061,3,3,1500
9228491@N06,3612,8,1329534021,1329535161,1,1,1140
9230719@N05,3613,6,1291447905,1291448925,4,2,1020
9230719@N05,3613,11,1291450617,1291452117,1,2,1500
92375998@N05,3614,1,1370071597,1370071687,1,1,90
92504072@N06,3615,13,1291416261,1291418061,3,1,1800
92505486@N00,3616,6,1289379294,1289380314,3,2,1020
92505486@N00,3616,8,1289380996,1289382136,2,2,1140
92517428@N00,3617,10,1287320400,1287321900,24,1,1500
92533979@N00,3618,4,1359853680,1359854580,3,5,900
92533979@N00,3618,10,1359868699,1359870199,5,5,1500
92533979@N00,3618,4,1359870897,1359871797,2,5,900
92533979@N00,3618,8,1359874745,1359875885,2,5,1140
92533979@N00,3618,9,1359880069,1359881569,1,5,1500
92589815@N02,3619,8,1366776901,1366778041,11,1,1140
9261503@N08,3620,1,1434245632,1434245722,8,2,90
9261503@N08,3620,8,1434248625,1434249765,2,2,1140
92622262@N08,3621,9,1370690814,1370692314,7,1,1500
92622262@N08,3622,5,1378532918,1378533818,5,3,900
92622262@N08,3622,4,1378543008,1378543908,6,3,900
92622262@N08,3622,6,1378544463,1378545483,2,3,1020
92622262@N08,3623,6,1392443377,1392443453,3,3,76
92622262@N08,3623,4,1392443453,1392444353,2,3,900
92622262@N08,3623,5,1392452044,1392452944,1,3,900
92622262@N08,3624,2,1400997297,1400997687,3,2,390
92622262@N08,3624,4,1401004109,1401005009,1,2,900
92622262@N08,3625,6,1418454869,1418455889,2,1,1020
9290765@N06,3626,7,1222221927,1222222947,9,2,1020
9290765@N06,3626,5,1222226504,1222227404,3,2,900
9292159@N06,3627,10,1449657597,1449658066,2,2,469
9292159@N06,3627,1,1449658066,1449658156,1,2,90
9292159@N06,3628,8,1449729530,1449730121,3,10,591
9292159@N06,3628,13,1449730121,1449730601,3,10,480
9292159@N06,3628,6,1449730601,1449731621,3,10,1020
9292159@N06,3628,7,1449731959,1449732979,2,10,1020
9292159@N06,3628,12,1449733155,1449733780,6,10,625
9292159@N06,3628,8,1449733780,1449734703,2,10,923
9292159@N06,3628,4,1449734703,1449735603,2,10,900
9292159@N06,3628,10,1449738471,1449738597,3,10,126
9292159@N06,3628,5,1449738597,1449739497,2,10,900
9292159@N06,3628,6,1449739725,1449740745,8,10,1020
92931591@N05,3629,9,1440919316,1440920816,1,1,1500
93003498@N05,3630,1,1331882111,1331882201,3,1,90
93003498@N05,3631,7,1367470402,1367471422,3,1,1020
93074386@N00,3632,9,1444987879,1444989379,1,1,1500
93081598@N05,3633,1,1365496364,1365496454,5,2,90
93081598@N05,3633,5,1365498605,1365499505,1,2,900
93117900@N03,3634,4,1383108991,1383109891,1,1,900
93150071@N06,3635,8,1363832547,1363833687,1,1,1140
93283041@N00,3636,5,1217925264,1217926164,1,1,900
93283041@N00,3637,1,1229464800,1229464802,3,25,2
93283041@N00,3637,6,1229464802,1229464823,20,25,21
93283041@N00,3637,13,1229464823,1229464830,3,25,7
93283041@N00,3637,6,1229464830,1229464832,3,25,2
93283041@N00,3637,7,1229464832,1229464833,2,25,1
93283041@N00,3637,6,1229464833,1229464842,4,25,9
93283041@N00,3637,1,1229464842,1229464843,2,25,1
93283041@N00,3637,5,1229464843,1229464844,2,25,1
93283041@N00,3637,10,1229464844,1229464845,2,25,1
93283041@N00,3637,1,1229464845,1229464847,2,25,2
93283041@N00,3637,6,1229464847,1229464850,4,25,3
93283041@N00,3637,8,1229464850,1229464851,2,25,1
93283041@N00,3637,7,1229464851,1229464857,7,25,6
93283041@N00,3637,1,1229464857,1229464868,9,25,11
93283041@N00,3637,8,1229464868,1229464869,2,25,1
93283041@N00,3637,1,1229464869,1229464870,2,25,1
93283041@N00,3637,8,1229464870,1229464878,8,25,8
93283041@N00,3637,12,1229464878,1229464879,2,25,1
93283041@N00,3637,10,1229464879,1229464889,8,25,10
93283041@N00,3637,1,1229464889,1229464890,2,25,1
93283041@N00,3637,6,1229464890,1229464898,8,25,8
93283041@N00,3637,8,1229464898,1229464899,2,25,1
93283041@N00,3637,10,1229464899,1229464904,6,25,5
93283041@N00,3637,1,1229464904,1229464907,4,25,3
93283041@N00,3637,10,1229464907,1229466407,1,25,1500
93283041@N00,3638,11,1279073014,1279074514,21,1,1500
93283041@N00,3639,10,1289097010,1289098510,3,3,1500
93283041@N00,3639,6,1289101865,1289102885,3,3,1020
93283041@N00,3639,9,1289112979,1289114479,2,3,1500
93283041@N00,3640,6,1292482813,1292483833,16,1,1020
9329633@N04,3641,2,1354244096,1354244486,1,1,390
93334382@N02,3642,5,1392499041,1392499941,3,1,900
93371661@N08,3643,1,1360361977,1360362067,1,1,90
93461622@N00,3644,4,1445583010,1445583910,2,2,900
93461622@N00,3644,9,1445595462,1445596962,1,2,1500
93480471@N06,3645,8,1362002069,1362003209,72,1,1140
93480471@N06,3646,8,1362113079,1362114219,39,1,1140
93503884@N03,3647,8,1351323969,1351325109,3,2,1140
93503884@N03,3647,2,1351325488,1351325878,1,2,390
93514520@N02,3648,6,1357028842,1357029862,1,1,1020
93538524@N06,3649,10,1374539053,1374540553,2,5,1500
93538524@N06,3649,1,1374540965,1374541055,4,5,90
93538524@N06,3649,6,1374546093,1374547113,7,5,1020
93538524@N06,3649,4,1374550124,1374551024,5,5,900
93538524@N06,3649,6,1374551711,1374552731,23,5,1020
93586926@N05,3650,5,1410204573,1410204608,2,2,35
93586926@N05,3650,4,1410204608,1410205508,1,2,900
93629101@N05,3651,10,1430600451,1430601951,4,34,1500
93629101@N05,3651,8,1430616929,1430618069,16,34,1140
93629101@N05,3651,2,1430618133,1430618252,5,34,119
93629101@N05,3651,8,1430618252,1430618380,6,34,128
93629101@N05,3651,2,1430618380,1430618610,5,34,230
93629101@N05,3651,13,1430618610,1430618789,5,34,179
93629101@N05,3651,6,1430618789,1430619809,6,34,1020
93629101@N05,3651,12,1430619835,1430620403,2,34,568
93629101@N05,3651,7,1430620403,1430621423,6,34,1020
93629101@N05,3651,9,1430621591,1430621608,2,34,17
93629101@N05,3651,12,1430621608,1430623057,20,34,1449
93629101@N05,3651,11,1430623057,1430623666,42,34,609
93629101@N05,3651,7,1430623666,1430624686,34,34,1020
93629101@N05,3651,8,1430625861,1430625961,2,34,100
93629101@N05,3651,2,1430625961,1430626351,12,34,390
93629101@N05,3651,8,1430627907,1430627982,2,34,75
93629101@N05,3651,2,1430627982,1430628372,8,34,390
93629101@N05,3651,6,1430632735,1430633755,14,34,1020
93629101@N05,3651,3,1430634109,1430634121,2,34,12
93629101@N05,3651,4,1430634121,1430634589,5,34,468
93629101@N05,3651,6,1430634589,1430635609,5,34,1020
93629101@N05,3651,4,1430636923,1430637192,2,34,269
93629101@N05,3651,1,1430637192,1430637282,5,34,90
93629101@N05,3651,10,1430637433,1430638933,11,34,1500
93629101@N05,3651,1,1430640485,1430640485,2,34,0
93629101@N05,3651,8,1430640485,1430640688,2,34,203
93629101@N05,3651,2,1430640688,1430640809,3,34,121
93629101@N05,3651,8,1430640809,1430640890,2,34,81
93629101@N05,3651,2,1430640890,1430641280,43,34,390
93629101@N05,3651,9,1430650926,1430652426,50,34,1500
93629101@N05,3651,5,1430653618,1430653735,4,34,117
93629101@N05,3651,10,1430653735,1430654297,2,34,562
93629101@N05,3651,5,1430654297,1430655126,5,34,829
93629101@N05,3651,1,1430655126,1430655216,9,34,90
93743574@N08,3652,4,1416951484,1416952384,11,3,900
93743574@N08,3652,6,1416954168,1416955188,2,3,1020
93743574@N08,3652,2,1416976566,1416976956,2,3,390
93857621@N00,3653,6,1387956435,1387957455,1,1,1020
93890245@N05,3654,13,1377168598,1377170398,2,2,1800
93890245@N05,3654,5,1377172030,1377172930,1,2,900
9426620@N06,3655,4,1213912126,1213913026,7,3,900
9426620@N06,3655,8,1213914718,1213915858,5,3,1140
9426620@N06,3655,1,1213919553,1213919643,1,3,90
9426620@N06,3656,8,1213966810,1213967950,1,1,1140
94335186@N07,3657,1,1427920969,1427921059,2,1,90
94378868@N00,3658,5,1361266231,1361266308,2,2,77
94378868@N00,3658,6,1361266308,1361267328,1,2,1020
94436430@N00,3659,7,1360276591,1360277611,1,1,1020
94529757@N00,3660,1,1256006934,1256007024,1,1,90
9456601@N03,3661,1,1308441934,1308442024,2,3,90
9456601@N03,3661,4,1308458057,1308458957,2,3,900
9456601@N03,3661,13,1308469030,1308470830,4,3,1800
9459831@N04,3662,6,1288492946,1288493966,1,1,1020
94608875@N00,3663,1,1215479321,1215479411,11,1,90
94608875@N00,3664,1,1215561189,1215561279,1,1,90
94608875@N00,3665,1,1215650714,1215650804,31,1,90
94608875@N00,3666,6,1291267854,1291268874,15,1,1020
9461342@N03,3667,2,1397195919,1397196309,1,1,390
9461342@N03,3668,6,1460012776,1460013796,1,1,1020
94687753@N00,3669,8,1372374103,1372375243,2,2,1140
94687753@N00,3669,2,1372377541,1372377931,1,2,390
94697173@N00,3670,4,1432936953,1432937474,10,5,521
94697173@N00,3670,6,1432937474,1432937648,2,5,174
94697173@N00,3670,4,1432937648,1432938548,21,5,900
94697173@N00,3670,8,1432943838,1432944978,25,5,1140
94697173@N00,3670,2,1432951738,1432952128,1,5,390
94697173@N00,3671,1,1443568631,1443568721,6,13,90
94697173@N00,3671,13,1443568751,1443568890,6,13,139
94697173@N00,3671,8,1443568890,1443570030,2,13,1140
94697173@N00,3671,1,1443571025,1443571115,5,13,90
94697173@N00,3671,12,1443571585,1443571724,2,13,139
94697173@N00,3671,11,1443571724,1443572289,14,13,565
94697173@N00,3671,7,1443572289,1443572308,2,13,19
94697173@N00,3671,8,1443572308,1443572332,3,13,24
94697173@N00,3671,7,1443572332,1443572715,8,13,383
94697173@N00,3671,2,1443572715,1443573105,3,13,390
94697173@N00,3671,6,1443574203,1443574770,47,13,567
94697173@N00,3671,4,1443574770,1443575670,5,13,900
94697173@N00,3671,8,1443576640,1443577780,1,13,1140
94697173@N00,3672,12,1454647799,1454649299,24,1,1500
94921086@N08,3673,5,1384383067,1384383967,1,1,900
95095552@N02,3674,8,1399076817,1399077957,3,3,1140
95095552@N02,3674,12,1399104606,1399106106,2,3,1500
95095552@N02,3674,2,1399115727,1399116117,2,3,390
95095552@N02,3675,4,1399230208,1399231108,3,1,900
95225007@N00,3676,2,1383961187,1383961577,1,1,390
95258067@N00,3677,6,1386807961,1386808981,3,12,1020
95258067@N00,3677,13,1386812188,1386813988,2,12,1800
95258067@N00,3677,6,1386818203,1386819223,2,12,1020
95258067@N00,3677,8,1386821386,1386822526,2,12,1140
95258067@N00,3677,11,1386825657,1386825863,2,12,206
95258067@N00,3677,2,1386825863,1386826253,2,12,390
95258067@N00,3677,7,1386832232,1386832523,2,12,291
95258067@N00,3677,8,1386832523,1386833663,3,12,1140
95258067@N00,3677,6,1386833916,1386834936,11,12,1020
95258067@N00,3677,5,1386836094,1386836994,4,12,900
95258067@N00,3677,9,1386839139,1386840639,3,12,1500
95258067@N00,3677,10,1386841334,1386842834,1,12,1500
95258067@N00,3678,11,1386889278,1386889394,2,3,116
95258067@N00,3678,8,1386889394,1386890534,3,3,1140
95258067@N00,3678,10,1386890816,1386892316,1,3,1500
95341382@N05,3679,9,1438511174,1438512674,1,1,1500
95341382@N05,3680,2,1443262057,1443262447,2,1,390
95356654@N00,3681,8,1223469300,1223470440,1,1,1140
95356654@N00,3682,4,1327886408,1327887308,1,1,900
95356654@N00,3683,9,1390205936,1390207436,21,1,1500
95400328@N03,3684,13,1371506890,1371508690,2,2,1800
95400328@N03,3684,2,1371511664,1371512054,1,2,390
95400328@N03,3685,9,1371547482,1371548982,1,1,1500
95413039@N00,3686,8,1198279887,1198281027,86,1,1140
9549670@N05,3687,1,1467842410,1467842500,9,23,90
9549670@N05,3687,13,1467842637,1467842961,3,23,324
9549670@N05,3687,4,1467842961,1467843021,2,23,60
9549670@N05,3687,6,1467843021,1467843029,2,23,8
9549670@N05,3687,4,1467843029,1467843048,2,23,19
9549670@N05,3687,6,1467843048,1467844068,11,23,1020
9549670@N05,3687,4,1467844560,1467844662,3,23,102
9549670@N05,3687,6,1467844662,1467844829,2,23,167
9549670@N05,3687,8,1467844829,1467845149,14,23,320
9549670@N05,3687,2,1467845149,1467845432,4,23,283
9549670@N05,3687,7,1467845432,1467845479,3,23,47
9549670@N05,3687,12,1467845479,1467845882,5,23,403
9549670@N05,3687,1,1467845882,1467845895,2,23,13
9549670@N05,3687,7,1467845895,1467845956,3,23,61
9549670@N05,3687,1,1467845956,1467846046,3,23,90
9549670@N05,3687,8,1467846084,1467846509,5,23,425
9549670@N05,3687,1,1467846509,1467846599,6,23,90
9549670@N05,3687,5,1467846694,1467846701,2,23,7
9549670@N05,3687,1,1467846701,1467846791,3,23,90
9549670@N05,3687,5,1467846805,1467847046,2,23,241
9549670@N05,3687,1,1467847046,1467847136,2,23,90
9549670@N05,3687,8,1467847381,1467848062,2,23,681
9549670@N05,3687,1,1467848062,1467848152,2,23,90
95532183@N07,3688,6,1451802694,1451803714,1,1,1020
95532183@N07,3689,12,1452582024,1452583524,1,1,1500
95555269@N00,3690,12,1385253583,1385255083,3,5,1500
95555269@N00,3690,1,1385256950,1385257040,3,5,90
95555269@N00,3690,6,1385270437,1385271457,7,5,1020
95555269@N00,3690,9,1385276147,1385277647,2,5,1500
95555269@N00,3690,6,1385277717,1385278737,4,5,1020
95559818@N00,3691,1,1190686249,1190686339,3,1,90
95559818@N00,3692,4,1333442529,1333443429,2,2,900
95559818@N00,3692,1,1333446480,1333446570,1,2,90
95572727@N00,3693,5,1310175368,1310176268,1,1,900
95608654@N04,3694,1,1363835351,1363835441,2,5,90
95608654@N04,3694,6,1363840969,1363841989,4,5,1020
95608654@N04,3694,4,1363842892,1363843792,2,5,900
95608654@N04,3694,5,1363846468,1363847368,2,5,900
95608654@N04,3694,1,1363848348,1363848438,2,5,90
95615577@N07,3695,7,1379578266,1379579286,150,1,1020
95653839@N03,3696,5,1416540042,1416540942,1,1,900
95694198@N00,3697,5,1363124667,1363125567,4,4,900
95694198@N00,3697,3,1363130611,1363131031,2,4,420
95694198@N00,3697,13,1363133989,1363135789,6,4,1800
95694198@N00,3697,5,1363137464,1363138364,1,4,900
95778894@N00,3698,8,1457233861,1457235001,2,4,1140
95778894@N00,3698,6,1457243548,1457244568,2,4,1020
95778894@N00,3698,7,1457255685,1457256246,2,4,561
95778894@N00,3698,12,1457256246,1457257746,1,4,1500
95786139@N05,3699,2,1342412035,1342412425,1,1,390
95839603@N02,3700,10,1395871551,1395872198,3,15,647
95839603@N02,3700,8,1395872198,1395872913,6,15,715
95839603@N02,3700,2,1395872913,1395873303,6,15,390
95839603@N02,3700,6,1395873382,1395874402,3,15,1020
95839603@N02,3700,12,1395874451,1395875951,5,15,1500
95839603@N02,3700,6,1395884707,1395884935,3,15,228
95839603@N02,3700,2,1395884935,1395885325,3,15,390
95839603@N02,3700,8,1395887543,1395888683,3,15,1140
95839603@N02,3700,6,1395893357,1395894377,3,15,1020
95839603@N02,3700,13,1395896940,1395898740,3,15,1800
95839603@N02,3700,4,1395901589,1395902489,2,15,900
95839603@N02,3700,7,1395903822,1395904842,2,15,1020
95839603@N02,3700,1,1395910236,1395910326,3,15,90
95839603@N02,3700,10,1395911220,1395912720,2,15,1500
95839603@N02,3700,9,1395914158,1395915658,1,15,1500
95928504@N03,3701,1,1428295003,1428295093,2,2,90
95928504@N03,3701,5,1428295649,1428296549,1,2,900
95979850@N00,3702,12,1237094513,1237096013,5,1,1500
96062950@N02,3703,8,1386199991,1386200595,2,7,604
96062950@N02,3703,6,1386200595,1386201615,2,7,1020
96062950@N02,3703,5,1386204498,1386205398,3,7,900
96062950@N02,3703,8,1386205942,1386207082,4,7,1140
96062950@N02,3703,13,1386220231,1386222031,2,7,1800
96062950@N02,3703,6,1386227691,1386228711,6,7,1020
96062950@N02,3703,2,1386228975,1386229365,2,7,390
96062950@N02,3704,11,1386460737,1386460781,2,5,44
96062950@N02,3704,7,1386460781,1386461003,2,5,222
96062950@N02,3704,10,1386461003,1386461146,2,5,143
96062950@N02,3704,9,1386461146,1386462646,2,5,1500
96062950@N02,3704,10,1386464970,1386466470,1,5,1500
96074685@N04,3705,2,1373941195,1373941585,17,5,390
96074685@N04,3705,4,1373964341,1373964743,52,5,402
96074685@N04,3705,13,1373964743,1373965230,3,5,487
96074685@N04,3705,1,1373965230,1373965320,7,5,90
96074685@N04,3705,13,1373971399,1373973199,12,5,1800
96074685@N04,3706,6,1374127764,1374128784,3,1,1020
96077153@N00,3707,6,1291541287,1291542307,2,1,1020
96077153@N00,3708,10,1322440332,1322441832,1,1,1500
96077153@N00,3709,10,1337923437,1337924937,2,2,1500
96077153@N00,3709,9,1337940878,1337942378,1,2,1500
96084178@N00,3710,1,1257823273,1257823363,4,1,90
96084178@N00,3711,6,1395476810,1395477830,3,1,1020
96110416@N06,3712,1,1374191048,1374191138,2,5,90
96110416@N06,3712,12,1374195271,1374196771,3,5,1500
96110416@N06,3712,1,1374207110,1374207200,2,5,90
96110416@N06,3712,6,1374220906,1374221415,2,5,509
96110416@N06,3712,1,1374221415,1374221505,1,5,90
96110416@N06,3713,6,1375163118,1375164138,1,1,1020
9611843@N04,3714,7,1265844084,1265845104,1,1,1020
9611843@N04,3715,11,1295311953,1295313453,1,1,1500
9611843@N04,3716,1,1317340395,1317340485,1,1,90
9611843@N04,3717,8,1350258933,1350260073,1,1,1140
96139953@N06,3718,10,1448680658,1448682158,18,3,1500
96139953@N06,3718,6,1448686138,1448687158,2,3,1020
96139953@N06,3718,7,1448695531,1448696551,1,3,1020
9621505@N08,3719,5,1411165787,1411166687,1,1,900
96244139@N03,3720,7,1280202606,1280203626,13,1,1020
96269557@N00,3721,6,1245806887,1245807225,2,4,338
96269557@N00,3721,2,1245807225,1245807615,4,4,390
96269557@N00,3721,6,1245807622,1245807661,6,4,39
96269557@N00,3721,2,1245807661,1245808051,1,4,390
96274088@N05,3722,1,1356217007,1356217097,2,7,90
96274088@N05,3722,5,1356217128,1356218028,2,7,900
96274088@N05,3722,6,1356226956,1356227976,4,7,1020
96274088@N05,3722,8,1356238053,1356239193,2,7,1140
96274088@N05,3722,6,1356239401,1356240421,2,7,1020
96274088@N05,3722,9,1356249804,1356251304,2,7,1500
96274088@N05,3722,6,1356251898,1356252918,9,7,1020
96274088@N05,3723,4,1356386730,1356387630,2,3,900
96274088@N05,3723,11,1356388761,1356389319,2,3,558
96274088@N05,3723,6,1356389319,1356390339,1,3,1020
96306402@N08,3724,5,1370325119,1370326019,1,1,900
96312503@N08,3725,10,1373123293,1373124793,1,1,1500
96312503@N08,3726,10,1382265956,1382267456,1,1,1500
96312503@N08,3727,4,1398912442,1398913342,3,2,900
96312503@N08,3727,1,1398947742,1398947832,1,2,90
96312503@N08,3728,6,1400928391,1400929411,1,1,1020
96312503@N08,3729,1,1400974586,1400974676,1,1,90
96312503@N08,3730,7,1401189653,1401190673,1,1,1020
9639902@N04,3731,8,1222901624,1222902764,1,1,1140
9639902@N04,3732,8,1240467091,1240468231,3,2,1140
9639902@N04,3732,11,1240481122,1240482622,1,2,1500
96430093@N05,3733,13,1369976696,1369978496,1,1,1800
96430093@N05,3734,4,1372995949,1372996849,3,2,900
96430093@N05,3734,1,1373006274,1373006364,1,2,90
96430093@N05,3735,1,1382221186,1382221276,3,2,90
96430093@N05,3735,8,1382235260,1382236400,1,2,1140
96430093@N05,3736,5,1382918841,1382919741,1,1,900
96430093@N05,3737,12,1391382053,1391383553,2,4,1500
96430093@N05,3737,1,1391384616,1391384706,5,4,90
96430093@N05,3737,12,1391392976,1391393288,2,4,312
96430093@N05,3737,1,1391393288,1391393378,2,4,90
96430093@N05,3738,1,1395188959,1395189049,3,1,90
96430093@N05,3739,1,1395451073,1395451163,3,1,90
96430093@N05,3740,4,1395521863,1395522763,1,1,900
96430093@N05,3741,1,1401521593,1401521683,1,1,90
96430093@N05,3742,1,1425341290,1425341380,1,1,90
96430093@N05,3743,1,1426884716,1426884806,1,1,90
96430093@N05,3744,1,1453940661,1453940751,1,1,90
9644199@N02,3745,8,1214913750,1214914890,10,1,1140
9644199@N02,3746,1,1310001607,1310001697,1,1,90
9644199@N02,3747,4,1325061512,1325062412,1,1,900
9644199@N02,3748,5,1331620699,1331621599,1,1,900
96466494@N00,3749,4,1471598392,1471599292,1,1,900
96525092@N00,3750,10,1254369658,1254371158,2,4,1500
96525092@N00,3750,8,1254384618,1254385609,2,4,991
96525092@N00,3750,1,1254385609,1254385699,2,4,90
96525092@N00,3750,8,1254385796,1254386936,2,4,1140
96525092@N00,3751,8,1257261291,1257262431,1,1,1140
96525092@N00,3752,8,1262951913,1262953053,1,1,1140
96525092@N00,3753,2,1267827940,1267828330,2,2,390
96525092@N00,3753,8,1267829141,1267830281,2,2,1140
9653109@N04,3754,10,1252310441,1252311941,2,3,1500
9653109@N04,3754,12,1252315984,1252316095,2,3,111
9653109@N04,3754,5,1252316095,1252316995,4,3,900
9653109@N04,3755,13,1252571586,1252573386,2,2,1800
9653109@N04,3755,11,1252581207,1252582707,1,2,1500
9653109@N04,3756,5,1285576404,1285577304,2,4,900
9653109@N04,3756,11,1285578592,1285580092,2,4,1500
9653109@N04,3756,4,1285580623,1285581523,2,4,900
9653109@N04,3756,5,1285584356,1285585256,1,4,900
96545872@N00,3757,4,1356243187,1356244087,1,1,900
96548081@N07,3758,2,1460342374,1460342764,1,1,390
96581740@N03,3759,8,1442539915,1442541055,13,6,1140
96581740@N03,3759,1,1442545424,1442545514,8,6,90
96581740@N03,3759,8,1442548171,1442549311,3,6,1140
96581740@N03,3759,12,1442559121,1442560621,14,6,1500
96581740@N03,3759,2,1442564736,1442565126,3,6,390
96581740@N03,3759,11,1442565237,1442566737,1,6,1500
96634395@N05,3760,5,1392176619,1392177519,1,1,900
96634395@N05,3761,4,1394355029,1394355929,2,2,900
96634395@N05,3761,11,1394357185,1394358685,2,2,1500
96637966@N00,3762,4,1402063028,1402063928,1,1,900
9664341@N05,3763,7,1215129419,1215130439,2,4,1020
9664341@N05,3763,2,1215131208,1215131598,4,4,390
9664341@N05,3763,6,1215140150,1215141170,2,4,1020
9664341@N05,3763,8,1215146274,1215147414,4,4,1140
9664341@N05,3764,2,1215214641,1215215031,3,2,390
9664341@N05,3764,12,1215217847,1215219347,1,2,1500
9664341@N05,3765,8,1215653927,1215655067,1,1,1140
96678288@N02,3766,8,1370579649,1370580789,4,1,1140
96678288@N02,3767,6,1384317722,1384318742,2,1,1020
96678288@N02,3768,10,1385530739,1385532239,2,4,1500
96678288@N02,3768,2,1385533140,1385533530,3,4,390
96678288@N02,3768,9,1385541083,1385542583,11,4,1500
96678288@N02,3768,10,1385545392,1385546892,7,4,1500
96678288@N02,3769,6,1388825509,1388826529,46,3,1020
96678288@N02,3769,4,1388833484,1388833779,2,3,295
96678288@N02,3769,6,1388833779,1388834799,1,3,1020
96678288@N02,3770,6,1448694791,1448695811,2,1,1020
96678288@N02,3771,6,1449916279,1449917299,2,2,1020
96678288@N02,3771,12,1449924470,1449925970,3,2,1500
96678288@N02,3772,5,1451020068,1451020968,2,2,900
96678288@N02,3772,6,1451026752,1451027772,3,2,1020
96678288@N02,3773,4,1451121166,1451122066,1,1,900
96678288@N02,3774,5,1451442024,1451442924,1,1,900
96678288@N02,3775,6,1451704571,1451705591,9,1,1020
96678288@N02,3776,6,1451814413,1451815433,1,1,1020
96678288@N02,3777,6,1451992824,1451993844,1,1,1020
96678288@N02,3778,6,1452302468,1452303488,5,1,1020
96678288@N02,3779,12,1455511610,1455513110,2,2,1500
96678288@N02,3779,8,1455524372,1455525512,2,2,1140
96678288@N02,3780,8,1455569342,1455570482,1,1,1140
96678288@N02,3781,6,1457933674,1457934694,3,6,1020
96678288@N02,3781,2,1457936016,1457936406,2,6,390
96678288@N02,3781,6,1457939174,1457940194,2,6,1020
96678288@N02,3781,4,1457940297,1457941197,4,6,900
96678288@N02,3781,8,1457944988,1457945933,2,6,945
96678288@N02,3781,4,1457945933,1457946833,1,6,900
96678288@N02,3782,2,1458789090,1458789480,2,2,390
96678288@N02,3782,8,1458813110,1458814250,2,2,1140
96678288@N02,3783,6,1459143044,1459144064,33,1,1020
96678288@N02,3784,5,1460962155,1460963055,2,7,900
96678288@N02,3784,8,1460963471,1460964611,2,7,1140
96678288@N02,3784,9,1460966697,1460968197,2,7,1500
96678288@N02,3784,8,1460968471,1460969611,2,7,1140
96678288@N02,3784,9,1460971645,1460973145,5,7,1500
96678288@N02,3784,6,1460975035,1460976055,2,7,1020
96678288@N02,3784,5,1460978008,1460978908,1,7,900
96678288@N02,3785,4,1462177955,1462178855,1,1,900
96678288@N02,3786,4,1465887760,1465888660,1,1,900
96678288@N02,3787,10,1466475864,1466477364,3,4,1500
96678288@N02,3787,2,1466495638,1466496028,2,4,390
96678288@N02,3787,4,1466499796,1466500696,2,4,900
96678288@N02,3787,10,1466510719,1466512219,3,4,1500
96678288@N02,3788,8,1467104576,1467105716,2,1,1140
96678288@N02,3789,8,1468315455,1468316595,4,1,1140
96678288@N02,3790,8,1469505147,1469506287,3,9,1140
96678288@N02,3790,5,1469512141,1469513041,2,9,900
96678288@N02,3790,7,1469513619,1469514349,2,9,730
96678288@N02,3790,6,1469514349,1469515369,2,9,1020
96678288@N02,3790,2,1469518365,1469518576,2,9,211
96678288@N02,3790,5,1469518576,1469519476,2,9,900
96678288@N02,3790,8,1469522347,1469523487,2,9,1140
96678288@N02,3790,5,1469527361,1469528129,2,9,768
96678288@N02,3790,8,1469528129,1469529269,1,9,1140
96739093@N00,3791,2,1279275032,1279275422,1,1,390
96744221@N05,3792,4,1370694123,1370694292,2,2,169
96744221@N05,3792,2,1370694292,1370694682,1,2,390
96818288@N03,3793,1,1202121738,1202121828,1,1,90
96846534@N05,3794,8,1363650332,1363651472,2,2,1140
96846534@N05,3794,2,1363660143,1363660533,1,2,390
96905971@N05,3795,10,1370654320,1370655820,2,3,1500
96905971@N05,3795,1,1370658111,1370658201,2,3,90
96905971@N05,3795,10,1370663927,1370665427,1,3,1500
96934975@N05,3796,2,1370404697,1370405087,1,1,390
97023479@N08,3797,5,1444169618,1444170518,2,6,900
97023479@N08,3797,8,1444173421,1444174561,2,6,1140
97023479@N08,3797,10,1444176425,1444177925,2,6,1500
97023479@N08,3797,5,1444178509,1444179409,2,6,900
97023479@N08,3797,6,1444181549,1444182569,4,6,1020
97023479@N08,3797,9,1444209767,1444211267,2,6,1500
9710088@N06,3798,6,1298725544,1298726564,1,1,1020
97174119@N07,3799,4,1405488847,1405489747,1,1,900
97174119@N07,3800,5,1405812951,1405813851,1,1,900
97267319@N00,3801,4,1365642743,1365643643,2,9,900
97267319@N00,3801,13,1365644512,1365646312,3,9,1800
97267319@N00,3801,6,1365647499,1365647519,2,9,20
97267319@N00,3801,4,1365647519,1365648419,3,9,900
97267319@N00,3801,6,1365650542,1365651562,5,9,1020
97267319@N00,3801,2,1365654301,1365654691,2,9,390
97267319@N00,3801,4,1365667079,1365667979,3,9,900
97267319@N00,3801,8,1365671373,1365671542,2,9,169
97267319@N00,3801,2,1365671542,1365671932,2,9,390
97316886@N04,3802,10,1452468705,1452470205,2,2,1500
97316886@N04,3802,6,1452470520,1452471540,1,2,1020
97408089@N00,3803,4,1362963470,1362964370,2,1,900
97413516@N00,3804,8,1287101839,1287102979,1,1,1140
97472023@N04,3805,2,1414034231,1414034621,2,2,390
97472023@N04,3805,1,1414041918,1414042008,1,2,90
97477255@N00,3806,6,1359865012,1359866032,10,1,1020
97489023@N00,3807,5,1322953795,1322954695,3,3,900
97489023@N00,3807,6,1322961012,1322962032,3,3,1020
97489023@N00,3807,11,1322967681,1322969181,1,3,1500
97550352@N08,3808,6,1387609066,1387610086,1,1,1020
97621779@N03,3809,7,1339319028,1339320048,1,1,1020
97639305@N00,3810,1,1300103040,1300103130,3,1,90
97721343@N08,3811,6,1420107989,1420109009,4,2,1020
97721343@N08,3811,1,1420109124,1420109214,3,2,90
97818848@N05,3812,12,1435566131,1435567631,1,1,1500
97818848@N05,3813,13,1453531249,1453533049,1,1,1800
97838235@N00,3814,5,1381102245,1381103145,2,4,900
97838235@N00,3814,13,1381110797,1381112597,2,4,1800
97838235@N00,3814,4,1381120008,1381120908,4,4,900
97838235@N00,3814,12,1381128311,1381129811,1,4,1500
97864553@N00,3815,11,1306359366,1306360866,63,1,1500
97864553@N00,3816,11,1306446894,1306448394,1,1,1500
97885855@N04,3817,6,1376366294,1376367314,1,1,1020
9790304@N07,3818,5,1363903219,1363904119,2,3,900
9790304@N07,3818,3,1363908500,1363908920,4,3,420
9790304@N07,3818,10,1363913283,1363914783,3,3,1500
97904625@N05,3819,2,1373170302,1373170692,2,1,390
97956153@N08,3820,8,1363391204,1363392344,1,1,1140
98109106@N00,3821,8,1246601148,1246602288,2,4,1140
98109106@N00,3821,13,1246603691,1246605491,3,4,1800
98109106@N00,3821,4,1246606395,1246607295,4,4,900
98109106@N00,3821,13,1246612514,1246614314,7,4,1800
98109106@N00,3822,8,1246705027,1246706167,18,1,1140
98109106@N00,3823,6,1247213075,1247214020,2,5,945
98109106@N00,3823,4,1247214020,1247214920,5,5,900
98109106@N00,3823,7,1247218619,1247219124,3,5,505
98109106@N00,3823,1,1247219124,1247219167,2,5,43
98109106@N00,3823,7,1247219167,1247220187,1,5,1020
9813050@N08,3824,8,1257031541,1257031671,2,13,130
9813050@N08,3824,5,1257031671,1257031720,2,13,49
9813050@N08,3824,10,1257031720,1257033220,3,13,1500
9813050@N08,3824,5,1257034396,1257034785,6,13,389
9813050@N08,3824,1,1257034785,1257034806,2,13,21
9813050@N08,3824,7,1257034806,1257035265,11,13,459
9813050@N08,3824,2,1257035265,1257035655,49,13,390
9813050@N08,3824,7,1257042302,1257042486,2,13,184
9813050@N08,3824,6,1257042486,1257042991,14,13,505
9813050@N08,3824,3,1257042991,1257043411,14,13,420
9813050@N08,3824,1,1257056348,1257056438,9,13,90
9813050@N08,3824,9,1257057634,1257059134,46,13,1500
9813050@N08,3824,8,1257072946,1257074086,1,13,1140
9813050@N08,3825,3,1257212819,1257213239,4,3,420
9813050@N08,3825,6,1257217168,1257217488,3,3,320
9813050@N08,3825,13,1257217488,1257219288,71,3,1800
9813050@N08,3826,11,1257558536,1257560036,4,1,1500
98223232@N00,3827,8,1255558625,1255559199,3,4,574
98223232@N00,3827,5,1255559199,1255560099,4,4,900
98223232@N00,3827,13,1255570642,1255572442,22,4,1800
98223232@N00,3827,6,1255580224,1255581244,9,4,1020
98297562@N04,3828,1,1395202918,1395203008,2,2,90
98297562@N04,3828,8,1395212269,1395213409,1,2,1140
98297562@N04,3829,2,1395383176,1395383566,2,3,390
98297562@N04,3829,4,1395388476,1395389376,3,3,900
98297562@N04,3829,8,1395391409,1395392549,1,3,1140
98317956@N00,3830,8,1337724812,1337725952,2,4,1140
98317956@N00,3830,6,1337734936,1337735956,3,4,1020
98317956@N00,3830,13,1337745932,1337747732,24,4,1800
98317956@N00,3830,6,1337755216,1337756236,3,4,1020
98317956@N00,3831,6,1338171572,1338172592,2,1,1020
98387918@N07,3832,6,1417245788,1417246808,4,1,1020
98474523@N00,3833,1,1323038954,1323039044,37,1,90
9858951@N03,3834,8,1274254724,1274254743,3,3,19
9858951@N03,3834,11,1274254743,1274254797,7,3,54
9858951@N03,3834,8,1274254797,1274255937,1,3,1140
9860213@N08,3835,2,1343093717,1343094107,5,1,390
9860213@N08,3836,5,1447893369,1447894269,2,2,900
9860213@N08,3836,7,1447894799,1447895819,1,2,1020
9860213@N08,3837,5,1448005196,1448006096,1,1,900
98655096@N05,3838,7,1373080029,1373080069,8,3,40
98655096@N05,3838,12,1373080069,1373081569,4,3,1500
98655096@N05,3838,10,1373091811,1373093311,3,3,1500
98672908@N07,3839,5,1451424934,1451425834,2,4,900
98672908@N07,3839,4,1451435244,1451436144,7,4,900
98672908@N07,3839,6,1451445076,1451446096,3,4,1020
98672908@N07,3839,4,1451446933,1451447833,3,4,900
9881590@N03,3840,10,1380090584,1380092084,1,1,1500
98889314@N02,3841,10,1403764324,1403764448,2,7,124
98889314@N02,3841,1,1403764448,1403764538,8,7,90
98889314@N02,3841,10,1403764575,1403764601,3,7,26
98889314@N02,3841,5,1403764601,1403765501,25,7,900
98889314@N02,3841,1,1403766326,1403766416,17,7,90
98889314@N02,3841,8,1403766698,1403767838,9,7,1140
98889314@N02,3841,1,1403769573,1403769663,1,7,90
9907136@N02,3842,1,1252103018,1252103108,1,1,90
9907136@N02,3843,10,1333594321,1333595821,2,1,1500
99119735@N06,3844,8,1382840337,1382841477,1,1,1140
99119735@N06,3845,11,1382917115,1382918615,6,9,1500
99119735@N06,3845,6,1382919226,1382920246,2,9,1020
99119735@N06,3845,4,1382922881,1382923318,2,9,437
99119735@N06,3845,13,1382923318,1382925118,2,9,1800
99119735@N06,3845,4,1382926600,1382927500,2,9,900
99119735@N06,3845,11,1382943193,1382943448,18,9,255
99119735@N06,3845,7,1382943448,1382944130,6,9,682
99119735@N06,3845,2,1382944130,1382944520,4,9,390
99119735@N06,3845,9,1382948159,1382949659,3,9,1500
99199321@N07,3846,6,1420933183,1420934203,1,1,1020
99219204@N00,3847,5,1359157853,1359158753,3,3,900
99219204@N00,3847,6,1359175281,1359176301,2,3,1020
99219204@N00,3847,4,1359181337,1359182237,3,3,900
9938245@N08,3848,1,1246312106,1246312196,1,1,90
99385068@N00,3849,1,1383353575,1383353665,10,1,90
99422834@N05,3850,10,1331508330,1331509830,4,2,1500
99422834@N05,3850,1,1331525801,1331525891,3,2,90
99471343@N00,3851,2,1366154734,1366155124,9,12,390
99471343@N00,3851,8,1366157309,1366158077,2,12,768
99471343@N00,3851,2,1366158077,1366158382,2,12,305
99471343@N00,3851,6,1366158382,1366158890,2,12,508
99471343@N00,3851,8,1366158890,1366160018,2,12,1128
99471343@N00,3851,7,1366160018,1366161038,2,12,1020
99471343@N00,3851,12,1366162176,1366163436,2,12,1260
99471343@N00,3851,6,1366163436,1366164456,6,12,1020
99471343@N00,3851,12,1366172574,1366173414,2,12,840
99471343@N00,3851,7,1366173414,1366173604,2,12,190
99471343@N00,3851,12,1366173604,1366175104,3,12,1500
99471343@N00,3851,2,1366188101,1366188491,1,12,390
99503665@N00,3852,2,1356316252,1356316642,2,3,390
99503665@N00,3852,8,1356318727,1356319867,2,3,1140
99503665@N00,3852,4,1356327367,1356328267,1,3,900
99544917@N00,3853,5,1406415546,1406416446,4,4,900
99544917@N00,3853,8,1406430246,1406430465,2,4,219
99544917@N00,3853,5,1406430465,1406430930,2,4,465
99544917@N00,3853,8,1406430930,1406432070,1,4,1140
99619919@N05,3854,1,1362288610,1362288700,2,2,90
99619919@N05,3854,2,1362290745,1362291135,1,2,390
9977376@N05,3855,12,1382231426,1382232926,1,1,1500
99876261@N00,3856,1,1212882505,1212882595,284,1,90
99929871@N00,3857,4,1294444664,1294445564,1,1,900
99948019@N00,3858,4,1386059683,1386060583,1,1,900
